Id,Id2,Geography,Number,Occupied,Vacant
1000000US060855001001000,060855001001000,"Block 1000, Block Group 1, Census Tract 5001, Santa Clara County, California",0,0,0
1000000US060855001001001,060855001001001,"Block 1001, Block Group 1, Census Tract 5001, Santa Clara County, California",14,11,3
1000000US060855001001002,060855001001002,"Block 1002, Block Group 1, Census Tract 5001, Santa Clara County, California",0,0,0
1000000US060855001001003,060855001001003,"Block 1003, Block Group 1, Census Tract 5001, Santa Clara County, California",0,0,0
1000000US060855001001004,060855001001004,"Block 1004, Block Group 1, Census Tract 5001, Santa Clara County, California",0,0,0
1000000US060855001001005,060855001001005,"Block 1005, Block Group 1, Census Tract 5001, Santa Clara County, California",10,9,1
1000000US060855001001006,060855001001006,"Block 1006, Block Group 1, Census Tract 5001, Santa Clara County, California",16,15,1
1000000US060855001001007,060855001001007,"Block 1007, Block Group 1, Census Tract 5001, Santa Clara County, California",0,0,0
1000000US060855001001008,060855001001008,"Block 1008, Block Group 1, Census Tract 5001, Santa Clara County, California",2,2,0
1000000US060855001001009,060855001001009,"Block 1009, Block Group 1, Census Tract 5001, Santa Clara County, California",24,20,4
1000000US060855001001010,060855001001010,"Block 1010, Block Group 1, Census Tract 5001, Santa Clara County, California",0,0,0
1000000US060855001001011,060855001001011,"Block 1011, Block Group 1, Census Tract 5001, Santa Clara County, California",0,0,0
1000000US060855001001012,060855001001012,"Block 1012, Block Group 1, Census Tract 5001, Santa Clara County, California",4,4,0
1000000US060855001001013,060855001001013,"Block 1013, Block Group 1, Census Tract 5001, Santa Clara County, California",14,12,2
1000000US060855001001014,060855001001014,"Block 1014, Block Group 1, Census Tract 5001, Santa Clara County, California",22,19,3
1000000US060855001001015,060855001001015,"Block 1015, Block Group 1, Census Tract 5001, Santa Clara County, California",44,41,3
1000000US060855001001016,060855001001016,"Block 1016, Block Group 1, Census Tract 5001, Santa Clara County, California",56,56,0
1000000US060855001001017,060855001001017,"Block 1017, Block Group 1, Census Tract 5001, Santa Clara County, California",37,33,4
1000000US060855001001018,060855001001018,"Block 1018, Block Group 1, Census Tract 5001, Santa Clara County, California",37,33,4
1000000US060855001001019,060855001001019,"Block 1019, Block Group 1, Census Tract 5001, Santa Clara County, California",46,42,4
1000000US060855001002000,060855001002000,"Block 2000, Block Group 2, Census Tract 5001, Santa Clara County, California",0,0,0
1000000US060855001002001,060855001002001,"Block 2001, Block Group 2, Census Tract 5001, Santa Clara County, California",48,45,3
1000000US060855001002002,060855001002002,"Block 2002, Block Group 2, Census Tract 5001, Santa Clara County, California",0,0,0
1000000US060855001002003,060855001002003,"Block 2003, Block Group 2, Census Tract 5001, Santa Clara County, California",0,0,0
1000000US060855001002004,060855001002004,"Block 2004, Block Group 2, Census Tract 5001, Santa Clara County, California",28,26,2
1000000US060855001002005,060855001002005,"Block 2005, Block Group 2, Census Tract 5001, Santa Clara County, California",12,12,0
1000000US060855001002006,060855001002006,"Block 2006, Block Group 2, Census Tract 5001, Santa Clara County, California",7,3,4
1000000US060855001002007,060855001002007,"Block 2007, Block Group 2, Census Tract 5001, Santa Clara County, California",22,22,0
1000000US060855001002008,060855001002008,"Block 2008, Block Group 2, Census Tract 5001, Santa Clara County, California",24,20,4
1000000US060855001002009,060855001002009,"Block 2009, Block Group 2, Census Tract 5001, Santa Clara County, California",40,37,3
1000000US060855001002010,060855001002010,"Block 2010, Block Group 2, Census Tract 5001, Santa Clara County, California",31,30,1
1000000US060855001002011,060855001002011,"Block 2011, Block Group 2, Census Tract 5001, Santa Clara County, California",38,38,0
1000000US060855001002012,060855001002012,"Block 2012, Block Group 2, Census Tract 5001, Santa Clara County, California",21,18,3
1000000US060855001002013,060855001002013,"Block 2013, Block Group 2, Census Tract 5001, Santa Clara County, California",26,21,5
1000000US060855001002014,060855001002014,"Block 2014, Block Group 2, Census Tract 5001, Santa Clara County, California",27,24,3
1000000US060855001002015,060855001002015,"Block 2015, Block Group 2, Census Tract 5001, Santa Clara County, California",16,16,0
1000000US060855001002016,060855001002016,"Block 2016, Block Group 2, Census Tract 5001, Santa Clara County, California",10,9,1
1000000US060855001002017,060855001002017,"Block 2017, Block Group 2, Census Tract 5001, Santa Clara County, California",15,15,0
1000000US060855001002018,060855001002018,"Block 2018, Block Group 2, Census Tract 5001, Santa Clara County, California",12,12,0
1000000US060855001002019,060855001002019,"Block 2019, Block Group 2, Census Tract 5001, Santa Clara County, California",27,26,1
1000000US060855001002020,060855001002020,"Block 2020, Block Group 2, Census Tract 5001, Santa Clara County, California",20,18,2
1000000US060855001002021,060855001002021,"Block 2021, Block Group 2, Census Tract 5001, Santa Clara County, California",31,31,0
1000000US060855001003000,060855001003000,"Block 3000, Block Group 3, Census Tract 5001, Santa Clara County, California",81,81,0
1000000US060855001003001,060855001003001,"Block 3001, Block Group 3, Census Tract 5001, Santa Clara County, California",13,12,1
1000000US060855001003002,060855001003002,"Block 3002, Block Group 3, Census Tract 5001, Santa Clara County, California",71,71,0
1000000US060855001003003,060855001003003,"Block 3003, Block Group 3, Census Tract 5001, Santa Clara County, California",68,66,2
1000000US060855001003004,060855001003004,"Block 3004, Block Group 3, Census Tract 5001, Santa Clara County, California",30,28,2
1000000US060855001003005,060855001003005,"Block 3005, Block Group 3, Census Tract 5001, Santa Clara County, California",33,33,0
1000000US060855001003006,060855001003006,"Block 3006, Block Group 3, Census Tract 5001, Santa Clara County, California",32,32,0
1000000US060855001003007,060855001003007,"Block 3007, Block Group 3, Census Tract 5001, Santa Clara County, California",34,34,0
1000000US060855001003008,060855001003008,"Block 3008, Block Group 3, Census Tract 5001, Santa Clara County, California",41,38,3
1000000US060855001003009,060855001003009,"Block 3009, Block Group 3, Census Tract 5001, Santa Clara County, California",49,49,0
1000000US060855001003010,060855001003010,"Block 3010, Block Group 3, Census Tract 5001, Santa Clara County, California",61,61,0
1000000US060855001003011,060855001003011,"Block 3011, Block Group 3, Census Tract 5001, Santa Clara County, California",37,33,4
1000000US060855001004000,060855001004000,"Block 4000, Block Group 4, Census Tract 5001, Santa Clara County, California",9,9,0
1000000US060855001004001,060855001004001,"Block 4001, Block Group 4, Census Tract 5001, Santa Clara County, California",30,30,0
1000000US060855001004002,060855001004002,"Block 4002, Block Group 4, Census Tract 5001, Santa Clara County, California",12,12,0
1000000US060855001004003,060855001004003,"Block 4003, Block Group 4, Census Tract 5001, Santa Clara County, California",10,10,0
1000000US060855001004004,060855001004004,"Block 4004, Block Group 4, Census Tract 5001, Santa Clara County, California",10,10,0
1000000US060855001004005,060855001004005,"Block 4005, Block Group 4, Census Tract 5001, Santa Clara County, California",8,8,0
1000000US060855001004006,060855001004006,"Block 4006, Block Group 4, Census Tract 5001, Santa Clara County, California",8,7,1
1000000US060855001004007,060855001004007,"Block 4007, Block Group 4, Census Tract 5001, Santa Clara County, California",83,77,6
1000000US060855001004008,060855001004008,"Block 4008, Block Group 4, Census Tract 5001, Santa Clara County, California",17,17,0
1000000US060855001004009,060855001004009,"Block 4009, Block Group 4, Census Tract 5001, Santa Clara County, California",13,12,1
1000000US060855001004010,060855001004010,"Block 4010, Block Group 4, Census Tract 5001, Santa Clara County, California",0,0,0
1000000US060855001004011,060855001004011,"Block 4011, Block Group 4, Census Tract 5001, Santa Clara County, California",0,0,0
1000000US060855001004012,060855001004012,"Block 4012, Block Group 4, Census Tract 5001, Santa Clara County, California",0,0,0
1000000US060855001004013,060855001004013,"Block 4013, Block Group 4, Census Tract 5001, Santa Clara County, California",7,7,0
1000000US060855001004014,060855001004014,"Block 4014, Block Group 4, Census Tract 5001, Santa Clara County, California",20,19,1
1000000US060855001004015,060855001004015,"Block 4015, Block Group 4, Census Tract 5001, Santa Clara County, California",58,57,1
1000000US060855001004016,060855001004016,"Block 4016, Block Group 4, Census Tract 5001, Santa Clara County, California",29,28,1
1000000US060855001004017,060855001004017,"Block 4017, Block Group 4, Census Tract 5001, Santa Clara County, California",25,25,0
1000000US060855001004018,060855001004018,"Block 4018, Block Group 4, Census Tract 5001, Santa Clara County, California",0,0,0
1000000US060855001004019,060855001004019,"Block 4019, Block Group 4, Census Tract 5001, Santa Clara County, California",38,32,6
1000000US060855001004020,060855001004020,"Block 4020, Block Group 4, Census Tract 5001, Santa Clara County, California",35,33,2
1000000US060855001004021,060855001004021,"Block 4021, Block Group 4, Census Tract 5001, Santa Clara County, California",40,38,2
1000000US060855001004022,060855001004022,"Block 4022, Block Group 4, Census Tract 5001, Santa Clara County, California",38,34,4
1000000US060855001004023,060855001004023,"Block 4023, Block Group 4, Census Tract 5001, Santa Clara County, California",46,44,2
1000000US060855001004024,060855001004024,"Block 4024, Block Group 4, Census Tract 5001, Santa Clara County, California",20,18,2
1000000US060855001004025,060855001004025,"Block 4025, Block Group 4, Census Tract 5001, Santa Clara County, California",232,218,14
1000000US060855001004026,060855001004026,"Block 4026, Block Group 4, Census Tract 5001, Santa Clara County, California",53,50,3
1000000US060855001004027,060855001004027,"Block 4027, Block Group 4, Census Tract 5001, Santa Clara County, California",26,25,1
1000000US060855002001000,060855002001000,"Block 1000, Block Group 1, Census Tract 5002, Santa Clara County, California",44,41,3
1000000US060855002001001,060855002001001,"Block 1001, Block Group 1, Census Tract 5002, Santa Clara County, California",39,39,0
1000000US060855002001002,060855002001002,"Block 1002, Block Group 1, Census Tract 5002, Santa Clara County, California",47,46,1
1000000US060855002001003,060855002001003,"Block 1003, Block Group 1, Census Tract 5002, Santa Clara County, California",41,39,2
1000000US060855002001004,060855002001004,"Block 1004, Block Group 1, Census Tract 5002, Santa Clara County, California",43,38,5
1000000US060855002001005,060855002001005,"Block 1005, Block Group 1, Census Tract 5002, Santa Clara County, California",27,24,3
1000000US060855002001006,060855002001006,"Block 1006, Block Group 1, Census Tract 5002, Santa Clara County, California",19,19,0
1000000US060855002001007,060855002001007,"Block 1007, Block Group 1, Census Tract 5002, Santa Clara County, California",0,0,0
1000000US060855002001008,060855002001008,"Block 1008, Block Group 1, Census Tract 5002, Santa Clara County, California",0,0,0
1000000US060855002001009,060855002001009,"Block 1009, Block Group 1, Census Tract 5002, Santa Clara County, California",0,0,0
1000000US060855002001010,060855002001010,"Block 1010, Block Group 1, Census Tract 5002, Santa Clara County, California",19,18,1
1000000US060855002001011,060855002001011,"Block 1011, Block Group 1, Census Tract 5002, Santa Clara County, California",0,0,0
1000000US060855002001012,060855002001012,"Block 1012, Block Group 1, Census Tract 5002, Santa Clara County, California",63,59,4
1000000US060855002001013,060855002001013,"Block 1013, Block Group 1, Census Tract 5002, Santa Clara County, California",55,52,3
1000000US060855002001014,060855002001014,"Block 1014, Block Group 1, Census Tract 5002, Santa Clara County, California",39,35,4
1000000US060855002001015,060855002001015,"Block 1015, Block Group 1, Census Tract 5002, Santa Clara County, California",1,1,0
1000000US060855002001016,060855002001016,"Block 1016, Block Group 1, Census Tract 5002, Santa Clara County, California",0,0,0
1000000US060855002001017,060855002001017,"Block 1017, Block Group 1, Census Tract 5002, Santa Clara County, California",0,0,0
1000000US060855002001018,060855002001018,"Block 1018, Block Group 1, Census Tract 5002, Santa Clara County, California",9,8,1
1000000US060855002001019,060855002001019,"Block 1019, Block Group 1, Census Tract 5002, Santa Clara County, California",74,72,2
1000000US060855002001020,060855002001020,"Block 1020, Block Group 1, Census Tract 5002, Santa Clara County, California",0,0,0
1000000US060855002002000,060855002002000,"Block 2000, Block Group 2, Census Tract 5002, Santa Clara County, California",0,0,0
1000000US060855002002001,060855002002001,"Block 2001, Block Group 2, Census Tract 5002, Santa Clara County, California",0,0,0
1000000US060855002002002,060855002002002,"Block 2002, Block Group 2, Census Tract 5002, Santa Clara County, California",0,0,0
1000000US060855002002003,060855002002003,"Block 2003, Block Group 2, Census Tract 5002, Santa Clara County, California",0,0,0
1000000US060855002003000,060855002003000,"Block 3000, Block Group 3, Census Tract 5002, Santa Clara County, California",83,78,5
1000000US060855002003001,060855002003001,"Block 3001, Block Group 3, Census Tract 5002, Santa Clara County, California",78,76,2
1000000US060855002003002,060855002003002,"Block 3002, Block Group 3, Census Tract 5002, Santa Clara County, California",27,24,3
1000000US060855002003003,060855002003003,"Block 3003, Block Group 3, Census Tract 5002, Santa Clara County, California",3,3,0
1000000US060855002003004,060855002003004,"Block 3004, Block Group 3, Census Tract 5002, Santa Clara County, California",13,11,2
1000000US060855002003005,060855002003005,"Block 3005, Block Group 3, Census Tract 5002, Santa Clara County, California",69,63,6
1000000US060855002003006,060855002003006,"Block 3006, Block Group 3, Census Tract 5002, Santa Clara County, California",0,0,0
1000000US060855002003007,060855002003007,"Block 3007, Block Group 3, Census Tract 5002, Santa Clara County, California",100,87,13
1000000US060855002003008,060855002003008,"Block 3008, Block Group 3, Census Tract 5002, Santa Clara County, California",97,89,8
1000000US060855002003009,060855002003009,"Block 3009, Block Group 3, Census Tract 5002, Santa Clara County, California",47,46,1
1000000US060855002003010,060855002003010,"Block 3010, Block Group 3, Census Tract 5002, Santa Clara County, California",129,123,6
1000000US060855002004000,060855002004000,"Block 4000, Block Group 4, Census Tract 5002, Santa Clara County, California",25,25,0
1000000US060855002004001,060855002004001,"Block 4001, Block Group 4, Census Tract 5002, Santa Clara County, California",18,17,1
1000000US060855002004002,060855002004002,"Block 4002, Block Group 4, Census Tract 5002, Santa Clara County, California",4,4,0
1000000US060855002004003,060855002004003,"Block 4003, Block Group 4, Census Tract 5002, Santa Clara County, California",49,47,2
1000000US060855002004004,060855002004004,"Block 4004, Block Group 4, Census Tract 5002, Santa Clara County, California",30,27,3
1000000US060855002004005,060855002004005,"Block 4005, Block Group 4, Census Tract 5002, Santa Clara County, California",66,64,2
1000000US060855002004006,060855002004006,"Block 4006, Block Group 4, Census Tract 5002, Santa Clara County, California",0,0,0
1000000US060855002004007,060855002004007,"Block 4007, Block Group 4, Census Tract 5002, Santa Clara County, California",51,51,0
1000000US060855002004008,060855002004008,"Block 4008, Block Group 4, Census Tract 5002, Santa Clara County, California",0,0,0
1000000US060855002004009,060855002004009,"Block 4009, Block Group 4, Census Tract 5002, Santa Clara County, California",0,0,0
1000000US060855002004010,060855002004010,"Block 4010, Block Group 4, Census Tract 5002, Santa Clara County, California",0,0,0
1000000US060855002004011,060855002004011,"Block 4011, Block Group 4, Census Tract 5002, Santa Clara County, California",2,2,0
1000000US060855002004012,060855002004012,"Block 4012, Block Group 4, Census Tract 5002, Santa Clara County, California",335,302,33
1000000US060855002004013,060855002004013,"Block 4013, Block Group 4, Census Tract 5002, Santa Clara County, California",51,49,2
1000000US060855002004014,060855002004014,"Block 4014, Block Group 4, Census Tract 5002, Santa Clara County, California",14,14,0
1000000US060855002004015,060855002004015,"Block 4015, Block Group 4, Census Tract 5002, Santa Clara County, California",55,52,3
1000000US060855002004016,060855002004016,"Block 4016, Block Group 4, Census Tract 5002, Santa Clara County, California",43,38,5
1000000US060855002004017,060855002004017,"Block 4017, Block Group 4, Census Tract 5002, Santa Clara County, California",0,0,0
1000000US060855002004018,060855002004018,"Block 4018, Block Group 4, Census Tract 5002, Santa Clara County, California",28,28,0
1000000US060855002004019,060855002004019,"Block 4019, Block Group 4, Census Tract 5002, Santa Clara County, California",197,187,10
1000000US060855002004020,060855002004020,"Block 4020, Block Group 4, Census Tract 5002, Santa Clara County, California",0,0,0
1000000US060855002004021,060855002004021,"Block 4021, Block Group 4, Census Tract 5002, Santa Clara County, California",0,0,0
1000000US060855002004022,060855002004022,"Block 4022, Block Group 4, Census Tract 5002, Santa Clara County, California",0,0,0
1000000US060855002004023,060855002004023,"Block 4023, Block Group 4, Census Tract 5002, Santa Clara County, California",0,0,0
1000000US060855003001000,060855003001000,"Block 1000, Block Group 1, Census Tract 5003, Santa Clara County, California",0,0,0
1000000US060855003001001,060855003001001,"Block 1001, Block Group 1, Census Tract 5003, Santa Clara County, California",0,0,0
1000000US060855003001002,060855003001002,"Block 1002, Block Group 1, Census Tract 5003, Santa Clara County, California",0,0,0
1000000US060855003001003,060855003001003,"Block 1003, Block Group 1, Census Tract 5003, Santa Clara County, California",0,0,0
1000000US060855003001004,060855003001004,"Block 1004, Block Group 1, Census Tract 5003, Santa Clara County, California",0,0,0
1000000US060855003001005,060855003001005,"Block 1005, Block Group 1, Census Tract 5003, Santa Clara County, California",0,0,0
1000000US060855003001006,060855003001006,"Block 1006, Block Group 1, Census Tract 5003, Santa Clara County, California",0,0,0
1000000US060855003001007,060855003001007,"Block 1007, Block Group 1, Census Tract 5003, Santa Clara County, California",0,0,0
1000000US060855003001008,060855003001008,"Block 1008, Block Group 1, Census Tract 5003, Santa Clara County, California",0,0,0
1000000US060855003001009,060855003001009,"Block 1009, Block Group 1, Census Tract 5003, Santa Clara County, California",0,0,0
1000000US060855003001010,060855003001010,"Block 1010, Block Group 1, Census Tract 5003, Santa Clara County, California",0,0,0
1000000US060855003001011,060855003001011,"Block 1011, Block Group 1, Census Tract 5003, Santa Clara County, California",0,0,0
1000000US060855003001012,060855003001012,"Block 1012, Block Group 1, Census Tract 5003, Santa Clara County, California",0,0,0
1000000US060855003001013,060855003001013,"Block 1013, Block Group 1, Census Tract 5003, Santa Clara County, California",11,9,2
1000000US060855003001014,060855003001014,"Block 1014, Block Group 1, Census Tract 5003, Santa Clara County, California",31,29,2
1000000US060855003001015,060855003001015,"Block 1015, Block Group 1, Census Tract 5003, Santa Clara County, California",27,26,1
1000000US060855003001016,060855003001016,"Block 1016, Block Group 1, Census Tract 5003, Santa Clara County, California",1,1,0
1000000US060855003001017,060855003001017,"Block 1017, Block Group 1, Census Tract 5003, Santa Clara County, California",0,0,0
1000000US060855003001018,060855003001018,"Block 1018, Block Group 1, Census Tract 5003, Santa Clara County, California",0,0,0
1000000US060855003001019,060855003001019,"Block 1019, Block Group 1, Census Tract 5003, Santa Clara County, California",0,0,0
1000000US060855003001020,060855003001020,"Block 1020, Block Group 1, Census Tract 5003, Santa Clara County, California",0,0,0
1000000US060855003001021,060855003001021,"Block 1021, Block Group 1, Census Tract 5003, Santa Clara County, California",1,1,0
1000000US060855003001022,060855003001022,"Block 1022, Block Group 1, Census Tract 5003, Santa Clara County, California",0,0,0
1000000US060855003001023,060855003001023,"Block 1023, Block Group 1, Census Tract 5003, Santa Clara County, California",0,0,0
1000000US060855003001024,060855003001024,"Block 1024, Block Group 1, Census Tract 5003, Santa Clara County, California",0,0,0
1000000US060855003001025,060855003001025,"Block 1025, Block Group 1, Census Tract 5003, Santa Clara County, California",0,0,0
1000000US060855003001026,060855003001026,"Block 1026, Block Group 1, Census Tract 5003, Santa Clara County, California",0,0,0
1000000US060855003001027,060855003001027,"Block 1027, Block Group 1, Census Tract 5003, Santa Clara County, California",0,0,0
1000000US060855003001028,060855003001028,"Block 1028, Block Group 1, Census Tract 5003, Santa Clara County, California",0,0,0
1000000US060855003001029,060855003001029,"Block 1029, Block Group 1, Census Tract 5003, Santa Clara County, California",0,0,0
1000000US060855003001030,060855003001030,"Block 1030, Block Group 1, Census Tract 5003, Santa Clara County, California",0,0,0
1000000US060855003001031,060855003001031,"Block 1031, Block Group 1, Census Tract 5003, Santa Clara County, California",0,0,0
1000000US060855003001032,060855003001032,"Block 1032, Block Group 1, Census Tract 5003, Santa Clara County, California",0,0,0
1000000US060855003001033,060855003001033,"Block 1033, Block Group 1, Census Tract 5003, Santa Clara County, California",0,0,0
1000000US060855003001034,060855003001034,"Block 1034, Block Group 1, Census Tract 5003, Santa Clara County, California",0,0,0
1000000US060855003001035,060855003001035,"Block 1035, Block Group 1, Census Tract 5003, Santa Clara County, California",0,0,0
1000000US060855003001036,060855003001036,"Block 1036, Block Group 1, Census Tract 5003, Santa Clara County, California",0,0,0
1000000US060855003001037,060855003001037,"Block 1037, Block Group 1, Census Tract 5003, Santa Clara County, California",0,0,0
1000000US060855003001038,060855003001038,"Block 1038, Block Group 1, Census Tract 5003, Santa Clara County, California",3,1,2
1000000US060855003001039,060855003001039,"Block 1039, Block Group 1, Census Tract 5003, Santa Clara County, California",11,9,2
1000000US060855003001040,060855003001040,"Block 1040, Block Group 1, Census Tract 5003, Santa Clara County, California",24,23,1
1000000US060855003001041,060855003001041,"Block 1041, Block Group 1, Census Tract 5003, Santa Clara County, California",5,4,1
1000000US060855003001042,060855003001042,"Block 1042, Block Group 1, Census Tract 5003, Santa Clara County, California",0,0,0
1000000US060855003001043,060855003001043,"Block 1043, Block Group 1, Census Tract 5003, Santa Clara County, California",0,0,0
1000000US060855003001044,060855003001044,"Block 1044, Block Group 1, Census Tract 5003, Santa Clara County, California",0,0,0
1000000US060855003001045,060855003001045,"Block 1045, Block Group 1, Census Tract 5003, Santa Clara County, California",0,0,0
1000000US060855003001046,060855003001046,"Block 1046, Block Group 1, Census Tract 5003, Santa Clara County, California",0,0,0
1000000US060855003001047,060855003001047,"Block 1047, Block Group 1, Census Tract 5003, Santa Clara County, California",0,0,0
1000000US060855003001048,060855003001048,"Block 1048, Block Group 1, Census Tract 5003, Santa Clara County, California",0,0,0
1000000US060855003001049,060855003001049,"Block 1049, Block Group 1, Census Tract 5003, Santa Clara County, California",1,1,0
1000000US060855003001050,060855003001050,"Block 1050, Block Group 1, Census Tract 5003, Santa Clara County, California",0,0,0
1000000US060855003001051,060855003001051,"Block 1051, Block Group 1, Census Tract 5003, Santa Clara County, California",0,0,0
1000000US060855003001052,060855003001052,"Block 1052, Block Group 1, Census Tract 5003, Santa Clara County, California",0,0,0
1000000US060855003001053,060855003001053,"Block 1053, Block Group 1, Census Tract 5003, Santa Clara County, California",0,0,0
1000000US060855003001054,060855003001054,"Block 1054, Block Group 1, Census Tract 5003, Santa Clara County, California",0,0,0
1000000US060855003001055,060855003001055,"Block 1055, Block Group 1, Census Tract 5003, Santa Clara County, California",0,0,0
1000000US060855003001056,060855003001056,"Block 1056, Block Group 1, Census Tract 5003, Santa Clara County, California",0,0,0
1000000US060855003001057,060855003001057,"Block 1057, Block Group 1, Census Tract 5003, Santa Clara County, California",0,0,0
1000000US060855003001058,060855003001058,"Block 1058, Block Group 1, Census Tract 5003, Santa Clara County, California",0,0,0
1000000US060855003001059,060855003001059,"Block 1059, Block Group 1, Census Tract 5003, Santa Clara County, California",2,2,0
1000000US060855003001060,060855003001060,"Block 1060, Block Group 1, Census Tract 5003, Santa Clara County, California",0,0,0
1000000US060855003001061,060855003001061,"Block 1061, Block Group 1, Census Tract 5003, Santa Clara County, California",0,0,0
1000000US060855003001062,060855003001062,"Block 1062, Block Group 1, Census Tract 5003, Santa Clara County, California",0,0,0
1000000US060855003001063,060855003001063,"Block 1063, Block Group 1, Census Tract 5003, Santa Clara County, California",0,0,0
1000000US060855003001064,060855003001064,"Block 1064, Block Group 1, Census Tract 5003, Santa Clara County, California",10,7,3
1000000US060855003001065,060855003001065,"Block 1065, Block Group 1, Census Tract 5003, Santa Clara County, California",18,18,0
1000000US060855003001066,060855003001066,"Block 1066, Block Group 1, Census Tract 5003, Santa Clara County, California",17,15,2
1000000US060855003001067,060855003001067,"Block 1067, Block Group 1, Census Tract 5003, Santa Clara County, California",0,0,0
1000000US060855003001068,060855003001068,"Block 1068, Block Group 1, Census Tract 5003, Santa Clara County, California",0,0,0
1000000US060855003001069,060855003001069,"Block 1069, Block Group 1, Census Tract 5003, Santa Clara County, California",0,0,0
1000000US060855003001070,060855003001070,"Block 1070, Block Group 1, Census Tract 5003, Santa Clara County, California",8,6,2
1000000US060855003001071,060855003001071,"Block 1071, Block Group 1, Census Tract 5003, Santa Clara County, California",0,0,0
1000000US060855003002000,060855003002000,"Block 2000, Block Group 2, Census Tract 5003, Santa Clara County, California",0,0,0
1000000US060855003002001,060855003002001,"Block 2001, Block Group 2, Census Tract 5003, Santa Clara County, California",3,2,1
1000000US060855003002002,060855003002002,"Block 2002, Block Group 2, Census Tract 5003, Santa Clara County, California",0,0,0
1000000US060855003002003,060855003002003,"Block 2003, Block Group 2, Census Tract 5003, Santa Clara County, California",0,0,0
1000000US060855003002004,060855003002004,"Block 2004, Block Group 2, Census Tract 5003, Santa Clara County, California",0,0,0
1000000US060855003002005,060855003002005,"Block 2005, Block Group 2, Census Tract 5003, Santa Clara County, California",0,0,0
1000000US060855003002006,060855003002006,"Block 2006, Block Group 2, Census Tract 5003, Santa Clara County, California",0,0,0
1000000US060855003002007,060855003002007,"Block 2007, Block Group 2, Census Tract 5003, Santa Clara County, California",0,0,0
1000000US060855003002008,060855003002008,"Block 2008, Block Group 2, Census Tract 5003, Santa Clara County, California",0,0,0
1000000US060855003002009,060855003002009,"Block 2009, Block Group 2, Census Tract 5003, Santa Clara County, California",3,3,0
1000000US060855003002010,060855003002010,"Block 2010, Block Group 2, Census Tract 5003, Santa Clara County, California",62,53,9
1000000US060855003002011,060855003002011,"Block 2011, Block Group 2, Census Tract 5003, Santa Clara County, California",35,35,0
1000000US060855003002012,060855003002012,"Block 2012, Block Group 2, Census Tract 5003, Santa Clara County, California",34,32,2
1000000US060855003002013,060855003002013,"Block 2013, Block Group 2, Census Tract 5003, Santa Clara County, California",39,38,1
1000000US060855003002014,060855003002014,"Block 2014, Block Group 2, Census Tract 5003, Santa Clara County, California",345,333,12
1000000US060855003002015,060855003002015,"Block 2015, Block Group 2, Census Tract 5003, Santa Clara County, California",42,36,6
1000000US060855003002016,060855003002016,"Block 2016, Block Group 2, Census Tract 5003, Santa Clara County, California",36,32,4
1000000US060855003002017,060855003002017,"Block 2017, Block Group 2, Census Tract 5003, Santa Clara County, California",51,50,1
1000000US060855003002018,060855003002018,"Block 2018, Block Group 2, Census Tract 5003, Santa Clara County, California",47,47,0
1000000US060855003002019,060855003002019,"Block 2019, Block Group 2, Census Tract 5003, Santa Clara County, California",64,59,5
1000000US060855003002020,060855003002020,"Block 2020, Block Group 2, Census Tract 5003, Santa Clara County, California",40,39,1
1000000US060855003002021,060855003002021,"Block 2021, Block Group 2, Census Tract 5003, Santa Clara County, California",9,9,0
1000000US060855003002022,060855003002022,"Block 2022, Block Group 2, Census Tract 5003, Santa Clara County, California",25,25,0
1000000US060855003002023,060855003002023,"Block 2023, Block Group 2, Census Tract 5003, Santa Clara County, California",77,70,7
1000000US060855003002024,060855003002024,"Block 2024, Block Group 2, Census Tract 5003, Santa Clara County, California",42,39,3
1000000US060855003002025,060855003002025,"Block 2025, Block Group 2, Census Tract 5003, Santa Clara County, California",46,46,0
1000000US060855003002026,060855003002026,"Block 2026, Block Group 2, Census Tract 5003, Santa Clara County, California",16,15,1
1000000US060855003002027,060855003002027,"Block 2027, Block Group 2, Census Tract 5003, Santa Clara County, California",61,60,1
1000000US060855003002028,060855003002028,"Block 2028, Block Group 2, Census Tract 5003, Santa Clara County, California",66,58,8
1000000US060855004001000,060855004001000,"Block 1000, Block Group 1, Census Tract 5004, Santa Clara County, California",207,195,12
1000000US060855004001001,060855004001001,"Block 1001, Block Group 1, Census Tract 5004, Santa Clara County, California",23,23,0
1000000US060855004001002,060855004001002,"Block 1002, Block Group 1, Census Tract 5004, Santa Clara County, California",17,17,0
1000000US060855004001003,060855004001003,"Block 1003, Block Group 1, Census Tract 5004, Santa Clara County, California",39,28,11
1000000US060855004001004,060855004001004,"Block 1004, Block Group 1, Census Tract 5004, Santa Clara County, California",1,1,0
1000000US060855004001005,060855004001005,"Block 1005, Block Group 1, Census Tract 5004, Santa Clara County, California",8,6,2
1000000US060855004001006,060855004001006,"Block 1006, Block Group 1, Census Tract 5004, Santa Clara County, California",27,25,2
1000000US060855004001007,060855004001007,"Block 1007, Block Group 1, Census Tract 5004, Santa Clara County, California",13,11,2
1000000US060855004001008,060855004001008,"Block 1008, Block Group 1, Census Tract 5004, Santa Clara County, California",13,12,1
1000000US060855004001009,060855004001009,"Block 1009, Block Group 1, Census Tract 5004, Santa Clara County, California",12,11,1
1000000US060855004001010,060855004001010,"Block 1010, Block Group 1, Census Tract 5004, Santa Clara County, California",55,52,3
1000000US060855004001011,060855004001011,"Block 1011, Block Group 1, Census Tract 5004, Santa Clara County, California",31,29,2
1000000US060855004001012,060855004001012,"Block 1012, Block Group 1, Census Tract 5004, Santa Clara County, California",18,18,0
1000000US060855004001013,060855004001013,"Block 1013, Block Group 1, Census Tract 5004, Santa Clara County, California",17,15,2
1000000US060855004001014,060855004001014,"Block 1014, Block Group 1, Census Tract 5004, Santa Clara County, California",35,34,1
1000000US060855004001015,060855004001015,"Block 1015, Block Group 1, Census Tract 5004, Santa Clara County, California",34,30,4
1000000US060855004001016,060855004001016,"Block 1016, Block Group 1, Census Tract 5004, Santa Clara County, California",8,8,0
1000000US060855004001017,060855004001017,"Block 1017, Block Group 1, Census Tract 5004, Santa Clara County, California",13,13,0
1000000US060855004002000,060855004002000,"Block 2000, Block Group 2, Census Tract 5004, Santa Clara County, California",7,5,2
1000000US060855004002001,060855004002001,"Block 2001, Block Group 2, Census Tract 5004, Santa Clara County, California",16,15,1
1000000US060855004002002,060855004002002,"Block 2002, Block Group 2, Census Tract 5004, Santa Clara County, California",48,47,1
1000000US060855004002003,060855004002003,"Block 2003, Block Group 2, Census Tract 5004, Santa Clara County, California",24,24,0
1000000US060855004002004,060855004002004,"Block 2004, Block Group 2, Census Tract 5004, Santa Clara County, California",76,73,3
1000000US060855004002005,060855004002005,"Block 2005, Block Group 2, Census Tract 5004, Santa Clara County, California",47,44,3
1000000US060855004002006,060855004002006,"Block 2006, Block Group 2, Census Tract 5004, Santa Clara County, California",38,36,2
1000000US060855004002007,060855004002007,"Block 2007, Block Group 2, Census Tract 5004, Santa Clara County, California",26,26,0
1000000US060855004002008,060855004002008,"Block 2008, Block Group 2, Census Tract 5004, Santa Clara County, California",25,25,0
1000000US060855004002009,060855004002009,"Block 2009, Block Group 2, Census Tract 5004, Santa Clara County, California",4,4,0
1000000US060855004002010,060855004002010,"Block 2010, Block Group 2, Census Tract 5004, Santa Clara County, California",7,7,0
1000000US060855004002011,060855004002011,"Block 2011, Block Group 2, Census Tract 5004, Santa Clara County, California",26,26,0
1000000US060855004002012,060855004002012,"Block 2012, Block Group 2, Census Tract 5004, Santa Clara County, California",19,17,2
1000000US060855004002013,060855004002013,"Block 2013, Block Group 2, Census Tract 5004, Santa Clara County, California",6,6,0
1000000US060855004002014,060855004002014,"Block 2014, Block Group 2, Census Tract 5004, Santa Clara County, California",36,36,0
1000000US060855004002015,060855004002015,"Block 2015, Block Group 2, Census Tract 5004, Santa Clara County, California",21,20,1
1000000US060855004002016,060855004002016,"Block 2016, Block Group 2, Census Tract 5004, Santa Clara County, California",13,11,2
1000000US060855005001000,060855005001000,"Block 1000, Block Group 1, Census Tract 5005, Santa Clara County, California",0,0,0
1000000US060855005001001,060855005001001,"Block 1001, Block Group 1, Census Tract 5005, Santa Clara County, California",44,42,2
1000000US060855005001002,060855005001002,"Block 1002, Block Group 1, Census Tract 5005, Santa Clara County, California",19,19,0
1000000US060855005001003,060855005001003,"Block 1003, Block Group 1, Census Tract 5005, Santa Clara County, California",56,55,1
1000000US060855005001004,060855005001004,"Block 1004, Block Group 1, Census Tract 5005, Santa Clara County, California",40,37,3
1000000US060855005001005,060855005001005,"Block 1005, Block Group 1, Census Tract 5005, Santa Clara County, California",40,39,1
1000000US060855005001006,060855005001006,"Block 1006, Block Group 1, Census Tract 5005, Santa Clara County, California",42,39,3
1000000US060855005001007,060855005001007,"Block 1007, Block Group 1, Census Tract 5005, Santa Clara County, California",42,42,0
1000000US060855005001008,060855005001008,"Block 1008, Block Group 1, Census Tract 5005, Santa Clara County, California",78,75,3
1000000US060855005001009,060855005001009,"Block 1009, Block Group 1, Census Tract 5005, Santa Clara County, California",16,16,0
1000000US060855005001010,060855005001010,"Block 1010, Block Group 1, Census Tract 5005, Santa Clara County, California",4,4,0
1000000US060855005001011,060855005001011,"Block 1011, Block Group 1, Census Tract 5005, Santa Clara County, California",37,37,0
1000000US060855005001012,060855005001012,"Block 1012, Block Group 1, Census Tract 5005, Santa Clara County, California",27,27,0
1000000US060855005002000,060855005002000,"Block 2000, Block Group 2, Census Tract 5005, Santa Clara County, California",45,42,3
1000000US060855005002001,060855005002001,"Block 2001, Block Group 2, Census Tract 5005, Santa Clara County, California",48,47,1
1000000US060855005002002,060855005002002,"Block 2002, Block Group 2, Census Tract 5005, Santa Clara County, California",81,76,5
1000000US060855005002003,060855005002003,"Block 2003, Block Group 2, Census Tract 5005, Santa Clara County, California",78,75,3
1000000US060855005002004,060855005002004,"Block 2004, Block Group 2, Census Tract 5005, Santa Clara County, California",145,130,15
1000000US060855005002005,060855005002005,"Block 2005, Block Group 2, Census Tract 5005, Santa Clara County, California",23,20,3
1000000US060855005002006,060855005002006,"Block 2006, Block Group 2, Census Tract 5005, Santa Clara County, California",60,59,1
1000000US060855005002007,060855005002007,"Block 2007, Block Group 2, Census Tract 5005, Santa Clara County, California",23,20,3
1000000US060855005002008,060855005002008,"Block 2008, Block Group 2, Census Tract 5005, Santa Clara County, California",3,3,0
1000000US060855005002009,060855005002009,"Block 2009, Block Group 2, Census Tract 5005, Santa Clara County, California",20,19,1
1000000US060855005002010,060855005002010,"Block 2010, Block Group 2, Census Tract 5005, Santa Clara County, California",34,32,2
1000000US060855005002011,060855005002011,"Block 2011, Block Group 2, Census Tract 5005, Santa Clara County, California",60,58,2
1000000US060855005002012,060855005002012,"Block 2012, Block Group 2, Census Tract 5005, Santa Clara County, California",0,0,0
1000000US060855005002013,060855005002013,"Block 2013, Block Group 2, Census Tract 5005, Santa Clara County, California",0,0,0
1000000US060855005002014,060855005002014,"Block 2014, Block Group 2, Census Tract 5005, Santa Clara County, California",0,0,0
1000000US060855005003000,060855005003000,"Block 3000, Block Group 3, Census Tract 5005, Santa Clara County, California",0,0,0
1000000US060855005003001,060855005003001,"Block 3001, Block Group 3, Census Tract 5005, Santa Clara County, California",38,36,2
1000000US060855005003002,060855005003002,"Block 3002, Block Group 3, Census Tract 5005, Santa Clara County, California",39,38,1
1000000US060855005003003,060855005003003,"Block 3003, Block Group 3, Census Tract 5005, Santa Clara County, California",30,29,1
1000000US060855005003004,060855005003004,"Block 3004, Block Group 3, Census Tract 5005, Santa Clara County, California",26,25,1
1000000US060855005003005,060855005003005,"Block 3005, Block Group 3, Census Tract 5005, Santa Clara County, California",11,10,1
1000000US060855005003006,060855005003006,"Block 3006, Block Group 3, Census Tract 5005, Santa Clara County, California",31,30,1
1000000US060855005003007,060855005003007,"Block 3007, Block Group 3, Census Tract 5005, Santa Clara County, California",20,19,1
1000000US060855005003008,060855005003008,"Block 3008, Block Group 3, Census Tract 5005, Santa Clara County, California",16,16,0
1000000US060855005003009,060855005003009,"Block 3009, Block Group 3, Census Tract 5005, Santa Clara County, California",57,56,1
1000000US060855005003010,060855005003010,"Block 3010, Block Group 3, Census Tract 5005, Santa Clara County, California",17,17,0
1000000US060855005003011,060855005003011,"Block 3011, Block Group 3, Census Tract 5005, Santa Clara County, California",10,10,0
1000000US060855005004000,060855005004000,"Block 4000, Block Group 4, Census Tract 5005, Santa Clara County, California",18,18,0
1000000US060855005004001,060855005004001,"Block 4001, Block Group 4, Census Tract 5005, Santa Clara County, California",101,91,10
1000000US060855005004002,060855005004002,"Block 4002, Block Group 4, Census Tract 5005, Santa Clara County, California",19,18,1
1000000US060855005004003,060855005004003,"Block 4003, Block Group 4, Census Tract 5005, Santa Clara County, California",18,18,0
1000000US060855005004004,060855005004004,"Block 4004, Block Group 4, Census Tract 5005, Santa Clara County, California",20,18,2
1000000US060855005004005,060855005004005,"Block 4005, Block Group 4, Census Tract 5005, Santa Clara County, California",22,21,1
1000000US060855005004006,060855005004006,"Block 4006, Block Group 4, Census Tract 5005, Santa Clara County, California",17,15,2
1000000US060855005004007,060855005004007,"Block 4007, Block Group 4, Census Tract 5005, Santa Clara County, California",19,19,0
1000000US060855005004008,060855005004008,"Block 4008, Block Group 4, Census Tract 5005, Santa Clara County, California",0,0,0
1000000US060855005004009,060855005004009,"Block 4009, Block Group 4, Census Tract 5005, Santa Clara County, California",6,6,0
1000000US060855005004010,060855005004010,"Block 4010, Block Group 4, Census Tract 5005, Santa Clara County, California",29,28,1
1000000US060855005004011,060855005004011,"Block 4011, Block Group 4, Census Tract 5005, Santa Clara County, California",34,32,2
1000000US060855005004012,060855005004012,"Block 4012, Block Group 4, Census Tract 5005, Santa Clara County, California",41,39,2
1000000US060855005004013,060855005004013,"Block 4013, Block Group 4, Census Tract 5005, Santa Clara County, California",0,0,0
1000000US060855005004014,060855005004014,"Block 4014, Block Group 4, Census Tract 5005, Santa Clara County, California",44,44,0
1000000US060855005004015,060855005004015,"Block 4015, Block Group 4, Census Tract 5005, Santa Clara County, California",0,0,0
1000000US060855005005000,060855005005000,"Block 5000, Block Group 5, Census Tract 5005, Santa Clara County, California",32,31,1
1000000US060855005005001,060855005005001,"Block 5001, Block Group 5, Census Tract 5005, Santa Clara County, California",0,0,0
1000000US060855005005002,060855005005002,"Block 5002, Block Group 5, Census Tract 5005, Santa Clara County, California",33,32,1
1000000US060855005005003,060855005005003,"Block 5003, Block Group 5, Census Tract 5005, Santa Clara County, California",19,19,0
1000000US060855005005004,060855005005004,"Block 5004, Block Group 5, Census Tract 5005, Santa Clara County, California",31,31,0
1000000US060855005005005,060855005005005,"Block 5005, Block Group 5, Census Tract 5005, Santa Clara County, California",22,22,0
1000000US060855005005006,060855005005006,"Block 5006, Block Group 5, Census Tract 5005, Santa Clara County, California",16,15,1
1000000US060855005005007,060855005005007,"Block 5007, Block Group 5, Census Tract 5005, Santa Clara County, California",9,9,0
1000000US060855005005008,060855005005008,"Block 5008, Block Group 5, Census Tract 5005, Santa Clara County, California",22,21,1
1000000US060855005005009,060855005005009,"Block 5009, Block Group 5, Census Tract 5005, Santa Clara County, California",13,11,2
1000000US060855005005010,060855005005010,"Block 5010, Block Group 5, Census Tract 5005, Santa Clara County, California",22,20,2
1000000US060855005005011,060855005005011,"Block 5011, Block Group 5, Census Tract 5005, Santa Clara County, California",4,4,0
1000000US060855005005012,060855005005012,"Block 5012, Block Group 5, Census Tract 5005, Santa Clara County, California",0,0,0
1000000US060855005005013,060855005005013,"Block 5013, Block Group 5, Census Tract 5005, Santa Clara County, California",25,25,0
1000000US060855005005014,060855005005014,"Block 5014, Block Group 5, Census Tract 5005, Santa Clara County, California",0,0,0
1000000US060855005005015,060855005005015,"Block 5015, Block Group 5, Census Tract 5005, Santa Clara County, California",23,21,2
1000000US060855005005016,060855005005016,"Block 5016, Block Group 5, Census Tract 5005, Santa Clara County, California",60,52,8
1000000US060855005005017,060855005005017,"Block 5017, Block Group 5, Census Tract 5005, Santa Clara County, California",0,0,0
1000000US060855006001000,060855006001000,"Block 1000, Block Group 1, Census Tract 5006, Santa Clara County, California",52,50,2
1000000US060855006001001,060855006001001,"Block 1001, Block Group 1, Census Tract 5006, Santa Clara County, California",232,222,10
1000000US060855006001002,060855006001002,"Block 1002, Block Group 1, Census Tract 5006, Santa Clara County, California",40,39,1
1000000US060855006001003,060855006001003,"Block 1003, Block Group 1, Census Tract 5006, Santa Clara County, California",36,35,1
1000000US060855006001004,060855006001004,"Block 1004, Block Group 1, Census Tract 5006, Santa Clara County, California",35,35,0
1000000US060855006001005,060855006001005,"Block 1005, Block Group 1, Census Tract 5006, Santa Clara County, California",28,28,0
1000000US060855006001006,060855006001006,"Block 1006, Block Group 1, Census Tract 5006, Santa Clara County, California",132,106,26
1000000US060855006001007,060855006001007,"Block 1007, Block Group 1, Census Tract 5006, Santa Clara County, California",671,623,48
1000000US060855006001008,060855006001008,"Block 1008, Block Group 1, Census Tract 5006, Santa Clara County, California",4,4,0
1000000US060855006001009,060855006001009,"Block 1009, Block Group 1, Census Tract 5006, Santa Clara County, California",12,11,1
1000000US060855006001010,060855006001010,"Block 1010, Block Group 1, Census Tract 5006, Santa Clara County, California",10,10,0
1000000US060855006001011,060855006001011,"Block 1011, Block Group 1, Census Tract 5006, Santa Clara County, California",63,58,5
1000000US060855006001012,060855006001012,"Block 1012, Block Group 1, Census Tract 5006, Santa Clara County, California",5,5,0
1000000US060855006001013,060855006001013,"Block 1013, Block Group 1, Census Tract 5006, Santa Clara County, California",76,59,17
1000000US060855006001014,060855006001014,"Block 1014, Block Group 1, Census Tract 5006, Santa Clara County, California",23,23,0
1000000US060855006001015,060855006001015,"Block 1015, Block Group 1, Census Tract 5006, Santa Clara County, California",0,0,0
1000000US060855006002000,060855006002000,"Block 2000, Block Group 2, Census Tract 5006, Santa Clara County, California",50,45,5
1000000US060855006002001,060855006002001,"Block 2001, Block Group 2, Census Tract 5006, Santa Clara County, California",15,15,0
1000000US060855006002002,060855006002002,"Block 2002, Block Group 2, Census Tract 5006, Santa Clara County, California",26,24,2
1000000US060855006002003,060855006002003,"Block 2003, Block Group 2, Census Tract 5006, Santa Clara County, California",27,27,0
1000000US060855006002004,060855006002004,"Block 2004, Block Group 2, Census Tract 5006, Santa Clara County, California",22,18,4
1000000US060855006002005,060855006002005,"Block 2005, Block Group 2, Census Tract 5006, Santa Clara County, California",19,18,1
1000000US060855006002006,060855006002006,"Block 2006, Block Group 2, Census Tract 5006, Santa Clara County, California",13,13,0
1000000US060855006002007,060855006002007,"Block 2007, Block Group 2, Census Tract 5006, Santa Clara County, California",18,17,1
1000000US060855006002008,060855006002008,"Block 2008, Block Group 2, Census Tract 5006, Santa Clara County, California",31,30,1
1000000US060855006002009,060855006002009,"Block 2009, Block Group 2, Census Tract 5006, Santa Clara County, California",27,27,0
1000000US060855006002010,060855006002010,"Block 2010, Block Group 2, Census Tract 5006, Santa Clara County, California",22,21,1
1000000US060855006002011,060855006002011,"Block 2011, Block Group 2, Census Tract 5006, Santa Clara County, California",21,21,0
1000000US060855006002012,060855006002012,"Block 2012, Block Group 2, Census Tract 5006, Santa Clara County, California",26,25,1
1000000US060855006002013,060855006002013,"Block 2013, Block Group 2, Census Tract 5006, Santa Clara County, California",27,27,0
1000000US060855006002014,060855006002014,"Block 2014, Block Group 2, Census Tract 5006, Santa Clara County, California",22,20,2
1000000US060855006002015,060855006002015,"Block 2015, Block Group 2, Census Tract 5006, Santa Clara County, California",18,18,0
1000000US060855006002016,060855006002016,"Block 2016, Block Group 2, Census Tract 5006, Santa Clara County, California",17,17,0
1000000US060855006003000,060855006003000,"Block 3000, Block Group 3, Census Tract 5006, Santa Clara County, California",50,50,0
1000000US060855006003001,060855006003001,"Block 3001, Block Group 3, Census Tract 5006, Santa Clara County, California",15,14,1
1000000US060855006003002,060855006003002,"Block 3002, Block Group 3, Census Tract 5006, Santa Clara County, California",12,12,0
1000000US060855006003003,060855006003003,"Block 3003, Block Group 3, Census Tract 5006, Santa Clara County, California",37,35,2
1000000US060855006003004,060855006003004,"Block 3004, Block Group 3, Census Tract 5006, Santa Clara County, California",36,34,2
1000000US060855006003005,060855006003005,"Block 3005, Block Group 3, Census Tract 5006, Santa Clara County, California",2,2,0
1000000US060855006003006,060855006003006,"Block 3006, Block Group 3, Census Tract 5006, Santa Clara County, California",52,48,4
1000000US060855006003007,060855006003007,"Block 3007, Block Group 3, Census Tract 5006, Santa Clara County, California",21,19,2
1000000US060855006003008,060855006003008,"Block 3008, Block Group 3, Census Tract 5006, Santa Clara County, California",28,24,4
1000000US060855006003009,060855006003009,"Block 3009, Block Group 3, Census Tract 5006, Santa Clara County, California",68,66,2
1000000US060855006003010,060855006003010,"Block 3010, Block Group 3, Census Tract 5006, Santa Clara County, California",85,78,7
1000000US060855008001000,060855008001000,"Block 1000, Block Group 1, Census Tract 5008, Santa Clara County, California",101,91,10
1000000US060855008001001,060855008001001,"Block 1001, Block Group 1, Census Tract 5008, Santa Clara County, California",0,0,0
1000000US060855008001002,060855008001002,"Block 1002, Block Group 1, Census Tract 5008, Santa Clara County, California",0,0,0
1000000US060855008001003,060855008001003,"Block 1003, Block Group 1, Census Tract 5008, Santa Clara County, California",0,0,0
1000000US060855008001004,060855008001004,"Block 1004, Block Group 1, Census Tract 5008, Santa Clara County, California",124,92,32
1000000US060855008001005,060855008001005,"Block 1005, Block Group 1, Census Tract 5008, Santa Clara County, California",0,0,0
1000000US060855008001006,060855008001006,"Block 1006, Block Group 1, Census Tract 5008, Santa Clara County, California",0,0,0
1000000US060855008001007,060855008001007,"Block 1007, Block Group 1, Census Tract 5008, Santa Clara County, California",0,0,0
1000000US060855008001008,060855008001008,"Block 1008, Block Group 1, Census Tract 5008, Santa Clara County, California",0,0,0
1000000US060855008001009,060855008001009,"Block 1009, Block Group 1, Census Tract 5008, Santa Clara County, California",0,0,0
1000000US060855008001010,060855008001010,"Block 1010, Block Group 1, Census Tract 5008, Santa Clara County, California",0,0,0
1000000US060855008001011,060855008001011,"Block 1011, Block Group 1, Census Tract 5008, Santa Clara County, California",1,1,0
1000000US060855008001012,060855008001012,"Block 1012, Block Group 1, Census Tract 5008, Santa Clara County, California",0,0,0
1000000US060855008001013,060855008001013,"Block 1013, Block Group 1, Census Tract 5008, Santa Clara County, California",47,33,14
1000000US060855008001014,060855008001014,"Block 1014, Block Group 1, Census Tract 5008, Santa Clara County, California",0,0,0
1000000US060855008001015,060855008001015,"Block 1015, Block Group 1, Census Tract 5008, Santa Clara County, California",0,0,0
1000000US060855008001016,060855008001016,"Block 1016, Block Group 1, Census Tract 5008, Santa Clara County, California",0,0,0
1000000US060855008001017,060855008001017,"Block 1017, Block Group 1, Census Tract 5008, Santa Clara County, California",0,0,0
1000000US060855008001018,060855008001018,"Block 1018, Block Group 1, Census Tract 5008, Santa Clara County, California",4,4,0
1000000US060855008001019,060855008001019,"Block 1019, Block Group 1, Census Tract 5008, Santa Clara County, California",0,0,0
1000000US060855008001020,060855008001020,"Block 1020, Block Group 1, Census Tract 5008, Santa Clara County, California",0,0,0
1000000US060855008001021,060855008001021,"Block 1021, Block Group 1, Census Tract 5008, Santa Clara County, California",0,0,0
1000000US060855008001022,060855008001022,"Block 1022, Block Group 1, Census Tract 5008, Santa Clara County, California",1,1,0
1000000US060855008001023,060855008001023,"Block 1023, Block Group 1, Census Tract 5008, Santa Clara County, California",0,0,0
1000000US060855008001024,060855008001024,"Block 1024, Block Group 1, Census Tract 5008, Santa Clara County, California",0,0,0
1000000US060855008001025,060855008001025,"Block 1025, Block Group 1, Census Tract 5008, Santa Clara County, California",0,0,0
1000000US060855008001026,060855008001026,"Block 1026, Block Group 1, Census Tract 5008, Santa Clara County, California",0,0,0
1000000US060855008001027,060855008001027,"Block 1027, Block Group 1, Census Tract 5008, Santa Clara County, California",0,0,0
1000000US060855008001028,060855008001028,"Block 1028, Block Group 1, Census Tract 5008, Santa Clara County, California",0,0,0
1000000US060855008001029,060855008001029,"Block 1029, Block Group 1, Census Tract 5008, Santa Clara County, California",0,0,0
1000000US060855008001030,060855008001030,"Block 1030, Block Group 1, Census Tract 5008, Santa Clara County, California",0,0,0
1000000US060855008001031,060855008001031,"Block 1031, Block Group 1, Census Tract 5008, Santa Clara County, California",330,86,244
1000000US060855008001032,060855008001032,"Block 1032, Block Group 1, Census Tract 5008, Santa Clara County, California",0,0,0
1000000US060855008001033,060855008001033,"Block 1033, Block Group 1, Census Tract 5008, Santa Clara County, California",2,1,1
1000000US060855008001034,060855008001034,"Block 1034, Block Group 1, Census Tract 5008, Santa Clara County, California",0,0,0
1000000US060855008001035,060855008001035,"Block 1035, Block Group 1, Census Tract 5008, Santa Clara County, California",0,0,0
1000000US060855008001036,060855008001036,"Block 1036, Block Group 1, Census Tract 5008, Santa Clara County, California",0,0,0
1000000US060855008001037,060855008001037,"Block 1037, Block Group 1, Census Tract 5008, Santa Clara County, California",0,0,0
1000000US060855008001038,060855008001038,"Block 1038, Block Group 1, Census Tract 5008, Santa Clara County, California",0,0,0
1000000US060855008001039,060855008001039,"Block 1039, Block Group 1, Census Tract 5008, Santa Clara County, California",165,164,1
1000000US060855008001040,060855008001040,"Block 1040, Block Group 1, Census Tract 5008, Santa Clara County, California",267,40,227
1000000US060855008001041,060855008001041,"Block 1041, Block Group 1, Census Tract 5008, Santa Clara County, California",0,0,0
1000000US060855008001042,060855008001042,"Block 1042, Block Group 1, Census Tract 5008, Santa Clara County, California",0,0,0
1000000US060855008001043,060855008001043,"Block 1043, Block Group 1, Census Tract 5008, Santa Clara County, California",0,0,0
1000000US060855008001044,060855008001044,"Block 1044, Block Group 1, Census Tract 5008, Santa Clara County, California",0,0,0
1000000US060855008001045,060855008001045,"Block 1045, Block Group 1, Census Tract 5008, Santa Clara County, California",0,0,0
1000000US060855008001046,060855008001046,"Block 1046, Block Group 1, Census Tract 5008, Santa Clara County, California",0,0,0
1000000US060855008001047,060855008001047,"Block 1047, Block Group 1, Census Tract 5008, Santa Clara County, California",0,0,0
1000000US060855008001048,060855008001048,"Block 1048, Block Group 1, Census Tract 5008, Santa Clara County, California",0,0,0
1000000US060855008001049,060855008001049,"Block 1049, Block Group 1, Census Tract 5008, Santa Clara County, California",0,0,0
1000000US060855008001050,060855008001050,"Block 1050, Block Group 1, Census Tract 5008, Santa Clara County, California",0,0,0
1000000US060855008001051,060855008001051,"Block 1051, Block Group 1, Census Tract 5008, Santa Clara County, California",0,0,0
1000000US060855008002000,060855008002000,"Block 2000, Block Group 2, Census Tract 5008, Santa Clara County, California",0,0,0
1000000US060855008002001,060855008002001,"Block 2001, Block Group 2, Census Tract 5008, Santa Clara County, California",3,3,0
1000000US060855008002002,060855008002002,"Block 2002, Block Group 2, Census Tract 5008, Santa Clara County, California",0,0,0
1000000US060855008002003,060855008002003,"Block 2003, Block Group 2, Census Tract 5008, Santa Clara County, California",2,2,0
1000000US060855008002004,060855008002004,"Block 2004, Block Group 2, Census Tract 5008, Santa Clara County, California",0,0,0
1000000US060855008002005,060855008002005,"Block 2005, Block Group 2, Census Tract 5008, Santa Clara County, California",0,0,0
1000000US060855008002006,060855008002006,"Block 2006, Block Group 2, Census Tract 5008, Santa Clara County, California",0,0,0
1000000US060855008002007,060855008002007,"Block 2007, Block Group 2, Census Tract 5008, Santa Clara County, California",0,0,0
1000000US060855008002008,060855008002008,"Block 2008, Block Group 2, Census Tract 5008, Santa Clara County, California",50,47,3
1000000US060855008002009,060855008002009,"Block 2009, Block Group 2, Census Tract 5008, Santa Clara County, California",6,6,0
1000000US060855008002010,060855008002010,"Block 2010, Block Group 2, Census Tract 5008, Santa Clara County, California",40,36,4
1000000US060855008002011,060855008002011,"Block 2011, Block Group 2, Census Tract 5008, Santa Clara County, California",12,9,3
1000000US060855008002012,060855008002012,"Block 2012, Block Group 2, Census Tract 5008, Santa Clara County, California",116,110,6
1000000US060855008002013,060855008002013,"Block 2013, Block Group 2, Census Tract 5008, Santa Clara County, California",2,2,0
1000000US060855008002014,060855008002014,"Block 2014, Block Group 2, Census Tract 5008, Santa Clara County, California",0,0,0
1000000US060855008002015,060855008002015,"Block 2015, Block Group 2, Census Tract 5008, Santa Clara County, California",0,0,0
1000000US060855008002016,060855008002016,"Block 2016, Block Group 2, Census Tract 5008, Santa Clara County, California",50,46,4
1000000US060855008002017,060855008002017,"Block 2017, Block Group 2, Census Tract 5008, Santa Clara County, California",4,2,2
1000000US060855008002018,060855008002018,"Block 2018, Block Group 2, Census Tract 5008, Santa Clara County, California",129,120,9
1000000US060855008002019,060855008002019,"Block 2019, Block Group 2, Census Tract 5008, Santa Clara County, California",4,4,0
1000000US060855008002020,060855008002020,"Block 2020, Block Group 2, Census Tract 5008, Santa Clara County, California",12,11,1
1000000US060855008002021,060855008002021,"Block 2021, Block Group 2, Census Tract 5008, Santa Clara County, California",21,18,3
1000000US060855008002022,060855008002022,"Block 2022, Block Group 2, Census Tract 5008, Santa Clara County, California",1,0,1
1000000US060855008002023,060855008002023,"Block 2023, Block Group 2, Census Tract 5008, Santa Clara County, California",65,61,4
1000000US060855008002024,060855008002024,"Block 2024, Block Group 2, Census Tract 5008, Santa Clara County, California",131,131,0
1000000US060855008002025,060855008002025,"Block 2025, Block Group 2, Census Tract 5008, Santa Clara County, California",129,126,3
1000000US060855008002026,060855008002026,"Block 2026, Block Group 2, Census Tract 5008, Santa Clara County, California",3,3,0
1000000US060855008002027,060855008002027,"Block 2027, Block Group 2, Census Tract 5008, Santa Clara County, California",0,0,0
1000000US060855008002028,060855008002028,"Block 2028, Block Group 2, Census Tract 5008, Santa Clara County, California",1,1,0
1000000US060855008002029,060855008002029,"Block 2029, Block Group 2, Census Tract 5008, Santa Clara County, California",3,3,0
1000000US060855008002030,060855008002030,"Block 2030, Block Group 2, Census Tract 5008, Santa Clara County, California",30,28,2
1000000US060855008002031,060855008002031,"Block 2031, Block Group 2, Census Tract 5008, Santa Clara County, California",25,23,2
1000000US060855009011000,060855009011000,"Block 1000, Block Group 1, Census Tract 5009.01, Santa Clara County, California",20,20,0
1000000US060855009011001,060855009011001,"Block 1001, Block Group 1, Census Tract 5009.01, Santa Clara County, California",130,125,5
1000000US060855009011002,060855009011002,"Block 1002, Block Group 1, Census Tract 5009.01, Santa Clara County, California",0,0,0
1000000US060855009011003,060855009011003,"Block 1003, Block Group 1, Census Tract 5009.01, Santa Clara County, California",0,0,0
1000000US060855009011004,060855009011004,"Block 1004, Block Group 1, Census Tract 5009.01, Santa Clara County, California",0,0,0
1000000US060855009011005,060855009011005,"Block 1005, Block Group 1, Census Tract 5009.01, Santa Clara County, California",90,69,21
1000000US060855009011006,060855009011006,"Block 1006, Block Group 1, Census Tract 5009.01, Santa Clara County, California",80,72,8
1000000US060855009011007,060855009011007,"Block 1007, Block Group 1, Census Tract 5009.01, Santa Clara County, California",205,194,11
1000000US060855009012000,060855009012000,"Block 2000, Block Group 2, Census Tract 5009.01, Santa Clara County, California",346,314,32
1000000US060855009012001,060855009012001,"Block 2001, Block Group 2, Census Tract 5009.01, Santa Clara County, California",186,161,25
1000000US060855009012002,060855009012002,"Block 2002, Block Group 2, Census Tract 5009.01, Santa Clara County, California",1,1,0
1000000US060855009012003,060855009012003,"Block 2003, Block Group 2, Census Tract 5009.01, Santa Clara County, California",0,0,0
1000000US060855009012004,060855009012004,"Block 2004, Block Group 2, Census Tract 5009.01, Santa Clara County, California",0,0,0
1000000US060855009012005,060855009012005,"Block 2005, Block Group 2, Census Tract 5009.01, Santa Clara County, California",197,54,143
1000000US060855009012006,060855009012006,"Block 2006, Block Group 2, Census Tract 5009.01, Santa Clara County, California",318,302,16
1000000US060855009012007,060855009012007,"Block 2007, Block Group 2, Census Tract 5009.01, Santa Clara County, California",221,201,20
1000000US060855009012008,060855009012008,"Block 2008, Block Group 2, Census Tract 5009.01, Santa Clara County, California",0,0,0
1000000US060855009012009,060855009012009,"Block 2009, Block Group 2, Census Tract 5009.01, Santa Clara County, California",36,30,6
1000000US060855009012010,060855009012010,"Block 2010, Block Group 2, Census Tract 5009.01, Santa Clara County, California",0,0,0
1000000US060855009012011,060855009012011,"Block 2011, Block Group 2, Census Tract 5009.01, Santa Clara County, California",69,69,0
1000000US060855009012012,060855009012012,"Block 2012, Block Group 2, Census Tract 5009.01, Santa Clara County, California",56,46,10
1000000US060855009012013,060855009012013,"Block 2013, Block Group 2, Census Tract 5009.01, Santa Clara County, California",182,173,9
1000000US060855009012014,060855009012014,"Block 2014, Block Group 2, Census Tract 5009.01, Santa Clara County, California",80,71,9
1000000US060855009012015,060855009012015,"Block 2015, Block Group 2, Census Tract 5009.01, Santa Clara County, California",9,9,0
1000000US060855009012016,060855009012016,"Block 2016, Block Group 2, Census Tract 5009.01, Santa Clara County, California",0,0,0
1000000US060855009021000,060855009021000,"Block 1000, Block Group 1, Census Tract 5009.02, Santa Clara County, California",0,0,0
1000000US060855009021001,060855009021001,"Block 1001, Block Group 1, Census Tract 5009.02, Santa Clara County, California",143,132,11
1000000US060855009021002,060855009021002,"Block 1002, Block Group 1, Census Tract 5009.02, Santa Clara County, California",109,96,13
1000000US060855009021003,060855009021003,"Block 1003, Block Group 1, Census Tract 5009.02, Santa Clara County, California",134,121,13
1000000US060855009022000,060855009022000,"Block 2000, Block Group 2, Census Tract 5009.02, Santa Clara County, California",6,6,0
1000000US060855009022001,060855009022001,"Block 2001, Block Group 2, Census Tract 5009.02, Santa Clara County, California",0,0,0
1000000US060855009022002,060855009022002,"Block 2002, Block Group 2, Census Tract 5009.02, Santa Clara County, California",0,0,0
1000000US060855009022003,060855009022003,"Block 2003, Block Group 2, Census Tract 5009.02, Santa Clara County, California",134,129,5
1000000US060855009022004,060855009022004,"Block 2004, Block Group 2, Census Tract 5009.02, Santa Clara County, California",107,101,6
1000000US060855009022005,060855009022005,"Block 2005, Block Group 2, Census Tract 5009.02, Santa Clara County, California",46,44,2
1000000US060855010001000,060855010001000,"Block 1000, Block Group 1, Census Tract 5010, Santa Clara County, California",46,44,2
1000000US060855010001001,060855010001001,"Block 1001, Block Group 1, Census Tract 5010, Santa Clara County, California",62,55,7
1000000US060855010001002,060855010001002,"Block 1002, Block Group 1, Census Tract 5010, Santa Clara County, California",80,70,10
1000000US060855010001003,060855010001003,"Block 1003, Block Group 1, Census Tract 5010, Santa Clara County, California",65,61,4
1000000US060855010001004,060855010001004,"Block 1004, Block Group 1, Census Tract 5010, Santa Clara County, California",50,48,2
1000000US060855010001005,060855010001005,"Block 1005, Block Group 1, Census Tract 5010, Santa Clara County, California",55,53,2
1000000US060855010001006,060855010001006,"Block 1006, Block Group 1, Census Tract 5010, Santa Clara County, California",70,69,1
1000000US060855010001007,060855010001007,"Block 1007, Block Group 1, Census Tract 5010, Santa Clara County, California",21,20,1
1000000US060855010001008,060855010001008,"Block 1008, Block Group 1, Census Tract 5010, Santa Clara County, California",15,15,0
1000000US060855010002000,060855010002000,"Block 2000, Block Group 2, Census Tract 5010, Santa Clara County, California",102,93,9
1000000US060855010002001,060855010002001,"Block 2001, Block Group 2, Census Tract 5010, Santa Clara County, California",104,99,5
1000000US060855010002002,060855010002002,"Block 2002, Block Group 2, Census Tract 5010, Santa Clara County, California",5,5,0
1000000US060855010002003,060855010002003,"Block 2003, Block Group 2, Census Tract 5010, Santa Clara County, California",105,95,10
1000000US060855010002004,060855010002004,"Block 2004, Block Group 2, Census Tract 5010, Santa Clara County, California",64,29,35
1000000US060855010002005,060855010002005,"Block 2005, Block Group 2, Census Tract 5010, Santa Clara County, California",0,0,0
1000000US060855010002006,060855010002006,"Block 2006, Block Group 2, Census Tract 5010, Santa Clara County, California",52,50,2
1000000US060855010003000,060855010003000,"Block 3000, Block Group 3, Census Tract 5010, Santa Clara County, California",116,87,29
1000000US060855010003001,060855010003001,"Block 3001, Block Group 3, Census Tract 5010, Santa Clara County, California",107,101,6
1000000US060855010003002,060855010003002,"Block 3002, Block Group 3, Census Tract 5010, Santa Clara County, California",56,56,0
1000000US060855010003003,060855010003003,"Block 3003, Block Group 3, Census Tract 5010, Santa Clara County, California",0,0,0
1000000US060855010003004,060855010003004,"Block 3004, Block Group 3, Census Tract 5010, Santa Clara County, California",0,0,0
1000000US060855010003005,060855010003005,"Block 3005, Block Group 3, Census Tract 5010, Santa Clara County, California",0,0,0
1000000US060855010003006,060855010003006,"Block 3006, Block Group 3, Census Tract 5010, Santa Clara County, California",0,0,0
1000000US060855010003007,060855010003007,"Block 3007, Block Group 3, Census Tract 5010, Santa Clara County, California",215,213,2
1000000US060855010003008,060855010003008,"Block 3008, Block Group 3, Census Tract 5010, Santa Clara County, California",8,8,0
1000000US060855010003009,060855010003009,"Block 3009, Block Group 3, Census Tract 5010, Santa Clara County, California",0,0,0
1000000US060855010004000,060855010004000,"Block 4000, Block Group 4, Census Tract 5010, Santa Clara County, California",62,57,5
1000000US060855010004001,060855010004001,"Block 4001, Block Group 4, Census Tract 5010, Santa Clara County, California",42,37,5
1000000US060855010004002,060855010004002,"Block 4002, Block Group 4, Census Tract 5010, Santa Clara County, California",168,158,10
1000000US060855010004003,060855010004003,"Block 4003, Block Group 4, Census Tract 5010, Santa Clara County, California",54,51,3
1000000US060855010004004,060855010004004,"Block 4004, Block Group 4, Census Tract 5010, Santa Clara County, California",92,82,10
1000000US060855010004005,060855010004005,"Block 4005, Block Group 4, Census Tract 5010, Santa Clara County, California",5,5,0
1000000US060855010005000,060855010005000,"Block 5000, Block Group 5, Census Tract 5010, Santa Clara County, California",50,45,5
1000000US060855010005001,060855010005001,"Block 5001, Block Group 5, Census Tract 5010, Santa Clara County, California",51,47,4
1000000US060855010005002,060855010005002,"Block 5002, Block Group 5, Census Tract 5010, Santa Clara County, California",80,70,10
1000000US060855010005003,060855010005003,"Block 5003, Block Group 5, Census Tract 5010, Santa Clara County, California",41,38,3
1000000US060855010005004,060855010005004,"Block 5004, Block Group 5, Census Tract 5010, Santa Clara County, California",23,19,4
1000000US060855010005005,060855010005005,"Block 5005, Block Group 5, Census Tract 5010, Santa Clara County, California",44,37,7
1000000US060855010005006,060855010005006,"Block 5006, Block Group 5, Census Tract 5010, Santa Clara County, California",22,21,1
1000000US060855010005007,060855010005007,"Block 5007, Block Group 5, Census Tract 5010, Santa Clara County, California",58,48,10
1000000US060855011011000,060855011011000,"Block 1000, Block Group 1, Census Tract 5011.01, Santa Clara County, California",0,0,0
1000000US060855011011001,060855011011001,"Block 1001, Block Group 1, Census Tract 5011.01, Santa Clara County, California",0,0,0
1000000US060855011011002,060855011011002,"Block 1002, Block Group 1, Census Tract 5011.01, Santa Clara County, California",158,151,7
1000000US060855011011003,060855011011003,"Block 1003, Block Group 1, Census Tract 5011.01, Santa Clara County, California",53,48,5
1000000US060855011011004,060855011011004,"Block 1004, Block Group 1, Census Tract 5011.01, Santa Clara County, California",56,55,1
1000000US060855011011005,060855011011005,"Block 1005, Block Group 1, Census Tract 5011.01, Santa Clara County, California",26,26,0
1000000US060855011011006,060855011011006,"Block 1006, Block Group 1, Census Tract 5011.01, Santa Clara County, California",109,109,0
1000000US060855011011007,060855011011007,"Block 1007, Block Group 1, Census Tract 5011.01, Santa Clara County, California",13,12,1
1000000US060855011011008,060855011011008,"Block 1008, Block Group 1, Census Tract 5011.01, Santa Clara County, California",34,31,3
1000000US060855011011009,060855011011009,"Block 1009, Block Group 1, Census Tract 5011.01, Santa Clara County, California",47,41,6
1000000US060855011011010,060855011011010,"Block 1010, Block Group 1, Census Tract 5011.01, Santa Clara County, California",45,32,13
1000000US060855011011011,060855011011011,"Block 1011, Block Group 1, Census Tract 5011.01, Santa Clara County, California",58,53,5
1000000US060855011011012,060855011011012,"Block 1012, Block Group 1, Census Tract 5011.01, Santa Clara County, California",172,162,10
1000000US060855011011013,060855011011013,"Block 1013, Block Group 1, Census Tract 5011.01, Santa Clara County, California",87,79,8
1000000US060855011011014,060855011011014,"Block 1014, Block Group 1, Census Tract 5011.01, Santa Clara County, California",39,35,4
1000000US060855011012000,060855011012000,"Block 2000, Block Group 2, Census Tract 5011.01, Santa Clara County, California",26,23,3
1000000US060855011012001,060855011012001,"Block 2001, Block Group 2, Census Tract 5011.01, Santa Clara County, California",217,211,6
1000000US060855011012002,060855011012002,"Block 2002, Block Group 2, Census Tract 5011.01, Santa Clara County, California",60,60,0
1000000US060855011012003,060855011012003,"Block 2003, Block Group 2, Census Tract 5011.01, Santa Clara County, California",26,25,1
1000000US060855011012004,060855011012004,"Block 2004, Block Group 2, Census Tract 5011.01, Santa Clara County, California",21,21,0
1000000US060855011012005,060855011012005,"Block 2005, Block Group 2, Census Tract 5011.01, Santa Clara County, California",43,42,1
1000000US060855011012006,060855011012006,"Block 2006, Block Group 2, Census Tract 5011.01, Santa Clara County, California",0,0,0
1000000US060855011012007,060855011012007,"Block 2007, Block Group 2, Census Tract 5011.01, Santa Clara County, California",140,133,7
1000000US060855011012008,060855011012008,"Block 2008, Block Group 2, Census Tract 5011.01, Santa Clara County, California",48,47,1
1000000US060855011012009,060855011012009,"Block 2009, Block Group 2, Census Tract 5011.01, Santa Clara County, California",70,63,7
1000000US060855011012010,060855011012010,"Block 2010, Block Group 2, Census Tract 5011.01, Santa Clara County, California",51,49,2
1000000US060855011012011,060855011012011,"Block 2011, Block Group 2, Census Tract 5011.01, Santa Clara County, California",142,134,8
1000000US060855011012012,060855011012012,"Block 2012, Block Group 2, Census Tract 5011.01, Santa Clara County, California",63,55,8
1000000US060855011012013,060855011012013,"Block 2013, Block Group 2, Census Tract 5011.01, Santa Clara County, California",20,15,5
1000000US060855011021000,060855011021000,"Block 1000, Block Group 1, Census Tract 5011.02, Santa Clara County, California",74,72,2
1000000US060855011021001,060855011021001,"Block 1001, Block Group 1, Census Tract 5011.02, Santa Clara County, California",33,32,1
1000000US060855011021002,060855011021002,"Block 1002, Block Group 1, Census Tract 5011.02, Santa Clara County, California",37,36,1
1000000US060855011021003,060855011021003,"Block 1003, Block Group 1, Census Tract 5011.02, Santa Clara County, California",41,39,2
1000000US060855011021004,060855011021004,"Block 1004, Block Group 1, Census Tract 5011.02, Santa Clara County, California",34,34,0
1000000US060855011021005,060855011021005,"Block 1005, Block Group 1, Census Tract 5011.02, Santa Clara County, California",33,31,2
1000000US060855011021006,060855011021006,"Block 1006, Block Group 1, Census Tract 5011.02, Santa Clara County, California",46,41,5
1000000US060855011021007,060855011021007,"Block 1007, Block Group 1, Census Tract 5011.02, Santa Clara County, California",43,40,3
1000000US060855011021008,060855011021008,"Block 1008, Block Group 1, Census Tract 5011.02, Santa Clara County, California",36,36,0
1000000US060855011021009,060855011021009,"Block 1009, Block Group 1, Census Tract 5011.02, Santa Clara County, California",33,30,3
1000000US060855011021010,060855011021010,"Block 1010, Block Group 1, Census Tract 5011.02, Santa Clara County, California",33,33,0
1000000US060855011022000,060855011022000,"Block 2000, Block Group 2, Census Tract 5011.02, Santa Clara County, California",44,40,4
1000000US060855011022001,060855011022001,"Block 2001, Block Group 2, Census Tract 5011.02, Santa Clara County, California",44,43,1
1000000US060855011022002,060855011022002,"Block 2002, Block Group 2, Census Tract 5011.02, Santa Clara County, California",54,49,5
1000000US060855011022003,060855011022003,"Block 2003, Block Group 2, Census Tract 5011.02, Santa Clara County, California",45,44,1
1000000US060855011022004,060855011022004,"Block 2004, Block Group 2, Census Tract 5011.02, Santa Clara County, California",42,38,4
1000000US060855011022005,060855011022005,"Block 2005, Block Group 2, Census Tract 5011.02, Santa Clara County, California",46,42,4
1000000US060855011022006,060855011022006,"Block 2006, Block Group 2, Census Tract 5011.02, Santa Clara County, California",56,50,6
1000000US060855011022007,060855011022007,"Block 2007, Block Group 2, Census Tract 5011.02, Santa Clara County, California",0,0,0
1000000US060855011022008,060855011022008,"Block 2008, Block Group 2, Census Tract 5011.02, Santa Clara County, California",50,46,4
1000000US060855011022009,060855011022009,"Block 2009, Block Group 2, Census Tract 5011.02, Santa Clara County, California",29,29,0
1000000US060855011022010,060855011022010,"Block 2010, Block Group 2, Census Tract 5011.02, Santa Clara County, California",49,46,3
1000000US060855011022011,060855011022011,"Block 2011, Block Group 2, Census Tract 5011.02, Santa Clara County, California",49,44,5
1000000US060855011022012,060855011022012,"Block 2012, Block Group 2, Census Tract 5011.02, Santa Clara County, California",40,40,0
1000000US060855011023000,060855011023000,"Block 3000, Block Group 3, Census Tract 5011.02, Santa Clara County, California",37,37,0
1000000US060855011023001,060855011023001,"Block 3001, Block Group 3, Census Tract 5011.02, Santa Clara County, California",38,38,0
1000000US060855011023002,060855011023002,"Block 3002, Block Group 3, Census Tract 5011.02, Santa Clara County, California",37,34,3
1000000US060855011023003,060855011023003,"Block 3003, Block Group 3, Census Tract 5011.02, Santa Clara County, California",42,41,1
1000000US060855011023004,060855011023004,"Block 3004, Block Group 3, Census Tract 5011.02, Santa Clara County, California",41,40,1
1000000US060855011023005,060855011023005,"Block 3005, Block Group 3, Census Tract 5011.02, Santa Clara County, California",45,42,3
1000000US060855011023006,060855011023006,"Block 3006, Block Group 3, Census Tract 5011.02, Santa Clara County, California",40,37,3
1000000US060855011023007,060855011023007,"Block 3007, Block Group 3, Census Tract 5011.02, Santa Clara County, California",0,0,0
1000000US060855011023008,060855011023008,"Block 3008, Block Group 3, Census Tract 5011.02, Santa Clara County, California",40,40,0
1000000US060855011023009,060855011023009,"Block 3009, Block Group 3, Census Tract 5011.02, Santa Clara County, California",41,37,4
1000000US060855011023010,060855011023010,"Block 3010, Block Group 3, Census Tract 5011.02, Santa Clara County, California",49,47,2
1000000US060855012001000,060855012001000,"Block 1000, Block Group 1, Census Tract 5012, Santa Clara County, California",42,41,1
1000000US060855012001001,060855012001001,"Block 1001, Block Group 1, Census Tract 5012, Santa Clara County, California",43,43,0
1000000US060855012001002,060855012001002,"Block 1002, Block Group 1, Census Tract 5012, Santa Clara County, California",50,48,2
1000000US060855012001003,060855012001003,"Block 1003, Block Group 1, Census Tract 5012, Santa Clara County, California",35,33,2
1000000US060855012001004,060855012001004,"Block 1004, Block Group 1, Census Tract 5012, Santa Clara County, California",30,26,4
1000000US060855012001005,060855012001005,"Block 1005, Block Group 1, Census Tract 5012, Santa Clara County, California",29,28,1
1000000US060855012002000,060855012002000,"Block 2000, Block Group 2, Census Tract 5012, Santa Clara County, California",24,22,2
1000000US060855012002001,060855012002001,"Block 2001, Block Group 2, Census Tract 5012, Santa Clara County, California",46,42,4
1000000US060855012002002,060855012002002,"Block 2002, Block Group 2, Census Tract 5012, Santa Clara County, California",46,44,2
1000000US060855012002003,060855012002003,"Block 2003, Block Group 2, Census Tract 5012, Santa Clara County, California",48,45,3
1000000US060855012002004,060855012002004,"Block 2004, Block Group 2, Census Tract 5012, Santa Clara County, California",28,27,1
1000000US060855012002005,060855012002005,"Block 2005, Block Group 2, Census Tract 5012, Santa Clara County, California",17,16,1
1000000US060855012002006,060855012002006,"Block 2006, Block Group 2, Census Tract 5012, Santa Clara County, California",64,60,4
1000000US060855012002007,060855012002007,"Block 2007, Block Group 2, Census Tract 5012, Santa Clara County, California",0,0,0
1000000US060855012002008,060855012002008,"Block 2008, Block Group 2, Census Tract 5012, Santa Clara County, California",34,29,5
1000000US060855012002009,060855012002009,"Block 2009, Block Group 2, Census Tract 5012, Santa Clara County, California",39,36,3
1000000US060855012002010,060855012002010,"Block 2010, Block Group 2, Census Tract 5012, Santa Clara County, California",29,27,2
1000000US060855012003000,060855012003000,"Block 3000, Block Group 3, Census Tract 5012, Santa Clara County, California",34,33,1
1000000US060855012003001,060855012003001,"Block 3001, Block Group 3, Census Tract 5012, Santa Clara County, California",47,43,4
1000000US060855012003002,060855012003002,"Block 3002, Block Group 3, Census Tract 5012, Santa Clara County, California",76,69,7
1000000US060855012003003,060855012003003,"Block 3003, Block Group 3, Census Tract 5012, Santa Clara County, California",42,41,1
1000000US060855012003004,060855012003004,"Block 3004, Block Group 3, Census Tract 5012, Santa Clara County, California",45,42,3
1000000US060855012003005,060855012003005,"Block 3005, Block Group 3, Census Tract 5012, Santa Clara County, California",63,59,4
1000000US060855012003006,060855012003006,"Block 3006, Block Group 3, Census Tract 5012, Santa Clara County, California",49,47,2
1000000US060855012003007,060855012003007,"Block 3007, Block Group 3, Census Tract 5012, Santa Clara County, California",13,13,0
1000000US060855012003008,060855012003008,"Block 3008, Block Group 3, Census Tract 5012, Santa Clara County, California",18,18,0
1000000US060855012004000,060855012004000,"Block 4000, Block Group 4, Census Tract 5012, Santa Clara County, California",45,42,3
1000000US060855012004001,060855012004001,"Block 4001, Block Group 4, Census Tract 5012, Santa Clara County, California",47,47,0
1000000US060855012004002,060855012004002,"Block 4002, Block Group 4, Census Tract 5012, Santa Clara County, California",50,49,1
1000000US060855012004003,060855012004003,"Block 4003, Block Group 4, Census Tract 5012, Santa Clara County, California",53,51,2
1000000US060855012004004,060855012004004,"Block 4004, Block Group 4, Census Tract 5012, Santa Clara County, California",59,59,0
1000000US060855012004005,060855012004005,"Block 4005, Block Group 4, Census Tract 5012, Santa Clara County, California",34,33,1
1000000US060855012004006,060855012004006,"Block 4006, Block Group 4, Census Tract 5012, Santa Clara County, California",40,36,4
1000000US060855012004007,060855012004007,"Block 4007, Block Group 4, Census Tract 5012, Santa Clara County, California",34,33,1
1000000US060855012004008,060855012004008,"Block 4008, Block Group 4, Census Tract 5012, Santa Clara County, California",48,45,3
1000000US060855012004009,060855012004009,"Block 4009, Block Group 4, Census Tract 5012, Santa Clara County, California",37,37,0
1000000US060855013001000,060855013001000,"Block 1000, Block Group 1, Census Tract 5013, Santa Clara County, California",10,9,1
1000000US060855013001001,060855013001001,"Block 1001, Block Group 1, Census Tract 5013, Santa Clara County, California",38,38,0
1000000US060855013001002,060855013001002,"Block 1002, Block Group 1, Census Tract 5013, Santa Clara County, California",53,51,2
1000000US060855013001003,060855013001003,"Block 1003, Block Group 1, Census Tract 5013, Santa Clara County, California",38,36,2
1000000US060855013001004,060855013001004,"Block 1004, Block Group 1, Census Tract 5013, Santa Clara County, California",44,41,3
1000000US060855013001005,060855013001005,"Block 1005, Block Group 1, Census Tract 5013, Santa Clara County, California",34,33,1
1000000US060855013001006,060855013001006,"Block 1006, Block Group 1, Census Tract 5013, Santa Clara County, California",25,25,0
1000000US060855013001007,060855013001007,"Block 1007, Block Group 1, Census Tract 5013, Santa Clara County, California",24,24,0
1000000US060855013002000,060855013002000,"Block 2000, Block Group 2, Census Tract 5013, Santa Clara County, California",25,25,0
1000000US060855013002001,060855013002001,"Block 2001, Block Group 2, Census Tract 5013, Santa Clara County, California",24,23,1
1000000US060855013002002,060855013002002,"Block 2002, Block Group 2, Census Tract 5013, Santa Clara County, California",20,20,0
1000000US060855013002003,060855013002003,"Block 2003, Block Group 2, Census Tract 5013, Santa Clara County, California",22,21,1
1000000US060855013002004,060855013002004,"Block 2004, Block Group 2, Census Tract 5013, Santa Clara County, California",22,20,2
1000000US060855013002005,060855013002005,"Block 2005, Block Group 2, Census Tract 5013, Santa Clara County, California",23,22,1
1000000US060855013002006,060855013002006,"Block 2006, Block Group 2, Census Tract 5013, Santa Clara County, California",26,26,0
1000000US060855013002007,060855013002007,"Block 2007, Block Group 2, Census Tract 5013, Santa Clara County, California",21,20,1
1000000US060855013002008,060855013002008,"Block 2008, Block Group 2, Census Tract 5013, Santa Clara County, California",21,21,0
1000000US060855013003000,060855013003000,"Block 3000, Block Group 3, Census Tract 5013, Santa Clara County, California",26,26,0
1000000US060855013003001,060855013003001,"Block 3001, Block Group 3, Census Tract 5013, Santa Clara County, California",26,26,0
1000000US060855013003002,060855013003002,"Block 3002, Block Group 3, Census Tract 5013, Santa Clara County, California",69,51,18
1000000US060855013003003,060855013003003,"Block 3003, Block Group 3, Census Tract 5013, Santa Clara County, California",128,119,9
1000000US060855013003004,060855013003004,"Block 3004, Block Group 3, Census Tract 5013, Santa Clara County, California",61,57,4
1000000US060855013003005,060855013003005,"Block 3005, Block Group 3, Census Tract 5013, Santa Clara County, California",59,55,4
1000000US060855013003006,060855013003006,"Block 3006, Block Group 3, Census Tract 5013, Santa Clara County, California",22,22,0
1000000US060855013003007,060855013003007,"Block 3007, Block Group 3, Census Tract 5013, Santa Clara County, California",23,22,1
1000000US060855013003008,060855013003008,"Block 3008, Block Group 3, Census Tract 5013, Santa Clara County, California",23,23,0
1000000US060855013003009,060855013003009,"Block 3009, Block Group 3, Census Tract 5013, Santa Clara County, California",20,20,0
1000000US060855013003010,060855013003010,"Block 3010, Block Group 3, Census Tract 5013, Santa Clara County, California",98,97,1
1000000US060855013003011,060855013003011,"Block 3011, Block Group 3, Census Tract 5013, Santa Clara County, California",95,86,9
1000000US060855013004000,060855013004000,"Block 4000, Block Group 4, Census Tract 5013, Santa Clara County, California",44,40,4
1000000US060855013004001,060855013004001,"Block 4001, Block Group 4, Census Tract 5013, Santa Clara County, California",29,28,1
1000000US060855013004002,060855013004002,"Block 4002, Block Group 4, Census Tract 5013, Santa Clara County, California",45,38,7
1000000US060855013004003,060855013004003,"Block 4003, Block Group 4, Census Tract 5013, Santa Clara County, California",56,52,4
1000000US060855013004004,060855013004004,"Block 4004, Block Group 4, Census Tract 5013, Santa Clara County, California",44,43,1
1000000US060855013004005,060855013004005,"Block 4005, Block Group 4, Census Tract 5013, Santa Clara County, California",16,16,0
1000000US060855013004006,060855013004006,"Block 4006, Block Group 4, Census Tract 5013, Santa Clara County, California",31,30,1
1000000US060855013004007,060855013004007,"Block 4007, Block Group 4, Census Tract 5013, Santa Clara County, California",42,42,0
1000000US060855014011000,060855014011000,"Block 1000, Block Group 1, Census Tract 5014.01, Santa Clara County, California",4,4,0
1000000US060855014011001,060855014011001,"Block 1001, Block Group 1, Census Tract 5014.01, Santa Clara County, California",0,0,0
1000000US060855014011002,060855014011002,"Block 1002, Block Group 1, Census Tract 5014.01, Santa Clara County, California",139,130,9
1000000US060855014011003,060855014011003,"Block 1003, Block Group 1, Census Tract 5014.01, Santa Clara County, California",0,0,0
1000000US060855014011004,060855014011004,"Block 1004, Block Group 1, Census Tract 5014.01, Santa Clara County, California",313,294,19
1000000US060855014011005,060855014011005,"Block 1005, Block Group 1, Census Tract 5014.01, Santa Clara County, California",54,54,0
1000000US060855014011006,060855014011006,"Block 1006, Block Group 1, Census Tract 5014.01, Santa Clara County, California",92,90,2
1000000US060855014011007,060855014011007,"Block 1007, Block Group 1, Census Tract 5014.01, Santa Clara County, California",45,45,0
1000000US060855014011008,060855014011008,"Block 1008, Block Group 1, Census Tract 5014.01, Santa Clara County, California",102,98,4
1000000US060855014011009,060855014011009,"Block 1009, Block Group 1, Census Tract 5014.01, Santa Clara County, California",0,0,0
1000000US060855014012000,060855014012000,"Block 2000, Block Group 2, Census Tract 5014.01, Santa Clara County, California",0,0,0
1000000US060855014012001,060855014012001,"Block 2001, Block Group 2, Census Tract 5014.01, Santa Clara County, California",0,0,0
1000000US060855014012002,060855014012002,"Block 2002, Block Group 2, Census Tract 5014.01, Santa Clara County, California",2,2,0
1000000US060855014012003,060855014012003,"Block 2003, Block Group 2, Census Tract 5014.01, Santa Clara County, California",16,16,0
1000000US060855014012004,060855014012004,"Block 2004, Block Group 2, Census Tract 5014.01, Santa Clara County, California",26,24,2
1000000US060855014012005,060855014012005,"Block 2005, Block Group 2, Census Tract 5014.01, Santa Clara County, California",20,20,0
1000000US060855014012006,060855014012006,"Block 2006, Block Group 2, Census Tract 5014.01, Santa Clara County, California",0,0,0
1000000US060855014012007,060855014012007,"Block 2007, Block Group 2, Census Tract 5014.01, Santa Clara County, California",2,2,0
1000000US060855014012008,060855014012008,"Block 2008, Block Group 2, Census Tract 5014.01, Santa Clara County, California",25,24,1
1000000US060855014012009,060855014012009,"Block 2009, Block Group 2, Census Tract 5014.01, Santa Clara County, California",35,34,1
1000000US060855014012010,060855014012010,"Block 2010, Block Group 2, Census Tract 5014.01, Santa Clara County, California",38,35,3
1000000US060855014012011,060855014012011,"Block 2011, Block Group 2, Census Tract 5014.01, Santa Clara County, California",4,4,0
1000000US060855014012012,060855014012012,"Block 2012, Block Group 2, Census Tract 5014.01, Santa Clara County, California",32,31,1
1000000US060855014012013,060855014012013,"Block 2013, Block Group 2, Census Tract 5014.01, Santa Clara County, California",24,22,2
1000000US060855014012014,060855014012014,"Block 2014, Block Group 2, Census Tract 5014.01, Santa Clara County, California",39,38,1
1000000US060855014012015,060855014012015,"Block 2015, Block Group 2, Census Tract 5014.01, Santa Clara County, California",7,6,1
1000000US060855014012016,060855014012016,"Block 2016, Block Group 2, Census Tract 5014.01, Santa Clara County, California",0,0,0
1000000US060855014012017,060855014012017,"Block 2017, Block Group 2, Census Tract 5014.01, Santa Clara County, California",0,0,0
1000000US060855014021000,060855014021000,"Block 1000, Block Group 1, Census Tract 5014.02, Santa Clara County, California",2,2,0
1000000US060855014021001,060855014021001,"Block 1001, Block Group 1, Census Tract 5014.02, Santa Clara County, California",31,31,0
1000000US060855014021002,060855014021002,"Block 1002, Block Group 1, Census Tract 5014.02, Santa Clara County, California",38,34,4
1000000US060855014021003,060855014021003,"Block 1003, Block Group 1, Census Tract 5014.02, Santa Clara County, California",24,21,3
1000000US060855014021004,060855014021004,"Block 1004, Block Group 1, Census Tract 5014.02, Santa Clara County, California",28,27,1
1000000US060855014021005,060855014021005,"Block 1005, Block Group 1, Census Tract 5014.02, Santa Clara County, California",0,0,0
1000000US060855014021006,060855014021006,"Block 1006, Block Group 1, Census Tract 5014.02, Santa Clara County, California",14,12,2
1000000US060855014021007,060855014021007,"Block 1007, Block Group 1, Census Tract 5014.02, Santa Clara County, California",51,48,3
1000000US060855014021008,060855014021008,"Block 1008, Block Group 1, Census Tract 5014.02, Santa Clara County, California",30,27,3
1000000US060855014021009,060855014021009,"Block 1009, Block Group 1, Census Tract 5014.02, Santa Clara County, California",28,28,0
1000000US060855014021010,060855014021010,"Block 1010, Block Group 1, Census Tract 5014.02, Santa Clara County, California",7,7,0
1000000US060855014021011,060855014021011,"Block 1011, Block Group 1, Census Tract 5014.02, Santa Clara County, California",7,6,1
1000000US060855014021012,060855014021012,"Block 1012, Block Group 1, Census Tract 5014.02, Santa Clara County, California",12,10,2
1000000US060855014021013,060855014021013,"Block 1013, Block Group 1, Census Tract 5014.02, Santa Clara County, California",32,31,1
1000000US060855014021014,060855014021014,"Block 1014, Block Group 1, Census Tract 5014.02, Santa Clara County, California",16,16,0
1000000US060855014021015,060855014021015,"Block 1015, Block Group 1, Census Tract 5014.02, Santa Clara County, California",27,22,5
1000000US060855014022000,060855014022000,"Block 2000, Block Group 2, Census Tract 5014.02, Santa Clara County, California",26,23,3
1000000US060855014022001,060855014022001,"Block 2001, Block Group 2, Census Tract 5014.02, Santa Clara County, California",64,64,0
1000000US060855014022002,060855014022002,"Block 2002, Block Group 2, Census Tract 5014.02, Santa Clara County, California",42,40,2
1000000US060855014022003,060855014022003,"Block 2003, Block Group 2, Census Tract 5014.02, Santa Clara County, California",52,44,8
1000000US060855014022004,060855014022004,"Block 2004, Block Group 2, Census Tract 5014.02, Santa Clara County, California",63,63,0
1000000US060855014022005,060855014022005,"Block 2005, Block Group 2, Census Tract 5014.02, Santa Clara County, California",106,101,5
1000000US060855014022006,060855014022006,"Block 2006, Block Group 2, Census Tract 5014.02, Santa Clara County, California",37,34,3
1000000US060855014022007,060855014022007,"Block 2007, Block Group 2, Census Tract 5014.02, Santa Clara County, California",25,25,0
1000000US060855014022008,060855014022008,"Block 2008, Block Group 2, Census Tract 5014.02, Santa Clara County, California",27,26,1
1000000US060855014022009,060855014022009,"Block 2009, Block Group 2, Census Tract 5014.02, Santa Clara County, California",34,31,3
1000000US060855014022010,060855014022010,"Block 2010, Block Group 2, Census Tract 5014.02, Santa Clara County, California",33,33,0
1000000US060855014022011,060855014022011,"Block 2011, Block Group 2, Census Tract 5014.02, Santa Clara County, California",23,23,0
1000000US060855015011000,060855015011000,"Block 1000, Block Group 1, Census Tract 5015.01, Santa Clara County, California",7,7,0
1000000US060855015011001,060855015011001,"Block 1001, Block Group 1, Census Tract 5015.01, Santa Clara County, California",0,0,0
1000000US060855015011002,060855015011002,"Block 1002, Block Group 1, Census Tract 5015.01, Santa Clara County, California",174,168,6
1000000US060855015011003,060855015011003,"Block 1003, Block Group 1, Census Tract 5015.01, Santa Clara County, California",16,16,0
1000000US060855015011004,060855015011004,"Block 1004, Block Group 1, Census Tract 5015.01, Santa Clara County, California",17,17,0
1000000US060855015011005,060855015011005,"Block 1005, Block Group 1, Census Tract 5015.01, Santa Clara County, California",13,13,0
1000000US060855015011006,060855015011006,"Block 1006, Block Group 1, Census Tract 5015.01, Santa Clara County, California",22,21,1
1000000US060855015011007,060855015011007,"Block 1007, Block Group 1, Census Tract 5015.01, Santa Clara County, California",92,89,3
1000000US060855015011008,060855015011008,"Block 1008, Block Group 1, Census Tract 5015.01, Santa Clara County, California",121,118,3
1000000US060855015011009,060855015011009,"Block 1009, Block Group 1, Census Tract 5015.01, Santa Clara County, California",20,19,1
1000000US060855015011010,060855015011010,"Block 1010, Block Group 1, Census Tract 5015.01, Santa Clara County, California",60,54,6
1000000US060855015011011,060855015011011,"Block 1011, Block Group 1, Census Tract 5015.01, Santa Clara County, California",15,15,0
1000000US060855015011012,060855015011012,"Block 1012, Block Group 1, Census Tract 5015.01, Santa Clara County, California",24,24,0
1000000US060855015011013,060855015011013,"Block 1013, Block Group 1, Census Tract 5015.01, Santa Clara County, California",46,44,2
1000000US060855015011014,060855015011014,"Block 1014, Block Group 1, Census Tract 5015.01, Santa Clara County, California",48,48,0
1000000US060855015012000,060855015012000,"Block 2000, Block Group 2, Census Tract 5015.01, Santa Clara County, California",0,0,0
1000000US060855015012001,060855015012001,"Block 2001, Block Group 2, Census Tract 5015.01, Santa Clara County, California",145,140,5
1000000US060855015012002,060855015012002,"Block 2002, Block Group 2, Census Tract 5015.01, Santa Clara County, California",84,75,9
1000000US060855015012003,060855015012003,"Block 2003, Block Group 2, Census Tract 5015.01, Santa Clara County, California",21,20,1
1000000US060855015012004,060855015012004,"Block 2004, Block Group 2, Census Tract 5015.01, Santa Clara County, California",254,246,8
1000000US060855015012005,060855015012005,"Block 2005, Block Group 2, Census Tract 5015.01, Santa Clara County, California",1,1,0
1000000US060855015021000,060855015021000,"Block 1000, Block Group 1, Census Tract 5015.02, Santa Clara County, California",33,31,2
1000000US060855015021001,060855015021001,"Block 1001, Block Group 1, Census Tract 5015.02, Santa Clara County, California",50,48,2
1000000US060855015021002,060855015021002,"Block 1002, Block Group 1, Census Tract 5015.02, Santa Clara County, California",34,34,0
1000000US060855015021003,060855015021003,"Block 1003, Block Group 1, Census Tract 5015.02, Santa Clara County, California",33,29,4
1000000US060855015021004,060855015021004,"Block 1004, Block Group 1, Census Tract 5015.02, Santa Clara County, California",29,26,3
1000000US060855015021005,060855015021005,"Block 1005, Block Group 1, Census Tract 5015.02, Santa Clara County, California",32,29,3
1000000US060855015021006,060855015021006,"Block 1006, Block Group 1, Census Tract 5015.02, Santa Clara County, California",36,31,5
1000000US060855015021007,060855015021007,"Block 1007, Block Group 1, Census Tract 5015.02, Santa Clara County, California",35,33,2
1000000US060855015021008,060855015021008,"Block 1008, Block Group 1, Census Tract 5015.02, Santa Clara County, California",39,37,2
1000000US060855015021009,060855015021009,"Block 1009, Block Group 1, Census Tract 5015.02, Santa Clara County, California",35,35,0
1000000US060855015021010,060855015021010,"Block 1010, Block Group 1, Census Tract 5015.02, Santa Clara County, California",2,2,0
1000000US060855015021011,060855015021011,"Block 1011, Block Group 1, Census Tract 5015.02, Santa Clara County, California",38,36,2
1000000US060855015021012,060855015021012,"Block 1012, Block Group 1, Census Tract 5015.02, Santa Clara County, California",37,37,0
1000000US060855015022000,060855015022000,"Block 2000, Block Group 2, Census Tract 5015.02, Santa Clara County, California",472,464,8
1000000US060855015022001,060855015022001,"Block 2001, Block Group 2, Census Tract 5015.02, Santa Clara County, California",0,0,0
1000000US060855015022002,060855015022002,"Block 2002, Block Group 2, Census Tract 5015.02, Santa Clara County, California",48,47,1
1000000US060855015022003,060855015022003,"Block 2003, Block Group 2, Census Tract 5015.02, Santa Clara County, California",11,9,2
1000000US060855015022004,060855015022004,"Block 2004, Block Group 2, Census Tract 5015.02, Santa Clara County, California",45,44,1
1000000US060855015022005,060855015022005,"Block 2005, Block Group 2, Census Tract 5015.02, Santa Clara County, California",11,11,0
1000000US060855015022006,060855015022006,"Block 2006, Block Group 2, Census Tract 5015.02, Santa Clara County, California",1,1,0
1000000US060855015022007,060855015022007,"Block 2007, Block Group 2, Census Tract 5015.02, Santa Clara County, California",62,62,0
1000000US060855015022008,060855015022008,"Block 2008, Block Group 2, Census Tract 5015.02, Santa Clara County, California",40,40,0
1000000US060855016001000,060855016001000,"Block 1000, Block Group 1, Census Tract 5016, Santa Clara County, California",138,133,5
1000000US060855016001001,060855016001001,"Block 1001, Block Group 1, Census Tract 5016, Santa Clara County, California",3,3,0
1000000US060855016001002,060855016001002,"Block 1002, Block Group 1, Census Tract 5016, Santa Clara County, California",50,44,6
1000000US060855016001003,060855016001003,"Block 1003, Block Group 1, Census Tract 5016, Santa Clara County, California",19,18,1
1000000US060855016001004,060855016001004,"Block 1004, Block Group 1, Census Tract 5016, Santa Clara County, California",9,9,0
1000000US060855016001005,060855016001005,"Block 1005, Block Group 1, Census Tract 5016, Santa Clara County, California",31,31,0
1000000US060855016002000,060855016002000,"Block 2000, Block Group 2, Census Tract 5016, Santa Clara County, California",114,105,9
1000000US060855016002001,060855016002001,"Block 2001, Block Group 2, Census Tract 5016, Santa Clara County, California",102,98,4
1000000US060855016002002,060855016002002,"Block 2002, Block Group 2, Census Tract 5016, Santa Clara County, California",112,107,5
1000000US060855016002003,060855016002003,"Block 2003, Block Group 2, Census Tract 5016, Santa Clara County, California",29,28,1
1000000US060855016002004,060855016002004,"Block 2004, Block Group 2, Census Tract 5016, Santa Clara County, California",0,0,0
1000000US060855016002005,060855016002005,"Block 2005, Block Group 2, Census Tract 5016, Santa Clara County, California",67,59,8
1000000US060855016002006,060855016002006,"Block 2006, Block Group 2, Census Tract 5016, Santa Clara County, California",0,0,0
1000000US060855016003000,060855016003000,"Block 3000, Block Group 3, Census Tract 5016, Santa Clara County, California",161,143,18
1000000US060855016003001,060855016003001,"Block 3001, Block Group 3, Census Tract 5016, Santa Clara County, California",126,122,4
1000000US060855016003002,060855016003002,"Block 3002, Block Group 3, Census Tract 5016, Santa Clara County, California",85,85,0
1000000US060855016003003,060855016003003,"Block 3003, Block Group 3, Census Tract 5016, Santa Clara County, California",94,85,9
1000000US060855016003004,060855016003004,"Block 3004, Block Group 3, Census Tract 5016, Santa Clara County, California",139,130,9
1000000US060855016003005,060855016003005,"Block 3005, Block Group 3, Census Tract 5016, Santa Clara County, California",110,107,3
1000000US060855016003006,060855016003006,"Block 3006, Block Group 3, Census Tract 5016, Santa Clara County, California",86,78,8
1000000US060855016004000,060855016004000,"Block 4000, Block Group 4, Census Tract 5016, Santa Clara County, California",95,89,6
1000000US060855016004001,060855016004001,"Block 4001, Block Group 4, Census Tract 5016, Santa Clara County, California",37,36,1
1000000US060855016004002,060855016004002,"Block 4002, Block Group 4, Census Tract 5016, Santa Clara County, California",50,49,1
1000000US060855016004003,060855016004003,"Block 4003, Block Group 4, Census Tract 5016, Santa Clara County, California",22,18,4
1000000US060855016004004,060855016004004,"Block 4004, Block Group 4, Census Tract 5016, Santa Clara County, California",21,21,0
1000000US060855016004005,060855016004005,"Block 4005, Block Group 4, Census Tract 5016, Santa Clara County, California",79,77,2
1000000US060855016004006,060855016004006,"Block 4006, Block Group 4, Census Tract 5016, Santa Clara County, California",85,81,4
1000000US060855016004007,060855016004007,"Block 4007, Block Group 4, Census Tract 5016, Santa Clara County, California",100,97,3
1000000US060855016004008,060855016004008,"Block 4008, Block Group 4, Census Tract 5016, Santa Clara County, California",44,41,3
1000000US060855016004009,060855016004009,"Block 4009, Block Group 4, Census Tract 5016, Santa Clara County, California",24,23,1
1000000US060855016004010,060855016004010,"Block 4010, Block Group 4, Census Tract 5016, Santa Clara County, California",20,20,0
1000000US060855016004011,060855016004011,"Block 4011, Block Group 4, Census Tract 5016, Santa Clara County, California",82,79,3
1000000US060855016004012,060855016004012,"Block 4012, Block Group 4, Census Tract 5016, Santa Clara County, California",50,35,15
1000000US060855016004013,060855016004013,"Block 4013, Block Group 4, Census Tract 5016, Santa Clara County, California",1,1,0
1000000US060855016005000,060855016005000,"Block 5000, Block Group 5, Census Tract 5016, Santa Clara County, California",11,10,1
1000000US060855016005001,060855016005001,"Block 5001, Block Group 5, Census Tract 5016, Santa Clara County, California",10,10,0
1000000US060855016005002,060855016005002,"Block 5002, Block Group 5, Census Tract 5016, Santa Clara County, California",18,17,1
1000000US060855016005003,060855016005003,"Block 5003, Block Group 5, Census Tract 5016, Santa Clara County, California",22,22,0
1000000US060855016005004,060855016005004,"Block 5004, Block Group 5, Census Tract 5016, Santa Clara County, California",25,20,5
1000000US060855016005005,060855016005005,"Block 5005, Block Group 5, Census Tract 5016, Santa Clara County, California",118,105,13
1000000US060855016005006,060855016005006,"Block 5006, Block Group 5, Census Tract 5016, Santa Clara County, California",14,14,0
1000000US060855016005007,060855016005007,"Block 5007, Block Group 5, Census Tract 5016, Santa Clara County, California",0,0,0
1000000US060855016005008,060855016005008,"Block 5008, Block Group 5, Census Tract 5016, Santa Clara County, California",21,21,0
1000000US060855016005009,060855016005009,"Block 5009, Block Group 5, Census Tract 5016, Santa Clara County, California",27,24,3
1000000US060855016005010,060855016005010,"Block 5010, Block Group 5, Census Tract 5016, Santa Clara County, California",52,45,7
1000000US060855016005011,060855016005011,"Block 5011, Block Group 5, Census Tract 5016, Santa Clara County, California",11,11,0
1000000US060855016005012,060855016005012,"Block 5012, Block Group 5, Census Tract 5016, Santa Clara County, California",18,18,0
1000000US060855016005013,060855016005013,"Block 5013, Block Group 5, Census Tract 5016, Santa Clara County, California",40,35,5
1000000US060855016005014,060855016005014,"Block 5014, Block Group 5, Census Tract 5016, Santa Clara County, California",26,26,0
1000000US060855016005015,060855016005015,"Block 5015, Block Group 5, Census Tract 5016, Santa Clara County, California",9,9,0
1000000US060855016005016,060855016005016,"Block 5016, Block Group 5, Census Tract 5016, Santa Clara County, California",41,36,5
1000000US060855016005017,060855016005017,"Block 5017, Block Group 5, Census Tract 5016, Santa Clara County, California",0,0,0
1000000US060855016005018,060855016005018,"Block 5018, Block Group 5, Census Tract 5016, Santa Clara County, California",1,1,0
1000000US060855016005019,060855016005019,"Block 5019, Block Group 5, Census Tract 5016, Santa Clara County, California",0,0,0
1000000US060855017001000,060855017001000,"Block 1000, Block Group 1, Census Tract 5017, Santa Clara County, California",0,0,0
1000000US060855017001001,060855017001001,"Block 1001, Block Group 1, Census Tract 5017, Santa Clara County, California",0,0,0
1000000US060855017001002,060855017001002,"Block 1002, Block Group 1, Census Tract 5017, Santa Clara County, California",0,0,0
1000000US060855017001003,060855017001003,"Block 1003, Block Group 1, Census Tract 5017, Santa Clara County, California",59,54,5
1000000US060855017001004,060855017001004,"Block 1004, Block Group 1, Census Tract 5017, Santa Clara County, California",75,73,2
1000000US060855017001005,060855017001005,"Block 1005, Block Group 1, Census Tract 5017, Santa Clara County, California",0,0,0
1000000US060855017001006,060855017001006,"Block 1006, Block Group 1, Census Tract 5017, Santa Clara County, California",93,88,5
1000000US060855017001007,060855017001007,"Block 1007, Block Group 1, Census Tract 5017, Santa Clara County, California",18,18,0
1000000US060855017001008,060855017001008,"Block 1008, Block Group 1, Census Tract 5017, Santa Clara County, California",9,8,1
1000000US060855017001009,060855017001009,"Block 1009, Block Group 1, Census Tract 5017, Santa Clara County, California",21,19,2
1000000US060855017001010,060855017001010,"Block 1010, Block Group 1, Census Tract 5017, Santa Clara County, California",0,0,0
1000000US060855017001011,060855017001011,"Block 1011, Block Group 1, Census Tract 5017, Santa Clara County, California",0,0,0
1000000US060855017002000,060855017002000,"Block 2000, Block Group 2, Census Tract 5017, Santa Clara County, California",0,0,0
1000000US060855017002001,060855017002001,"Block 2001, Block Group 2, Census Tract 5017, Santa Clara County, California",0,0,0
1000000US060855017002002,060855017002002,"Block 2002, Block Group 2, Census Tract 5017, Santa Clara County, California",15,13,2
1000000US060855017002003,060855017002003,"Block 2003, Block Group 2, Census Tract 5017, Santa Clara County, California",62,58,4
1000000US060855017002004,060855017002004,"Block 2004, Block Group 2, Census Tract 5017, Santa Clara County, California",0,0,0
1000000US060855017002005,060855017002005,"Block 2005, Block Group 2, Census Tract 5017, Santa Clara County, California",117,113,4
1000000US060855017002006,060855017002006,"Block 2006, Block Group 2, Census Tract 5017, Santa Clara County, California",0,0,0
1000000US060855017002007,060855017002007,"Block 2007, Block Group 2, Census Tract 5017, Santa Clara County, California",0,0,0
1000000US060855017003000,060855017003000,"Block 3000, Block Group 3, Census Tract 5017, Santa Clara County, California",99,93,6
1000000US060855017003001,060855017003001,"Block 3001, Block Group 3, Census Tract 5017, Santa Clara County, California",36,31,5
1000000US060855017003002,060855017003002,"Block 3002, Block Group 3, Census Tract 5017, Santa Clara County, California",28,27,1
1000000US060855017003003,060855017003003,"Block 3003, Block Group 3, Census Tract 5017, Santa Clara County, California",63,59,4
1000000US060855017003004,060855017003004,"Block 3004, Block Group 3, Census Tract 5017, Santa Clara County, California",78,76,2
1000000US060855017003005,060855017003005,"Block 3005, Block Group 3, Census Tract 5017, Santa Clara County, California",30,25,5
1000000US060855017003006,060855017003006,"Block 3006, Block Group 3, Census Tract 5017, Santa Clara County, California",31,29,2
1000000US060855017003007,060855017003007,"Block 3007, Block Group 3, Census Tract 5017, Santa Clara County, California",33,32,1
1000000US060855017003008,060855017003008,"Block 3008, Block Group 3, Census Tract 5017, Santa Clara County, California",6,6,0
1000000US060855017003009,060855017003009,"Block 3009, Block Group 3, Census Tract 5017, Santa Clara County, California",0,0,0
1000000US060855017003010,060855017003010,"Block 3010, Block Group 3, Census Tract 5017, Santa Clara County, California",0,0,0
1000000US060855017003011,060855017003011,"Block 3011, Block Group 3, Census Tract 5017, Santa Clara County, California",31,28,3
1000000US060855017003012,060855017003012,"Block 3012, Block Group 3, Census Tract 5017, Santa Clara County, California",26,26,0
1000000US060855017003013,060855017003013,"Block 3013, Block Group 3, Census Tract 5017, Santa Clara County, California",15,15,0
1000000US060855017004000,060855017004000,"Block 4000, Block Group 4, Census Tract 5017, Santa Clara County, California",54,49,5
1000000US060855017004001,060855017004001,"Block 4001, Block Group 4, Census Tract 5017, Santa Clara County, California",30,27,3
1000000US060855017004002,060855017004002,"Block 4002, Block Group 4, Census Tract 5017, Santa Clara County, California",26,26,0
1000000US060855017004003,060855017004003,"Block 4003, Block Group 4, Census Tract 5017, Santa Clara County, California",59,53,6
1000000US060855017004004,060855017004004,"Block 4004, Block Group 4, Census Tract 5017, Santa Clara County, California",22,22,0
1000000US060855017004005,060855017004005,"Block 4005, Block Group 4, Census Tract 5017, Santa Clara County, California",28,28,0
1000000US060855017004006,060855017004006,"Block 4006, Block Group 4, Census Tract 5017, Santa Clara County, California",0,0,0
1000000US060855017004007,060855017004007,"Block 4007, Block Group 4, Census Tract 5017, Santa Clara County, California",61,54,7
1000000US060855017004008,060855017004008,"Block 4008, Block Group 4, Census Tract 5017, Santa Clara County, California",1,1,0
1000000US060855017004009,060855017004009,"Block 4009, Block Group 4, Census Tract 5017, Santa Clara County, California",13,13,0
1000000US060855017004010,060855017004010,"Block 4010, Block Group 4, Census Tract 5017, Santa Clara County, California",10,10,0
1000000US060855017004011,060855017004011,"Block 4011, Block Group 4, Census Tract 5017, Santa Clara County, California",15,15,0
1000000US060855017004012,060855017004012,"Block 4012, Block Group 4, Census Tract 5017, Santa Clara County, California",20,20,0
1000000US060855017004013,060855017004013,"Block 4013, Block Group 4, Census Tract 5017, Santa Clara County, California",18,18,0
1000000US060855018001000,060855018001000,"Block 1000, Block Group 1, Census Tract 5018, Santa Clara County, California",51,46,5
1000000US060855018001001,060855018001001,"Block 1001, Block Group 1, Census Tract 5018, Santa Clara County, California",0,0,0
1000000US060855018001002,060855018001002,"Block 1002, Block Group 1, Census Tract 5018, Santa Clara County, California",48,45,3
1000000US060855018001003,060855018001003,"Block 1003, Block Group 1, Census Tract 5018, Santa Clara County, California",13,13,0
1000000US060855018001004,060855018001004,"Block 1004, Block Group 1, Census Tract 5018, Santa Clara County, California",20,20,0
1000000US060855018001005,060855018001005,"Block 1005, Block Group 1, Census Tract 5018, Santa Clara County, California",9,9,0
1000000US060855018001006,060855018001006,"Block 1006, Block Group 1, Census Tract 5018, Santa Clara County, California",13,13,0
1000000US060855018001007,060855018001007,"Block 1007, Block Group 1, Census Tract 5018, Santa Clara County, California",14,14,0
1000000US060855018001008,060855018001008,"Block 1008, Block Group 1, Census Tract 5018, Santa Clara County, California",12,12,0
1000000US060855018001009,060855018001009,"Block 1009, Block Group 1, Census Tract 5018, Santa Clara County, California",65,64,1
1000000US060855018001010,060855018001010,"Block 1010, Block Group 1, Census Tract 5018, Santa Clara County, California",102,94,8
1000000US060855018001011,060855018001011,"Block 1011, Block Group 1, Census Tract 5018, Santa Clara County, California",24,23,1
1000000US060855018001012,060855018001012,"Block 1012, Block Group 1, Census Tract 5018, Santa Clara County, California",1,1,0
1000000US060855018001013,060855018001013,"Block 1013, Block Group 1, Census Tract 5018, Santa Clara County, California",0,0,0
1000000US060855018001014,060855018001014,"Block 1014, Block Group 1, Census Tract 5018, Santa Clara County, California",1,1,0
1000000US060855018001015,060855018001015,"Block 1015, Block Group 1, Census Tract 5018, Santa Clara County, California",3,3,0
1000000US060855018001016,060855018001016,"Block 1016, Block Group 1, Census Tract 5018, Santa Clara County, California",15,15,0
1000000US060855018001017,060855018001017,"Block 1017, Block Group 1, Census Tract 5018, Santa Clara County, California",0,0,0
1000000US060855018002000,060855018002000,"Block 2000, Block Group 2, Census Tract 5018, Santa Clara County, California",36,34,2
1000000US060855018002001,060855018002001,"Block 2001, Block Group 2, Census Tract 5018, Santa Clara County, California",30,29,1
1000000US060855018002002,060855018002002,"Block 2002, Block Group 2, Census Tract 5018, Santa Clara County, California",31,30,1
1000000US060855018002003,060855018002003,"Block 2003, Block Group 2, Census Tract 5018, Santa Clara County, California",2,2,0
1000000US060855018002004,060855018002004,"Block 2004, Block Group 2, Census Tract 5018, Santa Clara County, California",44,44,0
1000000US060855018002005,060855018002005,"Block 2005, Block Group 2, Census Tract 5018, Santa Clara County, California",19,15,4
1000000US060855018002006,060855018002006,"Block 2006, Block Group 2, Census Tract 5018, Santa Clara County, California",0,0,0
1000000US060855018002007,060855018002007,"Block 2007, Block Group 2, Census Tract 5018, Santa Clara County, California",88,85,3
1000000US060855018002008,060855018002008,"Block 2008, Block Group 2, Census Tract 5018, Santa Clara County, California",45,43,2
1000000US060855018002009,060855018002009,"Block 2009, Block Group 2, Census Tract 5018, Santa Clara County, California",28,28,0
1000000US060855018002010,060855018002010,"Block 2010, Block Group 2, Census Tract 5018, Santa Clara County, California",9,8,1
1000000US060855018002011,060855018002011,"Block 2011, Block Group 2, Census Tract 5018, Santa Clara County, California",53,51,2
1000000US060855018002012,060855018002012,"Block 2012, Block Group 2, Census Tract 5018, Santa Clara County, California",51,48,3
1000000US060855018002013,060855018002013,"Block 2013, Block Group 2, Census Tract 5018, Santa Clara County, California",35,32,3
1000000US060855018003000,060855018003000,"Block 3000, Block Group 3, Census Tract 5018, Santa Clara County, California",63,63,0
1000000US060855018003001,060855018003001,"Block 3001, Block Group 3, Census Tract 5018, Santa Clara County, California",57,57,0
1000000US060855018003002,060855018003002,"Block 3002, Block Group 3, Census Tract 5018, Santa Clara County, California",65,62,3
1000000US060855018003003,060855018003003,"Block 3003, Block Group 3, Census Tract 5018, Santa Clara County, California",48,47,1
1000000US060855018003004,060855018003004,"Block 3004, Block Group 3, Census Tract 5018, Santa Clara County, California",34,34,0
1000000US060855018003005,060855018003005,"Block 3005, Block Group 3, Census Tract 5018, Santa Clara County, California",28,27,1
1000000US060855018003006,060855018003006,"Block 3006, Block Group 3, Census Tract 5018, Santa Clara County, California",32,32,0
1000000US060855018003007,060855018003007,"Block 3007, Block Group 3, Census Tract 5018, Santa Clara County, California",43,41,2
1000000US060855018003008,060855018003008,"Block 3008, Block Group 3, Census Tract 5018, Santa Clara County, California",22,22,0
1000000US060855018003009,060855018003009,"Block 3009, Block Group 3, Census Tract 5018, Santa Clara County, California",15,15,0
1000000US060855018004000,060855018004000,"Block 4000, Block Group 4, Census Tract 5018, Santa Clara County, California",35,33,2
1000000US060855018004001,060855018004001,"Block 4001, Block Group 4, Census Tract 5018, Santa Clara County, California",19,17,2
1000000US060855018004002,060855018004002,"Block 4002, Block Group 4, Census Tract 5018, Santa Clara County, California",13,12,1
1000000US060855018004003,060855018004003,"Block 4003, Block Group 4, Census Tract 5018, Santa Clara County, California",40,38,2
1000000US060855018004004,060855018004004,"Block 4004, Block Group 4, Census Tract 5018, Santa Clara County, California",0,0,0
1000000US060855018004005,060855018004005,"Block 4005, Block Group 4, Census Tract 5018, Santa Clara County, California",17,17,0
1000000US060855018004006,060855018004006,"Block 4006, Block Group 4, Census Tract 5018, Santa Clara County, California",35,32,3
1000000US060855018004007,060855018004007,"Block 4007, Block Group 4, Census Tract 5018, Santa Clara County, California",59,55,4
1000000US060855018004008,060855018004008,"Block 4008, Block Group 4, Census Tract 5018, Santa Clara County, California",184,163,21
1000000US060855018004009,060855018004009,"Block 4009, Block Group 4, Census Tract 5018, Santa Clara County, California",11,11,0
1000000US060855018004010,060855018004010,"Block 4010, Block Group 4, Census Tract 5018, Santa Clara County, California",37,35,2
1000000US060855018004011,060855018004011,"Block 4011, Block Group 4, Census Tract 5018, Santa Clara County, California",25,25,0
1000000US060855018004012,060855018004012,"Block 4012, Block Group 4, Census Tract 5018, Santa Clara County, California",27,26,1
1000000US060855019001000,060855019001000,"Block 1000, Block Group 1, Census Tract 5019, Santa Clara County, California",0,0,0
1000000US060855019001001,060855019001001,"Block 1001, Block Group 1, Census Tract 5019, Santa Clara County, California",0,0,0
1000000US060855019001002,060855019001002,"Block 1002, Block Group 1, Census Tract 5019, Santa Clara County, California",0,0,0
1000000US060855019001003,060855019001003,"Block 1003, Block Group 1, Census Tract 5019, Santa Clara County, California",1,0,1
1000000US060855019001004,060855019001004,"Block 1004, Block Group 1, Census Tract 5019, Santa Clara County, California",0,0,0
1000000US060855019001005,060855019001005,"Block 1005, Block Group 1, Census Tract 5019, Santa Clara County, California",91,81,10
1000000US060855019001006,060855019001006,"Block 1006, Block Group 1, Census Tract 5019, Santa Clara County, California",1,1,0
1000000US060855019001007,060855019001007,"Block 1007, Block Group 1, Census Tract 5019, Santa Clara County, California",120,110,10
1000000US060855019001008,060855019001008,"Block 1008, Block Group 1, Census Tract 5019, Santa Clara County, California",2,2,0
1000000US060855019001009,060855019001009,"Block 1009, Block Group 1, Census Tract 5019, Santa Clara County, California",26,25,1
1000000US060855019001010,060855019001010,"Block 1010, Block Group 1, Census Tract 5019, Santa Clara County, California",4,3,1
1000000US060855019001011,060855019001011,"Block 1011, Block Group 1, Census Tract 5019, Santa Clara County, California",2,1,1
1000000US060855019001012,060855019001012,"Block 1012, Block Group 1, Census Tract 5019, Santa Clara County, California",0,0,0
1000000US060855019001013,060855019001013,"Block 1013, Block Group 1, Census Tract 5019, Santa Clara County, California",292,288,4
1000000US060855019001014,060855019001014,"Block 1014, Block Group 1, Census Tract 5019, Santa Clara County, California",0,0,0
1000000US060855019001015,060855019001015,"Block 1015, Block Group 1, Census Tract 5019, Santa Clara County, California",3,3,0
1000000US060855019001016,060855019001016,"Block 1016, Block Group 1, Census Tract 5019, Santa Clara County, California",24,23,1
1000000US060855019001017,060855019001017,"Block 1017, Block Group 1, Census Tract 5019, Santa Clara County, California",7,7,0
1000000US060855019001018,060855019001018,"Block 1018, Block Group 1, Census Tract 5019, Santa Clara County, California",0,0,0
1000000US060855019001019,060855019001019,"Block 1019, Block Group 1, Census Tract 5019, Santa Clara County, California",0,0,0
1000000US060855019001020,060855019001020,"Block 1020, Block Group 1, Census Tract 5019, Santa Clara County, California",0,0,0
1000000US060855019001021,060855019001021,"Block 1021, Block Group 1, Census Tract 5019, Santa Clara County, California",281,238,43
1000000US060855019001022,060855019001022,"Block 1022, Block Group 1, Census Tract 5019, Santa Clara County, California",103,87,16
1000000US060855019001023,060855019001023,"Block 1023, Block Group 1, Census Tract 5019, Santa Clara County, California",0,0,0
1000000US060855019001024,060855019001024,"Block 1024, Block Group 1, Census Tract 5019, Santa Clara County, California",2,0,2
1000000US060855019001025,060855019001025,"Block 1025, Block Group 1, Census Tract 5019, Santa Clara County, California",0,0,0
1000000US060855019001026,060855019001026,"Block 1026, Block Group 1, Census Tract 5019, Santa Clara County, California",0,0,0
1000000US060855019001027,060855019001027,"Block 1027, Block Group 1, Census Tract 5019, Santa Clara County, California",3,2,1
1000000US060855019001028,060855019001028,"Block 1028, Block Group 1, Census Tract 5019, Santa Clara County, California",0,0,0
1000000US060855019001029,060855019001029,"Block 1029, Block Group 1, Census Tract 5019, Santa Clara County, California",191,181,10
1000000US060855019001030,060855019001030,"Block 1030, Block Group 1, Census Tract 5019, Santa Clara County, California",23,23,0
1000000US060855019001031,060855019001031,"Block 1031, Block Group 1, Census Tract 5019, Santa Clara County, California",0,0,0
1000000US060855019001032,060855019001032,"Block 1032, Block Group 1, Census Tract 5019, Santa Clara County, California",0,0,0
1000000US060855019001033,060855019001033,"Block 1033, Block Group 1, Census Tract 5019, Santa Clara County, California",0,0,0
1000000US060855019001034,060855019001034,"Block 1034, Block Group 1, Census Tract 5019, Santa Clara County, California",50,42,8
1000000US060855019001035,060855019001035,"Block 1035, Block Group 1, Census Tract 5019, Santa Clara County, California",1,1,0
1000000US060855019001036,060855019001036,"Block 1036, Block Group 1, Census Tract 5019, Santa Clara County, California",0,0,0
1000000US060855019001037,060855019001037,"Block 1037, Block Group 1, Census Tract 5019, Santa Clara County, California",225,130,95
1000000US060855019001038,060855019001038,"Block 1038, Block Group 1, Census Tract 5019, Santa Clara County, California",0,0,0
1000000US060855019001039,060855019001039,"Block 1039, Block Group 1, Census Tract 5019, Santa Clara County, California",0,0,0
1000000US060855019001040,060855019001040,"Block 1040, Block Group 1, Census Tract 5019, Santa Clara County, California",0,0,0
1000000US060855019001041,060855019001041,"Block 1041, Block Group 1, Census Tract 5019, Santa Clara County, California",0,0,0
1000000US060855019002000,060855019002000,"Block 2000, Block Group 2, Census Tract 5019, Santa Clara County, California",86,77,9
1000000US060855019002001,060855019002001,"Block 2001, Block Group 2, Census Tract 5019, Santa Clara County, California",35,32,3
1000000US060855019002002,060855019002002,"Block 2002, Block Group 2, Census Tract 5019, Santa Clara County, California",0,0,0
1000000US060855019002003,060855019002003,"Block 2003, Block Group 2, Census Tract 5019, Santa Clara County, California",0,0,0
1000000US060855019002004,060855019002004,"Block 2004, Block Group 2, Census Tract 5019, Santa Clara County, California",0,0,0
1000000US060855019002005,060855019002005,"Block 2005, Block Group 2, Census Tract 5019, Santa Clara County, California",0,0,0
1000000US060855019002006,060855019002006,"Block 2006, Block Group 2, Census Tract 5019, Santa Clara County, California",36,27,9
1000000US060855019002007,060855019002007,"Block 2007, Block Group 2, Census Tract 5019, Santa Clara County, California",189,178,11
1000000US060855019002008,060855019002008,"Block 2008, Block Group 2, Census Tract 5019, Santa Clara County, California",133,118,15
1000000US060855019002009,060855019002009,"Block 2009, Block Group 2, Census Tract 5019, Santa Clara County, California",74,71,3
1000000US060855019002010,060855019002010,"Block 2010, Block Group 2, Census Tract 5019, Santa Clara County, California",72,65,7
1000000US060855019002011,060855019002011,"Block 2011, Block Group 2, Census Tract 5019, Santa Clara County, California",87,85,2
1000000US060855019002012,060855019002012,"Block 2012, Block Group 2, Census Tract 5019, Santa Clara County, California",83,80,3
1000000US060855019002013,060855019002013,"Block 2013, Block Group 2, Census Tract 5019, Santa Clara County, California",4,4,0
1000000US060855019002014,060855019002014,"Block 2014, Block Group 2, Census Tract 5019, Santa Clara County, California",0,0,0
1000000US060855019002015,060855019002015,"Block 2015, Block Group 2, Census Tract 5019, Santa Clara County, California",61,59,2
1000000US060855019002016,060855019002016,"Block 2016, Block Group 2, Census Tract 5019, Santa Clara County, California",62,59,3
1000000US060855019002017,060855019002017,"Block 2017, Block Group 2, Census Tract 5019, Santa Clara County, California",0,0,0
1000000US060855020011000,060855020011000,"Block 1000, Block Group 1, Census Tract 5020.01, Santa Clara County, California",44,42,2
1000000US060855020011001,060855020011001,"Block 1001, Block Group 1, Census Tract 5020.01, Santa Clara County, California",2,2,0
1000000US060855020011002,060855020011002,"Block 1002, Block Group 1, Census Tract 5020.01, Santa Clara County, California",3,3,0
1000000US060855020011003,060855020011003,"Block 1003, Block Group 1, Census Tract 5020.01, Santa Clara County, California",48,46,2
1000000US060855020011004,060855020011004,"Block 1004, Block Group 1, Census Tract 5020.01, Santa Clara County, California",56,53,3
1000000US060855020011005,060855020011005,"Block 1005, Block Group 1, Census Tract 5020.01, Santa Clara County, California",48,44,4
1000000US060855020011006,060855020011006,"Block 1006, Block Group 1, Census Tract 5020.01, Santa Clara County, California",6,6,0
1000000US060855020011007,060855020011007,"Block 1007, Block Group 1, Census Tract 5020.01, Santa Clara County, California",34,29,5
1000000US060855020011008,060855020011008,"Block 1008, Block Group 1, Census Tract 5020.01, Santa Clara County, California",0,0,0
1000000US060855020011009,060855020011009,"Block 1009, Block Group 1, Census Tract 5020.01, Santa Clara County, California",2,1,1
1000000US060855020011010,060855020011010,"Block 1010, Block Group 1, Census Tract 5020.01, Santa Clara County, California",1,1,0
1000000US060855020011011,060855020011011,"Block 1011, Block Group 1, Census Tract 5020.01, Santa Clara County, California",47,46,1
1000000US060855020011012,060855020011012,"Block 1012, Block Group 1, Census Tract 5020.01, Santa Clara County, California",39,38,1
1000000US060855020011013,060855020011013,"Block 1013, Block Group 1, Census Tract 5020.01, Santa Clara County, California",38,36,2
1000000US060855020011014,060855020011014,"Block 1014, Block Group 1, Census Tract 5020.01, Santa Clara County, California",61,55,6
1000000US060855020011015,060855020011015,"Block 1015, Block Group 1, Census Tract 5020.01, Santa Clara County, California",31,31,0
1000000US060855020011016,060855020011016,"Block 1016, Block Group 1, Census Tract 5020.01, Santa Clara County, California",3,3,0
1000000US060855020011017,060855020011017,"Block 1017, Block Group 1, Census Tract 5020.01, Santa Clara County, California",0,0,0
1000000US060855020011018,060855020011018,"Block 1018, Block Group 1, Census Tract 5020.01, Santa Clara County, California",7,7,0
1000000US060855020011019,060855020011019,"Block 1019, Block Group 1, Census Tract 5020.01, Santa Clara County, California",1,1,0
1000000US060855020012000,060855020012000,"Block 2000, Block Group 2, Census Tract 5020.01, Santa Clara County, California",113,109,4
1000000US060855020012001,060855020012001,"Block 2001, Block Group 2, Census Tract 5020.01, Santa Clara County, California",0,0,0
1000000US060855020012002,060855020012002,"Block 2002, Block Group 2, Census Tract 5020.01, Santa Clara County, California",119,111,8
1000000US060855020012003,060855020012003,"Block 2003, Block Group 2, Census Tract 5020.01, Santa Clara County, California",5,5,0
1000000US060855020012004,060855020012004,"Block 2004, Block Group 2, Census Tract 5020.01, Santa Clara County, California",0,0,0
1000000US060855020012005,060855020012005,"Block 2005, Block Group 2, Census Tract 5020.01, Santa Clara County, California",0,0,0
1000000US060855020012006,060855020012006,"Block 2006, Block Group 2, Census Tract 5020.01, Santa Clara County, California",1,1,0
1000000US060855020012007,060855020012007,"Block 2007, Block Group 2, Census Tract 5020.01, Santa Clara County, California",2,2,0
1000000US060855020012008,060855020012008,"Block 2008, Block Group 2, Census Tract 5020.01, Santa Clara County, California",5,4,1
1000000US060855020012009,060855020012009,"Block 2009, Block Group 2, Census Tract 5020.01, Santa Clara County, California",2,2,0
1000000US060855020012010,060855020012010,"Block 2010, Block Group 2, Census Tract 5020.01, Santa Clara County, California",1,1,0
1000000US060855020012011,060855020012011,"Block 2011, Block Group 2, Census Tract 5020.01, Santa Clara County, California",3,3,0
1000000US060855020012012,060855020012012,"Block 2012, Block Group 2, Census Tract 5020.01, Santa Clara County, California",2,1,1
1000000US060855020012013,060855020012013,"Block 2013, Block Group 2, Census Tract 5020.01, Santa Clara County, California",8,6,2
1000000US060855020012014,060855020012014,"Block 2014, Block Group 2, Census Tract 5020.01, Santa Clara County, California",29,27,2
1000000US060855020012015,060855020012015,"Block 2015, Block Group 2, Census Tract 5020.01, Santa Clara County, California",9,8,1
1000000US060855020012016,060855020012016,"Block 2016, Block Group 2, Census Tract 5020.01, Santa Clara County, California",0,0,0
1000000US060855020012017,060855020012017,"Block 2017, Block Group 2, Census Tract 5020.01, Santa Clara County, California",1,1,0
1000000US060855020012018,060855020012018,"Block 2018, Block Group 2, Census Tract 5020.01, Santa Clara County, California",19,18,1
1000000US060855020012019,060855020012019,"Block 2019, Block Group 2, Census Tract 5020.01, Santa Clara County, California",2,2,0
1000000US060855020012020,060855020012020,"Block 2020, Block Group 2, Census Tract 5020.01, Santa Clara County, California",51,51,0
1000000US060855020012021,060855020012021,"Block 2021, Block Group 2, Census Tract 5020.01, Santa Clara County, California",2,2,0
1000000US060855020012022,060855020012022,"Block 2022, Block Group 2, Census Tract 5020.01, Santa Clara County, California",0,0,0
1000000US060855020012023,060855020012023,"Block 2023, Block Group 2, Census Tract 5020.01, Santa Clara County, California",8,7,1
1000000US060855020012024,060855020012024,"Block 2024, Block Group 2, Census Tract 5020.01, Santa Clara County, California",0,0,0
1000000US060855020012025,060855020012025,"Block 2025, Block Group 2, Census Tract 5020.01, Santa Clara County, California",0,0,0
1000000US060855020012026,060855020012026,"Block 2026, Block Group 2, Census Tract 5020.01, Santa Clara County, California",0,0,0
1000000US060855020012027,060855020012027,"Block 2027, Block Group 2, Census Tract 5020.01, Santa Clara County, California",0,0,0
1000000US060855020013000,060855020013000,"Block 3000, Block Group 3, Census Tract 5020.01, Santa Clara County, California",0,0,0
1000000US060855020013001,060855020013001,"Block 3001, Block Group 3, Census Tract 5020.01, Santa Clara County, California",1,1,0
1000000US060855020013002,060855020013002,"Block 3002, Block Group 3, Census Tract 5020.01, Santa Clara County, California",11,10,1
1000000US060855020013003,060855020013003,"Block 3003, Block Group 3, Census Tract 5020.01, Santa Clara County, California",2,2,0
1000000US060855020013004,060855020013004,"Block 3004, Block Group 3, Census Tract 5020.01, Santa Clara County, California",11,11,0
1000000US060855020013005,060855020013005,"Block 3005, Block Group 3, Census Tract 5020.01, Santa Clara County, California",8,8,0
1000000US060855020013006,060855020013006,"Block 3006, Block Group 3, Census Tract 5020.01, Santa Clara County, California",8,8,0
1000000US060855020013007,060855020013007,"Block 3007, Block Group 3, Census Tract 5020.01, Santa Clara County, California",4,4,0
1000000US060855020013008,060855020013008,"Block 3008, Block Group 3, Census Tract 5020.01, Santa Clara County, California",17,14,3
1000000US060855020013009,060855020013009,"Block 3009, Block Group 3, Census Tract 5020.01, Santa Clara County, California",6,6,0
1000000US060855020013010,060855020013010,"Block 3010, Block Group 3, Census Tract 5020.01, Santa Clara County, California",27,26,1
1000000US060855020013011,060855020013011,"Block 3011, Block Group 3, Census Tract 5020.01, Santa Clara County, California",19,19,0
1000000US060855020013012,060855020013012,"Block 3012, Block Group 3, Census Tract 5020.01, Santa Clara County, California",26,24,2
1000000US060855020013013,060855020013013,"Block 3013, Block Group 3, Census Tract 5020.01, Santa Clara County, California",33,33,0
1000000US060855020013014,060855020013014,"Block 3014, Block Group 3, Census Tract 5020.01, Santa Clara County, California",34,34,0
1000000US060855020013015,060855020013015,"Block 3015, Block Group 3, Census Tract 5020.01, Santa Clara County, California",32,30,2
1000000US060855020013016,060855020013016,"Block 3016, Block Group 3, Census Tract 5020.01, Santa Clara County, California",33,32,1
1000000US060855020013017,060855020013017,"Block 3017, Block Group 3, Census Tract 5020.01, Santa Clara County, California",33,32,1
1000000US060855020013018,060855020013018,"Block 3018, Block Group 3, Census Tract 5020.01, Santa Clara County, California",12,12,0
1000000US060855020013019,060855020013019,"Block 3019, Block Group 3, Census Tract 5020.01, Santa Clara County, California",19,19,0
1000000US060855020013020,060855020013020,"Block 3020, Block Group 3, Census Tract 5020.01, Santa Clara County, California",22,22,0
1000000US060855020013021,060855020013021,"Block 3021, Block Group 3, Census Tract 5020.01, Santa Clara County, California",24,24,0
1000000US060855020013022,060855020013022,"Block 3022, Block Group 3, Census Tract 5020.01, Santa Clara County, California",35,34,1
1000000US060855020013023,060855020013023,"Block 3023, Block Group 3, Census Tract 5020.01, Santa Clara County, California",17,15,2
1000000US060855020013024,060855020013024,"Block 3024, Block Group 3, Census Tract 5020.01, Santa Clara County, California",11,11,0
1000000US060855020013025,060855020013025,"Block 3025, Block Group 3, Census Tract 5020.01, Santa Clara County, California",0,0,0
1000000US060855020013026,060855020013026,"Block 3026, Block Group 3, Census Tract 5020.01, Santa Clara County, California",0,0,0
1000000US060855020013027,060855020013027,"Block 3027, Block Group 3, Census Tract 5020.01, Santa Clara County, California",0,0,0
1000000US060855020014000,060855020014000,"Block 4000, Block Group 4, Census Tract 5020.01, Santa Clara County, California",0,0,0
1000000US060855020014001,060855020014001,"Block 4001, Block Group 4, Census Tract 5020.01, Santa Clara County, California",95,90,5
1000000US060855020014002,060855020014002,"Block 4002, Block Group 4, Census Tract 5020.01, Santa Clara County, California",118,110,8
1000000US060855020014003,060855020014003,"Block 4003, Block Group 4, Census Tract 5020.01, Santa Clara County, California",0,0,0
1000000US060855020014004,060855020014004,"Block 4004, Block Group 4, Census Tract 5020.01, Santa Clara County, California",107,100,7
1000000US060855020014005,060855020014005,"Block 4005, Block Group 4, Census Tract 5020.01, Santa Clara County, California",8,8,0
1000000US060855020014006,060855020014006,"Block 4006, Block Group 4, Census Tract 5020.01, Santa Clara County, California",37,34,3
1000000US060855020014007,060855020014007,"Block 4007, Block Group 4, Census Tract 5020.01, Santa Clara County, California",32,28,4
1000000US060855020014008,060855020014008,"Block 4008, Block Group 4, Census Tract 5020.01, Santa Clara County, California",0,0,0
1000000US060855020014009,060855020014009,"Block 4009, Block Group 4, Census Tract 5020.01, Santa Clara County, California",0,0,0
1000000US060855020014010,060855020014010,"Block 4010, Block Group 4, Census Tract 5020.01, Santa Clara County, California",0,0,0
1000000US060855020014011,060855020014011,"Block 4011, Block Group 4, Census Tract 5020.01, Santa Clara County, California",1,1,0
1000000US060855020014012,060855020014012,"Block 4012, Block Group 4, Census Tract 5020.01, Santa Clara County, California",3,2,1
1000000US060855020014013,060855020014013,"Block 4013, Block Group 4, Census Tract 5020.01, Santa Clara County, California",16,15,1
1000000US060855020014014,060855020014014,"Block 4014, Block Group 4, Census Tract 5020.01, Santa Clara County, California",3,3,0
1000000US060855020014015,060855020014015,"Block 4015, Block Group 4, Census Tract 5020.01, Santa Clara County, California",26,24,2
1000000US060855020014016,060855020014016,"Block 4016, Block Group 4, Census Tract 5020.01, Santa Clara County, California",35,31,4
1000000US060855020014017,060855020014017,"Block 4017, Block Group 4, Census Tract 5020.01, Santa Clara County, California",42,39,3
1000000US060855020014018,060855020014018,"Block 4018, Block Group 4, Census Tract 5020.01, Santa Clara County, California",43,39,4
1000000US060855020014019,060855020014019,"Block 4019, Block Group 4, Census Tract 5020.01, Santa Clara County, California",43,42,1
1000000US060855020014020,060855020014020,"Block 4020, Block Group 4, Census Tract 5020.01, Santa Clara County, California",42,35,7
1000000US060855020014021,060855020014021,"Block 4021, Block Group 4, Census Tract 5020.01, Santa Clara County, California",29,28,1
1000000US060855020014022,060855020014022,"Block 4022, Block Group 4, Census Tract 5020.01, Santa Clara County, California",2,1,1
1000000US060855020014023,060855020014023,"Block 4023, Block Group 4, Census Tract 5020.01, Santa Clara County, California",39,37,2
1000000US060855020014024,060855020014024,"Block 4024, Block Group 4, Census Tract 5020.01, Santa Clara County, California",57,54,3
1000000US060855020014025,060855020014025,"Block 4025, Block Group 4, Census Tract 5020.01, Santa Clara County, California",2,2,0
1000000US060855020014026,060855020014026,"Block 4026, Block Group 4, Census Tract 5020.01, Santa Clara County, California",0,0,0
1000000US060855020014027,060855020014027,"Block 4027, Block Group 4, Census Tract 5020.01, Santa Clara County, California",13,11,2
1000000US060855020021000,060855020021000,"Block 1000, Block Group 1, Census Tract 5020.02, Santa Clara County, California",0,0,0
1000000US060855020021001,060855020021001,"Block 1001, Block Group 1, Census Tract 5020.02, Santa Clara County, California",12,11,1
1000000US060855020021002,060855020021002,"Block 1002, Block Group 1, Census Tract 5020.02, Santa Clara County, California",31,31,0
1000000US060855020021003,060855020021003,"Block 1003, Block Group 1, Census Tract 5020.02, Santa Clara County, California",28,25,3
1000000US060855020021004,060855020021004,"Block 1004, Block Group 1, Census Tract 5020.02, Santa Clara County, California",32,30,2
1000000US060855020021005,060855020021005,"Block 1005, Block Group 1, Census Tract 5020.02, Santa Clara County, California",36,33,3
1000000US060855020021006,060855020021006,"Block 1006, Block Group 1, Census Tract 5020.02, Santa Clara County, California",3,3,0
1000000US060855020021007,060855020021007,"Block 1007, Block Group 1, Census Tract 5020.02, Santa Clara County, California",45,41,4
1000000US060855020021008,060855020021008,"Block 1008, Block Group 1, Census Tract 5020.02, Santa Clara County, California",10,9,1
1000000US060855020021009,060855020021009,"Block 1009, Block Group 1, Census Tract 5020.02, Santa Clara County, California",54,43,11
1000000US060855020021010,060855020021010,"Block 1010, Block Group 1, Census Tract 5020.02, Santa Clara County, California",10,7,3
1000000US060855020021011,060855020021011,"Block 1011, Block Group 1, Census Tract 5020.02, Santa Clara County, California",33,33,0
1000000US060855020022000,060855020022000,"Block 2000, Block Group 2, Census Tract 5020.02, Santa Clara County, California",0,0,0
1000000US060855020022001,060855020022001,"Block 2001, Block Group 2, Census Tract 5020.02, Santa Clara County, California",75,66,9
1000000US060855020022002,060855020022002,"Block 2002, Block Group 2, Census Tract 5020.02, Santa Clara County, California",2,2,0
1000000US060855020022003,060855020022003,"Block 2003, Block Group 2, Census Tract 5020.02, Santa Clara County, California",61,58,3
1000000US060855020022004,060855020022004,"Block 2004, Block Group 2, Census Tract 5020.02, Santa Clara County, California",16,15,1
1000000US060855020022005,060855020022005,"Block 2005, Block Group 2, Census Tract 5020.02, Santa Clara County, California",77,71,6
1000000US060855020022006,060855020022006,"Block 2006, Block Group 2, Census Tract 5020.02, Santa Clara County, California",1,1,0
1000000US060855020022007,060855020022007,"Block 2007, Block Group 2, Census Tract 5020.02, Santa Clara County, California",44,37,7
1000000US060855020022008,060855020022008,"Block 2008, Block Group 2, Census Tract 5020.02, Santa Clara County, California",0,0,0
1000000US060855020022009,060855020022009,"Block 2009, Block Group 2, Census Tract 5020.02, Santa Clara County, California",3,2,1
1000000US060855020022010,060855020022010,"Block 2010, Block Group 2, Census Tract 5020.02, Santa Clara County, California",21,18,3
1000000US060855020022011,060855020022011,"Block 2011, Block Group 2, Census Tract 5020.02, Santa Clara County, California",66,63,3
1000000US060855020022012,060855020022012,"Block 2012, Block Group 2, Census Tract 5020.02, Santa Clara County, California",18,18,0
1000000US060855020022013,060855020022013,"Block 2013, Block Group 2, Census Tract 5020.02, Santa Clara County, California",27,27,0
1000000US060855020022014,060855020022014,"Block 2014, Block Group 2, Census Tract 5020.02, Santa Clara County, California",28,24,4
1000000US060855020022015,060855020022015,"Block 2015, Block Group 2, Census Tract 5020.02, Santa Clara County, California",52,47,5
1000000US060855020022016,060855020022016,"Block 2016, Block Group 2, Census Tract 5020.02, Santa Clara County, California",25,20,5
1000000US060855020022017,060855020022017,"Block 2017, Block Group 2, Census Tract 5020.02, Santa Clara County, California",0,0,0
1000000US060855020023000,060855020023000,"Block 3000, Block Group 3, Census Tract 5020.02, Santa Clara County, California",25,22,3
1000000US060855020023001,060855020023001,"Block 3001, Block Group 3, Census Tract 5020.02, Santa Clara County, California",61,55,6
1000000US060855020023002,060855020023002,"Block 3002, Block Group 3, Census Tract 5020.02, Santa Clara County, California",19,18,1
1000000US060855020023003,060855020023003,"Block 3003, Block Group 3, Census Tract 5020.02, Santa Clara County, California",49,49,0
1000000US060855020023004,060855020023004,"Block 3004, Block Group 3, Census Tract 5020.02, Santa Clara County, California",67,62,5
1000000US060855020023005,060855020023005,"Block 3005, Block Group 3, Census Tract 5020.02, Santa Clara County, California",102,99,3
1000000US060855020023006,060855020023006,"Block 3006, Block Group 3, Census Tract 5020.02, Santa Clara County, California",56,52,4
1000000US060855020023007,060855020023007,"Block 3007, Block Group 3, Census Tract 5020.02, Santa Clara County, California",48,46,2
1000000US060855020023008,060855020023008,"Block 3008, Block Group 3, Census Tract 5020.02, Santa Clara County, California",1,1,0
1000000US060855020023009,060855020023009,"Block 3009, Block Group 3, Census Tract 5020.02, Santa Clara County, California",0,0,0
1000000US060855020023010,060855020023010,"Block 3010, Block Group 3, Census Tract 5020.02, Santa Clara County, California",2,2,0
1000000US060855020023011,060855020023011,"Block 3011, Block Group 3, Census Tract 5020.02, Santa Clara County, California",1,1,0
1000000US060855020023012,060855020023012,"Block 3012, Block Group 3, Census Tract 5020.02, Santa Clara County, California",79,73,6
1000000US060855020023013,060855020023013,"Block 3013, Block Group 3, Census Tract 5020.02, Santa Clara County, California",24,22,2
1000000US060855020023014,060855020023014,"Block 3014, Block Group 3, Census Tract 5020.02, Santa Clara County, California",0,0,0
1000000US060855020023015,060855020023015,"Block 3015, Block Group 3, Census Tract 5020.02, Santa Clara County, California",0,0,0
1000000US060855020023016,060855020023016,"Block 3016, Block Group 3, Census Tract 5020.02, Santa Clara County, California",30,29,1
1000000US060855020023017,060855020023017,"Block 3017, Block Group 3, Census Tract 5020.02, Santa Clara County, California",30,28,2
1000000US060855020023018,060855020023018,"Block 3018, Block Group 3, Census Tract 5020.02, Santa Clara County, California",9,9,0
1000000US060855020023019,060855020023019,"Block 3019, Block Group 3, Census Tract 5020.02, Santa Clara County, California",10,10,0
1000000US060855020023020,060855020023020,"Block 3020, Block Group 3, Census Tract 5020.02, Santa Clara County, California",24,24,0
1000000US060855020023021,060855020023021,"Block 3021, Block Group 3, Census Tract 5020.02, Santa Clara County, California",26,26,0
1000000US060855020023022,060855020023022,"Block 3022, Block Group 3, Census Tract 5020.02, Santa Clara County, California",23,21,2
1000000US060855020023023,060855020023023,"Block 3023, Block Group 3, Census Tract 5020.02, Santa Clara County, California",24,22,2
1000000US060855020023024,060855020023024,"Block 3024, Block Group 3, Census Tract 5020.02, Santa Clara County, California",24,23,1
1000000US060855020023025,060855020023025,"Block 3025, Block Group 3, Census Tract 5020.02, Santa Clara County, California",11,11,0
1000000US060855020023026,060855020023026,"Block 3026, Block Group 3, Census Tract 5020.02, Santa Clara County, California",3,3,0
1000000US060855020023027,060855020023027,"Block 3027, Block Group 3, Census Tract 5020.02, Santa Clara County, California",10,10,0
1000000US060855020023028,060855020023028,"Block 3028, Block Group 3, Census Tract 5020.02, Santa Clara County, California",11,11,0
1000000US060855020023029,060855020023029,"Block 3029, Block Group 3, Census Tract 5020.02, Santa Clara County, California",12,12,0
1000000US060855020023030,060855020023030,"Block 3030, Block Group 3, Census Tract 5020.02, Santa Clara County, California",12,12,0
1000000US060855020023031,060855020023031,"Block 3031, Block Group 3, Census Tract 5020.02, Santa Clara County, California",10,10,0
1000000US060855020023032,060855020023032,"Block 3032, Block Group 3, Census Tract 5020.02, Santa Clara County, California",5,5,0
1000000US060855020023033,060855020023033,"Block 3033, Block Group 3, Census Tract 5020.02, Santa Clara County, California",5,5,0
1000000US060855020023034,060855020023034,"Block 3034, Block Group 3, Census Tract 5020.02, Santa Clara County, California",0,0,0
1000000US060855020023035,060855020023035,"Block 3035, Block Group 3, Census Tract 5020.02, Santa Clara County, California",0,0,0
1000000US060855020023036,060855020023036,"Block 3036, Block Group 3, Census Tract 5020.02, Santa Clara County, California",0,0,0
1000000US060855020023037,060855020023037,"Block 3037, Block Group 3, Census Tract 5020.02, Santa Clara County, California",30,26,4
1000000US060855020023038,060855020023038,"Block 3038, Block Group 3, Census Tract 5020.02, Santa Clara County, California",0,0,0
1000000US060855020023039,060855020023039,"Block 3039, Block Group 3, Census Tract 5020.02, Santa Clara County, California",0,0,0
1000000US060855020023040,060855020023040,"Block 3040, Block Group 3, Census Tract 5020.02, Santa Clara County, California",0,0,0
1000000US060855021011000,060855021011000,"Block 1000, Block Group 1, Census Tract 5021.01, Santa Clara County, California",4,4,0
1000000US060855021011001,060855021011001,"Block 1001, Block Group 1, Census Tract 5021.01, Santa Clara County, California",46,45,1
1000000US060855021011002,060855021011002,"Block 1002, Block Group 1, Census Tract 5021.01, Santa Clara County, California",14,10,4
1000000US060855021011003,060855021011003,"Block 1003, Block Group 1, Census Tract 5021.01, Santa Clara County, California",0,0,0
1000000US060855021011004,060855021011004,"Block 1004, Block Group 1, Census Tract 5021.01, Santa Clara County, California",0,0,0
1000000US060855021011005,060855021011005,"Block 1005, Block Group 1, Census Tract 5021.01, Santa Clara County, California",17,13,4
1000000US060855021011006,060855021011006,"Block 1006, Block Group 1, Census Tract 5021.01, Santa Clara County, California",76,68,8
1000000US060855021011007,060855021011007,"Block 1007, Block Group 1, Census Tract 5021.01, Santa Clara County, California",5,5,0
1000000US060855021011008,060855021011008,"Block 1008, Block Group 1, Census Tract 5021.01, Santa Clara County, California",112,103,9
1000000US060855021011009,060855021011009,"Block 1009, Block Group 1, Census Tract 5021.01, Santa Clara County, California",144,142,2
1000000US060855021011010,060855021011010,"Block 1010, Block Group 1, Census Tract 5021.01, Santa Clara County, California",35,35,0
1000000US060855021011011,060855021011011,"Block 1011, Block Group 1, Census Tract 5021.01, Santa Clara County, California",14,14,0
1000000US060855021011012,060855021011012,"Block 1012, Block Group 1, Census Tract 5021.01, Santa Clara County, California",0,0,0
1000000US060855021011013,060855021011013,"Block 1013, Block Group 1, Census Tract 5021.01, Santa Clara County, California",0,0,0
1000000US060855021011014,060855021011014,"Block 1014, Block Group 1, Census Tract 5021.01, Santa Clara County, California",0,0,0
1000000US060855021011015,060855021011015,"Block 1015, Block Group 1, Census Tract 5021.01, Santa Clara County, California",0,0,0
1000000US060855021011016,060855021011016,"Block 1016, Block Group 1, Census Tract 5021.01, Santa Clara County, California",0,0,0
1000000US060855021011017,060855021011017,"Block 1017, Block Group 1, Census Tract 5021.01, Santa Clara County, California",0,0,0
1000000US060855021011018,060855021011018,"Block 1018, Block Group 1, Census Tract 5021.01, Santa Clara County, California",0,0,0
1000000US060855021011019,060855021011019,"Block 1019, Block Group 1, Census Tract 5021.01, Santa Clara County, California",0,0,0
1000000US060855021011020,060855021011020,"Block 1020, Block Group 1, Census Tract 5021.01, Santa Clara County, California",123,117,6
1000000US060855021011021,060855021011021,"Block 1021, Block Group 1, Census Tract 5021.01, Santa Clara County, California",22,22,0
1000000US060855021012000,060855021012000,"Block 2000, Block Group 2, Census Tract 5021.01, Santa Clara County, California",48,43,5
1000000US060855021012001,060855021012001,"Block 2001, Block Group 2, Census Tract 5021.01, Santa Clara County, California",34,34,0
1000000US060855021012002,060855021012002,"Block 2002, Block Group 2, Census Tract 5021.01, Santa Clara County, California",52,51,1
1000000US060855021012003,060855021012003,"Block 2003, Block Group 2, Census Tract 5021.01, Santa Clara County, California",15,15,0
1000000US060855021012004,060855021012004,"Block 2004, Block Group 2, Census Tract 5021.01, Santa Clara County, California",0,0,0
1000000US060855021012005,060855021012005,"Block 2005, Block Group 2, Census Tract 5021.01, Santa Clara County, California",18,17,1
1000000US060855021012006,060855021012006,"Block 2006, Block Group 2, Census Tract 5021.01, Santa Clara County, California",14,13,1
1000000US060855021012007,060855021012007,"Block 2007, Block Group 2, Census Tract 5021.01, Santa Clara County, California",27,26,1
1000000US060855021012008,060855021012008,"Block 2008, Block Group 2, Census Tract 5021.01, Santa Clara County, California",16,16,0
1000000US060855021012009,060855021012009,"Block 2009, Block Group 2, Census Tract 5021.01, Santa Clara County, California",45,45,0
1000000US060855021012010,060855021012010,"Block 2010, Block Group 2, Census Tract 5021.01, Santa Clara County, California",41,41,0
1000000US060855021012011,060855021012011,"Block 2011, Block Group 2, Census Tract 5021.01, Santa Clara County, California",26,26,0
1000000US060855021013000,060855021013000,"Block 3000, Block Group 3, Census Tract 5021.01, Santa Clara County, California",21,21,0
1000000US060855021013001,060855021013001,"Block 3001, Block Group 3, Census Tract 5021.01, Santa Clara County, California",10,10,0
1000000US060855021013002,060855021013002,"Block 3002, Block Group 3, Census Tract 5021.01, Santa Clara County, California",48,48,0
1000000US060855021013003,060855021013003,"Block 3003, Block Group 3, Census Tract 5021.01, Santa Clara County, California",0,0,0
1000000US060855021013004,060855021013004,"Block 3004, Block Group 3, Census Tract 5021.01, Santa Clara County, California",16,14,2
1000000US060855021013005,060855021013005,"Block 3005, Block Group 3, Census Tract 5021.01, Santa Clara County, California",16,16,0
1000000US060855021013006,060855021013006,"Block 3006, Block Group 3, Census Tract 5021.01, Santa Clara County, California",108,106,2
1000000US060855021013007,060855021013007,"Block 3007, Block Group 3, Census Tract 5021.01, Santa Clara County, California",80,78,2
1000000US060855021013008,060855021013008,"Block 3008, Block Group 3, Census Tract 5021.01, Santa Clara County, California",0,0,0
1000000US060855021013009,060855021013009,"Block 3009, Block Group 3, Census Tract 5021.01, Santa Clara County, California",1,1,0
1000000US060855021013010,060855021013010,"Block 3010, Block Group 3, Census Tract 5021.01, Santa Clara County, California",24,24,0
1000000US060855021013011,060855021013011,"Block 3011, Block Group 3, Census Tract 5021.01, Santa Clara County, California",55,54,1
1000000US060855021013012,060855021013012,"Block 3012, Block Group 3, Census Tract 5021.01, Santa Clara County, California",15,15,0
1000000US060855021013013,060855021013013,"Block 3013, Block Group 3, Census Tract 5021.01, Santa Clara County, California",32,31,1
1000000US060855021013014,060855021013014,"Block 3014, Block Group 3, Census Tract 5021.01, Santa Clara County, California",18,18,0
1000000US060855021013015,060855021013015,"Block 3015, Block Group 3, Census Tract 5021.01, Santa Clara County, California",25,24,1
1000000US060855021013016,060855021013016,"Block 3016, Block Group 3, Census Tract 5021.01, Santa Clara County, California",17,16,1
1000000US060855021013017,060855021013017,"Block 3017, Block Group 3, Census Tract 5021.01, Santa Clara County, California",72,68,4
1000000US060855021013018,060855021013018,"Block 3018, Block Group 3, Census Tract 5021.01, Santa Clara County, California",66,65,1
1000000US060855021013019,060855021013019,"Block 3019, Block Group 3, Census Tract 5021.01, Santa Clara County, California",29,29,0
1000000US060855021013020,060855021013020,"Block 3020, Block Group 3, Census Tract 5021.01, Santa Clara County, California",125,118,7
1000000US060855021013021,060855021013021,"Block 3021, Block Group 3, Census Tract 5021.01, Santa Clara County, California",0,0,0
1000000US060855021013022,060855021013022,"Block 3022, Block Group 3, Census Tract 5021.01, Santa Clara County, California",153,146,7
1000000US060855021013023,060855021013023,"Block 3023, Block Group 3, Census Tract 5021.01, Santa Clara County, California",29,26,3
1000000US060855021013024,060855021013024,"Block 3024, Block Group 3, Census Tract 5021.01, Santa Clara County, California",16,15,1
1000000US060855021013025,060855021013025,"Block 3025, Block Group 3, Census Tract 5021.01, Santa Clara County, California",17,16,1
1000000US060855021013026,060855021013026,"Block 3026, Block Group 3, Census Tract 5021.01, Santa Clara County, California",31,29,2
1000000US060855021013027,060855021013027,"Block 3027, Block Group 3, Census Tract 5021.01, Santa Clara County, California",16,15,1
1000000US060855021013028,060855021013028,"Block 3028, Block Group 3, Census Tract 5021.01, Santa Clara County, California",0,0,0
1000000US060855021013029,060855021013029,"Block 3029, Block Group 3, Census Tract 5021.01, Santa Clara County, California",0,0,0
1000000US060855021013030,060855021013030,"Block 3030, Block Group 3, Census Tract 5021.01, Santa Clara County, California",0,0,0
1000000US060855021013031,060855021013031,"Block 3031, Block Group 3, Census Tract 5021.01, Santa Clara County, California",0,0,0
1000000US060855021013032,060855021013032,"Block 3032, Block Group 3, Census Tract 5021.01, Santa Clara County, California",0,0,0
1000000US060855021013033,060855021013033,"Block 3033, Block Group 3, Census Tract 5021.01, Santa Clara County, California",0,0,0
1000000US060855021013034,060855021013034,"Block 3034, Block Group 3, Census Tract 5021.01, Santa Clara County, California",0,0,0
1000000US060855021021000,060855021021000,"Block 1000, Block Group 1, Census Tract 5021.02, Santa Clara County, California",0,0,0
1000000US060855021021001,060855021021001,"Block 1001, Block Group 1, Census Tract 5021.02, Santa Clara County, California",0,0,0
1000000US060855021021002,060855021021002,"Block 1002, Block Group 1, Census Tract 5021.02, Santa Clara County, California",0,0,0
1000000US060855021021003,060855021021003,"Block 1003, Block Group 1, Census Tract 5021.02, Santa Clara County, California",0,0,0
1000000US060855021021004,060855021021004,"Block 1004, Block Group 1, Census Tract 5021.02, Santa Clara County, California",0,0,0
1000000US060855021021005,060855021021005,"Block 1005, Block Group 1, Census Tract 5021.02, Santa Clara County, California",0,0,0
1000000US060855021021006,060855021021006,"Block 1006, Block Group 1, Census Tract 5021.02, Santa Clara County, California",70,68,2
1000000US060855021021007,060855021021007,"Block 1007, Block Group 1, Census Tract 5021.02, Santa Clara County, California",127,124,3
1000000US060855021021008,060855021021008,"Block 1008, Block Group 1, Census Tract 5021.02, Santa Clara County, California",3,3,0
1000000US060855021021009,060855021021009,"Block 1009, Block Group 1, Census Tract 5021.02, Santa Clara County, California",0,0,0
1000000US060855021021010,060855021021010,"Block 1010, Block Group 1, Census Tract 5021.02, Santa Clara County, California",1,1,0
1000000US060855021021011,060855021021011,"Block 1011, Block Group 1, Census Tract 5021.02, Santa Clara County, California",1,1,0
1000000US060855021021012,060855021021012,"Block 1012, Block Group 1, Census Tract 5021.02, Santa Clara County, California",21,21,0
1000000US060855021021013,060855021021013,"Block 1013, Block Group 1, Census Tract 5021.02, Santa Clara County, California",22,22,0
1000000US060855021021014,060855021021014,"Block 1014, Block Group 1, Census Tract 5021.02, Santa Clara County, California",44,37,7
1000000US060855021021015,060855021021015,"Block 1015, Block Group 1, Census Tract 5021.02, Santa Clara County, California",51,49,2
1000000US060855021021016,060855021021016,"Block 1016, Block Group 1, Census Tract 5021.02, Santa Clara County, California",434,428,6
1000000US060855021022000,060855021022000,"Block 2000, Block Group 2, Census Tract 5021.02, Santa Clara County, California",216,200,16
1000000US060855021022001,060855021022001,"Block 2001, Block Group 2, Census Tract 5021.02, Santa Clara County, California",89,85,4
1000000US060855021022002,060855021022002,"Block 2002, Block Group 2, Census Tract 5021.02, Santa Clara County, California",75,72,3
1000000US060855021022003,060855021022003,"Block 2003, Block Group 2, Census Tract 5021.02, Santa Clara County, California",88,79,9
1000000US060855021022004,060855021022004,"Block 2004, Block Group 2, Census Tract 5021.02, Santa Clara County, California",48,48,0
1000000US060855021022005,060855021022005,"Block 2005, Block Group 2, Census Tract 5021.02, Santa Clara County, California",11,11,0
1000000US060855021022006,060855021022006,"Block 2006, Block Group 2, Census Tract 5021.02, Santa Clara County, California",10,10,0
1000000US060855021022007,060855021022007,"Block 2007, Block Group 2, Census Tract 5021.02, Santa Clara County, California",34,34,0
1000000US060855021022008,060855021022008,"Block 2008, Block Group 2, Census Tract 5021.02, Santa Clara County, California",34,32,2
1000000US060855021022009,060855021022009,"Block 2009, Block Group 2, Census Tract 5021.02, Santa Clara County, California",99,95,4
1000000US060855021022010,060855021022010,"Block 2010, Block Group 2, Census Tract 5021.02, Santa Clara County, California",56,56,0
1000000US060855021022011,060855021022011,"Block 2011, Block Group 2, Census Tract 5021.02, Santa Clara County, California",12,12,0
1000000US060855021022012,060855021022012,"Block 2012, Block Group 2, Census Tract 5021.02, Santa Clara County, California",40,40,0
1000000US060855021022013,060855021022013,"Block 2013, Block Group 2, Census Tract 5021.02, Santa Clara County, California",42,41,1
1000000US060855021022014,060855021022014,"Block 2014, Block Group 2, Census Tract 5021.02, Santa Clara County, California",33,30,3
1000000US060855021022015,060855021022015,"Block 2015, Block Group 2, Census Tract 5021.02, Santa Clara County, California",30,29,1
1000000US060855021023000,060855021023000,"Block 3000, Block Group 3, Census Tract 5021.02, Santa Clara County, California",345,327,18
1000000US060855021023001,060855021023001,"Block 3001, Block Group 3, Census Tract 5021.02, Santa Clara County, California",18,18,0
1000000US060855021023002,060855021023002,"Block 3002, Block Group 3, Census Tract 5021.02, Santa Clara County, California",137,128,9
1000000US060855021023003,060855021023003,"Block 3003, Block Group 3, Census Tract 5021.02, Santa Clara County, California",0,0,0
1000000US060855021023004,060855021023004,"Block 3004, Block Group 3, Census Tract 5021.02, Santa Clara County, California",87,86,1
1000000US060855021023005,060855021023005,"Block 3005, Block Group 3, Census Tract 5021.02, Santa Clara County, California",22,22,0
1000000US060855021024000,060855021024000,"Block 4000, Block Group 4, Census Tract 5021.02, Santa Clara County, California",192,185,7
1000000US060855021024001,060855021024001,"Block 4001, Block Group 4, Census Tract 5021.02, Santa Clara County, California",20,20,0
1000000US060855021024002,060855021024002,"Block 4002, Block Group 4, Census Tract 5021.02, Santa Clara County, California",102,97,5
1000000US060855021024003,060855021024003,"Block 4003, Block Group 4, Census Tract 5021.02, Santa Clara County, California",36,35,1
1000000US060855021024004,060855021024004,"Block 4004, Block Group 4, Census Tract 5021.02, Santa Clara County, California",26,25,1
1000000US060855021024005,060855021024005,"Block 4005, Block Group 4, Census Tract 5021.02, Santa Clara County, California",28,28,0
1000000US060855022011000,060855022011000,"Block 1000, Block Group 1, Census Tract 5022.01, Santa Clara County, California",0,0,0
1000000US060855022011001,060855022011001,"Block 1001, Block Group 1, Census Tract 5022.01, Santa Clara County, California",91,55,36
1000000US060855022011002,060855022011002,"Block 1002, Block Group 1, Census Tract 5022.01, Santa Clara County, California",112,104,8
1000000US060855022011003,060855022011003,"Block 1003, Block Group 1, Census Tract 5022.01, Santa Clara County, California",0,0,0
1000000US060855022011004,060855022011004,"Block 1004, Block Group 1, Census Tract 5022.01, Santa Clara County, California",1,1,0
1000000US060855022011005,060855022011005,"Block 1005, Block Group 1, Census Tract 5022.01, Santa Clara County, California",247,224,23
1000000US060855022011006,060855022011006,"Block 1006, Block Group 1, Census Tract 5022.01, Santa Clara County, California",121,102,19
1000000US060855022011007,060855022011007,"Block 1007, Block Group 1, Census Tract 5022.01, Santa Clara County, California",31,31,0
1000000US060855022011008,060855022011008,"Block 1008, Block Group 1, Census Tract 5022.01, Santa Clara County, California",0,0,0
1000000US060855022011009,060855022011009,"Block 1009, Block Group 1, Census Tract 5022.01, Santa Clara County, California",19,19,0
1000000US060855022011010,060855022011010,"Block 1010, Block Group 1, Census Tract 5022.01, Santa Clara County, California",6,6,0
1000000US060855022011011,060855022011011,"Block 1011, Block Group 1, Census Tract 5022.01, Santa Clara County, California",54,53,1
1000000US060855022011012,060855022011012,"Block 1012, Block Group 1, Census Tract 5022.01, Santa Clara County, California",28,27,1
1000000US060855022011013,060855022011013,"Block 1013, Block Group 1, Census Tract 5022.01, Santa Clara County, California",1,1,0
1000000US060855022011014,060855022011014,"Block 1014, Block Group 1, Census Tract 5022.01, Santa Clara County, California",378,363,15
1000000US060855022011015,060855022011015,"Block 1015, Block Group 1, Census Tract 5022.01, Santa Clara County, California",0,0,0
1000000US060855022011016,060855022011016,"Block 1016, Block Group 1, Census Tract 5022.01, Santa Clara County, California",42,40,2
1000000US060855022011017,060855022011017,"Block 1017, Block Group 1, Census Tract 5022.01, Santa Clara County, California",28,28,0
1000000US060855022011018,060855022011018,"Block 1018, Block Group 1, Census Tract 5022.01, Santa Clara County, California",60,60,0
1000000US060855022011019,060855022011019,"Block 1019, Block Group 1, Census Tract 5022.01, Santa Clara County, California",62,61,1
1000000US060855022011020,060855022011020,"Block 1020, Block Group 1, Census Tract 5022.01, Santa Clara County, California",0,0,0
1000000US060855022011021,060855022011021,"Block 1021, Block Group 1, Census Tract 5022.01, Santa Clara County, California",124,120,4
1000000US060855022011022,060855022011022,"Block 1022, Block Group 1, Census Tract 5022.01, Santa Clara County, California",99,92,7
1000000US060855022012000,060855022012000,"Block 2000, Block Group 2, Census Tract 5022.01, Santa Clara County, California",0,0,0
1000000US060855022012001,060855022012001,"Block 2001, Block Group 2, Census Tract 5022.01, Santa Clara County, California",0,0,0
1000000US060855022012002,060855022012002,"Block 2002, Block Group 2, Census Tract 5022.01, Santa Clara County, California",190,181,9
1000000US060855022012003,060855022012003,"Block 2003, Block Group 2, Census Tract 5022.01, Santa Clara County, California",156,143,13
1000000US060855022012004,060855022012004,"Block 2004, Block Group 2, Census Tract 5022.01, Santa Clara County, California",934,915,19
1000000US060855022012005,060855022012005,"Block 2005, Block Group 2, Census Tract 5022.01, Santa Clara County, California",0,0,0
1000000US060855022012006,060855022012006,"Block 2006, Block Group 2, Census Tract 5022.01, Santa Clara County, California",48,44,4
1000000US060855022021000,060855022021000,"Block 1000, Block Group 1, Census Tract 5022.02, Santa Clara County, California",335,316,19
1000000US060855022021001,060855022021001,"Block 1001, Block Group 1, Census Tract 5022.02, Santa Clara County, California",79,78,1
1000000US060855022021002,060855022021002,"Block 1002, Block Group 1, Census Tract 5022.02, Santa Clara County, California",24,24,0
1000000US060855022021003,060855022021003,"Block 1003, Block Group 1, Census Tract 5022.02, Santa Clara County, California",29,28,1
1000000US060855022021004,060855022021004,"Block 1004, Block Group 1, Census Tract 5022.02, Santa Clara County, California",64,62,2
1000000US060855022021005,060855022021005,"Block 1005, Block Group 1, Census Tract 5022.02, Santa Clara County, California",0,0,0
1000000US060855022021006,060855022021006,"Block 1006, Block Group 1, Census Tract 5022.02, Santa Clara County, California",36,35,1
1000000US060855022021007,060855022021007,"Block 1007, Block Group 1, Census Tract 5022.02, Santa Clara County, California",6,6,0
1000000US060855022021008,060855022021008,"Block 1008, Block Group 1, Census Tract 5022.02, Santa Clara County, California",32,30,2
1000000US060855022021009,060855022021009,"Block 1009, Block Group 1, Census Tract 5022.02, Santa Clara County, California",8,7,1
1000000US060855022021010,060855022021010,"Block 1010, Block Group 1, Census Tract 5022.02, Santa Clara County, California",162,155,7
1000000US060855022021011,060855022021011,"Block 1011, Block Group 1, Census Tract 5022.02, Santa Clara County, California",0,0,0
1000000US060855022021012,060855022021012,"Block 1012, Block Group 1, Census Tract 5022.02, Santa Clara County, California",0,0,0
1000000US060855022021013,060855022021013,"Block 1013, Block Group 1, Census Tract 5022.02, Santa Clara County, California",0,0,0
1000000US060855022021014,060855022021014,"Block 1014, Block Group 1, Census Tract 5022.02, Santa Clara County, California",13,13,0
1000000US060855022021015,060855022021015,"Block 1015, Block Group 1, Census Tract 5022.02, Santa Clara County, California",0,0,0
1000000US060855022021016,060855022021016,"Block 1016, Block Group 1, Census Tract 5022.02, Santa Clara County, California",0,0,0
1000000US060855022022000,060855022022000,"Block 2000, Block Group 2, Census Tract 5022.02, Santa Clara County, California",96,89,7
1000000US060855022022001,060855022022001,"Block 2001, Block Group 2, Census Tract 5022.02, Santa Clara County, California",19,17,2
1000000US060855022022002,060855022022002,"Block 2002, Block Group 2, Census Tract 5022.02, Santa Clara County, California",0,0,0
1000000US060855022022003,060855022022003,"Block 2003, Block Group 2, Census Tract 5022.02, Santa Clara County, California",8,8,0
1000000US060855022022004,060855022022004,"Block 2004, Block Group 2, Census Tract 5022.02, Santa Clara County, California",0,0,0
1000000US060855022022005,060855022022005,"Block 2005, Block Group 2, Census Tract 5022.02, Santa Clara County, California",0,0,0
1000000US060855022022006,060855022022006,"Block 2006, Block Group 2, Census Tract 5022.02, Santa Clara County, California",0,0,0
1000000US060855022022007,060855022022007,"Block 2007, Block Group 2, Census Tract 5022.02, Santa Clara County, California",11,11,0
1000000US060855022022008,060855022022008,"Block 2008, Block Group 2, Census Tract 5022.02, Santa Clara County, California",24,23,1
1000000US060855022022009,060855022022009,"Block 2009, Block Group 2, Census Tract 5022.02, Santa Clara County, California",26,26,0
1000000US060855022022010,060855022022010,"Block 2010, Block Group 2, Census Tract 5022.02, Santa Clara County, California",26,23,3
1000000US060855022022011,060855022022011,"Block 2011, Block Group 2, Census Tract 5022.02, Santa Clara County, California",22,21,1
1000000US060855022022012,060855022022012,"Block 2012, Block Group 2, Census Tract 5022.02, Santa Clara County, California",5,5,0
1000000US060855022022013,060855022022013,"Block 2013, Block Group 2, Census Tract 5022.02, Santa Clara County, California",38,33,5
1000000US060855022022014,060855022022014,"Block 2014, Block Group 2, Census Tract 5022.02, Santa Clara County, California",6,2,4
1000000US060855022022015,060855022022015,"Block 2015, Block Group 2, Census Tract 5022.02, Santa Clara County, California",23,22,1
1000000US060855022022016,060855022022016,"Block 2016, Block Group 2, Census Tract 5022.02, Santa Clara County, California",22,22,0
1000000US060855022022017,060855022022017,"Block 2017, Block Group 2, Census Tract 5022.02, Santa Clara County, California",24,22,2
1000000US060855022022018,060855022022018,"Block 2018, Block Group 2, Census Tract 5022.02, Santa Clara County, California",17,16,1
1000000US060855022023000,060855022023000,"Block 3000, Block Group 3, Census Tract 5022.02, Santa Clara County, California",125,108,17
1000000US060855022023001,060855022023001,"Block 3001, Block Group 3, Census Tract 5022.02, Santa Clara County, California",18,18,0
1000000US060855022023002,060855022023002,"Block 3002, Block Group 3, Census Tract 5022.02, Santa Clara County, California",26,25,1
1000000US060855022023003,060855022023003,"Block 3003, Block Group 3, Census Tract 5022.02, Santa Clara County, California",0,0,0
1000000US060855022023004,060855022023004,"Block 3004, Block Group 3, Census Tract 5022.02, Santa Clara County, California",18,18,0
1000000US060855022023005,060855022023005,"Block 3005, Block Group 3, Census Tract 5022.02, Santa Clara County, California",0,0,0
1000000US060855022023006,060855022023006,"Block 3006, Block Group 3, Census Tract 5022.02, Santa Clara County, California",28,28,0
1000000US060855022023007,060855022023007,"Block 3007, Block Group 3, Census Tract 5022.02, Santa Clara County, California",32,31,1
1000000US060855022023008,060855022023008,"Block 3008, Block Group 3, Census Tract 5022.02, Santa Clara County, California",39,37,2
1000000US060855022023009,060855022023009,"Block 3009, Block Group 3, Census Tract 5022.02, Santa Clara County, California",20,20,0
1000000US060855023011000,060855023011000,"Block 1000, Block Group 1, Census Tract 5023.01, Santa Clara County, California",17,17,0
1000000US060855023011001,060855023011001,"Block 1001, Block Group 1, Census Tract 5023.01, Santa Clara County, California",48,46,2
1000000US060855023011002,060855023011002,"Block 1002, Block Group 1, Census Tract 5023.01, Santa Clara County, California",20,19,1
1000000US060855023011003,060855023011003,"Block 1003, Block Group 1, Census Tract 5023.01, Santa Clara County, California",44,44,0
1000000US060855023011004,060855023011004,"Block 1004, Block Group 1, Census Tract 5023.01, Santa Clara County, California",63,62,1
1000000US060855023011005,060855023011005,"Block 1005, Block Group 1, Census Tract 5023.01, Santa Clara County, California",22,22,0
1000000US060855023011006,060855023011006,"Block 1006, Block Group 1, Census Tract 5023.01, Santa Clara County, California",35,35,0
1000000US060855023011007,060855023011007,"Block 1007, Block Group 1, Census Tract 5023.01, Santa Clara County, California",46,43,3
1000000US060855023011008,060855023011008,"Block 1008, Block Group 1, Census Tract 5023.01, Santa Clara County, California",26,25,1
1000000US060855023011009,060855023011009,"Block 1009, Block Group 1, Census Tract 5023.01, Santa Clara County, California",23,22,1
1000000US060855023011010,060855023011010,"Block 1010, Block Group 1, Census Tract 5023.01, Santa Clara County, California",29,29,0
1000000US060855023011011,060855023011011,"Block 1011, Block Group 1, Census Tract 5023.01, Santa Clara County, California",0,0,0
1000000US060855023011012,060855023011012,"Block 1012, Block Group 1, Census Tract 5023.01, Santa Clara County, California",170,164,6
1000000US060855023011013,060855023011013,"Block 1013, Block Group 1, Census Tract 5023.01, Santa Clara County, California",87,80,7
1000000US060855023011014,060855023011014,"Block 1014, Block Group 1, Census Tract 5023.01, Santa Clara County, California",36,35,1
1000000US060855023012000,060855023012000,"Block 2000, Block Group 2, Census Tract 5023.01, Santa Clara County, California",60,58,2
1000000US060855023012001,060855023012001,"Block 2001, Block Group 2, Census Tract 5023.01, Santa Clara County, California",19,19,0
1000000US060855023012002,060855023012002,"Block 2002, Block Group 2, Census Tract 5023.01, Santa Clara County, California",18,18,0
1000000US060855023012003,060855023012003,"Block 2003, Block Group 2, Census Tract 5023.01, Santa Clara County, California",24,23,1
1000000US060855023012004,060855023012004,"Block 2004, Block Group 2, Census Tract 5023.01, Santa Clara County, California",26,26,0
1000000US060855023012005,060855023012005,"Block 2005, Block Group 2, Census Tract 5023.01, Santa Clara County, California",21,19,2
1000000US060855023012006,060855023012006,"Block 2006, Block Group 2, Census Tract 5023.01, Santa Clara County, California",16,15,1
1000000US060855023012007,060855023012007,"Block 2007, Block Group 2, Census Tract 5023.01, Santa Clara County, California",6,6,0
1000000US060855023012008,060855023012008,"Block 2008, Block Group 2, Census Tract 5023.01, Santa Clara County, California",13,12,1
1000000US060855023012009,060855023012009,"Block 2009, Block Group 2, Census Tract 5023.01, Santa Clara County, California",10,9,1
1000000US060855023012010,060855023012010,"Block 2010, Block Group 2, Census Tract 5023.01, Santa Clara County, California",25,24,1
1000000US060855023012011,060855023012011,"Block 2011, Block Group 2, Census Tract 5023.01, Santa Clara County, California",12,11,1
1000000US060855023012012,060855023012012,"Block 2012, Block Group 2, Census Tract 5023.01, Santa Clara County, California",20,19,1
1000000US060855023012013,060855023012013,"Block 2013, Block Group 2, Census Tract 5023.01, Santa Clara County, California",14,12,2
1000000US060855023012014,060855023012014,"Block 2014, Block Group 2, Census Tract 5023.01, Santa Clara County, California",18,17,1
1000000US060855023012015,060855023012015,"Block 2015, Block Group 2, Census Tract 5023.01, Santa Clara County, California",26,24,2
1000000US060855023012016,060855023012016,"Block 2016, Block Group 2, Census Tract 5023.01, Santa Clara County, California",145,141,4
1000000US060855023012017,060855023012017,"Block 2017, Block Group 2, Census Tract 5023.01, Santa Clara County, California",55,55,0
1000000US060855023012018,060855023012018,"Block 2018, Block Group 2, Census Tract 5023.01, Santa Clara County, California",21,21,0
1000000US060855023012019,060855023012019,"Block 2019, Block Group 2, Census Tract 5023.01, Santa Clara County, California",12,12,0
1000000US060855023012020,060855023012020,"Block 2020, Block Group 2, Census Tract 5023.01, Santa Clara County, California",25,25,0
1000000US060855023012021,060855023012021,"Block 2021, Block Group 2, Census Tract 5023.01, Santa Clara County, California",137,135,2
1000000US060855023021000,060855023021000,"Block 1000, Block Group 1, Census Tract 5023.02, Santa Clara County, California",164,152,12
1000000US060855023021001,060855023021001,"Block 1001, Block Group 1, Census Tract 5023.02, Santa Clara County, California",104,100,4
1000000US060855023021002,060855023021002,"Block 1002, Block Group 1, Census Tract 5023.02, Santa Clara County, California",43,42,1
1000000US060855023021003,060855023021003,"Block 1003, Block Group 1, Census Tract 5023.02, Santa Clara County, California",32,30,2
1000000US060855023021004,060855023021004,"Block 1004, Block Group 1, Census Tract 5023.02, Santa Clara County, California",34,34,0
1000000US060855023021005,060855023021005,"Block 1005, Block Group 1, Census Tract 5023.02, Santa Clara County, California",31,31,0
1000000US060855023021006,060855023021006,"Block 1006, Block Group 1, Census Tract 5023.02, Santa Clara County, California",26,25,1
1000000US060855023021007,060855023021007,"Block 1007, Block Group 1, Census Tract 5023.02, Santa Clara County, California",26,23,3
1000000US060855023021008,060855023021008,"Block 1008, Block Group 1, Census Tract 5023.02, Santa Clara County, California",11,11,0
1000000US060855023021009,060855023021009,"Block 1009, Block Group 1, Census Tract 5023.02, Santa Clara County, California",65,59,6
1000000US060855023021010,060855023021010,"Block 1010, Block Group 1, Census Tract 5023.02, Santa Clara County, California",15,15,0
1000000US060855023021011,060855023021011,"Block 1011, Block Group 1, Census Tract 5023.02, Santa Clara County, California",11,11,0
1000000US060855023021012,060855023021012,"Block 1012, Block Group 1, Census Tract 5023.02, Santa Clara County, California",12,11,1
1000000US060855023022000,060855023022000,"Block 2000, Block Group 2, Census Tract 5023.02, Santa Clara County, California",198,187,11
1000000US060855023022001,060855023022001,"Block 2001, Block Group 2, Census Tract 5023.02, Santa Clara County, California",13,13,0
1000000US060855023022002,060855023022002,"Block 2002, Block Group 2, Census Tract 5023.02, Santa Clara County, California",11,10,1
1000000US060855023022003,060855023022003,"Block 2003, Block Group 2, Census Tract 5023.02, Santa Clara County, California",23,23,0
1000000US060855023022004,060855023022004,"Block 2004, Block Group 2, Census Tract 5023.02, Santa Clara County, California",27,26,1
1000000US060855023022005,060855023022005,"Block 2005, Block Group 2, Census Tract 5023.02, Santa Clara County, California",336,323,13
1000000US060855023022006,060855023022006,"Block 2006, Block Group 2, Census Tract 5023.02, Santa Clara County, California",28,25,3
1000000US060855023022007,060855023022007,"Block 2007, Block Group 2, Census Tract 5023.02, Santa Clara County, California",28,28,0
1000000US060855023022008,060855023022008,"Block 2008, Block Group 2, Census Tract 5023.02, Santa Clara County, California",13,13,0
1000000US060855023022009,060855023022009,"Block 2009, Block Group 2, Census Tract 5023.02, Santa Clara County, California",21,21,0
1000000US060855023022010,060855023022010,"Block 2010, Block Group 2, Census Tract 5023.02, Santa Clara County, California",29,25,4
1000000US060855023022011,060855023022011,"Block 2011, Block Group 2, Census Tract 5023.02, Santa Clara County, California",2,2,0
1000000US060855024001000,060855024001000,"Block 1000, Block Group 1, Census Tract 5024, Santa Clara County, California",54,52,2
1000000US060855024001001,060855024001001,"Block 1001, Block Group 1, Census Tract 5024, Santa Clara County, California",57,55,2
1000000US060855024001002,060855024001002,"Block 1002, Block Group 1, Census Tract 5024, Santa Clara County, California",16,16,0
1000000US060855024001003,060855024001003,"Block 1003, Block Group 1, Census Tract 5024, Santa Clara County, California",16,16,0
1000000US060855024001004,060855024001004,"Block 1004, Block Group 1, Census Tract 5024, Santa Clara County, California",23,22,1
1000000US060855024001005,060855024001005,"Block 1005, Block Group 1, Census Tract 5024, Santa Clara County, California",31,30,1
1000000US060855024001006,060855024001006,"Block 1006, Block Group 1, Census Tract 5024, Santa Clara County, California",19,19,0
1000000US060855024001007,060855024001007,"Block 1007, Block Group 1, Census Tract 5024, Santa Clara County, California",10,9,1
1000000US060855024001008,060855024001008,"Block 1008, Block Group 1, Census Tract 5024, Santa Clara County, California",22,22,0
1000000US060855024001009,060855024001009,"Block 1009, Block Group 1, Census Tract 5024, Santa Clara County, California",18,18,0
1000000US060855024001010,060855024001010,"Block 1010, Block Group 1, Census Tract 5024, Santa Clara County, California",19,19,0
1000000US060855024002000,060855024002000,"Block 2000, Block Group 2, Census Tract 5024, Santa Clara County, California",31,31,0
1000000US060855024002001,060855024002001,"Block 2001, Block Group 2, Census Tract 5024, Santa Clara County, California",33,32,1
1000000US060855024002002,060855024002002,"Block 2002, Block Group 2, Census Tract 5024, Santa Clara County, California",72,67,5
1000000US060855024002003,060855024002003,"Block 2003, Block Group 2, Census Tract 5024, Santa Clara County, California",51,51,0
1000000US060855024002004,060855024002004,"Block 2004, Block Group 2, Census Tract 5024, Santa Clara County, California",12,10,2
1000000US060855024002005,060855024002005,"Block 2005, Block Group 2, Census Tract 5024, Santa Clara County, California",61,61,0
1000000US060855024002006,060855024002006,"Block 2006, Block Group 2, Census Tract 5024, Santa Clara County, California",19,19,0
1000000US060855024002007,060855024002007,"Block 2007, Block Group 2, Census Tract 5024, Santa Clara County, California",21,21,0
1000000US060855024003000,060855024003000,"Block 3000, Block Group 3, Census Tract 5024, Santa Clara County, California",59,57,2
1000000US060855024003001,060855024003001,"Block 3001, Block Group 3, Census Tract 5024, Santa Clara County, California",0,0,0
1000000US060855024003002,060855024003002,"Block 3002, Block Group 3, Census Tract 5024, Santa Clara County, California",48,45,3
1000000US060855024003003,060855024003003,"Block 3003, Block Group 3, Census Tract 5024, Santa Clara County, California",20,18,2
1000000US060855024003004,060855024003004,"Block 3004, Block Group 3, Census Tract 5024, Santa Clara County, California",53,52,1
1000000US060855024003005,060855024003005,"Block 3005, Block Group 3, Census Tract 5024, Santa Clara County, California",59,55,4
1000000US060855024003006,060855024003006,"Block 3006, Block Group 3, Census Tract 5024, Santa Clara County, California",53,52,1
1000000US060855024004000,060855024004000,"Block 4000, Block Group 4, Census Tract 5024, Santa Clara County, California",83,80,3
1000000US060855024004001,060855024004001,"Block 4001, Block Group 4, Census Tract 5024, Santa Clara County, California",25,25,0
1000000US060855024004002,060855024004002,"Block 4002, Block Group 4, Census Tract 5024, Santa Clara County, California",29,29,0
1000000US060855024004003,060855024004003,"Block 4003, Block Group 4, Census Tract 5024, Santa Clara County, California",21,20,1
1000000US060855024004004,060855024004004,"Block 4004, Block Group 4, Census Tract 5024, Santa Clara County, California",22,21,1
1000000US060855024004005,060855024004005,"Block 4005, Block Group 4, Census Tract 5024, Santa Clara County, California",30,27,3
1000000US060855024004006,060855024004006,"Block 4006, Block Group 4, Census Tract 5024, Santa Clara County, California",58,56,2
1000000US060855024004007,060855024004007,"Block 4007, Block Group 4, Census Tract 5024, Santa Clara County, California",72,70,2
1000000US060855024004008,060855024004008,"Block 4008, Block Group 4, Census Tract 5024, Santa Clara County, California",28,27,1
1000000US060855024004009,060855024004009,"Block 4009, Block Group 4, Census Tract 5024, Santa Clara County, California",20,19,1
1000000US060855024005000,060855024005000,"Block 5000, Block Group 5, Census Tract 5024, Santa Clara County, California",5,5,0
1000000US060855024005001,060855024005001,"Block 5001, Block Group 5, Census Tract 5024, Santa Clara County, California",91,89,2
1000000US060855024005002,060855024005002,"Block 5002, Block Group 5, Census Tract 5024, Santa Clara County, California",56,56,0
1000000US060855024005003,060855024005003,"Block 5003, Block Group 5, Census Tract 5024, Santa Clara County, California",43,42,1
1000000US060855024005004,060855024005004,"Block 5004, Block Group 5, Census Tract 5024, Santa Clara County, California",56,53,3
1000000US060855024005005,060855024005005,"Block 5005, Block Group 5, Census Tract 5024, Santa Clara County, California",33,32,1
1000000US060855024005006,060855024005006,"Block 5006, Block Group 5, Census Tract 5024, Santa Clara County, California",44,38,6
1000000US060855024005007,060855024005007,"Block 5007, Block Group 5, Census Tract 5024, Santa Clara County, California",57,56,1
1000000US060855024005008,060855024005008,"Block 5008, Block Group 5, Census Tract 5024, Santa Clara County, California",46,44,2
1000000US060855024005009,060855024005009,"Block 5009, Block Group 5, Census Tract 5024, Santa Clara County, California",57,54,3
1000000US060855024005010,060855024005010,"Block 5010, Block Group 5, Census Tract 5024, Santa Clara County, California",77,75,2
1000000US060855024005011,060855024005011,"Block 5011, Block Group 5, Census Tract 5024, Santa Clara County, California",41,38,3
1000000US060855024005012,060855024005012,"Block 5012, Block Group 5, Census Tract 5024, Santa Clara County, California",28,28,0
1000000US060855024005013,060855024005013,"Block 5013, Block Group 5, Census Tract 5024, Santa Clara County, California",16,15,1
1000000US060855024005014,060855024005014,"Block 5014, Block Group 5, Census Tract 5024, Santa Clara County, California",15,14,1
1000000US060855024006000,060855024006000,"Block 6000, Block Group 6, Census Tract 5024, Santa Clara County, California",29,29,0
1000000US060855024006001,060855024006001,"Block 6001, Block Group 6, Census Tract 5024, Santa Clara County, California",12,10,2
1000000US060855024006002,060855024006002,"Block 6002, Block Group 6, Census Tract 5024, Santa Clara County, California",41,40,1
1000000US060855024006003,060855024006003,"Block 6003, Block Group 6, Census Tract 5024, Santa Clara County, California",173,162,11
1000000US060855024006004,060855024006004,"Block 6004, Block Group 6, Census Tract 5024, Santa Clara County, California",95,90,5
1000000US060855024006005,060855024006005,"Block 6005, Block Group 6, Census Tract 5024, Santa Clara County, California",56,54,2
1000000US060855024006006,060855024006006,"Block 6006, Block Group 6, Census Tract 5024, Santa Clara County, California",109,105,4
1000000US060855024006007,060855024006007,"Block 6007, Block Group 6, Census Tract 5024, Santa Clara County, California",33,32,1
1000000US060855024006008,060855024006008,"Block 6008, Block Group 6, Census Tract 5024, Santa Clara County, California",24,23,1
1000000US060855024006009,060855024006009,"Block 6009, Block Group 6, Census Tract 5024, Santa Clara County, California",23,22,1
1000000US060855024006010,060855024006010,"Block 6010, Block Group 6, Census Tract 5024, Santa Clara County, California",34,34,0
1000000US060855024006011,060855024006011,"Block 6011, Block Group 6, Census Tract 5024, Santa Clara County, California",23,22,1
1000000US060855024007000,060855024007000,"Block 7000, Block Group 7, Census Tract 5024, Santa Clara County, California",0,0,0
1000000US060855024007001,060855024007001,"Block 7001, Block Group 7, Census Tract 5024, Santa Clara County, California",27,27,0
1000000US060855024007002,060855024007002,"Block 7002, Block Group 7, Census Tract 5024, Santa Clara County, California",135,131,4
1000000US060855024007003,060855024007003,"Block 7003, Block Group 7, Census Tract 5024, Santa Clara County, California",44,40,4
1000000US060855024007004,060855024007004,"Block 7004, Block Group 7, Census Tract 5024, Santa Clara County, California",18,18,0
1000000US060855024007005,060855024007005,"Block 7005, Block Group 7, Census Tract 5024, Santa Clara County, California",32,30,2
1000000US060855024007006,060855024007006,"Block 7006, Block Group 7, Census Tract 5024, Santa Clara County, California",43,43,0
1000000US060855024007007,060855024007007,"Block 7007, Block Group 7, Census Tract 5024, Santa Clara County, California",10,10,0
1000000US060855024007008,060855024007008,"Block 7008, Block Group 7, Census Tract 5024, Santa Clara County, California",30,30,0
1000000US060855025001000,060855025001000,"Block 1000, Block Group 1, Census Tract 5025, Santa Clara County, California",36,35,1
1000000US060855025001001,060855025001001,"Block 1001, Block Group 1, Census Tract 5025, Santa Clara County, California",38,38,0
1000000US060855025001002,060855025001002,"Block 1002, Block Group 1, Census Tract 5025, Santa Clara County, California",24,24,0
1000000US060855025001003,060855025001003,"Block 1003, Block Group 1, Census Tract 5025, Santa Clara County, California",33,32,1
1000000US060855025001004,060855025001004,"Block 1004, Block Group 1, Census Tract 5025, Santa Clara County, California",36,36,0
1000000US060855025001005,060855025001005,"Block 1005, Block Group 1, Census Tract 5025, Santa Clara County, California",34,33,1
1000000US060855025001006,060855025001006,"Block 1006, Block Group 1, Census Tract 5025, Santa Clara County, California",37,35,2
1000000US060855025001007,060855025001007,"Block 1007, Block Group 1, Census Tract 5025, Santa Clara County, California",36,35,1
1000000US060855025001008,060855025001008,"Block 1008, Block Group 1, Census Tract 5025, Santa Clara County, California",34,33,1
1000000US060855025001009,060855025001009,"Block 1009, Block Group 1, Census Tract 5025, Santa Clara County, California",34,32,2
1000000US060855025001010,060855025001010,"Block 1010, Block Group 1, Census Tract 5025, Santa Clara County, California",29,29,0
1000000US060855025001011,060855025001011,"Block 1011, Block Group 1, Census Tract 5025, Santa Clara County, California",32,32,0
1000000US060855025002000,060855025002000,"Block 2000, Block Group 2, Census Tract 5025, Santa Clara County, California",73,71,2
1000000US060855025002001,060855025002001,"Block 2001, Block Group 2, Census Tract 5025, Santa Clara County, California",16,16,0
1000000US060855025002002,060855025002002,"Block 2002, Block Group 2, Census Tract 5025, Santa Clara County, California",77,70,7
1000000US060855025002003,060855025002003,"Block 2003, Block Group 2, Census Tract 5025, Santa Clara County, California",78,76,2
1000000US060855025002004,060855025002004,"Block 2004, Block Group 2, Census Tract 5025, Santa Clara County, California",29,29,0
1000000US060855025002005,060855025002005,"Block 2005, Block Group 2, Census Tract 5025, Santa Clara County, California",25,25,0
1000000US060855025002006,060855025002006,"Block 2006, Block Group 2, Census Tract 5025, Santa Clara County, California",24,24,0
1000000US060855025002007,060855025002007,"Block 2007, Block Group 2, Census Tract 5025, Santa Clara County, California",40,39,1
1000000US060855025002008,060855025002008,"Block 2008, Block Group 2, Census Tract 5025, Santa Clara County, California",40,39,1
1000000US060855025003000,060855025003000,"Block 3000, Block Group 3, Census Tract 5025, Santa Clara County, California",38,38,0
1000000US060855025003001,060855025003001,"Block 3001, Block Group 3, Census Tract 5025, Santa Clara County, California",37,37,0
1000000US060855025003002,060855025003002,"Block 3002, Block Group 3, Census Tract 5025, Santa Clara County, California",38,37,1
1000000US060855025003003,060855025003003,"Block 3003, Block Group 3, Census Tract 5025, Santa Clara County, California",19,17,2
1000000US060855025003004,060855025003004,"Block 3004, Block Group 3, Census Tract 5025, Santa Clara County, California",21,21,0
1000000US060855025003005,060855025003005,"Block 3005, Block Group 3, Census Tract 5025, Santa Clara County, California",40,37,3
1000000US060855025003006,060855025003006,"Block 3006, Block Group 3, Census Tract 5025, Santa Clara County, California",38,35,3
1000000US060855025003007,060855025003007,"Block 3007, Block Group 3, Census Tract 5025, Santa Clara County, California",33,32,1
1000000US060855025003008,060855025003008,"Block 3008, Block Group 3, Census Tract 5025, Santa Clara County, California",31,30,1
1000000US060855025003009,060855025003009,"Block 3009, Block Group 3, Census Tract 5025, Santa Clara County, California",33,32,1
1000000US060855025003010,060855025003010,"Block 3010, Block Group 3, Census Tract 5025, Santa Clara County, California",38,38,0
1000000US060855025003011,060855025003011,"Block 3011, Block Group 3, Census Tract 5025, Santa Clara County, California",38,35,3
1000000US060855025003012,060855025003012,"Block 3012, Block Group 3, Census Tract 5025, Santa Clara County, California",8,8,0
1000000US060855025003013,060855025003013,"Block 3013, Block Group 3, Census Tract 5025, Santa Clara County, California",35,33,2
1000000US060855025004000,060855025004000,"Block 4000, Block Group 4, Census Tract 5025, Santa Clara County, California",42,42,0
1000000US060855025004001,060855025004001,"Block 4001, Block Group 4, Census Tract 5025, Santa Clara County, California",36,35,1
1000000US060855025004002,060855025004002,"Block 4002, Block Group 4, Census Tract 5025, Santa Clara County, California",39,38,1
1000000US060855025004003,060855025004003,"Block 4003, Block Group 4, Census Tract 5025, Santa Clara County, California",49,46,3
1000000US060855025004004,060855025004004,"Block 4004, Block Group 4, Census Tract 5025, Santa Clara County, California",24,23,1
1000000US060855025004005,060855025004005,"Block 4005, Block Group 4, Census Tract 5025, Santa Clara County, California",23,23,0
1000000US060855025004006,060855025004006,"Block 4006, Block Group 4, Census Tract 5025, Santa Clara County, California",36,36,0
1000000US060855025004007,060855025004007,"Block 4007, Block Group 4, Census Tract 5025, Santa Clara County, California",31,29,2
1000000US060855025004008,060855025004008,"Block 4008, Block Group 4, Census Tract 5025, Santa Clara County, California",29,29,0
1000000US060855025004009,060855025004009,"Block 4009, Block Group 4, Census Tract 5025, Santa Clara County, California",34,32,2
1000000US060855025004010,060855025004010,"Block 4010, Block Group 4, Census Tract 5025, Santa Clara County, California",35,32,3
1000000US060855025004011,060855025004011,"Block 4011, Block Group 4, Census Tract 5025, Santa Clara County, California",33,33,0
1000000US060855025004012,060855025004012,"Block 4012, Block Group 4, Census Tract 5025, Santa Clara County, California",28,27,1
1000000US060855025005000,060855025005000,"Block 5000, Block Group 5, Census Tract 5025, Santa Clara County, California",114,107,7
1000000US060855025005001,060855025005001,"Block 5001, Block Group 5, Census Tract 5025, Santa Clara County, California",8,7,1
1000000US060855025005002,060855025005002,"Block 5002, Block Group 5, Census Tract 5025, Santa Clara County, California",101,90,11
1000000US060855025005003,060855025005003,"Block 5003, Block Group 5, Census Tract 5025, Santa Clara County, California",26,25,1
1000000US060855025005004,060855025005004,"Block 5004, Block Group 5, Census Tract 5025, Santa Clara County, California",14,14,0
1000000US060855025005005,060855025005005,"Block 5005, Block Group 5, Census Tract 5025, Santa Clara County, California",29,29,0
1000000US060855025005006,060855025005006,"Block 5006, Block Group 5, Census Tract 5025, Santa Clara County, California",29,29,0
1000000US060855025005007,060855025005007,"Block 5007, Block Group 5, Census Tract 5025, Santa Clara County, California",29,27,2
1000000US060855025006000,060855025006000,"Block 6000, Block Group 6, Census Tract 5025, Santa Clara County, California",34,33,1
1000000US060855025006001,060855025006001,"Block 6001, Block Group 6, Census Tract 5025, Santa Clara County, California",22,21,1
1000000US060855025006002,060855025006002,"Block 6002, Block Group 6, Census Tract 5025, Santa Clara County, California",31,29,2
1000000US060855025006003,060855025006003,"Block 6003, Block Group 6, Census Tract 5025, Santa Clara County, California",38,38,0
1000000US060855025006004,060855025006004,"Block 6004, Block Group 6, Census Tract 5025, Santa Clara County, California",11,11,0
1000000US060855025006005,060855025006005,"Block 6005, Block Group 6, Census Tract 5025, Santa Clara County, California",17,17,0
1000000US060855025006006,060855025006006,"Block 6006, Block Group 6, Census Tract 5025, Santa Clara County, California",11,11,0
1000000US060855025006007,060855025006007,"Block 6007, Block Group 6, Census Tract 5025, Santa Clara County, California",46,42,4
1000000US060855025006008,060855025006008,"Block 6008, Block Group 6, Census Tract 5025, Santa Clara County, California",22,21,1
1000000US060855025006009,060855025006009,"Block 6009, Block Group 6, Census Tract 5025, Santa Clara County, California",24,24,0
1000000US060855025006010,060855025006010,"Block 6010, Block Group 6, Census Tract 5025, Santa Clara County, California",23,23,0
1000000US060855025006011,060855025006011,"Block 6011, Block Group 6, Census Tract 5025, Santa Clara County, California",33,32,1
1000000US060855025006012,060855025006012,"Block 6012, Block Group 6, Census Tract 5025, Santa Clara County, California",0,0,0
1000000US060855025006013,060855025006013,"Block 6013, Block Group 6, Census Tract 5025, Santa Clara County, California",27,26,1
1000000US060855025006014,060855025006014,"Block 6014, Block Group 6, Census Tract 5025, Santa Clara County, California",40,40,0
1000000US060855025006015,060855025006015,"Block 6015, Block Group 6, Census Tract 5025, Santa Clara County, California",32,32,0
1000000US060855025006016,060855025006016,"Block 6016, Block Group 6, Census Tract 5025, Santa Clara County, California",30,30,0
1000000US060855025006017,060855025006017,"Block 6017, Block Group 6, Census Tract 5025, Santa Clara County, California",30,29,1
1000000US060855025006018,060855025006018,"Block 6018, Block Group 6, Census Tract 5025, Santa Clara County, California",13,13,0
1000000US060855026011000,060855026011000,"Block 1000, Block Group 1, Census Tract 5026.01, Santa Clara County, California",5,5,0
1000000US060855026011001,060855026011001,"Block 1001, Block Group 1, Census Tract 5026.01, Santa Clara County, California",4,3,1
1000000US060855026011002,060855026011002,"Block 1002, Block Group 1, Census Tract 5026.01, Santa Clara County, California",38,38,0
1000000US060855026011003,060855026011003,"Block 1003, Block Group 1, Census Tract 5026.01, Santa Clara County, California",2,1,1
1000000US060855026011004,060855026011004,"Block 1004, Block Group 1, Census Tract 5026.01, Santa Clara County, California",8,8,0
1000000US060855026011005,060855026011005,"Block 1005, Block Group 1, Census Tract 5026.01, Santa Clara County, California",22,20,2
1000000US060855026011006,060855026011006,"Block 1006, Block Group 1, Census Tract 5026.01, Santa Clara County, California",5,5,0
1000000US060855026011007,060855026011007,"Block 1007, Block Group 1, Census Tract 5026.01, Santa Clara County, California",30,28,2
1000000US060855026011008,060855026011008,"Block 1008, Block Group 1, Census Tract 5026.01, Santa Clara County, California",40,39,1
1000000US060855026011009,060855026011009,"Block 1009, Block Group 1, Census Tract 5026.01, Santa Clara County, California",0,0,0
1000000US060855026011010,060855026011010,"Block 1010, Block Group 1, Census Tract 5026.01, Santa Clara County, California",36,35,1
1000000US060855026011011,060855026011011,"Block 1011, Block Group 1, Census Tract 5026.01, Santa Clara County, California",11,11,0
1000000US060855026011012,060855026011012,"Block 1012, Block Group 1, Census Tract 5026.01, Santa Clara County, California",3,2,1
1000000US060855026011013,060855026011013,"Block 1013, Block Group 1, Census Tract 5026.01, Santa Clara County, California",2,2,0
1000000US060855026011014,060855026011014,"Block 1014, Block Group 1, Census Tract 5026.01, Santa Clara County, California",25,24,1
1000000US060855026011015,060855026011015,"Block 1015, Block Group 1, Census Tract 5026.01, Santa Clara County, California",12,11,1
1000000US060855026011016,060855026011016,"Block 1016, Block Group 1, Census Tract 5026.01, Santa Clara County, California",3,3,0
1000000US060855026011017,060855026011017,"Block 1017, Block Group 1, Census Tract 5026.01, Santa Clara County, California",2,2,0
1000000US060855026011018,060855026011018,"Block 1018, Block Group 1, Census Tract 5026.01, Santa Clara County, California",17,16,1
1000000US060855026011019,060855026011019,"Block 1019, Block Group 1, Census Tract 5026.01, Santa Clara County, California",7,7,0
1000000US060855026011020,060855026011020,"Block 1020, Block Group 1, Census Tract 5026.01, Santa Clara County, California",28,28,0
1000000US060855026012000,060855026012000,"Block 2000, Block Group 2, Census Tract 5026.01, Santa Clara County, California",21,20,1
1000000US060855026012001,060855026012001,"Block 2001, Block Group 2, Census Tract 5026.01, Santa Clara County, California",25,25,0
1000000US060855026012002,060855026012002,"Block 2002, Block Group 2, Census Tract 5026.01, Santa Clara County, California",19,19,0
1000000US060855026012003,060855026012003,"Block 2003, Block Group 2, Census Tract 5026.01, Santa Clara County, California",17,17,0
1000000US060855026012004,060855026012004,"Block 2004, Block Group 2, Census Tract 5026.01, Santa Clara County, California",32,32,0
1000000US060855026012005,060855026012005,"Block 2005, Block Group 2, Census Tract 5026.01, Santa Clara County, California",20,20,0
1000000US060855026012006,060855026012006,"Block 2006, Block Group 2, Census Tract 5026.01, Santa Clara County, California",16,16,0
1000000US060855026012007,060855026012007,"Block 2007, Block Group 2, Census Tract 5026.01, Santa Clara County, California",11,9,2
1000000US060855026012008,060855026012008,"Block 2008, Block Group 2, Census Tract 5026.01, Santa Clara County, California",32,31,1
1000000US060855026012009,060855026012009,"Block 2009, Block Group 2, Census Tract 5026.01, Santa Clara County, California",29,28,1
1000000US060855026012010,060855026012010,"Block 2010, Block Group 2, Census Tract 5026.01, Santa Clara County, California",15,15,0
1000000US060855026012011,060855026012011,"Block 2011, Block Group 2, Census Tract 5026.01, Santa Clara County, California",36,35,1
1000000US060855026012012,060855026012012,"Block 2012, Block Group 2, Census Tract 5026.01, Santa Clara County, California",0,0,0
1000000US060855026012013,060855026012013,"Block 2013, Block Group 2, Census Tract 5026.01, Santa Clara County, California",19,17,2
1000000US060855026012014,060855026012014,"Block 2014, Block Group 2, Census Tract 5026.01, Santa Clara County, California",6,6,0
1000000US060855026012015,060855026012015,"Block 2015, Block Group 2, Census Tract 5026.01, Santa Clara County, California",21,19,2
1000000US060855026012016,060855026012016,"Block 2016, Block Group 2, Census Tract 5026.01, Santa Clara County, California",0,0,0
1000000US060855026012017,060855026012017,"Block 2017, Block Group 2, Census Tract 5026.01, Santa Clara County, California",3,3,0
1000000US060855026013000,060855026013000,"Block 3000, Block Group 3, Census Tract 5026.01, Santa Clara County, California",49,49,0
1000000US060855026013001,060855026013001,"Block 3001, Block Group 3, Census Tract 5026.01, Santa Clara County, California",20,19,1
1000000US060855026013002,060855026013002,"Block 3002, Block Group 3, Census Tract 5026.01, Santa Clara County, California",0,0,0
1000000US060855026013003,060855026013003,"Block 3003, Block Group 3, Census Tract 5026.01, Santa Clara County, California",58,52,6
1000000US060855026013004,060855026013004,"Block 3004, Block Group 3, Census Tract 5026.01, Santa Clara County, California",15,15,0
1000000US060855026013005,060855026013005,"Block 3005, Block Group 3, Census Tract 5026.01, Santa Clara County, California",12,10,2
1000000US060855026013006,060855026013006,"Block 3006, Block Group 3, Census Tract 5026.01, Santa Clara County, California",306,250,56
1000000US060855026013007,060855026013007,"Block 3007, Block Group 3, Census Tract 5026.01, Santa Clara County, California",79,79,0
1000000US060855026013008,060855026013008,"Block 3008, Block Group 3, Census Tract 5026.01, Santa Clara County, California",13,13,0
1000000US060855026013009,060855026013009,"Block 3009, Block Group 3, Census Tract 5026.01, Santa Clara County, California",8,8,0
1000000US060855026013010,060855026013010,"Block 3010, Block Group 3, Census Tract 5026.01, Santa Clara County, California",24,23,1
1000000US060855026013011,060855026013011,"Block 3011, Block Group 3, Census Tract 5026.01, Santa Clara County, California",40,38,2
1000000US060855026013012,060855026013012,"Block 3012, Block Group 3, Census Tract 5026.01, Santa Clara County, California",8,7,1
1000000US060855026013013,060855026013013,"Block 3013, Block Group 3, Census Tract 5026.01, Santa Clara County, California",5,5,0
1000000US060855026031000,060855026031000,"Block 1000, Block Group 1, Census Tract 5026.03, Santa Clara County, California",29,27,2
1000000US060855026031001,060855026031001,"Block 1001, Block Group 1, Census Tract 5026.03, Santa Clara County, California",25,25,0
1000000US060855026031002,060855026031002,"Block 1002, Block Group 1, Census Tract 5026.03, Santa Clara County, California",194,175,19
1000000US060855026031003,060855026031003,"Block 1003, Block Group 1, Census Tract 5026.03, Santa Clara County, California",41,40,1
1000000US060855026031004,060855026031004,"Block 1004, Block Group 1, Census Tract 5026.03, Santa Clara County, California",53,50,3
1000000US060855026031005,060855026031005,"Block 1005, Block Group 1, Census Tract 5026.03, Santa Clara County, California",0,0,0
1000000US060855026031006,060855026031006,"Block 1006, Block Group 1, Census Tract 5026.03, Santa Clara County, California",0,0,0
1000000US060855026032000,060855026032000,"Block 2000, Block Group 2, Census Tract 5026.03, Santa Clara County, California",22,20,2
1000000US060855026032001,060855026032001,"Block 2001, Block Group 2, Census Tract 5026.03, Santa Clara County, California",22,22,0
1000000US060855026032002,060855026032002,"Block 2002, Block Group 2, Census Tract 5026.03, Santa Clara County, California",35,35,0
1000000US060855026032003,060855026032003,"Block 2003, Block Group 2, Census Tract 5026.03, Santa Clara County, California",33,33,0
1000000US060855026032004,060855026032004,"Block 2004, Block Group 2, Census Tract 5026.03, Santa Clara County, California",0,0,0
1000000US060855026032005,060855026032005,"Block 2005, Block Group 2, Census Tract 5026.03, Santa Clara County, California",45,44,1
1000000US060855026032006,060855026032006,"Block 2006, Block Group 2, Census Tract 5026.03, Santa Clara County, California",36,35,1
1000000US060855026032007,060855026032007,"Block 2007, Block Group 2, Census Tract 5026.03, Santa Clara County, California",39,39,0
1000000US060855026032008,060855026032008,"Block 2008, Block Group 2, Census Tract 5026.03, Santa Clara County, California",63,61,2
1000000US060855026032009,060855026032009,"Block 2009, Block Group 2, Census Tract 5026.03, Santa Clara County, California",24,23,1
1000000US060855026032010,060855026032010,"Block 2010, Block Group 2, Census Tract 5026.03, Santa Clara County, California",0,0,0
1000000US060855026033000,060855026033000,"Block 3000, Block Group 3, Census Tract 5026.03, Santa Clara County, California",5,5,0
1000000US060855026033001,060855026033001,"Block 3001, Block Group 3, Census Tract 5026.03, Santa Clara County, California",12,12,0
1000000US060855026033002,060855026033002,"Block 3002, Block Group 3, Census Tract 5026.03, Santa Clara County, California",33,33,0
1000000US060855026033003,060855026033003,"Block 3003, Block Group 3, Census Tract 5026.03, Santa Clara County, California",1,1,0
1000000US060855026033004,060855026033004,"Block 3004, Block Group 3, Census Tract 5026.03, Santa Clara County, California",10,10,0
1000000US060855026033005,060855026033005,"Block 3005, Block Group 3, Census Tract 5026.03, Santa Clara County, California",3,3,0
1000000US060855026033006,060855026033006,"Block 3006, Block Group 3, Census Tract 5026.03, Santa Clara County, California",55,53,2
1000000US060855026033007,060855026033007,"Block 3007, Block Group 3, Census Tract 5026.03, Santa Clara County, California",20,17,3
1000000US060855026033008,060855026033008,"Block 3008, Block Group 3, Census Tract 5026.03, Santa Clara County, California",39,37,2
1000000US060855026033009,060855026033009,"Block 3009, Block Group 3, Census Tract 5026.03, Santa Clara County, California",31,30,1
1000000US060855026033010,060855026033010,"Block 3010, Block Group 3, Census Tract 5026.03, Santa Clara County, California",20,19,1
1000000US060855026033011,060855026033011,"Block 3011, Block Group 3, Census Tract 5026.03, Santa Clara County, California",26,26,0
1000000US060855026033012,060855026033012,"Block 3012, Block Group 3, Census Tract 5026.03, Santa Clara County, California",12,12,0
1000000US060855026033013,060855026033013,"Block 3013, Block Group 3, Census Tract 5026.03, Santa Clara County, California",70,69,1
1000000US060855026033014,060855026033014,"Block 3014, Block Group 3, Census Tract 5026.03, Santa Clara County, California",23,23,0
1000000US060855026033015,060855026033015,"Block 3015, Block Group 3, Census Tract 5026.03, Santa Clara County, California",18,16,2
1000000US060855026033016,060855026033016,"Block 3016, Block Group 3, Census Tract 5026.03, Santa Clara County, California",19,19,0
1000000US060855026041000,060855026041000,"Block 1000, Block Group 1, Census Tract 5026.04, Santa Clara County, California",0,0,0
1000000US060855026041001,060855026041001,"Block 1001, Block Group 1, Census Tract 5026.04, Santa Clara County, California",0,0,0
1000000US060855026041002,060855026041002,"Block 1002, Block Group 1, Census Tract 5026.04, Santa Clara County, California",0,0,0
1000000US060855026041003,060855026041003,"Block 1003, Block Group 1, Census Tract 5026.04, Santa Clara County, California",0,0,0
1000000US060855026041004,060855026041004,"Block 1004, Block Group 1, Census Tract 5026.04, Santa Clara County, California",0,0,0
1000000US060855026041005,060855026041005,"Block 1005, Block Group 1, Census Tract 5026.04, Santa Clara County, California",0,0,0
1000000US060855026041006,060855026041006,"Block 1006, Block Group 1, Census Tract 5026.04, Santa Clara County, California",45,24,21
1000000US060855026041007,060855026041007,"Block 1007, Block Group 1, Census Tract 5026.04, Santa Clara County, California",0,0,0
1000000US060855026041008,060855026041008,"Block 1008, Block Group 1, Census Tract 5026.04, Santa Clara County, California",0,0,0
1000000US060855026041009,060855026041009,"Block 1009, Block Group 1, Census Tract 5026.04, Santa Clara County, California",0,0,0
1000000US060855026041010,060855026041010,"Block 1010, Block Group 1, Census Tract 5026.04, Santa Clara County, California",106,96,10
1000000US060855026041011,060855026041011,"Block 1011, Block Group 1, Census Tract 5026.04, Santa Clara County, California",0,0,0
1000000US060855026041012,060855026041012,"Block 1012, Block Group 1, Census Tract 5026.04, Santa Clara County, California",0,0,0
1000000US060855026041013,060855026041013,"Block 1013, Block Group 1, Census Tract 5026.04, Santa Clara County, California",0,0,0
1000000US060855026041014,060855026041014,"Block 1014, Block Group 1, Census Tract 5026.04, Santa Clara County, California",0,0,0
1000000US060855026041015,060855026041015,"Block 1015, Block Group 1, Census Tract 5026.04, Santa Clara County, California",0,0,0
1000000US060855026041016,060855026041016,"Block 1016, Block Group 1, Census Tract 5026.04, Santa Clara County, California",85,79,6
1000000US060855026041017,060855026041017,"Block 1017, Block Group 1, Census Tract 5026.04, Santa Clara County, California",171,159,12
1000000US060855026041018,060855026041018,"Block 1018, Block Group 1, Census Tract 5026.04, Santa Clara County, California",0,0,0
1000000US060855026041019,060855026041019,"Block 1019, Block Group 1, Census Tract 5026.04, Santa Clara County, California",344,330,14
1000000US060855026041020,060855026041020,"Block 1020, Block Group 1, Census Tract 5026.04, Santa Clara County, California",169,166,3
1000000US060855026041021,060855026041021,"Block 1021, Block Group 1, Census Tract 5026.04, Santa Clara County, California",0,0,0
1000000US060855026041022,060855026041022,"Block 1022, Block Group 1, Census Tract 5026.04, Santa Clara County, California",89,82,7
1000000US060855026041023,060855026041023,"Block 1023, Block Group 1, Census Tract 5026.04, Santa Clara County, California",14,14,0
1000000US060855026042000,060855026042000,"Block 2000, Block Group 2, Census Tract 5026.04, Santa Clara County, California",772,735,37
1000000US060855026042001,060855026042001,"Block 2001, Block Group 2, Census Tract 5026.04, Santa Clara County, California",0,0,0
1000000US060855026042002,060855026042002,"Block 2002, Block Group 2, Census Tract 5026.04, Santa Clara County, California",0,0,0
1000000US060855026042003,060855026042003,"Block 2003, Block Group 2, Census Tract 5026.04, Santa Clara County, California",76,72,4
1000000US060855026042004,060855026042004,"Block 2004, Block Group 2, Census Tract 5026.04, Santa Clara County, California",1,1,0
1000000US060855026042005,060855026042005,"Block 2005, Block Group 2, Census Tract 5026.04, Santa Clara County, California",0,0,0
1000000US060855026042006,060855026042006,"Block 2006, Block Group 2, Census Tract 5026.04, Santa Clara County, California",0,0,0
1000000US060855026042007,060855026042007,"Block 2007, Block Group 2, Census Tract 5026.04, Santa Clara County, California",0,0,0
1000000US060855026043000,060855026043000,"Block 3000, Block Group 3, Census Tract 5026.04, Santa Clara County, California",0,0,0
1000000US060855026043001,060855026043001,"Block 3001, Block Group 3, Census Tract 5026.04, Santa Clara County, California",174,168,6
1000000US060855026043002,060855026043002,"Block 3002, Block Group 3, Census Tract 5026.04, Santa Clara County, California",184,184,0
1000000US060855026043003,060855026043003,"Block 3003, Block Group 3, Census Tract 5026.04, Santa Clara County, California",0,0,0
1000000US060855026043004,060855026043004,"Block 3004, Block Group 3, Census Tract 5026.04, Santa Clara County, California",0,0,0
1000000US060855026043005,060855026043005,"Block 3005, Block Group 3, Census Tract 5026.04, Santa Clara County, California",45,39,6
1000000US060855026043006,060855026043006,"Block 3006, Block Group 3, Census Tract 5026.04, Santa Clara County, California",32,31,1
1000000US060855026043007,060855026043007,"Block 3007, Block Group 3, Census Tract 5026.04, Santa Clara County, California",32,30,2
1000000US060855027011000,060855027011000,"Block 1000, Block Group 1, Census Tract 5027.01, Santa Clara County, California",189,177,12
1000000US060855027011001,060855027011001,"Block 1001, Block Group 1, Census Tract 5027.01, Santa Clara County, California",2,2,0
1000000US060855027011002,060855027011002,"Block 1002, Block Group 1, Census Tract 5027.01, Santa Clara County, California",88,86,2
1000000US060855027011003,060855027011003,"Block 1003, Block Group 1, Census Tract 5027.01, Santa Clara County, California",20,20,0
1000000US060855027011004,060855027011004,"Block 1004, Block Group 1, Census Tract 5027.01, Santa Clara County, California",2,2,0
1000000US060855027011005,060855027011005,"Block 1005, Block Group 1, Census Tract 5027.01, Santa Clara County, California",20,19,1
1000000US060855027011006,060855027011006,"Block 1006, Block Group 1, Census Tract 5027.01, Santa Clara County, California",2,2,0
1000000US060855027011007,060855027011007,"Block 1007, Block Group 1, Census Tract 5027.01, Santa Clara County, California",26,26,0
1000000US060855027011008,060855027011008,"Block 1008, Block Group 1, Census Tract 5027.01, Santa Clara County, California",2,2,0
1000000US060855027011009,060855027011009,"Block 1009, Block Group 1, Census Tract 5027.01, Santa Clara County, California",7,6,1
1000000US060855027011010,060855027011010,"Block 1010, Block Group 1, Census Tract 5027.01, Santa Clara County, California",8,7,1
1000000US060855027011011,060855027011011,"Block 1011, Block Group 1, Census Tract 5027.01, Santa Clara County, California",9,9,0
1000000US060855027011012,060855027011012,"Block 1012, Block Group 1, Census Tract 5027.01, Santa Clara County, California",24,23,1
1000000US060855027011013,060855027011013,"Block 1013, Block Group 1, Census Tract 5027.01, Santa Clara County, California",32,31,1
1000000US060855027011014,060855027011014,"Block 1014, Block Group 1, Census Tract 5027.01, Santa Clara County, California",25,25,0
1000000US060855027011015,060855027011015,"Block 1015, Block Group 1, Census Tract 5027.01, Santa Clara County, California",6,6,0
1000000US060855027011016,060855027011016,"Block 1016, Block Group 1, Census Tract 5027.01, Santa Clara County, California",32,32,0
1000000US060855027011017,060855027011017,"Block 1017, Block Group 1, Census Tract 5027.01, Santa Clara County, California",24,24,0
1000000US060855027011018,060855027011018,"Block 1018, Block Group 1, Census Tract 5027.01, Santa Clara County, California",52,51,1
1000000US060855027011019,060855027011019,"Block 1019, Block Group 1, Census Tract 5027.01, Santa Clara County, California",58,57,1
1000000US060855027011020,060855027011020,"Block 1020, Block Group 1, Census Tract 5027.01, Santa Clara County, California",34,34,0
1000000US060855027011021,060855027011021,"Block 1021, Block Group 1, Census Tract 5027.01, Santa Clara County, California",17,17,0
1000000US060855027011022,060855027011022,"Block 1022, Block Group 1, Census Tract 5027.01, Santa Clara County, California",0,0,0
1000000US060855027012000,060855027012000,"Block 2000, Block Group 2, Census Tract 5027.01, Santa Clara County, California",36,34,2
1000000US060855027012001,060855027012001,"Block 2001, Block Group 2, Census Tract 5027.01, Santa Clara County, California",53,49,4
1000000US060855027012002,060855027012002,"Block 2002, Block Group 2, Census Tract 5027.01, Santa Clara County, California",54,54,0
1000000US060855027012003,060855027012003,"Block 2003, Block Group 2, Census Tract 5027.01, Santa Clara County, California",20,20,0
1000000US060855027012004,060855027012004,"Block 2004, Block Group 2, Census Tract 5027.01, Santa Clara County, California",29,28,1
1000000US060855027012005,060855027012005,"Block 2005, Block Group 2, Census Tract 5027.01, Santa Clara County, California",9,8,1
1000000US060855027012006,060855027012006,"Block 2006, Block Group 2, Census Tract 5027.01, Santa Clara County, California",14,14,0
1000000US060855027012007,060855027012007,"Block 2007, Block Group 2, Census Tract 5027.01, Santa Clara County, California",14,14,0
1000000US060855027012008,060855027012008,"Block 2008, Block Group 2, Census Tract 5027.01, Santa Clara County, California",18,18,0
1000000US060855027012009,060855027012009,"Block 2009, Block Group 2, Census Tract 5027.01, Santa Clara County, California",64,64,0
1000000US060855027012010,060855027012010,"Block 2010, Block Group 2, Census Tract 5027.01, Santa Clara County, California",29,28,1
1000000US060855027012011,060855027012011,"Block 2011, Block Group 2, Census Tract 5027.01, Santa Clara County, California",54,52,2
1000000US060855027012012,060855027012012,"Block 2012, Block Group 2, Census Tract 5027.01, Santa Clara County, California",34,34,0
1000000US060855027012013,060855027012013,"Block 2013, Block Group 2, Census Tract 5027.01, Santa Clara County, California",112,110,2
1000000US060855027012014,060855027012014,"Block 2014, Block Group 2, Census Tract 5027.01, Santa Clara County, California",8,8,0
1000000US060855027012015,060855027012015,"Block 2015, Block Group 2, Census Tract 5027.01, Santa Clara County, California",28,28,0
1000000US060855027012016,060855027012016,"Block 2016, Block Group 2, Census Tract 5027.01, Santa Clara County, California",28,27,1
1000000US060855027012017,060855027012017,"Block 2017, Block Group 2, Census Tract 5027.01, Santa Clara County, California",28,28,0
1000000US060855027013000,060855027013000,"Block 3000, Block Group 3, Census Tract 5027.01, Santa Clara County, California",0,0,0
1000000US060855027013001,060855027013001,"Block 3001, Block Group 3, Census Tract 5027.01, Santa Clara County, California",341,324,17
1000000US060855027013002,060855027013002,"Block 3002, Block Group 3, Census Tract 5027.01, Santa Clara County, California",60,55,5
1000000US060855027013003,060855027013003,"Block 3003, Block Group 3, Census Tract 5027.01, Santa Clara County, California",15,14,1
1000000US060855027013004,060855027013004,"Block 3004, Block Group 3, Census Tract 5027.01, Santa Clara County, California",35,34,1
1000000US060855027013005,060855027013005,"Block 3005, Block Group 3, Census Tract 5027.01, Santa Clara County, California",35,34,1
1000000US060855027013006,060855027013006,"Block 3006, Block Group 3, Census Tract 5027.01, Santa Clara County, California",32,30,2
1000000US060855027013007,060855027013007,"Block 3007, Block Group 3, Census Tract 5027.01, Santa Clara County, California",21,21,0
1000000US060855027013008,060855027013008,"Block 3008, Block Group 3, Census Tract 5027.01, Santa Clara County, California",1,1,0
1000000US060855027013009,060855027013009,"Block 3009, Block Group 3, Census Tract 5027.01, Santa Clara County, California",0,0,0
1000000US060855027013010,060855027013010,"Block 3010, Block Group 3, Census Tract 5027.01, Santa Clara County, California",0,0,0
1000000US060855027013011,060855027013011,"Block 3011, Block Group 3, Census Tract 5027.01, Santa Clara County, California",13,11,2
1000000US060855027013012,060855027013012,"Block 3012, Block Group 3, Census Tract 5027.01, Santa Clara County, California",1,1,0
1000000US060855027013013,060855027013013,"Block 3013, Block Group 3, Census Tract 5027.01, Santa Clara County, California",15,15,0
1000000US060855027013014,060855027013014,"Block 3014, Block Group 3, Census Tract 5027.01, Santa Clara County, California",31,29,2
1000000US060855027013015,060855027013015,"Block 3015, Block Group 3, Census Tract 5027.01, Santa Clara County, California",0,0,0
1000000US060855027013016,060855027013016,"Block 3016, Block Group 3, Census Tract 5027.01, Santa Clara County, California",61,58,3
1000000US060855027013017,060855027013017,"Block 3017, Block Group 3, Census Tract 5027.01, Santa Clara County, California",48,44,4
1000000US060855027021000,060855027021000,"Block 1000, Block Group 1, Census Tract 5027.02, Santa Clara County, California",0,0,0
1000000US060855027021001,060855027021001,"Block 1001, Block Group 1, Census Tract 5027.02, Santa Clara County, California",71,70,1
1000000US060855027021002,060855027021002,"Block 1002, Block Group 1, Census Tract 5027.02, Santa Clara County, California",37,37,0
1000000US060855027021003,060855027021003,"Block 1003, Block Group 1, Census Tract 5027.02, Santa Clara County, California",27,26,1
1000000US060855027021004,060855027021004,"Block 1004, Block Group 1, Census Tract 5027.02, Santa Clara County, California",30,28,2
1000000US060855027021005,060855027021005,"Block 1005, Block Group 1, Census Tract 5027.02, Santa Clara County, California",144,142,2
1000000US060855027021006,060855027021006,"Block 1006, Block Group 1, Census Tract 5027.02, Santa Clara County, California",1,1,0
1000000US060855027021007,060855027021007,"Block 1007, Block Group 1, Census Tract 5027.02, Santa Clara County, California",7,7,0
1000000US060855027021008,060855027021008,"Block 1008, Block Group 1, Census Tract 5027.02, Santa Clara County, California",22,21,1
1000000US060855027021009,060855027021009,"Block 1009, Block Group 1, Census Tract 5027.02, Santa Clara County, California",16,15,1
1000000US060855027021010,060855027021010,"Block 1010, Block Group 1, Census Tract 5027.02, Santa Clara County, California",184,181,3
1000000US060855027021011,060855027021011,"Block 1011, Block Group 1, Census Tract 5027.02, Santa Clara County, California",1,1,0
1000000US060855027021012,060855027021012,"Block 1012, Block Group 1, Census Tract 5027.02, Santa Clara County, California",1,1,0
1000000US060855027021013,060855027021013,"Block 1013, Block Group 1, Census Tract 5027.02, Santa Clara County, California",58,55,3
1000000US060855027021014,060855027021014,"Block 1014, Block Group 1, Census Tract 5027.02, Santa Clara County, California",24,24,0
1000000US060855027021015,060855027021015,"Block 1015, Block Group 1, Census Tract 5027.02, Santa Clara County, California",454,407,47
1000000US060855027021016,060855027021016,"Block 1016, Block Group 1, Census Tract 5027.02, Santa Clara County, California",0,0,0
1000000US060855027021017,060855027021017,"Block 1017, Block Group 1, Census Tract 5027.02, Santa Clara County, California",0,0,0
1000000US060855027021018,060855027021018,"Block 1018, Block Group 1, Census Tract 5027.02, Santa Clara County, California",0,0,0
1000000US060855027021019,060855027021019,"Block 1019, Block Group 1, Census Tract 5027.02, Santa Clara County, California",0,0,0
1000000US060855027021020,060855027021020,"Block 1020, Block Group 1, Census Tract 5027.02, Santa Clara County, California",6,6,0
1000000US060855027021021,060855027021021,"Block 1021, Block Group 1, Census Tract 5027.02, Santa Clara County, California",0,0,0
1000000US060855027021022,060855027021022,"Block 1022, Block Group 1, Census Tract 5027.02, Santa Clara County, California",0,0,0
1000000US060855027021023,060855027021023,"Block 1023, Block Group 1, Census Tract 5027.02, Santa Clara County, California",0,0,0
1000000US060855027021024,060855027021024,"Block 1024, Block Group 1, Census Tract 5027.02, Santa Clara County, California",0,0,0
1000000US060855027021025,060855027021025,"Block 1025, Block Group 1, Census Tract 5027.02, Santa Clara County, California",0,0,0
1000000US060855027021026,060855027021026,"Block 1026, Block Group 1, Census Tract 5027.02, Santa Clara County, California",0,0,0
1000000US060855027021027,060855027021027,"Block 1027, Block Group 1, Census Tract 5027.02, Santa Clara County, California",0,0,0
1000000US060855027021028,060855027021028,"Block 1028, Block Group 1, Census Tract 5027.02, Santa Clara County, California",0,0,0
1000000US060855027021029,060855027021029,"Block 1029, Block Group 1, Census Tract 5027.02, Santa Clara County, California",0,0,0
1000000US060855027021030,060855027021030,"Block 1030, Block Group 1, Census Tract 5027.02, Santa Clara County, California",0,0,0
1000000US060855027021031,060855027021031,"Block 1031, Block Group 1, Census Tract 5027.02, Santa Clara County, California",0,0,0
1000000US060855027022000,060855027022000,"Block 2000, Block Group 2, Census Tract 5027.02, Santa Clara County, California",2,2,0
1000000US060855027022001,060855027022001,"Block 2001, Block Group 2, Census Tract 5027.02, Santa Clara County, California",53,53,0
1000000US060855027022002,060855027022002,"Block 2002, Block Group 2, Census Tract 5027.02, Santa Clara County, California",41,39,2
1000000US060855027022003,060855027022003,"Block 2003, Block Group 2, Census Tract 5027.02, Santa Clara County, California",22,22,0
1000000US060855027022004,060855027022004,"Block 2004, Block Group 2, Census Tract 5027.02, Santa Clara County, California",15,15,0
1000000US060855027022005,060855027022005,"Block 2005, Block Group 2, Census Tract 5027.02, Santa Clara County, California",2,2,0
1000000US060855027022006,060855027022006,"Block 2006, Block Group 2, Census Tract 5027.02, Santa Clara County, California",157,153,4
1000000US060855027022007,060855027022007,"Block 2007, Block Group 2, Census Tract 5027.02, Santa Clara County, California",36,36,0
1000000US060855027022008,060855027022008,"Block 2008, Block Group 2, Census Tract 5027.02, Santa Clara County, California",8,8,0
1000000US060855027022009,060855027022009,"Block 2009, Block Group 2, Census Tract 5027.02, Santa Clara County, California",126,125,1
1000000US060855027022010,060855027022010,"Block 2010, Block Group 2, Census Tract 5027.02, Santa Clara County, California",8,8,0
1000000US060855027022011,060855027022011,"Block 2011, Block Group 2, Census Tract 5027.02, Santa Clara County, California",1,1,0
1000000US060855027022012,060855027022012,"Block 2012, Block Group 2, Census Tract 5027.02, Santa Clara County, California",18,18,0
1000000US060855027022013,060855027022013,"Block 2013, Block Group 2, Census Tract 5027.02, Santa Clara County, California",0,0,0
1000000US060855027022014,060855027022014,"Block 2014, Block Group 2, Census Tract 5027.02, Santa Clara County, California",11,11,0
1000000US060855027022015,060855027022015,"Block 2015, Block Group 2, Census Tract 5027.02, Santa Clara County, California",6,6,0
1000000US060855027022016,060855027022016,"Block 2016, Block Group 2, Census Tract 5027.02, Santa Clara County, California",18,18,0
1000000US060855027022017,060855027022017,"Block 2017, Block Group 2, Census Tract 5027.02, Santa Clara County, California",19,18,1
1000000US060855027022018,060855027022018,"Block 2018, Block Group 2, Census Tract 5027.02, Santa Clara County, California",85,81,4
1000000US060855027022019,060855027022019,"Block 2019, Block Group 2, Census Tract 5027.02, Santa Clara County, California",24,24,0
1000000US060855027022020,060855027022020,"Block 2020, Block Group 2, Census Tract 5027.02, Santa Clara County, California",18,16,2
1000000US060855027022021,060855027022021,"Block 2021, Block Group 2, Census Tract 5027.02, Santa Clara County, California",11,11,0
1000000US060855027022022,060855027022022,"Block 2022, Block Group 2, Census Tract 5027.02, Santa Clara County, California",32,32,0
1000000US060855027023000,060855027023000,"Block 3000, Block Group 3, Census Tract 5027.02, Santa Clara County, California",0,0,0
1000000US060855027023001,060855027023001,"Block 3001, Block Group 3, Census Tract 5027.02, Santa Clara County, California",20,19,1
1000000US060855027023002,060855027023002,"Block 3002, Block Group 3, Census Tract 5027.02, Santa Clara County, California",40,40,0
1000000US060855027023003,060855027023003,"Block 3003, Block Group 3, Census Tract 5027.02, Santa Clara County, California",2,2,0
1000000US060855027023004,060855027023004,"Block 3004, Block Group 3, Census Tract 5027.02, Santa Clara County, California",30,28,2
1000000US060855027023005,060855027023005,"Block 3005, Block Group 3, Census Tract 5027.02, Santa Clara County, California",27,26,1
1000000US060855027023006,060855027023006,"Block 3006, Block Group 3, Census Tract 5027.02, Santa Clara County, California",41,41,0
1000000US060855027023007,060855027023007,"Block 3007, Block Group 3, Census Tract 5027.02, Santa Clara County, California",25,20,5
1000000US060855027023008,060855027023008,"Block 3008, Block Group 3, Census Tract 5027.02, Santa Clara County, California",29,27,2
1000000US060855027023009,060855027023009,"Block 3009, Block Group 3, Census Tract 5027.02, Santa Clara County, California",23,22,1
1000000US060855027023010,060855027023010,"Block 3010, Block Group 3, Census Tract 5027.02, Santa Clara County, California",22,21,1
1000000US060855027023011,060855027023011,"Block 3011, Block Group 3, Census Tract 5027.02, Santa Clara County, California",23,23,0
1000000US060855027023012,060855027023012,"Block 3012, Block Group 3, Census Tract 5027.02, Santa Clara County, California",30,27,3
1000000US060855027023013,060855027023013,"Block 3013, Block Group 3, Census Tract 5027.02, Santa Clara County, California",34,33,1
1000000US060855027023014,060855027023014,"Block 3014, Block Group 3, Census Tract 5027.02, Santa Clara County, California",23,20,3
1000000US060855027023015,060855027023015,"Block 3015, Block Group 3, Census Tract 5027.02, Santa Clara County, California",25,25,0
1000000US060855027023016,060855027023016,"Block 3016, Block Group 3, Census Tract 5027.02, Santa Clara County, California",21,21,0
1000000US060855027024000,060855027024000,"Block 4000, Block Group 4, Census Tract 5027.02, Santa Clara County, California",151,148,3
1000000US060855027024001,060855027024001,"Block 4001, Block Group 4, Census Tract 5027.02, Santa Clara County, California",28,27,1
1000000US060855027024002,060855027024002,"Block 4002, Block Group 4, Census Tract 5027.02, Santa Clara County, California",28,28,0
1000000US060855027024003,060855027024003,"Block 4003, Block Group 4, Census Tract 5027.02, Santa Clara County, California",31,30,1
1000000US060855027024004,060855027024004,"Block 4004, Block Group 4, Census Tract 5027.02, Santa Clara County, California",119,117,2
1000000US060855027024005,060855027024005,"Block 4005, Block Group 4, Census Tract 5027.02, Santa Clara County, California",31,31,0
1000000US060855027024006,060855027024006,"Block 4006, Block Group 4, Census Tract 5027.02, Santa Clara County, California",30,30,0
1000000US060855027024007,060855027024007,"Block 4007, Block Group 4, Census Tract 5027.02, Santa Clara County, California",26,24,2
1000000US060855027024008,060855027024008,"Block 4008, Block Group 4, Census Tract 5027.02, Santa Clara County, California",0,0,0
1000000US060855027024009,060855027024009,"Block 4009, Block Group 4, Census Tract 5027.02, Santa Clara County, California",7,7,0
1000000US060855027024010,060855027024010,"Block 4010, Block Group 4, Census Tract 5027.02, Santa Clara County, California",10,10,0
1000000US060855027024011,060855027024011,"Block 4011, Block Group 4, Census Tract 5027.02, Santa Clara County, California",15,15,0
1000000US060855027024012,060855027024012,"Block 4012, Block Group 4, Census Tract 5027.02, Santa Clara County, California",23,23,0
1000000US060855027024013,060855027024013,"Block 4013, Block Group 4, Census Tract 5027.02, Santa Clara County, California",0,0,0
1000000US060855027025000,060855027025000,"Block 5000, Block Group 5, Census Tract 5027.02, Santa Clara County, California",117,117,0
1000000US060855027025001,060855027025001,"Block 5001, Block Group 5, Census Tract 5027.02, Santa Clara County, California",55,54,1
1000000US060855027025002,060855027025002,"Block 5002, Block Group 5, Census Tract 5027.02, Santa Clara County, California",20,18,2
1000000US060855027025003,060855027025003,"Block 5003, Block Group 5, Census Tract 5027.02, Santa Clara County, California",0,0,0
1000000US060855027025004,060855027025004,"Block 5004, Block Group 5, Census Tract 5027.02, Santa Clara County, California",0,0,0
1000000US060855027025005,060855027025005,"Block 5005, Block Group 5, Census Tract 5027.02, Santa Clara County, California",0,0,0
1000000US060855027025006,060855027025006,"Block 5006, Block Group 5, Census Tract 5027.02, Santa Clara County, California",0,0,0
1000000US060855027025007,060855027025007,"Block 5007, Block Group 5, Census Tract 5027.02, Santa Clara County, California",10,10,0
1000000US060855027025008,060855027025008,"Block 5008, Block Group 5, Census Tract 5027.02, Santa Clara County, California",44,40,4
1000000US060855027025009,060855027025009,"Block 5009, Block Group 5, Census Tract 5027.02, Santa Clara County, California",72,66,6
1000000US060855027025010,060855027025010,"Block 5010, Block Group 5, Census Tract 5027.02, Santa Clara County, California",44,42,2
1000000US060855027025011,060855027025011,"Block 5011, Block Group 5, Census Tract 5027.02, Santa Clara County, California",150,143,7
1000000US060855027025012,060855027025012,"Block 5012, Block Group 5, Census Tract 5027.02, Santa Clara County, California",11,11,0
1000000US060855027025013,060855027025013,"Block 5013, Block Group 5, Census Tract 5027.02, Santa Clara County, California",0,0,0
1000000US060855027025014,060855027025014,"Block 5014, Block Group 5, Census Tract 5027.02, Santa Clara County, California",13,13,0
1000000US060855027025015,060855027025015,"Block 5015, Block Group 5, Census Tract 5027.02, Santa Clara County, California",1,1,0
1000000US060855027025016,060855027025016,"Block 5016, Block Group 5, Census Tract 5027.02, Santa Clara County, California",10,10,0
1000000US060855028001000,060855028001000,"Block 1000, Block Group 1, Census Tract 5028, Santa Clara County, California",9,9,0
1000000US060855028001001,060855028001001,"Block 1001, Block Group 1, Census Tract 5028, Santa Clara County, California",0,0,0
1000000US060855028001002,060855028001002,"Block 1002, Block Group 1, Census Tract 5028, Santa Clara County, California",22,21,1
1000000US060855028001003,060855028001003,"Block 1003, Block Group 1, Census Tract 5028, Santa Clara County, California",0,0,0
1000000US060855028001004,060855028001004,"Block 1004, Block Group 1, Census Tract 5028, Santa Clara County, California",2,2,0
1000000US060855028001005,060855028001005,"Block 1005, Block Group 1, Census Tract 5028, Santa Clara County, California",4,4,0
1000000US060855028001006,060855028001006,"Block 1006, Block Group 1, Census Tract 5028, Santa Clara County, California",29,28,1
1000000US060855028001007,060855028001007,"Block 1007, Block Group 1, Census Tract 5028, Santa Clara County, California",19,19,0
1000000US060855028001008,060855028001008,"Block 1008, Block Group 1, Census Tract 5028, Santa Clara County, California",0,0,0
1000000US060855028001009,060855028001009,"Block 1009, Block Group 1, Census Tract 5028, Santa Clara County, California",5,5,0
1000000US060855028001010,060855028001010,"Block 1010, Block Group 1, Census Tract 5028, Santa Clara County, California",19,19,0
1000000US060855028001011,060855028001011,"Block 1011, Block Group 1, Census Tract 5028, Santa Clara County, California",20,19,1
1000000US060855028001012,060855028001012,"Block 1012, Block Group 1, Census Tract 5028, Santa Clara County, California",9,9,0
1000000US060855028001013,060855028001013,"Block 1013, Block Group 1, Census Tract 5028, Santa Clara County, California",12,12,0
1000000US060855028001014,060855028001014,"Block 1014, Block Group 1, Census Tract 5028, Santa Clara County, California",3,3,0
1000000US060855028001015,060855028001015,"Block 1015, Block Group 1, Census Tract 5028, Santa Clara County, California",17,16,1
1000000US060855028001016,060855028001016,"Block 1016, Block Group 1, Census Tract 5028, Santa Clara County, California",95,93,2
1000000US060855028001017,060855028001017,"Block 1017, Block Group 1, Census Tract 5028, Santa Clara County, California",22,22,0
1000000US060855028001018,060855028001018,"Block 1018, Block Group 1, Census Tract 5028, Santa Clara County, California",10,10,0
1000000US060855028001019,060855028001019,"Block 1019, Block Group 1, Census Tract 5028, Santa Clara County, California",19,19,0
1000000US060855028001020,060855028001020,"Block 1020, Block Group 1, Census Tract 5028, Santa Clara County, California",15,15,0
1000000US060855028001021,060855028001021,"Block 1021, Block Group 1, Census Tract 5028, Santa Clara County, California",4,4,0
1000000US060855028001022,060855028001022,"Block 1022, Block Group 1, Census Tract 5028, Santa Clara County, California",4,4,0
1000000US060855028001023,060855028001023,"Block 1023, Block Group 1, Census Tract 5028, Santa Clara County, California",11,11,0
1000000US060855028001024,060855028001024,"Block 1024, Block Group 1, Census Tract 5028, Santa Clara County, California",23,23,0
1000000US060855028001025,060855028001025,"Block 1025, Block Group 1, Census Tract 5028, Santa Clara County, California",24,24,0
1000000US060855028001026,060855028001026,"Block 1026, Block Group 1, Census Tract 5028, Santa Clara County, California",3,3,0
1000000US060855028001027,060855028001027,"Block 1027, Block Group 1, Census Tract 5028, Santa Clara County, California",6,6,0
1000000US060855028001028,060855028001028,"Block 1028, Block Group 1, Census Tract 5028, Santa Clara County, California",20,18,2
1000000US060855028001029,060855028001029,"Block 1029, Block Group 1, Census Tract 5028, Santa Clara County, California",27,27,0
1000000US060855028001030,060855028001030,"Block 1030, Block Group 1, Census Tract 5028, Santa Clara County, California",0,0,0
1000000US060855028002000,060855028002000,"Block 2000, Block Group 2, Census Tract 5028, Santa Clara County, California",66,64,2
1000000US060855028002001,060855028002001,"Block 2001, Block Group 2, Census Tract 5028, Santa Clara County, California",18,17,1
1000000US060855028002002,060855028002002,"Block 2002, Block Group 2, Census Tract 5028, Santa Clara County, California",33,33,0
1000000US060855028002003,060855028002003,"Block 2003, Block Group 2, Census Tract 5028, Santa Clara County, California",18,18,0
1000000US060855028002004,060855028002004,"Block 2004, Block Group 2, Census Tract 5028, Santa Clara County, California",23,23,0
1000000US060855028002005,060855028002005,"Block 2005, Block Group 2, Census Tract 5028, Santa Clara County, California",36,36,0
1000000US060855028002006,060855028002006,"Block 2006, Block Group 2, Census Tract 5028, Santa Clara County, California",11,11,0
1000000US060855028002007,060855028002007,"Block 2007, Block Group 2, Census Tract 5028, Santa Clara County, California",0,0,0
1000000US060855028002008,060855028002008,"Block 2008, Block Group 2, Census Tract 5028, Santa Clara County, California",22,22,0
1000000US060855028002009,060855028002009,"Block 2009, Block Group 2, Census Tract 5028, Santa Clara County, California",27,27,0
1000000US060855028002010,060855028002010,"Block 2010, Block Group 2, Census Tract 5028, Santa Clara County, California",32,32,0
1000000US060855028002011,060855028002011,"Block 2011, Block Group 2, Census Tract 5028, Santa Clara County, California",47,47,0
1000000US060855028002012,060855028002012,"Block 2012, Block Group 2, Census Tract 5028, Santa Clara County, California",32,32,0
1000000US060855028002013,060855028002013,"Block 2013, Block Group 2, Census Tract 5028, Santa Clara County, California",50,48,2
1000000US060855028002014,060855028002014,"Block 2014, Block Group 2, Census Tract 5028, Santa Clara County, California",23,23,0
1000000US060855028002015,060855028002015,"Block 2015, Block Group 2, Census Tract 5028, Santa Clara County, California",40,40,0
1000000US060855028002016,060855028002016,"Block 2016, Block Group 2, Census Tract 5028, Santa Clara County, California",27,27,0
1000000US060855028002017,060855028002017,"Block 2017, Block Group 2, Census Tract 5028, Santa Clara County, California",33,33,0
1000000US060855028002018,060855028002018,"Block 2018, Block Group 2, Census Tract 5028, Santa Clara County, California",38,38,0
1000000US060855028002019,060855028002019,"Block 2019, Block Group 2, Census Tract 5028, Santa Clara County, California",0,0,0
1000000US060855028002020,060855028002020,"Block 2020, Block Group 2, Census Tract 5028, Santa Clara County, California",0,0,0
1000000US060855028002021,060855028002021,"Block 2021, Block Group 2, Census Tract 5028, Santa Clara County, California",0,0,0
1000000US060855028003000,060855028003000,"Block 3000, Block Group 3, Census Tract 5028, Santa Clara County, California",23,22,1
1000000US060855028003001,060855028003001,"Block 3001, Block Group 3, Census Tract 5028, Santa Clara County, California",7,7,0
1000000US060855028003002,060855028003002,"Block 3002, Block Group 3, Census Tract 5028, Santa Clara County, California",6,6,0
1000000US060855028003003,060855028003003,"Block 3003, Block Group 3, Census Tract 5028, Santa Clara County, California",13,13,0
1000000US060855028003004,060855028003004,"Block 3004, Block Group 3, Census Tract 5028, Santa Clara County, California",61,60,1
1000000US060855028003005,060855028003005,"Block 3005, Block Group 3, Census Tract 5028, Santa Clara County, California",19,19,0
1000000US060855028003006,060855028003006,"Block 3006, Block Group 3, Census Tract 5028, Santa Clara County, California",19,18,1
1000000US060855028003007,060855028003007,"Block 3007, Block Group 3, Census Tract 5028, Santa Clara County, California",71,67,4
1000000US060855028003008,060855028003008,"Block 3008, Block Group 3, Census Tract 5028, Santa Clara County, California",19,19,0
1000000US060855028003009,060855028003009,"Block 3009, Block Group 3, Census Tract 5028, Santa Clara County, California",94,93,1
1000000US060855028003010,060855028003010,"Block 3010, Block Group 3, Census Tract 5028, Santa Clara County, California",17,17,0
1000000US060855028003011,060855028003011,"Block 3011, Block Group 3, Census Tract 5028, Santa Clara County, California",18,16,2
1000000US060855028003012,060855028003012,"Block 3012, Block Group 3, Census Tract 5028, Santa Clara County, California",0,0,0
1000000US060855028003013,060855028003013,"Block 3013, Block Group 3, Census Tract 5028, Santa Clara County, California",0,0,0
1000000US060855028003014,060855028003014,"Block 3014, Block Group 3, Census Tract 5028, Santa Clara County, California",0,0,0
1000000US060855028003015,060855028003015,"Block 3015, Block Group 3, Census Tract 5028, Santa Clara County, California",0,0,0
1000000US060855028003016,060855028003016,"Block 3016, Block Group 3, Census Tract 5028, Santa Clara County, California",0,0,0
1000000US060855028003017,060855028003017,"Block 3017, Block Group 3, Census Tract 5028, Santa Clara County, California",17,17,0
1000000US060855029011000,060855029011000,"Block 1000, Block Group 1, Census Tract 5029.01, Santa Clara County, California",103,101,2
1000000US060855029011001,060855029011001,"Block 1001, Block Group 1, Census Tract 5029.01, Santa Clara County, California",19,19,0
1000000US060855029011002,060855029011002,"Block 1002, Block Group 1, Census Tract 5029.01, Santa Clara County, California",16,16,0
1000000US060855029011003,060855029011003,"Block 1003, Block Group 1, Census Tract 5029.01, Santa Clara County, California",26,25,1
1000000US060855029011004,060855029011004,"Block 1004, Block Group 1, Census Tract 5029.01, Santa Clara County, California",19,19,0
1000000US060855029011005,060855029011005,"Block 1005, Block Group 1, Census Tract 5029.01, Santa Clara County, California",18,18,0
1000000US060855029011006,060855029011006,"Block 1006, Block Group 1, Census Tract 5029.01, Santa Clara County, California",71,70,1
1000000US060855029011007,060855029011007,"Block 1007, Block Group 1, Census Tract 5029.01, Santa Clara County, California",18,17,1
1000000US060855029011008,060855029011008,"Block 1008, Block Group 1, Census Tract 5029.01, Santa Clara County, California",37,35,2
1000000US060855029011009,060855029011009,"Block 1009, Block Group 1, Census Tract 5029.01, Santa Clara County, California",32,32,0
1000000US060855029011010,060855029011010,"Block 1010, Block Group 1, Census Tract 5029.01, Santa Clara County, California",14,14,0
1000000US060855029011011,060855029011011,"Block 1011, Block Group 1, Census Tract 5029.01, Santa Clara County, California",25,23,2
1000000US060855029011012,060855029011012,"Block 1012, Block Group 1, Census Tract 5029.01, Santa Clara County, California",35,34,1
1000000US060855029011013,060855029011013,"Block 1013, Block Group 1, Census Tract 5029.01, Santa Clara County, California",30,29,1
1000000US060855029011014,060855029011014,"Block 1014, Block Group 1, Census Tract 5029.01, Santa Clara County, California",31,31,0
1000000US060855029011015,060855029011015,"Block 1015, Block Group 1, Census Tract 5029.01, Santa Clara County, California",14,14,0
1000000US060855029012000,060855029012000,"Block 2000, Block Group 2, Census Tract 5029.01, Santa Clara County, California",24,24,0
1000000US060855029012001,060855029012001,"Block 2001, Block Group 2, Census Tract 5029.01, Santa Clara County, California",16,16,0
1000000US060855029012002,060855029012002,"Block 2002, Block Group 2, Census Tract 5029.01, Santa Clara County, California",30,29,1
1000000US060855029012003,060855029012003,"Block 2003, Block Group 2, Census Tract 5029.01, Santa Clara County, California",27,26,1
1000000US060855029012004,060855029012004,"Block 2004, Block Group 2, Census Tract 5029.01, Santa Clara County, California",18,17,1
1000000US060855029012005,060855029012005,"Block 2005, Block Group 2, Census Tract 5029.01, Santa Clara County, California",49,49,0
1000000US060855029012006,060855029012006,"Block 2006, Block Group 2, Census Tract 5029.01, Santa Clara County, California",18,18,0
1000000US060855029012007,060855029012007,"Block 2007, Block Group 2, Census Tract 5029.01, Santa Clara County, California",26,26,0
1000000US060855029012008,060855029012008,"Block 2008, Block Group 2, Census Tract 5029.01, Santa Clara County, California",22,21,1
1000000US060855029012009,060855029012009,"Block 2009, Block Group 2, Census Tract 5029.01, Santa Clara County, California",55,55,0
1000000US060855029012010,060855029012010,"Block 2010, Block Group 2, Census Tract 5029.01, Santa Clara County, California",38,37,1
1000000US060855029012011,060855029012011,"Block 2011, Block Group 2, Census Tract 5029.01, Santa Clara County, California",46,46,0
1000000US060855029012012,060855029012012,"Block 2012, Block Group 2, Census Tract 5029.01, Santa Clara County, California",44,42,2
1000000US060855029012013,060855029012013,"Block 2013, Block Group 2, Census Tract 5029.01, Santa Clara County, California",44,43,1
1000000US060855029012014,060855029012014,"Block 2014, Block Group 2, Census Tract 5029.01, Santa Clara County, California",50,50,0
1000000US060855029012015,060855029012015,"Block 2015, Block Group 2, Census Tract 5029.01, Santa Clara County, California",37,37,0
1000000US060855029012016,060855029012016,"Block 2016, Block Group 2, Census Tract 5029.01, Santa Clara County, California",26,24,2
1000000US060855029013000,060855029013000,"Block 3000, Block Group 3, Census Tract 5029.01, Santa Clara County, California",24,24,0
1000000US060855029013001,060855029013001,"Block 3001, Block Group 3, Census Tract 5029.01, Santa Clara County, California",19,19,0
1000000US060855029013002,060855029013002,"Block 3002, Block Group 3, Census Tract 5029.01, Santa Clara County, California",86,84,2
1000000US060855029013003,060855029013003,"Block 3003, Block Group 3, Census Tract 5029.01, Santa Clara County, California",16,16,0
1000000US060855029013004,060855029013004,"Block 3004, Block Group 3, Census Tract 5029.01, Santa Clara County, California",39,39,0
1000000US060855029013005,060855029013005,"Block 3005, Block Group 3, Census Tract 5029.01, Santa Clara County, California",17,17,0
1000000US060855029013006,060855029013006,"Block 3006, Block Group 3, Census Tract 5029.01, Santa Clara County, California",16,16,0
1000000US060855029013007,060855029013007,"Block 3007, Block Group 3, Census Tract 5029.01, Santa Clara County, California",31,28,3
1000000US060855029013008,060855029013008,"Block 3008, Block Group 3, Census Tract 5029.01, Santa Clara County, California",26,26,0
1000000US060855029013009,060855029013009,"Block 3009, Block Group 3, Census Tract 5029.01, Santa Clara County, California",25,25,0
1000000US060855029013010,060855029013010,"Block 3010, Block Group 3, Census Tract 5029.01, Santa Clara County, California",14,14,0
1000000US060855029013011,060855029013011,"Block 3011, Block Group 3, Census Tract 5029.01, Santa Clara County, California",42,42,0
1000000US060855029013012,060855029013012,"Block 3012, Block Group 3, Census Tract 5029.01, Santa Clara County, California",22,21,1
1000000US060855029014000,060855029014000,"Block 4000, Block Group 4, Census Tract 5029.01, Santa Clara County, California",81,79,2
1000000US060855029014001,060855029014001,"Block 4001, Block Group 4, Census Tract 5029.01, Santa Clara County, California",135,128,7
1000000US060855029014002,060855029014002,"Block 4002, Block Group 4, Census Tract 5029.01, Santa Clara County, California",208,162,46
1000000US060855029014003,060855029014003,"Block 4003, Block Group 4, Census Tract 5029.01, Santa Clara County, California",95,95,0
1000000US060855029014004,060855029014004,"Block 4004, Block Group 4, Census Tract 5029.01, Santa Clara County, California",30,27,3
1000000US060855029014005,060855029014005,"Block 4005, Block Group 4, Census Tract 5029.01, Santa Clara County, California",22,22,0
1000000US060855029014006,060855029014006,"Block 4006, Block Group 4, Census Tract 5029.01, Santa Clara County, California",43,42,1
1000000US060855029014007,060855029014007,"Block 4007, Block Group 4, Census Tract 5029.01, Santa Clara County, California",30,30,0
1000000US060855029014008,060855029014008,"Block 4008, Block Group 4, Census Tract 5029.01, Santa Clara County, California",34,32,2
1000000US060855029014009,060855029014009,"Block 4009, Block Group 4, Census Tract 5029.01, Santa Clara County, California",36,35,1
1000000US060855029014010,060855029014010,"Block 4010, Block Group 4, Census Tract 5029.01, Santa Clara County, California",25,25,0
1000000US060855029014011,060855029014011,"Block 4011, Block Group 4, Census Tract 5029.01, Santa Clara County, California",34,32,2
1000000US060855029014012,060855029014012,"Block 4012, Block Group 4, Census Tract 5029.01, Santa Clara County, California",34,33,1
1000000US060855029014013,060855029014013,"Block 4013, Block Group 4, Census Tract 5029.01, Santa Clara County, California",24,23,1
1000000US060855029021000,060855029021000,"Block 1000, Block Group 1, Census Tract 5029.02, Santa Clara County, California",31,31,0
1000000US060855029021001,060855029021001,"Block 1001, Block Group 1, Census Tract 5029.02, Santa Clara County, California",7,7,0
1000000US060855029021002,060855029021002,"Block 1002, Block Group 1, Census Tract 5029.02, Santa Clara County, California",21,20,1
1000000US060855029021003,060855029021003,"Block 1003, Block Group 1, Census Tract 5029.02, Santa Clara County, California",20,20,0
1000000US060855029021004,060855029021004,"Block 1004, Block Group 1, Census Tract 5029.02, Santa Clara County, California",9,9,0
1000000US060855029021005,060855029021005,"Block 1005, Block Group 1, Census Tract 5029.02, Santa Clara County, California",34,34,0
1000000US060855029021006,060855029021006,"Block 1006, Block Group 1, Census Tract 5029.02, Santa Clara County, California",23,23,0
1000000US060855029021007,060855029021007,"Block 1007, Block Group 1, Census Tract 5029.02, Santa Clara County, California",24,24,0
1000000US060855029021008,060855029021008,"Block 1008, Block Group 1, Census Tract 5029.02, Santa Clara County, California",16,15,1
1000000US060855029021009,060855029021009,"Block 1009, Block Group 1, Census Tract 5029.02, Santa Clara County, California",54,53,1
1000000US060855029021010,060855029021010,"Block 1010, Block Group 1, Census Tract 5029.02, Santa Clara County, California",25,24,1
1000000US060855029021011,060855029021011,"Block 1011, Block Group 1, Census Tract 5029.02, Santa Clara County, California",18,17,1
1000000US060855029021012,060855029021012,"Block 1012, Block Group 1, Census Tract 5029.02, Santa Clara County, California",47,46,1
1000000US060855029021013,060855029021013,"Block 1013, Block Group 1, Census Tract 5029.02, Santa Clara County, California",43,43,0
1000000US060855029021014,060855029021014,"Block 1014, Block Group 1, Census Tract 5029.02, Santa Clara County, California",23,23,0
1000000US060855029021015,060855029021015,"Block 1015, Block Group 1, Census Tract 5029.02, Santa Clara County, California",21,21,0
1000000US060855029021016,060855029021016,"Block 1016, Block Group 1, Census Tract 5029.02, Santa Clara County, California",16,16,0
1000000US060855029021017,060855029021017,"Block 1017, Block Group 1, Census Tract 5029.02, Santa Clara County, California",30,30,0
1000000US060855029021018,060855029021018,"Block 1018, Block Group 1, Census Tract 5029.02, Santa Clara County, California",29,28,1
1000000US060855029021019,060855029021019,"Block 1019, Block Group 1, Census Tract 5029.02, Santa Clara County, California",44,44,0
1000000US060855029021020,060855029021020,"Block 1020, Block Group 1, Census Tract 5029.02, Santa Clara County, California",22,21,1
1000000US060855029021021,060855029021021,"Block 1021, Block Group 1, Census Tract 5029.02, Santa Clara County, California",29,29,0
1000000US060855029021022,060855029021022,"Block 1022, Block Group 1, Census Tract 5029.02, Santa Clara County, California",14,14,0
1000000US060855029021023,060855029021023,"Block 1023, Block Group 1, Census Tract 5029.02, Santa Clara County, California",50,49,1
1000000US060855029021024,060855029021024,"Block 1024, Block Group 1, Census Tract 5029.02, Santa Clara County, California",40,40,0
1000000US060855029021025,060855029021025,"Block 1025, Block Group 1, Census Tract 5029.02, Santa Clara County, California",57,53,4
1000000US060855029021026,060855029021026,"Block 1026, Block Group 1, Census Tract 5029.02, Santa Clara County, California",32,31,1
1000000US060855029021027,060855029021027,"Block 1027, Block Group 1, Census Tract 5029.02, Santa Clara County, California",22,21,1
1000000US060855029021028,060855029021028,"Block 1028, Block Group 1, Census Tract 5029.02, Santa Clara County, California",26,26,0
1000000US060855029022000,060855029022000,"Block 2000, Block Group 2, Census Tract 5029.02, Santa Clara County, California",51,51,0
1000000US060855029022001,060855029022001,"Block 2001, Block Group 2, Census Tract 5029.02, Santa Clara County, California",47,47,0
1000000US060855029022002,060855029022002,"Block 2002, Block Group 2, Census Tract 5029.02, Santa Clara County, California",20,18,2
1000000US060855029022003,060855029022003,"Block 2003, Block Group 2, Census Tract 5029.02, Santa Clara County, California",60,60,0
1000000US060855029022004,060855029022004,"Block 2004, Block Group 2, Census Tract 5029.02, Santa Clara County, California",37,37,0
1000000US060855029022005,060855029022005,"Block 2005, Block Group 2, Census Tract 5029.02, Santa Clara County, California",32,31,1
1000000US060855029022006,060855029022006,"Block 2006, Block Group 2, Census Tract 5029.02, Santa Clara County, California",47,47,0
1000000US060855029022007,060855029022007,"Block 2007, Block Group 2, Census Tract 5029.02, Santa Clara County, California",45,45,0
1000000US060855029022008,060855029022008,"Block 2008, Block Group 2, Census Tract 5029.02, Santa Clara County, California",19,19,0
1000000US060855029022009,060855029022009,"Block 2009, Block Group 2, Census Tract 5029.02, Santa Clara County, California",18,18,0
1000000US060855029022010,060855029022010,"Block 2010, Block Group 2, Census Tract 5029.02, Santa Clara County, California",19,19,0
1000000US060855029022011,060855029022011,"Block 2011, Block Group 2, Census Tract 5029.02, Santa Clara County, California",23,21,2
1000000US060855029022012,060855029022012,"Block 2012, Block Group 2, Census Tract 5029.02, Santa Clara County, California",20,20,0
1000000US060855029022013,060855029022013,"Block 2013, Block Group 2, Census Tract 5029.02, Santa Clara County, California",44,42,2
1000000US060855029022014,060855029022014,"Block 2014, Block Group 2, Census Tract 5029.02, Santa Clara County, California",47,46,1
1000000US060855029022015,060855029022015,"Block 2015, Block Group 2, Census Tract 5029.02, Santa Clara County, California",18,18,0
1000000US060855029022016,060855029022016,"Block 2016, Block Group 2, Census Tract 5029.02, Santa Clara County, California",30,29,1
1000000US060855029022017,060855029022017,"Block 2017, Block Group 2, Census Tract 5029.02, Santa Clara County, California",28,27,1
1000000US060855029022018,060855029022018,"Block 2018, Block Group 2, Census Tract 5029.02, Santa Clara County, California",15,14,1
1000000US060855029022019,060855029022019,"Block 2019, Block Group 2, Census Tract 5029.02, Santa Clara County, California",35,34,1
1000000US060855029022020,060855029022020,"Block 2020, Block Group 2, Census Tract 5029.02, Santa Clara County, California",28,28,0
1000000US060855029022021,060855029022021,"Block 2021, Block Group 2, Census Tract 5029.02, Santa Clara County, California",41,40,1
1000000US060855029022022,060855029022022,"Block 2022, Block Group 2, Census Tract 5029.02, Santa Clara County, California",23,21,2
1000000US060855029022023,060855029022023,"Block 2023, Block Group 2, Census Tract 5029.02, Santa Clara County, California",89,89,0
1000000US060855029022024,060855029022024,"Block 2024, Block Group 2, Census Tract 5029.02, Santa Clara County, California",39,39,0
1000000US060855029022025,060855029022025,"Block 2025, Block Group 2, Census Tract 5029.02, Santa Clara County, California",13,13,0
1000000US060855029023000,060855029023000,"Block 3000, Block Group 3, Census Tract 5029.02, Santa Clara County, California",38,37,1
1000000US060855029023001,060855029023001,"Block 3001, Block Group 3, Census Tract 5029.02, Santa Clara County, California",6,6,0
1000000US060855029023002,060855029023002,"Block 3002, Block Group 3, Census Tract 5029.02, Santa Clara County, California",11,10,1
1000000US060855029023003,060855029023003,"Block 3003, Block Group 3, Census Tract 5029.02, Santa Clara County, California",33,33,0
1000000US060855029023004,060855029023004,"Block 3004, Block Group 3, Census Tract 5029.02, Santa Clara County, California",194,97,97
1000000US060855029023005,060855029023005,"Block 3005, Block Group 3, Census Tract 5029.02, Santa Clara County, California",0,0,0
1000000US060855029023006,060855029023006,"Block 3006, Block Group 3, Census Tract 5029.02, Santa Clara County, California",48,46,2
1000000US060855029023007,060855029023007,"Block 3007, Block Group 3, Census Tract 5029.02, Santa Clara County, California",23,22,1
1000000US060855029023008,060855029023008,"Block 3008, Block Group 3, Census Tract 5029.02, Santa Clara County, California",19,19,0
1000000US060855029023009,060855029023009,"Block 3009, Block Group 3, Census Tract 5029.02, Santa Clara County, California",7,7,0
1000000US060855029023010,060855029023010,"Block 3010, Block Group 3, Census Tract 5029.02, Santa Clara County, California",34,34,0
1000000US060855029023011,060855029023011,"Block 3011, Block Group 3, Census Tract 5029.02, Santa Clara County, California",22,22,0
1000000US060855029023012,060855029023012,"Block 3012, Block Group 3, Census Tract 5029.02, Santa Clara County, California",28,27,1
1000000US060855029023013,060855029023013,"Block 3013, Block Group 3, Census Tract 5029.02, Santa Clara County, California",32,30,2
1000000US060855029023014,060855029023014,"Block 3014, Block Group 3, Census Tract 5029.02, Santa Clara County, California",41,41,0
1000000US060855029023015,060855029023015,"Block 3015, Block Group 3, Census Tract 5029.02, Santa Clara County, California",20,20,0
1000000US060855029023016,060855029023016,"Block 3016, Block Group 3, Census Tract 5029.02, Santa Clara County, California",42,41,1
1000000US060855029023017,060855029023017,"Block 3017, Block Group 3, Census Tract 5029.02, Santa Clara County, California",42,42,0
1000000US060855029023018,060855029023018,"Block 3018, Block Group 3, Census Tract 5029.02, Santa Clara County, California",43,43,0
1000000US060855029023019,060855029023019,"Block 3019, Block Group 3, Census Tract 5029.02, Santa Clara County, California",61,60,1
1000000US060855029023020,060855029023020,"Block 3020, Block Group 3, Census Tract 5029.02, Santa Clara County, California",9,9,0
1000000US060855029023021,060855029023021,"Block 3021, Block Group 3, Census Tract 5029.02, Santa Clara County, California",27,27,0
1000000US060855029023022,060855029023022,"Block 3022, Block Group 3, Census Tract 5029.02, Santa Clara County, California",22,22,0
1000000US060855029023023,060855029023023,"Block 3023, Block Group 3, Census Tract 5029.02, Santa Clara County, California",171,167,4
1000000US060855029023024,060855029023024,"Block 3024, Block Group 3, Census Tract 5029.02, Santa Clara County, California",28,28,0
1000000US060855029031000,060855029031000,"Block 1000, Block Group 1, Census Tract 5029.03, Santa Clara County, California",20,19,1
1000000US060855029031001,060855029031001,"Block 1001, Block Group 1, Census Tract 5029.03, Santa Clara County, California",21,19,2
1000000US060855029031002,060855029031002,"Block 1002, Block Group 1, Census Tract 5029.03, Santa Clara County, California",22,21,1
1000000US060855029031003,060855029031003,"Block 1003, Block Group 1, Census Tract 5029.03, Santa Clara County, California",32,32,0
1000000US060855029031004,060855029031004,"Block 1004, Block Group 1, Census Tract 5029.03, Santa Clara County, California",39,37,2
1000000US060855029031005,060855029031005,"Block 1005, Block Group 1, Census Tract 5029.03, Santa Clara County, California",27,26,1
1000000US060855029031006,060855029031006,"Block 1006, Block Group 1, Census Tract 5029.03, Santa Clara County, California",7,7,0
1000000US060855029031007,060855029031007,"Block 1007, Block Group 1, Census Tract 5029.03, Santa Clara County, California",44,44,0
1000000US060855029031008,060855029031008,"Block 1008, Block Group 1, Census Tract 5029.03, Santa Clara County, California",19,18,1
1000000US060855029031009,060855029031009,"Block 1009, Block Group 1, Census Tract 5029.03, Santa Clara County, California",31,29,2
1000000US060855029031010,060855029031010,"Block 1010, Block Group 1, Census Tract 5029.03, Santa Clara County, California",38,38,0
1000000US060855029031011,060855029031011,"Block 1011, Block Group 1, Census Tract 5029.03, Santa Clara County, California",28,28,0
1000000US060855029031012,060855029031012,"Block 1012, Block Group 1, Census Tract 5029.03, Santa Clara County, California",42,41,1
1000000US060855029031013,060855029031013,"Block 1013, Block Group 1, Census Tract 5029.03, Santa Clara County, California",22,21,1
1000000US060855029031014,060855029031014,"Block 1014, Block Group 1, Census Tract 5029.03, Santa Clara County, California",26,25,1
1000000US060855029031015,060855029031015,"Block 1015, Block Group 1, Census Tract 5029.03, Santa Clara County, California",18,17,1
1000000US060855029031016,060855029031016,"Block 1016, Block Group 1, Census Tract 5029.03, Santa Clara County, California",29,29,0
1000000US060855029031017,060855029031017,"Block 1017, Block Group 1, Census Tract 5029.03, Santa Clara County, California",26,26,0
1000000US060855029031018,060855029031018,"Block 1018, Block Group 1, Census Tract 5029.03, Santa Clara County, California",52,51,1
1000000US060855029031019,060855029031019,"Block 1019, Block Group 1, Census Tract 5029.03, Santa Clara County, California",56,56,0
1000000US060855029031020,060855029031020,"Block 1020, Block Group 1, Census Tract 5029.03, Santa Clara County, California",20,19,1
1000000US060855029031021,060855029031021,"Block 1021, Block Group 1, Census Tract 5029.03, Santa Clara County, California",34,34,0
1000000US060855029031022,060855029031022,"Block 1022, Block Group 1, Census Tract 5029.03, Santa Clara County, California",34,32,2
1000000US060855029031023,060855029031023,"Block 1023, Block Group 1, Census Tract 5029.03, Santa Clara County, California",45,43,2
1000000US060855029031024,060855029031024,"Block 1024, Block Group 1, Census Tract 5029.03, Santa Clara County, California",25,24,1
1000000US060855029031025,060855029031025,"Block 1025, Block Group 1, Census Tract 5029.03, Santa Clara County, California",22,22,0
1000000US060855029031026,060855029031026,"Block 1026, Block Group 1, Census Tract 5029.03, Santa Clara County, California",25,25,0
1000000US060855029031027,060855029031027,"Block 1027, Block Group 1, Census Tract 5029.03, Santa Clara County, California",13,13,0
1000000US060855029032000,060855029032000,"Block 2000, Block Group 2, Census Tract 5029.03, Santa Clara County, California",24,24,0
1000000US060855029032001,060855029032001,"Block 2001, Block Group 2, Census Tract 5029.03, Santa Clara County, California",29,28,1
1000000US060855029032002,060855029032002,"Block 2002, Block Group 2, Census Tract 5029.03, Santa Clara County, California",28,28,0
1000000US060855029032003,060855029032003,"Block 2003, Block Group 2, Census Tract 5029.03, Santa Clara County, California",26,26,0
1000000US060855029032004,060855029032004,"Block 2004, Block Group 2, Census Tract 5029.03, Santa Clara County, California",26,26,0
1000000US060855029032005,060855029032005,"Block 2005, Block Group 2, Census Tract 5029.03, Santa Clara County, California",14,13,1
1000000US060855029032006,060855029032006,"Block 2006, Block Group 2, Census Tract 5029.03, Santa Clara County, California",27,25,2
1000000US060855029032007,060855029032007,"Block 2007, Block Group 2, Census Tract 5029.03, Santa Clara County, California",27,27,0
1000000US060855029032008,060855029032008,"Block 2008, Block Group 2, Census Tract 5029.03, Santa Clara County, California",29,29,0
1000000US060855029032009,060855029032009,"Block 2009, Block Group 2, Census Tract 5029.03, Santa Clara County, California",21,21,0
1000000US060855029032010,060855029032010,"Block 2010, Block Group 2, Census Tract 5029.03, Santa Clara County, California",16,16,0
1000000US060855029032011,060855029032011,"Block 2011, Block Group 2, Census Tract 5029.03, Santa Clara County, California",16,15,1
1000000US060855029032012,060855029032012,"Block 2012, Block Group 2, Census Tract 5029.03, Santa Clara County, California",17,16,1
1000000US060855029032013,060855029032013,"Block 2013, Block Group 2, Census Tract 5029.03, Santa Clara County, California",34,34,0
1000000US060855029032014,060855029032014,"Block 2014, Block Group 2, Census Tract 5029.03, Santa Clara County, California",51,48,3
1000000US060855029032015,060855029032015,"Block 2015, Block Group 2, Census Tract 5029.03, Santa Clara County, California",18,18,0
1000000US060855029032016,060855029032016,"Block 2016, Block Group 2, Census Tract 5029.03, Santa Clara County, California",13,13,0
1000000US060855029032017,060855029032017,"Block 2017, Block Group 2, Census Tract 5029.03, Santa Clara County, California",16,16,0
1000000US060855029032018,060855029032018,"Block 2018, Block Group 2, Census Tract 5029.03, Santa Clara County, California",24,24,0
1000000US060855029032019,060855029032019,"Block 2019, Block Group 2, Census Tract 5029.03, Santa Clara County, California",34,34,0
1000000US060855029032020,060855029032020,"Block 2020, Block Group 2, Census Tract 5029.03, Santa Clara County, California",34,34,0
1000000US060855029032021,060855029032021,"Block 2021, Block Group 2, Census Tract 5029.03, Santa Clara County, California",15,15,0
1000000US060855029033000,060855029033000,"Block 3000, Block Group 3, Census Tract 5029.03, Santa Clara County, California",16,16,0
1000000US060855029033001,060855029033001,"Block 3001, Block Group 3, Census Tract 5029.03, Santa Clara County, California",16,16,0
1000000US060855029033002,060855029033002,"Block 3002, Block Group 3, Census Tract 5029.03, Santa Clara County, California",29,29,0
1000000US060855029033003,060855029033003,"Block 3003, Block Group 3, Census Tract 5029.03, Santa Clara County, California",23,23,0
1000000US060855029033004,060855029033004,"Block 3004, Block Group 3, Census Tract 5029.03, Santa Clara County, California",40,39,1
1000000US060855029033005,060855029033005,"Block 3005, Block Group 3, Census Tract 5029.03, Santa Clara County, California",51,51,0
1000000US060855029033006,060855029033006,"Block 3006, Block Group 3, Census Tract 5029.03, Santa Clara County, California",17,16,1
1000000US060855029033007,060855029033007,"Block 3007, Block Group 3, Census Tract 5029.03, Santa Clara County, California",18,18,0
1000000US060855029033008,060855029033008,"Block 3008, Block Group 3, Census Tract 5029.03, Santa Clara County, California",23,23,0
1000000US060855029033009,060855029033009,"Block 3009, Block Group 3, Census Tract 5029.03, Santa Clara County, California",26,26,0
1000000US060855029033010,060855029033010,"Block 3010, Block Group 3, Census Tract 5029.03, Santa Clara County, California",45,44,1
1000000US060855029033011,060855029033011,"Block 3011, Block Group 3, Census Tract 5029.03, Santa Clara County, California",33,31,2
1000000US060855029033012,060855029033012,"Block 3012, Block Group 3, Census Tract 5029.03, Santa Clara County, California",46,44,2
1000000US060855029033013,060855029033013,"Block 3013, Block Group 3, Census Tract 5029.03, Santa Clara County, California",34,33,1
1000000US060855029033014,060855029033014,"Block 3014, Block Group 3, Census Tract 5029.03, Santa Clara County, California",36,36,0
1000000US060855029033015,060855029033015,"Block 3015, Block Group 3, Census Tract 5029.03, Santa Clara County, California",16,16,0
1000000US060855029033016,060855029033016,"Block 3016, Block Group 3, Census Tract 5029.03, Santa Clara County, California",38,33,5
1000000US060855029033017,060855029033017,"Block 3017, Block Group 3, Census Tract 5029.03, Santa Clara County, California",26,25,1
1000000US060855029033018,060855029033018,"Block 3018, Block Group 3, Census Tract 5029.03, Santa Clara County, California",19,19,0
1000000US060855029033019,060855029033019,"Block 3019, Block Group 3, Census Tract 5029.03, Santa Clara County, California",36,36,0
1000000US060855029033020,060855029033020,"Block 3020, Block Group 3, Census Tract 5029.03, Santa Clara County, California",18,17,1
1000000US060855029061000,060855029061000,"Block 1000, Block Group 1, Census Tract 5029.06, Santa Clara County, California",380,368,12
1000000US060855029061001,060855029061001,"Block 1001, Block Group 1, Census Tract 5029.06, Santa Clara County, California",104,100,4
1000000US060855029061002,060855029061002,"Block 1002, Block Group 1, Census Tract 5029.06, Santa Clara County, California",26,25,1
1000000US060855029061003,060855029061003,"Block 1003, Block Group 1, Census Tract 5029.06, Santa Clara County, California",0,0,0
1000000US060855029062000,060855029062000,"Block 2000, Block Group 2, Census Tract 5029.06, Santa Clara County, California",42,41,1
1000000US060855029062001,060855029062001,"Block 2001, Block Group 2, Census Tract 5029.06, Santa Clara County, California",54,54,0
1000000US060855029062002,060855029062002,"Block 2002, Block Group 2, Census Tract 5029.06, Santa Clara County, California",41,41,0
1000000US060855029062003,060855029062003,"Block 2003, Block Group 2, Census Tract 5029.06, Santa Clara County, California",32,32,0
1000000US060855029062004,060855029062004,"Block 2004, Block Group 2, Census Tract 5029.06, Santa Clara County, California",47,47,0
1000000US060855029062005,060855029062005,"Block 2005, Block Group 2, Census Tract 5029.06, Santa Clara County, California",35,34,1
1000000US060855029062006,060855029062006,"Block 2006, Block Group 2, Census Tract 5029.06, Santa Clara County, California",49,48,1
1000000US060855029062007,060855029062007,"Block 2007, Block Group 2, Census Tract 5029.06, Santa Clara County, California",30,30,0
1000000US060855029062008,060855029062008,"Block 2008, Block Group 2, Census Tract 5029.06, Santa Clara County, California",17,16,1
1000000US060855029062009,060855029062009,"Block 2009, Block Group 2, Census Tract 5029.06, Santa Clara County, California",119,114,5
1000000US060855029062010,060855029062010,"Block 2010, Block Group 2, Census Tract 5029.06, Santa Clara County, California",43,43,0
1000000US060855029062011,060855029062011,"Block 2011, Block Group 2, Census Tract 5029.06, Santa Clara County, California",33,33,0
1000000US060855029062012,060855029062012,"Block 2012, Block Group 2, Census Tract 5029.06, Santa Clara County, California",43,43,0
1000000US060855029062013,060855029062013,"Block 2013, Block Group 2, Census Tract 5029.06, Santa Clara County, California",14,14,0
1000000US060855029062014,060855029062014,"Block 2014, Block Group 2, Census Tract 5029.06, Santa Clara County, California",17,17,0
1000000US060855029063000,060855029063000,"Block 3000, Block Group 3, Census Tract 5029.06, Santa Clara County, California",13,13,0
1000000US060855029063001,060855029063001,"Block 3001, Block Group 3, Census Tract 5029.06, Santa Clara County, California",40,40,0
1000000US060855029063002,060855029063002,"Block 3002, Block Group 3, Census Tract 5029.06, Santa Clara County, California",39,38,1
1000000US060855029063003,060855029063003,"Block 3003, Block Group 3, Census Tract 5029.06, Santa Clara County, California",40,40,0
1000000US060855029063004,060855029063004,"Block 3004, Block Group 3, Census Tract 5029.06, Santa Clara County, California",25,23,2
1000000US060855029063005,060855029063005,"Block 3005, Block Group 3, Census Tract 5029.06, Santa Clara County, California",132,125,7
1000000US060855029063006,060855029063006,"Block 3006, Block Group 3, Census Tract 5029.06, Santa Clara County, California",28,28,0
1000000US060855029063007,060855029063007,"Block 3007, Block Group 3, Census Tract 5029.06, Santa Clara County, California",28,27,1
1000000US060855029063008,060855029063008,"Block 3008, Block Group 3, Census Tract 5029.06, Santa Clara County, California",16,16,0
1000000US060855029063009,060855029063009,"Block 3009, Block Group 3, Census Tract 5029.06, Santa Clara County, California",28,26,2
1000000US060855029063010,060855029063010,"Block 3010, Block Group 3, Census Tract 5029.06, Santa Clara County, California",37,37,0
1000000US060855029063011,060855029063011,"Block 3011, Block Group 3, Census Tract 5029.06, Santa Clara County, California",22,22,0
1000000US060855029063012,060855029063012,"Block 3012, Block Group 3, Census Tract 5029.06, Santa Clara County, California",19,19,0
1000000US060855029063013,060855029063013,"Block 3013, Block Group 3, Census Tract 5029.06, Santa Clara County, California",13,13,0
1000000US060855029063014,060855029063014,"Block 3014, Block Group 3, Census Tract 5029.06, Santa Clara County, California",27,26,1
1000000US060855029063015,060855029063015,"Block 3015, Block Group 3, Census Tract 5029.06, Santa Clara County, California",22,22,0
1000000US060855029071000,060855029071000,"Block 1000, Block Group 1, Census Tract 5029.07, Santa Clara County, California",30,29,1
1000000US060855029071001,060855029071001,"Block 1001, Block Group 1, Census Tract 5029.07, Santa Clara County, California",24,24,0
1000000US060855029071002,060855029071002,"Block 1002, Block Group 1, Census Tract 5029.07, Santa Clara County, California",37,36,1
1000000US060855029071003,060855029071003,"Block 1003, Block Group 1, Census Tract 5029.07, Santa Clara County, California",50,49,1
1000000US060855029071004,060855029071004,"Block 1004, Block Group 1, Census Tract 5029.07, Santa Clara County, California",45,45,0
1000000US060855029071005,060855029071005,"Block 1005, Block Group 1, Census Tract 5029.07, Santa Clara County, California",36,34,2
1000000US060855029071006,060855029071006,"Block 1006, Block Group 1, Census Tract 5029.07, Santa Clara County, California",37,37,0
1000000US060855029071007,060855029071007,"Block 1007, Block Group 1, Census Tract 5029.07, Santa Clara County, California",15,15,0
1000000US060855029071008,060855029071008,"Block 1008, Block Group 1, Census Tract 5029.07, Santa Clara County, California",15,15,0
1000000US060855029071009,060855029071009,"Block 1009, Block Group 1, Census Tract 5029.07, Santa Clara County, California",38,37,1
1000000US060855029071010,060855029071010,"Block 1010, Block Group 1, Census Tract 5029.07, Santa Clara County, California",32,32,0
1000000US060855029071011,060855029071011,"Block 1011, Block Group 1, Census Tract 5029.07, Santa Clara County, California",32,32,0
1000000US060855029071012,060855029071012,"Block 1012, Block Group 1, Census Tract 5029.07, Santa Clara County, California",28,28,0
1000000US060855029071013,060855029071013,"Block 1013, Block Group 1, Census Tract 5029.07, Santa Clara County, California",32,31,1
1000000US060855029071014,060855029071014,"Block 1014, Block Group 1, Census Tract 5029.07, Santa Clara County, California",28,28,0
1000000US060855029071015,060855029071015,"Block 1015, Block Group 1, Census Tract 5029.07, Santa Clara County, California",28,25,3
1000000US060855029071016,060855029071016,"Block 1016, Block Group 1, Census Tract 5029.07, Santa Clara County, California",28,27,1
1000000US060855029071017,060855029071017,"Block 1017, Block Group 1, Census Tract 5029.07, Santa Clara County, California",38,38,0
1000000US060855029071018,060855029071018,"Block 1018, Block Group 1, Census Tract 5029.07, Santa Clara County, California",38,38,0
1000000US060855029071019,060855029071019,"Block 1019, Block Group 1, Census Tract 5029.07, Santa Clara County, California",37,37,0
1000000US060855029071020,060855029071020,"Block 1020, Block Group 1, Census Tract 5029.07, Santa Clara County, California",26,25,1
1000000US060855029072000,060855029072000,"Block 2000, Block Group 2, Census Tract 5029.07, Santa Clara County, California",12,12,0
1000000US060855029072001,060855029072001,"Block 2001, Block Group 2, Census Tract 5029.07, Santa Clara County, California",37,36,1
1000000US060855029072002,060855029072002,"Block 2002, Block Group 2, Census Tract 5029.07, Santa Clara County, California",45,44,1
1000000US060855029072003,060855029072003,"Block 2003, Block Group 2, Census Tract 5029.07, Santa Clara County, California",35,35,0
1000000US060855029072004,060855029072004,"Block 2004, Block Group 2, Census Tract 5029.07, Santa Clara County, California",44,44,0
1000000US060855029072005,060855029072005,"Block 2005, Block Group 2, Census Tract 5029.07, Santa Clara County, California",32,31,1
1000000US060855029072006,060855029072006,"Block 2006, Block Group 2, Census Tract 5029.07, Santa Clara County, California",27,27,0
1000000US060855029072007,060855029072007,"Block 2007, Block Group 2, Census Tract 5029.07, Santa Clara County, California",16,15,1
1000000US060855029072008,060855029072008,"Block 2008, Block Group 2, Census Tract 5029.07, Santa Clara County, California",96,95,1
1000000US060855029072009,060855029072009,"Block 2009, Block Group 2, Census Tract 5029.07, Santa Clara County, California",28,27,1
1000000US060855029072010,060855029072010,"Block 2010, Block Group 2, Census Tract 5029.07, Santa Clara County, California",3,3,0
1000000US060855029072011,060855029072011,"Block 2011, Block Group 2, Census Tract 5029.07, Santa Clara County, California",43,43,0
1000000US060855029072012,060855029072012,"Block 2012, Block Group 2, Census Tract 5029.07, Santa Clara County, California",30,30,0
1000000US060855029072013,060855029072013,"Block 2013, Block Group 2, Census Tract 5029.07, Santa Clara County, California",41,41,0
1000000US060855029072014,060855029072014,"Block 2014, Block Group 2, Census Tract 5029.07, Santa Clara County, California",21,21,0
1000000US060855029072015,060855029072015,"Block 2015, Block Group 2, Census Tract 5029.07, Santa Clara County, California",38,38,0
1000000US060855029072016,060855029072016,"Block 2016, Block Group 2, Census Tract 5029.07, Santa Clara County, California",24,23,1
1000000US060855029072017,060855029072017,"Block 2017, Block Group 2, Census Tract 5029.07, Santa Clara County, California",20,19,1
1000000US060855029072018,060855029072018,"Block 2018, Block Group 2, Census Tract 5029.07, Santa Clara County, California",20,20,0
1000000US060855029072019,060855029072019,"Block 2019, Block Group 2, Census Tract 5029.07, Santa Clara County, California",21,20,1
1000000US060855029072020,060855029072020,"Block 2020, Block Group 2, Census Tract 5029.07, Santa Clara County, California",32,32,0
1000000US060855029081000,060855029081000,"Block 1000, Block Group 1, Census Tract 5029.08, Santa Clara County, California",80,79,1
1000000US060855029081001,060855029081001,"Block 1001, Block Group 1, Census Tract 5029.08, Santa Clara County, California",19,19,0
1000000US060855029081002,060855029081002,"Block 1002, Block Group 1, Census Tract 5029.08, Santa Clara County, California",18,18,0
1000000US060855029081003,060855029081003,"Block 1003, Block Group 1, Census Tract 5029.08, Santa Clara County, California",28,28,0
1000000US060855029081004,060855029081004,"Block 1004, Block Group 1, Census Tract 5029.08, Santa Clara County, California",38,36,2
1000000US060855029081005,060855029081005,"Block 1005, Block Group 1, Census Tract 5029.08, Santa Clara County, California",38,36,2
1000000US060855029081006,060855029081006,"Block 1006, Block Group 1, Census Tract 5029.08, Santa Clara County, California",38,38,0
1000000US060855029081007,060855029081007,"Block 1007, Block Group 1, Census Tract 5029.08, Santa Clara County, California",38,37,1
1000000US060855029081008,060855029081008,"Block 1008, Block Group 1, Census Tract 5029.08, Santa Clara County, California",29,28,1
1000000US060855029081009,060855029081009,"Block 1009, Block Group 1, Census Tract 5029.08, Santa Clara County, California",48,48,0
1000000US060855029081010,060855029081010,"Block 1010, Block Group 1, Census Tract 5029.08, Santa Clara County, California",22,22,0
1000000US060855029081011,060855029081011,"Block 1011, Block Group 1, Census Tract 5029.08, Santa Clara County, California",38,38,0
1000000US060855029081012,060855029081012,"Block 1012, Block Group 1, Census Tract 5029.08, Santa Clara County, California",26,25,1
1000000US060855029081013,060855029081013,"Block 1013, Block Group 1, Census Tract 5029.08, Santa Clara County, California",34,31,3
1000000US060855029081014,060855029081014,"Block 1014, Block Group 1, Census Tract 5029.08, Santa Clara County, California",20,19,1
1000000US060855029081015,060855029081015,"Block 1015, Block Group 1, Census Tract 5029.08, Santa Clara County, California",0,0,0
1000000US060855029081016,060855029081016,"Block 1016, Block Group 1, Census Tract 5029.08, Santa Clara County, California",155,152,3
1000000US060855029081017,060855029081017,"Block 1017, Block Group 1, Census Tract 5029.08, Santa Clara County, California",99,92,7
1000000US060855029081018,060855029081018,"Block 1018, Block Group 1, Census Tract 5029.08, Santa Clara County, California",0,0,0
1000000US060855029081019,060855029081019,"Block 1019, Block Group 1, Census Tract 5029.08, Santa Clara County, California",0,0,0
1000000US060855029081020,060855029081020,"Block 1020, Block Group 1, Census Tract 5029.08, Santa Clara County, California",51,50,1
1000000US060855029081021,060855029081021,"Block 1021, Block Group 1, Census Tract 5029.08, Santa Clara County, California",17,17,0
1000000US060855029082000,060855029082000,"Block 2000, Block Group 2, Census Tract 5029.08, Santa Clara County, California",18,18,0
1000000US060855029082001,060855029082001,"Block 2001, Block Group 2, Census Tract 5029.08, Santa Clara County, California",39,39,0
1000000US060855029082002,060855029082002,"Block 2002, Block Group 2, Census Tract 5029.08, Santa Clara County, California",17,17,0
1000000US060855029082003,060855029082003,"Block 2003, Block Group 2, Census Tract 5029.08, Santa Clara County, California",35,34,1
1000000US060855029082004,060855029082004,"Block 2004, Block Group 2, Census Tract 5029.08, Santa Clara County, California",0,0,0
1000000US060855029082005,060855029082005,"Block 2005, Block Group 2, Census Tract 5029.08, Santa Clara County, California",32,31,1
1000000US060855029082006,060855029082006,"Block 2006, Block Group 2, Census Tract 5029.08, Santa Clara County, California",115,115,0
1000000US060855029082007,060855029082007,"Block 2007, Block Group 2, Census Tract 5029.08, Santa Clara County, California",37,37,0
1000000US060855029082008,060855029082008,"Block 2008, Block Group 2, Census Tract 5029.08, Santa Clara County, California",28,28,0
1000000US060855029082009,060855029082009,"Block 2009, Block Group 2, Census Tract 5029.08, Santa Clara County, California",30,30,0
1000000US060855029082010,060855029082010,"Block 2010, Block Group 2, Census Tract 5029.08, Santa Clara County, California",72,72,0
1000000US060855029082011,060855029082011,"Block 2011, Block Group 2, Census Tract 5029.08, Santa Clara County, California",56,56,0
1000000US060855029082012,060855029082012,"Block 2012, Block Group 2, Census Tract 5029.08, Santa Clara County, California",38,38,0
1000000US060855029082013,060855029082013,"Block 2013, Block Group 2, Census Tract 5029.08, Santa Clara County, California",38,38,0
1000000US060855029082014,060855029082014,"Block 2014, Block Group 2, Census Tract 5029.08, Santa Clara County, California",12,12,0
1000000US060855029082015,060855029082015,"Block 2015, Block Group 2, Census Tract 5029.08, Santa Clara County, California",26,25,1
1000000US060855029082016,060855029082016,"Block 2016, Block Group 2, Census Tract 5029.08, Santa Clara County, California",35,33,2
1000000US060855029082017,060855029082017,"Block 2017, Block Group 2, Census Tract 5029.08, Santa Clara County, California",36,35,1
1000000US060855029082018,060855029082018,"Block 2018, Block Group 2, Census Tract 5029.08, Santa Clara County, California",161,154,7
1000000US060855029082019,060855029082019,"Block 2019, Block Group 2, Census Tract 5029.08, Santa Clara County, California",0,0,0
1000000US060855029082020,060855029082020,"Block 2020, Block Group 2, Census Tract 5029.08, Santa Clara County, California",14,14,0
1000000US060855029082021,060855029082021,"Block 2021, Block Group 2, Census Tract 5029.08, Santa Clara County, California",39,39,0
1000000US060855029082022,060855029082022,"Block 2022, Block Group 2, Census Tract 5029.08, Santa Clara County, California",25,24,1
1000000US060855029082023,060855029082023,"Block 2023, Block Group 2, Census Tract 5029.08, Santa Clara County, California",39,38,1
1000000US060855029082024,060855029082024,"Block 2024, Block Group 2, Census Tract 5029.08, Santa Clara County, California",16,15,1
1000000US060855029083000,060855029083000,"Block 3000, Block Group 3, Census Tract 5029.08, Santa Clara County, California",32,31,1
1000000US060855029083001,060855029083001,"Block 3001, Block Group 3, Census Tract 5029.08, Santa Clara County, California",18,17,1
1000000US060855029083002,060855029083002,"Block 3002, Block Group 3, Census Tract 5029.08, Santa Clara County, California",53,51,2
1000000US060855029083003,060855029083003,"Block 3003, Block Group 3, Census Tract 5029.08, Santa Clara County, California",18,18,0
1000000US060855029083004,060855029083004,"Block 3004, Block Group 3, Census Tract 5029.08, Santa Clara County, California",18,18,0
1000000US060855029083005,060855029083005,"Block 3005, Block Group 3, Census Tract 5029.08, Santa Clara County, California",32,32,0
1000000US060855029083006,060855029083006,"Block 3006, Block Group 3, Census Tract 5029.08, Santa Clara County, California",36,35,1
1000000US060855029083007,060855029083007,"Block 3007, Block Group 3, Census Tract 5029.08, Santa Clara County, California",88,85,3
1000000US060855029083008,060855029083008,"Block 3008, Block Group 3, Census Tract 5029.08, Santa Clara County, California",22,22,0
1000000US060855029083009,060855029083009,"Block 3009, Block Group 3, Census Tract 5029.08, Santa Clara County, California",34,34,0
1000000US060855029083010,060855029083010,"Block 3010, Block Group 3, Census Tract 5029.08, Santa Clara County, California",33,32,1
1000000US060855029083011,060855029083011,"Block 3011, Block Group 3, Census Tract 5029.08, Santa Clara County, California",39,39,0
1000000US060855029083012,060855029083012,"Block 3012, Block Group 3, Census Tract 5029.08, Santa Clara County, California",23,22,1
1000000US060855029083013,060855029083013,"Block 3013, Block Group 3, Census Tract 5029.08, Santa Clara County, California",14,13,1
1000000US060855029083014,060855029083014,"Block 3014, Block Group 3, Census Tract 5029.08, Santa Clara County, California",12,12,0
1000000US060855029083015,060855029083015,"Block 3015, Block Group 3, Census Tract 5029.08, Santa Clara County, California",12,12,0
1000000US060855029083016,060855029083016,"Block 3016, Block Group 3, Census Tract 5029.08, Santa Clara County, California",26,26,0
1000000US060855029083017,060855029083017,"Block 3017, Block Group 3, Census Tract 5029.08, Santa Clara County, California",3,2,1
1000000US060855029083018,060855029083018,"Block 3018, Block Group 3, Census Tract 5029.08, Santa Clara County, California",30,28,2
1000000US060855029083019,060855029083019,"Block 3019, Block Group 3, Census Tract 5029.08, Santa Clara County, California",23,23,0
1000000US060855029083020,060855029083020,"Block 3020, Block Group 3, Census Tract 5029.08, Santa Clara County, California",5,5,0
1000000US060855029083021,060855029083021,"Block 3021, Block Group 3, Census Tract 5029.08, Santa Clara County, California",24,23,1
1000000US060855029083022,060855029083022,"Block 3022, Block Group 3, Census Tract 5029.08, Santa Clara County, California",24,24,0
1000000US060855029091000,060855029091000,"Block 1000, Block Group 1, Census Tract 5029.09, Santa Clara County, California",47,45,2
1000000US060855029091001,060855029091001,"Block 1001, Block Group 1, Census Tract 5029.09, Santa Clara County, California",98,96,2
1000000US060855029091002,060855029091002,"Block 1002, Block Group 1, Census Tract 5029.09, Santa Clara County, California",23,23,0
1000000US060855029091003,060855029091003,"Block 1003, Block Group 1, Census Tract 5029.09, Santa Clara County, California",120,116,4
1000000US060855029091004,060855029091004,"Block 1004, Block Group 1, Census Tract 5029.09, Santa Clara County, California",15,15,0
1000000US060855029091005,060855029091005,"Block 1005, Block Group 1, Census Tract 5029.09, Santa Clara County, California",29,28,1
1000000US060855029091006,060855029091006,"Block 1006, Block Group 1, Census Tract 5029.09, Santa Clara County, California",28,28,0
1000000US060855029091007,060855029091007,"Block 1007, Block Group 1, Census Tract 5029.09, Santa Clara County, California",13,13,0
1000000US060855029091008,060855029091008,"Block 1008, Block Group 1, Census Tract 5029.09, Santa Clara County, California",39,38,1
1000000US060855029091009,060855029091009,"Block 1009, Block Group 1, Census Tract 5029.09, Santa Clara County, California",30,30,0
1000000US060855029092000,060855029092000,"Block 2000, Block Group 2, Census Tract 5029.09, Santa Clara County, California",32,31,1
1000000US060855029092001,060855029092001,"Block 2001, Block Group 2, Census Tract 5029.09, Santa Clara County, California",34,34,0
1000000US060855029092002,060855029092002,"Block 2002, Block Group 2, Census Tract 5029.09, Santa Clara County, California",19,19,0
1000000US060855029092003,060855029092003,"Block 2003, Block Group 2, Census Tract 5029.09, Santa Clara County, California",57,57,0
1000000US060855029092004,060855029092004,"Block 2004, Block Group 2, Census Tract 5029.09, Santa Clara County, California",57,55,2
1000000US060855029092005,060855029092005,"Block 2005, Block Group 2, Census Tract 5029.09, Santa Clara County, California",39,38,1
1000000US060855029092006,060855029092006,"Block 2006, Block Group 2, Census Tract 5029.09, Santa Clara County, California",60,58,2
1000000US060855029092007,060855029092007,"Block 2007, Block Group 2, Census Tract 5029.09, Santa Clara County, California",32,30,2
1000000US060855029093000,060855029093000,"Block 3000, Block Group 3, Census Tract 5029.09, Santa Clara County, California",132,123,9
1000000US060855029093001,060855029093001,"Block 3001, Block Group 3, Census Tract 5029.09, Santa Clara County, California",92,82,10
1000000US060855029093002,060855029093002,"Block 3002, Block Group 3, Census Tract 5029.09, Santa Clara County, California",56,54,2
1000000US060855029093003,060855029093003,"Block 3003, Block Group 3, Census Tract 5029.09, Santa Clara County, California",102,99,3
1000000US060855029093004,060855029093004,"Block 3004, Block Group 3, Census Tract 5029.09, Santa Clara County, California",162,155,7
1000000US060855029093005,060855029093005,"Block 3005, Block Group 3, Census Tract 5029.09, Santa Clara County, California",0,0,0
1000000US060855029093006,060855029093006,"Block 3006, Block Group 3, Census Tract 5029.09, Santa Clara County, California",34,34,0
1000000US060855029093007,060855029093007,"Block 3007, Block Group 3, Census Tract 5029.09, Santa Clara County, California",52,49,3
1000000US060855029093008,060855029093008,"Block 3008, Block Group 3, Census Tract 5029.09, Santa Clara County, California",22,22,0
1000000US060855029093009,060855029093009,"Block 3009, Block Group 3, Census Tract 5029.09, Santa Clara County, California",34,34,0
1000000US060855029094000,060855029094000,"Block 4000, Block Group 4, Census Tract 5029.09, Santa Clara County, California",225,219,6
1000000US060855029094001,060855029094001,"Block 4001, Block Group 4, Census Tract 5029.09, Santa Clara County, California",154,146,8
1000000US060855029094002,060855029094002,"Block 4002, Block Group 4, Census Tract 5029.09, Santa Clara County, California",217,210,7
1000000US060855029101000,060855029101000,"Block 1000, Block Group 1, Census Tract 5029.10, Santa Clara County, California",35,33,2
1000000US060855029101001,060855029101001,"Block 1001, Block Group 1, Census Tract 5029.10, Santa Clara County, California",49,49,0
1000000US060855029101002,060855029101002,"Block 1002, Block Group 1, Census Tract 5029.10, Santa Clara County, California",34,32,2
1000000US060855029101003,060855029101003,"Block 1003, Block Group 1, Census Tract 5029.10, Santa Clara County, California",8,7,1
1000000US060855029101004,060855029101004,"Block 1004, Block Group 1, Census Tract 5029.10, Santa Clara County, California",9,9,0
1000000US060855029101005,060855029101005,"Block 1005, Block Group 1, Census Tract 5029.10, Santa Clara County, California",39,39,0
1000000US060855029101006,060855029101006,"Block 1006, Block Group 1, Census Tract 5029.10, Santa Clara County, California",31,30,1
1000000US060855029101007,060855029101007,"Block 1007, Block Group 1, Census Tract 5029.10, Santa Clara County, California",29,27,2
1000000US060855029101008,060855029101008,"Block 1008, Block Group 1, Census Tract 5029.10, Santa Clara County, California",9,8,1
1000000US060855029101009,060855029101009,"Block 1009, Block Group 1, Census Tract 5029.10, Santa Clara County, California",8,8,0
1000000US060855029101010,060855029101010,"Block 1010, Block Group 1, Census Tract 5029.10, Santa Clara County, California",21,20,1
1000000US060855029101011,060855029101011,"Block 1011, Block Group 1, Census Tract 5029.10, Santa Clara County, California",43,40,3
1000000US060855029101012,060855029101012,"Block 1012, Block Group 1, Census Tract 5029.10, Santa Clara County, California",29,29,0
1000000US060855029101013,060855029101013,"Block 1013, Block Group 1, Census Tract 5029.10, Santa Clara County, California",0,0,0
1000000US060855029101014,060855029101014,"Block 1014, Block Group 1, Census Tract 5029.10, Santa Clara County, California",0,0,0
1000000US060855029102000,060855029102000,"Block 2000, Block Group 2, Census Tract 5029.10, Santa Clara County, California",57,57,0
1000000US060855029102001,060855029102001,"Block 2001, Block Group 2, Census Tract 5029.10, Santa Clara County, California",36,35,1
1000000US060855029102002,060855029102002,"Block 2002, Block Group 2, Census Tract 5029.10, Santa Clara County, California",36,36,0
1000000US060855029102003,060855029102003,"Block 2003, Block Group 2, Census Tract 5029.10, Santa Clara County, California",34,34,0
1000000US060855029102004,060855029102004,"Block 2004, Block Group 2, Census Tract 5029.10, Santa Clara County, California",48,46,2
1000000US060855029102005,060855029102005,"Block 2005, Block Group 2, Census Tract 5029.10, Santa Clara County, California",3,3,0
1000000US060855029102006,060855029102006,"Block 2006, Block Group 2, Census Tract 5029.10, Santa Clara County, California",58,57,1
1000000US060855029102007,060855029102007,"Block 2007, Block Group 2, Census Tract 5029.10, Santa Clara County, California",21,21,0
1000000US060855029102008,060855029102008,"Block 2008, Block Group 2, Census Tract 5029.10, Santa Clara County, California",9,9,0
1000000US060855029103000,060855029103000,"Block 3000, Block Group 3, Census Tract 5029.10, Santa Clara County, California",20,19,1
1000000US060855029103001,060855029103001,"Block 3001, Block Group 3, Census Tract 5029.10, Santa Clara County, California",69,64,5
1000000US060855029103002,060855029103002,"Block 3002, Block Group 3, Census Tract 5029.10, Santa Clara County, California",27,27,0
1000000US060855029103003,060855029103003,"Block 3003, Block Group 3, Census Tract 5029.10, Santa Clara County, California",26,26,0
1000000US060855029103004,060855029103004,"Block 3004, Block Group 3, Census Tract 5029.10, Santa Clara County, California",112,106,6
1000000US060855029104000,060855029104000,"Block 4000, Block Group 4, Census Tract 5029.10, Santa Clara County, California",226,223,3
1000000US060855029104001,060855029104001,"Block 4001, Block Group 4, Census Tract 5029.10, Santa Clara County, California",68,67,1
1000000US060855029104002,060855029104002,"Block 4002, Block Group 4, Census Tract 5029.10, Santa Clara County, California",0,0,0
1000000US060855029104003,060855029104003,"Block 4003, Block Group 4, Census Tract 5029.10, Santa Clara County, California",312,299,13
1000000US060855030011000,060855030011000,"Block 1000, Block Group 1, Census Tract 5030.01, Santa Clara County, California",57,53,4
1000000US060855030011001,060855030011001,"Block 1001, Block Group 1, Census Tract 5030.01, Santa Clara County, California",18,18,0
1000000US060855030011002,060855030011002,"Block 1002, Block Group 1, Census Tract 5030.01, Santa Clara County, California",11,11,0
1000000US060855030011003,060855030011003,"Block 1003, Block Group 1, Census Tract 5030.01, Santa Clara County, California",31,31,0
1000000US060855030011004,060855030011004,"Block 1004, Block Group 1, Census Tract 5030.01, Santa Clara County, California",30,29,1
1000000US060855030011005,060855030011005,"Block 1005, Block Group 1, Census Tract 5030.01, Santa Clara County, California",17,17,0
1000000US060855030011006,060855030011006,"Block 1006, Block Group 1, Census Tract 5030.01, Santa Clara County, California",10,10,0
1000000US060855030011007,060855030011007,"Block 1007, Block Group 1, Census Tract 5030.01, Santa Clara County, California",24,24,0
1000000US060855030011008,060855030011008,"Block 1008, Block Group 1, Census Tract 5030.01, Santa Clara County, California",24,22,2
1000000US060855030011009,060855030011009,"Block 1009, Block Group 1, Census Tract 5030.01, Santa Clara County, California",16,16,0
1000000US060855030011010,060855030011010,"Block 1010, Block Group 1, Census Tract 5030.01, Santa Clara County, California",29,28,1
1000000US060855030011011,060855030011011,"Block 1011, Block Group 1, Census Tract 5030.01, Santa Clara County, California",21,21,0
1000000US060855030011012,060855030011012,"Block 1012, Block Group 1, Census Tract 5030.01, Santa Clara County, California",14,13,1
1000000US060855030011013,060855030011013,"Block 1013, Block Group 1, Census Tract 5030.01, Santa Clara County, California",43,42,1
1000000US060855030011014,060855030011014,"Block 1014, Block Group 1, Census Tract 5030.01, Santa Clara County, California",35,35,0
1000000US060855030011015,060855030011015,"Block 1015, Block Group 1, Census Tract 5030.01, Santa Clara County, California",33,32,1
1000000US060855030011016,060855030011016,"Block 1016, Block Group 1, Census Tract 5030.01, Santa Clara County, California",35,34,1
1000000US060855030011017,060855030011017,"Block 1017, Block Group 1, Census Tract 5030.01, Santa Clara County, California",26,26,0
1000000US060855030011018,060855030011018,"Block 1018, Block Group 1, Census Tract 5030.01, Santa Clara County, California",29,28,1
1000000US060855030011019,060855030011019,"Block 1019, Block Group 1, Census Tract 5030.01, Santa Clara County, California",19,18,1
1000000US060855030011020,060855030011020,"Block 1020, Block Group 1, Census Tract 5030.01, Santa Clara County, California",0,0,0
1000000US060855030011021,060855030011021,"Block 1021, Block Group 1, Census Tract 5030.01, Santa Clara County, California",0,0,0
1000000US060855030011022,060855030011022,"Block 1022, Block Group 1, Census Tract 5030.01, Santa Clara County, California",0,0,0
1000000US060855030012000,060855030012000,"Block 2000, Block Group 2, Census Tract 5030.01, Santa Clara County, California",29,27,2
1000000US060855030012001,060855030012001,"Block 2001, Block Group 2, Census Tract 5030.01, Santa Clara County, California",29,27,2
1000000US060855030012002,060855030012002,"Block 2002, Block Group 2, Census Tract 5030.01, Santa Clara County, California",31,29,2
1000000US060855030012003,060855030012003,"Block 2003, Block Group 2, Census Tract 5030.01, Santa Clara County, California",13,13,0
1000000US060855030012004,060855030012004,"Block 2004, Block Group 2, Census Tract 5030.01, Santa Clara County, California",31,30,1
1000000US060855030012005,060855030012005,"Block 2005, Block Group 2, Census Tract 5030.01, Santa Clara County, California",20,19,1
1000000US060855030012006,060855030012006,"Block 2006, Block Group 2, Census Tract 5030.01, Santa Clara County, California",28,28,0
1000000US060855030012007,060855030012007,"Block 2007, Block Group 2, Census Tract 5030.01, Santa Clara County, California",28,28,0
1000000US060855030012008,060855030012008,"Block 2008, Block Group 2, Census Tract 5030.01, Santa Clara County, California",30,29,1
1000000US060855030012009,060855030012009,"Block 2009, Block Group 2, Census Tract 5030.01, Santa Clara County, California",24,24,0
1000000US060855030012010,060855030012010,"Block 2010, Block Group 2, Census Tract 5030.01, Santa Clara County, California",31,30,1
1000000US060855030012011,060855030012011,"Block 2011, Block Group 2, Census Tract 5030.01, Santa Clara County, California",29,29,0
1000000US060855030012012,060855030012012,"Block 2012, Block Group 2, Census Tract 5030.01, Santa Clara County, California",14,13,1
1000000US060855030012013,060855030012013,"Block 2013, Block Group 2, Census Tract 5030.01, Santa Clara County, California",20,19,1
1000000US060855030012014,060855030012014,"Block 2014, Block Group 2, Census Tract 5030.01, Santa Clara County, California",19,18,1
1000000US060855030013000,060855030013000,"Block 3000, Block Group 3, Census Tract 5030.01, Santa Clara County, California",57,53,4
1000000US060855030013001,060855030013001,"Block 3001, Block Group 3, Census Tract 5030.01, Santa Clara County, California",55,50,5
1000000US060855030013002,060855030013002,"Block 3002, Block Group 3, Census Tract 5030.01, Santa Clara County, California",20,20,0
1000000US060855030013003,060855030013003,"Block 3003, Block Group 3, Census Tract 5030.01, Santa Clara County, California",26,25,1
1000000US060855030013004,060855030013004,"Block 3004, Block Group 3, Census Tract 5030.01, Santa Clara County, California",33,32,1
1000000US060855030013005,060855030013005,"Block 3005, Block Group 3, Census Tract 5030.01, Santa Clara County, California",15,13,2
1000000US060855030013006,060855030013006,"Block 3006, Block Group 3, Census Tract 5030.01, Santa Clara County, California",43,43,0
1000000US060855030013007,060855030013007,"Block 3007, Block Group 3, Census Tract 5030.01, Santa Clara County, California",35,33,2
1000000US060855030013008,060855030013008,"Block 3008, Block Group 3, Census Tract 5030.01, Santa Clara County, California",32,32,0
1000000US060855030013009,060855030013009,"Block 3009, Block Group 3, Census Tract 5030.01, Santa Clara County, California",31,29,2
1000000US060855030013010,060855030013010,"Block 3010, Block Group 3, Census Tract 5030.01, Santa Clara County, California",32,32,0
1000000US060855030013011,060855030013011,"Block 3011, Block Group 3, Census Tract 5030.01, Santa Clara County, California",61,58,3
1000000US060855030013012,060855030013012,"Block 3012, Block Group 3, Census Tract 5030.01, Santa Clara County, California",20,20,0
1000000US060855030013013,060855030013013,"Block 3013, Block Group 3, Census Tract 5030.01, Santa Clara County, California",36,36,0
1000000US060855030013014,060855030013014,"Block 3014, Block Group 3, Census Tract 5030.01, Santa Clara County, California",31,30,1
1000000US060855030013015,060855030013015,"Block 3015, Block Group 3, Census Tract 5030.01, Santa Clara County, California",33,31,2
1000000US060855030013016,060855030013016,"Block 3016, Block Group 3, Census Tract 5030.01, Santa Clara County, California",32,32,0
1000000US060855030013017,060855030013017,"Block 3017, Block Group 3, Census Tract 5030.01, Santa Clara County, California",30,29,1
1000000US060855030013018,060855030013018,"Block 3018, Block Group 3, Census Tract 5030.01, Santa Clara County, California",20,20,0
1000000US060855030013019,060855030013019,"Block 3019, Block Group 3, Census Tract 5030.01, Santa Clara County, California",22,22,0
1000000US060855030013020,060855030013020,"Block 3020, Block Group 3, Census Tract 5030.01, Santa Clara County, California",22,22,0
1000000US060855030013021,060855030013021,"Block 3021, Block Group 3, Census Tract 5030.01, Santa Clara County, California",29,29,0
1000000US060855030013022,060855030013022,"Block 3022, Block Group 3, Census Tract 5030.01, Santa Clara County, California",22,22,0
1000000US060855030021000,060855030021000,"Block 1000, Block Group 1, Census Tract 5030.02, Santa Clara County, California",0,0,0
1000000US060855030021001,060855030021001,"Block 1001, Block Group 1, Census Tract 5030.02, Santa Clara County, California",0,0,0
1000000US060855030021002,060855030021002,"Block 1002, Block Group 1, Census Tract 5030.02, Santa Clara County, California",0,0,0
1000000US060855030021003,060855030021003,"Block 1003, Block Group 1, Census Tract 5030.02, Santa Clara County, California",0,0,0
1000000US060855030021004,060855030021004,"Block 1004, Block Group 1, Census Tract 5030.02, Santa Clara County, California",0,0,0
1000000US060855030021005,060855030021005,"Block 1005, Block Group 1, Census Tract 5030.02, Santa Clara County, California",0,0,0
1000000US060855030021006,060855030021006,"Block 1006, Block Group 1, Census Tract 5030.02, Santa Clara County, California",23,23,0
1000000US060855030021007,060855030021007,"Block 1007, Block Group 1, Census Tract 5030.02, Santa Clara County, California",36,36,0
1000000US060855030021008,060855030021008,"Block 1008, Block Group 1, Census Tract 5030.02, Santa Clara County, California",19,19,0
1000000US060855030021009,060855030021009,"Block 1009, Block Group 1, Census Tract 5030.02, Santa Clara County, California",15,14,1
1000000US060855030021010,060855030021010,"Block 1010, Block Group 1, Census Tract 5030.02, Santa Clara County, California",10,9,1
1000000US060855030021011,060855030021011,"Block 1011, Block Group 1, Census Tract 5030.02, Santa Clara County, California",19,19,0
1000000US060855030021012,060855030021012,"Block 1012, Block Group 1, Census Tract 5030.02, Santa Clara County, California",0,0,0
1000000US060855030021013,060855030021013,"Block 1013, Block Group 1, Census Tract 5030.02, Santa Clara County, California",22,22,0
1000000US060855030021014,060855030021014,"Block 1014, Block Group 1, Census Tract 5030.02, Santa Clara County, California",17,17,0
1000000US060855030021015,060855030021015,"Block 1015, Block Group 1, Census Tract 5030.02, Santa Clara County, California",22,21,1
1000000US060855030021016,060855030021016,"Block 1016, Block Group 1, Census Tract 5030.02, Santa Clara County, California",22,21,1
1000000US060855030021017,060855030021017,"Block 1017, Block Group 1, Census Tract 5030.02, Santa Clara County, California",17,16,1
1000000US060855030021018,060855030021018,"Block 1018, Block Group 1, Census Tract 5030.02, Santa Clara County, California",47,44,3
1000000US060855030021019,060855030021019,"Block 1019, Block Group 1, Census Tract 5030.02, Santa Clara County, California",0,0,0
1000000US060855030021020,060855030021020,"Block 1020, Block Group 1, Census Tract 5030.02, Santa Clara County, California",140,137,3
1000000US060855030021021,060855030021021,"Block 1021, Block Group 1, Census Tract 5030.02, Santa Clara County, California",22,22,0
1000000US060855030021022,060855030021022,"Block 1022, Block Group 1, Census Tract 5030.02, Santa Clara County, California",37,36,1
1000000US060855030021023,060855030021023,"Block 1023, Block Group 1, Census Tract 5030.02, Santa Clara County, California",22,20,2
1000000US060855030021024,060855030021024,"Block 1024, Block Group 1, Census Tract 5030.02, Santa Clara County, California",21,21,0
1000000US060855030021025,060855030021025,"Block 1025, Block Group 1, Census Tract 5030.02, Santa Clara County, California",38,38,0
1000000US060855030021026,060855030021026,"Block 1026, Block Group 1, Census Tract 5030.02, Santa Clara County, California",0,0,0
1000000US060855030021027,060855030021027,"Block 1027, Block Group 1, Census Tract 5030.02, Santa Clara County, California",0,0,0
1000000US060855030021028,060855030021028,"Block 1028, Block Group 1, Census Tract 5030.02, Santa Clara County, California",0,0,0
1000000US060855030022000,060855030022000,"Block 2000, Block Group 2, Census Tract 5030.02, Santa Clara County, California",14,14,0
1000000US060855030022001,060855030022001,"Block 2001, Block Group 2, Census Tract 5030.02, Santa Clara County, California",14,13,1
1000000US060855030022002,060855030022002,"Block 2002, Block Group 2, Census Tract 5030.02, Santa Clara County, California",14,14,0
1000000US060855030022003,060855030022003,"Block 2003, Block Group 2, Census Tract 5030.02, Santa Clara County, California",21,21,0
1000000US060855030022004,060855030022004,"Block 2004, Block Group 2, Census Tract 5030.02, Santa Clara County, California",18,18,0
1000000US060855030022005,060855030022005,"Block 2005, Block Group 2, Census Tract 5030.02, Santa Clara County, California",17,16,1
1000000US060855030022006,060855030022006,"Block 2006, Block Group 2, Census Tract 5030.02, Santa Clara County, California",24,23,1
1000000US060855030022007,060855030022007,"Block 2007, Block Group 2, Census Tract 5030.02, Santa Clara County, California",24,24,0
1000000US060855030022008,060855030022008,"Block 2008, Block Group 2, Census Tract 5030.02, Santa Clara County, California",23,23,0
1000000US060855030022009,060855030022009,"Block 2009, Block Group 2, Census Tract 5030.02, Santa Clara County, California",162,147,15
1000000US060855030022010,060855030022010,"Block 2010, Block Group 2, Census Tract 5030.02, Santa Clara County, California",22,20,2
1000000US060855030022011,060855030022011,"Block 2011, Block Group 2, Census Tract 5030.02, Santa Clara County, California",42,39,3
1000000US060855030022012,060855030022012,"Block 2012, Block Group 2, Census Tract 5030.02, Santa Clara County, California",88,88,0
1000000US060855030022013,060855030022013,"Block 2013, Block Group 2, Census Tract 5030.02, Santa Clara County, California",32,31,1
1000000US060855030022014,060855030022014,"Block 2014, Block Group 2, Census Tract 5030.02, Santa Clara County, California",26,26,0
1000000US060855030022015,060855030022015,"Block 2015, Block Group 2, Census Tract 5030.02, Santa Clara County, California",30,29,1
1000000US060855030022016,060855030022016,"Block 2016, Block Group 2, Census Tract 5030.02, Santa Clara County, California",12,12,0
1000000US060855030022017,060855030022017,"Block 2017, Block Group 2, Census Tract 5030.02, Santa Clara County, California",14,14,0
1000000US060855030022018,060855030022018,"Block 2018, Block Group 2, Census Tract 5030.02, Santa Clara County, California",16,15,1
1000000US060855030022019,060855030022019,"Block 2019, Block Group 2, Census Tract 5030.02, Santa Clara County, California",16,16,0
1000000US060855030022020,060855030022020,"Block 2020, Block Group 2, Census Tract 5030.02, Santa Clara County, California",25,25,0
1000000US060855030022021,060855030022021,"Block 2021, Block Group 2, Census Tract 5030.02, Santa Clara County, California",30,30,0
1000000US060855030022022,060855030022022,"Block 2022, Block Group 2, Census Tract 5030.02, Santa Clara County, California",0,0,0
1000000US060855030022023,060855030022023,"Block 2023, Block Group 2, Census Tract 5030.02, Santa Clara County, California",57,55,2
1000000US060855030022024,060855030022024,"Block 2024, Block Group 2, Census Tract 5030.02, Santa Clara County, California",14,14,0
1000000US060855030022025,060855030022025,"Block 2025, Block Group 2, Census Tract 5030.02, Santa Clara County, California",14,14,0
1000000US060855030031000,060855030031000,"Block 1000, Block Group 1, Census Tract 5030.03, Santa Clara County, California",2,2,0
1000000US060855030031001,060855030031001,"Block 1001, Block Group 1, Census Tract 5030.03, Santa Clara County, California",0,0,0
1000000US060855030031002,060855030031002,"Block 1002, Block Group 1, Census Tract 5030.03, Santa Clara County, California",0,0,0
1000000US060855030031003,060855030031003,"Block 1003, Block Group 1, Census Tract 5030.03, Santa Clara County, California",0,0,0
1000000US060855030031004,060855030031004,"Block 1004, Block Group 1, Census Tract 5030.03, Santa Clara County, California",33,33,0
1000000US060855030031005,060855030031005,"Block 1005, Block Group 1, Census Tract 5030.03, Santa Clara County, California",36,36,0
1000000US060855030031006,060855030031006,"Block 1006, Block Group 1, Census Tract 5030.03, Santa Clara County, California",36,36,0
1000000US060855030031007,060855030031007,"Block 1007, Block Group 1, Census Tract 5030.03, Santa Clara County, California",42,40,2
1000000US060855030031008,060855030031008,"Block 1008, Block Group 1, Census Tract 5030.03, Santa Clara County, California",18,17,1
1000000US060855030031009,060855030031009,"Block 1009, Block Group 1, Census Tract 5030.03, Santa Clara County, California",18,17,1
1000000US060855030031010,060855030031010,"Block 1010, Block Group 1, Census Tract 5030.03, Santa Clara County, California",42,42,0
1000000US060855030031011,060855030031011,"Block 1011, Block Group 1, Census Tract 5030.03, Santa Clara County, California",41,41,0
1000000US060855030031012,060855030031012,"Block 1012, Block Group 1, Census Tract 5030.03, Santa Clara County, California",18,18,0
1000000US060855030031013,060855030031013,"Block 1013, Block Group 1, Census Tract 5030.03, Santa Clara County, California",0,0,0
1000000US060855030031014,060855030031014,"Block 1014, Block Group 1, Census Tract 5030.03, Santa Clara County, California",21,21,0
1000000US060855030031015,060855030031015,"Block 1015, Block Group 1, Census Tract 5030.03, Santa Clara County, California",22,22,0
1000000US060855030031016,060855030031016,"Block 1016, Block Group 1, Census Tract 5030.03, Santa Clara County, California",35,35,0
1000000US060855030032000,060855030032000,"Block 2000, Block Group 2, Census Tract 5030.03, Santa Clara County, California",0,0,0
1000000US060855030032001,060855030032001,"Block 2001, Block Group 2, Census Tract 5030.03, Santa Clara County, California",24,23,1
1000000US060855030032002,060855030032002,"Block 2002, Block Group 2, Census Tract 5030.03, Santa Clara County, California",16,15,1
1000000US060855030032003,060855030032003,"Block 2003, Block Group 2, Census Tract 5030.03, Santa Clara County, California",23,23,0
1000000US060855030032004,060855030032004,"Block 2004, Block Group 2, Census Tract 5030.03, Santa Clara County, California",23,23,0
1000000US060855030032005,060855030032005,"Block 2005, Block Group 2, Census Tract 5030.03, Santa Clara County, California",0,0,0
1000000US060855030032006,060855030032006,"Block 2006, Block Group 2, Census Tract 5030.03, Santa Clara County, California",19,19,0
1000000US060855030032007,060855030032007,"Block 2007, Block Group 2, Census Tract 5030.03, Santa Clara County, California",18,18,0
1000000US060855030032008,060855030032008,"Block 2008, Block Group 2, Census Tract 5030.03, Santa Clara County, California",30,30,0
1000000US060855030032009,060855030032009,"Block 2009, Block Group 2, Census Tract 5030.03, Santa Clara County, California",18,18,0
1000000US060855030032010,060855030032010,"Block 2010, Block Group 2, Census Tract 5030.03, Santa Clara County, California",32,32,0
1000000US060855030032011,060855030032011,"Block 2011, Block Group 2, Census Tract 5030.03, Santa Clara County, California",30,30,0
1000000US060855030032012,060855030032012,"Block 2012, Block Group 2, Census Tract 5030.03, Santa Clara County, California",39,39,0
1000000US060855030032013,060855030032013,"Block 2013, Block Group 2, Census Tract 5030.03, Santa Clara County, California",53,52,1
1000000US060855030032014,060855030032014,"Block 2014, Block Group 2, Census Tract 5030.03, Santa Clara County, California",14,14,0
1000000US060855030032015,060855030032015,"Block 2015, Block Group 2, Census Tract 5030.03, Santa Clara County, California",13,13,0
1000000US060855030032016,060855030032016,"Block 2016, Block Group 2, Census Tract 5030.03, Santa Clara County, California",44,41,3
1000000US060855030032017,060855030032017,"Block 2017, Block Group 2, Census Tract 5030.03, Santa Clara County, California",18,15,3
1000000US060855030032018,060855030032018,"Block 2018, Block Group 2, Census Tract 5030.03, Santa Clara County, California",36,33,3
1000000US060855030032019,060855030032019,"Block 2019, Block Group 2, Census Tract 5030.03, Santa Clara County, California",7,6,1
1000000US060855030032020,060855030032020,"Block 2020, Block Group 2, Census Tract 5030.03, Santa Clara County, California",74,73,1
1000000US060855030032021,060855030032021,"Block 2021, Block Group 2, Census Tract 5030.03, Santa Clara County, California",27,27,0
1000000US060855030032022,060855030032022,"Block 2022, Block Group 2, Census Tract 5030.03, Santa Clara County, California",37,36,1
1000000US060855030032023,060855030032023,"Block 2023, Block Group 2, Census Tract 5030.03, Santa Clara County, California",25,25,0
1000000US060855030032024,060855030032024,"Block 2024, Block Group 2, Census Tract 5030.03, Santa Clara County, California",1,1,0
1000000US060855030032025,060855030032025,"Block 2025, Block Group 2, Census Tract 5030.03, Santa Clara County, California",81,80,1
1000000US060855030033000,060855030033000,"Block 3000, Block Group 3, Census Tract 5030.03, Santa Clara County, California",37,36,1
1000000US060855030033001,060855030033001,"Block 3001, Block Group 3, Census Tract 5030.03, Santa Clara County, California",18,17,1
1000000US060855030033002,060855030033002,"Block 3002, Block Group 3, Census Tract 5030.03, Santa Clara County, California",17,16,1
1000000US060855030033003,060855030033003,"Block 3003, Block Group 3, Census Tract 5030.03, Santa Clara County, California",50,50,0
1000000US060855030033004,060855030033004,"Block 3004, Block Group 3, Census Tract 5030.03, Santa Clara County, California",18,17,1
1000000US060855030033005,060855030033005,"Block 3005, Block Group 3, Census Tract 5030.03, Santa Clara County, California",4,4,0
1000000US060855030033006,060855030033006,"Block 3006, Block Group 3, Census Tract 5030.03, Santa Clara County, California",16,16,0
1000000US060855030033007,060855030033007,"Block 3007, Block Group 3, Census Tract 5030.03, Santa Clara County, California",45,44,1
1000000US060855030033008,060855030033008,"Block 3008, Block Group 3, Census Tract 5030.03, Santa Clara County, California",47,47,0
1000000US060855030033009,060855030033009,"Block 3009, Block Group 3, Census Tract 5030.03, Santa Clara County, California",45,45,0
1000000US060855030033010,060855030033010,"Block 3010, Block Group 3, Census Tract 5030.03, Santa Clara County, California",0,0,0
1000000US060855030033011,060855030033011,"Block 3011, Block Group 3, Census Tract 5030.03, Santa Clara County, California",25,24,1
1000000US060855030033012,060855030033012,"Block 3012, Block Group 3, Census Tract 5030.03, Santa Clara County, California",53,53,0
1000000US060855030033013,060855030033013,"Block 3013, Block Group 3, Census Tract 5030.03, Santa Clara County, California",34,34,0
1000000US060855030033014,060855030033014,"Block 3014, Block Group 3, Census Tract 5030.03, Santa Clara County, California",23,23,0
1000000US060855030033015,060855030033015,"Block 3015, Block Group 3, Census Tract 5030.03, Santa Clara County, California",28,28,0
1000000US060855030033016,060855030033016,"Block 3016, Block Group 3, Census Tract 5030.03, Santa Clara County, California",20,19,1
1000000US060855030033017,060855030033017,"Block 3017, Block Group 3, Census Tract 5030.03, Santa Clara County, California",25,25,0
1000000US060855030034000,060855030034000,"Block 4000, Block Group 4, Census Tract 5030.03, Santa Clara County, California",19,19,0
1000000US060855030034001,060855030034001,"Block 4001, Block Group 4, Census Tract 5030.03, Santa Clara County, California",0,0,0
1000000US060855030034002,060855030034002,"Block 4002, Block Group 4, Census Tract 5030.03, Santa Clara County, California",43,42,1
1000000US060855030034003,060855030034003,"Block 4003, Block Group 4, Census Tract 5030.03, Santa Clara County, California",31,30,1
1000000US060855030034004,060855030034004,"Block 4004, Block Group 4, Census Tract 5030.03, Santa Clara County, California",36,34,2
1000000US060855030034005,060855030034005,"Block 4005, Block Group 4, Census Tract 5030.03, Santa Clara County, California",27,26,1
1000000US060855030034006,060855030034006,"Block 4006, Block Group 4, Census Tract 5030.03, Santa Clara County, California",21,21,0
1000000US060855030034007,060855030034007,"Block 4007, Block Group 4, Census Tract 5030.03, Santa Clara County, California",14,14,0
1000000US060855030034008,060855030034008,"Block 4008, Block Group 4, Census Tract 5030.03, Santa Clara County, California",36,36,0
1000000US060855031051000,060855031051000,"Block 1000, Block Group 1, Census Tract 5031.05, Santa Clara County, California",2,2,0
1000000US060855031051001,060855031051001,"Block 1001, Block Group 1, Census Tract 5031.05, Santa Clara County, California",54,53,1
1000000US060855031051002,060855031051002,"Block 1002, Block Group 1, Census Tract 5031.05, Santa Clara County, California",0,0,0
1000000US060855031051003,060855031051003,"Block 1003, Block Group 1, Census Tract 5031.05, Santa Clara County, California",0,0,0
1000000US060855031051004,060855031051004,"Block 1004, Block Group 1, Census Tract 5031.05, Santa Clara County, California",42,42,0
1000000US060855031051005,060855031051005,"Block 1005, Block Group 1, Census Tract 5031.05, Santa Clara County, California",207,203,4
1000000US060855031051006,060855031051006,"Block 1006, Block Group 1, Census Tract 5031.05, Santa Clara County, California",38,35,3
1000000US060855031051007,060855031051007,"Block 1007, Block Group 1, Census Tract 5031.05, Santa Clara County, California",22,22,0
1000000US060855031051008,060855031051008,"Block 1008, Block Group 1, Census Tract 5031.05, Santa Clara County, California",209,206,3
1000000US060855031051009,060855031051009,"Block 1009, Block Group 1, Census Tract 5031.05, Santa Clara County, California",0,0,0
1000000US060855031051010,060855031051010,"Block 1010, Block Group 1, Census Tract 5031.05, Santa Clara County, California",70,69,1
1000000US060855031051011,060855031051011,"Block 1011, Block Group 1, Census Tract 5031.05, Santa Clara County, California",73,72,1
1000000US060855031051012,060855031051012,"Block 1012, Block Group 1, Census Tract 5031.05, Santa Clara County, California",54,52,2
1000000US060855031081000,060855031081000,"Block 1000, Block Group 1, Census Tract 5031.08, Santa Clara County, California",0,0,0
1000000US060855031081001,060855031081001,"Block 1001, Block Group 1, Census Tract 5031.08, Santa Clara County, California",637,582,55
1000000US060855031081002,060855031081002,"Block 1002, Block Group 1, Census Tract 5031.08, Santa Clara County, California",38,38,0
1000000US060855031081003,060855031081003,"Block 1003, Block Group 1, Census Tract 5031.08, Santa Clara County, California",0,0,0
1000000US060855031081004,060855031081004,"Block 1004, Block Group 1, Census Tract 5031.08, Santa Clara County, California",29,29,0
1000000US060855031081005,060855031081005,"Block 1005, Block Group 1, Census Tract 5031.08, Santa Clara County, California",0,0,0
1000000US060855031081006,060855031081006,"Block 1006, Block Group 1, Census Tract 5031.08, Santa Clara County, California",0,0,0
1000000US060855031081007,060855031081007,"Block 1007, Block Group 1, Census Tract 5031.08, Santa Clara County, California",52,49,3
1000000US060855031081008,060855031081008,"Block 1008, Block Group 1, Census Tract 5031.08, Santa Clara County, California",0,0,0
1000000US060855031081009,060855031081009,"Block 1009, Block Group 1, Census Tract 5031.08, Santa Clara County, California",0,0,0
1000000US060855031081010,060855031081010,"Block 1010, Block Group 1, Census Tract 5031.08, Santa Clara County, California",0,0,0
1000000US060855031081011,060855031081011,"Block 1011, Block Group 1, Census Tract 5031.08, Santa Clara County, California",0,0,0
1000000US060855031081012,060855031081012,"Block 1012, Block Group 1, Census Tract 5031.08, Santa Clara County, California",23,23,0
1000000US060855031081013,060855031081013,"Block 1013, Block Group 1, Census Tract 5031.08, Santa Clara County, California",0,0,0
1000000US060855031082000,060855031082000,"Block 2000, Block Group 2, Census Tract 5031.08, Santa Clara County, California",247,237,10
1000000US060855031082001,060855031082001,"Block 2001, Block Group 2, Census Tract 5031.08, Santa Clara County, California",17,17,0
1000000US060855031082002,060855031082002,"Block 2002, Block Group 2, Census Tract 5031.08, Santa Clara County, California",40,39,1
1000000US060855031082003,060855031082003,"Block 2003, Block Group 2, Census Tract 5031.08, Santa Clara County, California",20,20,0
1000000US060855031082004,060855031082004,"Block 2004, Block Group 2, Census Tract 5031.08, Santa Clara County, California",0,0,0
1000000US060855031082005,060855031082005,"Block 2005, Block Group 2, Census Tract 5031.08, Santa Clara County, California",0,0,0
1000000US060855031082006,060855031082006,"Block 2006, Block Group 2, Census Tract 5031.08, Santa Clara County, California",68,68,0
1000000US060855031082007,060855031082007,"Block 2007, Block Group 2, Census Tract 5031.08, Santa Clara County, California",43,42,1
1000000US060855031082008,060855031082008,"Block 2008, Block Group 2, Census Tract 5031.08, Santa Clara County, California",50,47,3
1000000US060855031082009,060855031082009,"Block 2009, Block Group 2, Census Tract 5031.08, Santa Clara County, California",26,25,1
1000000US060855031082010,060855031082010,"Block 2010, Block Group 2, Census Tract 5031.08, Santa Clara County, California",24,24,0
1000000US060855031082011,060855031082011,"Block 2011, Block Group 2, Census Tract 5031.08, Santa Clara County, California",113,109,4
1000000US060855031082012,060855031082012,"Block 2012, Block Group 2, Census Tract 5031.08, Santa Clara County, California",12,12,0
1000000US060855031082013,060855031082013,"Block 2013, Block Group 2, Census Tract 5031.08, Santa Clara County, California",12,12,0
1000000US060855031082014,060855031082014,"Block 2014, Block Group 2, Census Tract 5031.08, Santa Clara County, California",43,43,0
1000000US060855031082015,060855031082015,"Block 2015, Block Group 2, Census Tract 5031.08, Santa Clara County, California",27,27,0
1000000US060855031082016,060855031082016,"Block 2016, Block Group 2, Census Tract 5031.08, Santa Clara County, California",12,12,0
1000000US060855031082017,060855031082017,"Block 2017, Block Group 2, Census Tract 5031.08, Santa Clara County, California",35,35,0
1000000US060855031082018,060855031082018,"Block 2018, Block Group 2, Census Tract 5031.08, Santa Clara County, California",25,25,0
1000000US060855031082019,060855031082019,"Block 2019, Block Group 2, Census Tract 5031.08, Santa Clara County, California",134,134,0
1000000US060855031082020,060855031082020,"Block 2020, Block Group 2, Census Tract 5031.08, Santa Clara County, California",132,128,4
1000000US060855031082021,060855031082021,"Block 2021, Block Group 2, Census Tract 5031.08, Santa Clara County, California",123,116,7
1000000US060855031082022,060855031082022,"Block 2022, Block Group 2, Census Tract 5031.08, Santa Clara County, California",44,41,3
1000000US060855031082023,060855031082023,"Block 2023, Block Group 2, Census Tract 5031.08, Santa Clara County, California",40,39,1
1000000US060855031082024,060855031082024,"Block 2024, Block Group 2, Census Tract 5031.08, Santa Clara County, California",27,26,1
1000000US060855031082025,060855031082025,"Block 2025, Block Group 2, Census Tract 5031.08, Santa Clara County, California",49,49,0
1000000US060855031083000,060855031083000,"Block 3000, Block Group 3, Census Tract 5031.08, Santa Clara County, California",52,52,0
1000000US060855031083001,060855031083001,"Block 3001, Block Group 3, Census Tract 5031.08, Santa Clara County, California",35,35,0
1000000US060855031083002,060855031083002,"Block 3002, Block Group 3, Census Tract 5031.08, Santa Clara County, California",60,58,2
1000000US060855031083003,060855031083003,"Block 3003, Block Group 3, Census Tract 5031.08, Santa Clara County, California",154,149,5
1000000US060855031084000,060855031084000,"Block 4000, Block Group 4, Census Tract 5031.08, Santa Clara County, California",137,137,0
1000000US060855031084001,060855031084001,"Block 4001, Block Group 4, Census Tract 5031.08, Santa Clara County, California",6,6,0
1000000US060855031084002,060855031084002,"Block 4002, Block Group 4, Census Tract 5031.08, Santa Clara County, California",173,172,1
1000000US060855031084003,060855031084003,"Block 4003, Block Group 4, Census Tract 5031.08, Santa Clara County, California",2,2,0
1000000US060855031084004,060855031084004,"Block 4004, Block Group 4, Census Tract 5031.08, Santa Clara County, California",21,19,2
1000000US060855031084005,060855031084005,"Block 4005, Block Group 4, Census Tract 5031.08, Santa Clara County, California",51,50,1
1000000US060855031084006,060855031084006,"Block 4006, Block Group 4, Census Tract 5031.08, Santa Clara County, California",11,11,0
1000000US060855031101000,060855031101000,"Block 1000, Block Group 1, Census Tract 5031.10, Santa Clara County, California",4,3,1
1000000US060855031101001,060855031101001,"Block 1001, Block Group 1, Census Tract 5031.10, Santa Clara County, California",438,424,14
1000000US060855031101002,060855031101002,"Block 1002, Block Group 1, Census Tract 5031.10, Santa Clara County, California",25,25,0
1000000US060855031101003,060855031101003,"Block 1003, Block Group 1, Census Tract 5031.10, Santa Clara County, California",33,32,1
1000000US060855031101004,060855031101004,"Block 1004, Block Group 1, Census Tract 5031.10, Santa Clara County, California",6,6,0
1000000US060855031102000,060855031102000,"Block 2000, Block Group 2, Census Tract 5031.10, Santa Clara County, California",186,179,7
1000000US060855031102001,060855031102001,"Block 2001, Block Group 2, Census Tract 5031.10, Santa Clara County, California",32,32,0
1000000US060855031102002,060855031102002,"Block 2002, Block Group 2, Census Tract 5031.10, Santa Clara County, California",25,24,1
1000000US060855031102003,060855031102003,"Block 2003, Block Group 2, Census Tract 5031.10, Santa Clara County, California",28,27,1
1000000US060855031102004,060855031102004,"Block 2004, Block Group 2, Census Tract 5031.10, Santa Clara County, California",27,26,1
1000000US060855031103000,060855031103000,"Block 3000, Block Group 3, Census Tract 5031.10, Santa Clara County, California",104,99,5
1000000US060855031103001,060855031103001,"Block 3001, Block Group 3, Census Tract 5031.10, Santa Clara County, California",100,99,1
1000000US060855031103002,060855031103002,"Block 3002, Block Group 3, Census Tract 5031.10, Santa Clara County, California",96,86,10
1000000US060855031111000,060855031111000,"Block 1000, Block Group 1, Census Tract 5031.11, Santa Clara County, California",20,20,0
1000000US060855031111001,060855031111001,"Block 1001, Block Group 1, Census Tract 5031.11, Santa Clara County, California",120,109,11
1000000US060855031111002,060855031111002,"Block 1002, Block Group 1, Census Tract 5031.11, Santa Clara County, California",13,13,0
1000000US060855031111003,060855031111003,"Block 1003, Block Group 1, Census Tract 5031.11, Santa Clara County, California",86,84,2
1000000US060855031112000,060855031112000,"Block 2000, Block Group 2, Census Tract 5031.11, Santa Clara County, California",111,108,3
1000000US060855031112001,060855031112001,"Block 2001, Block Group 2, Census Tract 5031.11, Santa Clara County, California",124,120,4
1000000US060855031112002,060855031112002,"Block 2002, Block Group 2, Census Tract 5031.11, Santa Clara County, California",39,38,1
1000000US060855031112003,060855031112003,"Block 2003, Block Group 2, Census Tract 5031.11, Santa Clara County, California",34,33,1
1000000US060855031112004,060855031112004,"Block 2004, Block Group 2, Census Tract 5031.11, Santa Clara County, California",24,23,1
1000000US060855031112005,060855031112005,"Block 2005, Block Group 2, Census Tract 5031.11, Santa Clara County, California",31,30,1
1000000US060855031112006,060855031112006,"Block 2006, Block Group 2, Census Tract 5031.11, Santa Clara County, California",38,34,4
1000000US060855031113000,060855031113000,"Block 3000, Block Group 3, Census Tract 5031.11, Santa Clara County, California",61,59,2
1000000US060855031113001,060855031113001,"Block 3001, Block Group 3, Census Tract 5031.11, Santa Clara County, California",40,40,0
1000000US060855031113002,060855031113002,"Block 3002, Block Group 3, Census Tract 5031.11, Santa Clara County, California",46,45,1
1000000US060855031113003,060855031113003,"Block 3003, Block Group 3, Census Tract 5031.11, Santa Clara County, California",40,38,2
1000000US060855031113004,060855031113004,"Block 3004, Block Group 3, Census Tract 5031.11, Santa Clara County, California",47,47,0
1000000US060855031113005,060855031113005,"Block 3005, Block Group 3, Census Tract 5031.11, Santa Clara County, California",96,96,0
1000000US060855031113006,060855031113006,"Block 3006, Block Group 3, Census Tract 5031.11, Santa Clara County, California",49,49,0
1000000US060855031113007,060855031113007,"Block 3007, Block Group 3, Census Tract 5031.11, Santa Clara County, California",42,42,0
1000000US060855031113008,060855031113008,"Block 3008, Block Group 3, Census Tract 5031.11, Santa Clara County, California",35,35,0
1000000US060855031121000,060855031121000,"Block 1000, Block Group 1, Census Tract 5031.12, Santa Clara County, California",114,110,4
1000000US060855031121001,060855031121001,"Block 1001, Block Group 1, Census Tract 5031.12, Santa Clara County, California",143,136,7
1000000US060855031121002,060855031121002,"Block 1002, Block Group 1, Census Tract 5031.12, Santa Clara County, California",37,35,2
1000000US060855031121003,060855031121003,"Block 1003, Block Group 1, Census Tract 5031.12, Santa Clara County, California",28,28,0
1000000US060855031121004,060855031121004,"Block 1004, Block Group 1, Census Tract 5031.12, Santa Clara County, California",51,49,2
1000000US060855031121005,060855031121005,"Block 1005, Block Group 1, Census Tract 5031.12, Santa Clara County, California",64,61,3
1000000US060855031121006,060855031121006,"Block 1006, Block Group 1, Census Tract 5031.12, Santa Clara County, California",29,25,4
1000000US060855031121007,060855031121007,"Block 1007, Block Group 1, Census Tract 5031.12, Santa Clara County, California",361,353,8
1000000US060855031121008,060855031121008,"Block 1008, Block Group 1, Census Tract 5031.12, Santa Clara County, California",189,173,16
1000000US060855031121009,060855031121009,"Block 1009, Block Group 1, Census Tract 5031.12, Santa Clara County, California",42,41,1
1000000US060855031121010,060855031121010,"Block 1010, Block Group 1, Census Tract 5031.12, Santa Clara County, California",3,3,0
1000000US060855031121011,060855031121011,"Block 1011, Block Group 1, Census Tract 5031.12, Santa Clara County, California",28,26,2
1000000US060855031121012,060855031121012,"Block 1012, Block Group 1, Census Tract 5031.12, Santa Clara County, California",24,23,1
1000000US060855031121013,060855031121013,"Block 1013, Block Group 1, Census Tract 5031.12, Santa Clara County, California",26,24,2
1000000US060855031121014,060855031121014,"Block 1014, Block Group 1, Census Tract 5031.12, Santa Clara County, California",17,13,4
1000000US060855031122000,060855031122000,"Block 2000, Block Group 2, Census Tract 5031.12, Santa Clara County, California",0,0,0
1000000US060855031122001,060855031122001,"Block 2001, Block Group 2, Census Tract 5031.12, Santa Clara County, California",107,106,1
1000000US060855031122002,060855031122002,"Block 2002, Block Group 2, Census Tract 5031.12, Santa Clara County, California",29,28,1
1000000US060855031122003,060855031122003,"Block 2003, Block Group 2, Census Tract 5031.12, Santa Clara County, California",29,29,0
1000000US060855031122004,060855031122004,"Block 2004, Block Group 2, Census Tract 5031.12, Santa Clara County, California",37,37,0
1000000US060855031122005,060855031122005,"Block 2005, Block Group 2, Census Tract 5031.12, Santa Clara County, California",21,21,0
1000000US060855031122006,060855031122006,"Block 2006, Block Group 2, Census Tract 5031.12, Santa Clara County, California",25,23,2
1000000US060855031122007,060855031122007,"Block 2007, Block Group 2, Census Tract 5031.12, Santa Clara County, California",31,31,0
1000000US060855031122008,060855031122008,"Block 2008, Block Group 2, Census Tract 5031.12, Santa Clara County, California",15,14,1
1000000US060855031122009,060855031122009,"Block 2009, Block Group 2, Census Tract 5031.12, Santa Clara County, California",29,28,1
1000000US060855031122010,060855031122010,"Block 2010, Block Group 2, Census Tract 5031.12, Santa Clara County, California",0,0,0
1000000US060855031122011,060855031122011,"Block 2011, Block Group 2, Census Tract 5031.12, Santa Clara County, California",5,4,1
1000000US060855031122012,060855031122012,"Block 2012, Block Group 2, Census Tract 5031.12, Santa Clara County, California",0,0,0
1000000US060855031122013,060855031122013,"Block 2013, Block Group 2, Census Tract 5031.12, Santa Clara County, California",36,34,2
1000000US060855031131000,060855031131000,"Block 1000, Block Group 1, Census Tract 5031.13, Santa Clara County, California",43,42,1
1000000US060855031131001,060855031131001,"Block 1001, Block Group 1, Census Tract 5031.13, Santa Clara County, California",21,20,1
1000000US060855031131002,060855031131002,"Block 1002, Block Group 1, Census Tract 5031.13, Santa Clara County, California",36,32,4
1000000US060855031131003,060855031131003,"Block 1003, Block Group 1, Census Tract 5031.13, Santa Clara County, California",29,28,1
1000000US060855031131004,060855031131004,"Block 1004, Block Group 1, Census Tract 5031.13, Santa Clara County, California",34,32,2
1000000US060855031131005,060855031131005,"Block 1005, Block Group 1, Census Tract 5031.13, Santa Clara County, California",131,121,10
1000000US060855031131006,060855031131006,"Block 1006, Block Group 1, Census Tract 5031.13, Santa Clara County, California",22,22,0
1000000US060855031131007,060855031131007,"Block 1007, Block Group 1, Census Tract 5031.13, Santa Clara County, California",97,92,5
1000000US060855031131008,060855031131008,"Block 1008, Block Group 1, Census Tract 5031.13, Santa Clara County, California",0,0,0
1000000US060855031131009,060855031131009,"Block 1009, Block Group 1, Census Tract 5031.13, Santa Clara County, California",26,24,2
1000000US060855031131010,060855031131010,"Block 1010, Block Group 1, Census Tract 5031.13, Santa Clara County, California",34,32,2
1000000US060855031131011,060855031131011,"Block 1011, Block Group 1, Census Tract 5031.13, Santa Clara County, California",35,35,0
1000000US060855031131012,060855031131012,"Block 1012, Block Group 1, Census Tract 5031.13, Santa Clara County, California",31,30,1
1000000US060855031131013,060855031131013,"Block 1013, Block Group 1, Census Tract 5031.13, Santa Clara County, California",33,31,2
1000000US060855031131014,060855031131014,"Block 1014, Block Group 1, Census Tract 5031.13, Santa Clara County, California",34,32,2
1000000US060855031131015,060855031131015,"Block 1015, Block Group 1, Census Tract 5031.13, Santa Clara County, California",60,54,6
1000000US060855031131016,060855031131016,"Block 1016, Block Group 1, Census Tract 5031.13, Santa Clara County, California",31,30,1
1000000US060855031131017,060855031131017,"Block 1017, Block Group 1, Census Tract 5031.13, Santa Clara County, California",17,17,0
1000000US060855031131018,060855031131018,"Block 1018, Block Group 1, Census Tract 5031.13, Santa Clara County, California",0,0,0
1000000US060855031131019,060855031131019,"Block 1019, Block Group 1, Census Tract 5031.13, Santa Clara County, California",44,39,5
1000000US060855031132000,060855031132000,"Block 2000, Block Group 2, Census Tract 5031.13, Santa Clara County, California",29,28,1
1000000US060855031132001,060855031132001,"Block 2001, Block Group 2, Census Tract 5031.13, Santa Clara County, California",23,23,0
1000000US060855031132002,060855031132002,"Block 2002, Block Group 2, Census Tract 5031.13, Santa Clara County, California",16,16,0
1000000US060855031132003,060855031132003,"Block 2003, Block Group 2, Census Tract 5031.13, Santa Clara County, California",121,118,3
1000000US060855031132004,060855031132004,"Block 2004, Block Group 2, Census Tract 5031.13, Santa Clara County, California",0,0,0
1000000US060855031132005,060855031132005,"Block 2005, Block Group 2, Census Tract 5031.13, Santa Clara County, California",32,30,2
1000000US060855031132006,060855031132006,"Block 2006, Block Group 2, Census Tract 5031.13, Santa Clara County, California",17,17,0
1000000US060855031132007,060855031132007,"Block 2007, Block Group 2, Census Tract 5031.13, Santa Clara County, California",26,25,1
1000000US060855031132008,060855031132008,"Block 2008, Block Group 2, Census Tract 5031.13, Santa Clara County, California",43,43,0
1000000US060855031132009,060855031132009,"Block 2009, Block Group 2, Census Tract 5031.13, Santa Clara County, California",30,30,0
1000000US060855031132010,060855031132010,"Block 2010, Block Group 2, Census Tract 5031.13, Santa Clara County, California",30,29,1
1000000US060855031132011,060855031132011,"Block 2011, Block Group 2, Census Tract 5031.13, Santa Clara County, California",32,31,1
1000000US060855031132012,060855031132012,"Block 2012, Block Group 2, Census Tract 5031.13, Santa Clara County, California",87,81,6
1000000US060855031132013,060855031132013,"Block 2013, Block Group 2, Census Tract 5031.13, Santa Clara County, California",47,46,1
1000000US060855031132014,060855031132014,"Block 2014, Block Group 2, Census Tract 5031.13, Santa Clara County, California",0,0,0
1000000US060855031132015,060855031132015,"Block 2015, Block Group 2, Census Tract 5031.13, Santa Clara County, California",32,32,0
1000000US060855031132016,060855031132016,"Block 2016, Block Group 2, Census Tract 5031.13, Santa Clara County, California",14,14,0
1000000US060855031151000,060855031151000,"Block 1000, Block Group 1, Census Tract 5031.15, Santa Clara County, California",152,148,4
1000000US060855031151001,060855031151001,"Block 1001, Block Group 1, Census Tract 5031.15, Santa Clara County, California",30,27,3
1000000US060855031151002,060855031151002,"Block 1002, Block Group 1, Census Tract 5031.15, Santa Clara County, California",67,63,4
1000000US060855031151003,060855031151003,"Block 1003, Block Group 1, Census Tract 5031.15, Santa Clara County, California",41,38,3
1000000US060855031151004,060855031151004,"Block 1004, Block Group 1, Census Tract 5031.15, Santa Clara County, California",8,8,0
1000000US060855031151005,060855031151005,"Block 1005, Block Group 1, Census Tract 5031.15, Santa Clara County, California",0,0,0
1000000US060855031151006,060855031151006,"Block 1006, Block Group 1, Census Tract 5031.15, Santa Clara County, California",1,1,0
1000000US060855031151007,060855031151007,"Block 1007, Block Group 1, Census Tract 5031.15, Santa Clara County, California",45,42,3
1000000US060855031151008,060855031151008,"Block 1008, Block Group 1, Census Tract 5031.15, Santa Clara County, California",6,5,1
1000000US060855031151009,060855031151009,"Block 1009, Block Group 1, Census Tract 5031.15, Santa Clara County, California",9,8,1
1000000US060855031151010,060855031151010,"Block 1010, Block Group 1, Census Tract 5031.15, Santa Clara County, California",24,22,2
1000000US060855031151011,060855031151011,"Block 1011, Block Group 1, Census Tract 5031.15, Santa Clara County, California",14,14,0
1000000US060855031151012,060855031151012,"Block 1012, Block Group 1, Census Tract 5031.15, Santa Clara County, California",30,28,2
1000000US060855031151013,060855031151013,"Block 1013, Block Group 1, Census Tract 5031.15, Santa Clara County, California",20,20,0
1000000US060855031151014,060855031151014,"Block 1014, Block Group 1, Census Tract 5031.15, Santa Clara County, California",20,16,4
1000000US060855031151015,060855031151015,"Block 1015, Block Group 1, Census Tract 5031.15, Santa Clara County, California",40,38,2
1000000US060855031151016,060855031151016,"Block 1016, Block Group 1, Census Tract 5031.15, Santa Clara County, California",29,25,4
1000000US060855031151017,060855031151017,"Block 1017, Block Group 1, Census Tract 5031.15, Santa Clara County, California",15,14,1
1000000US060855031151018,060855031151018,"Block 1018, Block Group 1, Census Tract 5031.15, Santa Clara County, California",30,30,0
1000000US060855031151019,060855031151019,"Block 1019, Block Group 1, Census Tract 5031.15, Santa Clara County, California",19,18,1
1000000US060855031151020,060855031151020,"Block 1020, Block Group 1, Census Tract 5031.15, Santa Clara County, California",172,165,7
1000000US060855031151021,060855031151021,"Block 1021, Block Group 1, Census Tract 5031.15, Santa Clara County, California",15,14,1
1000000US060855031151022,060855031151022,"Block 1022, Block Group 1, Census Tract 5031.15, Santa Clara County, California",30,30,0
1000000US060855031151023,060855031151023,"Block 1023, Block Group 1, Census Tract 5031.15, Santa Clara County, California",15,13,2
1000000US060855031151024,060855031151024,"Block 1024, Block Group 1, Census Tract 5031.15, Santa Clara County, California",15,15,0
1000000US060855031151025,060855031151025,"Block 1025, Block Group 1, Census Tract 5031.15, Santa Clara County, California",19,18,1
1000000US060855031151026,060855031151026,"Block 1026, Block Group 1, Census Tract 5031.15, Santa Clara County, California",13,13,0
1000000US060855031151027,060855031151027,"Block 1027, Block Group 1, Census Tract 5031.15, Santa Clara County, California",0,0,0
1000000US060855031151028,060855031151028,"Block 1028, Block Group 1, Census Tract 5031.15, Santa Clara County, California",143,136,7
1000000US060855031151029,060855031151029,"Block 1029, Block Group 1, Census Tract 5031.15, Santa Clara County, California",18,17,1
1000000US060855031151030,060855031151030,"Block 1030, Block Group 1, Census Tract 5031.15, Santa Clara County, California",0,0,0
1000000US060855031151031,060855031151031,"Block 1031, Block Group 1, Census Tract 5031.15, Santa Clara County, California",9,9,0
1000000US060855031151032,060855031151032,"Block 1032, Block Group 1, Census Tract 5031.15, Santa Clara County, California",19,19,0
1000000US060855031151033,060855031151033,"Block 1033, Block Group 1, Census Tract 5031.15, Santa Clara County, California",0,0,0
1000000US060855031151034,060855031151034,"Block 1034, Block Group 1, Census Tract 5031.15, Santa Clara County, California",19,17,2
1000000US060855031151035,060855031151035,"Block 1035, Block Group 1, Census Tract 5031.15, Santa Clara County, California",9,9,0
1000000US060855031151036,060855031151036,"Block 1036, Block Group 1, Census Tract 5031.15, Santa Clara County, California",0,0,0
1000000US060855031151037,060855031151037,"Block 1037, Block Group 1, Census Tract 5031.15, Santa Clara County, California",10,10,0
1000000US060855031151038,060855031151038,"Block 1038, Block Group 1, Census Tract 5031.15, Santa Clara County, California",0,0,0
1000000US060855031151039,060855031151039,"Block 1039, Block Group 1, Census Tract 5031.15, Santa Clara County, California",7,5,2
1000000US060855031151040,060855031151040,"Block 1040, Block Group 1, Census Tract 5031.15, Santa Clara County, California",0,0,0
1000000US060855031151041,060855031151041,"Block 1041, Block Group 1, Census Tract 5031.15, Santa Clara County, California",8,8,0
1000000US060855031151042,060855031151042,"Block 1042, Block Group 1, Census Tract 5031.15, Santa Clara County, California",3,3,0
1000000US060855031151043,060855031151043,"Block 1043, Block Group 1, Census Tract 5031.15, Santa Clara County, California",0,0,0
1000000US060855031151044,060855031151044,"Block 1044, Block Group 1, Census Tract 5031.15, Santa Clara County, California",7,7,0
1000000US060855031151045,060855031151045,"Block 1045, Block Group 1, Census Tract 5031.15, Santa Clara County, California",1,1,0
1000000US060855031151046,060855031151046,"Block 1046, Block Group 1, Census Tract 5031.15, Santa Clara County, California",0,0,0
1000000US060855031151047,060855031151047,"Block 1047, Block Group 1, Census Tract 5031.15, Santa Clara County, California",0,0,0
1000000US060855031151048,060855031151048,"Block 1048, Block Group 1, Census Tract 5031.15, Santa Clara County, California",0,0,0
1000000US060855031151049,060855031151049,"Block 1049, Block Group 1, Census Tract 5031.15, Santa Clara County, California",26,25,1
1000000US060855031151050,060855031151050,"Block 1050, Block Group 1, Census Tract 5031.15, Santa Clara County, California",33,33,0
1000000US060855031151051,060855031151051,"Block 1051, Block Group 1, Census Tract 5031.15, Santa Clara County, California",14,14,0
1000000US060855031151052,060855031151052,"Block 1052, Block Group 1, Census Tract 5031.15, Santa Clara County, California",0,0,0
1000000US060855031151053,060855031151053,"Block 1053, Block Group 1, Census Tract 5031.15, Santa Clara County, California",0,0,0
1000000US060855031151054,060855031151054,"Block 1054, Block Group 1, Census Tract 5031.15, Santa Clara County, California",0,0,0
1000000US060855031151055,060855031151055,"Block 1055, Block Group 1, Census Tract 5031.15, Santa Clara County, California",0,0,0
1000000US060855031151056,060855031151056,"Block 1056, Block Group 1, Census Tract 5031.15, Santa Clara County, California",36,35,1
1000000US060855031151057,060855031151057,"Block 1057, Block Group 1, Census Tract 5031.15, Santa Clara County, California",9,8,1
1000000US060855031151058,060855031151058,"Block 1058, Block Group 1, Census Tract 5031.15, Santa Clara County, California",57,55,2
1000000US060855031151059,060855031151059,"Block 1059, Block Group 1, Census Tract 5031.15, Santa Clara County, California",0,0,0
1000000US060855031151060,060855031151060,"Block 1060, Block Group 1, Census Tract 5031.15, Santa Clara County, California",42,37,5
1000000US060855031151061,060855031151061,"Block 1061, Block Group 1, Census Tract 5031.15, Santa Clara County, California",11,11,0
1000000US060855031151062,060855031151062,"Block 1062, Block Group 1, Census Tract 5031.15, Santa Clara County, California",25,23,2
1000000US060855031151063,060855031151063,"Block 1063, Block Group 1, Census Tract 5031.15, Santa Clara County, California",53,52,1
1000000US060855031151064,060855031151064,"Block 1064, Block Group 1, Census Tract 5031.15, Santa Clara County, California",20,20,0
1000000US060855031151065,060855031151065,"Block 1065, Block Group 1, Census Tract 5031.15, Santa Clara County, California",11,11,0
1000000US060855031151066,060855031151066,"Block 1066, Block Group 1, Census Tract 5031.15, Santa Clara County, California",48,46,2
1000000US060855031151067,060855031151067,"Block 1067, Block Group 1, Census Tract 5031.15, Santa Clara County, California",34,33,1
1000000US060855031151068,060855031151068,"Block 1068, Block Group 1, Census Tract 5031.15, Santa Clara County, California",23,22,1
1000000US060855031151069,060855031151069,"Block 1069, Block Group 1, Census Tract 5031.15, Santa Clara County, California",8,8,0
1000000US060855031151070,060855031151070,"Block 1070, Block Group 1, Census Tract 5031.15, Santa Clara County, California",282,265,17
1000000US060855031151071,060855031151071,"Block 1071, Block Group 1, Census Tract 5031.15, Santa Clara County, California",47,44,3
1000000US060855031151072,060855031151072,"Block 1072, Block Group 1, Census Tract 5031.15, Santa Clara County, California",0,0,0
1000000US060855031151073,060855031151073,"Block 1073, Block Group 1, Census Tract 5031.15, Santa Clara County, California",16,16,0
1000000US060855031151074,060855031151074,"Block 1074, Block Group 1, Census Tract 5031.15, Santa Clara County, California",26,25,1
1000000US060855031151075,060855031151075,"Block 1075, Block Group 1, Census Tract 5031.15, Santa Clara County, California",90,86,4
1000000US060855031151076,060855031151076,"Block 1076, Block Group 1, Census Tract 5031.15, Santa Clara County, California",0,0,0
1000000US060855031151077,060855031151077,"Block 1077, Block Group 1, Census Tract 5031.15, Santa Clara County, California",0,0,0
1000000US060855031151078,060855031151078,"Block 1078, Block Group 1, Census Tract 5031.15, Santa Clara County, California",0,0,0
1000000US060855031151079,060855031151079,"Block 1079, Block Group 1, Census Tract 5031.15, Santa Clara County, California",72,67,5
1000000US060855031151080,060855031151080,"Block 1080, Block Group 1, Census Tract 5031.15, Santa Clara County, California",17,16,1
1000000US060855031151081,060855031151081,"Block 1081, Block Group 1, Census Tract 5031.15, Santa Clara County, California",18,18,0
1000000US060855031151082,060855031151082,"Block 1082, Block Group 1, Census Tract 5031.15, Santa Clara County, California",20,19,1
1000000US060855031151083,060855031151083,"Block 1083, Block Group 1, Census Tract 5031.15, Santa Clara County, California",89,88,1
1000000US060855031151084,060855031151084,"Block 1084, Block Group 1, Census Tract 5031.15, Santa Clara County, California",24,24,0
1000000US060855031151085,060855031151085,"Block 1085, Block Group 1, Census Tract 5031.15, Santa Clara County, California",0,0,0
1000000US060855031151086,060855031151086,"Block 1086, Block Group 1, Census Tract 5031.15, Santa Clara County, California",11,10,1
1000000US060855031151087,060855031151087,"Block 1087, Block Group 1, Census Tract 5031.15, Santa Clara County, California",31,30,1
1000000US060855031151088,060855031151088,"Block 1088, Block Group 1, Census Tract 5031.15, Santa Clara County, California",31,29,2
1000000US060855031151089,060855031151089,"Block 1089, Block Group 1, Census Tract 5031.15, Santa Clara County, California",29,29,0
1000000US060855031151090,060855031151090,"Block 1090, Block Group 1, Census Tract 5031.15, Santa Clara County, California",8,8,0
1000000US060855031151091,060855031151091,"Block 1091, Block Group 1, Census Tract 5031.15, Santa Clara County, California",1,1,0
1000000US060855031151092,060855031151092,"Block 1092, Block Group 1, Census Tract 5031.15, Santa Clara County, California",22,22,0
1000000US060855031151093,060855031151093,"Block 1093, Block Group 1, Census Tract 5031.15, Santa Clara County, California",5,5,0
1000000US060855031151094,060855031151094,"Block 1094, Block Group 1, Census Tract 5031.15, Santa Clara County, California",14,13,1
1000000US060855031151095,060855031151095,"Block 1095, Block Group 1, Census Tract 5031.15, Santa Clara County, California",27,26,1
1000000US060855031151096,060855031151096,"Block 1096, Block Group 1, Census Tract 5031.15, Santa Clara County, California",19,19,0
1000000US060855031151097,060855031151097,"Block 1097, Block Group 1, Census Tract 5031.15, Santa Clara County, California",10,10,0
1000000US060855031151098,060855031151098,"Block 1098, Block Group 1, Census Tract 5031.15, Santa Clara County, California",19,17,2
1000000US060855031151099,060855031151099,"Block 1099, Block Group 1, Census Tract 5031.15, Santa Clara County, California",12,12,0
1000000US060855031151100,060855031151100,"Block 1100, Block Group 1, Census Tract 5031.15, Santa Clara County, California",5,5,0
1000000US060855031151101,060855031151101,"Block 1101, Block Group 1, Census Tract 5031.15, Santa Clara County, California",18,18,0
1000000US060855031151102,060855031151102,"Block 1102, Block Group 1, Census Tract 5031.15, Santa Clara County, California",15,15,0
1000000US060855031151103,060855031151103,"Block 1103, Block Group 1, Census Tract 5031.15, Santa Clara County, California",16,15,1
1000000US060855031151104,060855031151104,"Block 1104, Block Group 1, Census Tract 5031.15, Santa Clara County, California",0,0,0
1000000US060855031151105,060855031151105,"Block 1105, Block Group 1, Census Tract 5031.15, Santa Clara County, California",19,18,1
1000000US060855031161000,060855031161000,"Block 1000, Block Group 1, Census Tract 5031.16, Santa Clara County, California",119,117,2
1000000US060855031161001,060855031161001,"Block 1001, Block Group 1, Census Tract 5031.16, Santa Clara County, California",1,1,0
1000000US060855031161002,060855031161002,"Block 1002, Block Group 1, Census Tract 5031.16, Santa Clara County, California",80,80,0
1000000US060855031161003,060855031161003,"Block 1003, Block Group 1, Census Tract 5031.16, Santa Clara County, California",48,46,2
1000000US060855031161004,060855031161004,"Block 1004, Block Group 1, Census Tract 5031.16, Santa Clara County, California",14,13,1
1000000US060855031161005,060855031161005,"Block 1005, Block Group 1, Census Tract 5031.16, Santa Clara County, California",16,16,0
1000000US060855031161006,060855031161006,"Block 1006, Block Group 1, Census Tract 5031.16, Santa Clara County, California",20,19,1
1000000US060855031161007,060855031161007,"Block 1007, Block Group 1, Census Tract 5031.16, Santa Clara County, California",26,24,2
1000000US060855031161008,060855031161008,"Block 1008, Block Group 1, Census Tract 5031.16, Santa Clara County, California",26,25,1
1000000US060855031161009,060855031161009,"Block 1009, Block Group 1, Census Tract 5031.16, Santa Clara County, California",0,0,0
1000000US060855031161010,060855031161010,"Block 1010, Block Group 1, Census Tract 5031.16, Santa Clara County, California",50,45,5
1000000US060855031161011,060855031161011,"Block 1011, Block Group 1, Census Tract 5031.16, Santa Clara County, California",31,30,1
1000000US060855031161012,060855031161012,"Block 1012, Block Group 1, Census Tract 5031.16, Santa Clara County, California",29,26,3
1000000US060855031161013,060855031161013,"Block 1013, Block Group 1, Census Tract 5031.16, Santa Clara County, California",33,32,1
1000000US060855031161014,060855031161014,"Block 1014, Block Group 1, Census Tract 5031.16, Santa Clara County, California",27,27,0
1000000US060855031161015,060855031161015,"Block 1015, Block Group 1, Census Tract 5031.16, Santa Clara County, California",0,0,0
1000000US060855031161016,060855031161016,"Block 1016, Block Group 1, Census Tract 5031.16, Santa Clara County, California",126,124,2
1000000US060855031161017,060855031161017,"Block 1017, Block Group 1, Census Tract 5031.16, Santa Clara County, California",22,22,0
1000000US060855031161018,060855031161018,"Block 1018, Block Group 1, Census Tract 5031.16, Santa Clara County, California",38,37,1
1000000US060855031161019,060855031161019,"Block 1019, Block Group 1, Census Tract 5031.16, Santa Clara County, California",10,10,0
1000000US060855031161020,060855031161020,"Block 1020, Block Group 1, Census Tract 5031.16, Santa Clara County, California",119,116,3
1000000US060855031161021,060855031161021,"Block 1021, Block Group 1, Census Tract 5031.16, Santa Clara County, California",132,125,7
1000000US060855031161022,060855031161022,"Block 1022, Block Group 1, Census Tract 5031.16, Santa Clara County, California",49,48,1
1000000US060855031161023,060855031161023,"Block 1023, Block Group 1, Census Tract 5031.16, Santa Clara County, California",2,2,0
1000000US060855031161024,060855031161024,"Block 1024, Block Group 1, Census Tract 5031.16, Santa Clara County, California",158,157,1
1000000US060855031161025,060855031161025,"Block 1025, Block Group 1, Census Tract 5031.16, Santa Clara County, California",20,20,0
1000000US060855031161026,060855031161026,"Block 1026, Block Group 1, Census Tract 5031.16, Santa Clara County, California",96,94,2
1000000US060855031161027,060855031161027,"Block 1027, Block Group 1, Census Tract 5031.16, Santa Clara County, California",60,58,2
1000000US060855031162000,060855031162000,"Block 2000, Block Group 2, Census Tract 5031.16, Santa Clara County, California",109,107,2
1000000US060855031162001,060855031162001,"Block 2001, Block Group 2, Census Tract 5031.16, Santa Clara County, California",42,38,4
1000000US060855031162002,060855031162002,"Block 2002, Block Group 2, Census Tract 5031.16, Santa Clara County, California",0,0,0
1000000US060855031162003,060855031162003,"Block 2003, Block Group 2, Census Tract 5031.16, Santa Clara County, California",33,33,0
1000000US060855031162004,060855031162004,"Block 2004, Block Group 2, Census Tract 5031.16, Santa Clara County, California",16,15,1
1000000US060855031162005,060855031162005,"Block 2005, Block Group 2, Census Tract 5031.16, Santa Clara County, California",0,0,0
1000000US060855031162006,060855031162006,"Block 2006, Block Group 2, Census Tract 5031.16, Santa Clara County, California",17,17,0
1000000US060855031162007,060855031162007,"Block 2007, Block Group 2, Census Tract 5031.16, Santa Clara County, California",18,17,1
1000000US060855031162008,060855031162008,"Block 2008, Block Group 2, Census Tract 5031.16, Santa Clara County, California",15,15,0
1000000US060855031162009,060855031162009,"Block 2009, Block Group 2, Census Tract 5031.16, Santa Clara County, California",28,27,1
1000000US060855031162010,060855031162010,"Block 2010, Block Group 2, Census Tract 5031.16, Santa Clara County, California",99,97,2
1000000US060855031162011,060855031162011,"Block 2011, Block Group 2, Census Tract 5031.16, Santa Clara County, California",0,0,0
1000000US060855031162012,060855031162012,"Block 2012, Block Group 2, Census Tract 5031.16, Santa Clara County, California",81,81,0
1000000US060855031162013,060855031162013,"Block 2013, Block Group 2, Census Tract 5031.16, Santa Clara County, California",28,27,1
1000000US060855031162014,060855031162014,"Block 2014, Block Group 2, Census Tract 5031.16, Santa Clara County, California",384,341,43
1000000US060855031162015,060855031162015,"Block 2015, Block Group 2, Census Tract 5031.16, Santa Clara County, California",0,0,0
1000000US060855031171000,060855031171000,"Block 1000, Block Group 1, Census Tract 5031.17, Santa Clara County, California",26,24,2
1000000US060855031171001,060855031171001,"Block 1001, Block Group 1, Census Tract 5031.17, Santa Clara County, California",65,62,3
1000000US060855031171002,060855031171002,"Block 1002, Block Group 1, Census Tract 5031.17, Santa Clara County, California",106,104,2
1000000US060855031171003,060855031171003,"Block 1003, Block Group 1, Census Tract 5031.17, Santa Clara County, California",31,31,0
1000000US060855031171004,060855031171004,"Block 1004, Block Group 1, Census Tract 5031.17, Santa Clara County, California",38,37,1
1000000US060855031171005,060855031171005,"Block 1005, Block Group 1, Census Tract 5031.17, Santa Clara County, California",93,93,0
1000000US060855031172000,060855031172000,"Block 2000, Block Group 2, Census Tract 5031.17, Santa Clara County, California",47,46,1
1000000US060855031172001,060855031172001,"Block 2001, Block Group 2, Census Tract 5031.17, Santa Clara County, California",165,164,1
1000000US060855031172002,060855031172002,"Block 2002, Block Group 2, Census Tract 5031.17, Santa Clara County, California",22,22,0
1000000US060855031172003,060855031172003,"Block 2003, Block Group 2, Census Tract 5031.17, Santa Clara County, California",24,23,1
1000000US060855031172004,060855031172004,"Block 2004, Block Group 2, Census Tract 5031.17, Santa Clara County, California",24,24,0
1000000US060855031172005,060855031172005,"Block 2005, Block Group 2, Census Tract 5031.17, Santa Clara County, California",83,80,3
1000000US060855031172006,060855031172006,"Block 2006, Block Group 2, Census Tract 5031.17, Santa Clara County, California",0,0,0
1000000US060855031172007,060855031172007,"Block 2007, Block Group 2, Census Tract 5031.17, Santa Clara County, California",0,0,0
1000000US060855031172008,060855031172008,"Block 2008, Block Group 2, Census Tract 5031.17, Santa Clara County, California",12,11,1
1000000US060855031181000,060855031181000,"Block 1000, Block Group 1, Census Tract 5031.18, Santa Clara County, California",27,25,2
1000000US060855031181001,060855031181001,"Block 1001, Block Group 1, Census Tract 5031.18, Santa Clara County, California",30,29,1
1000000US060855031181002,060855031181002,"Block 1002, Block Group 1, Census Tract 5031.18, Santa Clara County, California",66,66,0
1000000US060855031181003,060855031181003,"Block 1003, Block Group 1, Census Tract 5031.18, Santa Clara County, California",33,32,1
1000000US060855031181004,060855031181004,"Block 1004, Block Group 1, Census Tract 5031.18, Santa Clara County, California",31,31,0
1000000US060855031182000,060855031182000,"Block 2000, Block Group 2, Census Tract 5031.18, Santa Clara County, California",489,465,24
1000000US060855031182001,060855031182001,"Block 2001, Block Group 2, Census Tract 5031.18, Santa Clara County, California",25,24,1
1000000US060855031182002,060855031182002,"Block 2002, Block Group 2, Census Tract 5031.18, Santa Clara County, California",116,110,6
1000000US060855031182003,060855031182003,"Block 2003, Block Group 2, Census Tract 5031.18, Santa Clara County, California",28,26,2
1000000US060855031182004,060855031182004,"Block 2004, Block Group 2, Census Tract 5031.18, Santa Clara County, California",0,0,0
1000000US060855031183000,060855031183000,"Block 3000, Block Group 3, Census Tract 5031.18, Santa Clara County, California",748,735,13
1000000US060855031183001,060855031183001,"Block 3001, Block Group 3, Census Tract 5031.18, Santa Clara County, California",80,76,4
1000000US060855031211000,060855031211000,"Block 1000, Block Group 1, Census Tract 5031.21, Santa Clara County, California",21,20,1
1000000US060855031211001,060855031211001,"Block 1001, Block Group 1, Census Tract 5031.21, Santa Clara County, California",40,37,3
1000000US060855031211002,060855031211002,"Block 1002, Block Group 1, Census Tract 5031.21, Santa Clara County, California",44,42,2
1000000US060855031211003,060855031211003,"Block 1003, Block Group 1, Census Tract 5031.21, Santa Clara County, California",9,8,1
1000000US060855031211004,060855031211004,"Block 1004, Block Group 1, Census Tract 5031.21, Santa Clara County, California",23,23,0
1000000US060855031211005,060855031211005,"Block 1005, Block Group 1, Census Tract 5031.21, Santa Clara County, California",7,7,0
1000000US060855031211006,060855031211006,"Block 1006, Block Group 1, Census Tract 5031.21, Santa Clara County, California",23,22,1
1000000US060855031211007,060855031211007,"Block 1007, Block Group 1, Census Tract 5031.21, Santa Clara County, California",60,56,4
1000000US060855031211008,060855031211008,"Block 1008, Block Group 1, Census Tract 5031.21, Santa Clara County, California",349,324,25
1000000US060855031211009,060855031211009,"Block 1009, Block Group 1, Census Tract 5031.21, Santa Clara County, California",1,0,1
1000000US060855031211010,060855031211010,"Block 1010, Block Group 1, Census Tract 5031.21, Santa Clara County, California",60,59,1
1000000US060855031211011,060855031211011,"Block 1011, Block Group 1, Census Tract 5031.21, Santa Clara County, California",0,0,0
1000000US060855031211012,060855031211012,"Block 1012, Block Group 1, Census Tract 5031.21, Santa Clara County, California",64,60,4
1000000US060855031211013,060855031211013,"Block 1013, Block Group 1, Census Tract 5031.21, Santa Clara County, California",56,53,3
1000000US060855031211014,060855031211014,"Block 1014, Block Group 1, Census Tract 5031.21, Santa Clara County, California",244,235,9
1000000US060855031211015,060855031211015,"Block 1015, Block Group 1, Census Tract 5031.21, Santa Clara County, California",226,225,1
1000000US060855031211016,060855031211016,"Block 1016, Block Group 1, Census Tract 5031.21, Santa Clara County, California",0,0,0
1000000US060855031211017,060855031211017,"Block 1017, Block Group 1, Census Tract 5031.21, Santa Clara County, California",0,0,0
1000000US060855031211018,060855031211018,"Block 1018, Block Group 1, Census Tract 5031.21, Santa Clara County, California",0,0,0
1000000US060855031211019,060855031211019,"Block 1019, Block Group 1, Census Tract 5031.21, Santa Clara County, California",0,0,0
1000000US060855031211020,060855031211020,"Block 1020, Block Group 1, Census Tract 5031.21, Santa Clara County, California",0,0,0
1000000US060855031211021,060855031211021,"Block 1021, Block Group 1, Census Tract 5031.21, Santa Clara County, California",0,0,0
1000000US060855031211022,060855031211022,"Block 1022, Block Group 1, Census Tract 5031.21, Santa Clara County, California",9,8,1
1000000US060855031211023,060855031211023,"Block 1023, Block Group 1, Census Tract 5031.21, Santa Clara County, California",0,0,0
1000000US060855031211024,060855031211024,"Block 1024, Block Group 1, Census Tract 5031.21, Santa Clara County, California",0,0,0
1000000US060855031211025,060855031211025,"Block 1025, Block Group 1, Census Tract 5031.21, Santa Clara County, California",0,0,0
1000000US060855031211026,060855031211026,"Block 1026, Block Group 1, Census Tract 5031.21, Santa Clara County, California",3,3,0
1000000US060855031211027,060855031211027,"Block 1027, Block Group 1, Census Tract 5031.21, Santa Clara County, California",0,0,0
1000000US060855031211028,060855031211028,"Block 1028, Block Group 1, Census Tract 5031.21, Santa Clara County, California",5,4,1
1000000US060855031211029,060855031211029,"Block 1029, Block Group 1, Census Tract 5031.21, Santa Clara County, California",6,5,1
1000000US060855031211030,060855031211030,"Block 1030, Block Group 1, Census Tract 5031.21, Santa Clara County, California",2,2,0
1000000US060855031211031,060855031211031,"Block 1031, Block Group 1, Census Tract 5031.21, Santa Clara County, California",43,43,0
1000000US060855031211032,060855031211032,"Block 1032, Block Group 1, Census Tract 5031.21, Santa Clara County, California",0,0,0
1000000US060855031211033,060855031211033,"Block 1033, Block Group 1, Census Tract 5031.21, Santa Clara County, California",0,0,0
1000000US060855031211034,060855031211034,"Block 1034, Block Group 1, Census Tract 5031.21, Santa Clara County, California",24,22,2
1000000US060855031211035,060855031211035,"Block 1035, Block Group 1, Census Tract 5031.21, Santa Clara County, California",0,0,0
1000000US060855031211036,060855031211036,"Block 1036, Block Group 1, Census Tract 5031.21, Santa Clara County, California",0,0,0
1000000US060855031212000,060855031212000,"Block 2000, Block Group 2, Census Tract 5031.21, Santa Clara County, California",1,1,0
1000000US060855031212001,060855031212001,"Block 2001, Block Group 2, Census Tract 5031.21, Santa Clara County, California",2,2,0
1000000US060855031212002,060855031212002,"Block 2002, Block Group 2, Census Tract 5031.21, Santa Clara County, California",12,12,0
1000000US060855031212003,060855031212003,"Block 2003, Block Group 2, Census Tract 5031.21, Santa Clara County, California",35,35,0
1000000US060855031212004,060855031212004,"Block 2004, Block Group 2, Census Tract 5031.21, Santa Clara County, California",21,21,0
1000000US060855031212005,060855031212005,"Block 2005, Block Group 2, Census Tract 5031.21, Santa Clara County, California",27,27,0
1000000US060855031212006,060855031212006,"Block 2006, Block Group 2, Census Tract 5031.21, Santa Clara County, California",0,0,0
1000000US060855031212007,060855031212007,"Block 2007, Block Group 2, Census Tract 5031.21, Santa Clara County, California",0,0,0
1000000US060855031212008,060855031212008,"Block 2008, Block Group 2, Census Tract 5031.21, Santa Clara County, California",66,65,1
1000000US060855031212009,060855031212009,"Block 2009, Block Group 2, Census Tract 5031.21, Santa Clara County, California",0,0,0
1000000US060855031212010,060855031212010,"Block 2010, Block Group 2, Census Tract 5031.21, Santa Clara County, California",19,18,1
1000000US060855031212011,060855031212011,"Block 2011, Block Group 2, Census Tract 5031.21, Santa Clara County, California",42,41,1
1000000US060855031221000,060855031221000,"Block 1000, Block Group 1, Census Tract 5031.22, Santa Clara County, California",0,0,0
1000000US060855031221001,060855031221001,"Block 1001, Block Group 1, Census Tract 5031.22, Santa Clara County, California",116,114,2
1000000US060855031221002,060855031221002,"Block 1002, Block Group 1, Census Tract 5031.22, Santa Clara County, California",0,0,0
1000000US060855031221003,060855031221003,"Block 1003, Block Group 1, Census Tract 5031.22, Santa Clara County, California",0,0,0
1000000US060855031221004,060855031221004,"Block 1004, Block Group 1, Census Tract 5031.22, Santa Clara County, California",0,0,0
1000000US060855031221005,060855031221005,"Block 1005, Block Group 1, Census Tract 5031.22, Santa Clara County, California",0,0,0
1000000US060855031221006,060855031221006,"Block 1006, Block Group 1, Census Tract 5031.22, Santa Clara County, California",0,0,0
1000000US060855031221007,060855031221007,"Block 1007, Block Group 1, Census Tract 5031.22, Santa Clara County, California",0,0,0
1000000US060855031221008,060855031221008,"Block 1008, Block Group 1, Census Tract 5031.22, Santa Clara County, California",0,0,0
1000000US060855031221009,060855031221009,"Block 1009, Block Group 1, Census Tract 5031.22, Santa Clara County, California",53,52,1
1000000US060855031221010,060855031221010,"Block 1010, Block Group 1, Census Tract 5031.22, Santa Clara County, California",387,381,6
1000000US060855031221011,060855031221011,"Block 1011, Block Group 1, Census Tract 5031.22, Santa Clara County, California",15,14,1
1000000US060855031221012,060855031221012,"Block 1012, Block Group 1, Census Tract 5031.22, Santa Clara County, California",18,18,0
1000000US060855031221013,060855031221013,"Block 1013, Block Group 1, Census Tract 5031.22, Santa Clara County, California",16,15,1
1000000US060855031221014,060855031221014,"Block 1014, Block Group 1, Census Tract 5031.22, Santa Clara County, California",16,15,1
1000000US060855031221015,060855031221015,"Block 1015, Block Group 1, Census Tract 5031.22, Santa Clara County, California",16,15,1
1000000US060855031221016,060855031221016,"Block 1016, Block Group 1, Census Tract 5031.22, Santa Clara County, California",15,15,0
1000000US060855031221017,060855031221017,"Block 1017, Block Group 1, Census Tract 5031.22, Santa Clara County, California",18,17,1
1000000US060855031221018,060855031221018,"Block 1018, Block Group 1, Census Tract 5031.22, Santa Clara County, California",18,18,0
1000000US060855031221019,060855031221019,"Block 1019, Block Group 1, Census Tract 5031.22, Santa Clara County, California",28,27,1
1000000US060855031221020,060855031221020,"Block 1020, Block Group 1, Census Tract 5031.22, Santa Clara County, California",18,18,0
1000000US060855031221021,060855031221021,"Block 1021, Block Group 1, Census Tract 5031.22, Santa Clara County, California",16,16,0
1000000US060855031221022,060855031221022,"Block 1022, Block Group 1, Census Tract 5031.22, Santa Clara County, California",0,0,0
1000000US060855031221023,060855031221023,"Block 1023, Block Group 1, Census Tract 5031.22, Santa Clara County, California",0,0,0
1000000US060855031221024,060855031221024,"Block 1024, Block Group 1, Census Tract 5031.22, Santa Clara County, California",0,0,0
1000000US060855031221025,060855031221025,"Block 1025, Block Group 1, Census Tract 5031.22, Santa Clara County, California",2,2,0
1000000US060855031221026,060855031221026,"Block 1026, Block Group 1, Census Tract 5031.22, Santa Clara County, California",102,99,3
1000000US060855031221027,060855031221027,"Block 1027, Block Group 1, Census Tract 5031.22, Santa Clara County, California",0,0,0
1000000US060855031221028,060855031221028,"Block 1028, Block Group 1, Census Tract 5031.22, Santa Clara County, California",1,0,1
1000000US060855031221029,060855031221029,"Block 1029, Block Group 1, Census Tract 5031.22, Santa Clara County, California",0,0,0
1000000US060855031222000,060855031222000,"Block 2000, Block Group 2, Census Tract 5031.22, Santa Clara County, California",14,12,2
1000000US060855031222001,060855031222001,"Block 2001, Block Group 2, Census Tract 5031.22, Santa Clara County, California",4,3,1
1000000US060855031222002,060855031222002,"Block 2002, Block Group 2, Census Tract 5031.22, Santa Clara County, California",0,0,0
1000000US060855031222003,060855031222003,"Block 2003, Block Group 2, Census Tract 5031.22, Santa Clara County, California",0,0,0
1000000US060855031222004,060855031222004,"Block 2004, Block Group 2, Census Tract 5031.22, Santa Clara County, California",30,28,2
1000000US060855031222005,060855031222005,"Block 2005, Block Group 2, Census Tract 5031.22, Santa Clara County, California",112,106,6
1000000US060855031222006,060855031222006,"Block 2006, Block Group 2, Census Tract 5031.22, Santa Clara County, California",176,168,8
1000000US060855031231000,060855031231000,"Block 1000, Block Group 1, Census Tract 5031.23, Santa Clara County, California",658,610,48
1000000US060855031231001,060855031231001,"Block 1001, Block Group 1, Census Tract 5031.23, Santa Clara County, California",178,169,9
1000000US060855031231002,060855031231002,"Block 1002, Block Group 1, Census Tract 5031.23, Santa Clara County, California",22,21,1
1000000US060855031232000,060855031232000,"Block 2000, Block Group 2, Census Tract 5031.23, Santa Clara County, California",379,344,35
1000000US060855031232001,060855031232001,"Block 2001, Block Group 2, Census Tract 5031.23, Santa Clara County, California",179,179,0
1000000US060855031232002,060855031232002,"Block 2002, Block Group 2, Census Tract 5031.23, Santa Clara County, California",158,139,19
1000000US060855031232003,060855031232003,"Block 2003, Block Group 2, Census Tract 5031.23, Santa Clara County, California",9,9,0
1000000US060855031232004,060855031232004,"Block 2004, Block Group 2, Census Tract 5031.23, Santa Clara County, California",35,32,3
1000000US060855031232005,060855031232005,"Block 2005, Block Group 2, Census Tract 5031.23, Santa Clara County, California",16,16,0
1000000US060855031232006,060855031232006,"Block 2006, Block Group 2, Census Tract 5031.23, Santa Clara County, California",12,11,1
1000000US060855031232007,060855031232007,"Block 2007, Block Group 2, Census Tract 5031.23, Santa Clara County, California",9,8,1
1000000US060855031232008,060855031232008,"Block 2008, Block Group 2, Census Tract 5031.23, Santa Clara County, California",11,11,0
1000000US060855031232009,060855031232009,"Block 2009, Block Group 2, Census Tract 5031.23, Santa Clara County, California",0,0,0
1000000US060855032041000,060855032041000,"Block 1000, Block Group 1, Census Tract 5032.04, Santa Clara County, California",23,21,2
1000000US060855032041001,060855032041001,"Block 1001, Block Group 1, Census Tract 5032.04, Santa Clara County, California",52,52,0
1000000US060855032041002,060855032041002,"Block 1002, Block Group 1, Census Tract 5032.04, Santa Clara County, California",24,23,1
1000000US060855032041003,060855032041003,"Block 1003, Block Group 1, Census Tract 5032.04, Santa Clara County, California",41,39,2
1000000US060855032041004,060855032041004,"Block 1004, Block Group 1, Census Tract 5032.04, Santa Clara County, California",42,41,1
1000000US060855032041005,060855032041005,"Block 1005, Block Group 1, Census Tract 5032.04, Santa Clara County, California",47,46,1
1000000US060855032041006,060855032041006,"Block 1006, Block Group 1, Census Tract 5032.04, Santa Clara County, California",32,32,0
1000000US060855032041007,060855032041007,"Block 1007, Block Group 1, Census Tract 5032.04, Santa Clara County, California",37,36,1
1000000US060855032041008,060855032041008,"Block 1008, Block Group 1, Census Tract 5032.04, Santa Clara County, California",52,50,2
1000000US060855032041009,060855032041009,"Block 1009, Block Group 1, Census Tract 5032.04, Santa Clara County, California",28,26,2
1000000US060855032041010,060855032041010,"Block 1010, Block Group 1, Census Tract 5032.04, Santa Clara County, California",23,21,2
1000000US060855032041011,060855032041011,"Block 1011, Block Group 1, Census Tract 5032.04, Santa Clara County, California",16,16,0
1000000US060855032041012,060855032041012,"Block 1012, Block Group 1, Census Tract 5032.04, Santa Clara County, California",53,51,2
1000000US060855032041013,060855032041013,"Block 1013, Block Group 1, Census Tract 5032.04, Santa Clara County, California",3,3,0
1000000US060855032041014,060855032041014,"Block 1014, Block Group 1, Census Tract 5032.04, Santa Clara County, California",54,51,3
1000000US060855032041015,060855032041015,"Block 1015, Block Group 1, Census Tract 5032.04, Santa Clara County, California",60,57,3
1000000US060855032041016,060855032041016,"Block 1016, Block Group 1, Census Tract 5032.04, Santa Clara County, California",29,29,0
1000000US060855032041017,060855032041017,"Block 1017, Block Group 1, Census Tract 5032.04, Santa Clara County, California",3,3,0
1000000US060855032041018,060855032041018,"Block 1018, Block Group 1, Census Tract 5032.04, Santa Clara County, California",5,4,1
1000000US060855032042000,060855032042000,"Block 2000, Block Group 2, Census Tract 5032.04, Santa Clara County, California",0,0,0
1000000US060855032042001,060855032042001,"Block 2001, Block Group 2, Census Tract 5032.04, Santa Clara County, California",55,54,1
1000000US060855032042002,060855032042002,"Block 2002, Block Group 2, Census Tract 5032.04, Santa Clara County, California",104,100,4
1000000US060855032042003,060855032042003,"Block 2003, Block Group 2, Census Tract 5032.04, Santa Clara County, California",4,4,0
1000000US060855032042004,060855032042004,"Block 2004, Block Group 2, Census Tract 5032.04, Santa Clara County, California",92,88,4
1000000US060855032042005,060855032042005,"Block 2005, Block Group 2, Census Tract 5032.04, Santa Clara County, California",136,135,1
1000000US060855032042006,060855032042006,"Block 2006, Block Group 2, Census Tract 5032.04, Santa Clara County, California",60,58,2
1000000US060855032042007,060855032042007,"Block 2007, Block Group 2, Census Tract 5032.04, Santa Clara County, California",1,1,0
1000000US060855032042008,060855032042008,"Block 2008, Block Group 2, Census Tract 5032.04, Santa Clara County, California",19,19,0
1000000US060855032043000,060855032043000,"Block 3000, Block Group 3, Census Tract 5032.04, Santa Clara County, California",32,32,0
1000000US060855032043001,060855032043001,"Block 3001, Block Group 3, Census Tract 5032.04, Santa Clara County, California",20,20,0
1000000US060855032043002,060855032043002,"Block 3002, Block Group 3, Census Tract 5032.04, Santa Clara County, California",141,136,5
1000000US060855032043003,060855032043003,"Block 3003, Block Group 3, Census Tract 5032.04, Santa Clara County, California",259,248,11
1000000US060855032044000,060855032044000,"Block 4000, Block Group 4, Census Tract 5032.04, Santa Clara County, California",22,21,1
1000000US060855032044001,060855032044001,"Block 4001, Block Group 4, Census Tract 5032.04, Santa Clara County, California",39,38,1
1000000US060855032044002,060855032044002,"Block 4002, Block Group 4, Census Tract 5032.04, Santa Clara County, California",29,29,0
1000000US060855032044003,060855032044003,"Block 4003, Block Group 4, Census Tract 5032.04, Santa Clara County, California",31,30,1
1000000US060855032044004,060855032044004,"Block 4004, Block Group 4, Census Tract 5032.04, Santa Clara County, California",30,29,1
1000000US060855032044005,060855032044005,"Block 4005, Block Group 4, Census Tract 5032.04, Santa Clara County, California",17,17,0
1000000US060855032045000,060855032045000,"Block 5000, Block Group 5, Census Tract 5032.04, Santa Clara County, California",25,23,2
1000000US060855032045001,060855032045001,"Block 5001, Block Group 5, Census Tract 5032.04, Santa Clara County, California",51,50,1
1000000US060855032045002,060855032045002,"Block 5002, Block Group 5, Census Tract 5032.04, Santa Clara County, California",278,267,11
1000000US060855032045003,060855032045003,"Block 5003, Block Group 5, Census Tract 5032.04, Santa Clara County, California",20,19,1
1000000US060855032045004,060855032045004,"Block 5004, Block Group 5, Census Tract 5032.04, Santa Clara County, California",12,12,0
1000000US060855032045005,060855032045005,"Block 5005, Block Group 5, Census Tract 5032.04, Santa Clara County, California",23,23,0
1000000US060855032045006,060855032045006,"Block 5006, Block Group 5, Census Tract 5032.04, Santa Clara County, California",23,23,0
1000000US060855032045007,060855032045007,"Block 5007, Block Group 5, Census Tract 5032.04, Santa Clara County, California",12,12,0
1000000US060855032045008,060855032045008,"Block 5008, Block Group 5, Census Tract 5032.04, Santa Clara County, California",24,24,0
1000000US060855032045009,060855032045009,"Block 5009, Block Group 5, Census Tract 5032.04, Santa Clara County, California",19,19,0
1000000US060855032071000,060855032071000,"Block 1000, Block Group 1, Census Tract 5032.07, Santa Clara County, California",223,214,9
1000000US060855032071001,060855032071001,"Block 1001, Block Group 1, Census Tract 5032.07, Santa Clara County, California",22,22,0
1000000US060855032071002,060855032071002,"Block 1002, Block Group 1, Census Tract 5032.07, Santa Clara County, California",40,37,3
1000000US060855032071003,060855032071003,"Block 1003, Block Group 1, Census Tract 5032.07, Santa Clara County, California",23,22,1
1000000US060855032071004,060855032071004,"Block 1004, Block Group 1, Census Tract 5032.07, Santa Clara County, California",9,9,0
1000000US060855032071005,060855032071005,"Block 1005, Block Group 1, Census Tract 5032.07, Santa Clara County, California",34,33,1
1000000US060855032071006,060855032071006,"Block 1006, Block Group 1, Census Tract 5032.07, Santa Clara County, California",46,45,1
1000000US060855032071007,060855032071007,"Block 1007, Block Group 1, Census Tract 5032.07, Santa Clara County, California",51,49,2
1000000US060855032071008,060855032071008,"Block 1008, Block Group 1, Census Tract 5032.07, Santa Clara County, California",10,10,0
1000000US060855032071009,060855032071009,"Block 1009, Block Group 1, Census Tract 5032.07, Santa Clara County, California",34,33,1
1000000US060855032071010,060855032071010,"Block 1010, Block Group 1, Census Tract 5032.07, Santa Clara County, California",27,26,1
1000000US060855032071011,060855032071011,"Block 1011, Block Group 1, Census Tract 5032.07, Santa Clara County, California",25,25,0
1000000US060855032071012,060855032071012,"Block 1012, Block Group 1, Census Tract 5032.07, Santa Clara County, California",17,16,1
1000000US060855032071013,060855032071013,"Block 1013, Block Group 1, Census Tract 5032.07, Santa Clara County, California",44,42,2
1000000US060855032071014,060855032071014,"Block 1014, Block Group 1, Census Tract 5032.07, Santa Clara County, California",0,0,0
1000000US060855032071015,060855032071015,"Block 1015, Block Group 1, Census Tract 5032.07, Santa Clara County, California",0,0,0
1000000US060855032071016,060855032071016,"Block 1016, Block Group 1, Census Tract 5032.07, Santa Clara County, California",9,9,0
1000000US060855032071017,060855032071017,"Block 1017, Block Group 1, Census Tract 5032.07, Santa Clara County, California",9,9,0
1000000US060855032071018,060855032071018,"Block 1018, Block Group 1, Census Tract 5032.07, Santa Clara County, California",0,0,0
1000000US060855032072000,060855032072000,"Block 2000, Block Group 2, Census Tract 5032.07, Santa Clara County, California",15,14,1
1000000US060855032072001,060855032072001,"Block 2001, Block Group 2, Census Tract 5032.07, Santa Clara County, California",0,0,0
1000000US060855032072002,060855032072002,"Block 2002, Block Group 2, Census Tract 5032.07, Santa Clara County, California",33,32,1
1000000US060855032072003,060855032072003,"Block 2003, Block Group 2, Census Tract 5032.07, Santa Clara County, California",147,142,5
1000000US060855032072004,060855032072004,"Block 2004, Block Group 2, Census Tract 5032.07, Santa Clara County, California",0,0,0
1000000US060855032072005,060855032072005,"Block 2005, Block Group 2, Census Tract 5032.07, Santa Clara County, California",130,127,3
1000000US060855032072006,060855032072006,"Block 2006, Block Group 2, Census Tract 5032.07, Santa Clara County, California",22,22,0
1000000US060855032072007,060855032072007,"Block 2007, Block Group 2, Census Tract 5032.07, Santa Clara County, California",22,21,1
1000000US060855032072008,060855032072008,"Block 2008, Block Group 2, Census Tract 5032.07, Santa Clara County, California",13,13,0
1000000US060855032072009,060855032072009,"Block 2009, Block Group 2, Census Tract 5032.07, Santa Clara County, California",17,17,0
1000000US060855032081000,060855032081000,"Block 1000, Block Group 1, Census Tract 5032.08, Santa Clara County, California",55,52,3
1000000US060855032081001,060855032081001,"Block 1001, Block Group 1, Census Tract 5032.08, Santa Clara County, California",38,36,2
1000000US060855032081002,060855032081002,"Block 1002, Block Group 1, Census Tract 5032.08, Santa Clara County, California",39,39,0
1000000US060855032081003,060855032081003,"Block 1003, Block Group 1, Census Tract 5032.08, Santa Clara County, California",63,60,3
1000000US060855032081004,060855032081004,"Block 1004, Block Group 1, Census Tract 5032.08, Santa Clara County, California",21,21,0
1000000US060855032081005,060855032081005,"Block 1005, Block Group 1, Census Tract 5032.08, Santa Clara County, California",31,31,0
1000000US060855032081006,060855032081006,"Block 1006, Block Group 1, Census Tract 5032.08, Santa Clara County, California",32,31,1
1000000US060855032081007,060855032081007,"Block 1007, Block Group 1, Census Tract 5032.08, Santa Clara County, California",25,23,2
1000000US060855032081008,060855032081008,"Block 1008, Block Group 1, Census Tract 5032.08, Santa Clara County, California",60,55,5
1000000US060855032081009,060855032081009,"Block 1009, Block Group 1, Census Tract 5032.08, Santa Clara County, California",24,24,0
1000000US060855032081010,060855032081010,"Block 1010, Block Group 1, Census Tract 5032.08, Santa Clara County, California",17,17,0
1000000US060855032082000,060855032082000,"Block 2000, Block Group 2, Census Tract 5032.08, Santa Clara County, California",0,0,0
1000000US060855032082001,060855032082001,"Block 2001, Block Group 2, Census Tract 5032.08, Santa Clara County, California",0,0,0
1000000US060855032082002,060855032082002,"Block 2002, Block Group 2, Census Tract 5032.08, Santa Clara County, California",0,0,0
1000000US060855032082003,060855032082003,"Block 2003, Block Group 2, Census Tract 5032.08, Santa Clara County, California",35,34,1
1000000US060855032082004,060855032082004,"Block 2004, Block Group 2, Census Tract 5032.08, Santa Clara County, California",30,30,0
1000000US060855032082005,060855032082005,"Block 2005, Block Group 2, Census Tract 5032.08, Santa Clara County, California",32,31,1
1000000US060855032082006,060855032082006,"Block 2006, Block Group 2, Census Tract 5032.08, Santa Clara County, California",26,25,1
1000000US060855032082007,060855032082007,"Block 2007, Block Group 2, Census Tract 5032.08, Santa Clara County, California",74,73,1
1000000US060855032082008,060855032082008,"Block 2008, Block Group 2, Census Tract 5032.08, Santa Clara County, California",33,33,0
1000000US060855032082009,060855032082009,"Block 2009, Block Group 2, Census Tract 5032.08, Santa Clara County, California",47,46,1
1000000US060855032082010,060855032082010,"Block 2010, Block Group 2, Census Tract 5032.08, Santa Clara County, California",33,33,0
1000000US060855032082011,060855032082011,"Block 2011, Block Group 2, Census Tract 5032.08, Santa Clara County, California",33,33,0
1000000US060855032082012,060855032082012,"Block 2012, Block Group 2, Census Tract 5032.08, Santa Clara County, California",0,0,0
1000000US060855032082013,060855032082013,"Block 2013, Block Group 2, Census Tract 5032.08, Santa Clara County, California",16,16,0
1000000US060855032082014,060855032082014,"Block 2014, Block Group 2, Census Tract 5032.08, Santa Clara County, California",0,0,0
1000000US060855032082015,060855032082015,"Block 2015, Block Group 2, Census Tract 5032.08, Santa Clara County, California",0,0,0
1000000US060855032082016,060855032082016,"Block 2016, Block Group 2, Census Tract 5032.08, Santa Clara County, California",40,40,0
1000000US060855032082017,060855032082017,"Block 2017, Block Group 2, Census Tract 5032.08, Santa Clara County, California",28,26,2
1000000US060855032082018,060855032082018,"Block 2018, Block Group 2, Census Tract 5032.08, Santa Clara County, California",37,35,2
1000000US060855032101000,060855032101000,"Block 1000, Block Group 1, Census Tract 5032.10, Santa Clara County, California",116,116,0
1000000US060855032101001,060855032101001,"Block 1001, Block Group 1, Census Tract 5032.10, Santa Clara County, California",32,32,0
1000000US060855032101002,060855032101002,"Block 1002, Block Group 1, Census Tract 5032.10, Santa Clara County, California",25,25,0
1000000US060855032101003,060855032101003,"Block 1003, Block Group 1, Census Tract 5032.10, Santa Clara County, California",13,13,0
1000000US060855032101004,060855032101004,"Block 1004, Block Group 1, Census Tract 5032.10, Santa Clara County, California",0,0,0
1000000US060855032101005,060855032101005,"Block 1005, Block Group 1, Census Tract 5032.10, Santa Clara County, California",109,107,2
1000000US060855032101006,060855032101006,"Block 1006, Block Group 1, Census Tract 5032.10, Santa Clara County, California",23,23,0
1000000US060855032101007,060855032101007,"Block 1007, Block Group 1, Census Tract 5032.10, Santa Clara County, California",39,37,2
1000000US060855032101008,060855032101008,"Block 1008, Block Group 1, Census Tract 5032.10, Santa Clara County, California",45,42,3
1000000US060855032101009,060855032101009,"Block 1009, Block Group 1, Census Tract 5032.10, Santa Clara County, California",72,70,2
1000000US060855032101010,060855032101010,"Block 1010, Block Group 1, Census Tract 5032.10, Santa Clara County, California",67,64,3
1000000US060855032102000,060855032102000,"Block 2000, Block Group 2, Census Tract 5032.10, Santa Clara County, California",2,2,0
1000000US060855032102001,060855032102001,"Block 2001, Block Group 2, Census Tract 5032.10, Santa Clara County, California",0,0,0
1000000US060855032102002,060855032102002,"Block 2002, Block Group 2, Census Tract 5032.10, Santa Clara County, California",0,0,0
1000000US060855032102003,060855032102003,"Block 2003, Block Group 2, Census Tract 5032.10, Santa Clara County, California",17,15,2
1000000US060855032102004,060855032102004,"Block 2004, Block Group 2, Census Tract 5032.10, Santa Clara County, California",39,38,1
1000000US060855032102005,060855032102005,"Block 2005, Block Group 2, Census Tract 5032.10, Santa Clara County, California",51,49,2
1000000US060855032102006,060855032102006,"Block 2006, Block Group 2, Census Tract 5032.10, Santa Clara County, California",20,20,0
1000000US060855032102007,060855032102007,"Block 2007, Block Group 2, Census Tract 5032.10, Santa Clara County, California",23,23,0
1000000US060855032102008,060855032102008,"Block 2008, Block Group 2, Census Tract 5032.10, Santa Clara County, California",24,23,1
1000000US060855032102009,060855032102009,"Block 2009, Block Group 2, Census Tract 5032.10, Santa Clara County, California",91,88,3
1000000US060855032102010,060855032102010,"Block 2010, Block Group 2, Census Tract 5032.10, Santa Clara County, California",30,26,4
1000000US060855032102011,060855032102011,"Block 2011, Block Group 2, Census Tract 5032.10, Santa Clara County, California",27,25,2
1000000US060855032102012,060855032102012,"Block 2012, Block Group 2, Census Tract 5032.10, Santa Clara County, California",1,1,0
1000000US060855032102013,060855032102013,"Block 2013, Block Group 2, Census Tract 5032.10, Santa Clara County, California",91,87,4
1000000US060855032111000,060855032111000,"Block 1000, Block Group 1, Census Tract 5032.11, Santa Clara County, California",166,160,6
1000000US060855032111001,060855032111001,"Block 1001, Block Group 1, Census Tract 5032.11, Santa Clara County, California",17,17,0
1000000US060855032111002,060855032111002,"Block 1002, Block Group 1, Census Tract 5032.11, Santa Clara County, California",34,34,0
1000000US060855032111003,060855032111003,"Block 1003, Block Group 1, Census Tract 5032.11, Santa Clara County, California",68,67,1
1000000US060855032111004,060855032111004,"Block 1004, Block Group 1, Census Tract 5032.11, Santa Clara County, California",39,38,1
1000000US060855032111005,060855032111005,"Block 1005, Block Group 1, Census Tract 5032.11, Santa Clara County, California",65,62,3
1000000US060855032111006,060855032111006,"Block 1006, Block Group 1, Census Tract 5032.11, Santa Clara County, California",30,29,1
1000000US060855032111007,060855032111007,"Block 1007, Block Group 1, Census Tract 5032.11, Santa Clara County, California",45,45,0
1000000US060855032111008,060855032111008,"Block 1008, Block Group 1, Census Tract 5032.11, Santa Clara County, California",53,51,2
1000000US060855032111009,060855032111009,"Block 1009, Block Group 1, Census Tract 5032.11, Santa Clara County, California",41,41,0
1000000US060855032112000,060855032112000,"Block 2000, Block Group 2, Census Tract 5032.11, Santa Clara County, California",25,25,0
1000000US060855032112001,060855032112001,"Block 2001, Block Group 2, Census Tract 5032.11, Santa Clara County, California",36,35,1
1000000US060855032112002,060855032112002,"Block 2002, Block Group 2, Census Tract 5032.11, Santa Clara County, California",39,37,2
1000000US060855032112003,060855032112003,"Block 2003, Block Group 2, Census Tract 5032.11, Santa Clara County, California",64,63,1
1000000US060855032112004,060855032112004,"Block 2004, Block Group 2, Census Tract 5032.11, Santa Clara County, California",25,25,0
1000000US060855032112005,060855032112005,"Block 2005, Block Group 2, Census Tract 5032.11, Santa Clara County, California",65,63,2
1000000US060855032112006,060855032112006,"Block 2006, Block Group 2, Census Tract 5032.11, Santa Clara County, California",62,61,1
1000000US060855032112007,060855032112007,"Block 2007, Block Group 2, Census Tract 5032.11, Santa Clara County, California",13,12,1
1000000US060855032112008,060855032112008,"Block 2008, Block Group 2, Census Tract 5032.11, Santa Clara County, California",14,13,1
1000000US060855032112009,060855032112009,"Block 2009, Block Group 2, Census Tract 5032.11, Santa Clara County, California",60,60,0
1000000US060855032112010,060855032112010,"Block 2010, Block Group 2, Census Tract 5032.11, Santa Clara County, California",38,37,1
1000000US060855032112011,060855032112011,"Block 2011, Block Group 2, Census Tract 5032.11, Santa Clara County, California",44,44,0
1000000US060855032112012,060855032112012,"Block 2012, Block Group 2, Census Tract 5032.11, Santa Clara County, California",30,30,0
1000000US060855032112013,060855032112013,"Block 2013, Block Group 2, Census Tract 5032.11, Santa Clara County, California",52,51,1
1000000US060855032121000,060855032121000,"Block 1000, Block Group 1, Census Tract 5032.12, Santa Clara County, California",24,23,1
1000000US060855032121001,060855032121001,"Block 1001, Block Group 1, Census Tract 5032.12, Santa Clara County, California",25,25,0
1000000US060855032121002,060855032121002,"Block 1002, Block Group 1, Census Tract 5032.12, Santa Clara County, California",0,0,0
1000000US060855032121003,060855032121003,"Block 1003, Block Group 1, Census Tract 5032.12, Santa Clara County, California",13,13,0
1000000US060855032121004,060855032121004,"Block 1004, Block Group 1, Census Tract 5032.12, Santa Clara County, California",52,51,1
1000000US060855032121005,060855032121005,"Block 1005, Block Group 1, Census Tract 5032.12, Santa Clara County, California",54,53,1
1000000US060855032121006,060855032121006,"Block 1006, Block Group 1, Census Tract 5032.12, Santa Clara County, California",50,50,0
1000000US060855032122000,060855032122000,"Block 2000, Block Group 2, Census Tract 5032.12, Santa Clara County, California",61,60,1
1000000US060855032122001,060855032122001,"Block 2001, Block Group 2, Census Tract 5032.12, Santa Clara County, California",33,32,1
1000000US060855032122002,060855032122002,"Block 2002, Block Group 2, Census Tract 5032.12, Santa Clara County, California",65,64,1
1000000US060855032122003,060855032122003,"Block 2003, Block Group 2, Census Tract 5032.12, Santa Clara County, California",38,38,0
1000000US060855032122004,060855032122004,"Block 2004, Block Group 2, Census Tract 5032.12, Santa Clara County, California",44,44,0
1000000US060855032122005,060855032122005,"Block 2005, Block Group 2, Census Tract 5032.12, Santa Clara County, California",69,64,5
1000000US060855032122006,060855032122006,"Block 2006, Block Group 2, Census Tract 5032.12, Santa Clara County, California",30,29,1
1000000US060855032122007,060855032122007,"Block 2007, Block Group 2, Census Tract 5032.12, Santa Clara County, California",13,12,1
1000000US060855032122008,060855032122008,"Block 2008, Block Group 2, Census Tract 5032.12, Santa Clara County, California",21,21,0
1000000US060855032122009,060855032122009,"Block 2009, Block Group 2, Census Tract 5032.12, Santa Clara County, California",14,14,0
1000000US060855032122010,060855032122010,"Block 2010, Block Group 2, Census Tract 5032.12, Santa Clara County, California",32,32,0
1000000US060855032122011,060855032122011,"Block 2011, Block Group 2, Census Tract 5032.12, Santa Clara County, California",51,50,1
1000000US060855032122012,060855032122012,"Block 2012, Block Group 2, Census Tract 5032.12, Santa Clara County, California",18,18,0
1000000US060855032123000,060855032123000,"Block 3000, Block Group 3, Census Tract 5032.12, Santa Clara County, California",61,61,0
1000000US060855032123001,060855032123001,"Block 3001, Block Group 3, Census Tract 5032.12, Santa Clara County, California",17,16,1
1000000US060855032123002,060855032123002,"Block 3002, Block Group 3, Census Tract 5032.12, Santa Clara County, California",59,53,6
1000000US060855032123003,060855032123003,"Block 3003, Block Group 3, Census Tract 5032.12, Santa Clara County, California",20,20,0
1000000US060855032123004,060855032123004,"Block 3004, Block Group 3, Census Tract 5032.12, Santa Clara County, California",38,36,2
1000000US060855032123005,060855032123005,"Block 3005, Block Group 3, Census Tract 5032.12, Santa Clara County, California",48,47,1
1000000US060855032131000,060855032131000,"Block 1000, Block Group 1, Census Tract 5032.13, Santa Clara County, California",46,44,2
1000000US060855032131001,060855032131001,"Block 1001, Block Group 1, Census Tract 5032.13, Santa Clara County, California",44,41,3
1000000US060855032131002,060855032131002,"Block 1002, Block Group 1, Census Tract 5032.13, Santa Clara County, California",0,0,0
1000000US060855032131003,060855032131003,"Block 1003, Block Group 1, Census Tract 5032.13, Santa Clara County, California",57,57,0
1000000US060855032131004,060855032131004,"Block 1004, Block Group 1, Census Tract 5032.13, Santa Clara County, California",116,110,6
1000000US060855032131005,060855032131005,"Block 1005, Block Group 1, Census Tract 5032.13, Santa Clara County, California",12,12,0
1000000US060855032131006,060855032131006,"Block 1006, Block Group 1, Census Tract 5032.13, Santa Clara County, California",75,75,0
1000000US060855032131007,060855032131007,"Block 1007, Block Group 1, Census Tract 5032.13, Santa Clara County, California",15,15,0
1000000US060855032131008,060855032131008,"Block 1008, Block Group 1, Census Tract 5032.13, Santa Clara County, California",58,57,1
1000000US060855032132000,060855032132000,"Block 2000, Block Group 2, Census Tract 5032.13, Santa Clara County, California",497,472,25
1000000US060855032132001,060855032132001,"Block 2001, Block Group 2, Census Tract 5032.13, Santa Clara County, California",19,18,1
1000000US060855032132002,060855032132002,"Block 2002, Block Group 2, Census Tract 5032.13, Santa Clara County, California",0,0,0
1000000US060855032132003,060855032132003,"Block 2003, Block Group 2, Census Tract 5032.13, Santa Clara County, California",31,31,0
1000000US060855032132004,060855032132004,"Block 2004, Block Group 2, Census Tract 5032.13, Santa Clara County, California",32,30,2
1000000US060855032132005,060855032132005,"Block 2005, Block Group 2, Census Tract 5032.13, Santa Clara County, California",35,34,1
1000000US060855032132006,060855032132006,"Block 2006, Block Group 2, Census Tract 5032.13, Santa Clara County, California",27,26,1
1000000US060855032132007,060855032132007,"Block 2007, Block Group 2, Census Tract 5032.13, Santa Clara County, California",14,14,0
1000000US060855032132008,060855032132008,"Block 2008, Block Group 2, Census Tract 5032.13, Santa Clara County, California",30,30,0
1000000US060855032132009,060855032132009,"Block 2009, Block Group 2, Census Tract 5032.13, Santa Clara County, California",11,10,1
1000000US060855032132010,060855032132010,"Block 2010, Block Group 2, Census Tract 5032.13, Santa Clara County, California",42,42,0
1000000US060855032132011,060855032132011,"Block 2011, Block Group 2, Census Tract 5032.13, Santa Clara County, California",0,0,0
1000000US060855032132012,060855032132012,"Block 2012, Block Group 2, Census Tract 5032.13, Santa Clara County, California",39,39,0
1000000US060855032132013,060855032132013,"Block 2013, Block Group 2, Census Tract 5032.13, Santa Clara County, California",33,32,1
1000000US060855032141000,060855032141000,"Block 1000, Block Group 1, Census Tract 5032.14, Santa Clara County, California",664,650,14
1000000US060855032141001,060855032141001,"Block 1001, Block Group 1, Census Tract 5032.14, Santa Clara County, California",48,48,0
1000000US060855032141002,060855032141002,"Block 1002, Block Group 1, Census Tract 5032.14, Santa Clara County, California",20,20,0
1000000US060855032141003,060855032141003,"Block 1003, Block Group 1, Census Tract 5032.14, Santa Clara County, California",24,24,0
1000000US060855032141004,060855032141004,"Block 1004, Block Group 1, Census Tract 5032.14, Santa Clara County, California",1,1,0
1000000US060855032141005,060855032141005,"Block 1005, Block Group 1, Census Tract 5032.14, Santa Clara County, California",22,22,0
1000000US060855032141006,060855032141006,"Block 1006, Block Group 1, Census Tract 5032.14, Santa Clara County, California",23,23,0
1000000US060855032141007,060855032141007,"Block 1007, Block Group 1, Census Tract 5032.14, Santa Clara County, California",28,28,0
1000000US060855032141008,060855032141008,"Block 1008, Block Group 1, Census Tract 5032.14, Santa Clara County, California",32,32,0
1000000US060855032141009,060855032141009,"Block 1009, Block Group 1, Census Tract 5032.14, Santa Clara County, California",31,31,0
1000000US060855032141010,060855032141010,"Block 1010, Block Group 1, Census Tract 5032.14, Santa Clara County, California",24,24,0
1000000US060855032141011,060855032141011,"Block 1011, Block Group 1, Census Tract 5032.14, Santa Clara County, California",19,17,2
1000000US060855032141012,060855032141012,"Block 1012, Block Group 1, Census Tract 5032.14, Santa Clara County, California",42,40,2
1000000US060855032141013,060855032141013,"Block 1013, Block Group 1, Census Tract 5032.14, Santa Clara County, California",215,215,0
1000000US060855032142000,060855032142000,"Block 2000, Block Group 2, Census Tract 5032.14, Santa Clara County, California",725,714,11
1000000US060855032142001,060855032142001,"Block 2001, Block Group 2, Census Tract 5032.14, Santa Clara County, California",16,15,1
1000000US060855032142002,060855032142002,"Block 2002, Block Group 2, Census Tract 5032.14, Santa Clara County, California",24,22,2
1000000US060855032142003,060855032142003,"Block 2003, Block Group 2, Census Tract 5032.14, Santa Clara County, California",25,23,2
1000000US060855032142004,060855032142004,"Block 2004, Block Group 2, Census Tract 5032.14, Santa Clara County, California",16,16,0
1000000US060855032142005,060855032142005,"Block 2005, Block Group 2, Census Tract 5032.14, Santa Clara County, California",12,12,0
1000000US060855032142006,060855032142006,"Block 2006, Block Group 2, Census Tract 5032.14, Santa Clara County, California",27,27,0
1000000US060855032142007,060855032142007,"Block 2007, Block Group 2, Census Tract 5032.14, Santa Clara County, California",43,43,0
1000000US060855032142008,060855032142008,"Block 2008, Block Group 2, Census Tract 5032.14, Santa Clara County, California",25,25,0
1000000US060855032142009,060855032142009,"Block 2009, Block Group 2, Census Tract 5032.14, Santa Clara County, California",1,1,0
1000000US060855032142010,060855032142010,"Block 2010, Block Group 2, Census Tract 5032.14, Santa Clara County, California",8,7,1
1000000US060855032142011,060855032142011,"Block 2011, Block Group 2, Census Tract 5032.14, Santa Clara County, California",1,1,0
1000000US060855032142012,060855032142012,"Block 2012, Block Group 2, Census Tract 5032.14, Santa Clara County, California",11,10,1
1000000US060855032142013,060855032142013,"Block 2013, Block Group 2, Census Tract 5032.14, Santa Clara County, California",1,1,0
1000000US060855032171000,060855032171000,"Block 1000, Block Group 1, Census Tract 5032.17, Santa Clara County, California",164,158,6
1000000US060855032171001,060855032171001,"Block 1001, Block Group 1, Census Tract 5032.17, Santa Clara County, California",25,23,2
1000000US060855032171002,060855032171002,"Block 1002, Block Group 1, Census Tract 5032.17, Santa Clara County, California",3,3,0
1000000US060855032171003,060855032171003,"Block 1003, Block Group 1, Census Tract 5032.17, Santa Clara County, California",7,7,0
1000000US060855032171004,060855032171004,"Block 1004, Block Group 1, Census Tract 5032.17, Santa Clara County, California",2,2,0
1000000US060855032171005,060855032171005,"Block 1005, Block Group 1, Census Tract 5032.17, Santa Clara County, California",0,0,0
1000000US060855032171006,060855032171006,"Block 1006, Block Group 1, Census Tract 5032.17, Santa Clara County, California",2,2,0
1000000US060855032171007,060855032171007,"Block 1007, Block Group 1, Census Tract 5032.17, Santa Clara County, California",27,27,0
1000000US060855032171008,060855032171008,"Block 1008, Block Group 1, Census Tract 5032.17, Santa Clara County, California",28,24,4
1000000US060855032171009,060855032171009,"Block 1009, Block Group 1, Census Tract 5032.17, Santa Clara County, California",25,24,1
1000000US060855032171010,060855032171010,"Block 1010, Block Group 1, Census Tract 5032.17, Santa Clara County, California",8,7,1
1000000US060855032171011,060855032171011,"Block 1011, Block Group 1, Census Tract 5032.17, Santa Clara County, California",25,25,0
1000000US060855032171012,060855032171012,"Block 1012, Block Group 1, Census Tract 5032.17, Santa Clara County, California",2,1,1
1000000US060855032171013,060855032171013,"Block 1013, Block Group 1, Census Tract 5032.17, Santa Clara County, California",70,64,6
1000000US060855032171014,060855032171014,"Block 1014, Block Group 1, Census Tract 5032.17, Santa Clara County, California",11,9,2
1000000US060855032171015,060855032171015,"Block 1015, Block Group 1, Census Tract 5032.17, Santa Clara County, California",8,8,0
1000000US060855032172000,060855032172000,"Block 2000, Block Group 2, Census Tract 5032.17, Santa Clara County, California",41,38,3
1000000US060855032172001,060855032172001,"Block 2001, Block Group 2, Census Tract 5032.17, Santa Clara County, California",53,51,2
1000000US060855032172002,060855032172002,"Block 2002, Block Group 2, Census Tract 5032.17, Santa Clara County, California",116,110,6
1000000US060855032172003,060855032172003,"Block 2003, Block Group 2, Census Tract 5032.17, Santa Clara County, California",21,20,1
1000000US060855032172004,060855032172004,"Block 2004, Block Group 2, Census Tract 5032.17, Santa Clara County, California",77,75,2
1000000US060855032172005,060855032172005,"Block 2005, Block Group 2, Census Tract 5032.17, Santa Clara County, California",17,15,2
1000000US060855032172006,060855032172006,"Block 2006, Block Group 2, Census Tract 5032.17, Santa Clara County, California",6,6,0
1000000US060855032172007,060855032172007,"Block 2007, Block Group 2, Census Tract 5032.17, Santa Clara County, California",32,31,1
1000000US060855032172008,060855032172008,"Block 2008, Block Group 2, Census Tract 5032.17, Santa Clara County, California",14,14,0
1000000US060855032173000,060855032173000,"Block 3000, Block Group 3, Census Tract 5032.17, Santa Clara County, California",45,45,0
1000000US060855032173001,060855032173001,"Block 3001, Block Group 3, Census Tract 5032.17, Santa Clara County, California",47,44,3
1000000US060855032173002,060855032173002,"Block 3002, Block Group 3, Census Tract 5032.17, Santa Clara County, California",38,38,0
1000000US060855032173003,060855032173003,"Block 3003, Block Group 3, Census Tract 5032.17, Santa Clara County, California",28,27,1
1000000US060855032173004,060855032173004,"Block 3004, Block Group 3, Census Tract 5032.17, Santa Clara County, California",25,25,0
1000000US060855032173005,060855032173005,"Block 3005, Block Group 3, Census Tract 5032.17, Santa Clara County, California",25,25,0
1000000US060855032173006,060855032173006,"Block 3006, Block Group 3, Census Tract 5032.17, Santa Clara County, California",19,18,1
1000000US060855032173007,060855032173007,"Block 3007, Block Group 3, Census Tract 5032.17, Santa Clara County, California",48,48,0
1000000US060855032181000,060855032181000,"Block 1000, Block Group 1, Census Tract 5032.18, Santa Clara County, California",58,56,2
1000000US060855032181001,060855032181001,"Block 1001, Block Group 1, Census Tract 5032.18, Santa Clara County, California",28,28,0
1000000US060855032181002,060855032181002,"Block 1002, Block Group 1, Census Tract 5032.18, Santa Clara County, California",27,25,2
1000000US060855032181003,060855032181003,"Block 1003, Block Group 1, Census Tract 5032.18, Santa Clara County, California",286,276,10
1000000US060855032181004,060855032181004,"Block 1004, Block Group 1, Census Tract 5032.18, Santa Clara County, California",288,281,7
1000000US060855032181005,060855032181005,"Block 1005, Block Group 1, Census Tract 5032.18, Santa Clara County, California",53,53,0
1000000US060855032181006,060855032181006,"Block 1006, Block Group 1, Census Tract 5032.18, Santa Clara County, California",29,28,1
1000000US060855032181007,060855032181007,"Block 1007, Block Group 1, Census Tract 5032.18, Santa Clara County, California",29,28,1
1000000US060855032181008,060855032181008,"Block 1008, Block Group 1, Census Tract 5032.18, Santa Clara County, California",31,31,0
1000000US060855032181009,060855032181009,"Block 1009, Block Group 1, Census Tract 5032.18, Santa Clara County, California",11,10,1
1000000US060855032181010,060855032181010,"Block 1010, Block Group 1, Census Tract 5032.18, Santa Clara County, California",6,6,0
1000000US060855032182000,060855032182000,"Block 2000, Block Group 2, Census Tract 5032.18, Santa Clara County, California",64,60,4
1000000US060855032182001,060855032182001,"Block 2001, Block Group 2, Census Tract 5032.18, Santa Clara County, California",58,58,0
1000000US060855032182002,060855032182002,"Block 2002, Block Group 2, Census Tract 5032.18, Santa Clara County, California",41,40,1
1000000US060855032182003,060855032182003,"Block 2003, Block Group 2, Census Tract 5032.18, Santa Clara County, California",43,42,1
1000000US060855032182004,060855032182004,"Block 2004, Block Group 2, Census Tract 5032.18, Santa Clara County, California",44,42,2
1000000US060855032182005,060855032182005,"Block 2005, Block Group 2, Census Tract 5032.18, Santa Clara County, California",41,38,3
1000000US060855033041000,060855033041000,"Block 1000, Block Group 1, Census Tract 5033.04, Santa Clara County, California",0,0,0
1000000US060855033041001,060855033041001,"Block 1001, Block Group 1, Census Tract 5033.04, Santa Clara County, California",1,1,0
1000000US060855033041002,060855033041002,"Block 1002, Block Group 1, Census Tract 5033.04, Santa Clara County, California",0,0,0
1000000US060855033041003,060855033041003,"Block 1003, Block Group 1, Census Tract 5033.04, Santa Clara County, California",16,14,2
1000000US060855033041004,060855033041004,"Block 1004, Block Group 1, Census Tract 5033.04, Santa Clara County, California",286,278,8
1000000US060855033041005,060855033041005,"Block 1005, Block Group 1, Census Tract 5033.04, Santa Clara County, California",131,124,7
1000000US060855033041006,060855033041006,"Block 1006, Block Group 1, Census Tract 5033.04, Santa Clara County, California",126,123,3
1000000US060855033041007,060855033041007,"Block 1007, Block Group 1, Census Tract 5033.04, Santa Clara County, California",42,40,2
1000000US060855033041008,060855033041008,"Block 1008, Block Group 1, Census Tract 5033.04, Santa Clara County, California",21,21,0
1000000US060855033041009,060855033041009,"Block 1009, Block Group 1, Census Tract 5033.04, Santa Clara County, California",5,5,0
1000000US060855033042000,060855033042000,"Block 2000, Block Group 2, Census Tract 5033.04, Santa Clara County, California",38,38,0
1000000US060855033042001,060855033042001,"Block 2001, Block Group 2, Census Tract 5033.04, Santa Clara County, California",38,38,0
1000000US060855033042002,060855033042002,"Block 2002, Block Group 2, Census Tract 5033.04, Santa Clara County, California",38,37,1
1000000US060855033042003,060855033042003,"Block 2003, Block Group 2, Census Tract 5033.04, Santa Clara County, California",37,37,0
1000000US060855033042004,060855033042004,"Block 2004, Block Group 2, Census Tract 5033.04, Santa Clara County, California",36,34,2
1000000US060855033042005,060855033042005,"Block 2005, Block Group 2, Census Tract 5033.04, Santa Clara County, California",229,218,11
1000000US060855033042006,060855033042006,"Block 2006, Block Group 2, Census Tract 5033.04, Santa Clara County, California",27,27,0
1000000US060855033043000,060855033043000,"Block 3000, Block Group 3, Census Tract 5033.04, Santa Clara County, California",43,42,1
1000000US060855033043001,060855033043001,"Block 3001, Block Group 3, Census Tract 5033.04, Santa Clara County, California",10,10,0
1000000US060855033043002,060855033043002,"Block 3002, Block Group 3, Census Tract 5033.04, Santa Clara County, California",124,122,2
1000000US060855033043003,060855033043003,"Block 3003, Block Group 3, Census Tract 5033.04, Santa Clara County, California",30,30,0
1000000US060855033043004,060855033043004,"Block 3004, Block Group 3, Census Tract 5033.04, Santa Clara County, California",72,70,2
1000000US060855033043005,060855033043005,"Block 3005, Block Group 3, Census Tract 5033.04, Santa Clara County, California",49,48,1
1000000US060855033043006,060855033043006,"Block 3006, Block Group 3, Census Tract 5033.04, Santa Clara County, California",20,18,2
1000000US060855033043007,060855033043007,"Block 3007, Block Group 3, Census Tract 5033.04, Santa Clara County, California",31,28,3
1000000US060855033044000,060855033044000,"Block 4000, Block Group 4, Census Tract 5033.04, Santa Clara County, California",0,0,0
1000000US060855033044001,060855033044001,"Block 4001, Block Group 4, Census Tract 5033.04, Santa Clara County, California",0,0,0
1000000US060855033044002,060855033044002,"Block 4002, Block Group 4, Census Tract 5033.04, Santa Clara County, California",192,183,9
1000000US060855033044003,060855033044003,"Block 4003, Block Group 4, Census Tract 5033.04, Santa Clara County, California",26,25,1
1000000US060855033044004,060855033044004,"Block 4004, Block Group 4, Census Tract 5033.04, Santa Clara County, California",19,17,2
1000000US060855033044005,060855033044005,"Block 4005, Block Group 4, Census Tract 5033.04, Santa Clara County, California",1,1,0
1000000US060855033044006,060855033044006,"Block 4006, Block Group 4, Census Tract 5033.04, Santa Clara County, California",29,29,0
1000000US060855033044007,060855033044007,"Block 4007, Block Group 4, Census Tract 5033.04, Santa Clara County, California",32,30,2
1000000US060855033044008,060855033044008,"Block 4008, Block Group 4, Census Tract 5033.04, Santa Clara County, California",16,15,1
1000000US060855033044009,060855033044009,"Block 4009, Block Group 4, Census Tract 5033.04, Santa Clara County, California",19,19,0
1000000US060855033044010,060855033044010,"Block 4010, Block Group 4, Census Tract 5033.04, Santa Clara County, California",29,27,2
1000000US060855033044011,060855033044011,"Block 4011, Block Group 4, Census Tract 5033.04, Santa Clara County, California",9,9,0
1000000US060855033044012,060855033044012,"Block 4012, Block Group 4, Census Tract 5033.04, Santa Clara County, California",0,0,0
1000000US060855033044013,060855033044013,"Block 4013, Block Group 4, Census Tract 5033.04, Santa Clara County, California",0,0,0
1000000US060855033051000,060855033051000,"Block 1000, Block Group 1, Census Tract 5033.05, Santa Clara County, California",6,6,0
1000000US060855033051001,060855033051001,"Block 1001, Block Group 1, Census Tract 5033.05, Santa Clara County, California",38,37,1
1000000US060855033051002,060855033051002,"Block 1002, Block Group 1, Census Tract 5033.05, Santa Clara County, California",0,0,0
1000000US060855033051003,060855033051003,"Block 1003, Block Group 1, Census Tract 5033.05, Santa Clara County, California",57,54,3
1000000US060855033051004,060855033051004,"Block 1004, Block Group 1, Census Tract 5033.05, Santa Clara County, California",30,28,2
1000000US060855033051005,060855033051005,"Block 1005, Block Group 1, Census Tract 5033.05, Santa Clara County, California",38,35,3
1000000US060855033051006,060855033051006,"Block 1006, Block Group 1, Census Tract 5033.05, Santa Clara County, California",42,40,2
1000000US060855033051007,060855033051007,"Block 1007, Block Group 1, Census Tract 5033.05, Santa Clara County, California",39,39,0
1000000US060855033051008,060855033051008,"Block 1008, Block Group 1, Census Tract 5033.05, Santa Clara County, California",0,0,0
1000000US060855033051009,060855033051009,"Block 1009, Block Group 1, Census Tract 5033.05, Santa Clara County, California",0,0,0
1000000US060855033051010,060855033051010,"Block 1010, Block Group 1, Census Tract 5033.05, Santa Clara County, California",38,38,0
1000000US060855033051011,060855033051011,"Block 1011, Block Group 1, Census Tract 5033.05, Santa Clara County, California",22,21,1
1000000US060855033051012,060855033051012,"Block 1012, Block Group 1, Census Tract 5033.05, Santa Clara County, California",12,12,0
1000000US060855033052000,060855033052000,"Block 2000, Block Group 2, Census Tract 5033.05, Santa Clara County, California",127,120,7
1000000US060855033052001,060855033052001,"Block 2001, Block Group 2, Census Tract 5033.05, Santa Clara County, California",47,46,1
1000000US060855033052002,060855033052002,"Block 2002, Block Group 2, Census Tract 5033.05, Santa Clara County, California",26,26,0
1000000US060855033052003,060855033052003,"Block 2003, Block Group 2, Census Tract 5033.05, Santa Clara County, California",34,33,1
1000000US060855033052004,060855033052004,"Block 2004, Block Group 2, Census Tract 5033.05, Santa Clara County, California",39,36,3
1000000US060855033052005,060855033052005,"Block 2005, Block Group 2, Census Tract 5033.05, Santa Clara County, California",42,41,1
1000000US060855033052006,060855033052006,"Block 2006, Block Group 2, Census Tract 5033.05, Santa Clara County, California",42,42,0
1000000US060855033052007,060855033052007,"Block 2007, Block Group 2, Census Tract 5033.05, Santa Clara County, California",40,40,0
1000000US060855033052008,060855033052008,"Block 2008, Block Group 2, Census Tract 5033.05, Santa Clara County, California",43,41,2
1000000US060855033052009,060855033052009,"Block 2009, Block Group 2, Census Tract 5033.05, Santa Clara County, California",39,36,3
1000000US060855033052010,060855033052010,"Block 2010, Block Group 2, Census Tract 5033.05, Santa Clara County, California",39,37,2
1000000US060855033053000,060855033053000,"Block 3000, Block Group 3, Census Tract 5033.05, Santa Clara County, California",0,0,0
1000000US060855033053001,060855033053001,"Block 3001, Block Group 3, Census Tract 5033.05, Santa Clara County, California",0,0,0
1000000US060855033053002,060855033053002,"Block 3002, Block Group 3, Census Tract 5033.05, Santa Clara County, California",0,0,0
1000000US060855033053003,060855033053003,"Block 3003, Block Group 3, Census Tract 5033.05, Santa Clara County, California",0,0,0
1000000US060855033053004,060855033053004,"Block 3004, Block Group 3, Census Tract 5033.05, Santa Clara County, California",0,0,0
1000000US060855033053005,060855033053005,"Block 3005, Block Group 3, Census Tract 5033.05, Santa Clara County, California",0,0,0
1000000US060855033053006,060855033053006,"Block 3006, Block Group 3, Census Tract 5033.05, Santa Clara County, California",0,0,0
1000000US060855033053007,060855033053007,"Block 3007, Block Group 3, Census Tract 5033.05, Santa Clara County, California",0,0,0
1000000US060855033053008,060855033053008,"Block 3008, Block Group 3, Census Tract 5033.05, Santa Clara County, California",40,39,1
1000000US060855033053009,060855033053009,"Block 3009, Block Group 3, Census Tract 5033.05, Santa Clara County, California",35,35,0
1000000US060855033053010,060855033053010,"Block 3010, Block Group 3, Census Tract 5033.05, Santa Clara County, California",15,15,0
1000000US060855033053011,060855033053011,"Block 3011, Block Group 3, Census Tract 5033.05, Santa Clara County, California",52,52,0
1000000US060855033053012,060855033053012,"Block 3012, Block Group 3, Census Tract 5033.05, Santa Clara County, California",26,26,0
1000000US060855033053013,060855033053013,"Block 3013, Block Group 3, Census Tract 5033.05, Santa Clara County, California",385,379,6
1000000US060855033053014,060855033053014,"Block 3014, Block Group 3, Census Tract 5033.05, Santa Clara County, California",56,51,5
1000000US060855033053015,060855033053015,"Block 3015, Block Group 3, Census Tract 5033.05, Santa Clara County, California",0,0,0
1000000US060855033061000,060855033061000,"Block 1000, Block Group 1, Census Tract 5033.06, Santa Clara County, California",0,0,0
1000000US060855033061001,060855033061001,"Block 1001, Block Group 1, Census Tract 5033.06, Santa Clara County, California",0,0,0
1000000US060855033061002,060855033061002,"Block 1002, Block Group 1, Census Tract 5033.06, Santa Clara County, California",0,0,0
1000000US060855033061003,060855033061003,"Block 1003, Block Group 1, Census Tract 5033.06, Santa Clara County, California",0,0,0
1000000US060855033061004,060855033061004,"Block 1004, Block Group 1, Census Tract 5033.06, Santa Clara County, California",0,0,0
1000000US060855033061005,060855033061005,"Block 1005, Block Group 1, Census Tract 5033.06, Santa Clara County, California",0,0,0
1000000US060855033061006,060855033061006,"Block 1006, Block Group 1, Census Tract 5033.06, Santa Clara County, California",77,76,1
1000000US060855033061007,060855033061007,"Block 1007, Block Group 1, Census Tract 5033.06, Santa Clara County, California",9,9,0
1000000US060855033061008,060855033061008,"Block 1008, Block Group 1, Census Tract 5033.06, Santa Clara County, California",10,10,0
1000000US060855033061009,060855033061009,"Block 1009, Block Group 1, Census Tract 5033.06, Santa Clara County, California",15,15,0
1000000US060855033061010,060855033061010,"Block 1010, Block Group 1, Census Tract 5033.06, Santa Clara County, California",11,11,0
1000000US060855033061011,060855033061011,"Block 1011, Block Group 1, Census Tract 5033.06, Santa Clara County, California",11,10,1
1000000US060855033061012,060855033061012,"Block 1012, Block Group 1, Census Tract 5033.06, Santa Clara County, California",22,21,1
1000000US060855033061013,060855033061013,"Block 1013, Block Group 1, Census Tract 5033.06, Santa Clara County, California",0,0,0
1000000US060855033061014,060855033061014,"Block 1014, Block Group 1, Census Tract 5033.06, Santa Clara County, California",9,9,0
1000000US060855033061015,060855033061015,"Block 1015, Block Group 1, Census Tract 5033.06, Santa Clara County, California",22,21,1
1000000US060855033061016,060855033061016,"Block 1016, Block Group 1, Census Tract 5033.06, Santa Clara County, California",104,101,3
1000000US060855033061017,060855033061017,"Block 1017, Block Group 1, Census Tract 5033.06, Santa Clara County, California",0,0,0
1000000US060855033061018,060855033061018,"Block 1018, Block Group 1, Census Tract 5033.06, Santa Clara County, California",0,0,0
1000000US060855033061019,060855033061019,"Block 1019, Block Group 1, Census Tract 5033.06, Santa Clara County, California",8,8,0
1000000US060855033062000,060855033062000,"Block 2000, Block Group 2, Census Tract 5033.06, Santa Clara County, California",51,49,2
1000000US060855033062001,060855033062001,"Block 2001, Block Group 2, Census Tract 5033.06, Santa Clara County, California",30,28,2
1000000US060855033062002,060855033062002,"Block 2002, Block Group 2, Census Tract 5033.06, Santa Clara County, California",27,25,2
1000000US060855033062003,060855033062003,"Block 2003, Block Group 2, Census Tract 5033.06, Santa Clara County, California",56,54,2
1000000US060855033062004,060855033062004,"Block 2004, Block Group 2, Census Tract 5033.06, Santa Clara County, California",34,34,0
1000000US060855033062005,060855033062005,"Block 2005, Block Group 2, Census Tract 5033.06, Santa Clara County, California",39,37,2
1000000US060855033062006,060855033062006,"Block 2006, Block Group 2, Census Tract 5033.06, Santa Clara County, California",54,52,2
1000000US060855033062007,060855033062007,"Block 2007, Block Group 2, Census Tract 5033.06, Santa Clara County, California",45,42,3
1000000US060855033062008,060855033062008,"Block 2008, Block Group 2, Census Tract 5033.06, Santa Clara County, California",35,34,1
1000000US060855033063000,060855033063000,"Block 3000, Block Group 3, Census Tract 5033.06, Santa Clara County, California",22,22,0
1000000US060855033063001,060855033063001,"Block 3001, Block Group 3, Census Tract 5033.06, Santa Clara County, California",20,19,1
1000000US060855033063002,060855033063002,"Block 3002, Block Group 3, Census Tract 5033.06, Santa Clara County, California",41,41,0
1000000US060855033063003,060855033063003,"Block 3003, Block Group 3, Census Tract 5033.06, Santa Clara County, California",43,43,0
1000000US060855033063004,060855033063004,"Block 3004, Block Group 3, Census Tract 5033.06, Santa Clara County, California",8,7,1
1000000US060855033063005,060855033063005,"Block 3005, Block Group 3, Census Tract 5033.06, Santa Clara County, California",2,2,0
1000000US060855033063006,060855033063006,"Block 3006, Block Group 3, Census Tract 5033.06, Santa Clara County, California",52,51,1
1000000US060855033063007,060855033063007,"Block 3007, Block Group 3, Census Tract 5033.06, Santa Clara County, California",33,33,0
1000000US060855033063008,060855033063008,"Block 3008, Block Group 3, Census Tract 5033.06, Santa Clara County, California",0,0,0
1000000US060855033121000,060855033121000,"Block 1000, Block Group 1, Census Tract 5033.12, Santa Clara County, California",0,0,0
1000000US060855033121001,060855033121001,"Block 1001, Block Group 1, Census Tract 5033.12, Santa Clara County, California",242,226,16
1000000US060855033122000,060855033122000,"Block 2000, Block Group 2, Census Tract 5033.12, Santa Clara County, California",78,69,9
1000000US060855033122001,060855033122001,"Block 2001, Block Group 2, Census Tract 5033.12, Santa Clara County, California",4,4,0
1000000US060855033122002,060855033122002,"Block 2002, Block Group 2, Census Tract 5033.12, Santa Clara County, California",2,1,1
1000000US060855033122003,060855033122003,"Block 2003, Block Group 2, Census Tract 5033.12, Santa Clara County, California",1,1,0
1000000US060855033122004,060855033122004,"Block 2004, Block Group 2, Census Tract 5033.12, Santa Clara County, California",3,3,0
1000000US060855033122005,060855033122005,"Block 2005, Block Group 2, Census Tract 5033.12, Santa Clara County, California",6,5,1
1000000US060855033122006,060855033122006,"Block 2006, Block Group 2, Census Tract 5033.12, Santa Clara County, California",2,1,1
1000000US060855033122007,060855033122007,"Block 2007, Block Group 2, Census Tract 5033.12, Santa Clara County, California",9,9,0
1000000US060855033122008,060855033122008,"Block 2008, Block Group 2, Census Tract 5033.12, Santa Clara County, California",127,118,9
1000000US060855033122009,060855033122009,"Block 2009, Block Group 2, Census Tract 5033.12, Santa Clara County, California",1,0,1
1000000US060855033122010,060855033122010,"Block 2010, Block Group 2, Census Tract 5033.12, Santa Clara County, California",17,15,2
1000000US060855033122011,060855033122011,"Block 2011, Block Group 2, Census Tract 5033.12, Santa Clara County, California",8,8,0
1000000US060855033122012,060855033122012,"Block 2012, Block Group 2, Census Tract 5033.12, Santa Clara County, California",12,12,0
1000000US060855033122013,060855033122013,"Block 2013, Block Group 2, Census Tract 5033.12, Santa Clara County, California",0,0,0
1000000US060855033122014,060855033122014,"Block 2014, Block Group 2, Census Tract 5033.12, Santa Clara County, California",39,36,3
1000000US060855033122015,060855033122015,"Block 2015, Block Group 2, Census Tract 5033.12, Santa Clara County, California",13,13,0
1000000US060855033122016,060855033122016,"Block 2016, Block Group 2, Census Tract 5033.12, Santa Clara County, California",0,0,0
1000000US060855033122017,060855033122017,"Block 2017, Block Group 2, Census Tract 5033.12, Santa Clara County, California",1,1,0
1000000US060855033122018,060855033122018,"Block 2018, Block Group 2, Census Tract 5033.12, Santa Clara County, California",0,0,0
1000000US060855033122019,060855033122019,"Block 2019, Block Group 2, Census Tract 5033.12, Santa Clara County, California",32,32,0
1000000US060855033122020,060855033122020,"Block 2020, Block Group 2, Census Tract 5033.12, Santa Clara County, California",0,0,0
1000000US060855033122021,060855033122021,"Block 2021, Block Group 2, Census Tract 5033.12, Santa Clara County, California",1,1,0
1000000US060855033122022,060855033122022,"Block 2022, Block Group 2, Census Tract 5033.12, Santa Clara County, California",13,13,0
1000000US060855033122023,060855033122023,"Block 2023, Block Group 2, Census Tract 5033.12, Santa Clara County, California",14,14,0
1000000US060855033122024,060855033122024,"Block 2024, Block Group 2, Census Tract 5033.12, Santa Clara County, California",49,48,1
1000000US060855033122025,060855033122025,"Block 2025, Block Group 2, Census Tract 5033.12, Santa Clara County, California",37,36,1
1000000US060855033122026,060855033122026,"Block 2026, Block Group 2, Census Tract 5033.12, Santa Clara County, California",24,24,0
1000000US060855033122027,060855033122027,"Block 2027, Block Group 2, Census Tract 5033.12, Santa Clara County, California",22,21,1
1000000US060855033122028,060855033122028,"Block 2028, Block Group 2, Census Tract 5033.12, Santa Clara County, California",2,2,0
1000000US060855033122029,060855033122029,"Block 2029, Block Group 2, Census Tract 5033.12, Santa Clara County, California",45,37,8
1000000US060855033122030,060855033122030,"Block 2030, Block Group 2, Census Tract 5033.12, Santa Clara County, California",2,2,0
1000000US060855033122031,060855033122031,"Block 2031, Block Group 2, Census Tract 5033.12, Santa Clara County, California",1,1,0
1000000US060855033122032,060855033122032,"Block 2032, Block Group 2, Census Tract 5033.12, Santa Clara County, California",5,5,0
1000000US060855033122033,060855033122033,"Block 2033, Block Group 2, Census Tract 5033.12, Santa Clara County, California",2,2,0
1000000US060855033122034,060855033122034,"Block 2034, Block Group 2, Census Tract 5033.12, Santa Clara County, California",5,5,0
1000000US060855033122035,060855033122035,"Block 2035, Block Group 2, Census Tract 5033.12, Santa Clara County, California",2,2,0
1000000US060855033122036,060855033122036,"Block 2036, Block Group 2, Census Tract 5033.12, Santa Clara County, California",2,2,0
1000000US060855033122037,060855033122037,"Block 2037, Block Group 2, Census Tract 5033.12, Santa Clara County, California",0,0,0
1000000US060855033122038,060855033122038,"Block 2038, Block Group 2, Census Tract 5033.12, Santa Clara County, California",0,0,0
1000000US060855033122039,060855033122039,"Block 2039, Block Group 2, Census Tract 5033.12, Santa Clara County, California",0,0,0
1000000US060855033122040,060855033122040,"Block 2040, Block Group 2, Census Tract 5033.12, Santa Clara County, California",1,1,0
1000000US060855033122041,060855033122041,"Block 2041, Block Group 2, Census Tract 5033.12, Santa Clara County, California",2,2,0
1000000US060855033123000,060855033123000,"Block 3000, Block Group 3, Census Tract 5033.12, Santa Clara County, California",35,34,1
1000000US060855033123001,060855033123001,"Block 3001, Block Group 3, Census Tract 5033.12, Santa Clara County, California",33,31,2
1000000US060855033123002,060855033123002,"Block 3002, Block Group 3, Census Tract 5033.12, Santa Clara County, California",39,35,4
1000000US060855033123003,060855033123003,"Block 3003, Block Group 3, Census Tract 5033.12, Santa Clara County, California",48,46,2
1000000US060855033123004,060855033123004,"Block 3004, Block Group 3, Census Tract 5033.12, Santa Clara County, California",23,21,2
1000000US060855033123005,060855033123005,"Block 3005, Block Group 3, Census Tract 5033.12, Santa Clara County, California",46,44,2
1000000US060855033123006,060855033123006,"Block 3006, Block Group 3, Census Tract 5033.12, Santa Clara County, California",24,24,0
1000000US060855033131000,060855033131000,"Block 1000, Block Group 1, Census Tract 5033.13, Santa Clara County, California",41,40,1
1000000US060855033131001,060855033131001,"Block 1001, Block Group 1, Census Tract 5033.13, Santa Clara County, California",17,17,0
1000000US060855033131002,060855033131002,"Block 1002, Block Group 1, Census Tract 5033.13, Santa Clara County, California",63,60,3
1000000US060855033131003,060855033131003,"Block 1003, Block Group 1, Census Tract 5033.13, Santa Clara County, California",71,69,2
1000000US060855033131004,060855033131004,"Block 1004, Block Group 1, Census Tract 5033.13, Santa Clara County, California",17,17,0
1000000US060855033131005,060855033131005,"Block 1005, Block Group 1, Census Tract 5033.13, Santa Clara County, California",45,44,1
1000000US060855033131006,060855033131006,"Block 1006, Block Group 1, Census Tract 5033.13, Santa Clara County, California",39,39,0
1000000US060855033131007,060855033131007,"Block 1007, Block Group 1, Census Tract 5033.13, Santa Clara County, California",16,16,0
1000000US060855033131008,060855033131008,"Block 1008, Block Group 1, Census Tract 5033.13, Santa Clara County, California",23,23,0
1000000US060855033131009,060855033131009,"Block 1009, Block Group 1, Census Tract 5033.13, Santa Clara County, California",22,22,0
1000000US060855033131010,060855033131010,"Block 1010, Block Group 1, Census Tract 5033.13, Santa Clara County, California",23,23,0
1000000US060855033131011,060855033131011,"Block 1011, Block Group 1, Census Tract 5033.13, Santa Clara County, California",19,19,0
1000000US060855033131012,060855033131012,"Block 1012, Block Group 1, Census Tract 5033.13, Santa Clara County, California",27,26,1
1000000US060855033132000,060855033132000,"Block 2000, Block Group 2, Census Tract 5033.13, Santa Clara County, California",0,0,0
1000000US060855033132001,060855033132001,"Block 2001, Block Group 2, Census Tract 5033.13, Santa Clara County, California",27,27,0
1000000US060855033132002,060855033132002,"Block 2002, Block Group 2, Census Tract 5033.13, Santa Clara County, California",15,15,0
1000000US060855033132003,060855033132003,"Block 2003, Block Group 2, Census Tract 5033.13, Santa Clara County, California",5,5,0
1000000US060855033132004,060855033132004,"Block 2004, Block Group 2, Census Tract 5033.13, Santa Clara County, California",30,29,1
1000000US060855033132005,060855033132005,"Block 2005, Block Group 2, Census Tract 5033.13, Santa Clara County, California",39,39,0
1000000US060855033132006,060855033132006,"Block 2006, Block Group 2, Census Tract 5033.13, Santa Clara County, California",37,36,1
1000000US060855033132007,060855033132007,"Block 2007, Block Group 2, Census Tract 5033.13, Santa Clara County, California",21,20,1
1000000US060855033132008,060855033132008,"Block 2008, Block Group 2, Census Tract 5033.13, Santa Clara County, California",32,32,0
1000000US060855033132009,060855033132009,"Block 2009, Block Group 2, Census Tract 5033.13, Santa Clara County, California",27,27,0
1000000US060855033132010,060855033132010,"Block 2010, Block Group 2, Census Tract 5033.13, Santa Clara County, California",23,22,1
1000000US060855033132011,060855033132011,"Block 2011, Block Group 2, Census Tract 5033.13, Santa Clara County, California",30,30,0
1000000US060855033132012,060855033132012,"Block 2012, Block Group 2, Census Tract 5033.13, Santa Clara County, California",38,37,1
1000000US060855033132013,060855033132013,"Block 2013, Block Group 2, Census Tract 5033.13, Santa Clara County, California",38,38,0
1000000US060855033132014,060855033132014,"Block 2014, Block Group 2, Census Tract 5033.13, Santa Clara County, California",28,28,0
1000000US060855033132015,060855033132015,"Block 2015, Block Group 2, Census Tract 5033.13, Santa Clara County, California",19,19,0
1000000US060855033132016,060855033132016,"Block 2016, Block Group 2, Census Tract 5033.13, Santa Clara County, California",30,30,0
1000000US060855033132017,060855033132017,"Block 2017, Block Group 2, Census Tract 5033.13, Santa Clara County, California",29,29,0
1000000US060855033133000,060855033133000,"Block 3000, Block Group 3, Census Tract 5033.13, Santa Clara County, California",23,22,1
1000000US060855033133001,060855033133001,"Block 3001, Block Group 3, Census Tract 5033.13, Santa Clara County, California",47,47,0
1000000US060855033133002,060855033133002,"Block 3002, Block Group 3, Census Tract 5033.13, Santa Clara County, California",43,41,2
1000000US060855033133003,060855033133003,"Block 3003, Block Group 3, Census Tract 5033.13, Santa Clara County, California",47,45,2
1000000US060855033133004,060855033133004,"Block 3004, Block Group 3, Census Tract 5033.13, Santa Clara County, California",0,0,0
1000000US060855033133005,060855033133005,"Block 3005, Block Group 3, Census Tract 5033.13, Santa Clara County, California",35,34,1
1000000US060855033133006,060855033133006,"Block 3006, Block Group 3, Census Tract 5033.13, Santa Clara County, California",13,13,0
1000000US060855033133007,060855033133007,"Block 3007, Block Group 3, Census Tract 5033.13, Santa Clara County, California",84,83,1
1000000US060855033133008,060855033133008,"Block 3008, Block Group 3, Census Tract 5033.13, Santa Clara County, California",62,59,3
1000000US060855033133009,060855033133009,"Block 3009, Block Group 3, Census Tract 5033.13, Santa Clara County, California",1,1,0
1000000US060855033133010,060855033133010,"Block 3010, Block Group 3, Census Tract 5033.13, Santa Clara County, California",33,33,0
1000000US060855033151000,060855033151000,"Block 1000, Block Group 1, Census Tract 5033.15, Santa Clara County, California",28,28,0
1000000US060855033151001,060855033151001,"Block 1001, Block Group 1, Census Tract 5033.15, Santa Clara County, California",69,68,1
1000000US060855033151002,060855033151002,"Block 1002, Block Group 1, Census Tract 5033.15, Santa Clara County, California",58,56,2
1000000US060855033151003,060855033151003,"Block 1003, Block Group 1, Census Tract 5033.15, Santa Clara County, California",36,34,2
1000000US060855033151004,060855033151004,"Block 1004, Block Group 1, Census Tract 5033.15, Santa Clara County, California",53,51,2
1000000US060855033151005,060855033151005,"Block 1005, Block Group 1, Census Tract 5033.15, Santa Clara County, California",46,44,2
1000000US060855033151006,060855033151006,"Block 1006, Block Group 1, Census Tract 5033.15, Santa Clara County, California",45,43,2
1000000US060855033151007,060855033151007,"Block 1007, Block Group 1, Census Tract 5033.15, Santa Clara County, California",60,58,2
1000000US060855033151008,060855033151008,"Block 1008, Block Group 1, Census Tract 5033.15, Santa Clara County, California",40,39,1
1000000US060855033151009,060855033151009,"Block 1009, Block Group 1, Census Tract 5033.15, Santa Clara County, California",61,59,2
1000000US060855033152000,060855033152000,"Block 2000, Block Group 2, Census Tract 5033.15, Santa Clara County, California",61,59,2
1000000US060855033152001,060855033152001,"Block 2001, Block Group 2, Census Tract 5033.15, Santa Clara County, California",25,24,1
1000000US060855033152002,060855033152002,"Block 2002, Block Group 2, Census Tract 5033.15, Santa Clara County, California",40,39,1
1000000US060855033152003,060855033152003,"Block 2003, Block Group 2, Census Tract 5033.15, Santa Clara County, California",42,41,1
1000000US060855033152004,060855033152004,"Block 2004, Block Group 2, Census Tract 5033.15, Santa Clara County, California",32,32,0
1000000US060855033152005,060855033152005,"Block 2005, Block Group 2, Census Tract 5033.15, Santa Clara County, California",23,22,1
1000000US060855033152006,060855033152006,"Block 2006, Block Group 2, Census Tract 5033.15, Santa Clara County, California",21,21,0
1000000US060855033152007,060855033152007,"Block 2007, Block Group 2, Census Tract 5033.15, Santa Clara County, California",58,58,0
1000000US060855033152008,060855033152008,"Block 2008, Block Group 2, Census Tract 5033.15, Santa Clara County, California",41,37,4
1000000US060855033152009,060855033152009,"Block 2009, Block Group 2, Census Tract 5033.15, Santa Clara County, California",0,0,0
1000000US060855033153000,060855033153000,"Block 3000, Block Group 3, Census Tract 5033.15, Santa Clara County, California",42,41,1
1000000US060855033153001,060855033153001,"Block 3001, Block Group 3, Census Tract 5033.15, Santa Clara County, California",6,5,1
1000000US060855033153002,060855033153002,"Block 3002, Block Group 3, Census Tract 5033.15, Santa Clara County, California",4,3,1
1000000US060855033153003,060855033153003,"Block 3003, Block Group 3, Census Tract 5033.15, Santa Clara County, California",9,9,0
1000000US060855033153004,060855033153004,"Block 3004, Block Group 3, Census Tract 5033.15, Santa Clara County, California",18,18,0
1000000US060855033153005,060855033153005,"Block 3005, Block Group 3, Census Tract 5033.15, Santa Clara County, California",28,27,1
1000000US060855033153006,060855033153006,"Block 3006, Block Group 3, Census Tract 5033.15, Santa Clara County, California",14,13,1
1000000US060855033153007,060855033153007,"Block 3007, Block Group 3, Census Tract 5033.15, Santa Clara County, California",85,83,2
1000000US060855033153008,060855033153008,"Block 3008, Block Group 3, Census Tract 5033.15, Santa Clara County, California",28,26,2
1000000US060855033153009,060855033153009,"Block 3009, Block Group 3, Census Tract 5033.15, Santa Clara County, California",40,39,1
1000000US060855033153010,060855033153010,"Block 3010, Block Group 3, Census Tract 5033.15, Santa Clara County, California",42,41,1
1000000US060855033153011,060855033153011,"Block 3011, Block Group 3, Census Tract 5033.15, Santa Clara County, California",37,36,1
1000000US060855033153012,060855033153012,"Block 3012, Block Group 3, Census Tract 5033.15, Santa Clara County, California",44,43,1
1000000US060855033153013,060855033153013,"Block 3013, Block Group 3, Census Tract 5033.15, Santa Clara County, California",39,37,2
1000000US060855033153014,060855033153014,"Block 3014, Block Group 3, Census Tract 5033.15, Santa Clara County, California",72,71,1
1000000US060855033153015,060855033153015,"Block 3015, Block Group 3, Census Tract 5033.15, Santa Clara County, California",291,276,15
1000000US060855033153016,060855033153016,"Block 3016, Block Group 3, Census Tract 5033.15, Santa Clara County, California",144,141,3
1000000US060855033153017,060855033153017,"Block 3017, Block Group 3, Census Tract 5033.15, Santa Clara County, California",48,47,1
1000000US060855033153018,060855033153018,"Block 3018, Block Group 3, Census Tract 5033.15, Santa Clara County, California",28,28,0
1000000US060855033153019,060855033153019,"Block 3019, Block Group 3, Census Tract 5033.15, Santa Clara County, California",28,27,1
1000000US060855033153020,060855033153020,"Block 3020, Block Group 3, Census Tract 5033.15, Santa Clara County, California",14,14,0
1000000US060855033153021,060855033153021,"Block 3021, Block Group 3, Census Tract 5033.15, Santa Clara County, California",33,31,2
1000000US060855033153022,060855033153022,"Block 3022, Block Group 3, Census Tract 5033.15, Santa Clara County, California",36,36,0
1000000US060855033153023,060855033153023,"Block 3023, Block Group 3, Census Tract 5033.15, Santa Clara County, California",14,14,0
1000000US060855033211000,060855033211000,"Block 1000, Block Group 1, Census Tract 5033.21, Santa Clara County, California",0,0,0
1000000US060855033211001,060855033211001,"Block 1001, Block Group 1, Census Tract 5033.21, Santa Clara County, California",0,0,0
1000000US060855033211002,060855033211002,"Block 1002, Block Group 1, Census Tract 5033.21, Santa Clara County, California",0,0,0
1000000US060855033211003,060855033211003,"Block 1003, Block Group 1, Census Tract 5033.21, Santa Clara County, California",0,0,0
1000000US060855033211004,060855033211004,"Block 1004, Block Group 1, Census Tract 5033.21, Santa Clara County, California",0,0,0
1000000US060855033211005,060855033211005,"Block 1005, Block Group 1, Census Tract 5033.21, Santa Clara County, California",0,0,0
1000000US060855033211006,060855033211006,"Block 1006, Block Group 1, Census Tract 5033.21, Santa Clara County, California",0,0,0
1000000US060855033211007,060855033211007,"Block 1007, Block Group 1, Census Tract 5033.21, Santa Clara County, California",0,0,0
1000000US060855033211008,060855033211008,"Block 1008, Block Group 1, Census Tract 5033.21, Santa Clara County, California",0,0,0
1000000US060855033211009,060855033211009,"Block 1009, Block Group 1, Census Tract 5033.21, Santa Clara County, California",49,49,0
1000000US060855033211010,060855033211010,"Block 1010, Block Group 1, Census Tract 5033.21, Santa Clara County, California",105,100,5
1000000US060855033211011,060855033211011,"Block 1011, Block Group 1, Census Tract 5033.21, Santa Clara County, California",53,53,0
1000000US060855033211012,060855033211012,"Block 1012, Block Group 1, Census Tract 5033.21, Santa Clara County, California",87,85,2
1000000US060855033211013,060855033211013,"Block 1013, Block Group 1, Census Tract 5033.21, Santa Clara County, California",72,70,2
1000000US060855033211014,060855033211014,"Block 1014, Block Group 1, Census Tract 5033.21, Santa Clara County, California",78,78,0
1000000US060855033211015,060855033211015,"Block 1015, Block Group 1, Census Tract 5033.21, Santa Clara County, California",0,0,0
1000000US060855033211016,060855033211016,"Block 1016, Block Group 1, Census Tract 5033.21, Santa Clara County, California",0,0,0
1000000US060855033211017,060855033211017,"Block 1017, Block Group 1, Census Tract 5033.21, Santa Clara County, California",0,0,0
1000000US060855033211018,060855033211018,"Block 1018, Block Group 1, Census Tract 5033.21, Santa Clara County, California",0,0,0
1000000US060855033212000,060855033212000,"Block 2000, Block Group 2, Census Tract 5033.21, Santa Clara County, California",15,15,0
1000000US060855033212001,060855033212001,"Block 2001, Block Group 2, Census Tract 5033.21, Santa Clara County, California",19,16,3
1000000US060855033212002,060855033212002,"Block 2002, Block Group 2, Census Tract 5033.21, Santa Clara County, California",19,18,1
1000000US060855033212003,060855033212003,"Block 2003, Block Group 2, Census Tract 5033.21, Santa Clara County, California",80,79,1
1000000US060855033212004,060855033212004,"Block 2004, Block Group 2, Census Tract 5033.21, Santa Clara County, California",45,44,1
1000000US060855033212005,060855033212005,"Block 2005, Block Group 2, Census Tract 5033.21, Santa Clara County, California",71,71,0
1000000US060855033212006,060855033212006,"Block 2006, Block Group 2, Census Tract 5033.21, Santa Clara County, California",10,10,0
1000000US060855033212007,060855033212007,"Block 2007, Block Group 2, Census Tract 5033.21, Santa Clara County, California",11,11,0
1000000US060855033212008,060855033212008,"Block 2008, Block Group 2, Census Tract 5033.21, Santa Clara County, California",25,25,0
1000000US060855033212009,060855033212009,"Block 2009, Block Group 2, Census Tract 5033.21, Santa Clara County, California",11,11,0
1000000US060855033212010,060855033212010,"Block 2010, Block Group 2, Census Tract 5033.21, Santa Clara County, California",0,0,0
1000000US060855033212011,060855033212011,"Block 2011, Block Group 2, Census Tract 5033.21, Santa Clara County, California",0,0,0
1000000US060855033212012,060855033212012,"Block 2012, Block Group 2, Census Tract 5033.21, Santa Clara County, California",0,0,0
1000000US060855033212013,060855033212013,"Block 2013, Block Group 2, Census Tract 5033.21, Santa Clara County, California",102,101,1
1000000US060855033212014,060855033212014,"Block 2014, Block Group 2, Census Tract 5033.21, Santa Clara County, California",36,33,3
1000000US060855033212015,060855033212015,"Block 2015, Block Group 2, Census Tract 5033.21, Santa Clara County, California",22,21,1
1000000US060855033212016,060855033212016,"Block 2016, Block Group 2, Census Tract 5033.21, Santa Clara County, California",22,22,0
1000000US060855033212017,060855033212017,"Block 2017, Block Group 2, Census Tract 5033.21, Santa Clara County, California",73,71,2
1000000US060855033212018,060855033212018,"Block 2018, Block Group 2, Census Tract 5033.21, Santa Clara County, California",68,67,1
1000000US060855033212019,060855033212019,"Block 2019, Block Group 2, Census Tract 5033.21, Santa Clara County, California",15,15,0
1000000US060855033221000,060855033221000,"Block 1000, Block Group 1, Census Tract 5033.22, Santa Clara County, California",27,26,1
1000000US060855033221001,060855033221001,"Block 1001, Block Group 1, Census Tract 5033.22, Santa Clara County, California",29,27,2
1000000US060855033221002,060855033221002,"Block 1002, Block Group 1, Census Tract 5033.22, Santa Clara County, California",30,28,2
1000000US060855033221003,060855033221003,"Block 1003, Block Group 1, Census Tract 5033.22, Santa Clara County, California",46,46,0
1000000US060855033221004,060855033221004,"Block 1004, Block Group 1, Census Tract 5033.22, Santa Clara County, California",40,40,0
1000000US060855033221005,060855033221005,"Block 1005, Block Group 1, Census Tract 5033.22, Santa Clara County, California",41,41,0
1000000US060855033221006,060855033221006,"Block 1006, Block Group 1, Census Tract 5033.22, Santa Clara County, California",31,30,1
1000000US060855033221007,060855033221007,"Block 1007, Block Group 1, Census Tract 5033.22, Santa Clara County, California",54,51,3
1000000US060855033222000,060855033222000,"Block 2000, Block Group 2, Census Tract 5033.22, Santa Clara County, California",0,0,0
1000000US060855033222001,060855033222001,"Block 2001, Block Group 2, Census Tract 5033.22, Santa Clara County, California",4,4,0
1000000US060855033222002,060855033222002,"Block 2002, Block Group 2, Census Tract 5033.22, Santa Clara County, California",59,58,1
1000000US060855033222003,060855033222003,"Block 2003, Block Group 2, Census Tract 5033.22, Santa Clara County, California",50,48,2
1000000US060855033222004,060855033222004,"Block 2004, Block Group 2, Census Tract 5033.22, Santa Clara County, California",28,28,0
1000000US060855033222005,060855033222005,"Block 2005, Block Group 2, Census Tract 5033.22, Santa Clara County, California",15,15,0
1000000US060855033222006,060855033222006,"Block 2006, Block Group 2, Census Tract 5033.22, Santa Clara County, California",7,7,0
1000000US060855033222007,060855033222007,"Block 2007, Block Group 2, Census Tract 5033.22, Santa Clara County, California",14,14,0
1000000US060855033222008,060855033222008,"Block 2008, Block Group 2, Census Tract 5033.22, Santa Clara County, California",35,35,0
1000000US060855033222009,060855033222009,"Block 2009, Block Group 2, Census Tract 5033.22, Santa Clara County, California",35,33,2
1000000US060855033222010,060855033222010,"Block 2010, Block Group 2, Census Tract 5033.22, Santa Clara County, California",28,27,1
1000000US060855033222011,060855033222011,"Block 2011, Block Group 2, Census Tract 5033.22, Santa Clara County, California",30,30,0
1000000US060855033222012,060855033222012,"Block 2012, Block Group 2, Census Tract 5033.22, Santa Clara County, California",27,26,1
1000000US060855033222013,060855033222013,"Block 2013, Block Group 2, Census Tract 5033.22, Santa Clara County, California",23,23,0
1000000US060855033222014,060855033222014,"Block 2014, Block Group 2, Census Tract 5033.22, Santa Clara County, California",29,28,1
1000000US060855033222015,060855033222015,"Block 2015, Block Group 2, Census Tract 5033.22, Santa Clara County, California",27,26,1
1000000US060855033222016,060855033222016,"Block 2016, Block Group 2, Census Tract 5033.22, Santa Clara County, California",0,0,0
1000000US060855033223000,060855033223000,"Block 3000, Block Group 3, Census Tract 5033.22, Santa Clara County, California",21,20,1
1000000US060855033223001,060855033223001,"Block 3001, Block Group 3, Census Tract 5033.22, Santa Clara County, California",53,53,0
1000000US060855033223002,060855033223002,"Block 3002, Block Group 3, Census Tract 5033.22, Santa Clara County, California",35,34,1
1000000US060855033223003,060855033223003,"Block 3003, Block Group 3, Census Tract 5033.22, Santa Clara County, California",25,24,1
1000000US060855033223004,060855033223004,"Block 3004, Block Group 3, Census Tract 5033.22, Santa Clara County, California",42,41,1
1000000US060855033223005,060855033223005,"Block 3005, Block Group 3, Census Tract 5033.22, Santa Clara County, California",28,28,0
1000000US060855033223006,060855033223006,"Block 3006, Block Group 3, Census Tract 5033.22, Santa Clara County, California",56,52,4
1000000US060855033223007,060855033223007,"Block 3007, Block Group 3, Census Tract 5033.22, Santa Clara County, California",18,18,0
1000000US060855033223008,060855033223008,"Block 3008, Block Group 3, Census Tract 5033.22, Santa Clara County, California",35,33,2
1000000US060855033231000,060855033231000,"Block 1000, Block Group 1, Census Tract 5033.23, Santa Clara County, California",28,25,3
1000000US060855033231001,060855033231001,"Block 1001, Block Group 1, Census Tract 5033.23, Santa Clara County, California",54,50,4
1000000US060855033231002,060855033231002,"Block 1002, Block Group 1, Census Tract 5033.23, Santa Clara County, California",31,31,0
1000000US060855033231003,060855033231003,"Block 1003, Block Group 1, Census Tract 5033.23, Santa Clara County, California",39,39,0
1000000US060855033231004,060855033231004,"Block 1004, Block Group 1, Census Tract 5033.23, Santa Clara County, California",49,47,2
1000000US060855033231005,060855033231005,"Block 1005, Block Group 1, Census Tract 5033.23, Santa Clara County, California",77,77,0
1000000US060855033231006,060855033231006,"Block 1006, Block Group 1, Census Tract 5033.23, Santa Clara County, California",47,45,2
1000000US060855033231007,060855033231007,"Block 1007, Block Group 1, Census Tract 5033.23, Santa Clara County, California",27,27,0
1000000US060855033231008,060855033231008,"Block 1008, Block Group 1, Census Tract 5033.23, Santa Clara County, California",36,36,0
1000000US060855033231009,060855033231009,"Block 1009, Block Group 1, Census Tract 5033.23, Santa Clara County, California",15,14,1
1000000US060855033231010,060855033231010,"Block 1010, Block Group 1, Census Tract 5033.23, Santa Clara County, California",53,53,0
1000000US060855033231011,060855033231011,"Block 1011, Block Group 1, Census Tract 5033.23, Santa Clara County, California",17,17,0
1000000US060855033231012,060855033231012,"Block 1012, Block Group 1, Census Tract 5033.23, Santa Clara County, California",17,17,0
1000000US060855033231013,060855033231013,"Block 1013, Block Group 1, Census Tract 5033.23, Santa Clara County, California",12,12,0
1000000US060855033231014,060855033231014,"Block 1014, Block Group 1, Census Tract 5033.23, Santa Clara County, California",12,12,0
1000000US060855033231015,060855033231015,"Block 1015, Block Group 1, Census Tract 5033.23, Santa Clara County, California",9,9,0
1000000US060855033231016,060855033231016,"Block 1016, Block Group 1, Census Tract 5033.23, Santa Clara County, California",15,15,0
1000000US060855033232000,060855033232000,"Block 2000, Block Group 2, Census Tract 5033.23, Santa Clara County, California",38,38,0
1000000US060855033232001,060855033232001,"Block 2001, Block Group 2, Census Tract 5033.23, Santa Clara County, California",26,24,2
1000000US060855033232002,060855033232002,"Block 2002, Block Group 2, Census Tract 5033.23, Santa Clara County, California",51,49,2
1000000US060855033232003,060855033232003,"Block 2003, Block Group 2, Census Tract 5033.23, Santa Clara County, California",54,54,0
1000000US060855033232004,060855033232004,"Block 2004, Block Group 2, Census Tract 5033.23, Santa Clara County, California",25,22,3
1000000US060855033232005,060855033232005,"Block 2005, Block Group 2, Census Tract 5033.23, Santa Clara County, California",24,24,0
1000000US060855033232006,060855033232006,"Block 2006, Block Group 2, Census Tract 5033.23, Santa Clara County, California",38,38,0
1000000US060855033232007,060855033232007,"Block 2007, Block Group 2, Census Tract 5033.23, Santa Clara County, California",36,36,0
1000000US060855033232008,060855033232008,"Block 2008, Block Group 2, Census Tract 5033.23, Santa Clara County, California",37,37,0
1000000US060855033232009,060855033232009,"Block 2009, Block Group 2, Census Tract 5033.23, Santa Clara County, California",57,55,2
1000000US060855033232010,060855033232010,"Block 2010, Block Group 2, Census Tract 5033.23, Santa Clara County, California",42,41,1
1000000US060855033232011,060855033232011,"Block 2011, Block Group 2, Census Tract 5033.23, Santa Clara County, California",25,25,0
1000000US060855033232012,060855033232012,"Block 2012, Block Group 2, Census Tract 5033.23, Santa Clara County, California",73,69,4
1000000US060855033232013,060855033232013,"Block 2013, Block Group 2, Census Tract 5033.23, Santa Clara County, California",45,45,0
1000000US060855033232014,060855033232014,"Block 2014, Block Group 2, Census Tract 5033.23, Santa Clara County, California",32,30,2
1000000US060855033232015,060855033232015,"Block 2015, Block Group 2, Census Tract 5033.23, Santa Clara County, California",18,16,2
1000000US060855033232016,060855033232016,"Block 2016, Block Group 2, Census Tract 5033.23, Santa Clara County, California",18,17,1
1000000US060855033232017,060855033232017,"Block 2017, Block Group 2, Census Tract 5033.23, Santa Clara County, California",19,19,0
1000000US060855033241000,060855033241000,"Block 1000, Block Group 1, Census Tract 5033.24, Santa Clara County, California",56,55,1
1000000US060855033241001,060855033241001,"Block 1001, Block Group 1, Census Tract 5033.24, Santa Clara County, California",88,85,3
1000000US060855033241002,060855033241002,"Block 1002, Block Group 1, Census Tract 5033.24, Santa Clara County, California",30,30,0
1000000US060855033241003,060855033241003,"Block 1003, Block Group 1, Census Tract 5033.24, Santa Clara County, California",21,21,0
1000000US060855033241004,060855033241004,"Block 1004, Block Group 1, Census Tract 5033.24, Santa Clara County, California",44,44,0
1000000US060855033241005,060855033241005,"Block 1005, Block Group 1, Census Tract 5033.24, Santa Clara County, California",57,55,2
1000000US060855033241006,060855033241006,"Block 1006, Block Group 1, Census Tract 5033.24, Santa Clara County, California",40,40,0
1000000US060855033241007,060855033241007,"Block 1007, Block Group 1, Census Tract 5033.24, Santa Clara County, California",43,42,1
1000000US060855033241008,060855033241008,"Block 1008, Block Group 1, Census Tract 5033.24, Santa Clara County, California",31,30,1
1000000US060855033241009,060855033241009,"Block 1009, Block Group 1, Census Tract 5033.24, Santa Clara County, California",69,67,2
1000000US060855033241010,060855033241010,"Block 1010, Block Group 1, Census Tract 5033.24, Santa Clara County, California",33,33,0
1000000US060855033242000,060855033242000,"Block 2000, Block Group 2, Census Tract 5033.24, Santa Clara County, California",49,48,1
1000000US060855033242001,060855033242001,"Block 2001, Block Group 2, Census Tract 5033.24, Santa Clara County, California",28,28,0
1000000US060855033242002,060855033242002,"Block 2002, Block Group 2, Census Tract 5033.24, Santa Clara County, California",45,45,0
1000000US060855033242003,060855033242003,"Block 2003, Block Group 2, Census Tract 5033.24, Santa Clara County, California",29,29,0
1000000US060855033242004,060855033242004,"Block 2004, Block Group 2, Census Tract 5033.24, Santa Clara County, California",29,28,1
1000000US060855033242005,060855033242005,"Block 2005, Block Group 2, Census Tract 5033.24, Santa Clara County, California",71,70,1
1000000US060855033242006,060855033242006,"Block 2006, Block Group 2, Census Tract 5033.24, Santa Clara County, California",16,16,0
1000000US060855033242007,060855033242007,"Block 2007, Block Group 2, Census Tract 5033.24, Santa Clara County, California",31,30,1
1000000US060855033242008,060855033242008,"Block 2008, Block Group 2, Census Tract 5033.24, Santa Clara County, California",71,70,1
1000000US060855033242009,060855033242009,"Block 2009, Block Group 2, Census Tract 5033.24, Santa Clara County, California",16,16,0
1000000US060855033251000,060855033251000,"Block 1000, Block Group 1, Census Tract 5033.25, Santa Clara County, California",58,55,3
1000000US060855033251001,060855033251001,"Block 1001, Block Group 1, Census Tract 5033.25, Santa Clara County, California",62,60,2
1000000US060855033251002,060855033251002,"Block 1002, Block Group 1, Census Tract 5033.25, Santa Clara County, California",43,42,1
1000000US060855033251003,060855033251003,"Block 1003, Block Group 1, Census Tract 5033.25, Santa Clara County, California",25,24,1
1000000US060855033251004,060855033251004,"Block 1004, Block Group 1, Census Tract 5033.25, Santa Clara County, California",67,65,2
1000000US060855033251005,060855033251005,"Block 1005, Block Group 1, Census Tract 5033.25, Santa Clara County, California",44,40,4
1000000US060855033251006,060855033251006,"Block 1006, Block Group 1, Census Tract 5033.25, Santa Clara County, California",40,38,2
1000000US060855033251007,060855033251007,"Block 1007, Block Group 1, Census Tract 5033.25, Santa Clara County, California",42,41,1
1000000US060855033251008,060855033251008,"Block 1008, Block Group 1, Census Tract 5033.25, Santa Clara County, California",39,37,2
1000000US060855033251009,060855033251009,"Block 1009, Block Group 1, Census Tract 5033.25, Santa Clara County, California",65,65,0
1000000US060855033251010,060855033251010,"Block 1010, Block Group 1, Census Tract 5033.25, Santa Clara County, California",40,40,0
1000000US060855033251011,060855033251011,"Block 1011, Block Group 1, Census Tract 5033.25, Santa Clara County, California",26,26,0
1000000US060855033251012,060855033251012,"Block 1012, Block Group 1, Census Tract 5033.25, Santa Clara County, California",21,21,0
1000000US060855033252000,060855033252000,"Block 2000, Block Group 2, Census Tract 5033.25, Santa Clara County, California",39,39,0
1000000US060855033252001,060855033252001,"Block 2001, Block Group 2, Census Tract 5033.25, Santa Clara County, California",114,110,4
1000000US060855033252002,060855033252002,"Block 2002, Block Group 2, Census Tract 5033.25, Santa Clara County, California",43,43,0
1000000US060855033252003,060855033252003,"Block 2003, Block Group 2, Census Tract 5033.25, Santa Clara County, California",59,56,3
1000000US060855033252004,060855033252004,"Block 2004, Block Group 2, Census Tract 5033.25, Santa Clara County, California",42,41,1
1000000US060855033252005,060855033252005,"Block 2005, Block Group 2, Census Tract 5033.25, Santa Clara County, California",59,57,2
1000000US060855033252006,060855033252006,"Block 2006, Block Group 2, Census Tract 5033.25, Santa Clara County, California",53,52,1
1000000US060855033252007,060855033252007,"Block 2007, Block Group 2, Census Tract 5033.25, Santa Clara County, California",130,127,3
1000000US060855033252008,060855033252008,"Block 2008, Block Group 2, Census Tract 5033.25, Santa Clara County, California",32,31,1
1000000US060855033261000,060855033261000,"Block 1000, Block Group 1, Census Tract 5033.26, Santa Clara County, California",2,2,0
1000000US060855033261001,060855033261001,"Block 1001, Block Group 1, Census Tract 5033.26, Santa Clara County, California",2,1,1
1000000US060855033261002,060855033261002,"Block 1002, Block Group 1, Census Tract 5033.26, Santa Clara County, California",0,0,0
1000000US060855033261003,060855033261003,"Block 1003, Block Group 1, Census Tract 5033.26, Santa Clara County, California",0,0,0
1000000US060855033261004,060855033261004,"Block 1004, Block Group 1, Census Tract 5033.26, Santa Clara County, California",30,29,1
1000000US060855033261005,060855033261005,"Block 1005, Block Group 1, Census Tract 5033.26, Santa Clara County, California",2,2,0
1000000US060855033261006,060855033261006,"Block 1006, Block Group 1, Census Tract 5033.26, Santa Clara County, California",9,9,0
1000000US060855033261007,060855033261007,"Block 1007, Block Group 1, Census Tract 5033.26, Santa Clara County, California",0,0,0
1000000US060855033261008,060855033261008,"Block 1008, Block Group 1, Census Tract 5033.26, Santa Clara County, California",48,46,2
1000000US060855033261009,060855033261009,"Block 1009, Block Group 1, Census Tract 5033.26, Santa Clara County, California",0,0,0
1000000US060855033261010,060855033261010,"Block 1010, Block Group 1, Census Tract 5033.26, Santa Clara County, California",20,20,0
1000000US060855033261011,060855033261011,"Block 1011, Block Group 1, Census Tract 5033.26, Santa Clara County, California",0,0,0
1000000US060855033261012,060855033261012,"Block 1012, Block Group 1, Census Tract 5033.26, Santa Clara County, California",0,0,0
1000000US060855033261013,060855033261013,"Block 1013, Block Group 1, Census Tract 5033.26, Santa Clara County, California",40,40,0
1000000US060855033261014,060855033261014,"Block 1014, Block Group 1, Census Tract 5033.26, Santa Clara County, California",108,107,1
1000000US060855033261015,060855033261015,"Block 1015, Block Group 1, Census Tract 5033.26, Santa Clara County, California",97,95,2
1000000US060855033261016,060855033261016,"Block 1016, Block Group 1, Census Tract 5033.26, Santa Clara County, California",15,15,0
1000000US060855033261017,060855033261017,"Block 1017, Block Group 1, Census Tract 5033.26, Santa Clara County, California",18,18,0
1000000US060855033261018,060855033261018,"Block 1018, Block Group 1, Census Tract 5033.26, Santa Clara County, California",0,0,0
1000000US060855033261019,060855033261019,"Block 1019, Block Group 1, Census Tract 5033.26, Santa Clara County, California",66,65,1
1000000US060855033261020,060855033261020,"Block 1020, Block Group 1, Census Tract 5033.26, Santa Clara County, California",32,31,1
1000000US060855033261021,060855033261021,"Block 1021, Block Group 1, Census Tract 5033.26, Santa Clara County, California",11,11,0
1000000US060855033261022,060855033261022,"Block 1022, Block Group 1, Census Tract 5033.26, Santa Clara County, California",7,7,0
1000000US060855033261023,060855033261023,"Block 1023, Block Group 1, Census Tract 5033.26, Santa Clara County, California",40,40,0
1000000US060855033261024,060855033261024,"Block 1024, Block Group 1, Census Tract 5033.26, Santa Clara County, California",18,18,0
1000000US060855033261025,060855033261025,"Block 1025, Block Group 1, Census Tract 5033.26, Santa Clara County, California",12,11,1
1000000US060855033261026,060855033261026,"Block 1026, Block Group 1, Census Tract 5033.26, Santa Clara County, California",143,128,15
1000000US060855033261027,060855033261027,"Block 1027, Block Group 1, Census Tract 5033.26, Santa Clara County, California",12,9,3
1000000US060855033261028,060855033261028,"Block 1028, Block Group 1, Census Tract 5033.26, Santa Clara County, California",27,24,3
1000000US060855033261029,060855033261029,"Block 1029, Block Group 1, Census Tract 5033.26, Santa Clara County, California",13,11,2
1000000US060855033261030,060855033261030,"Block 1030, Block Group 1, Census Tract 5033.26, Santa Clara County, California",20,16,4
1000000US060855033261031,060855033261031,"Block 1031, Block Group 1, Census Tract 5033.26, Santa Clara County, California",22,21,1
1000000US060855033261032,060855033261032,"Block 1032, Block Group 1, Census Tract 5033.26, Santa Clara County, California",10,9,1
1000000US060855033261033,060855033261033,"Block 1033, Block Group 1, Census Tract 5033.26, Santa Clara County, California",60,60,0
1000000US060855033261034,060855033261034,"Block 1034, Block Group 1, Census Tract 5033.26, Santa Clara County, California",12,10,2
1000000US060855033261035,060855033261035,"Block 1035, Block Group 1, Census Tract 5033.26, Santa Clara County, California",10,10,0
1000000US060855033261036,060855033261036,"Block 1036, Block Group 1, Census Tract 5033.26, Santa Clara County, California",21,21,0
1000000US060855033261037,060855033261037,"Block 1037, Block Group 1, Census Tract 5033.26, Santa Clara County, California",12,12,0
1000000US060855033261038,060855033261038,"Block 1038, Block Group 1, Census Tract 5033.26, Santa Clara County, California",104,98,6
1000000US060855033261039,060855033261039,"Block 1039, Block Group 1, Census Tract 5033.26, Santa Clara County, California",87,86,1
1000000US060855033261040,060855033261040,"Block 1040, Block Group 1, Census Tract 5033.26, Santa Clara County, California",44,44,0
1000000US060855033261041,060855033261041,"Block 1041, Block Group 1, Census Tract 5033.26, Santa Clara County, California",34,32,2
1000000US060855033261042,060855033261042,"Block 1042, Block Group 1, Census Tract 5033.26, Santa Clara County, California",6,6,0
1000000US060855033262000,060855033262000,"Block 2000, Block Group 2, Census Tract 5033.26, Santa Clara County, California",57,57,0
1000000US060855033262001,060855033262001,"Block 2001, Block Group 2, Census Tract 5033.26, Santa Clara County, California",59,59,0
1000000US060855033262002,060855033262002,"Block 2002, Block Group 2, Census Tract 5033.26, Santa Clara County, California",97,96,1
1000000US060855033262003,060855033262003,"Block 2003, Block Group 2, Census Tract 5033.26, Santa Clara County, California",55,54,1
1000000US060855033262004,060855033262004,"Block 2004, Block Group 2, Census Tract 5033.26, Santa Clara County, California",99,98,1
1000000US060855033262005,060855033262005,"Block 2005, Block Group 2, Census Tract 5033.26, Santa Clara County, California",52,48,4
1000000US060855033262006,060855033262006,"Block 2006, Block Group 2, Census Tract 5033.26, Santa Clara County, California",30,30,0
1000000US060855033262007,060855033262007,"Block 2007, Block Group 2, Census Tract 5033.26, Santa Clara County, California",22,22,0
1000000US060855033262008,060855033262008,"Block 2008, Block Group 2, Census Tract 5033.26, Santa Clara County, California",19,19,0
1000000US060855033262009,060855033262009,"Block 2009, Block Group 2, Census Tract 5033.26, Santa Clara County, California",36,35,1
1000000US060855033271000,060855033271000,"Block 1000, Block Group 1, Census Tract 5033.27, Santa Clara County, California",28,28,0
1000000US060855033271001,060855033271001,"Block 1001, Block Group 1, Census Tract 5033.27, Santa Clara County, California",47,45,2
1000000US060855033271002,060855033271002,"Block 1002, Block Group 1, Census Tract 5033.27, Santa Clara County, California",75,73,2
1000000US060855033271003,060855033271003,"Block 1003, Block Group 1, Census Tract 5033.27, Santa Clara County, California",12,11,1
1000000US060855033271004,060855033271004,"Block 1004, Block Group 1, Census Tract 5033.27, Santa Clara County, California",46,46,0
1000000US060855033271005,060855033271005,"Block 1005, Block Group 1, Census Tract 5033.27, Santa Clara County, California",50,46,4
1000000US060855033271006,060855033271006,"Block 1006, Block Group 1, Census Tract 5033.27, Santa Clara County, California",45,44,1
1000000US060855033271007,060855033271007,"Block 1007, Block Group 1, Census Tract 5033.27, Santa Clara County, California",102,100,2
1000000US060855033271008,060855033271008,"Block 1008, Block Group 1, Census Tract 5033.27, Santa Clara County, California",30,30,0
1000000US060855033272000,060855033272000,"Block 2000, Block Group 2, Census Tract 5033.27, Santa Clara County, California",0,0,0
1000000US060855033272001,060855033272001,"Block 2001, Block Group 2, Census Tract 5033.27, Santa Clara County, California",66,63,3
1000000US060855033272002,060855033272002,"Block 2002, Block Group 2, Census Tract 5033.27, Santa Clara County, California",49,48,1
1000000US060855033272003,060855033272003,"Block 2003, Block Group 2, Census Tract 5033.27, Santa Clara County, California",28,28,0
1000000US060855033272004,060855033272004,"Block 2004, Block Group 2, Census Tract 5033.27, Santa Clara County, California",79,77,2
1000000US060855033272005,060855033272005,"Block 2005, Block Group 2, Census Tract 5033.27, Santa Clara County, California",20,20,0
1000000US060855033272006,060855033272006,"Block 2006, Block Group 2, Census Tract 5033.27, Santa Clara County, California",56,56,0
1000000US060855033272007,060855033272007,"Block 2007, Block Group 2, Census Tract 5033.27, Santa Clara County, California",22,20,2
1000000US060855033272008,060855033272008,"Block 2008, Block Group 2, Census Tract 5033.27, Santa Clara County, California",9,8,1
1000000US060855033272009,060855033272009,"Block 2009, Block Group 2, Census Tract 5033.27, Santa Clara County, California",29,28,1
1000000US060855033272010,060855033272010,"Block 2010, Block Group 2, Census Tract 5033.27, Santa Clara County, California",38,38,0
1000000US060855033272011,060855033272011,"Block 2011, Block Group 2, Census Tract 5033.27, Santa Clara County, California",15,15,0
1000000US060855033272012,060855033272012,"Block 2012, Block Group 2, Census Tract 5033.27, Santa Clara County, California",36,34,2
1000000US060855033273000,060855033273000,"Block 3000, Block Group 3, Census Tract 5033.27, Santa Clara County, California",14,14,0
1000000US060855033273001,060855033273001,"Block 3001, Block Group 3, Census Tract 5033.27, Santa Clara County, California",1,1,0
1000000US060855033273002,060855033273002,"Block 3002, Block Group 3, Census Tract 5033.27, Santa Clara County, California",9,8,1
1000000US060855033273003,060855033273003,"Block 3003, Block Group 3, Census Tract 5033.27, Santa Clara County, California",32,31,1
1000000US060855033273004,060855033273004,"Block 3004, Block Group 3, Census Tract 5033.27, Santa Clara County, California",13,12,1
1000000US060855033273005,060855033273005,"Block 3005, Block Group 3, Census Tract 5033.27, Santa Clara County, California",69,69,0
1000000US060855033273006,060855033273006,"Block 3006, Block Group 3, Census Tract 5033.27, Santa Clara County, California",31,31,0
1000000US060855033273007,060855033273007,"Block 3007, Block Group 3, Census Tract 5033.27, Santa Clara County, California",37,36,1
1000000US060855033273008,060855033273008,"Block 3008, Block Group 3, Census Tract 5033.27, Santa Clara County, California",18,17,1
1000000US060855033273009,060855033273009,"Block 3009, Block Group 3, Census Tract 5033.27, Santa Clara County, California",47,46,1
1000000US060855033273010,060855033273010,"Block 3010, Block Group 3, Census Tract 5033.27, Santa Clara County, California",27,25,2
1000000US060855033273011,060855033273011,"Block 3011, Block Group 3, Census Tract 5033.27, Santa Clara County, California",29,28,1
1000000US060855033273012,060855033273012,"Block 3012, Block Group 3, Census Tract 5033.27, Santa Clara County, California",233,176,57
1000000US060855033273013,060855033273013,"Block 3013, Block Group 3, Census Tract 5033.27, Santa Clara County, California",8,8,0
1000000US060855033291000,060855033291000,"Block 1000, Block Group 1, Census Tract 5033.29, Santa Clara County, California",67,65,2
1000000US060855033291001,060855033291001,"Block 1001, Block Group 1, Census Tract 5033.29, Santa Clara County, California",29,29,0
1000000US060855033291002,060855033291002,"Block 1002, Block Group 1, Census Tract 5033.29, Santa Clara County, California",11,11,0
1000000US060855033291003,060855033291003,"Block 1003, Block Group 1, Census Tract 5033.29, Santa Clara County, California",15,14,1
1000000US060855033291004,060855033291004,"Block 1004, Block Group 1, Census Tract 5033.29, Santa Clara County, California",46,44,2
1000000US060855033291005,060855033291005,"Block 1005, Block Group 1, Census Tract 5033.29, Santa Clara County, California",18,18,0
1000000US060855033291006,060855033291006,"Block 1006, Block Group 1, Census Tract 5033.29, Santa Clara County, California",14,14,0
1000000US060855033291007,060855033291007,"Block 1007, Block Group 1, Census Tract 5033.29, Santa Clara County, California",18,18,0
1000000US060855033291008,060855033291008,"Block 1008, Block Group 1, Census Tract 5033.29, Santa Clara County, California",0,0,0
1000000US060855033291009,060855033291009,"Block 1009, Block Group 1, Census Tract 5033.29, Santa Clara County, California",0,0,0
1000000US060855033291010,060855033291010,"Block 1010, Block Group 1, Census Tract 5033.29, Santa Clara County, California",40,40,0
1000000US060855033291011,060855033291011,"Block 1011, Block Group 1, Census Tract 5033.29, Santa Clara County, California",41,41,0
1000000US060855033291012,060855033291012,"Block 1012, Block Group 1, Census Tract 5033.29, Santa Clara County, California",63,62,1
1000000US060855033291013,060855033291013,"Block 1013, Block Group 1, Census Tract 5033.29, Santa Clara County, California",51,51,0
1000000US060855033291014,060855033291014,"Block 1014, Block Group 1, Census Tract 5033.29, Santa Clara County, California",19,19,0
1000000US060855033291015,060855033291015,"Block 1015, Block Group 1, Census Tract 5033.29, Santa Clara County, California",7,7,0
1000000US060855033291016,060855033291016,"Block 1016, Block Group 1, Census Tract 5033.29, Santa Clara County, California",57,56,1
1000000US060855033291017,060855033291017,"Block 1017, Block Group 1, Census Tract 5033.29, Santa Clara County, California",0,0,0
1000000US060855033292000,060855033292000,"Block 2000, Block Group 2, Census Tract 5033.29, Santa Clara County, California",52,52,0
1000000US060855033292001,060855033292001,"Block 2001, Block Group 2, Census Tract 5033.29, Santa Clara County, California",12,12,0
1000000US060855033292002,060855033292002,"Block 2002, Block Group 2, Census Tract 5033.29, Santa Clara County, California",11,11,0
1000000US060855033292003,060855033292003,"Block 2003, Block Group 2, Census Tract 5033.29, Santa Clara County, California",8,8,0
1000000US060855033292004,060855033292004,"Block 2004, Block Group 2, Census Tract 5033.29, Santa Clara County, California",17,17,0
1000000US060855033292005,060855033292005,"Block 2005, Block Group 2, Census Tract 5033.29, Santa Clara County, California",9,9,0
1000000US060855033292006,060855033292006,"Block 2006, Block Group 2, Census Tract 5033.29, Santa Clara County, California",51,49,2
1000000US060855033292007,060855033292007,"Block 2007, Block Group 2, Census Tract 5033.29, Santa Clara County, California",46,41,5
1000000US060855033292008,060855033292008,"Block 2008, Block Group 2, Census Tract 5033.29, Santa Clara County, California",63,61,2
1000000US060855033292009,060855033292009,"Block 2009, Block Group 2, Census Tract 5033.29, Santa Clara County, California",56,56,0
1000000US060855033292010,060855033292010,"Block 2010, Block Group 2, Census Tract 5033.29, Santa Clara County, California",50,50,0
1000000US060855033292011,060855033292011,"Block 2011, Block Group 2, Census Tract 5033.29, Santa Clara County, California",25,24,1
1000000US060855033292012,060855033292012,"Block 2012, Block Group 2, Census Tract 5033.29, Santa Clara County, California",21,21,0
1000000US060855033292013,060855033292013,"Block 2013, Block Group 2, Census Tract 5033.29, Santa Clara County, California",55,55,0
1000000US060855033301000,060855033301000,"Block 1000, Block Group 1, Census Tract 5033.30, Santa Clara County, California",112,110,2
1000000US060855033301001,060855033301001,"Block 1001, Block Group 1, Census Tract 5033.30, Santa Clara County, California",22,22,0
1000000US060855033301002,060855033301002,"Block 1002, Block Group 1, Census Tract 5033.30, Santa Clara County, California",47,46,1
1000000US060855033301003,060855033301003,"Block 1003, Block Group 1, Census Tract 5033.30, Santa Clara County, California",18,18,0
1000000US060855033301004,060855033301004,"Block 1004, Block Group 1, Census Tract 5033.30, Santa Clara County, California",42,42,0
1000000US060855033301005,060855033301005,"Block 1005, Block Group 1, Census Tract 5033.30, Santa Clara County, California",15,15,0
1000000US060855033301006,060855033301006,"Block 1006, Block Group 1, Census Tract 5033.30, Santa Clara County, California",16,16,0
1000000US060855033301007,060855033301007,"Block 1007, Block Group 1, Census Tract 5033.30, Santa Clara County, California",11,11,0
1000000US060855033301008,060855033301008,"Block 1008, Block Group 1, Census Tract 5033.30, Santa Clara County, California",19,19,0
1000000US060855033301009,060855033301009,"Block 1009, Block Group 1, Census Tract 5033.30, Santa Clara County, California",40,39,1
1000000US060855033301010,060855033301010,"Block 1010, Block Group 1, Census Tract 5033.30, Santa Clara County, California",24,24,0
1000000US060855033301011,060855033301011,"Block 1011, Block Group 1, Census Tract 5033.30, Santa Clara County, California",47,46,1
1000000US060855033301012,060855033301012,"Block 1012, Block Group 1, Census Tract 5033.30, Santa Clara County, California",0,0,0
1000000US060855033301013,060855033301013,"Block 1013, Block Group 1, Census Tract 5033.30, Santa Clara County, California",22,22,0
1000000US060855033301014,060855033301014,"Block 1014, Block Group 1, Census Tract 5033.30, Santa Clara County, California",35,34,1
1000000US060855033301015,060855033301015,"Block 1015, Block Group 1, Census Tract 5033.30, Santa Clara County, California",55,54,1
1000000US060855033301016,060855033301016,"Block 1016, Block Group 1, Census Tract 5033.30, Santa Clara County, California",34,34,0
1000000US060855033301017,060855033301017,"Block 1017, Block Group 1, Census Tract 5033.30, Santa Clara County, California",16,16,0
1000000US060855033302000,060855033302000,"Block 2000, Block Group 2, Census Tract 5033.30, Santa Clara County, California",48,48,0
1000000US060855033302001,060855033302001,"Block 2001, Block Group 2, Census Tract 5033.30, Santa Clara County, California",16,15,1
1000000US060855033302002,060855033302002,"Block 2002, Block Group 2, Census Tract 5033.30, Santa Clara County, California",14,14,0
1000000US060855033302003,060855033302003,"Block 2003, Block Group 2, Census Tract 5033.30, Santa Clara County, California",9,9,0
1000000US060855033302004,060855033302004,"Block 2004, Block Group 2, Census Tract 5033.30, Santa Clara County, California",0,0,0
1000000US060855033302005,060855033302005,"Block 2005, Block Group 2, Census Tract 5033.30, Santa Clara County, California",25,25,0
1000000US060855033302006,060855033302006,"Block 2006, Block Group 2, Census Tract 5033.30, Santa Clara County, California",42,42,0
1000000US060855033302007,060855033302007,"Block 2007, Block Group 2, Census Tract 5033.30, Santa Clara County, California",16,16,0
1000000US060855033302008,060855033302008,"Block 2008, Block Group 2, Census Tract 5033.30, Santa Clara County, California",80,77,3
1000000US060855033302009,060855033302009,"Block 2009, Block Group 2, Census Tract 5033.30, Santa Clara County, California",66,63,3
1000000US060855033302010,060855033302010,"Block 2010, Block Group 2, Census Tract 5033.30, Santa Clara County, California",0,0,0
1000000US060855033302011,060855033302011,"Block 2011, Block Group 2, Census Tract 5033.30, Santa Clara County, California",72,70,2
1000000US060855033302012,060855033302012,"Block 2012, Block Group 2, Census Tract 5033.30, Santa Clara County, California",79,78,1
1000000US060855033303000,060855033303000,"Block 3000, Block Group 3, Census Tract 5033.30, Santa Clara County, California",1,1,0
1000000US060855033303001,060855033303001,"Block 3001, Block Group 3, Census Tract 5033.30, Santa Clara County, California",0,0,0
1000000US060855033303002,060855033303002,"Block 3002, Block Group 3, Census Tract 5033.30, Santa Clara County, California",36,27,9
1000000US060855033303003,060855033303003,"Block 3003, Block Group 3, Census Tract 5033.30, Santa Clara County, California",0,0,0
1000000US060855033303004,060855033303004,"Block 3004, Block Group 3, Census Tract 5033.30, Santa Clara County, California",0,0,0
1000000US060855033303005,060855033303005,"Block 3005, Block Group 3, Census Tract 5033.30, Santa Clara County, California",0,0,0
1000000US060855033303006,060855033303006,"Block 3006, Block Group 3, Census Tract 5033.30, Santa Clara County, California",4,4,0
1000000US060855033303007,060855033303007,"Block 3007, Block Group 3, Census Tract 5033.30, Santa Clara County, California",1,1,0
1000000US060855033303008,060855033303008,"Block 3008, Block Group 3, Census Tract 5033.30, Santa Clara County, California",0,0,0
1000000US060855033303009,060855033303009,"Block 3009, Block Group 3, Census Tract 5033.30, Santa Clara County, California",49,48,1
1000000US060855033303010,060855033303010,"Block 3010, Block Group 3, Census Tract 5033.30, Santa Clara County, California",8,7,1
1000000US060855033303011,060855033303011,"Block 3011, Block Group 3, Census Tract 5033.30, Santa Clara County, California",17,17,0
1000000US060855033303012,060855033303012,"Block 3012, Block Group 3, Census Tract 5033.30, Santa Clara County, California",0,0,0
1000000US060855033303013,060855033303013,"Block 3013, Block Group 3, Census Tract 5033.30, Santa Clara County, California",0,0,0
1000000US060855033303014,060855033303014,"Block 3014, Block Group 3, Census Tract 5033.30, Santa Clara County, California",34,33,1
1000000US060855033303015,060855033303015,"Block 3015, Block Group 3, Census Tract 5033.30, Santa Clara County, California",23,23,0
1000000US060855033303016,060855033303016,"Block 3016, Block Group 3, Census Tract 5033.30, Santa Clara County, California",7,7,0
1000000US060855033303017,060855033303017,"Block 3017, Block Group 3, Census Tract 5033.30, Santa Clara County, California",30,28,2
1000000US060855033303018,060855033303018,"Block 3018, Block Group 3, Census Tract 5033.30, Santa Clara County, California",69,69,0
1000000US060855033303019,060855033303019,"Block 3019, Block Group 3, Census Tract 5033.30, Santa Clara County, California",8,7,1
1000000US060855033303020,060855033303020,"Block 3020, Block Group 3, Census Tract 5033.30, Santa Clara County, California",7,6,1
1000000US060855033303021,060855033303021,"Block 3021, Block Group 3, Census Tract 5033.30, Santa Clara County, California",36,35,1
1000000US060855033303022,060855033303022,"Block 3022, Block Group 3, Census Tract 5033.30, Santa Clara County, California",7,6,1
1000000US060855033303023,060855033303023,"Block 3023, Block Group 3, Census Tract 5033.30, Santa Clara County, California",52,51,1
1000000US060855033303024,060855033303024,"Block 3024, Block Group 3, Census Tract 5033.30, Santa Clara County, California",10,9,1
1000000US060855033303025,060855033303025,"Block 3025, Block Group 3, Census Tract 5033.30, Santa Clara County, California",19,18,1
1000000US060855033303026,060855033303026,"Block 3026, Block Group 3, Census Tract 5033.30, Santa Clara County, California",19,16,3
1000000US060855033303027,060855033303027,"Block 3027, Block Group 3, Census Tract 5033.30, Santa Clara County, California",0,0,0
1000000US060855033303028,060855033303028,"Block 3028, Block Group 3, Census Tract 5033.30, Santa Clara County, California",21,20,1
1000000US060855033303029,060855033303029,"Block 3029, Block Group 3, Census Tract 5033.30, Santa Clara County, California",5,5,0
1000000US060855033303030,060855033303030,"Block 3030, Block Group 3, Census Tract 5033.30, Santa Clara County, California",12,12,0
1000000US060855033303031,060855033303031,"Block 3031, Block Group 3, Census Tract 5033.30, Santa Clara County, California",12,12,0
1000000US060855033303032,060855033303032,"Block 3032, Block Group 3, Census Tract 5033.30, Santa Clara County, California",12,12,0
1000000US060855033303033,060855033303033,"Block 3033, Block Group 3, Census Tract 5033.30, Santa Clara County, California",9,9,0
1000000US060855033303034,060855033303034,"Block 3034, Block Group 3, Census Tract 5033.30, Santa Clara County, California",1,1,0
1000000US060855033303035,060855033303035,"Block 3035, Block Group 3, Census Tract 5033.30, Santa Clara County, California",9,8,1
1000000US060855033303036,060855033303036,"Block 3036, Block Group 3, Census Tract 5033.30, Santa Clara County, California",55,53,2
1000000US060855033303037,060855033303037,"Block 3037, Block Group 3, Census Tract 5033.30, Santa Clara County, California",12,12,0
1000000US060855033303038,060855033303038,"Block 3038, Block Group 3, Census Tract 5033.30, Santa Clara County, California",0,0,0
1000000US060855033303039,060855033303039,"Block 3039, Block Group 3, Census Tract 5033.30, Santa Clara County, California",0,0,0
1000000US060855033303040,060855033303040,"Block 3040, Block Group 3, Census Tract 5033.30, Santa Clara County, California",0,0,0
1000000US060855033303041,060855033303041,"Block 3041, Block Group 3, Census Tract 5033.30, Santa Clara County, California",0,0,0
1000000US060855033303042,060855033303042,"Block 3042, Block Group 3, Census Tract 5033.30, Santa Clara County, California",0,0,0
1000000US060855033303043,060855033303043,"Block 3043, Block Group 3, Census Tract 5033.30, Santa Clara County, California",1,1,0
1000000US060855033303044,060855033303044,"Block 3044, Block Group 3, Census Tract 5033.30, Santa Clara County, California",0,0,0
1000000US060855033303045,060855033303045,"Block 3045, Block Group 3, Census Tract 5033.30, Santa Clara County, California",1,0,1
1000000US060855033303046,060855033303046,"Block 3046, Block Group 3, Census Tract 5033.30, Santa Clara County, California",0,0,0
1000000US060855033303047,060855033303047,"Block 3047, Block Group 3, Census Tract 5033.30, Santa Clara County, California",84,72,12
1000000US060855033303048,060855033303048,"Block 3048, Block Group 3, Census Tract 5033.30, Santa Clara County, California",39,38,1
1000000US060855033303049,060855033303049,"Block 3049, Block Group 3, Census Tract 5033.30, Santa Clara County, California",1,1,0
1000000US060855033303050,060855033303050,"Block 3050, Block Group 3, Census Tract 5033.30, Santa Clara County, California",94,90,4
1000000US060855033303051,060855033303051,"Block 3051, Block Group 3, Census Tract 5033.30, Santa Clara County, California",26,26,0
1000000US060855033303052,060855033303052,"Block 3052, Block Group 3, Census Tract 5033.30, Santa Clara County, California",32,30,2
1000000US060855033303053,060855033303053,"Block 3053, Block Group 3, Census Tract 5033.30, Santa Clara County, California",33,32,1
1000000US060855033303054,060855033303054,"Block 3054, Block Group 3, Census Tract 5033.30, Santa Clara County, California",30,29,1
1000000US060855033303055,060855033303055,"Block 3055, Block Group 3, Census Tract 5033.30, Santa Clara County, California",36,35,1
1000000US060855033303056,060855033303056,"Block 3056, Block Group 3, Census Tract 5033.30, Santa Clara County, California",38,37,1
1000000US060855033303057,060855033303057,"Block 3057, Block Group 3, Census Tract 5033.30, Santa Clara County, California",48,48,0
1000000US060855033303058,060855033303058,"Block 3058, Block Group 3, Census Tract 5033.30, Santa Clara County, California",0,0,0
1000000US060855033303059,060855033303059,"Block 3059, Block Group 3, Census Tract 5033.30, Santa Clara County, California",0,0,0
1000000US060855033303060,060855033303060,"Block 3060, Block Group 3, Census Tract 5033.30, Santa Clara County, California",0,0,0
1000000US060855033303061,060855033303061,"Block 3061, Block Group 3, Census Tract 5033.30, Santa Clara County, California",3,3,0
1000000US060855033311000,060855033311000,"Block 1000, Block Group 1, Census Tract 5033.31, Santa Clara County, California",274,252,22
1000000US060855033311001,060855033311001,"Block 1001, Block Group 1, Census Tract 5033.31, Santa Clara County, California",31,25,6
1000000US060855033311002,060855033311002,"Block 1002, Block Group 1, Census Tract 5033.31, Santa Clara County, California",200,184,16
1000000US060855033311003,060855033311003,"Block 1003, Block Group 1, Census Tract 5033.31, Santa Clara County, California",248,234,14
1000000US060855033311004,060855033311004,"Block 1004, Block Group 1, Census Tract 5033.31, Santa Clara County, California",0,0,0
1000000US060855033311005,060855033311005,"Block 1005, Block Group 1, Census Tract 5033.31, Santa Clara County, California",39,37,2
1000000US060855033311006,060855033311006,"Block 1006, Block Group 1, Census Tract 5033.31, Santa Clara County, California",65,64,1
1000000US060855033311007,060855033311007,"Block 1007, Block Group 1, Census Tract 5033.31, Santa Clara County, California",0,0,0
1000000US060855033311008,060855033311008,"Block 1008, Block Group 1, Census Tract 5033.31, Santa Clara County, California",0,0,0
1000000US060855033311009,060855033311009,"Block 1009, Block Group 1, Census Tract 5033.31, Santa Clara County, California",131,124,7
1000000US060855033311010,060855033311010,"Block 1010, Block Group 1, Census Tract 5033.31, Santa Clara County, California",68,67,1
1000000US060855033311011,060855033311011,"Block 1011, Block Group 1, Census Tract 5033.31, Santa Clara County, California",0,0,0
1000000US060855033311012,060855033311012,"Block 1012, Block Group 1, Census Tract 5033.31, Santa Clara County, California",15,15,0
1000000US060855033312000,060855033312000,"Block 2000, Block Group 2, Census Tract 5033.31, Santa Clara County, California",36,35,1
1000000US060855033312001,060855033312001,"Block 2001, Block Group 2, Census Tract 5033.31, Santa Clara County, California",17,17,0
1000000US060855033312002,060855033312002,"Block 2002, Block Group 2, Census Tract 5033.31, Santa Clara County, California",18,18,0
1000000US060855033312003,060855033312003,"Block 2003, Block Group 2, Census Tract 5033.31, Santa Clara County, California",64,62,2
1000000US060855033312004,060855033312004,"Block 2004, Block Group 2, Census Tract 5033.31, Santa Clara County, California",39,38,1
1000000US060855033312005,060855033312005,"Block 2005, Block Group 2, Census Tract 5033.31, Santa Clara County, California",69,67,2
1000000US060855033312006,060855033312006,"Block 2006, Block Group 2, Census Tract 5033.31, Santa Clara County, California",24,24,0
1000000US060855033312007,060855033312007,"Block 2007, Block Group 2, Census Tract 5033.31, Santa Clara County, California",55,53,2
1000000US060855033312008,060855033312008,"Block 2008, Block Group 2, Census Tract 5033.31, Santa Clara County, California",23,23,0
1000000US060855033321000,060855033321000,"Block 1000, Block Group 1, Census Tract 5033.32, Santa Clara County, California",74,69,5
1000000US060855033321001,060855033321001,"Block 1001, Block Group 1, Census Tract 5033.32, Santa Clara County, California",0,0,0
1000000US060855033321002,060855033321002,"Block 1002, Block Group 1, Census Tract 5033.32, Santa Clara County, California",0,0,0
1000000US060855033321003,060855033321003,"Block 1003, Block Group 1, Census Tract 5033.32, Santa Clara County, California",0,0,0
1000000US060855033321004,060855033321004,"Block 1004, Block Group 1, Census Tract 5033.32, Santa Clara County, California",27,27,0
1000000US060855033321005,060855033321005,"Block 1005, Block Group 1, Census Tract 5033.32, Santa Clara County, California",34,34,0
1000000US060855033321006,060855033321006,"Block 1006, Block Group 1, Census Tract 5033.32, Santa Clara County, California",35,32,3
1000000US060855033321007,060855033321007,"Block 1007, Block Group 1, Census Tract 5033.32, Santa Clara County, California",17,17,0
1000000US060855033321008,060855033321008,"Block 1008, Block Group 1, Census Tract 5033.32, Santa Clara County, California",102,98,4
1000000US060855033321009,060855033321009,"Block 1009, Block Group 1, Census Tract 5033.32, Santa Clara County, California",45,41,4
1000000US060855033321010,060855033321010,"Block 1010, Block Group 1, Census Tract 5033.32, Santa Clara County, California",31,29,2
1000000US060855033321011,060855033321011,"Block 1011, Block Group 1, Census Tract 5033.32, Santa Clara County, California",359,333,26
1000000US060855033321012,060855033321012,"Block 1012, Block Group 1, Census Tract 5033.32, Santa Clara County, California",35,32,3
1000000US060855033321013,060855033321013,"Block 1013, Block Group 1, Census Tract 5033.32, Santa Clara County, California",37,36,1
1000000US060855033321014,060855033321014,"Block 1014, Block Group 1, Census Tract 5033.32, Santa Clara County, California",40,40,0
1000000US060855033321015,060855033321015,"Block 1015, Block Group 1, Census Tract 5033.32, Santa Clara County, California",0,0,0
1000000US060855033321016,060855033321016,"Block 1016, Block Group 1, Census Tract 5033.32, Santa Clara County, California",48,45,3
1000000US060855033322000,060855033322000,"Block 2000, Block Group 2, Census Tract 5033.32, Santa Clara County, California",252,240,12
1000000US060855033322001,060855033322001,"Block 2001, Block Group 2, Census Tract 5033.32, Santa Clara County, California",0,0,0
1000000US060855033322002,060855033322002,"Block 2002, Block Group 2, Census Tract 5033.32, Santa Clara County, California",30,29,1
1000000US060855033322003,060855033322003,"Block 2003, Block Group 2, Census Tract 5033.32, Santa Clara County, California",25,25,0
1000000US060855033322004,060855033322004,"Block 2004, Block Group 2, Census Tract 5033.32, Santa Clara County, California",0,0,0
1000000US060855033322005,060855033322005,"Block 2005, Block Group 2, Census Tract 5033.32, Santa Clara County, California",43,42,1
1000000US060855033322006,060855033322006,"Block 2006, Block Group 2, Census Tract 5033.32, Santa Clara County, California",64,60,4
1000000US060855033322007,060855033322007,"Block 2007, Block Group 2, Census Tract 5033.32, Santa Clara County, California",25,22,3
1000000US060855033322008,060855033322008,"Block 2008, Block Group 2, Census Tract 5033.32, Santa Clara County, California",19,17,2
1000000US060855033323000,060855033323000,"Block 3000, Block Group 3, Census Tract 5033.32, Santa Clara County, California",28,28,0
1000000US060855033323001,060855033323001,"Block 3001, Block Group 3, Census Tract 5033.32, Santa Clara County, California",35,34,1
1000000US060855033323002,060855033323002,"Block 3002, Block Group 3, Census Tract 5033.32, Santa Clara County, California",24,24,0
1000000US060855033323003,060855033323003,"Block 3003, Block Group 3, Census Tract 5033.32, Santa Clara County, California",26,23,3
1000000US060855033323004,060855033323004,"Block 3004, Block Group 3, Census Tract 5033.32, Santa Clara County, California",12,12,0
1000000US060855033323005,060855033323005,"Block 3005, Block Group 3, Census Tract 5033.32, Santa Clara County, California",21,21,0
1000000US060855033323006,060855033323006,"Block 3006, Block Group 3, Census Tract 5033.32, Santa Clara County, California",73,72,1
1000000US060855033323007,060855033323007,"Block 3007, Block Group 3, Census Tract 5033.32, Santa Clara County, California",47,47,0
1000000US060855033323008,060855033323008,"Block 3008, Block Group 3, Census Tract 5033.32, Santa Clara County, California",1,1,0
1000000US060855033324000,060855033324000,"Block 4000, Block Group 4, Census Tract 5033.32, Santa Clara County, California",546,531,15
1000000US060855033324001,060855033324001,"Block 4001, Block Group 4, Census Tract 5033.32, Santa Clara County, California",4,4,0
1000000US060855033324002,060855033324002,"Block 4002, Block Group 4, Census Tract 5033.32, Santa Clara County, California",3,3,0
1000000US060855033324003,060855033324003,"Block 4003, Block Group 4, Census Tract 5033.32, Santa Clara County, California",23,23,0
1000000US060855033324004,060855033324004,"Block 4004, Block Group 4, Census Tract 5033.32, Santa Clara County, California",30,29,1
1000000US060855033324005,060855033324005,"Block 4005, Block Group 4, Census Tract 5033.32, Santa Clara County, California",8,8,0
1000000US060855033324006,060855033324006,"Block 4006, Block Group 4, Census Tract 5033.32, Santa Clara County, California",8,8,0
1000000US060855033324007,060855033324007,"Block 4007, Block Group 4, Census Tract 5033.32, Santa Clara County, California",12,12,0
1000000US060855033324008,060855033324008,"Block 4008, Block Group 4, Census Tract 5033.32, Santa Clara County, California",21,20,1
1000000US060855033324009,060855033324009,"Block 4009, Block Group 4, Census Tract 5033.32, Santa Clara County, California",21,20,1
1000000US060855033324010,060855033324010,"Block 4010, Block Group 4, Census Tract 5033.32, Santa Clara County, California",46,46,0
1000000US060855033324011,060855033324011,"Block 4011, Block Group 4, Census Tract 5033.32, Santa Clara County, California",23,23,0
1000000US060855033324012,060855033324012,"Block 4012, Block Group 4, Census Tract 5033.32, Santa Clara County, California",11,11,0
1000000US060855033324013,060855033324013,"Block 4013, Block Group 4, Census Tract 5033.32, Santa Clara County, California",0,0,0
1000000US060855033324014,060855033324014,"Block 4014, Block Group 4, Census Tract 5033.32, Santa Clara County, California",52,50,2
1000000US060855033324015,060855033324015,"Block 4015, Block Group 4, Census Tract 5033.32, Santa Clara County, California",8,8,0
1000000US060855033324016,060855033324016,"Block 4016, Block Group 4, Census Tract 5033.32, Santa Clara County, California",34,34,0
1000000US060855033324017,060855033324017,"Block 4017, Block Group 4, Census Tract 5033.32, Santa Clara County, California",6,6,0
1000000US060855033324018,060855033324018,"Block 4018, Block Group 4, Census Tract 5033.32, Santa Clara County, California",2,2,0
1000000US060855033324019,060855033324019,"Block 4019, Block Group 4, Census Tract 5033.32, Santa Clara County, California",31,31,0
1000000US060855033324020,060855033324020,"Block 4020, Block Group 4, Census Tract 5033.32, Santa Clara County, California",5,4,1
1000000US060855033324021,060855033324021,"Block 4021, Block Group 4, Census Tract 5033.32, Santa Clara County, California",0,0,0
1000000US060855033324022,060855033324022,"Block 4022, Block Group 4, Census Tract 5033.32, Santa Clara County, California",19,19,0
1000000US060855033324023,060855033324023,"Block 4023, Block Group 4, Census Tract 5033.32, Santa Clara County, California",1,1,0
1000000US060855033324024,060855033324024,"Block 4024, Block Group 4, Census Tract 5033.32, Santa Clara County, California",0,0,0
1000000US060855033324025,060855033324025,"Block 4025, Block Group 4, Census Tract 5033.32, Santa Clara County, California",10,10,0
1000000US060855033324026,060855033324026,"Block 4026, Block Group 4, Census Tract 5033.32, Santa Clara County, California",29,29,0
1000000US060855033324027,060855033324027,"Block 4027, Block Group 4, Census Tract 5033.32, Santa Clara County, California",7,7,0
1000000US060855033331000,060855033331000,"Block 1000, Block Group 1, Census Tract 5033.33, Santa Clara County, California",21,21,0
1000000US060855033331001,060855033331001,"Block 1001, Block Group 1, Census Tract 5033.33, Santa Clara County, California",283,279,4
1000000US060855033331002,060855033331002,"Block 1002, Block Group 1, Census Tract 5033.33, Santa Clara County, California",26,26,0
1000000US060855033331003,060855033331003,"Block 1003, Block Group 1, Census Tract 5033.33, Santa Clara County, California",14,14,0
1000000US060855033331004,060855033331004,"Block 1004, Block Group 1, Census Tract 5033.33, Santa Clara County, California",36,35,1
1000000US060855033331005,060855033331005,"Block 1005, Block Group 1, Census Tract 5033.33, Santa Clara County, California",25,25,0
1000000US060855033331006,060855033331006,"Block 1006, Block Group 1, Census Tract 5033.33, Santa Clara County, California",24,23,1
1000000US060855033331007,060855033331007,"Block 1007, Block Group 1, Census Tract 5033.33, Santa Clara County, California",15,14,1
1000000US060855033331008,060855033331008,"Block 1008, Block Group 1, Census Tract 5033.33, Santa Clara County, California",16,16,0
1000000US060855033331009,060855033331009,"Block 1009, Block Group 1, Census Tract 5033.33, Santa Clara County, California",10,10,0
1000000US060855033331010,060855033331010,"Block 1010, Block Group 1, Census Tract 5033.33, Santa Clara County, California",13,13,0
1000000US060855033331011,060855033331011,"Block 1011, Block Group 1, Census Tract 5033.33, Santa Clara County, California",20,20,0
1000000US060855033331012,060855033331012,"Block 1012, Block Group 1, Census Tract 5033.33, Santa Clara County, California",0,0,0
1000000US060855033332000,060855033332000,"Block 2000, Block Group 2, Census Tract 5033.33, Santa Clara County, California",257,254,3
1000000US060855033332001,060855033332001,"Block 2001, Block Group 2, Census Tract 5033.33, Santa Clara County, California",20,20,0
1000000US060855033332002,060855033332002,"Block 2002, Block Group 2, Census Tract 5033.33, Santa Clara County, California",33,32,1
1000000US060855033332003,060855033332003,"Block 2003, Block Group 2, Census Tract 5033.33, Santa Clara County, California",37,37,0
1000000US060855033332004,060855033332004,"Block 2004, Block Group 2, Census Tract 5033.33, Santa Clara County, California",26,26,0
1000000US060855033332005,060855033332005,"Block 2005, Block Group 2, Census Tract 5033.33, Santa Clara County, California",8,8,0
1000000US060855033332006,060855033332006,"Block 2006, Block Group 2, Census Tract 5033.33, Santa Clara County, California",412,391,21
1000000US060855033341000,060855033341000,"Block 1000, Block Group 1, Census Tract 5033.34, Santa Clara County, California",30,29,1
1000000US060855033341001,060855033341001,"Block 1001, Block Group 1, Census Tract 5033.34, Santa Clara County, California",0,0,0
1000000US060855033341002,060855033341002,"Block 1002, Block Group 1, Census Tract 5033.34, Santa Clara County, California",0,0,0
1000000US060855033341003,060855033341003,"Block 1003, Block Group 1, Census Tract 5033.34, Santa Clara County, California",72,70,2
1000000US060855033341004,060855033341004,"Block 1004, Block Group 1, Census Tract 5033.34, Santa Clara County, California",335,330,5
1000000US060855033341005,060855033341005,"Block 1005, Block Group 1, Census Tract 5033.34, Santa Clara County, California",27,26,1
1000000US060855033341006,060855033341006,"Block 1006, Block Group 1, Census Tract 5033.34, Santa Clara County, California",0,0,0
1000000US060855033341007,060855033341007,"Block 1007, Block Group 1, Census Tract 5033.34, Santa Clara County, California",7,7,0
1000000US060855033341008,060855033341008,"Block 1008, Block Group 1, Census Tract 5033.34, Santa Clara County, California",204,196,8
1000000US060855033341009,060855033341009,"Block 1009, Block Group 1, Census Tract 5033.34, Santa Clara County, California",55,55,0
1000000US060855033341010,060855033341010,"Block 1010, Block Group 1, Census Tract 5033.34, Santa Clara County, California",7,7,0
1000000US060855033341011,060855033341011,"Block 1011, Block Group 1, Census Tract 5033.34, Santa Clara County, California",18,16,2
1000000US060855033341012,060855033341012,"Block 1012, Block Group 1, Census Tract 5033.34, Santa Clara County, California",9,8,1
1000000US060855033341013,060855033341013,"Block 1013, Block Group 1, Census Tract 5033.34, Santa Clara County, California",16,15,1
1000000US060855033341014,060855033341014,"Block 1014, Block Group 1, Census Tract 5033.34, Santa Clara County, California",33,32,1
1000000US060855033341015,060855033341015,"Block 1015, Block Group 1, Census Tract 5033.34, Santa Clara County, California",144,139,5
1000000US060855033341016,060855033341016,"Block 1016, Block Group 1, Census Tract 5033.34, Santa Clara County, California",0,0,0
1000000US060855033341017,060855033341017,"Block 1017, Block Group 1, Census Tract 5033.34, Santa Clara County, California",2,2,0
1000000US060855033341018,060855033341018,"Block 1018, Block Group 1, Census Tract 5033.34, Santa Clara County, California",9,8,1
1000000US060855033341019,060855033341019,"Block 1019, Block Group 1, Census Tract 5033.34, Santa Clara County, California",21,21,0
1000000US060855033341020,060855033341020,"Block 1020, Block Group 1, Census Tract 5033.34, Santa Clara County, California",3,3,0
1000000US060855033341021,060855033341021,"Block 1021, Block Group 1, Census Tract 5033.34, Santa Clara County, California",0,0,0
1000000US060855033341022,060855033341022,"Block 1022, Block Group 1, Census Tract 5033.34, Santa Clara County, California",26,26,0
1000000US060855033341023,060855033341023,"Block 1023, Block Group 1, Census Tract 5033.34, Santa Clara County, California",0,0,0
1000000US060855033341024,060855033341024,"Block 1024, Block Group 1, Census Tract 5033.34, Santa Clara County, California",4,2,2
1000000US060855033341025,060855033341025,"Block 1025, Block Group 1, Census Tract 5033.34, Santa Clara County, California",0,0,0
1000000US060855033341026,060855033341026,"Block 1026, Block Group 1, Census Tract 5033.34, Santa Clara County, California",0,0,0
1000000US060855033341027,060855033341027,"Block 1027, Block Group 1, Census Tract 5033.34, Santa Clara County, California",0,0,0
1000000US060855033341028,060855033341028,"Block 1028, Block Group 1, Census Tract 5033.34, Santa Clara County, California",0,0,0
1000000US060855033341029,060855033341029,"Block 1029, Block Group 1, Census Tract 5033.34, Santa Clara County, California",1,1,0
1000000US060855033341030,060855033341030,"Block 1030, Block Group 1, Census Tract 5033.34, Santa Clara County, California",0,0,0
1000000US060855033341031,060855033341031,"Block 1031, Block Group 1, Census Tract 5033.34, Santa Clara County, California",0,0,0
1000000US060855033341032,060855033341032,"Block 1032, Block Group 1, Census Tract 5033.34, Santa Clara County, California",143,139,4
1000000US060855033341033,060855033341033,"Block 1033, Block Group 1, Census Tract 5033.34, Santa Clara County, California",45,44,1
1000000US060855033341034,060855033341034,"Block 1034, Block Group 1, Census Tract 5033.34, Santa Clara County, California",30,30,0
1000000US060855033341035,060855033341035,"Block 1035, Block Group 1, Census Tract 5033.34, Santa Clara County, California",3,3,0
1000000US060855033341036,060855033341036,"Block 1036, Block Group 1, Census Tract 5033.34, Santa Clara County, California",0,0,0
1000000US060855033341037,060855033341037,"Block 1037, Block Group 1, Census Tract 5033.34, Santa Clara County, California",53,52,1
1000000US060855033341038,060855033341038,"Block 1038, Block Group 1, Census Tract 5033.34, Santa Clara County, California",4,3,1
1000000US060855033341039,060855033341039,"Block 1039, Block Group 1, Census Tract 5033.34, Santa Clara County, California",19,18,1
1000000US060855033341040,060855033341040,"Block 1040, Block Group 1, Census Tract 5033.34, Santa Clara County, California",0,0,0
1000000US060855033341041,060855033341041,"Block 1041, Block Group 1, Census Tract 5033.34, Santa Clara County, California",24,23,1
1000000US060855033341042,060855033341042,"Block 1042, Block Group 1, Census Tract 5033.34, Santa Clara County, California",1,1,0
1000000US060855033341043,060855033341043,"Block 1043, Block Group 1, Census Tract 5033.34, Santa Clara County, California",0,0,0
1000000US060855033341044,060855033341044,"Block 1044, Block Group 1, Census Tract 5033.34, Santa Clara County, California",1,1,0
1000000US060855033341045,060855033341045,"Block 1045, Block Group 1, Census Tract 5033.34, Santa Clara County, California",0,0,0
1000000US060855033341046,060855033341046,"Block 1046, Block Group 1, Census Tract 5033.34, Santa Clara County, California",2,1,1
1000000US060855033341047,060855033341047,"Block 1047, Block Group 1, Census Tract 5033.34, Santa Clara County, California",1,0,1
1000000US060855033341048,060855033341048,"Block 1048, Block Group 1, Census Tract 5033.34, Santa Clara County, California",0,0,0
1000000US060855033341049,060855033341049,"Block 1049, Block Group 1, Census Tract 5033.34, Santa Clara County, California",0,0,0
1000000US060855033341050,060855033341050,"Block 1050, Block Group 1, Census Tract 5033.34, Santa Clara County, California",0,0,0
1000000US060855033341051,060855033341051,"Block 1051, Block Group 1, Census Tract 5033.34, Santa Clara County, California",1,1,0
1000000US060855033342000,060855033342000,"Block 2000, Block Group 2, Census Tract 5033.34, Santa Clara County, California",151,147,4
1000000US060855033342001,060855033342001,"Block 2001, Block Group 2, Census Tract 5033.34, Santa Clara County, California",32,31,1
1000000US060855033342002,060855033342002,"Block 2002, Block Group 2, Census Tract 5033.34, Santa Clara County, California",39,39,0
1000000US060855033342003,060855033342003,"Block 2003, Block Group 2, Census Tract 5033.34, Santa Clara County, California",5,4,1
1000000US060855033342004,060855033342004,"Block 2004, Block Group 2, Census Tract 5033.34, Santa Clara County, California",25,24,1
1000000US060855033342005,060855033342005,"Block 2005, Block Group 2, Census Tract 5033.34, Santa Clara County, California",90,89,1
1000000US060855033342006,060855033342006,"Block 2006, Block Group 2, Census Tract 5033.34, Santa Clara County, California",24,23,1
1000000US060855033342007,060855033342007,"Block 2007, Block Group 2, Census Tract 5033.34, Santa Clara County, California",27,27,0
1000000US060855033342008,060855033342008,"Block 2008, Block Group 2, Census Tract 5033.34, Santa Clara County, California",44,44,0
1000000US060855033342009,060855033342009,"Block 2009, Block Group 2, Census Tract 5033.34, Santa Clara County, California",27,27,0
1000000US060855033342010,060855033342010,"Block 2010, Block Group 2, Census Tract 5033.34, Santa Clara County, California",40,40,0
1000000US060855033342011,060855033342011,"Block 2011, Block Group 2, Census Tract 5033.34, Santa Clara County, California",9,9,0
1000000US060855033343000,060855033343000,"Block 3000, Block Group 3, Census Tract 5033.34, Santa Clara County, California",234,223,11
1000000US060855033343001,060855033343001,"Block 3001, Block Group 3, Census Tract 5033.34, Santa Clara County, California",24,24,0
1000000US060855033343002,060855033343002,"Block 3002, Block Group 3, Census Tract 5033.34, Santa Clara County, California",168,158,10
1000000US060855033343003,060855033343003,"Block 3003, Block Group 3, Census Tract 5033.34, Santa Clara County, California",1,1,0
1000000US060855033343004,060855033343004,"Block 3004, Block Group 3, Census Tract 5033.34, Santa Clara County, California",69,67,2
1000000US060855033343005,060855033343005,"Block 3005, Block Group 3, Census Tract 5033.34, Santa Clara County, California",56,54,2
1000000US060855033343006,060855033343006,"Block 3006, Block Group 3, Census Tract 5033.34, Santa Clara County, California",12,12,0
1000000US060855033343007,060855033343007,"Block 3007, Block Group 3, Census Tract 5033.34, Santa Clara County, California",41,40,1
1000000US060855033343008,060855033343008,"Block 3008, Block Group 3, Census Tract 5033.34, Santa Clara County, California",28,28,0
1000000US060855033343009,060855033343009,"Block 3009, Block Group 3, Census Tract 5033.34, Santa Clara County, California",53,52,1
1000000US060855033343010,060855033343010,"Block 3010, Block Group 3, Census Tract 5033.34, Santa Clara County, California",73,72,1
1000000US060855033361000,060855033361000,"Block 1000, Block Group 1, Census Tract 5033.36, Santa Clara County, California",29,28,1
1000000US060855033361001,060855033361001,"Block 1001, Block Group 1, Census Tract 5033.36, Santa Clara County, California",43,41,2
1000000US060855033361002,060855033361002,"Block 1002, Block Group 1, Census Tract 5033.36, Santa Clara County, California",15,15,0
1000000US060855033361003,060855033361003,"Block 1003, Block Group 1, Census Tract 5033.36, Santa Clara County, California",33,33,0
1000000US060855033361004,060855033361004,"Block 1004, Block Group 1, Census Tract 5033.36, Santa Clara County, California",180,173,7
1000000US060855033361005,060855033361005,"Block 1005, Block Group 1, Census Tract 5033.36, Santa Clara County, California",12,12,0
1000000US060855033361006,060855033361006,"Block 1006, Block Group 1, Census Tract 5033.36, Santa Clara County, California",42,40,2
1000000US060855033362000,060855033362000,"Block 2000, Block Group 2, Census Tract 5033.36, Santa Clara County, California",98,95,3
1000000US060855033362001,060855033362001,"Block 2001, Block Group 2, Census Tract 5033.36, Santa Clara County, California",35,33,2
1000000US060855033362002,060855033362002,"Block 2002, Block Group 2, Census Tract 5033.36, Santa Clara County, California",41,37,4
1000000US060855033362003,060855033362003,"Block 2003, Block Group 2, Census Tract 5033.36, Santa Clara County, California",38,36,2
1000000US060855033362004,060855033362004,"Block 2004, Block Group 2, Census Tract 5033.36, Santa Clara County, California",25,25,0
1000000US060855033362005,060855033362005,"Block 2005, Block Group 2, Census Tract 5033.36, Santa Clara County, California",53,51,2
1000000US060855033362006,060855033362006,"Block 2006, Block Group 2, Census Tract 5033.36, Santa Clara County, California",64,64,0
1000000US060855033362007,060855033362007,"Block 2007, Block Group 2, Census Tract 5033.36, Santa Clara County, California",43,40,3
1000000US060855033362008,060855033362008,"Block 2008, Block Group 2, Census Tract 5033.36, Santa Clara County, California",19,19,0
1000000US060855033362009,060855033362009,"Block 2009, Block Group 2, Census Tract 5033.36, Santa Clara County, California",34,33,1
1000000US060855033362010,060855033362010,"Block 2010, Block Group 2, Census Tract 5033.36, Santa Clara County, California",27,27,0
1000000US060855033362011,060855033362011,"Block 2011, Block Group 2, Census Tract 5033.36, Santa Clara County, California",1,1,0
1000000US060855033362012,060855033362012,"Block 2012, Block Group 2, Census Tract 5033.36, Santa Clara County, California",35,35,0
1000000US060855033371000,060855033371000,"Block 1000, Block Group 1, Census Tract 5033.37, Santa Clara County, California",54,51,3
1000000US060855033371001,060855033371001,"Block 1001, Block Group 1, Census Tract 5033.37, Santa Clara County, California",9,9,0
1000000US060855033371002,060855033371002,"Block 1002, Block Group 1, Census Tract 5033.37, Santa Clara County, California",30,29,1
1000000US060855033371003,060855033371003,"Block 1003, Block Group 1, Census Tract 5033.37, Santa Clara County, California",143,137,6
1000000US060855033371004,060855033371004,"Block 1004, Block Group 1, Census Tract 5033.37, Santa Clara County, California",45,45,0
1000000US060855033371005,060855033371005,"Block 1005, Block Group 1, Census Tract 5033.37, Santa Clara County, California",24,23,1
1000000US060855033371006,060855033371006,"Block 1006, Block Group 1, Census Tract 5033.37, Santa Clara County, California",29,28,1
1000000US060855033371007,060855033371007,"Block 1007, Block Group 1, Census Tract 5033.37, Santa Clara County, California",32,32,0
1000000US060855033371008,060855033371008,"Block 1008, Block Group 1, Census Tract 5033.37, Santa Clara County, California",27,26,1
1000000US060855033371009,060855033371009,"Block 1009, Block Group 1, Census Tract 5033.37, Santa Clara County, California",34,33,1
1000000US060855033371010,060855033371010,"Block 1010, Block Group 1, Census Tract 5033.37, Santa Clara County, California",0,0,0
1000000US060855033371011,060855033371011,"Block 1011, Block Group 1, Census Tract 5033.37, Santa Clara County, California",36,35,1
1000000US060855033371012,060855033371012,"Block 1012, Block Group 1, Census Tract 5033.37, Santa Clara County, California",34,32,2
1000000US060855033371013,060855033371013,"Block 1013, Block Group 1, Census Tract 5033.37, Santa Clara County, California",42,42,0
1000000US060855033371014,060855033371014,"Block 1014, Block Group 1, Census Tract 5033.37, Santa Clara County, California",32,32,0
1000000US060855033371015,060855033371015,"Block 1015, Block Group 1, Census Tract 5033.37, Santa Clara County, California",23,23,0
1000000US060855033372000,060855033372000,"Block 2000, Block Group 2, Census Tract 5033.37, Santa Clara County, California",31,30,1
1000000US060855033372001,060855033372001,"Block 2001, Block Group 2, Census Tract 5033.37, Santa Clara County, California",44,44,0
1000000US060855033372002,060855033372002,"Block 2002, Block Group 2, Census Tract 5033.37, Santa Clara County, California",3,3,0
1000000US060855033372003,060855033372003,"Block 2003, Block Group 2, Census Tract 5033.37, Santa Clara County, California",36,36,0
1000000US060855033372004,060855033372004,"Block 2004, Block Group 2, Census Tract 5033.37, Santa Clara County, California",36,36,0
1000000US060855033372005,060855033372005,"Block 2005, Block Group 2, Census Tract 5033.37, Santa Clara County, California",31,31,0
1000000US060855033372006,060855033372006,"Block 2006, Block Group 2, Census Tract 5033.37, Santa Clara County, California",15,14,1
1000000US060855033372007,060855033372007,"Block 2007, Block Group 2, Census Tract 5033.37, Santa Clara County, California",79,76,3
1000000US060855033372008,060855033372008,"Block 2008, Block Group 2, Census Tract 5033.37, Santa Clara County, California",32,32,0
1000000US060855033372009,060855033372009,"Block 2009, Block Group 2, Census Tract 5033.37, Santa Clara County, California",47,46,1
1000000US060855034011000,060855034011000,"Block 1000, Block Group 1, Census Tract 5034.01, Santa Clara County, California",28,28,0
1000000US060855034011001,060855034011001,"Block 1001, Block Group 1, Census Tract 5034.01, Santa Clara County, California",16,15,1
1000000US060855034011002,060855034011002,"Block 1002, Block Group 1, Census Tract 5034.01, Santa Clara County, California",29,26,3
1000000US060855034011003,060855034011003,"Block 1003, Block Group 1, Census Tract 5034.01, Santa Clara County, California",53,50,3
1000000US060855034011004,060855034011004,"Block 1004, Block Group 1, Census Tract 5034.01, Santa Clara County, California",44,43,1
1000000US060855034011005,060855034011005,"Block 1005, Block Group 1, Census Tract 5034.01, Santa Clara County, California",31,30,1
1000000US060855034011006,060855034011006,"Block 1006, Block Group 1, Census Tract 5034.01, Santa Clara County, California",36,34,2
1000000US060855034012000,060855034012000,"Block 2000, Block Group 2, Census Tract 5034.01, Santa Clara County, California",61,60,1
1000000US060855034012001,060855034012001,"Block 2001, Block Group 2, Census Tract 5034.01, Santa Clara County, California",53,51,2
1000000US060855034012002,060855034012002,"Block 2002, Block Group 2, Census Tract 5034.01, Santa Clara County, California",35,35,0
1000000US060855034012003,060855034012003,"Block 2003, Block Group 2, Census Tract 5034.01, Santa Clara County, California",55,54,1
1000000US060855034012004,060855034012004,"Block 2004, Block Group 2, Census Tract 5034.01, Santa Clara County, California",37,37,0
1000000US060855034012005,060855034012005,"Block 2005, Block Group 2, Census Tract 5034.01, Santa Clara County, California",34,34,0
1000000US060855034012006,060855034012006,"Block 2006, Block Group 2, Census Tract 5034.01, Santa Clara County, California",58,55,3
1000000US060855034013000,060855034013000,"Block 3000, Block Group 3, Census Tract 5034.01, Santa Clara County, California",53,51,2
1000000US060855034013001,060855034013001,"Block 3001, Block Group 3, Census Tract 5034.01, Santa Clara County, California",53,50,3
1000000US060855034013002,060855034013002,"Block 3002, Block Group 3, Census Tract 5034.01, Santa Clara County, California",0,0,0
1000000US060855034013003,060855034013003,"Block 3003, Block Group 3, Census Tract 5034.01, Santa Clara County, California",56,52,4
1000000US060855034013004,060855034013004,"Block 3004, Block Group 3, Census Tract 5034.01, Santa Clara County, California",50,49,1
1000000US060855034013005,060855034013005,"Block 3005, Block Group 3, Census Tract 5034.01, Santa Clara County, California",55,55,0
1000000US060855034013006,060855034013006,"Block 3006, Block Group 3, Census Tract 5034.01, Santa Clara County, California",31,29,2
1000000US060855034013007,060855034013007,"Block 3007, Block Group 3, Census Tract 5034.01, Santa Clara County, California",33,33,0
1000000US060855034013008,060855034013008,"Block 3008, Block Group 3, Census Tract 5034.01, Santa Clara County, California",45,44,1
1000000US060855034021000,060855034021000,"Block 1000, Block Group 1, Census Tract 5034.02, Santa Clara County, California",23,21,2
1000000US060855034022000,060855034022000,"Block 2000, Block Group 2, Census Tract 5034.02, Santa Clara County, California",18,17,1
1000000US060855034022001,060855034022001,"Block 2001, Block Group 2, Census Tract 5034.02, Santa Clara County, California",50,48,2
1000000US060855034022002,060855034022002,"Block 2002, Block Group 2, Census Tract 5034.02, Santa Clara County, California",23,23,0
1000000US060855034022003,060855034022003,"Block 2003, Block Group 2, Census Tract 5034.02, Santa Clara County, California",265,262,3
1000000US060855034022004,060855034022004,"Block 2004, Block Group 2, Census Tract 5034.02, Santa Clara County, California",21,21,0
1000000US060855034022005,060855034022005,"Block 2005, Block Group 2, Census Tract 5034.02, Santa Clara County, California",40,38,2
1000000US060855034022006,060855034022006,"Block 2006, Block Group 2, Census Tract 5034.02, Santa Clara County, California",24,23,1
1000000US060855034022007,060855034022007,"Block 2007, Block Group 2, Census Tract 5034.02, Santa Clara County, California",22,22,0
1000000US060855034023000,060855034023000,"Block 3000, Block Group 3, Census Tract 5034.02, Santa Clara County, California",0,0,0
1000000US060855034023001,060855034023001,"Block 3001, Block Group 3, Census Tract 5034.02, Santa Clara County, California",15,14,1
1000000US060855034023002,060855034023002,"Block 3002, Block Group 3, Census Tract 5034.02, Santa Clara County, California",31,31,0
1000000US060855034023003,060855034023003,"Block 3003, Block Group 3, Census Tract 5034.02, Santa Clara County, California",16,16,0
1000000US060855034023004,060855034023004,"Block 3004, Block Group 3, Census Tract 5034.02, Santa Clara County, California",15,15,0
1000000US060855034023005,060855034023005,"Block 3005, Block Group 3, Census Tract 5034.02, Santa Clara County, California",21,21,0
1000000US060855034023006,060855034023006,"Block 3006, Block Group 3, Census Tract 5034.02, Santa Clara County, California",390,348,42
1000000US060855034023007,060855034023007,"Block 3007, Block Group 3, Census Tract 5034.02, Santa Clara County, California",50,49,1
1000000US060855034023008,060855034023008,"Block 3008, Block Group 3, Census Tract 5034.02, Santa Clara County, California",30,30,0
1000000US060855034023009,060855034023009,"Block 3009, Block Group 3, Census Tract 5034.02, Santa Clara County, California",28,28,0
1000000US060855034023010,060855034023010,"Block 3010, Block Group 3, Census Tract 5034.02, Santa Clara County, California",56,54,2
1000000US060855034023011,060855034023011,"Block 3011, Block Group 3, Census Tract 5034.02, Santa Clara County, California",37,37,0
1000000US060855034023012,060855034023012,"Block 3012, Block Group 3, Census Tract 5034.02, Santa Clara County, California",9,9,0
1000000US060855034023013,060855034023013,"Block 3013, Block Group 3, Census Tract 5034.02, Santa Clara County, California",0,0,0
1000000US060855035041000,060855035041000,"Block 1000, Block Group 1, Census Tract 5035.04, Santa Clara County, California",31,31,0
1000000US060855035041001,060855035041001,"Block 1001, Block Group 1, Census Tract 5035.04, Santa Clara County, California",53,51,2
1000000US060855035041002,060855035041002,"Block 1002, Block Group 1, Census Tract 5035.04, Santa Clara County, California",62,58,4
1000000US060855035041003,060855035041003,"Block 1003, Block Group 1, Census Tract 5035.04, Santa Clara County, California",36,36,0
1000000US060855035041004,060855035041004,"Block 1004, Block Group 1, Census Tract 5035.04, Santa Clara County, California",51,51,0
1000000US060855035041005,060855035041005,"Block 1005, Block Group 1, Census Tract 5035.04, Santa Clara County, California",33,32,1
1000000US060855035042000,060855035042000,"Block 2000, Block Group 2, Census Tract 5035.04, Santa Clara County, California",74,74,0
1000000US060855035042001,060855035042001,"Block 2001, Block Group 2, Census Tract 5035.04, Santa Clara County, California",29,29,0
1000000US060855035042002,060855035042002,"Block 2002, Block Group 2, Census Tract 5035.04, Santa Clara County, California",29,27,2
1000000US060855035042003,060855035042003,"Block 2003, Block Group 2, Census Tract 5035.04, Santa Clara County, California",27,27,0
1000000US060855035042004,060855035042004,"Block 2004, Block Group 2, Census Tract 5035.04, Santa Clara County, California",35,35,0
1000000US060855035042005,060855035042005,"Block 2005, Block Group 2, Census Tract 5035.04, Santa Clara County, California",50,47,3
1000000US060855035042006,060855035042006,"Block 2006, Block Group 2, Census Tract 5035.04, Santa Clara County, California",28,28,0
1000000US060855035042007,060855035042007,"Block 2007, Block Group 2, Census Tract 5035.04, Santa Clara County, California",29,28,1
1000000US060855035043000,060855035043000,"Block 3000, Block Group 3, Census Tract 5035.04, Santa Clara County, California",52,49,3
1000000US060855035043001,060855035043001,"Block 3001, Block Group 3, Census Tract 5035.04, Santa Clara County, California",61,57,4
1000000US060855035043002,060855035043002,"Block 3002, Block Group 3, Census Tract 5035.04, Santa Clara County, California",44,42,2
1000000US060855035043003,060855035043003,"Block 3003, Block Group 3, Census Tract 5035.04, Santa Clara County, California",52,50,2
1000000US060855035043004,060855035043004,"Block 3004, Block Group 3, Census Tract 5035.04, Santa Clara County, California",53,50,3
1000000US060855035044000,060855035044000,"Block 4000, Block Group 4, Census Tract 5035.04, Santa Clara County, California",37,37,0
1000000US060855035044001,060855035044001,"Block 4001, Block Group 4, Census Tract 5035.04, Santa Clara County, California",28,27,1
1000000US060855035044002,060855035044002,"Block 4002, Block Group 4, Census Tract 5035.04, Santa Clara County, California",60,57,3
1000000US060855035044003,060855035044003,"Block 4003, Block Group 4, Census Tract 5035.04, Santa Clara County, California",43,39,4
1000000US060855035045000,060855035045000,"Block 5000, Block Group 5, Census Tract 5035.04, Santa Clara County, California",45,40,5
1000000US060855035045001,060855035045001,"Block 5001, Block Group 5, Census Tract 5035.04, Santa Clara County, California",41,41,0
1000000US060855035045002,060855035045002,"Block 5002, Block Group 5, Census Tract 5035.04, Santa Clara County, California",24,24,0
1000000US060855035045003,060855035045003,"Block 5003, Block Group 5, Census Tract 5035.04, Santa Clara County, California",49,49,0
1000000US060855035045004,060855035045004,"Block 5004, Block Group 5, Census Tract 5035.04, Santa Clara County, California",41,41,0
1000000US060855035061000,060855035061000,"Block 1000, Block Group 1, Census Tract 5035.06, Santa Clara County, California",216,213,3
1000000US060855035061001,060855035061001,"Block 1001, Block Group 1, Census Tract 5035.06, Santa Clara County, California",50,50,0
1000000US060855035061002,060855035061002,"Block 1002, Block Group 1, Census Tract 5035.06, Santa Clara County, California",0,0,0
1000000US060855035061003,060855035061003,"Block 1003, Block Group 1, Census Tract 5035.06, Santa Clara County, California",0,0,0
1000000US060855035061004,060855035061004,"Block 1004, Block Group 1, Census Tract 5035.06, Santa Clara County, California",0,0,0
1000000US060855035061005,060855035061005,"Block 1005, Block Group 1, Census Tract 5035.06, Santa Clara County, California",15,15,0
1000000US060855035061006,060855035061006,"Block 1006, Block Group 1, Census Tract 5035.06, Santa Clara County, California",135,133,2
1000000US060855035061007,060855035061007,"Block 1007, Block Group 1, Census Tract 5035.06, Santa Clara County, California",0,0,0
1000000US060855035061008,060855035061008,"Block 1008, Block Group 1, Census Tract 5035.06, Santa Clara County, California",28,28,0
1000000US060855035061009,060855035061009,"Block 1009, Block Group 1, Census Tract 5035.06, Santa Clara County, California",26,23,3
1000000US060855035061010,060855035061010,"Block 1010, Block Group 1, Census Tract 5035.06, Santa Clara County, California",29,28,1
1000000US060855035061011,060855035061011,"Block 1011, Block Group 1, Census Tract 5035.06, Santa Clara County, California",34,33,1
1000000US060855035062000,060855035062000,"Block 2000, Block Group 2, Census Tract 5035.06, Santa Clara County, California",32,32,0
1000000US060855035062001,060855035062001,"Block 2001, Block Group 2, Census Tract 5035.06, Santa Clara County, California",20,20,0
1000000US060855035062002,060855035062002,"Block 2002, Block Group 2, Census Tract 5035.06, Santa Clara County, California",29,29,0
1000000US060855035062003,060855035062003,"Block 2003, Block Group 2, Census Tract 5035.06, Santa Clara County, California",66,64,2
1000000US060855035062004,060855035062004,"Block 2004, Block Group 2, Census Tract 5035.06, Santa Clara County, California",45,41,4
1000000US060855035062005,060855035062005,"Block 2005, Block Group 2, Census Tract 5035.06, Santa Clara County, California",35,34,1
1000000US060855035062006,060855035062006,"Block 2006, Block Group 2, Census Tract 5035.06, Santa Clara County, California",37,36,1
1000000US060855035062007,060855035062007,"Block 2007, Block Group 2, Census Tract 5035.06, Santa Clara County, California",46,45,1
1000000US060855035062008,060855035062008,"Block 2008, Block Group 2, Census Tract 5035.06, Santa Clara County, California",49,49,0
1000000US060855035062009,060855035062009,"Block 2009, Block Group 2, Census Tract 5035.06, Santa Clara County, California",33,29,4
1000000US060855035062010,060855035062010,"Block 2010, Block Group 2, Census Tract 5035.06, Santa Clara County, California",38,38,0
1000000US060855035063000,060855035063000,"Block 3000, Block Group 3, Census Tract 5035.06, Santa Clara County, California",61,59,2
1000000US060855035063001,060855035063001,"Block 3001, Block Group 3, Census Tract 5035.06, Santa Clara County, California",22,22,0
1000000US060855035063002,060855035063002,"Block 3002, Block Group 3, Census Tract 5035.06, Santa Clara County, California",45,43,2
1000000US060855035063003,060855035063003,"Block 3003, Block Group 3, Census Tract 5035.06, Santa Clara County, California",50,49,1
1000000US060855035063004,060855035063004,"Block 3004, Block Group 3, Census Tract 5035.06, Santa Clara County, California",25,24,1
1000000US060855035063005,060855035063005,"Block 3005, Block Group 3, Census Tract 5035.06, Santa Clara County, California",40,39,1
1000000US060855035063006,060855035063006,"Block 3006, Block Group 3, Census Tract 5035.06, Santa Clara County, California",28,26,2
1000000US060855035063007,060855035063007,"Block 3007, Block Group 3, Census Tract 5035.06, Santa Clara County, California",0,0,0
1000000US060855035063008,060855035063008,"Block 3008, Block Group 3, Census Tract 5035.06, Santa Clara County, California",25,25,0
1000000US060855035071000,060855035071000,"Block 1000, Block Group 1, Census Tract 5035.07, Santa Clara County, California",39,38,1
1000000US060855035071001,060855035071001,"Block 1001, Block Group 1, Census Tract 5035.07, Santa Clara County, California",61,61,0
1000000US060855035071002,060855035071002,"Block 1002, Block Group 1, Census Tract 5035.07, Santa Clara County, California",35,35,0
1000000US060855035071003,060855035071003,"Block 1003, Block Group 1, Census Tract 5035.07, Santa Clara County, California",14,14,0
1000000US060855035071004,060855035071004,"Block 1004, Block Group 1, Census Tract 5035.07, Santa Clara County, California",45,44,1
1000000US060855035071005,060855035071005,"Block 1005, Block Group 1, Census Tract 5035.07, Santa Clara County, California",14,14,0
1000000US060855035071006,060855035071006,"Block 1006, Block Group 1, Census Tract 5035.07, Santa Clara County, California",15,13,2
1000000US060855035071007,060855035071007,"Block 1007, Block Group 1, Census Tract 5035.07, Santa Clara County, California",44,43,1
1000000US060855035072000,060855035072000,"Block 2000, Block Group 2, Census Tract 5035.07, Santa Clara County, California",41,40,1
1000000US060855035072001,060855035072001,"Block 2001, Block Group 2, Census Tract 5035.07, Santa Clara County, California",39,38,1
1000000US060855035072002,060855035072002,"Block 2002, Block Group 2, Census Tract 5035.07, Santa Clara County, California",33,32,1
1000000US060855035081000,060855035081000,"Block 1000, Block Group 1, Census Tract 5035.08, Santa Clara County, California",76,74,2
1000000US060855035081001,060855035081001,"Block 1001, Block Group 1, Census Tract 5035.08, Santa Clara County, California",28,28,0
1000000US060855035081002,060855035081002,"Block 1002, Block Group 1, Census Tract 5035.08, Santa Clara County, California",131,125,6
1000000US060855035081003,060855035081003,"Block 1003, Block Group 1, Census Tract 5035.08, Santa Clara County, California",27,26,1
1000000US060855035081004,060855035081004,"Block 1004, Block Group 1, Census Tract 5035.08, Santa Clara County, California",17,17,0
1000000US060855035081005,060855035081005,"Block 1005, Block Group 1, Census Tract 5035.08, Santa Clara County, California",53,51,2
1000000US060855035081006,060855035081006,"Block 1006, Block Group 1, Census Tract 5035.08, Santa Clara County, California",35,34,1
1000000US060855035081007,060855035081007,"Block 1007, Block Group 1, Census Tract 5035.08, Santa Clara County, California",41,39,2
1000000US060855035081008,060855035081008,"Block 1008, Block Group 1, Census Tract 5035.08, Santa Clara County, California",71,69,2
1000000US060855035081009,060855035081009,"Block 1009, Block Group 1, Census Tract 5035.08, Santa Clara County, California",40,39,1
1000000US060855035081010,060855035081010,"Block 1010, Block Group 1, Census Tract 5035.08, Santa Clara County, California",64,62,2
1000000US060855035081011,060855035081011,"Block 1011, Block Group 1, Census Tract 5035.08, Santa Clara County, California",11,11,0
1000000US060855035081012,060855035081012,"Block 1012, Block Group 1, Census Tract 5035.08, Santa Clara County, California",39,36,3
1000000US060855035081013,060855035081013,"Block 1013, Block Group 1, Census Tract 5035.08, Santa Clara County, California",39,36,3
1000000US060855035081014,060855035081014,"Block 1014, Block Group 1, Census Tract 5035.08, Santa Clara County, California",10,10,0
1000000US060855035081015,060855035081015,"Block 1015, Block Group 1, Census Tract 5035.08, Santa Clara County, California",25,25,0
1000000US060855035081016,060855035081016,"Block 1016, Block Group 1, Census Tract 5035.08, Santa Clara County, California",28,28,0
1000000US060855035081017,060855035081017,"Block 1017, Block Group 1, Census Tract 5035.08, Santa Clara County, California",30,28,2
1000000US060855035082000,060855035082000,"Block 2000, Block Group 2, Census Tract 5035.08, Santa Clara County, California",55,54,1
1000000US060855035082001,060855035082001,"Block 2001, Block Group 2, Census Tract 5035.08, Santa Clara County, California",42,42,0
1000000US060855035082002,060855035082002,"Block 2002, Block Group 2, Census Tract 5035.08, Santa Clara County, California",39,37,2
1000000US060855035082003,060855035082003,"Block 2003, Block Group 2, Census Tract 5035.08, Santa Clara County, California",37,36,1
1000000US060855035082004,060855035082004,"Block 2004, Block Group 2, Census Tract 5035.08, Santa Clara County, California",47,46,1
1000000US060855035082005,060855035082005,"Block 2005, Block Group 2, Census Tract 5035.08, Santa Clara County, California",45,44,1
1000000US060855035082006,060855035082006,"Block 2006, Block Group 2, Census Tract 5035.08, Santa Clara County, California",44,41,3
1000000US060855035082007,060855035082007,"Block 2007, Block Group 2, Census Tract 5035.08, Santa Clara County, California",42,41,1
1000000US060855035082008,060855035082008,"Block 2008, Block Group 2, Census Tract 5035.08, Santa Clara County, California",40,38,2
1000000US060855035082009,060855035082009,"Block 2009, Block Group 2, Census Tract 5035.08, Santa Clara County, California",47,45,2
1000000US060855035082010,060855035082010,"Block 2010, Block Group 2, Census Tract 5035.08, Santa Clara County, California",43,42,1
1000000US060855035082011,060855035082011,"Block 2011, Block Group 2, Census Tract 5035.08, Santa Clara County, California",22,21,1
1000000US060855035091000,060855035091000,"Block 1000, Block Group 1, Census Tract 5035.09, Santa Clara County, California",35,34,1
1000000US060855035091001,060855035091001,"Block 1001, Block Group 1, Census Tract 5035.09, Santa Clara County, California",37,36,1
1000000US060855035091002,060855035091002,"Block 1002, Block Group 1, Census Tract 5035.09, Santa Clara County, California",37,36,1
1000000US060855035091003,060855035091003,"Block 1003, Block Group 1, Census Tract 5035.09, Santa Clara County, California",27,27,0
1000000US060855035091004,060855035091004,"Block 1004, Block Group 1, Census Tract 5035.09, Santa Clara County, California",52,52,0
1000000US060855035091005,060855035091005,"Block 1005, Block Group 1, Census Tract 5035.09, Santa Clara County, California",36,34,2
1000000US060855035091006,060855035091006,"Block 1006, Block Group 1, Census Tract 5035.09, Santa Clara County, California",55,50,5
1000000US060855035091007,060855035091007,"Block 1007, Block Group 1, Census Tract 5035.09, Santa Clara County, California",39,37,2
1000000US060855035091008,060855035091008,"Block 1008, Block Group 1, Census Tract 5035.09, Santa Clara County, California",50,48,2
1000000US060855035091009,060855035091009,"Block 1009, Block Group 1, Census Tract 5035.09, Santa Clara County, California",29,29,0
1000000US060855035092000,060855035092000,"Block 2000, Block Group 2, Census Tract 5035.09, Santa Clara County, California",15,11,4
1000000US060855035092001,060855035092001,"Block 2001, Block Group 2, Census Tract 5035.09, Santa Clara County, California",19,18,1
1000000US060855035092002,060855035092002,"Block 2002, Block Group 2, Census Tract 5035.09, Santa Clara County, California",51,51,0
1000000US060855035092003,060855035092003,"Block 2003, Block Group 2, Census Tract 5035.09, Santa Clara County, California",34,34,0
1000000US060855035092004,060855035092004,"Block 2004, Block Group 2, Census Tract 5035.09, Santa Clara County, California",51,51,0
1000000US060855035092005,060855035092005,"Block 2005, Block Group 2, Census Tract 5035.09, Santa Clara County, California",22,22,0
1000000US060855035092006,060855035092006,"Block 2006, Block Group 2, Census Tract 5035.09, Santa Clara County, California",22,20,2
1000000US060855035093000,060855035093000,"Block 3000, Block Group 3, Census Tract 5035.09, Santa Clara County, California",19,18,1
1000000US060855035093001,060855035093001,"Block 3001, Block Group 3, Census Tract 5035.09, Santa Clara County, California",11,11,0
1000000US060855035093002,060855035093002,"Block 3002, Block Group 3, Census Tract 5035.09, Santa Clara County, California",32,32,0
1000000US060855035093003,060855035093003,"Block 3003, Block Group 3, Census Tract 5035.09, Santa Clara County, California",23,22,1
1000000US060855035093004,060855035093004,"Block 3004, Block Group 3, Census Tract 5035.09, Santa Clara County, California",39,38,1
1000000US060855035093005,060855035093005,"Block 3005, Block Group 3, Census Tract 5035.09, Santa Clara County, California",57,56,1
1000000US060855035093006,060855035093006,"Block 3006, Block Group 3, Census Tract 5035.09, Santa Clara County, California",9,9,0
1000000US060855035093007,060855035093007,"Block 3007, Block Group 3, Census Tract 5035.09, Santa Clara County, California",71,71,0
1000000US060855035101000,060855035101000,"Block 1000, Block Group 1, Census Tract 5035.10, Santa Clara County, California",101,98,3
1000000US060855035101001,060855035101001,"Block 1001, Block Group 1, Census Tract 5035.10, Santa Clara County, California",16,14,2
1000000US060855035101002,060855035101002,"Block 1002, Block Group 1, Census Tract 5035.10, Santa Clara County, California",93,91,2
1000000US060855035101003,060855035101003,"Block 1003, Block Group 1, Census Tract 5035.10, Santa Clara County, California",122,118,4
1000000US060855035101004,060855035101004,"Block 1004, Block Group 1, Census Tract 5035.10, Santa Clara County, California",169,161,8
1000000US060855035101005,060855035101005,"Block 1005, Block Group 1, Census Tract 5035.10, Santa Clara County, California",0,0,0
1000000US060855035101006,060855035101006,"Block 1006, Block Group 1, Census Tract 5035.10, Santa Clara County, California",0,0,0
1000000US060855035101007,060855035101007,"Block 1007, Block Group 1, Census Tract 5035.10, Santa Clara County, California",43,41,2
1000000US060855035101008,060855035101008,"Block 1008, Block Group 1, Census Tract 5035.10, Santa Clara County, California",17,17,0
1000000US060855035101009,060855035101009,"Block 1009, Block Group 1, Census Tract 5035.10, Santa Clara County, California",47,47,0
1000000US060855035102000,060855035102000,"Block 2000, Block Group 2, Census Tract 5035.10, Santa Clara County, California",41,40,1
1000000US060855035102001,060855035102001,"Block 2001, Block Group 2, Census Tract 5035.10, Santa Clara County, California",24,24,0
1000000US060855035102002,060855035102002,"Block 2002, Block Group 2, Census Tract 5035.10, Santa Clara County, California",159,152,7
1000000US060855035102003,060855035102003,"Block 2003, Block Group 2, Census Tract 5035.10, Santa Clara County, California",20,20,0
1000000US060855035102004,060855035102004,"Block 2004, Block Group 2, Census Tract 5035.10, Santa Clara County, California",23,23,0
1000000US060855035102005,060855035102005,"Block 2005, Block Group 2, Census Tract 5035.10, Santa Clara County, California",26,25,1
1000000US060855035102006,060855035102006,"Block 2006, Block Group 2, Census Tract 5035.10, Santa Clara County, California",38,37,1
1000000US060855035103000,060855035103000,"Block 3000, Block Group 3, Census Tract 5035.10, Santa Clara County, California",35,34,1
1000000US060855035103001,060855035103001,"Block 3001, Block Group 3, Census Tract 5035.10, Santa Clara County, California",35,35,0
1000000US060855035103002,060855035103002,"Block 3002, Block Group 3, Census Tract 5035.10, Santa Clara County, California",115,114,1
1000000US060855035103003,060855035103003,"Block 3003, Block Group 3, Census Tract 5035.10, Santa Clara County, California",20,19,1
1000000US060855035103004,060855035103004,"Block 3004, Block Group 3, Census Tract 5035.10, Santa Clara County, California",22,21,1
1000000US060855035103005,060855035103005,"Block 3005, Block Group 3, Census Tract 5035.10, Santa Clara County, California",0,0,0
1000000US060855035103006,060855035103006,"Block 3006, Block Group 3, Census Tract 5035.10, Santa Clara County, California",52,52,0
1000000US060855035103007,060855035103007,"Block 3007, Block Group 3, Census Tract 5035.10, Santa Clara County, California",36,36,0
1000000US060855035103008,060855035103008,"Block 3008, Block Group 3, Census Tract 5035.10, Santa Clara County, California",33,33,0
1000000US060855035103009,060855035103009,"Block 3009, Block Group 3, Census Tract 5035.10, Santa Clara County, California",53,51,2
1000000US060855035111000,060855035111000,"Block 1000, Block Group 1, Census Tract 5035.11, Santa Clara County, California",15,15,0
1000000US060855035111001,060855035111001,"Block 1001, Block Group 1, Census Tract 5035.11, Santa Clara County, California",26,26,0
1000000US060855035111002,060855035111002,"Block 1002, Block Group 1, Census Tract 5035.11, Santa Clara County, California",20,19,1
1000000US060855035111003,060855035111003,"Block 1003, Block Group 1, Census Tract 5035.11, Santa Clara County, California",53,53,0
1000000US060855035111004,060855035111004,"Block 1004, Block Group 1, Census Tract 5035.11, Santa Clara County, California",91,88,3
1000000US060855035111005,060855035111005,"Block 1005, Block Group 1, Census Tract 5035.11, Santa Clara County, California",24,22,2
1000000US060855035111006,060855035111006,"Block 1006, Block Group 1, Census Tract 5035.11, Santa Clara County, California",25,22,3
1000000US060855035111007,060855035111007,"Block 1007, Block Group 1, Census Tract 5035.11, Santa Clara County, California",40,38,2
1000000US060855035111008,060855035111008,"Block 1008, Block Group 1, Census Tract 5035.11, Santa Clara County, California",102,97,5
1000000US060855035112000,060855035112000,"Block 2000, Block Group 2, Census Tract 5035.11, Santa Clara County, California",39,38,1
1000000US060855035112001,060855035112001,"Block 2001, Block Group 2, Census Tract 5035.11, Santa Clara County, California",41,39,2
1000000US060855035112002,060855035112002,"Block 2002, Block Group 2, Census Tract 5035.11, Santa Clara County, California",35,34,1
1000000US060855035112003,060855035112003,"Block 2003, Block Group 2, Census Tract 5035.11, Santa Clara County, California",26,26,0
1000000US060855035112004,060855035112004,"Block 2004, Block Group 2, Census Tract 5035.11, Santa Clara County, California",34,34,0
1000000US060855035112005,060855035112005,"Block 2005, Block Group 2, Census Tract 5035.11, Santa Clara County, California",33,32,1
1000000US060855035112006,060855035112006,"Block 2006, Block Group 2, Census Tract 5035.11, Santa Clara County, California",48,45,3
1000000US060855035112007,060855035112007,"Block 2007, Block Group 2, Census Tract 5035.11, Santa Clara County, California",35,35,0
1000000US060855035112008,060855035112008,"Block 2008, Block Group 2, Census Tract 5035.11, Santa Clara County, California",57,57,0
1000000US060855035112009,060855035112009,"Block 2009, Block Group 2, Census Tract 5035.11, Santa Clara County, California",20,19,1
1000000US060855035112010,060855035112010,"Block 2010, Block Group 2, Census Tract 5035.11, Santa Clara County, California",25,25,0
1000000US060855035112011,060855035112011,"Block 2011, Block Group 2, Census Tract 5035.11, Santa Clara County, California",19,19,0
1000000US060855035112012,060855035112012,"Block 2012, Block Group 2, Census Tract 5035.11, Santa Clara County, California",21,20,1
1000000US060855035112013,060855035112013,"Block 2013, Block Group 2, Census Tract 5035.11, Santa Clara County, California",2,2,0
1000000US060855036011000,060855036011000,"Block 1000, Block Group 1, Census Tract 5036.01, Santa Clara County, California",0,0,0
1000000US060855036011001,060855036011001,"Block 1001, Block Group 1, Census Tract 5036.01, Santa Clara County, California",0,0,0
1000000US060855036011002,060855036011002,"Block 1002, Block Group 1, Census Tract 5036.01, Santa Clara County, California",0,0,0
1000000US060855036011003,060855036011003,"Block 1003, Block Group 1, Census Tract 5036.01, Santa Clara County, California",0,0,0
1000000US060855036011004,060855036011004,"Block 1004, Block Group 1, Census Tract 5036.01, Santa Clara County, California",0,0,0
1000000US060855036011005,060855036011005,"Block 1005, Block Group 1, Census Tract 5036.01, Santa Clara County, California",0,0,0
1000000US060855036011006,060855036011006,"Block 1006, Block Group 1, Census Tract 5036.01, Santa Clara County, California",1,1,0
1000000US060855036011007,060855036011007,"Block 1007, Block Group 1, Census Tract 5036.01, Santa Clara County, California",1,1,0
1000000US060855036011008,060855036011008,"Block 1008, Block Group 1, Census Tract 5036.01, Santa Clara County, California",143,132,11
1000000US060855036011009,060855036011009,"Block 1009, Block Group 1, Census Tract 5036.01, Santa Clara County, California",9,9,0
1000000US060855036011010,060855036011010,"Block 1010, Block Group 1, Census Tract 5036.01, Santa Clara County, California",27,26,1
1000000US060855036011011,060855036011011,"Block 1011, Block Group 1, Census Tract 5036.01, Santa Clara County, California",24,24,0
1000000US060855036011012,060855036011012,"Block 1012, Block Group 1, Census Tract 5036.01, Santa Clara County, California",26,26,0
1000000US060855036011013,060855036011013,"Block 1013, Block Group 1, Census Tract 5036.01, Santa Clara County, California",47,42,5
1000000US060855036011014,060855036011014,"Block 1014, Block Group 1, Census Tract 5036.01, Santa Clara County, California",0,0,0
1000000US060855036011015,060855036011015,"Block 1015, Block Group 1, Census Tract 5036.01, Santa Clara County, California",0,0,0
1000000US060855036011016,060855036011016,"Block 1016, Block Group 1, Census Tract 5036.01, Santa Clara County, California",7,7,0
1000000US060855036011017,060855036011017,"Block 1017, Block Group 1, Census Tract 5036.01, Santa Clara County, California",0,0,0
1000000US060855036012000,060855036012000,"Block 2000, Block Group 2, Census Tract 5036.01, Santa Clara County, California",36,35,1
1000000US060855036012001,060855036012001,"Block 2001, Block Group 2, Census Tract 5036.01, Santa Clara County, California",38,35,3
1000000US060855036012002,060855036012002,"Block 2002, Block Group 2, Census Tract 5036.01, Santa Clara County, California",38,36,2
1000000US060855036012003,060855036012003,"Block 2003, Block Group 2, Census Tract 5036.01, Santa Clara County, California",28,24,4
1000000US060855036012004,060855036012004,"Block 2004, Block Group 2, Census Tract 5036.01, Santa Clara County, California",74,72,2
1000000US060855036012005,060855036012005,"Block 2005, Block Group 2, Census Tract 5036.01, Santa Clara County, California",42,38,4
1000000US060855036012006,060855036012006,"Block 2006, Block Group 2, Census Tract 5036.01, Santa Clara County, California",7,6,1
1000000US060855036012007,060855036012007,"Block 2007, Block Group 2, Census Tract 5036.01, Santa Clara County, California",27,26,1
1000000US060855036012008,060855036012008,"Block 2008, Block Group 2, Census Tract 5036.01, Santa Clara County, California",179,177,2
1000000US060855036012009,060855036012009,"Block 2009, Block Group 2, Census Tract 5036.01, Santa Clara County, California",94,90,4
1000000US060855036012010,060855036012010,"Block 2010, Block Group 2, Census Tract 5036.01, Santa Clara County, California",43,42,1
1000000US060855036021000,060855036021000,"Block 1000, Block Group 1, Census Tract 5036.02, Santa Clara County, California",63,61,2
1000000US060855036021001,060855036021001,"Block 1001, Block Group 1, Census Tract 5036.02, Santa Clara County, California",31,26,5
1000000US060855036021002,060855036021002,"Block 1002, Block Group 1, Census Tract 5036.02, Santa Clara County, California",39,39,0
1000000US060855036021003,060855036021003,"Block 1003, Block Group 1, Census Tract 5036.02, Santa Clara County, California",39,38,1
1000000US060855036021004,060855036021004,"Block 1004, Block Group 1, Census Tract 5036.02, Santa Clara County, California",30,30,0
1000000US060855036021005,060855036021005,"Block 1005, Block Group 1, Census Tract 5036.02, Santa Clara County, California",31,31,0
1000000US060855036021006,060855036021006,"Block 1006, Block Group 1, Census Tract 5036.02, Santa Clara County, California",30,29,1
1000000US060855036021007,060855036021007,"Block 1007, Block Group 1, Census Tract 5036.02, Santa Clara County, California",26,26,0
1000000US060855036021008,060855036021008,"Block 1008, Block Group 1, Census Tract 5036.02, Santa Clara County, California",28,26,2
1000000US060855036021009,060855036021009,"Block 1009, Block Group 1, Census Tract 5036.02, Santa Clara County, California",28,27,1
1000000US060855036021010,060855036021010,"Block 1010, Block Group 1, Census Tract 5036.02, Santa Clara County, California",32,31,1
1000000US060855036021011,060855036021011,"Block 1011, Block Group 1, Census Tract 5036.02, Santa Clara County, California",29,27,2
1000000US060855036022000,060855036022000,"Block 2000, Block Group 2, Census Tract 5036.02, Santa Clara County, California",72,70,2
1000000US060855036022001,060855036022001,"Block 2001, Block Group 2, Census Tract 5036.02, Santa Clara County, California",27,25,2
1000000US060855036022002,060855036022002,"Block 2002, Block Group 2, Census Tract 5036.02, Santa Clara County, California",366,357,9
1000000US060855036022003,060855036022003,"Block 2003, Block Group 2, Census Tract 5036.02, Santa Clara County, California",0,0,0
1000000US060855036022004,060855036022004,"Block 2004, Block Group 2, Census Tract 5036.02, Santa Clara County, California",32,30,2
1000000US060855036022005,060855036022005,"Block 2005, Block Group 2, Census Tract 5036.02, Santa Clara County, California",20,18,2
1000000US060855036022006,060855036022006,"Block 2006, Block Group 2, Census Tract 5036.02, Santa Clara County, California",32,31,1
1000000US060855036022007,060855036022007,"Block 2007, Block Group 2, Census Tract 5036.02, Santa Clara County, California",32,32,0
1000000US060855036022008,060855036022008,"Block 2008, Block Group 2, Census Tract 5036.02, Santa Clara County, California",7,6,1
1000000US060855036023000,060855036023000,"Block 3000, Block Group 3, Census Tract 5036.02, Santa Clara County, California",37,37,0
1000000US060855036023001,060855036023001,"Block 3001, Block Group 3, Census Tract 5036.02, Santa Clara County, California",50,50,0
1000000US060855036023002,060855036023002,"Block 3002, Block Group 3, Census Tract 5036.02, Santa Clara County, California",132,129,3
1000000US060855036023003,060855036023003,"Block 3003, Block Group 3, Census Tract 5036.02, Santa Clara County, California",40,38,2
1000000US060855036023004,060855036023004,"Block 3004, Block Group 3, Census Tract 5036.02, Santa Clara County, California",16,16,0
1000000US060855036023005,060855036023005,"Block 3005, Block Group 3, Census Tract 5036.02, Santa Clara County, California",15,15,0
1000000US060855036023006,060855036023006,"Block 3006, Block Group 3, Census Tract 5036.02, Santa Clara County, California",1,1,0
1000000US060855037031000,060855037031000,"Block 1000, Block Group 1, Census Tract 5037.03, Santa Clara County, California",33,33,0
1000000US060855037031001,060855037031001,"Block 1001, Block Group 1, Census Tract 5037.03, Santa Clara County, California",21,21,0
1000000US060855037031002,060855037031002,"Block 1002, Block Group 1, Census Tract 5037.03, Santa Clara County, California",22,22,0
1000000US060855037031003,060855037031003,"Block 1003, Block Group 1, Census Tract 5037.03, Santa Clara County, California",21,21,0
1000000US060855037031004,060855037031004,"Block 1004, Block Group 1, Census Tract 5037.03, Santa Clara County, California",20,20,0
1000000US060855037031005,060855037031005,"Block 1005, Block Group 1, Census Tract 5037.03, Santa Clara County, California",37,35,2
1000000US060855037032000,060855037032000,"Block 2000, Block Group 2, Census Tract 5037.03, Santa Clara County, California",0,0,0
1000000US060855037032001,060855037032001,"Block 2001, Block Group 2, Census Tract 5037.03, Santa Clara County, California",35,33,2
1000000US060855037032002,060855037032002,"Block 2002, Block Group 2, Census Tract 5037.03, Santa Clara County, California",113,112,1
1000000US060855037032003,060855037032003,"Block 2003, Block Group 2, Census Tract 5037.03, Santa Clara County, California",34,34,0
1000000US060855037032004,060855037032004,"Block 2004, Block Group 2, Census Tract 5037.03, Santa Clara County, California",33,33,0
1000000US060855037032005,060855037032005,"Block 2005, Block Group 2, Census Tract 5037.03, Santa Clara County, California",25,25,0
1000000US060855037032006,060855037032006,"Block 2006, Block Group 2, Census Tract 5037.03, Santa Clara County, California",54,54,0
1000000US060855037033000,060855037033000,"Block 3000, Block Group 3, Census Tract 5037.03, Santa Clara County, California",18,17,1
1000000US060855037033001,060855037033001,"Block 3001, Block Group 3, Census Tract 5037.03, Santa Clara County, California",24,24,0
1000000US060855037033002,060855037033002,"Block 3002, Block Group 3, Census Tract 5037.03, Santa Clara County, California",75,74,1
1000000US060855037033003,060855037033003,"Block 3003, Block Group 3, Census Tract 5037.03, Santa Clara County, California",35,33,2
1000000US060855037033004,060855037033004,"Block 3004, Block Group 3, Census Tract 5037.03, Santa Clara County, California",30,30,0
1000000US060855037033005,060855037033005,"Block 3005, Block Group 3, Census Tract 5037.03, Santa Clara County, California",53,52,1
1000000US060855037033006,060855037033006,"Block 3006, Block Group 3, Census Tract 5037.03, Santa Clara County, California",216,214,2
1000000US060855037071000,060855037071000,"Block 1000, Block Group 1, Census Tract 5037.07, Santa Clara County, California",441,422,19
1000000US060855037071001,060855037071001,"Block 1001, Block Group 1, Census Tract 5037.07, Santa Clara County, California",4,4,0
1000000US060855037071002,060855037071002,"Block 1002, Block Group 1, Census Tract 5037.07, Santa Clara County, California",0,0,0
1000000US060855037071003,060855037071003,"Block 1003, Block Group 1, Census Tract 5037.07, Santa Clara County, California",6,6,0
1000000US060855037072000,060855037072000,"Block 2000, Block Group 2, Census Tract 5037.07, Santa Clara County, California",287,269,18
1000000US060855037072001,060855037072001,"Block 2001, Block Group 2, Census Tract 5037.07, Santa Clara County, California",20,19,1
1000000US060855037072002,060855037072002,"Block 2002, Block Group 2, Census Tract 5037.07, Santa Clara County, California",18,18,0
1000000US060855037072003,060855037072003,"Block 2003, Block Group 2, Census Tract 5037.07, Santa Clara County, California",38,38,0
1000000US060855037072004,060855037072004,"Block 2004, Block Group 2, Census Tract 5037.07, Santa Clara County, California",48,44,4
1000000US060855037072005,060855037072005,"Block 2005, Block Group 2, Census Tract 5037.07, Santa Clara County, California",19,19,0
1000000US060855037072006,060855037072006,"Block 2006, Block Group 2, Census Tract 5037.07, Santa Clara County, California",62,62,0
1000000US060855037072007,060855037072007,"Block 2007, Block Group 2, Census Tract 5037.07, Santa Clara County, California",37,36,1
1000000US060855037072008,060855037072008,"Block 2008, Block Group 2, Census Tract 5037.07, Santa Clara County, California",25,24,1
1000000US060855037072009,060855037072009,"Block 2009, Block Group 2, Census Tract 5037.07, Santa Clara County, California",24,20,4
1000000US060855037072010,060855037072010,"Block 2010, Block Group 2, Census Tract 5037.07, Santa Clara County, California",16,16,0
1000000US060855037072011,060855037072011,"Block 2011, Block Group 2, Census Tract 5037.07, Santa Clara County, California",2,2,0
1000000US060855037073000,060855037073000,"Block 3000, Block Group 3, Census Tract 5037.07, Santa Clara County, California",135,130,5
1000000US060855037073001,060855037073001,"Block 3001, Block Group 3, Census Tract 5037.07, Santa Clara County, California",46,40,6
1000000US060855037073002,060855037073002,"Block 3002, Block Group 3, Census Tract 5037.07, Santa Clara County, California",47,44,3
1000000US060855037073003,060855037073003,"Block 3003, Block Group 3, Census Tract 5037.07, Santa Clara County, California",4,4,0
1000000US060855037073004,060855037073004,"Block 3004, Block Group 3, Census Tract 5037.07, Santa Clara County, California",21,21,0
1000000US060855037073005,060855037073005,"Block 3005, Block Group 3, Census Tract 5037.07, Santa Clara County, California",34,32,2
1000000US060855037073006,060855037073006,"Block 3006, Block Group 3, Census Tract 5037.07, Santa Clara County, California",16,16,0
1000000US060855037073007,060855037073007,"Block 3007, Block Group 3, Census Tract 5037.07, Santa Clara County, California",13,13,0
1000000US060855037073008,060855037073008,"Block 3008, Block Group 3, Census Tract 5037.07, Santa Clara County, California",2,2,0
1000000US060855037073009,060855037073009,"Block 3009, Block Group 3, Census Tract 5037.07, Santa Clara County, California",17,15,2
1000000US060855037073010,060855037073010,"Block 3010, Block Group 3, Census Tract 5037.07, Santa Clara County, California",22,21,1
1000000US060855037081000,060855037081000,"Block 1000, Block Group 1, Census Tract 5037.08, Santa Clara County, California",315,311,4
1000000US060855037081001,060855037081001,"Block 1001, Block Group 1, Census Tract 5037.08, Santa Clara County, California",30,29,1
1000000US060855037081002,060855037081002,"Block 1002, Block Group 1, Census Tract 5037.08, Santa Clara County, California",23,23,0
1000000US060855037081003,060855037081003,"Block 1003, Block Group 1, Census Tract 5037.08, Santa Clara County, California",36,36,0
1000000US060855037081004,060855037081004,"Block 1004, Block Group 1, Census Tract 5037.08, Santa Clara County, California",27,27,0
1000000US060855037081005,060855037081005,"Block 1005, Block Group 1, Census Tract 5037.08, Santa Clara County, California",67,65,2
1000000US060855037081006,060855037081006,"Block 1006, Block Group 1, Census Tract 5037.08, Santa Clara County, California",26,23,3
1000000US060855037081007,060855037081007,"Block 1007, Block Group 1, Census Tract 5037.08, Santa Clara County, California",2,2,0
1000000US060855037081008,060855037081008,"Block 1008, Block Group 1, Census Tract 5037.08, Santa Clara County, California",25,25,0
1000000US060855037081009,060855037081009,"Block 1009, Block Group 1, Census Tract 5037.08, Santa Clara County, California",0,0,0
1000000US060855037082000,060855037082000,"Block 2000, Block Group 2, Census Tract 5037.08, Santa Clara County, California",65,65,0
1000000US060855037082001,060855037082001,"Block 2001, Block Group 2, Census Tract 5037.08, Santa Clara County, California",28,28,0
1000000US060855037082002,060855037082002,"Block 2002, Block Group 2, Census Tract 5037.08, Santa Clara County, California",47,47,0
1000000US060855037082003,060855037082003,"Block 2003, Block Group 2, Census Tract 5037.08, Santa Clara County, California",44,43,1
1000000US060855037091000,060855037091000,"Block 1000, Block Group 1, Census Tract 5037.09, Santa Clara County, California",2,2,0
1000000US060855037091001,060855037091001,"Block 1001, Block Group 1, Census Tract 5037.09, Santa Clara County, California",36,36,0
1000000US060855037091002,060855037091002,"Block 1002, Block Group 1, Census Tract 5037.09, Santa Clara County, California",17,17,0
1000000US060855037091003,060855037091003,"Block 1003, Block Group 1, Census Tract 5037.09, Santa Clara County, California",38,36,2
1000000US060855037091004,060855037091004,"Block 1004, Block Group 1, Census Tract 5037.09, Santa Clara County, California",27,27,0
1000000US060855037091005,060855037091005,"Block 1005, Block Group 1, Census Tract 5037.09, Santa Clara County, California",38,34,4
1000000US060855037091006,060855037091006,"Block 1006, Block Group 1, Census Tract 5037.09, Santa Clara County, California",119,116,3
1000000US060855037091007,060855037091007,"Block 1007, Block Group 1, Census Tract 5037.09, Santa Clara County, California",69,65,4
1000000US060855037091008,060855037091008,"Block 1008, Block Group 1, Census Tract 5037.09, Santa Clara County, California",60,58,2
1000000US060855037091009,060855037091009,"Block 1009, Block Group 1, Census Tract 5037.09, Santa Clara County, California",60,60,0
1000000US060855037091010,060855037091010,"Block 1010, Block Group 1, Census Tract 5037.09, Santa Clara County, California",25,24,1
1000000US060855037092000,060855037092000,"Block 2000, Block Group 2, Census Tract 5037.09, Santa Clara County, California",375,357,18
1000000US060855037092001,060855037092001,"Block 2001, Block Group 2, Census Tract 5037.09, Santa Clara County, California",45,43,2
1000000US060855037093000,060855037093000,"Block 3000, Block Group 3, Census Tract 5037.09, Santa Clara County, California",9,9,0
1000000US060855037093001,060855037093001,"Block 3001, Block Group 3, Census Tract 5037.09, Santa Clara County, California",483,476,7
1000000US060855037101000,060855037101000,"Block 1000, Block Group 1, Census Tract 5037.10, Santa Clara County, California",1,1,0
1000000US060855037101001,060855037101001,"Block 1001, Block Group 1, Census Tract 5037.10, Santa Clara County, California",135,129,6
1000000US060855037101002,060855037101002,"Block 1002, Block Group 1, Census Tract 5037.10, Santa Clara County, California",197,188,9
1000000US060855037101003,060855037101003,"Block 1003, Block Group 1, Census Tract 5037.10, Santa Clara County, California",49,48,1
1000000US060855037101004,060855037101004,"Block 1004, Block Group 1, Census Tract 5037.10, Santa Clara County, California",43,41,2
1000000US060855037102000,060855037102000,"Block 2000, Block Group 2, Census Tract 5037.10, Santa Clara County, California",32,31,1
1000000US060855037102001,060855037102001,"Block 2001, Block Group 2, Census Tract 5037.10, Santa Clara County, California",106,102,4
1000000US060855037102002,060855037102002,"Block 2002, Block Group 2, Census Tract 5037.10, Santa Clara County, California",257,254,3
1000000US060855037102003,060855037102003,"Block 2003, Block Group 2, Census Tract 5037.10, Santa Clara County, California",36,36,0
1000000US060855037102004,060855037102004,"Block 2004, Block Group 2, Census Tract 5037.10, Santa Clara County, California",81,80,1
1000000US060855037102005,060855037102005,"Block 2005, Block Group 2, Census Tract 5037.10, Santa Clara County, California",22,22,0
1000000US060855037111000,060855037111000,"Block 1000, Block Group 1, Census Tract 5037.11, Santa Clara County, California",55,51,4
1000000US060855037111001,060855037111001,"Block 1001, Block Group 1, Census Tract 5037.11, Santa Clara County, California",54,50,4
1000000US060855037111002,060855037111002,"Block 1002, Block Group 1, Census Tract 5037.11, Santa Clara County, California",51,48,3
1000000US060855037111003,060855037111003,"Block 1003, Block Group 1, Census Tract 5037.11, Santa Clara County, California",66,63,3
1000000US060855037111004,060855037111004,"Block 1004, Block Group 1, Census Tract 5037.11, Santa Clara County, California",44,44,0
1000000US060855037112000,060855037112000,"Block 2000, Block Group 2, Census Tract 5037.11, Santa Clara County, California",1,1,0
1000000US060855037112001,060855037112001,"Block 2001, Block Group 2, Census Tract 5037.11, Santa Clara County, California",109,104,5
1000000US060855037112002,060855037112002,"Block 2002, Block Group 2, Census Tract 5037.11, Santa Clara County, California",19,19,0
1000000US060855037112003,060855037112003,"Block 2003, Block Group 2, Census Tract 5037.11, Santa Clara County, California",33,32,1
1000000US060855037112004,060855037112004,"Block 2004, Block Group 2, Census Tract 5037.11, Santa Clara County, California",39,39,0
1000000US060855037112005,060855037112005,"Block 2005, Block Group 2, Census Tract 5037.11, Santa Clara County, California",47,44,3
1000000US060855037112006,060855037112006,"Block 2006, Block Group 2, Census Tract 5037.11, Santa Clara County, California",17,17,0
1000000US060855037112007,060855037112007,"Block 2007, Block Group 2, Census Tract 5037.11, Santa Clara County, California",14,14,0
1000000US060855037112008,060855037112008,"Block 2008, Block Group 2, Census Tract 5037.11, Santa Clara County, California",75,75,0
1000000US060855037112009,060855037112009,"Block 2009, Block Group 2, Census Tract 5037.11, Santa Clara County, California",58,57,1
1000000US060855037113000,060855037113000,"Block 3000, Block Group 3, Census Tract 5037.11, Santa Clara County, California",38,36,2
1000000US060855037113001,060855037113001,"Block 3001, Block Group 3, Census Tract 5037.11, Santa Clara County, California",51,47,4
1000000US060855037113002,060855037113002,"Block 3002, Block Group 3, Census Tract 5037.11, Santa Clara County, California",29,27,2
1000000US060855037113003,060855037113003,"Block 3003, Block Group 3, Census Tract 5037.11, Santa Clara County, California",35,34,1
1000000US060855037113004,060855037113004,"Block 3004, Block Group 3, Census Tract 5037.11, Santa Clara County, California",32,31,1
1000000US060855037113005,060855037113005,"Block 3005, Block Group 3, Census Tract 5037.11, Santa Clara County, California",37,37,0
1000000US060855037113006,060855037113006,"Block 3006, Block Group 3, Census Tract 5037.11, Santa Clara County, California",15,15,0
1000000US060855037113007,060855037113007,"Block 3007, Block Group 3, Census Tract 5037.11, Santa Clara County, California",17,16,1
1000000US060855037113008,060855037113008,"Block 3008, Block Group 3, Census Tract 5037.11, Santa Clara County, California",70,68,2
1000000US060855037121000,060855037121000,"Block 1000, Block Group 1, Census Tract 5037.12, Santa Clara County, California",0,0,0
1000000US060855037121001,060855037121001,"Block 1001, Block Group 1, Census Tract 5037.12, Santa Clara County, California",82,76,6
1000000US060855037121002,060855037121002,"Block 1002, Block Group 1, Census Tract 5037.12, Santa Clara County, California",142,135,7
1000000US060855037121003,060855037121003,"Block 1003, Block Group 1, Census Tract 5037.12, Santa Clara County, California",35,34,1
1000000US060855037121004,060855037121004,"Block 1004, Block Group 1, Census Tract 5037.12, Santa Clara County, California",66,62,4
1000000US060855037122000,060855037122000,"Block 2000, Block Group 2, Census Tract 5037.12, Santa Clara County, California",229,215,14
1000000US060855037122001,060855037122001,"Block 2001, Block Group 2, Census Tract 5037.12, Santa Clara County, California",46,43,3
1000000US060855037122002,060855037122002,"Block 2002, Block Group 2, Census Tract 5037.12, Santa Clara County, California",41,41,0
1000000US060855037122003,060855037122003,"Block 2003, Block Group 2, Census Tract 5037.12, Santa Clara County, California",66,63,3
1000000US060855037122004,060855037122004,"Block 2004, Block Group 2, Census Tract 5037.12, Santa Clara County, California",545,450,95
1000000US060855037122005,060855037122005,"Block 2005, Block Group 2, Census Tract 5037.12, Santa Clara County, California",62,58,4
1000000US060855037122006,060855037122006,"Block 2006, Block Group 2, Census Tract 5037.12, Santa Clara County, California",43,43,0
1000000US060855037131000,060855037131000,"Block 1000, Block Group 1, Census Tract 5037.13, Santa Clara County, California",380,357,23
1000000US060855037131001,060855037131001,"Block 1001, Block Group 1, Census Tract 5037.13, Santa Clara County, California",0,0,0
1000000US060855037131002,060855037131002,"Block 1002, Block Group 1, Census Tract 5037.13, Santa Clara County, California",0,0,0
1000000US060855037131003,060855037131003,"Block 1003, Block Group 1, Census Tract 5037.13, Santa Clara County, California",219,217,2
1000000US060855037131004,060855037131004,"Block 1004, Block Group 1, Census Tract 5037.13, Santa Clara County, California",85,78,7
1000000US060855037131005,060855037131005,"Block 1005, Block Group 1, Census Tract 5037.13, Santa Clara County, California",100,99,1
1000000US060855037131006,060855037131006,"Block 1006, Block Group 1, Census Tract 5037.13, Santa Clara County, California",49,47,2
1000000US060855037132000,060855037132000,"Block 2000, Block Group 2, Census Tract 5037.13, Santa Clara County, California",18,18,0
1000000US060855037132001,060855037132001,"Block 2001, Block Group 2, Census Tract 5037.13, Santa Clara County, California",5,5,0
1000000US060855037132002,060855037132002,"Block 2002, Block Group 2, Census Tract 5037.13, Santa Clara County, California",224,209,15
1000000US060855037132003,060855037132003,"Block 2003, Block Group 2, Census Tract 5037.13, Santa Clara County, California",42,42,0
1000000US060855038021000,060855038021000,"Block 1000, Block Group 1, Census Tract 5038.02, Santa Clara County, California",45,44,1
1000000US060855038021001,060855038021001,"Block 1001, Block Group 1, Census Tract 5038.02, Santa Clara County, California",51,49,2
1000000US060855038021002,060855038021002,"Block 1002, Block Group 1, Census Tract 5038.02, Santa Clara County, California",0,0,0
1000000US060855038021003,060855038021003,"Block 1003, Block Group 1, Census Tract 5038.02, Santa Clara County, California",26,26,0
1000000US060855038021004,060855038021004,"Block 1004, Block Group 1, Census Tract 5038.02, Santa Clara County, California",59,58,1
1000000US060855038021005,060855038021005,"Block 1005, Block Group 1, Census Tract 5038.02, Santa Clara County, California",27,27,0
1000000US060855038021006,060855038021006,"Block 1006, Block Group 1, Census Tract 5038.02, Santa Clara County, California",26,26,0
1000000US060855038021007,060855038021007,"Block 1007, Block Group 1, Census Tract 5038.02, Santa Clara County, California",30,29,1
1000000US060855038021008,060855038021008,"Block 1008, Block Group 1, Census Tract 5038.02, Santa Clara County, California",27,27,0
1000000US060855038021009,060855038021009,"Block 1009, Block Group 1, Census Tract 5038.02, Santa Clara County, California",19,18,1
1000000US060855038021010,060855038021010,"Block 1010, Block Group 1, Census Tract 5038.02, Santa Clara County, California",24,23,1
1000000US060855038021011,060855038021011,"Block 1011, Block Group 1, Census Tract 5038.02, Santa Clara County, California",45,44,1
1000000US060855038021012,060855038021012,"Block 1012, Block Group 1, Census Tract 5038.02, Santa Clara County, California",44,42,2
1000000US060855038021013,060855038021013,"Block 1013, Block Group 1, Census Tract 5038.02, Santa Clara County, California",30,30,0
1000000US060855038021014,060855038021014,"Block 1014, Block Group 1, Census Tract 5038.02, Santa Clara County, California",26,26,0
1000000US060855038021015,060855038021015,"Block 1015, Block Group 1, Census Tract 5038.02, Santa Clara County, California",32,32,0
1000000US060855038021016,060855038021016,"Block 1016, Block Group 1, Census Tract 5038.02, Santa Clara County, California",53,52,1
1000000US060855038021017,060855038021017,"Block 1017, Block Group 1, Census Tract 5038.02, Santa Clara County, California",54,51,3
1000000US060855038021018,060855038021018,"Block 1018, Block Group 1, Census Tract 5038.02, Santa Clara County, California",29,28,1
1000000US060855038021019,060855038021019,"Block 1019, Block Group 1, Census Tract 5038.02, Santa Clara County, California",25,24,1
1000000US060855038021020,060855038021020,"Block 1020, Block Group 1, Census Tract 5038.02, Santa Clara County, California",41,39,2
1000000US060855038021021,060855038021021,"Block 1021, Block Group 1, Census Tract 5038.02, Santa Clara County, California",2,2,0
1000000US060855038021022,060855038021022,"Block 1022, Block Group 1, Census Tract 5038.02, Santa Clara County, California",56,53,3
1000000US060855038021023,060855038021023,"Block 1023, Block Group 1, Census Tract 5038.02, Santa Clara County, California",44,43,1
1000000US060855038021024,060855038021024,"Block 1024, Block Group 1, Census Tract 5038.02, Santa Clara County, California",53,51,2
1000000US060855038021025,060855038021025,"Block 1025, Block Group 1, Census Tract 5038.02, Santa Clara County, California",26,26,0
1000000US060855038022000,060855038022000,"Block 2000, Block Group 2, Census Tract 5038.02, Santa Clara County, California",21,20,1
1000000US060855038022001,060855038022001,"Block 2001, Block Group 2, Census Tract 5038.02, Santa Clara County, California",21,21,0
1000000US060855038022002,060855038022002,"Block 2002, Block Group 2, Census Tract 5038.02, Santa Clara County, California",29,27,2
1000000US060855038022003,060855038022003,"Block 2003, Block Group 2, Census Tract 5038.02, Santa Clara County, California",30,29,1
1000000US060855038022004,060855038022004,"Block 2004, Block Group 2, Census Tract 5038.02, Santa Clara County, California",49,48,1
1000000US060855038022005,060855038022005,"Block 2005, Block Group 2, Census Tract 5038.02, Santa Clara County, California",26,26,0
1000000US060855038022006,060855038022006,"Block 2006, Block Group 2, Census Tract 5038.02, Santa Clara County, California",32,30,2
1000000US060855038022007,060855038022007,"Block 2007, Block Group 2, Census Tract 5038.02, Santa Clara County, California",5,4,1
1000000US060855038022008,060855038022008,"Block 2008, Block Group 2, Census Tract 5038.02, Santa Clara County, California",0,0,0
1000000US060855038022009,060855038022009,"Block 2009, Block Group 2, Census Tract 5038.02, Santa Clara County, California",14,11,3
1000000US060855038022010,060855038022010,"Block 2010, Block Group 2, Census Tract 5038.02, Santa Clara County, California",14,14,0
1000000US060855038023000,060855038023000,"Block 3000, Block Group 3, Census Tract 5038.02, Santa Clara County, California",12,11,1
1000000US060855038023001,060855038023001,"Block 3001, Block Group 3, Census Tract 5038.02, Santa Clara County, California",13,13,0
1000000US060855038023002,060855038023002,"Block 3002, Block Group 3, Census Tract 5038.02, Santa Clara County, California",14,13,1
1000000US060855038023003,060855038023003,"Block 3003, Block Group 3, Census Tract 5038.02, Santa Clara County, California",13,12,1
1000000US060855038023004,060855038023004,"Block 3004, Block Group 3, Census Tract 5038.02, Santa Clara County, California",12,11,1
1000000US060855038023005,060855038023005,"Block 3005, Block Group 3, Census Tract 5038.02, Santa Clara County, California",15,15,0
1000000US060855038023006,060855038023006,"Block 3006, Block Group 3, Census Tract 5038.02, Santa Clara County, California",14,14,0
1000000US060855038023007,060855038023007,"Block 3007, Block Group 3, Census Tract 5038.02, Santa Clara County, California",14,14,0
1000000US060855038023008,060855038023008,"Block 3008, Block Group 3, Census Tract 5038.02, Santa Clara County, California",16,16,0
1000000US060855038023009,060855038023009,"Block 3009, Block Group 3, Census Tract 5038.02, Santa Clara County, California",14,13,1
1000000US060855038023010,060855038023010,"Block 3010, Block Group 3, Census Tract 5038.02, Santa Clara County, California",41,39,2
1000000US060855038023011,060855038023011,"Block 3011, Block Group 3, Census Tract 5038.02, Santa Clara County, California",0,0,0
1000000US060855038023012,060855038023012,"Block 3012, Block Group 3, Census Tract 5038.02, Santa Clara County, California",157,147,10
1000000US060855038023013,060855038023013,"Block 3013, Block Group 3, Census Tract 5038.02, Santa Clara County, California",0,0,0
1000000US060855038024000,060855038024000,"Block 4000, Block Group 4, Census Tract 5038.02, Santa Clara County, California",8,8,0
1000000US060855038024001,060855038024001,"Block 4001, Block Group 4, Census Tract 5038.02, Santa Clara County, California",53,52,1
1000000US060855038024002,060855038024002,"Block 4002, Block Group 4, Census Tract 5038.02, Santa Clara County, California",30,29,1
1000000US060855038024003,060855038024003,"Block 4003, Block Group 4, Census Tract 5038.02, Santa Clara County, California",46,44,2
1000000US060855038024004,060855038024004,"Block 4004, Block Group 4, Census Tract 5038.02, Santa Clara County, California",26,26,0
1000000US060855038024005,060855038024005,"Block 4005, Block Group 4, Census Tract 5038.02, Santa Clara County, California",19,19,0
1000000US060855038024006,060855038024006,"Block 4006, Block Group 4, Census Tract 5038.02, Santa Clara County, California",68,67,1
1000000US060855038024007,060855038024007,"Block 4007, Block Group 4, Census Tract 5038.02, Santa Clara County, California",246,236,10
1000000US060855038024008,060855038024008,"Block 4008, Block Group 4, Census Tract 5038.02, Santa Clara County, California",133,122,11
1000000US060855038024009,060855038024009,"Block 4009, Block Group 4, Census Tract 5038.02, Santa Clara County, California",16,16,0
1000000US060855038024010,060855038024010,"Block 4010, Block Group 4, Census Tract 5038.02, Santa Clara County, California",32,32,0
1000000US060855038024011,060855038024011,"Block 4011, Block Group 4, Census Tract 5038.02, Santa Clara County, California",62,59,3
1000000US060855038024012,060855038024012,"Block 4012, Block Group 4, Census Tract 5038.02, Santa Clara County, California",35,34,1
1000000US060855038024013,060855038024013,"Block 4013, Block Group 4, Census Tract 5038.02, Santa Clara County, California",1,1,0
1000000US060855038024014,060855038024014,"Block 4014, Block Group 4, Census Tract 5038.02, Santa Clara County, California",50,50,0
1000000US060855038031000,060855038031000,"Block 1000, Block Group 1, Census Tract 5038.03, Santa Clara County, California",0,0,0
1000000US060855038031001,060855038031001,"Block 1001, Block Group 1, Census Tract 5038.03, Santa Clara County, California",0,0,0
1000000US060855038031002,060855038031002,"Block 1002, Block Group 1, Census Tract 5038.03, Santa Clara County, California",87,86,1
1000000US060855038031003,060855038031003,"Block 1003, Block Group 1, Census Tract 5038.03, Santa Clara County, California",22,21,1
1000000US060855038031004,060855038031004,"Block 1004, Block Group 1, Census Tract 5038.03, Santa Clara County, California",27,26,1
1000000US060855038031005,060855038031005,"Block 1005, Block Group 1, Census Tract 5038.03, Santa Clara County, California",20,20,0
1000000US060855038031006,060855038031006,"Block 1006, Block Group 1, Census Tract 5038.03, Santa Clara County, California",116,109,7
1000000US060855038031007,060855038031007,"Block 1007, Block Group 1, Census Tract 5038.03, Santa Clara County, California",39,39,0
1000000US060855038031008,060855038031008,"Block 1008, Block Group 1, Census Tract 5038.03, Santa Clara County, California",25,25,0
1000000US060855038031009,060855038031009,"Block 1009, Block Group 1, Census Tract 5038.03, Santa Clara County, California",104,100,4
1000000US060855038031010,060855038031010,"Block 1010, Block Group 1, Census Tract 5038.03, Santa Clara County, California",60,58,2
1000000US060855038031011,060855038031011,"Block 1011, Block Group 1, Census Tract 5038.03, Santa Clara County, California",160,150,10
1000000US060855038031012,060855038031012,"Block 1012, Block Group 1, Census Tract 5038.03, Santa Clara County, California",32,31,1
1000000US060855038031013,060855038031013,"Block 1013, Block Group 1, Census Tract 5038.03, Santa Clara County, California",24,24,0
1000000US060855038031014,060855038031014,"Block 1014, Block Group 1, Census Tract 5038.03, Santa Clara County, California",58,56,2
1000000US060855038031015,060855038031015,"Block 1015, Block Group 1, Census Tract 5038.03, Santa Clara County, California",47,46,1
1000000US060855038031016,060855038031016,"Block 1016, Block Group 1, Census Tract 5038.03, Santa Clara County, California",0,0,0
1000000US060855038032000,060855038032000,"Block 2000, Block Group 2, Census Tract 5038.03, Santa Clara County, California",66,66,0
1000000US060855038032001,060855038032001,"Block 2001, Block Group 2, Census Tract 5038.03, Santa Clara County, California",20,20,0
1000000US060855038032002,060855038032002,"Block 2002, Block Group 2, Census Tract 5038.03, Santa Clara County, California",125,125,0
1000000US060855038032003,060855038032003,"Block 2003, Block Group 2, Census Tract 5038.03, Santa Clara County, California",35,35,0
1000000US060855038032004,060855038032004,"Block 2004, Block Group 2, Census Tract 5038.03, Santa Clara County, California",43,40,3
1000000US060855038032005,060855038032005,"Block 2005, Block Group 2, Census Tract 5038.03, Santa Clara County, California",85,85,0
1000000US060855038032006,060855038032006,"Block 2006, Block Group 2, Census Tract 5038.03, Santa Clara County, California",41,40,1
1000000US060855038032007,060855038032007,"Block 2007, Block Group 2, Census Tract 5038.03, Santa Clara County, California",30,30,0
1000000US060855038032008,060855038032008,"Block 2008, Block Group 2, Census Tract 5038.03, Santa Clara County, California",73,71,2
1000000US060855038032009,060855038032009,"Block 2009, Block Group 2, Census Tract 5038.03, Santa Clara County, California",26,26,0
1000000US060855038041000,060855038041000,"Block 1000, Block Group 1, Census Tract 5038.04, Santa Clara County, California",104,101,3
1000000US060855038041001,060855038041001,"Block 1001, Block Group 1, Census Tract 5038.04, Santa Clara County, California",17,17,0
1000000US060855038041002,060855038041002,"Block 1002, Block Group 1, Census Tract 5038.04, Santa Clara County, California",29,28,1
1000000US060855038041003,060855038041003,"Block 1003, Block Group 1, Census Tract 5038.04, Santa Clara County, California",41,39,2
1000000US060855038041004,060855038041004,"Block 1004, Block Group 1, Census Tract 5038.04, Santa Clara County, California",28,28,0
1000000US060855038041005,060855038041005,"Block 1005, Block Group 1, Census Tract 5038.04, Santa Clara County, California",43,20,23
1000000US060855038041006,060855038041006,"Block 1006, Block Group 1, Census Tract 5038.04, Santa Clara County, California",17,6,11
1000000US060855038041007,060855038041007,"Block 1007, Block Group 1, Census Tract 5038.04, Santa Clara County, California",33,31,2
1000000US060855038041008,060855038041008,"Block 1008, Block Group 1, Census Tract 5038.04, Santa Clara County, California",52,49,3
1000000US060855038041009,060855038041009,"Block 1009, Block Group 1, Census Tract 5038.04, Santa Clara County, California",30,27,3
1000000US060855038041010,060855038041010,"Block 1010, Block Group 1, Census Tract 5038.04, Santa Clara County, California",6,6,0
1000000US060855038041011,060855038041011,"Block 1011, Block Group 1, Census Tract 5038.04, Santa Clara County, California",1,1,0
1000000US060855038041012,060855038041012,"Block 1012, Block Group 1, Census Tract 5038.04, Santa Clara County, California",23,23,0
1000000US060855038041013,060855038041013,"Block 1013, Block Group 1, Census Tract 5038.04, Santa Clara County, California",25,25,0
1000000US060855038041014,060855038041014,"Block 1014, Block Group 1, Census Tract 5038.04, Santa Clara County, California",56,53,3
1000000US060855038041015,060855038041015,"Block 1015, Block Group 1, Census Tract 5038.04, Santa Clara County, California",8,7,1
1000000US060855038041016,060855038041016,"Block 1016, Block Group 1, Census Tract 5038.04, Santa Clara County, California",60,60,0
1000000US060855038041017,060855038041017,"Block 1017, Block Group 1, Census Tract 5038.04, Santa Clara County, California",51,50,1
1000000US060855038041018,060855038041018,"Block 1018, Block Group 1, Census Tract 5038.04, Santa Clara County, California",29,27,2
1000000US060855038041019,060855038041019,"Block 1019, Block Group 1, Census Tract 5038.04, Santa Clara County, California",14,14,0
1000000US060855038042000,060855038042000,"Block 2000, Block Group 2, Census Tract 5038.04, Santa Clara County, California",21,18,3
1000000US060855038042001,060855038042001,"Block 2001, Block Group 2, Census Tract 5038.04, Santa Clara County, California",0,0,0
1000000US060855038042002,060855038042002,"Block 2002, Block Group 2, Census Tract 5038.04, Santa Clara County, California",0,0,0
1000000US060855038042003,060855038042003,"Block 2003, Block Group 2, Census Tract 5038.04, Santa Clara County, California",11,11,0
1000000US060855038042004,060855038042004,"Block 2004, Block Group 2, Census Tract 5038.04, Santa Clara County, California",13,13,0
1000000US060855038042005,060855038042005,"Block 2005, Block Group 2, Census Tract 5038.04, Santa Clara County, California",0,0,0
1000000US060855038042006,060855038042006,"Block 2006, Block Group 2, Census Tract 5038.04, Santa Clara County, California",27,24,3
1000000US060855038042007,060855038042007,"Block 2007, Block Group 2, Census Tract 5038.04, Santa Clara County, California",0,0,0
1000000US060855038042008,060855038042008,"Block 2008, Block Group 2, Census Tract 5038.04, Santa Clara County, California",33,31,2
1000000US060855038042009,060855038042009,"Block 2009, Block Group 2, Census Tract 5038.04, Santa Clara County, California",31,25,6
1000000US060855038042010,060855038042010,"Block 2010, Block Group 2, Census Tract 5038.04, Santa Clara County, California",12,11,1
1000000US060855038042011,060855038042011,"Block 2011, Block Group 2, Census Tract 5038.04, Santa Clara County, California",6,6,0
1000000US060855038042012,060855038042012,"Block 2012, Block Group 2, Census Tract 5038.04, Santa Clara County, California",6,6,0
1000000US060855038042013,060855038042013,"Block 2013, Block Group 2, Census Tract 5038.04, Santa Clara County, California",18,17,1
1000000US060855038042014,060855038042014,"Block 2014, Block Group 2, Census Tract 5038.04, Santa Clara County, California",0,0,0
1000000US060855038042015,060855038042015,"Block 2015, Block Group 2, Census Tract 5038.04, Santa Clara County, California",112,108,4
1000000US060855038042016,060855038042016,"Block 2016, Block Group 2, Census Tract 5038.04, Santa Clara County, California",29,27,2
1000000US060855038042017,060855038042017,"Block 2017, Block Group 2, Census Tract 5038.04, Santa Clara County, California",14,14,0
1000000US060855038043000,060855038043000,"Block 3000, Block Group 3, Census Tract 5038.04, Santa Clara County, California",8,2,6
1000000US060855038043001,060855038043001,"Block 3001, Block Group 3, Census Tract 5038.04, Santa Clara County, California",38,26,12
1000000US060855038043002,060855038043002,"Block 3002, Block Group 3, Census Tract 5038.04, Santa Clara County, California",143,140,3
1000000US060855038043003,060855038043003,"Block 3003, Block Group 3, Census Tract 5038.04, Santa Clara County, California",0,0,0
1000000US060855038043004,060855038043004,"Block 3004, Block Group 3, Census Tract 5038.04, Santa Clara County, California",59,59,0
1000000US060855038043005,060855038043005,"Block 3005, Block Group 3, Census Tract 5038.04, Santa Clara County, California",16,15,1
1000000US060855038043006,060855038043006,"Block 3006, Block Group 3, Census Tract 5038.04, Santa Clara County, California",14,14,0
1000000US060855038043007,060855038043007,"Block 3007, Block Group 3, Census Tract 5038.04, Santa Clara County, California",14,14,0
1000000US060855038043008,060855038043008,"Block 3008, Block Group 3, Census Tract 5038.04, Santa Clara County, California",14,14,0
1000000US060855038043009,060855038043009,"Block 3009, Block Group 3, Census Tract 5038.04, Santa Clara County, California",20,17,3
1000000US060855038043010,060855038043010,"Block 3010, Block Group 3, Census Tract 5038.04, Santa Clara County, California",96,90,6
1000000US060855038043011,060855038043011,"Block 3011, Block Group 3, Census Tract 5038.04, Santa Clara County, California",28,23,5
1000000US060855038043012,060855038043012,"Block 3012, Block Group 3, Census Tract 5038.04, Santa Clara County, California",32,31,1
1000000US060855038043013,060855038043013,"Block 3013, Block Group 3, Census Tract 5038.04, Santa Clara County, California",123,112,11
1000000US060855039021000,060855039021000,"Block 1000, Block Group 1, Census Tract 5039.02, Santa Clara County, California",49,49,0
1000000US060855039021001,060855039021001,"Block 1001, Block Group 1, Census Tract 5039.02, Santa Clara County, California",138,129,9
1000000US060855039021002,060855039021002,"Block 1002, Block Group 1, Census Tract 5039.02, Santa Clara County, California",1,1,0
1000000US060855039021003,060855039021003,"Block 1003, Block Group 1, Census Tract 5039.02, Santa Clara County, California",3,3,0
1000000US060855039021004,060855039021004,"Block 1004, Block Group 1, Census Tract 5039.02, Santa Clara County, California",3,2,1
1000000US060855039021005,060855039021005,"Block 1005, Block Group 1, Census Tract 5039.02, Santa Clara County, California",86,75,11
1000000US060855039021006,060855039021006,"Block 1006, Block Group 1, Census Tract 5039.02, Santa Clara County, California",68,67,1
1000000US060855039021007,060855039021007,"Block 1007, Block Group 1, Census Tract 5039.02, Santa Clara County, California",23,23,0
1000000US060855039021008,060855039021008,"Block 1008, Block Group 1, Census Tract 5039.02, Santa Clara County, California",3,2,1
1000000US060855039021009,060855039021009,"Block 1009, Block Group 1, Census Tract 5039.02, Santa Clara County, California",24,23,1
1000000US060855039021010,060855039021010,"Block 1010, Block Group 1, Census Tract 5039.02, Santa Clara County, California",34,34,0
1000000US060855039021011,060855039021011,"Block 1011, Block Group 1, Census Tract 5039.02, Santa Clara County, California",5,5,0
1000000US060855039021012,060855039021012,"Block 1012, Block Group 1, Census Tract 5039.02, Santa Clara County, California",21,20,1
1000000US060855039021013,060855039021013,"Block 1013, Block Group 1, Census Tract 5039.02, Santa Clara County, California",1,1,0
1000000US060855039022000,060855039022000,"Block 2000, Block Group 2, Census Tract 5039.02, Santa Clara County, California",11,11,0
1000000US060855039022001,060855039022001,"Block 2001, Block Group 2, Census Tract 5039.02, Santa Clara County, California",4,4,0
1000000US060855039022002,060855039022002,"Block 2002, Block Group 2, Census Tract 5039.02, Santa Clara County, California",13,12,1
1000000US060855039022003,060855039022003,"Block 2003, Block Group 2, Census Tract 5039.02, Santa Clara County, California",32,32,0
1000000US060855039022004,060855039022004,"Block 2004, Block Group 2, Census Tract 5039.02, Santa Clara County, California",39,39,0
1000000US060855039022005,060855039022005,"Block 2005, Block Group 2, Census Tract 5039.02, Santa Clara County, California",57,54,3
1000000US060855039022006,060855039022006,"Block 2006, Block Group 2, Census Tract 5039.02, Santa Clara County, California",0,0,0
1000000US060855039022007,060855039022007,"Block 2007, Block Group 2, Census Tract 5039.02, Santa Clara County, California",16,15,1
1000000US060855039022008,060855039022008,"Block 2008, Block Group 2, Census Tract 5039.02, Santa Clara County, California",42,39,3
1000000US060855039022009,060855039022009,"Block 2009, Block Group 2, Census Tract 5039.02, Santa Clara County, California",5,5,0
1000000US060855039022010,060855039022010,"Block 2010, Block Group 2, Census Tract 5039.02, Santa Clara County, California",40,39,1
1000000US060855039022011,060855039022011,"Block 2011, Block Group 2, Census Tract 5039.02, Santa Clara County, California",1,1,0
1000000US060855039023000,060855039023000,"Block 3000, Block Group 3, Census Tract 5039.02, Santa Clara County, California",32,26,6
1000000US060855039023001,060855039023001,"Block 3001, Block Group 3, Census Tract 5039.02, Santa Clara County, California",48,48,0
1000000US060855039023002,060855039023002,"Block 3002, Block Group 3, Census Tract 5039.02, Santa Clara County, California",21,21,0
1000000US060855039023003,060855039023003,"Block 3003, Block Group 3, Census Tract 5039.02, Santa Clara County, California",24,22,2
1000000US060855039023004,060855039023004,"Block 3004, Block Group 3, Census Tract 5039.02, Santa Clara County, California",30,26,4
1000000US060855039023005,060855039023005,"Block 3005, Block Group 3, Census Tract 5039.02, Santa Clara County, California",23,22,1
1000000US060855039023006,060855039023006,"Block 3006, Block Group 3, Census Tract 5039.02, Santa Clara County, California",14,14,0
1000000US060855039023007,060855039023007,"Block 3007, Block Group 3, Census Tract 5039.02, Santa Clara County, California",20,20,0
1000000US060855039023008,060855039023008,"Block 3008, Block Group 3, Census Tract 5039.02, Santa Clara County, California",17,17,0
1000000US060855039023009,060855039023009,"Block 3009, Block Group 3, Census Tract 5039.02, Santa Clara County, California",21,21,0
1000000US060855039023010,060855039023010,"Block 3010, Block Group 3, Census Tract 5039.02, Santa Clara County, California",9,9,0
1000000US060855039023011,060855039023011,"Block 3011, Block Group 3, Census Tract 5039.02, Santa Clara County, California",0,0,0
1000000US060855039023012,060855039023012,"Block 3012, Block Group 3, Census Tract 5039.02, Santa Clara County, California",11,11,0
1000000US060855039023013,060855039023013,"Block 3013, Block Group 3, Census Tract 5039.02, Santa Clara County, California",38,34,4
1000000US060855039024000,060855039024000,"Block 4000, Block Group 4, Census Tract 5039.02, Santa Clara County, California",27,24,3
1000000US060855039024001,060855039024001,"Block 4001, Block Group 4, Census Tract 5039.02, Santa Clara County, California",2,2,0
1000000US060855039024002,060855039024002,"Block 4002, Block Group 4, Census Tract 5039.02, Santa Clara County, California",139,135,4
1000000US060855039024003,060855039024003,"Block 4003, Block Group 4, Census Tract 5039.02, Santa Clara County, California",10,10,0
1000000US060855039024004,060855039024004,"Block 4004, Block Group 4, Census Tract 5039.02, Santa Clara County, California",17,17,0
1000000US060855039024005,060855039024005,"Block 4005, Block Group 4, Census Tract 5039.02, Santa Clara County, California",28,28,0
1000000US060855039024006,060855039024006,"Block 4006, Block Group 4, Census Tract 5039.02, Santa Clara County, California",16,14,2
1000000US060855039024007,060855039024007,"Block 4007, Block Group 4, Census Tract 5039.02, Santa Clara County, California",120,116,4
1000000US060855039024008,060855039024008,"Block 4008, Block Group 4, Census Tract 5039.02, Santa Clara County, California",32,29,3
1000000US060855039024009,060855039024009,"Block 4009, Block Group 4, Census Tract 5039.02, Santa Clara County, California",62,60,2
1000000US060855039024010,060855039024010,"Block 4010, Block Group 4, Census Tract 5039.02, Santa Clara County, California",10,9,1
1000000US060855039031000,060855039031000,"Block 1000, Block Group 1, Census Tract 5039.03, Santa Clara County, California",38,35,3
1000000US060855039031001,060855039031001,"Block 1001, Block Group 1, Census Tract 5039.03, Santa Clara County, California",27,26,1
1000000US060855039031002,060855039031002,"Block 1002, Block Group 1, Census Tract 5039.03, Santa Clara County, California",26,26,0
1000000US060855039031003,060855039031003,"Block 1003, Block Group 1, Census Tract 5039.03, Santa Clara County, California",74,73,1
1000000US060855039031004,060855039031004,"Block 1004, Block Group 1, Census Tract 5039.03, Santa Clara County, California",30,30,0
1000000US060855039031005,060855039031005,"Block 1005, Block Group 1, Census Tract 5039.03, Santa Clara County, California",17,17,0
1000000US060855039031006,060855039031006,"Block 1006, Block Group 1, Census Tract 5039.03, Santa Clara County, California",1,1,0
1000000US060855039031007,060855039031007,"Block 1007, Block Group 1, Census Tract 5039.03, Santa Clara County, California",22,22,0
1000000US060855039031008,060855039031008,"Block 1008, Block Group 1, Census Tract 5039.03, Santa Clara County, California",38,37,1
1000000US060855039031009,060855039031009,"Block 1009, Block Group 1, Census Tract 5039.03, Santa Clara County, California",28,28,0
1000000US060855039031010,060855039031010,"Block 1010, Block Group 1, Census Tract 5039.03, Santa Clara County, California",0,0,0
1000000US060855039031011,060855039031011,"Block 1011, Block Group 1, Census Tract 5039.03, Santa Clara County, California",204,190,14
1000000US060855039031012,060855039031012,"Block 1012, Block Group 1, Census Tract 5039.03, Santa Clara County, California",25,25,0
1000000US060855039031013,060855039031013,"Block 1013, Block Group 1, Census Tract 5039.03, Santa Clara County, California",69,67,2
1000000US060855039032000,060855039032000,"Block 2000, Block Group 2, Census Tract 5039.03, Santa Clara County, California",1,1,0
1000000US060855039032001,060855039032001,"Block 2001, Block Group 2, Census Tract 5039.03, Santa Clara County, California",28,27,1
1000000US060855039032002,060855039032002,"Block 2002, Block Group 2, Census Tract 5039.03, Santa Clara County, California",31,30,1
1000000US060855039032003,060855039032003,"Block 2003, Block Group 2, Census Tract 5039.03, Santa Clara County, California",31,31,0
1000000US060855039032004,060855039032004,"Block 2004, Block Group 2, Census Tract 5039.03, Santa Clara County, California",38,38,0
1000000US060855039032005,060855039032005,"Block 2005, Block Group 2, Census Tract 5039.03, Santa Clara County, California",43,40,3
1000000US060855039032006,060855039032006,"Block 2006, Block Group 2, Census Tract 5039.03, Santa Clara County, California",2,2,0
1000000US060855039032007,060855039032007,"Block 2007, Block Group 2, Census Tract 5039.03, Santa Clara County, California",4,4,0
1000000US060855039032008,060855039032008,"Block 2008, Block Group 2, Census Tract 5039.03, Santa Clara County, California",5,5,0
1000000US060855039032009,060855039032009,"Block 2009, Block Group 2, Census Tract 5039.03, Santa Clara County, California",40,34,6
1000000US060855039032010,060855039032010,"Block 2010, Block Group 2, Census Tract 5039.03, Santa Clara County, California",37,34,3
1000000US060855039032011,060855039032011,"Block 2011, Block Group 2, Census Tract 5039.03, Santa Clara County, California",34,33,1
1000000US060855039032012,060855039032012,"Block 2012, Block Group 2, Census Tract 5039.03, Santa Clara County, California",0,0,0
1000000US060855039032013,060855039032013,"Block 2013, Block Group 2, Census Tract 5039.03, Santa Clara County, California",0,0,0
1000000US060855039032014,060855039032014,"Block 2014, Block Group 2, Census Tract 5039.03, Santa Clara County, California",4,4,0
1000000US060855039032015,060855039032015,"Block 2015, Block Group 2, Census Tract 5039.03, Santa Clara County, California",8,8,0
1000000US060855039032016,060855039032016,"Block 2016, Block Group 2, Census Tract 5039.03, Santa Clara County, California",12,11,1
1000000US060855039032017,060855039032017,"Block 2017, Block Group 2, Census Tract 5039.03, Santa Clara County, California",3,3,0
1000000US060855040011000,060855040011000,"Block 1000, Block Group 1, Census Tract 5040.01, Santa Clara County, California",1,1,0
1000000US060855040011001,060855040011001,"Block 1001, Block Group 1, Census Tract 5040.01, Santa Clara County, California",34,31,3
1000000US060855040011002,060855040011002,"Block 1002, Block Group 1, Census Tract 5040.01, Santa Clara County, California",27,27,0
1000000US060855040011003,060855040011003,"Block 1003, Block Group 1, Census Tract 5040.01, Santa Clara County, California",26,26,0
1000000US060855040011004,060855040011004,"Block 1004, Block Group 1, Census Tract 5040.01, Santa Clara County, California",28,26,2
1000000US060855040011005,060855040011005,"Block 1005, Block Group 1, Census Tract 5040.01, Santa Clara County, California",27,26,1
1000000US060855040011006,060855040011006,"Block 1006, Block Group 1, Census Tract 5040.01, Santa Clara County, California",2,2,0
1000000US060855040011007,060855040011007,"Block 1007, Block Group 1, Census Tract 5040.01, Santa Clara County, California",11,10,1
1000000US060855040011008,060855040011008,"Block 1008, Block Group 1, Census Tract 5040.01, Santa Clara County, California",11,11,0
1000000US060855040011009,060855040011009,"Block 1009, Block Group 1, Census Tract 5040.01, Santa Clara County, California",16,13,3
1000000US060855040011010,060855040011010,"Block 1010, Block Group 1, Census Tract 5040.01, Santa Clara County, California",40,39,1
1000000US060855040011011,060855040011011,"Block 1011, Block Group 1, Census Tract 5040.01, Santa Clara County, California",15,14,1
1000000US060855040011012,060855040011012,"Block 1012, Block Group 1, Census Tract 5040.01, Santa Clara County, California",33,32,1
1000000US060855040011013,060855040011013,"Block 1013, Block Group 1, Census Tract 5040.01, Santa Clara County, California",33,31,2
1000000US060855040011014,060855040011014,"Block 1014, Block Group 1, Census Tract 5040.01, Santa Clara County, California",20,20,0
1000000US060855040011015,060855040011015,"Block 1015, Block Group 1, Census Tract 5040.01, Santa Clara County, California",34,34,0
1000000US060855040011016,060855040011016,"Block 1016, Block Group 1, Census Tract 5040.01, Santa Clara County, California",7,7,0
1000000US060855040011017,060855040011017,"Block 1017, Block Group 1, Census Tract 5040.01, Santa Clara County, California",21,21,0
1000000US060855040011018,060855040011018,"Block 1018, Block Group 1, Census Tract 5040.01, Santa Clara County, California",16,16,0
1000000US060855040011019,060855040011019,"Block 1019, Block Group 1, Census Tract 5040.01, Santa Clara County, California",24,24,0
1000000US060855040012000,060855040012000,"Block 2000, Block Group 2, Census Tract 5040.01, Santa Clara County, California",17,17,0
1000000US060855040012001,060855040012001,"Block 2001, Block Group 2, Census Tract 5040.01, Santa Clara County, California",86,84,2
1000000US060855040012002,060855040012002,"Block 2002, Block Group 2, Census Tract 5040.01, Santa Clara County, California",0,0,0
1000000US060855040012003,060855040012003,"Block 2003, Block Group 2, Census Tract 5040.01, Santa Clara County, California",31,30,1
1000000US060855040012004,060855040012004,"Block 2004, Block Group 2, Census Tract 5040.01, Santa Clara County, California",51,49,2
1000000US060855040012005,060855040012005,"Block 2005, Block Group 2, Census Tract 5040.01, Santa Clara County, California",59,54,5
1000000US060855040012006,060855040012006,"Block 2006, Block Group 2, Census Tract 5040.01, Santa Clara County, California",0,0,0
1000000US060855040012007,060855040012007,"Block 2007, Block Group 2, Census Tract 5040.01, Santa Clara County, California",30,29,1
1000000US060855040012008,060855040012008,"Block 2008, Block Group 2, Census Tract 5040.01, Santa Clara County, California",33,32,1
1000000US060855040012009,060855040012009,"Block 2009, Block Group 2, Census Tract 5040.01, Santa Clara County, California",70,69,1
1000000US060855040012010,060855040012010,"Block 2010, Block Group 2, Census Tract 5040.01, Santa Clara County, California",22,21,1
1000000US060855040012011,060855040012011,"Block 2011, Block Group 2, Census Tract 5040.01, Santa Clara County, California",8,7,1
1000000US060855040012012,060855040012012,"Block 2012, Block Group 2, Census Tract 5040.01, Santa Clara County, California",14,14,0
1000000US060855040012013,060855040012013,"Block 2013, Block Group 2, Census Tract 5040.01, Santa Clara County, California",0,0,0
1000000US060855040012014,060855040012014,"Block 2014, Block Group 2, Census Tract 5040.01, Santa Clara County, California",16,15,1
1000000US060855040012015,060855040012015,"Block 2015, Block Group 2, Census Tract 5040.01, Santa Clara County, California",28,26,2
1000000US060855040012016,060855040012016,"Block 2016, Block Group 2, Census Tract 5040.01, Santa Clara County, California",0,0,0
1000000US060855040012017,060855040012017,"Block 2017, Block Group 2, Census Tract 5040.01, Santa Clara County, California",5,5,0
1000000US060855040012018,060855040012018,"Block 2018, Block Group 2, Census Tract 5040.01, Santa Clara County, California",0,0,0
1000000US060855040012019,060855040012019,"Block 2019, Block Group 2, Census Tract 5040.01, Santa Clara County, California",0,0,0
1000000US060855040012020,060855040012020,"Block 2020, Block Group 2, Census Tract 5040.01, Santa Clara County, California",19,18,1
1000000US060855040013000,060855040013000,"Block 3000, Block Group 3, Census Tract 5040.01, Santa Clara County, California",145,140,5
1000000US060855040013001,060855040013001,"Block 3001, Block Group 3, Census Tract 5040.01, Santa Clara County, California",8,7,1
1000000US060855040013002,060855040013002,"Block 3002, Block Group 3, Census Tract 5040.01, Santa Clara County, California",14,14,0
1000000US060855040013003,060855040013003,"Block 3003, Block Group 3, Census Tract 5040.01, Santa Clara County, California",19,18,1
1000000US060855040013004,060855040013004,"Block 3004, Block Group 3, Census Tract 5040.01, Santa Clara County, California",231,226,5
1000000US060855040013005,060855040013005,"Block 3005, Block Group 3, Census Tract 5040.01, Santa Clara County, California",146,139,7
1000000US060855040013006,060855040013006,"Block 3006, Block Group 3, Census Tract 5040.01, Santa Clara County, California",23,22,1
1000000US060855040013007,060855040013007,"Block 3007, Block Group 3, Census Tract 5040.01, Santa Clara County, California",13,13,0
1000000US060855040021000,060855040021000,"Block 1000, Block Group 1, Census Tract 5040.02, Santa Clara County, California",30,28,2
1000000US060855040021001,060855040021001,"Block 1001, Block Group 1, Census Tract 5040.02, Santa Clara County, California",10,10,0
1000000US060855040021002,060855040021002,"Block 1002, Block Group 1, Census Tract 5040.02, Santa Clara County, California",10,9,1
1000000US060855040021003,060855040021003,"Block 1003, Block Group 1, Census Tract 5040.02, Santa Clara County, California",470,454,16
1000000US060855040021004,060855040021004,"Block 1004, Block Group 1, Census Tract 5040.02, Santa Clara County, California",10,8,2
1000000US060855040021005,060855040021005,"Block 1005, Block Group 1, Census Tract 5040.02, Santa Clara County, California",37,36,1
1000000US060855040021006,060855040021006,"Block 1006, Block Group 1, Census Tract 5040.02, Santa Clara County, California",39,38,1
1000000US060855040021007,060855040021007,"Block 1007, Block Group 1, Census Tract 5040.02, Santa Clara County, California",46,46,0
1000000US060855040021008,060855040021008,"Block 1008, Block Group 1, Census Tract 5040.02, Santa Clara County, California",21,20,1
1000000US060855040021009,060855040021009,"Block 1009, Block Group 1, Census Tract 5040.02, Santa Clara County, California",0,0,0
1000000US060855040022000,060855040022000,"Block 2000, Block Group 2, Census Tract 5040.02, Santa Clara County, California",0,0,0
1000000US060855040022001,060855040022001,"Block 2001, Block Group 2, Census Tract 5040.02, Santa Clara County, California",39,38,1
1000000US060855040022002,060855040022002,"Block 2002, Block Group 2, Census Tract 5040.02, Santa Clara County, California",0,0,0
1000000US060855040022003,060855040022003,"Block 2003, Block Group 2, Census Tract 5040.02, Santa Clara County, California",133,125,8
1000000US060855040022004,060855040022004,"Block 2004, Block Group 2, Census Tract 5040.02, Santa Clara County, California",103,101,2
1000000US060855040022005,060855040022005,"Block 2005, Block Group 2, Census Tract 5040.02, Santa Clara County, California",1,1,0
1000000US060855040022006,060855040022006,"Block 2006, Block Group 2, Census Tract 5040.02, Santa Clara County, California",17,17,0
1000000US060855040022007,060855040022007,"Block 2007, Block Group 2, Census Tract 5040.02, Santa Clara County, California",43,41,2
1000000US060855040022008,060855040022008,"Block 2008, Block Group 2, Census Tract 5040.02, Santa Clara County, California",20,16,4
1000000US060855040022009,060855040022009,"Block 2009, Block Group 2, Census Tract 5040.02, Santa Clara County, California",29,29,0
1000000US060855040022010,060855040022010,"Block 2010, Block Group 2, Census Tract 5040.02, Santa Clara County, California",40,38,2
1000000US060855040022011,060855040022011,"Block 2011, Block Group 2, Census Tract 5040.02, Santa Clara County, California",21,20,1
1000000US060855040022012,060855040022012,"Block 2012, Block Group 2, Census Tract 5040.02, Santa Clara County, California",41,39,2
1000000US060855040022013,060855040022013,"Block 2013, Block Group 2, Census Tract 5040.02, Santa Clara County, California",39,38,1
1000000US060855040022014,060855040022014,"Block 2014, Block Group 2, Census Tract 5040.02, Santa Clara County, California",43,43,0
1000000US060855040022015,060855040022015,"Block 2015, Block Group 2, Census Tract 5040.02, Santa Clara County, California",52,52,0
1000000US060855040022016,060855040022016,"Block 2016, Block Group 2, Census Tract 5040.02, Santa Clara County, California",21,21,0
1000000US060855040022017,060855040022017,"Block 2017, Block Group 2, Census Tract 5040.02, Santa Clara County, California",20,19,1
1000000US060855040022018,060855040022018,"Block 2018, Block Group 2, Census Tract 5040.02, Santa Clara County, California",10,10,0
1000000US060855040022019,060855040022019,"Block 2019, Block Group 2, Census Tract 5040.02, Santa Clara County, California",22,21,1
1000000US060855041011000,060855041011000,"Block 1000, Block Group 1, Census Tract 5041.01, Santa Clara County, California",17,16,1
1000000US060855041011001,060855041011001,"Block 1001, Block Group 1, Census Tract 5041.01, Santa Clara County, California",33,33,0
1000000US060855041011002,060855041011002,"Block 1002, Block Group 1, Census Tract 5041.01, Santa Clara County, California",55,52,3
1000000US060855041011003,060855041011003,"Block 1003, Block Group 1, Census Tract 5041.01, Santa Clara County, California",23,23,0
1000000US060855041011004,060855041011004,"Block 1004, Block Group 1, Census Tract 5041.01, Santa Clara County, California",25,22,3
1000000US060855041011005,060855041011005,"Block 1005, Block Group 1, Census Tract 5041.01, Santa Clara County, California",29,29,0
1000000US060855041011006,060855041011006,"Block 1006, Block Group 1, Census Tract 5041.01, Santa Clara County, California",65,64,1
1000000US060855041011007,060855041011007,"Block 1007, Block Group 1, Census Tract 5041.01, Santa Clara County, California",9,9,0
1000000US060855041011008,060855041011008,"Block 1008, Block Group 1, Census Tract 5041.01, Santa Clara County, California",1,1,0
1000000US060855041011009,060855041011009,"Block 1009, Block Group 1, Census Tract 5041.01, Santa Clara County, California",8,8,0
1000000US060855041011010,060855041011010,"Block 1010, Block Group 1, Census Tract 5041.01, Santa Clara County, California",34,31,3
1000000US060855041011011,060855041011011,"Block 1011, Block Group 1, Census Tract 5041.01, Santa Clara County, California",23,23,0
1000000US060855041011012,060855041011012,"Block 1012, Block Group 1, Census Tract 5041.01, Santa Clara County, California",18,18,0
1000000US060855041012000,060855041012000,"Block 2000, Block Group 2, Census Tract 5041.01, Santa Clara County, California",73,69,4
1000000US060855041012001,060855041012001,"Block 2001, Block Group 2, Census Tract 5041.01, Santa Clara County, California",26,25,1
1000000US060855041012002,060855041012002,"Block 2002, Block Group 2, Census Tract 5041.01, Santa Clara County, California",23,22,1
1000000US060855041012003,060855041012003,"Block 2003, Block Group 2, Census Tract 5041.01, Santa Clara County, California",5,4,1
1000000US060855041012004,060855041012004,"Block 2004, Block Group 2, Census Tract 5041.01, Santa Clara County, California",5,5,0
1000000US060855041012005,060855041012005,"Block 2005, Block Group 2, Census Tract 5041.01, Santa Clara County, California",61,60,1
1000000US060855041012006,060855041012006,"Block 2006, Block Group 2, Census Tract 5041.01, Santa Clara County, California",95,91,4
1000000US060855041012007,060855041012007,"Block 2007, Block Group 2, Census Tract 5041.01, Santa Clara County, California",71,69,2
1000000US060855041012008,060855041012008,"Block 2008, Block Group 2, Census Tract 5041.01, Santa Clara County, California",9,8,1
1000000US060855041012009,060855041012009,"Block 2009, Block Group 2, Census Tract 5041.01, Santa Clara County, California",24,23,1
1000000US060855041012010,060855041012010,"Block 2010, Block Group 2, Census Tract 5041.01, Santa Clara County, California",12,10,2
1000000US060855041012011,060855041012011,"Block 2011, Block Group 2, Census Tract 5041.01, Santa Clara County, California",0,0,0
1000000US060855041012012,060855041012012,"Block 2012, Block Group 2, Census Tract 5041.01, Santa Clara County, California",1,1,0
1000000US060855041012013,060855041012013,"Block 2013, Block Group 2, Census Tract 5041.01, Santa Clara County, California",42,40,2
1000000US060855041012014,060855041012014,"Block 2014, Block Group 2, Census Tract 5041.01, Santa Clara County, California",51,51,0
1000000US060855041012015,060855041012015,"Block 2015, Block Group 2, Census Tract 5041.01, Santa Clara County, California",27,27,0
1000000US060855041012016,060855041012016,"Block 2016, Block Group 2, Census Tract 5041.01, Santa Clara County, California",21,17,4
1000000US060855041012017,060855041012017,"Block 2017, Block Group 2, Census Tract 5041.01, Santa Clara County, California",7,6,1
1000000US060855041012018,060855041012018,"Block 2018, Block Group 2, Census Tract 5041.01, Santa Clara County, California",1,1,0
1000000US060855041012019,060855041012019,"Block 2019, Block Group 2, Census Tract 5041.01, Santa Clara County, California",5,5,0
1000000US060855041012020,060855041012020,"Block 2020, Block Group 2, Census Tract 5041.01, Santa Clara County, California",48,42,6
1000000US060855041012021,060855041012021,"Block 2021, Block Group 2, Census Tract 5041.01, Santa Clara County, California",67,63,4
1000000US060855041012022,060855041012022,"Block 2022, Block Group 2, Census Tract 5041.01, Santa Clara County, California",6,6,0
1000000US060855041012023,060855041012023,"Block 2023, Block Group 2, Census Tract 5041.01, Santa Clara County, California",16,16,0
1000000US060855041021000,060855041021000,"Block 1000, Block Group 1, Census Tract 5041.02, Santa Clara County, California",39,35,4
1000000US060855041021001,060855041021001,"Block 1001, Block Group 1, Census Tract 5041.02, Santa Clara County, California",46,44,2
1000000US060855041021002,060855041021002,"Block 1002, Block Group 1, Census Tract 5041.02, Santa Clara County, California",7,7,0
1000000US060855041021003,060855041021003,"Block 1003, Block Group 1, Census Tract 5041.02, Santa Clara County, California",2,2,0
1000000US060855041021004,060855041021004,"Block 1004, Block Group 1, Census Tract 5041.02, Santa Clara County, California",33,31,2
1000000US060855041021005,060855041021005,"Block 1005, Block Group 1, Census Tract 5041.02, Santa Clara County, California",30,28,2
1000000US060855041021006,060855041021006,"Block 1006, Block Group 1, Census Tract 5041.02, Santa Clara County, California",154,146,8
1000000US060855041021007,060855041021007,"Block 1007, Block Group 1, Census Tract 5041.02, Santa Clara County, California",21,21,0
1000000US060855041021008,060855041021008,"Block 1008, Block Group 1, Census Tract 5041.02, Santa Clara County, California",4,4,0
1000000US060855041021009,060855041021009,"Block 1009, Block Group 1, Census Tract 5041.02, Santa Clara County, California",4,4,0
1000000US060855041021010,060855041021010,"Block 1010, Block Group 1, Census Tract 5041.02, Santa Clara County, California",15,15,0
1000000US060855041021011,060855041021011,"Block 1011, Block Group 1, Census Tract 5041.02, Santa Clara County, California",3,2,1
1000000US060855041021012,060855041021012,"Block 1012, Block Group 1, Census Tract 5041.02, Santa Clara County, California",7,7,0
1000000US060855041021013,060855041021013,"Block 1013, Block Group 1, Census Tract 5041.02, Santa Clara County, California",27,27,0
1000000US060855041021014,060855041021014,"Block 1014, Block Group 1, Census Tract 5041.02, Santa Clara County, California",23,23,0
1000000US060855041021015,060855041021015,"Block 1015, Block Group 1, Census Tract 5041.02, Santa Clara County, California",26,24,2
1000000US060855041021016,060855041021016,"Block 1016, Block Group 1, Census Tract 5041.02, Santa Clara County, California",4,4,0
1000000US060855041021017,060855041021017,"Block 1017, Block Group 1, Census Tract 5041.02, Santa Clara County, California",48,47,1
1000000US060855041021018,060855041021018,"Block 1018, Block Group 1, Census Tract 5041.02, Santa Clara County, California",12,12,0
1000000US060855041021019,060855041021019,"Block 1019, Block Group 1, Census Tract 5041.02, Santa Clara County, California",0,0,0
1000000US060855041021020,060855041021020,"Block 1020, Block Group 1, Census Tract 5041.02, Santa Clara County, California",15,15,0
1000000US060855041021021,060855041021021,"Block 1021, Block Group 1, Census Tract 5041.02, Santa Clara County, California",5,4,1
1000000US060855041021022,060855041021022,"Block 1022, Block Group 1, Census Tract 5041.02, Santa Clara County, California",18,16,2
1000000US060855041021023,060855041021023,"Block 1023, Block Group 1, Census Tract 5041.02, Santa Clara County, California",24,23,1
1000000US060855041021024,060855041021024,"Block 1024, Block Group 1, Census Tract 5041.02, Santa Clara County, California",24,24,0
1000000US060855041021025,060855041021025,"Block 1025, Block Group 1, Census Tract 5041.02, Santa Clara County, California",17,15,2
1000000US060855041022000,060855041022000,"Block 2000, Block Group 2, Census Tract 5041.02, Santa Clara County, California",36,32,4
1000000US060855041022001,060855041022001,"Block 2001, Block Group 2, Census Tract 5041.02, Santa Clara County, California",33,30,3
1000000US060855041022002,060855041022002,"Block 2002, Block Group 2, Census Tract 5041.02, Santa Clara County, California",42,42,0
1000000US060855041022003,060855041022003,"Block 2003, Block Group 2, Census Tract 5041.02, Santa Clara County, California",121,114,7
1000000US060855041022004,060855041022004,"Block 2004, Block Group 2, Census Tract 5041.02, Santa Clara County, California",36,34,2
1000000US060855041022005,060855041022005,"Block 2005, Block Group 2, Census Tract 5041.02, Santa Clara County, California",21,20,1
1000000US060855041022006,060855041022006,"Block 2006, Block Group 2, Census Tract 5041.02, Santa Clara County, California",2,2,0
1000000US060855041022007,060855041022007,"Block 2007, Block Group 2, Census Tract 5041.02, Santa Clara County, California",23,23,0
1000000US060855041022008,060855041022008,"Block 2008, Block Group 2, Census Tract 5041.02, Santa Clara County, California",0,0,0
1000000US060855041022009,060855041022009,"Block 2009, Block Group 2, Census Tract 5041.02, Santa Clara County, California",1,1,0
1000000US060855041022010,060855041022010,"Block 2010, Block Group 2, Census Tract 5041.02, Santa Clara County, California",6,5,1
1000000US060855041022011,060855041022011,"Block 2011, Block Group 2, Census Tract 5041.02, Santa Clara County, California",13,12,1
1000000US060855041022012,060855041022012,"Block 2012, Block Group 2, Census Tract 5041.02, Santa Clara County, California",18,18,0
1000000US060855041022013,060855041022013,"Block 2013, Block Group 2, Census Tract 5041.02, Santa Clara County, California",0,0,0
1000000US060855041023000,060855041023000,"Block 3000, Block Group 3, Census Tract 5041.02, Santa Clara County, California",11,9,2
1000000US060855041023001,060855041023001,"Block 3001, Block Group 3, Census Tract 5041.02, Santa Clara County, California",49,47,2
1000000US060855041023002,060855041023002,"Block 3002, Block Group 3, Census Tract 5041.02, Santa Clara County, California",53,49,4
1000000US060855041023003,060855041023003,"Block 3003, Block Group 3, Census Tract 5041.02, Santa Clara County, California",42,39,3
1000000US060855041023004,060855041023004,"Block 3004, Block Group 3, Census Tract 5041.02, Santa Clara County, California",15,14,1
1000000US060855041023005,060855041023005,"Block 3005, Block Group 3, Census Tract 5041.02, Santa Clara County, California",15,15,0
1000000US060855041023006,060855041023006,"Block 3006, Block Group 3, Census Tract 5041.02, Santa Clara County, California",25,25,0
1000000US060855041023007,060855041023007,"Block 3007, Block Group 3, Census Tract 5041.02, Santa Clara County, California",3,3,0
1000000US060855041023008,060855041023008,"Block 3008, Block Group 3, Census Tract 5041.02, Santa Clara County, California",20,20,0
1000000US060855041023009,060855041023009,"Block 3009, Block Group 3, Census Tract 5041.02, Santa Clara County, California",37,35,2
1000000US060855041023010,060855041023010,"Block 3010, Block Group 3, Census Tract 5041.02, Santa Clara County, California",75,74,1
1000000US060855041023011,060855041023011,"Block 3011, Block Group 3, Census Tract 5041.02, Santa Clara County, California",37,36,1
1000000US060855042011000,060855042011000,"Block 1000, Block Group 1, Census Tract 5042.01, Santa Clara County, California",3,3,0
1000000US060855042011001,060855042011001,"Block 1001, Block Group 1, Census Tract 5042.01, Santa Clara County, California",4,3,1
1000000US060855042011002,060855042011002,"Block 1002, Block Group 1, Census Tract 5042.01, Santa Clara County, California",0,0,0
1000000US060855042011003,060855042011003,"Block 1003, Block Group 1, Census Tract 5042.01, Santa Clara County, California",8,8,0
1000000US060855042011004,060855042011004,"Block 1004, Block Group 1, Census Tract 5042.01, Santa Clara County, California",10,10,0
1000000US060855042011005,060855042011005,"Block 1005, Block Group 1, Census Tract 5042.01, Santa Clara County, California",19,18,1
1000000US060855042011006,060855042011006,"Block 1006, Block Group 1, Census Tract 5042.01, Santa Clara County, California",30,30,0
1000000US060855042011007,060855042011007,"Block 1007, Block Group 1, Census Tract 5042.01, Santa Clara County, California",14,13,1
1000000US060855042011008,060855042011008,"Block 1008, Block Group 1, Census Tract 5042.01, Santa Clara County, California",7,7,0
1000000US060855042011009,060855042011009,"Block 1009, Block Group 1, Census Tract 5042.01, Santa Clara County, California",15,14,1
1000000US060855042011010,060855042011010,"Block 1010, Block Group 1, Census Tract 5042.01, Santa Clara County, California",22,21,1
1000000US060855042011011,060855042011011,"Block 1011, Block Group 1, Census Tract 5042.01, Santa Clara County, California",25,23,2
1000000US060855042011012,060855042011012,"Block 1012, Block Group 1, Census Tract 5042.01, Santa Clara County, California",293,279,14
1000000US060855042011013,060855042011013,"Block 1013, Block Group 1, Census Tract 5042.01, Santa Clara County, California",2,2,0
1000000US060855042011014,060855042011014,"Block 1014, Block Group 1, Census Tract 5042.01, Santa Clara County, California",12,12,0
1000000US060855042011015,060855042011015,"Block 1015, Block Group 1, Census Tract 5042.01, Santa Clara County, California",25,25,0
1000000US060855042011016,060855042011016,"Block 1016, Block Group 1, Census Tract 5042.01, Santa Clara County, California",0,0,0
1000000US060855042011017,060855042011017,"Block 1017, Block Group 1, Census Tract 5042.01, Santa Clara County, California",30,27,3
1000000US060855042011018,060855042011018,"Block 1018, Block Group 1, Census Tract 5042.01, Santa Clara County, California",19,19,0
1000000US060855042011019,060855042011019,"Block 1019, Block Group 1, Census Tract 5042.01, Santa Clara County, California",18,17,1
1000000US060855042011020,060855042011020,"Block 1020, Block Group 1, Census Tract 5042.01, Santa Clara County, California",8,8,0
1000000US060855042011021,060855042011021,"Block 1021, Block Group 1, Census Tract 5042.01, Santa Clara County, California",42,41,1
1000000US060855042011022,060855042011022,"Block 1022, Block Group 1, Census Tract 5042.01, Santa Clara County, California",25,25,0
1000000US060855042011023,060855042011023,"Block 1023, Block Group 1, Census Tract 5042.01, Santa Clara County, California",1,1,0
1000000US060855042011024,060855042011024,"Block 1024, Block Group 1, Census Tract 5042.01, Santa Clara County, California",0,0,0
1000000US060855042011025,060855042011025,"Block 1025, Block Group 1, Census Tract 5042.01, Santa Clara County, California",0,0,0
1000000US060855042011026,060855042011026,"Block 1026, Block Group 1, Census Tract 5042.01, Santa Clara County, California",0,0,0
1000000US060855042011027,060855042011027,"Block 1027, Block Group 1, Census Tract 5042.01, Santa Clara County, California",0,0,0
1000000US060855042011028,060855042011028,"Block 1028, Block Group 1, Census Tract 5042.01, Santa Clara County, California",39,38,1
1000000US060855042011029,060855042011029,"Block 1029, Block Group 1, Census Tract 5042.01, Santa Clara County, California",27,27,0
1000000US060855042011030,060855042011030,"Block 1030, Block Group 1, Census Tract 5042.01, Santa Clara County, California",20,20,0
1000000US060855042011031,060855042011031,"Block 1031, Block Group 1, Census Tract 5042.01, Santa Clara County, California",0,0,0
1000000US060855042011032,060855042011032,"Block 1032, Block Group 1, Census Tract 5042.01, Santa Clara County, California",0,0,0
1000000US060855042011033,060855042011033,"Block 1033, Block Group 1, Census Tract 5042.01, Santa Clara County, California",17,17,0
1000000US060855042011034,060855042011034,"Block 1034, Block Group 1, Census Tract 5042.01, Santa Clara County, California",56,53,3
1000000US060855042011035,060855042011035,"Block 1035, Block Group 1, Census Tract 5042.01, Santa Clara County, California",93,89,4
1000000US060855042012000,060855042012000,"Block 2000, Block Group 2, Census Tract 5042.01, Santa Clara County, California",31,31,0
1000000US060855042012001,060855042012001,"Block 2001, Block Group 2, Census Tract 5042.01, Santa Clara County, California",8,6,2
1000000US060855042012002,060855042012002,"Block 2002, Block Group 2, Census Tract 5042.01, Santa Clara County, California",42,39,3
1000000US060855042012003,060855042012003,"Block 2003, Block Group 2, Census Tract 5042.01, Santa Clara County, California",7,7,0
1000000US060855042012004,060855042012004,"Block 2004, Block Group 2, Census Tract 5042.01, Santa Clara County, California",21,19,2
1000000US060855042012005,060855042012005,"Block 2005, Block Group 2, Census Tract 5042.01, Santa Clara County, California",46,43,3
1000000US060855042012006,060855042012006,"Block 2006, Block Group 2, Census Tract 5042.01, Santa Clara County, California",12,12,0
1000000US060855042012007,060855042012007,"Block 2007, Block Group 2, Census Tract 5042.01, Santa Clara County, California",35,34,1
1000000US060855042012008,060855042012008,"Block 2008, Block Group 2, Census Tract 5042.01, Santa Clara County, California",0,0,0
1000000US060855042012009,060855042012009,"Block 2009, Block Group 2, Census Tract 5042.01, Santa Clara County, California",39,39,0
1000000US060855042012010,060855042012010,"Block 2010, Block Group 2, Census Tract 5042.01, Santa Clara County, California",3,3,0
1000000US060855042012011,060855042012011,"Block 2011, Block Group 2, Census Tract 5042.01, Santa Clara County, California",2,1,1
1000000US060855042012012,060855042012012,"Block 2012, Block Group 2, Census Tract 5042.01, Santa Clara County, California",0,0,0
1000000US060855042012013,060855042012013,"Block 2013, Block Group 2, Census Tract 5042.01, Santa Clara County, California",0,0,0
1000000US060855042012014,060855042012014,"Block 2014, Block Group 2, Census Tract 5042.01, Santa Clara County, California",18,14,4
1000000US060855042012015,060855042012015,"Block 2015, Block Group 2, Census Tract 5042.01, Santa Clara County, California",0,0,0
1000000US060855042012016,060855042012016,"Block 2016, Block Group 2, Census Tract 5042.01, Santa Clara County, California",15,15,0
1000000US060855042012017,060855042012017,"Block 2017, Block Group 2, Census Tract 5042.01, Santa Clara County, California",25,24,1
1000000US060855042012018,060855042012018,"Block 2018, Block Group 2, Census Tract 5042.01, Santa Clara County, California",38,37,1
1000000US060855042012019,060855042012019,"Block 2019, Block Group 2, Census Tract 5042.01, Santa Clara County, California",7,6,1
1000000US060855042012020,060855042012020,"Block 2020, Block Group 2, Census Tract 5042.01, Santa Clara County, California",22,20,2
1000000US060855042012021,060855042012021,"Block 2021, Block Group 2, Census Tract 5042.01, Santa Clara County, California",17,15,2
1000000US060855042013000,060855042013000,"Block 3000, Block Group 3, Census Tract 5042.01, Santa Clara County, California",8,8,0
1000000US060855042013001,060855042013001,"Block 3001, Block Group 3, Census Tract 5042.01, Santa Clara County, California",29,27,2
1000000US060855042013002,060855042013002,"Block 3002, Block Group 3, Census Tract 5042.01, Santa Clara County, California",133,126,7
1000000US060855042013003,060855042013003,"Block 3003, Block Group 3, Census Tract 5042.01, Santa Clara County, California",3,3,0
1000000US060855042013004,060855042013004,"Block 3004, Block Group 3, Census Tract 5042.01, Santa Clara County, California",18,18,0
1000000US060855042013005,060855042013005,"Block 3005, Block Group 3, Census Tract 5042.01, Santa Clara County, California",25,22,3
1000000US060855042013006,060855042013006,"Block 3006, Block Group 3, Census Tract 5042.01, Santa Clara County, California",24,23,1
1000000US060855042013007,060855042013007,"Block 3007, Block Group 3, Census Tract 5042.01, Santa Clara County, California",55,54,1
1000000US060855042013008,060855042013008,"Block 3008, Block Group 3, Census Tract 5042.01, Santa Clara County, California",29,28,1
1000000US060855042013009,060855042013009,"Block 3009, Block Group 3, Census Tract 5042.01, Santa Clara County, California",16,16,0
1000000US060855042013010,060855042013010,"Block 3010, Block Group 3, Census Tract 5042.01, Santa Clara County, California",45,44,1
1000000US060855042013011,060855042013011,"Block 3011, Block Group 3, Census Tract 5042.01, Santa Clara County, California",11,11,0
1000000US060855042013012,060855042013012,"Block 3012, Block Group 3, Census Tract 5042.01, Santa Clara County, California",3,3,0
1000000US060855042013013,060855042013013,"Block 3013, Block Group 3, Census Tract 5042.01, Santa Clara County, California",10,10,0
1000000US060855042013014,060855042013014,"Block 3014, Block Group 3, Census Tract 5042.01, Santa Clara County, California",9,8,1
1000000US060855042013015,060855042013015,"Block 3015, Block Group 3, Census Tract 5042.01, Santa Clara County, California",7,7,0
1000000US060855042013016,060855042013016,"Block 3016, Block Group 3, Census Tract 5042.01, Santa Clara County, California",9,9,0
1000000US060855042021000,060855042021000,"Block 1000, Block Group 1, Census Tract 5042.02, Santa Clara County, California",228,210,18
1000000US060855042021001,060855042021001,"Block 1001, Block Group 1, Census Tract 5042.02, Santa Clara County, California",0,0,0
1000000US060855042021002,060855042021002,"Block 1002, Block Group 1, Census Tract 5042.02, Santa Clara County, California",22,20,2
1000000US060855042021003,060855042021003,"Block 1003, Block Group 1, Census Tract 5042.02, Santa Clara County, California",0,0,0
1000000US060855042021004,060855042021004,"Block 1004, Block Group 1, Census Tract 5042.02, Santa Clara County, California",10,10,0
1000000US060855042021005,060855042021005,"Block 1005, Block Group 1, Census Tract 5042.02, Santa Clara County, California",7,7,0
1000000US060855042021006,060855042021006,"Block 1006, Block Group 1, Census Tract 5042.02, Santa Clara County, California",11,10,1
1000000US060855042021007,060855042021007,"Block 1007, Block Group 1, Census Tract 5042.02, Santa Clara County, California",0,0,0
1000000US060855042021008,060855042021008,"Block 1008, Block Group 1, Census Tract 5042.02, Santa Clara County, California",2,2,0
1000000US060855042021009,060855042021009,"Block 1009, Block Group 1, Census Tract 5042.02, Santa Clara County, California",42,39,3
1000000US060855042021010,060855042021010,"Block 1010, Block Group 1, Census Tract 5042.02, Santa Clara County, California",15,15,0
1000000US060855042021011,060855042021011,"Block 1011, Block Group 1, Census Tract 5042.02, Santa Clara County, California",50,49,1
1000000US060855042021012,060855042021012,"Block 1012, Block Group 1, Census Tract 5042.02, Santa Clara County, California",48,44,4
1000000US060855042022000,060855042022000,"Block 2000, Block Group 2, Census Tract 5042.02, Santa Clara County, California",0,0,0
1000000US060855042022001,060855042022001,"Block 2001, Block Group 2, Census Tract 5042.02, Santa Clara County, California",0,0,0
1000000US060855042022002,060855042022002,"Block 2002, Block Group 2, Census Tract 5042.02, Santa Clara County, California",0,0,0
1000000US060855042022003,060855042022003,"Block 2003, Block Group 2, Census Tract 5042.02, Santa Clara County, California",0,0,0
1000000US060855042022004,060855042022004,"Block 2004, Block Group 2, Census Tract 5042.02, Santa Clara County, California",0,0,0
1000000US060855042022005,060855042022005,"Block 2005, Block Group 2, Census Tract 5042.02, Santa Clara County, California",54,52,2
1000000US060855042022006,060855042022006,"Block 2006, Block Group 2, Census Tract 5042.02, Santa Clara County, California",41,34,7
1000000US060855042022007,060855042022007,"Block 2007, Block Group 2, Census Tract 5042.02, Santa Clara County, California",38,34,4
1000000US060855042022008,060855042022008,"Block 2008, Block Group 2, Census Tract 5042.02, Santa Clara County, California",1,1,0
1000000US060855042022009,060855042022009,"Block 2009, Block Group 2, Census Tract 5042.02, Santa Clara County, California",0,0,0
1000000US060855042022010,060855042022010,"Block 2010, Block Group 2, Census Tract 5042.02, Santa Clara County, California",1,1,0
1000000US060855042022011,060855042022011,"Block 2011, Block Group 2, Census Tract 5042.02, Santa Clara County, California",0,0,0
1000000US060855042022012,060855042022012,"Block 2012, Block Group 2, Census Tract 5042.02, Santa Clara County, California",0,0,0
1000000US060855042022013,060855042022013,"Block 2013, Block Group 2, Census Tract 5042.02, Santa Clara County, California",14,13,1
1000000US060855042022014,060855042022014,"Block 2014, Block Group 2, Census Tract 5042.02, Santa Clara County, California",165,160,5
1000000US060855042022015,060855042022015,"Block 2015, Block Group 2, Census Tract 5042.02, Santa Clara County, California",2,2,0
1000000US060855042022016,060855042022016,"Block 2016, Block Group 2, Census Tract 5042.02, Santa Clara County, California",0,0,0
1000000US060855042022017,060855042022017,"Block 2017, Block Group 2, Census Tract 5042.02, Santa Clara County, California",7,7,0
1000000US060855042022018,060855042022018,"Block 2018, Block Group 2, Census Tract 5042.02, Santa Clara County, California",9,7,2
1000000US060855042022019,060855042022019,"Block 2019, Block Group 2, Census Tract 5042.02, Santa Clara County, California",33,31,2
1000000US060855042022020,060855042022020,"Block 2020, Block Group 2, Census Tract 5042.02, Santa Clara County, California",34,33,1
1000000US060855042022021,060855042022021,"Block 2021, Block Group 2, Census Tract 5042.02, Santa Clara County, California",7,6,1
1000000US060855042022022,060855042022022,"Block 2022, Block Group 2, Census Tract 5042.02, Santa Clara County, California",41,40,1
1000000US060855042022023,060855042022023,"Block 2023, Block Group 2, Census Tract 5042.02, Santa Clara County, California",0,0,0
1000000US060855042022024,060855042022024,"Block 2024, Block Group 2, Census Tract 5042.02, Santa Clara County, California",13,13,0
1000000US060855042022025,060855042022025,"Block 2025, Block Group 2, Census Tract 5042.02, Santa Clara County, California",0,0,0
1000000US060855042022026,060855042022026,"Block 2026, Block Group 2, Census Tract 5042.02, Santa Clara County, California",0,0,0
1000000US060855042022027,060855042022027,"Block 2027, Block Group 2, Census Tract 5042.02, Santa Clara County, California",1,0,1
1000000US060855042022028,060855042022028,"Block 2028, Block Group 2, Census Tract 5042.02, Santa Clara County, California",13,12,1
1000000US060855042022029,060855042022029,"Block 2029, Block Group 2, Census Tract 5042.02, Santa Clara County, California",8,7,1
1000000US060855042022030,060855042022030,"Block 2030, Block Group 2, Census Tract 5042.02, Santa Clara County, California",34,33,1
1000000US060855042022031,060855042022031,"Block 2031, Block Group 2, Census Tract 5042.02, Santa Clara County, California",1,1,0
1000000US060855042022032,060855042022032,"Block 2032, Block Group 2, Census Tract 5042.02, Santa Clara County, California",11,10,1
1000000US060855042022033,060855042022033,"Block 2033, Block Group 2, Census Tract 5042.02, Santa Clara County, California",23,23,0
1000000US060855042022034,060855042022034,"Block 2034, Block Group 2, Census Tract 5042.02, Santa Clara County, California",7,7,0
1000000US060855042022035,060855042022035,"Block 2035, Block Group 2, Census Tract 5042.02, Santa Clara County, California",51,49,2
1000000US060855042022036,060855042022036,"Block 2036, Block Group 2, Census Tract 5042.02, Santa Clara County, California",17,17,0
1000000US060855042023000,060855042023000,"Block 3000, Block Group 3, Census Tract 5042.02, Santa Clara County, California",17,17,0
1000000US060855042023001,060855042023001,"Block 3001, Block Group 3, Census Tract 5042.02, Santa Clara County, California",11,10,1
1000000US060855042023002,060855042023002,"Block 3002, Block Group 3, Census Tract 5042.02, Santa Clara County, California",46,46,0
1000000US060855042023003,060855042023003,"Block 3003, Block Group 3, Census Tract 5042.02, Santa Clara County, California",31,29,2
1000000US060855042023004,060855042023004,"Block 3004, Block Group 3, Census Tract 5042.02, Santa Clara County, California",226,217,9
1000000US060855042023005,060855042023005,"Block 3005, Block Group 3, Census Tract 5042.02, Santa Clara County, California",37,37,0
1000000US060855042023006,060855042023006,"Block 3006, Block Group 3, Census Tract 5042.02, Santa Clara County, California",14,13,1
1000000US060855042023007,060855042023007,"Block 3007, Block Group 3, Census Tract 5042.02, Santa Clara County, California",34,33,1
1000000US060855042023008,060855042023008,"Block 3008, Block Group 3, Census Tract 5042.02, Santa Clara County, California",11,11,0
1000000US060855042023009,060855042023009,"Block 3009, Block Group 3, Census Tract 5042.02, Santa Clara County, California",12,12,0
1000000US060855042023010,060855042023010,"Block 3010, Block Group 3, Census Tract 5042.02, Santa Clara County, California",38,34,4
1000000US060855043071000,060855043071000,"Block 1000, Block Group 1, Census Tract 5043.07, Santa Clara County, California",40,39,1
1000000US060855043071001,060855043071001,"Block 1001, Block Group 1, Census Tract 5043.07, Santa Clara County, California",113,112,1
1000000US060855043071002,060855043071002,"Block 1002, Block Group 1, Census Tract 5043.07, Santa Clara County, California",113,111,2
1000000US060855043071003,060855043071003,"Block 1003, Block Group 1, Census Tract 5043.07, Santa Clara County, California",96,95,1
1000000US060855043071004,060855043071004,"Block 1004, Block Group 1, Census Tract 5043.07, Santa Clara County, California",47,46,1
1000000US060855043071005,060855043071005,"Block 1005, Block Group 1, Census Tract 5043.07, Santa Clara County, California",21,20,1
1000000US060855043071006,060855043071006,"Block 1006, Block Group 1, Census Tract 5043.07, Santa Clara County, California",31,31,0
1000000US060855043071007,060855043071007,"Block 1007, Block Group 1, Census Tract 5043.07, Santa Clara County, California",41,40,1
1000000US060855043071008,060855043071008,"Block 1008, Block Group 1, Census Tract 5043.07, Santa Clara County, California",29,29,0
1000000US060855043071009,060855043071009,"Block 1009, Block Group 1, Census Tract 5043.07, Santa Clara County, California",51,50,1
1000000US060855043071010,060855043071010,"Block 1010, Block Group 1, Census Tract 5043.07, Santa Clara County, California",26,26,0
1000000US060855043071011,060855043071011,"Block 1011, Block Group 1, Census Tract 5043.07, Santa Clara County, California",71,70,1
1000000US060855043071012,060855043071012,"Block 1012, Block Group 1, Census Tract 5043.07, Santa Clara County, California",25,25,0
1000000US060855043071013,060855043071013,"Block 1013, Block Group 1, Census Tract 5043.07, Santa Clara County, California",9,8,1
1000000US060855043071014,060855043071014,"Block 1014, Block Group 1, Census Tract 5043.07, Santa Clara County, California",74,73,1
1000000US060855043072000,060855043072000,"Block 2000, Block Group 2, Census Tract 5043.07, Santa Clara County, California",59,55,4
1000000US060855043072001,060855043072001,"Block 2001, Block Group 2, Census Tract 5043.07, Santa Clara County, California",86,85,1
1000000US060855043072002,060855043072002,"Block 2002, Block Group 2, Census Tract 5043.07, Santa Clara County, California",68,66,2
1000000US060855043072003,060855043072003,"Block 2003, Block Group 2, Census Tract 5043.07, Santa Clara County, California",33,32,1
1000000US060855043072004,060855043072004,"Block 2004, Block Group 2, Census Tract 5043.07, Santa Clara County, California",45,45,0
1000000US060855043072005,060855043072005,"Block 2005, Block Group 2, Census Tract 5043.07, Santa Clara County, California",42,41,1
1000000US060855043072006,060855043072006,"Block 2006, Block Group 2, Census Tract 5043.07, Santa Clara County, California",338,320,18
1000000US060855043072007,060855043072007,"Block 2007, Block Group 2, Census Tract 5043.07, Santa Clara County, California",11,11,0
1000000US060855043072008,060855043072008,"Block 2008, Block Group 2, Census Tract 5043.07, Santa Clara County, California",64,62,2
1000000US060855043072009,060855043072009,"Block 2009, Block Group 2, Census Tract 5043.07, Santa Clara County, California",39,39,0
1000000US060855043072010,060855043072010,"Block 2010, Block Group 2, Census Tract 5043.07, Santa Clara County, California",38,37,1
1000000US060855043072011,060855043072011,"Block 2011, Block Group 2, Census Tract 5043.07, Santa Clara County, California",37,37,0
1000000US060855043072012,060855043072012,"Block 2012, Block Group 2, Census Tract 5043.07, Santa Clara County, California",19,18,1
1000000US060855043072013,060855043072013,"Block 2013, Block Group 2, Census Tract 5043.07, Santa Clara County, California",28,27,1
1000000US060855043072014,060855043072014,"Block 2014, Block Group 2, Census Tract 5043.07, Santa Clara County, California",59,58,1
1000000US060855043072015,060855043072015,"Block 2015, Block Group 2, Census Tract 5043.07, Santa Clara County, California",0,0,0
1000000US060855043072016,060855043072016,"Block 2016, Block Group 2, Census Tract 5043.07, Santa Clara County, California",1,1,0
1000000US060855043081000,060855043081000,"Block 1000, Block Group 1, Census Tract 5043.08, Santa Clara County, California",6,5,1
1000000US060855043081001,060855043081001,"Block 1001, Block Group 1, Census Tract 5043.08, Santa Clara County, California",30,29,1
1000000US060855043081002,060855043081002,"Block 1002, Block Group 1, Census Tract 5043.08, Santa Clara County, California",3,3,0
1000000US060855043081003,060855043081003,"Block 1003, Block Group 1, Census Tract 5043.08, Santa Clara County, California",1,1,0
1000000US060855043081004,060855043081004,"Block 1004, Block Group 1, Census Tract 5043.08, Santa Clara County, California",0,0,0
1000000US060855043081005,060855043081005,"Block 1005, Block Group 1, Census Tract 5043.08, Santa Clara County, California",1,1,0
1000000US060855043081006,060855043081006,"Block 1006, Block Group 1, Census Tract 5043.08, Santa Clara County, California",0,0,0
1000000US060855043081007,060855043081007,"Block 1007, Block Group 1, Census Tract 5043.08, Santa Clara County, California",0,0,0
1000000US060855043081008,060855043081008,"Block 1008, Block Group 1, Census Tract 5043.08, Santa Clara County, California",1,1,0
1000000US060855043081009,060855043081009,"Block 1009, Block Group 1, Census Tract 5043.08, Santa Clara County, California",0,0,0
1000000US060855043081010,060855043081010,"Block 1010, Block Group 1, Census Tract 5043.08, Santa Clara County, California",0,0,0
1000000US060855043081011,060855043081011,"Block 1011, Block Group 1, Census Tract 5043.08, Santa Clara County, California",296,287,9
1000000US060855043081012,060855043081012,"Block 1012, Block Group 1, Census Tract 5043.08, Santa Clara County, California",27,25,2
1000000US060855043081013,060855043081013,"Block 1013, Block Group 1, Census Tract 5043.08, Santa Clara County, California",1,1,0
1000000US060855043081014,060855043081014,"Block 1014, Block Group 1, Census Tract 5043.08, Santa Clara County, California",1,1,0
1000000US060855043081015,060855043081015,"Block 1015, Block Group 1, Census Tract 5043.08, Santa Clara County, California",12,12,0
1000000US060855043081016,060855043081016,"Block 1016, Block Group 1, Census Tract 5043.08, Santa Clara County, California",30,30,0
1000000US060855043081017,060855043081017,"Block 1017, Block Group 1, Census Tract 5043.08, Santa Clara County, California",0,0,0
1000000US060855043081018,060855043081018,"Block 1018, Block Group 1, Census Tract 5043.08, Santa Clara County, California",2,1,1
1000000US060855043081019,060855043081019,"Block 1019, Block Group 1, Census Tract 5043.08, Santa Clara County, California",0,0,0
1000000US060855043081020,060855043081020,"Block 1020, Block Group 1, Census Tract 5043.08, Santa Clara County, California",20,18,2
1000000US060855043081021,060855043081021,"Block 1021, Block Group 1, Census Tract 5043.08, Santa Clara County, California",29,27,2
1000000US060855043081022,060855043081022,"Block 1022, Block Group 1, Census Tract 5043.08, Santa Clara County, California",0,0,0
1000000US060855043081023,060855043081023,"Block 1023, Block Group 1, Census Tract 5043.08, Santa Clara County, California",56,56,0
1000000US060855043081024,060855043081024,"Block 1024, Block Group 1, Census Tract 5043.08, Santa Clara County, California",4,4,0
1000000US060855043081025,060855043081025,"Block 1025, Block Group 1, Census Tract 5043.08, Santa Clara County, California",12,12,0
1000000US060855043081026,060855043081026,"Block 1026, Block Group 1, Census Tract 5043.08, Santa Clara County, California",14,13,1
1000000US060855043081027,060855043081027,"Block 1027, Block Group 1, Census Tract 5043.08, Santa Clara County, California",8,8,0
1000000US060855043081028,060855043081028,"Block 1028, Block Group 1, Census Tract 5043.08, Santa Clara County, California",15,15,0
1000000US060855043081029,060855043081029,"Block 1029, Block Group 1, Census Tract 5043.08, Santa Clara County, California",1,1,0
1000000US060855043081030,060855043081030,"Block 1030, Block Group 1, Census Tract 5043.08, Santa Clara County, California",1,0,1
1000000US060855043082000,060855043082000,"Block 2000, Block Group 2, Census Tract 5043.08, Santa Clara County, California",0,0,0
1000000US060855043082001,060855043082001,"Block 2001, Block Group 2, Census Tract 5043.08, Santa Clara County, California",0,0,0
1000000US060855043082002,060855043082002,"Block 2002, Block Group 2, Census Tract 5043.08, Santa Clara County, California",0,0,0
1000000US060855043082003,060855043082003,"Block 2003, Block Group 2, Census Tract 5043.08, Santa Clara County, California",0,0,0
1000000US060855043082004,060855043082004,"Block 2004, Block Group 2, Census Tract 5043.08, Santa Clara County, California",0,0,0
1000000US060855043082005,060855043082005,"Block 2005, Block Group 2, Census Tract 5043.08, Santa Clara County, California",16,16,0
1000000US060855043082006,060855043082006,"Block 2006, Block Group 2, Census Tract 5043.08, Santa Clara County, California",4,4,0
1000000US060855043082007,060855043082007,"Block 2007, Block Group 2, Census Tract 5043.08, Santa Clara County, California",0,0,0
1000000US060855043082008,060855043082008,"Block 2008, Block Group 2, Census Tract 5043.08, Santa Clara County, California",2,1,1
1000000US060855043082009,060855043082009,"Block 2009, Block Group 2, Census Tract 5043.08, Santa Clara County, California",132,127,5
1000000US060855043082010,060855043082010,"Block 2010, Block Group 2, Census Tract 5043.08, Santa Clara County, California",14,13,1
1000000US060855043082011,060855043082011,"Block 2011, Block Group 2, Census Tract 5043.08, Santa Clara County, California",9,9,0
1000000US060855043082012,060855043082012,"Block 2012, Block Group 2, Census Tract 5043.08, Santa Clara County, California",1,1,0
1000000US060855043082013,060855043082013,"Block 2013, Block Group 2, Census Tract 5043.08, Santa Clara County, California",0,0,0
1000000US060855043082014,060855043082014,"Block 2014, Block Group 2, Census Tract 5043.08, Santa Clara County, California",4,4,0
1000000US060855043082015,060855043082015,"Block 2015, Block Group 2, Census Tract 5043.08, Santa Clara County, California",26,26,0
1000000US060855043082016,060855043082016,"Block 2016, Block Group 2, Census Tract 5043.08, Santa Clara County, California",168,165,3
1000000US060855043082017,060855043082017,"Block 2017, Block Group 2, Census Tract 5043.08, Santa Clara County, California",17,17,0
1000000US060855043082018,060855043082018,"Block 2018, Block Group 2, Census Tract 5043.08, Santa Clara County, California",29,29,0
1000000US060855043082019,060855043082019,"Block 2019, Block Group 2, Census Tract 5043.08, Santa Clara County, California",5,4,1
1000000US060855043082020,060855043082020,"Block 2020, Block Group 2, Census Tract 5043.08, Santa Clara County, California",5,4,1
1000000US060855043082021,060855043082021,"Block 2021, Block Group 2, Census Tract 5043.08, Santa Clara County, California",0,0,0
1000000US060855043082022,060855043082022,"Block 2022, Block Group 2, Census Tract 5043.08, Santa Clara County, California",0,0,0
1000000US060855043082023,060855043082023,"Block 2023, Block Group 2, Census Tract 5043.08, Santa Clara County, California",0,0,0
1000000US060855043082024,060855043082024,"Block 2024, Block Group 2, Census Tract 5043.08, Santa Clara County, California",0,0,0
1000000US060855043082025,060855043082025,"Block 2025, Block Group 2, Census Tract 5043.08, Santa Clara County, California",0,0,0
1000000US060855043082026,060855043082026,"Block 2026, Block Group 2, Census Tract 5043.08, Santa Clara County, California",0,0,0
1000000US060855043082027,060855043082027,"Block 2027, Block Group 2, Census Tract 5043.08, Santa Clara County, California",35,35,0
1000000US060855043082028,060855043082028,"Block 2028, Block Group 2, Census Tract 5043.08, Santa Clara County, California",1,0,1
1000000US060855043082029,060855043082029,"Block 2029, Block Group 2, Census Tract 5043.08, Santa Clara County, California",0,0,0
1000000US060855043082030,060855043082030,"Block 2030, Block Group 2, Census Tract 5043.08, Santa Clara County, California",1,1,0
1000000US060855043082031,060855043082031,"Block 2031, Block Group 2, Census Tract 5043.08, Santa Clara County, California",3,3,0
1000000US060855043082032,060855043082032,"Block 2032, Block Group 2, Census Tract 5043.08, Santa Clara County, California",10,10,0
1000000US060855043082033,060855043082033,"Block 2033, Block Group 2, Census Tract 5043.08, Santa Clara County, California",5,5,0
1000000US060855043082034,060855043082034,"Block 2034, Block Group 2, Census Tract 5043.08, Santa Clara County, California",3,3,0
1000000US060855043083000,060855043083000,"Block 3000, Block Group 3, Census Tract 5043.08, Santa Clara County, California",19,19,0
1000000US060855043083001,060855043083001,"Block 3001, Block Group 3, Census Tract 5043.08, Santa Clara County, California",49,47,2
1000000US060855043083002,060855043083002,"Block 3002, Block Group 3, Census Tract 5043.08, Santa Clara County, California",18,18,0
1000000US060855043083003,060855043083003,"Block 3003, Block Group 3, Census Tract 5043.08, Santa Clara County, California",5,3,2
1000000US060855043083004,060855043083004,"Block 3004, Block Group 3, Census Tract 5043.08, Santa Clara County, California",28,27,1
1000000US060855043083005,060855043083005,"Block 3005, Block Group 3, Census Tract 5043.08, Santa Clara County, California",14,14,0
1000000US060855043083006,060855043083006,"Block 3006, Block Group 3, Census Tract 5043.08, Santa Clara County, California",38,38,0
1000000US060855043083007,060855043083007,"Block 3007, Block Group 3, Census Tract 5043.08, Santa Clara County, California",1,1,0
1000000US060855043083008,060855043083008,"Block 3008, Block Group 3, Census Tract 5043.08, Santa Clara County, California",13,13,0
1000000US060855043083009,060855043083009,"Block 3009, Block Group 3, Census Tract 5043.08, Santa Clara County, California",13,13,0
1000000US060855043083010,060855043083010,"Block 3010, Block Group 3, Census Tract 5043.08, Santa Clara County, California",11,11,0
1000000US060855043083011,060855043083011,"Block 3011, Block Group 3, Census Tract 5043.08, Santa Clara County, California",21,20,1
1000000US060855043083012,060855043083012,"Block 3012, Block Group 3, Census Tract 5043.08, Santa Clara County, California",37,37,0
1000000US060855043083013,060855043083013,"Block 3013, Block Group 3, Census Tract 5043.08, Santa Clara County, California",10,10,0
1000000US060855043083014,060855043083014,"Block 3014, Block Group 3, Census Tract 5043.08, Santa Clara County, California",7,6,1
1000000US060855043083015,060855043083015,"Block 3015, Block Group 3, Census Tract 5043.08, Santa Clara County, California",1,1,0
1000000US060855043083016,060855043083016,"Block 3016, Block Group 3, Census Tract 5043.08, Santa Clara County, California",2,2,0
1000000US060855043083017,060855043083017,"Block 3017, Block Group 3, Census Tract 5043.08, Santa Clara County, California",1,1,0
1000000US060855043083018,060855043083018,"Block 3018, Block Group 3, Census Tract 5043.08, Santa Clara County, California",36,36,0
1000000US060855043083019,060855043083019,"Block 3019, Block Group 3, Census Tract 5043.08, Santa Clara County, California",33,33,0
1000000US060855043083020,060855043083020,"Block 3020, Block Group 3, Census Tract 5043.08, Santa Clara County, California",21,21,0
1000000US060855043083021,060855043083021,"Block 3021, Block Group 3, Census Tract 5043.08, Santa Clara County, California",26,26,0
1000000US060855043083022,060855043083022,"Block 3022, Block Group 3, Census Tract 5043.08, Santa Clara County, California",18,18,0
1000000US060855043083023,060855043083023,"Block 3023, Block Group 3, Census Tract 5043.08, Santa Clara County, California",17,17,0
1000000US060855043083024,060855043083024,"Block 3024, Block Group 3, Census Tract 5043.08, Santa Clara County, California",0,0,0
1000000US060855043111000,060855043111000,"Block 1000, Block Group 1, Census Tract 5043.11, Santa Clara County, California",58,58,0
1000000US060855043111001,060855043111001,"Block 1001, Block Group 1, Census Tract 5043.11, Santa Clara County, California",19,19,0
1000000US060855043111002,060855043111002,"Block 1002, Block Group 1, Census Tract 5043.11, Santa Clara County, California",25,25,0
1000000US060855043111003,060855043111003,"Block 1003, Block Group 1, Census Tract 5043.11, Santa Clara County, California",0,0,0
1000000US060855043111004,060855043111004,"Block 1004, Block Group 1, Census Tract 5043.11, Santa Clara County, California",12,10,2
1000000US060855043111005,060855043111005,"Block 1005, Block Group 1, Census Tract 5043.11, Santa Clara County, California",0,0,0
1000000US060855043111006,060855043111006,"Block 1006, Block Group 1, Census Tract 5043.11, Santa Clara County, California",57,55,2
1000000US060855043111007,060855043111007,"Block 1007, Block Group 1, Census Tract 5043.11, Santa Clara County, California",64,63,1
1000000US060855043111008,060855043111008,"Block 1008, Block Group 1, Census Tract 5043.11, Santa Clara County, California",248,242,6
1000000US060855043111009,060855043111009,"Block 1009, Block Group 1, Census Tract 5043.11, Santa Clara County, California",24,23,1
1000000US060855043111010,060855043111010,"Block 1010, Block Group 1, Census Tract 5043.11, Santa Clara County, California",23,22,1
1000000US060855043111011,060855043111011,"Block 1011, Block Group 1, Census Tract 5043.11, Santa Clara County, California",56,54,2
1000000US060855043111012,060855043111012,"Block 1012, Block Group 1, Census Tract 5043.11, Santa Clara County, California",23,23,0
1000000US060855043111013,060855043111013,"Block 1013, Block Group 1, Census Tract 5043.11, Santa Clara County, California",2,2,0
1000000US060855043111014,060855043111014,"Block 1014, Block Group 1, Census Tract 5043.11, Santa Clara County, California",128,126,2
1000000US060855043111015,060855043111015,"Block 1015, Block Group 1, Census Tract 5043.11, Santa Clara County, California",23,22,1
1000000US060855043111016,060855043111016,"Block 1016, Block Group 1, Census Tract 5043.11, Santa Clara County, California",18,18,0
1000000US060855043111017,060855043111017,"Block 1017, Block Group 1, Census Tract 5043.11, Santa Clara County, California",74,72,2
1000000US060855043111018,060855043111018,"Block 1018, Block Group 1, Census Tract 5043.11, Santa Clara County, California",32,32,0
1000000US060855043111019,060855043111019,"Block 1019, Block Group 1, Census Tract 5043.11, Santa Clara County, California",51,46,5
1000000US060855043111020,060855043111020,"Block 1020, Block Group 1, Census Tract 5043.11, Santa Clara County, California",0,0,0
1000000US060855043112000,060855043112000,"Block 2000, Block Group 2, Census Tract 5043.11, Santa Clara County, California",101,100,1
1000000US060855043112001,060855043112001,"Block 2001, Block Group 2, Census Tract 5043.11, Santa Clara County, California",20,18,2
1000000US060855043112002,060855043112002,"Block 2002, Block Group 2, Census Tract 5043.11, Santa Clara County, California",15,15,0
1000000US060855043112003,060855043112003,"Block 2003, Block Group 2, Census Tract 5043.11, Santa Clara County, California",27,27,0
1000000US060855043112004,060855043112004,"Block 2004, Block Group 2, Census Tract 5043.11, Santa Clara County, California",26,26,0
1000000US060855043112005,060855043112005,"Block 2005, Block Group 2, Census Tract 5043.11, Santa Clara County, California",28,27,1
1000000US060855043112006,060855043112006,"Block 2006, Block Group 2, Census Tract 5043.11, Santa Clara County, California",21,20,1
1000000US060855043112007,060855043112007,"Block 2007, Block Group 2, Census Tract 5043.11, Santa Clara County, California",185,183,2
1000000US060855043112008,060855043112008,"Block 2008, Block Group 2, Census Tract 5043.11, Santa Clara County, California",19,19,0
1000000US060855043112009,060855043112009,"Block 2009, Block Group 2, Census Tract 5043.11, Santa Clara County, California",27,27,0
1000000US060855043112010,060855043112010,"Block 2010, Block Group 2, Census Tract 5043.11, Santa Clara County, California",55,54,1
1000000US060855043112011,060855043112011,"Block 2011, Block Group 2, Census Tract 5043.11, Santa Clara County, California",27,27,0
1000000US060855043112012,060855043112012,"Block 2012, Block Group 2, Census Tract 5043.11, Santa Clara County, California",51,50,1
1000000US060855043112013,060855043112013,"Block 2013, Block Group 2, Census Tract 5043.11, Santa Clara County, California",51,49,2
1000000US060855043112014,060855043112014,"Block 2014, Block Group 2, Census Tract 5043.11, Santa Clara County, California",19,19,0
1000000US060855043112015,060855043112015,"Block 2015, Block Group 2, Census Tract 5043.11, Santa Clara County, California",27,26,1
1000000US060855043112016,060855043112016,"Block 2016, Block Group 2, Census Tract 5043.11, Santa Clara County, California",149,146,3
1000000US060855043112017,060855043112017,"Block 2017, Block Group 2, Census Tract 5043.11, Santa Clara County, California",14,14,0
1000000US060855043112018,060855043112018,"Block 2018, Block Group 2, Census Tract 5043.11, Santa Clara County, California",43,40,3
1000000US060855043112019,060855043112019,"Block 2019, Block Group 2, Census Tract 5043.11, Santa Clara County, California",20,20,0
1000000US060855043113000,060855043113000,"Block 3000, Block Group 3, Census Tract 5043.11, Santa Clara County, California",26,26,0
1000000US060855043113001,060855043113001,"Block 3001, Block Group 3, Census Tract 5043.11, Santa Clara County, California",23,22,1
1000000US060855043113002,060855043113002,"Block 3002, Block Group 3, Census Tract 5043.11, Santa Clara County, California",26,26,0
1000000US060855043113003,060855043113003,"Block 3003, Block Group 3, Census Tract 5043.11, Santa Clara County, California",132,129,3
1000000US060855043113004,060855043113004,"Block 3004, Block Group 3, Census Tract 5043.11, Santa Clara County, California",21,21,0
1000000US060855043113005,060855043113005,"Block 3005, Block Group 3, Census Tract 5043.11, Santa Clara County, California",0,0,0
1000000US060855043113006,060855043113006,"Block 3006, Block Group 3, Census Tract 5043.11, Santa Clara County, California",28,26,2
1000000US060855043113007,060855043113007,"Block 3007, Block Group 3, Census Tract 5043.11, Santa Clara County, California",90,84,6
1000000US060855043113008,060855043113008,"Block 3008, Block Group 3, Census Tract 5043.11, Santa Clara County, California",0,0,0
1000000US060855043113009,060855043113009,"Block 3009, Block Group 3, Census Tract 5043.11, Santa Clara County, California",9,9,0
1000000US060855043113010,060855043113010,"Block 3010, Block Group 3, Census Tract 5043.11, Santa Clara County, California",17,17,0
1000000US060855043113011,060855043113011,"Block 3011, Block Group 3, Census Tract 5043.11, Santa Clara County, California",25,22,3
1000000US060855043113012,060855043113012,"Block 3012, Block Group 3, Census Tract 5043.11, Santa Clara County, California",6,6,0
1000000US060855043113013,060855043113013,"Block 3013, Block Group 3, Census Tract 5043.11, Santa Clara County, California",68,68,0
1000000US060855043113014,060855043113014,"Block 3014, Block Group 3, Census Tract 5043.11, Santa Clara County, California",20,19,1
1000000US060855043113015,060855043113015,"Block 3015, Block Group 3, Census Tract 5043.11, Santa Clara County, California",0,0,0
1000000US060855043113016,060855043113016,"Block 3016, Block Group 3, Census Tract 5043.11, Santa Clara County, California",2,2,0
1000000US060855043141000,060855043141000,"Block 1000, Block Group 1, Census Tract 5043.14, Santa Clara County, California",106,106,0
1000000US060855043141001,060855043141001,"Block 1001, Block Group 1, Census Tract 5043.14, Santa Clara County, California",48,47,1
1000000US060855043141002,060855043141002,"Block 1002, Block Group 1, Census Tract 5043.14, Santa Clara County, California",42,41,1
1000000US060855043141003,060855043141003,"Block 1003, Block Group 1, Census Tract 5043.14, Santa Clara County, California",64,60,4
1000000US060855043141004,060855043141004,"Block 1004, Block Group 1, Census Tract 5043.14, Santa Clara County, California",70,70,0
1000000US060855043141005,060855043141005,"Block 1005, Block Group 1, Census Tract 5043.14, Santa Clara County, California",46,46,0
1000000US060855043142000,060855043142000,"Block 2000, Block Group 2, Census Tract 5043.14, Santa Clara County, California",20,20,0
1000000US060855043142001,060855043142001,"Block 2001, Block Group 2, Census Tract 5043.14, Santa Clara County, California",38,36,2
1000000US060855043142002,060855043142002,"Block 2002, Block Group 2, Census Tract 5043.14, Santa Clara County, California",30,28,2
1000000US060855043142003,060855043142003,"Block 2003, Block Group 2, Census Tract 5043.14, Santa Clara County, California",66,66,0
1000000US060855043142004,060855043142004,"Block 2004, Block Group 2, Census Tract 5043.14, Santa Clara County, California",39,39,0
1000000US060855043142005,060855043142005,"Block 2005, Block Group 2, Census Tract 5043.14, Santa Clara County, California",38,38,0
1000000US060855043142006,060855043142006,"Block 2006, Block Group 2, Census Tract 5043.14, Santa Clara County, California",38,37,1
1000000US060855043142007,060855043142007,"Block 2007, Block Group 2, Census Tract 5043.14, Santa Clara County, California",40,40,0
1000000US060855043143000,060855043143000,"Block 3000, Block Group 3, Census Tract 5043.14, Santa Clara County, California",38,38,0
1000000US060855043143001,060855043143001,"Block 3001, Block Group 3, Census Tract 5043.14, Santa Clara County, California",39,38,1
1000000US060855043143002,060855043143002,"Block 3002, Block Group 3, Census Tract 5043.14, Santa Clara County, California",42,40,2
1000000US060855043143003,060855043143003,"Block 3003, Block Group 3, Census Tract 5043.14, Santa Clara County, California",34,34,0
1000000US060855043143004,060855043143004,"Block 3004, Block Group 3, Census Tract 5043.14, Santa Clara County, California",54,54,0
1000000US060855043143005,060855043143005,"Block 3005, Block Group 3, Census Tract 5043.14, Santa Clara County, California",52,52,0
1000000US060855043144000,060855043144000,"Block 4000, Block Group 4, Census Tract 5043.14, Santa Clara County, California",115,113,2
1000000US060855043144001,060855043144001,"Block 4001, Block Group 4, Census Tract 5043.14, Santa Clara County, California",26,26,0
1000000US060855043144002,060855043144002,"Block 4002, Block Group 4, Census Tract 5043.14, Santa Clara County, California",26,26,0
1000000US060855043144003,060855043144003,"Block 4003, Block Group 4, Census Tract 5043.14, Santa Clara County, California",33,32,1
1000000US060855043144004,060855043144004,"Block 4004, Block Group 4, Census Tract 5043.14, Santa Clara County, California",69,66,3
1000000US060855043144005,060855043144005,"Block 4005, Block Group 4, Census Tract 5043.14, Santa Clara County, California",46,46,0
1000000US060855043144006,060855043144006,"Block 4006, Block Group 4, Census Tract 5043.14, Santa Clara County, California",30,30,0
1000000US060855043144007,060855043144007,"Block 4007, Block Group 4, Census Tract 5043.14, Santa Clara County, California",20,20,0
1000000US060855043151000,060855043151000,"Block 1000, Block Group 1, Census Tract 5043.15, Santa Clara County, California",40,40,0
1000000US060855043151001,060855043151001,"Block 1001, Block Group 1, Census Tract 5043.15, Santa Clara County, California",38,38,0
1000000US060855043151002,060855043151002,"Block 1002, Block Group 1, Census Tract 5043.15, Santa Clara County, California",51,49,2
1000000US060855043151003,060855043151003,"Block 1003, Block Group 1, Census Tract 5043.15, Santa Clara County, California",0,0,0
1000000US060855043151004,060855043151004,"Block 1004, Block Group 1, Census Tract 5043.15, Santa Clara County, California",123,119,4
1000000US060855043151005,060855043151005,"Block 1005, Block Group 1, Census Tract 5043.15, Santa Clara County, California",0,0,0
1000000US060855043151006,060855043151006,"Block 1006, Block Group 1, Census Tract 5043.15, Santa Clara County, California",0,0,0
1000000US060855043151007,060855043151007,"Block 1007, Block Group 1, Census Tract 5043.15, Santa Clara County, California",59,56,3
1000000US060855043151008,060855043151008,"Block 1008, Block Group 1, Census Tract 5043.15, Santa Clara County, California",0,0,0
1000000US060855043151009,060855043151009,"Block 1009, Block Group 1, Census Tract 5043.15, Santa Clara County, California",0,0,0
1000000US060855043151010,060855043151010,"Block 1010, Block Group 1, Census Tract 5043.15, Santa Clara County, California",46,46,0
1000000US060855043151011,060855043151011,"Block 1011, Block Group 1, Census Tract 5043.15, Santa Clara County, California",0,0,0
1000000US060855043151012,060855043151012,"Block 1012, Block Group 1, Census Tract 5043.15, Santa Clara County, California",135,131,4
1000000US060855043151013,060855043151013,"Block 1013, Block Group 1, Census Tract 5043.15, Santa Clara County, California",0,0,0
1000000US060855043151014,060855043151014,"Block 1014, Block Group 1, Census Tract 5043.15, Santa Clara County, California",20,20,0
1000000US060855043151015,060855043151015,"Block 1015, Block Group 1, Census Tract 5043.15, Santa Clara County, California",0,0,0
1000000US060855043151016,060855043151016,"Block 1016, Block Group 1, Census Tract 5043.15, Santa Clara County, California",0,0,0
1000000US060855043151017,060855043151017,"Block 1017, Block Group 1, Census Tract 5043.15, Santa Clara County, California",24,24,0
1000000US060855043152000,060855043152000,"Block 2000, Block Group 2, Census Tract 5043.15, Santa Clara County, California",34,34,0
1000000US060855043152001,060855043152001,"Block 2001, Block Group 2, Census Tract 5043.15, Santa Clara County, California",14,12,2
1000000US060855043152002,060855043152002,"Block 2002, Block Group 2, Census Tract 5043.15, Santa Clara County, California",34,33,1
1000000US060855043152003,060855043152003,"Block 2003, Block Group 2, Census Tract 5043.15, Santa Clara County, California",62,61,1
1000000US060855043152004,060855043152004,"Block 2004, Block Group 2, Census Tract 5043.15, Santa Clara County, California",78,77,1
1000000US060855043152005,060855043152005,"Block 2005, Block Group 2, Census Tract 5043.15, Santa Clara County, California",42,42,0
1000000US060855043153000,060855043153000,"Block 3000, Block Group 3, Census Tract 5043.15, Santa Clara County, California",28,28,0
1000000US060855043153001,060855043153001,"Block 3001, Block Group 3, Census Tract 5043.15, Santa Clara County, California",72,70,2
1000000US060855043153002,060855043153002,"Block 3002, Block Group 3, Census Tract 5043.15, Santa Clara County, California",29,28,1
1000000US060855043153003,060855043153003,"Block 3003, Block Group 3, Census Tract 5043.15, Santa Clara County, California",52,52,0
1000000US060855043153004,060855043153004,"Block 3004, Block Group 3, Census Tract 5043.15, Santa Clara County, California",40,40,0
1000000US060855043153005,060855043153005,"Block 3005, Block Group 3, Census Tract 5043.15, Santa Clara County, California",58,57,1
1000000US060855043153006,060855043153006,"Block 3006, Block Group 3, Census Tract 5043.15, Santa Clara County, California",46,46,0
1000000US060855043153007,060855043153007,"Block 3007, Block Group 3, Census Tract 5043.15, Santa Clara County, California",24,24,0
1000000US060855043153008,060855043153008,"Block 3008, Block Group 3, Census Tract 5043.15, Santa Clara County, California",64,60,4
1000000US060855043153009,060855043153009,"Block 3009, Block Group 3, Census Tract 5043.15, Santa Clara County, California",33,33,0
1000000US060855043154000,060855043154000,"Block 4000, Block Group 4, Census Tract 5043.15, Santa Clara County, California",22,22,0
1000000US060855043154001,060855043154001,"Block 4001, Block Group 4, Census Tract 5043.15, Santa Clara County, California",23,23,0
1000000US060855043154002,060855043154002,"Block 4002, Block Group 4, Census Tract 5043.15, Santa Clara County, California",45,45,0
1000000US060855043154003,060855043154003,"Block 4003, Block Group 4, Census Tract 5043.15, Santa Clara County, California",35,34,1
1000000US060855043154004,060855043154004,"Block 4004, Block Group 4, Census Tract 5043.15, Santa Clara County, California",47,44,3
1000000US060855043154005,060855043154005,"Block 4005, Block Group 4, Census Tract 5043.15, Santa Clara County, California",39,36,3
1000000US060855043154006,060855043154006,"Block 4006, Block Group 4, Census Tract 5043.15, Santa Clara County, California",53,53,0
1000000US060855043154007,060855043154007,"Block 4007, Block Group 4, Census Tract 5043.15, Santa Clara County, California",40,39,1
1000000US060855043154008,060855043154008,"Block 4008, Block Group 4, Census Tract 5043.15, Santa Clara County, California",17,17,0
1000000US060855043155000,060855043155000,"Block 5000, Block Group 5, Census Tract 5043.15, Santa Clara County, California",13,12,1
1000000US060855043155001,060855043155001,"Block 5001, Block Group 5, Census Tract 5043.15, Santa Clara County, California",26,26,0
1000000US060855043155002,060855043155002,"Block 5002, Block Group 5, Census Tract 5043.15, Santa Clara County, California",205,196,9
1000000US060855043155003,060855043155003,"Block 5003, Block Group 5, Census Tract 5043.15, Santa Clara County, California",9,9,0
1000000US060855043155004,060855043155004,"Block 5004, Block Group 5, Census Tract 5043.15, Santa Clara County, California",19,17,2
1000000US060855043155005,060855043155005,"Block 5005, Block Group 5, Census Tract 5043.15, Santa Clara County, California",40,39,1
1000000US060855043155006,060855043155006,"Block 5006, Block Group 5, Census Tract 5043.15, Santa Clara County, California",45,45,0
1000000US060855043155007,060855043155007,"Block 5007, Block Group 5, Census Tract 5043.15, Santa Clara County, California",42,42,0
1000000US060855043161000,060855043161000,"Block 1000, Block Group 1, Census Tract 5043.16, Santa Clara County, California",191,178,13
1000000US060855043161001,060855043161001,"Block 1001, Block Group 1, Census Tract 5043.16, Santa Clara County, California",33,32,1
1000000US060855043161002,060855043161002,"Block 1002, Block Group 1, Census Tract 5043.16, Santa Clara County, California",18,18,0
1000000US060855043161003,060855043161003,"Block 1003, Block Group 1, Census Tract 5043.16, Santa Clara County, California",26,26,0
1000000US060855043161004,060855043161004,"Block 1004, Block Group 1, Census Tract 5043.16, Santa Clara County, California",43,43,0
1000000US060855043161005,060855043161005,"Block 1005, Block Group 1, Census Tract 5043.16, Santa Clara County, California",14,14,0
1000000US060855043161006,060855043161006,"Block 1006, Block Group 1, Census Tract 5043.16, Santa Clara County, California",67,64,3
1000000US060855043161007,060855043161007,"Block 1007, Block Group 1, Census Tract 5043.16, Santa Clara County, California",68,68,0
1000000US060855043161008,060855043161008,"Block 1008, Block Group 1, Census Tract 5043.16, Santa Clara County, California",83,82,1
1000000US060855043161009,060855043161009,"Block 1009, Block Group 1, Census Tract 5043.16, Santa Clara County, California",3,3,0
1000000US060855043161010,060855043161010,"Block 1010, Block Group 1, Census Tract 5043.16, Santa Clara County, California",36,36,0
1000000US060855043161011,060855043161011,"Block 1011, Block Group 1, Census Tract 5043.16, Santa Clara County, California",34,34,0
1000000US060855043161012,060855043161012,"Block 1012, Block Group 1, Census Tract 5043.16, Santa Clara County, California",24,23,1
1000000US060855043161013,060855043161013,"Block 1013, Block Group 1, Census Tract 5043.16, Santa Clara County, California",24,24,0
1000000US060855043161014,060855043161014,"Block 1014, Block Group 1, Census Tract 5043.16, Santa Clara County, California",24,23,1
1000000US060855043161015,060855043161015,"Block 1015, Block Group 1, Census Tract 5043.16, Santa Clara County, California",40,40,0
1000000US060855043162000,060855043162000,"Block 2000, Block Group 2, Census Tract 5043.16, Santa Clara County, California",52,52,0
1000000US060855043162001,060855043162001,"Block 2001, Block Group 2, Census Tract 5043.16, Santa Clara County, California",51,50,1
1000000US060855043162002,060855043162002,"Block 2002, Block Group 2, Census Tract 5043.16, Santa Clara County, California",60,59,1
1000000US060855043162003,060855043162003,"Block 2003, Block Group 2, Census Tract 5043.16, Santa Clara County, California",23,22,1
1000000US060855043162004,060855043162004,"Block 2004, Block Group 2, Census Tract 5043.16, Santa Clara County, California",44,43,1
1000000US060855043162005,060855043162005,"Block 2005, Block Group 2, Census Tract 5043.16, Santa Clara County, California",36,35,1
1000000US060855043162006,060855043162006,"Block 2006, Block Group 2, Census Tract 5043.16, Santa Clara County, California",39,38,1
1000000US060855043162007,060855043162007,"Block 2007, Block Group 2, Census Tract 5043.16, Santa Clara County, California",137,136,1
1000000US060855043163000,060855043163000,"Block 3000, Block Group 3, Census Tract 5043.16, Santa Clara County, California",43,41,2
1000000US060855043163001,060855043163001,"Block 3001, Block Group 3, Census Tract 5043.16, Santa Clara County, California",86,85,1
1000000US060855043163002,060855043163002,"Block 3002, Block Group 3, Census Tract 5043.16, Santa Clara County, California",40,38,2
1000000US060855043163003,060855043163003,"Block 3003, Block Group 3, Census Tract 5043.16, Santa Clara County, California",21,19,2
1000000US060855043163004,060855043163004,"Block 3004, Block Group 3, Census Tract 5043.16, Santa Clara County, California",41,38,3
1000000US060855043171000,060855043171000,"Block 1000, Block Group 1, Census Tract 5043.17, Santa Clara County, California",29,29,0
1000000US060855043171001,060855043171001,"Block 1001, Block Group 1, Census Tract 5043.17, Santa Clara County, California",22,22,0
1000000US060855043171002,060855043171002,"Block 1002, Block Group 1, Census Tract 5043.17, Santa Clara County, California",61,60,1
1000000US060855043171003,060855043171003,"Block 1003, Block Group 1, Census Tract 5043.17, Santa Clara County, California",30,29,1
1000000US060855043171004,060855043171004,"Block 1004, Block Group 1, Census Tract 5043.17, Santa Clara County, California",45,45,0
1000000US060855043171005,060855043171005,"Block 1005, Block Group 1, Census Tract 5043.17, Santa Clara County, California",54,52,2
1000000US060855043171006,060855043171006,"Block 1006, Block Group 1, Census Tract 5043.17, Santa Clara County, California",97,94,3
1000000US060855043171007,060855043171007,"Block 1007, Block Group 1, Census Tract 5043.17, Santa Clara County, California",108,104,4
1000000US060855043171008,060855043171008,"Block 1008, Block Group 1, Census Tract 5043.17, Santa Clara County, California",45,44,1
1000000US060855043171009,060855043171009,"Block 1009, Block Group 1, Census Tract 5043.17, Santa Clara County, California",0,0,0
1000000US060855043171010,060855043171010,"Block 1010, Block Group 1, Census Tract 5043.17, Santa Clara County, California",53,53,0
1000000US060855043171011,060855043171011,"Block 1011, Block Group 1, Census Tract 5043.17, Santa Clara County, California",30,30,0
1000000US060855043171012,060855043171012,"Block 1012, Block Group 1, Census Tract 5043.17, Santa Clara County, California",63,63,0
1000000US060855043171013,060855043171013,"Block 1013, Block Group 1, Census Tract 5043.17, Santa Clara County, California",41,41,0
1000000US060855043172000,060855043172000,"Block 2000, Block Group 2, Census Tract 5043.17, Santa Clara County, California",29,28,1
1000000US060855043172001,060855043172001,"Block 2001, Block Group 2, Census Tract 5043.17, Santa Clara County, California",66,65,1
1000000US060855043172002,060855043172002,"Block 2002, Block Group 2, Census Tract 5043.17, Santa Clara County, California",47,45,2
1000000US060855043172003,060855043172003,"Block 2003, Block Group 2, Census Tract 5043.17, Santa Clara County, California",30,30,0
1000000US060855043172004,060855043172004,"Block 2004, Block Group 2, Census Tract 5043.17, Santa Clara County, California",20,15,5
1000000US060855043172005,060855043172005,"Block 2005, Block Group 2, Census Tract 5043.17, Santa Clara County, California",91,86,5
1000000US060855043172006,060855043172006,"Block 2006, Block Group 2, Census Tract 5043.17, Santa Clara County, California",94,91,3
1000000US060855043172007,060855043172007,"Block 2007, Block Group 2, Census Tract 5043.17, Santa Clara County, California",37,35,2
1000000US060855043172008,060855043172008,"Block 2008, Block Group 2, Census Tract 5043.17, Santa Clara County, California",48,47,1
1000000US060855043172009,060855043172009,"Block 2009, Block Group 2, Census Tract 5043.17, Santa Clara County, California",34,34,0
1000000US060855043172010,060855043172010,"Block 2010, Block Group 2, Census Tract 5043.17, Santa Clara County, California",48,47,1
1000000US060855043181000,060855043181000,"Block 1000, Block Group 1, Census Tract 5043.18, Santa Clara County, California",102,100,2
1000000US060855043181001,060855043181001,"Block 1001, Block Group 1, Census Tract 5043.18, Santa Clara County, California",10,10,0
1000000US060855043181002,060855043181002,"Block 1002, Block Group 1, Census Tract 5043.18, Santa Clara County, California",16,16,0
1000000US060855043181003,060855043181003,"Block 1003, Block Group 1, Census Tract 5043.18, Santa Clara County, California",28,28,0
1000000US060855043181004,060855043181004,"Block 1004, Block Group 1, Census Tract 5043.18, Santa Clara County, California",23,23,0
1000000US060855043181005,060855043181005,"Block 1005, Block Group 1, Census Tract 5043.18, Santa Clara County, California",36,32,4
1000000US060855043181006,060855043181006,"Block 1006, Block Group 1, Census Tract 5043.18, Santa Clara County, California",14,13,1
1000000US060855043181007,060855043181007,"Block 1007, Block Group 1, Census Tract 5043.18, Santa Clara County, California",10,10,0
1000000US060855043181008,060855043181008,"Block 1008, Block Group 1, Census Tract 5043.18, Santa Clara County, California",34,33,1
1000000US060855043181009,060855043181009,"Block 1009, Block Group 1, Census Tract 5043.18, Santa Clara County, California",30,29,1
1000000US060855043181010,060855043181010,"Block 1010, Block Group 1, Census Tract 5043.18, Santa Clara County, California",10,10,0
1000000US060855043181011,060855043181011,"Block 1011, Block Group 1, Census Tract 5043.18, Santa Clara County, California",9,7,2
1000000US060855043181012,060855043181012,"Block 1012, Block Group 1, Census Tract 5043.18, Santa Clara County, California",0,0,0
1000000US060855043181013,060855043181013,"Block 1013, Block Group 1, Census Tract 5043.18, Santa Clara County, California",13,13,0
1000000US060855043181014,060855043181014,"Block 1014, Block Group 1, Census Tract 5043.18, Santa Clara County, California",16,14,2
1000000US060855043181015,060855043181015,"Block 1015, Block Group 1, Census Tract 5043.18, Santa Clara County, California",20,20,0
1000000US060855043181016,060855043181016,"Block 1016, Block Group 1, Census Tract 5043.18, Santa Clara County, California",0,0,0
1000000US060855043181017,060855043181017,"Block 1017, Block Group 1, Census Tract 5043.18, Santa Clara County, California",0,0,0
1000000US060855043181018,060855043181018,"Block 1018, Block Group 1, Census Tract 5043.18, Santa Clara County, California",10,10,0
1000000US060855043181019,060855043181019,"Block 1019, Block Group 1, Census Tract 5043.18, Santa Clara County, California",29,29,0
1000000US060855043181020,060855043181020,"Block 1020, Block Group 1, Census Tract 5043.18, Santa Clara County, California",58,45,13
1000000US060855043181021,060855043181021,"Block 1021, Block Group 1, Census Tract 5043.18, Santa Clara County, California",32,31,1
1000000US060855043181022,060855043181022,"Block 1022, Block Group 1, Census Tract 5043.18, Santa Clara County, California",41,40,1
1000000US060855043181023,060855043181023,"Block 1023, Block Group 1, Census Tract 5043.18, Santa Clara County, California",28,26,2
1000000US060855043181024,060855043181024,"Block 1024, Block Group 1, Census Tract 5043.18, Santa Clara County, California",11,9,2
1000000US060855043181025,060855043181025,"Block 1025, Block Group 1, Census Tract 5043.18, Santa Clara County, California",15,15,0
1000000US060855043181026,060855043181026,"Block 1026, Block Group 1, Census Tract 5043.18, Santa Clara County, California",15,15,0
1000000US060855043181027,060855043181027,"Block 1027, Block Group 1, Census Tract 5043.18, Santa Clara County, California",0,0,0
1000000US060855043181028,060855043181028,"Block 1028, Block Group 1, Census Tract 5043.18, Santa Clara County, California",1,1,0
1000000US060855043181029,060855043181029,"Block 1029, Block Group 1, Census Tract 5043.18, Santa Clara County, California",0,0,0
1000000US060855043181030,060855043181030,"Block 1030, Block Group 1, Census Tract 5043.18, Santa Clara County, California",0,0,0
1000000US060855043181031,060855043181031,"Block 1031, Block Group 1, Census Tract 5043.18, Santa Clara County, California",0,0,0
1000000US060855043181032,060855043181032,"Block 1032, Block Group 1, Census Tract 5043.18, Santa Clara County, California",0,0,0
1000000US060855043181033,060855043181033,"Block 1033, Block Group 1, Census Tract 5043.18, Santa Clara County, California",0,0,0
1000000US060855043181034,060855043181034,"Block 1034, Block Group 1, Census Tract 5043.18, Santa Clara County, California",0,0,0
1000000US060855043181035,060855043181035,"Block 1035, Block Group 1, Census Tract 5043.18, Santa Clara County, California",0,0,0
1000000US060855043181036,060855043181036,"Block 1036, Block Group 1, Census Tract 5043.18, Santa Clara County, California",1,1,0
1000000US060855043181037,060855043181037,"Block 1037, Block Group 1, Census Tract 5043.18, Santa Clara County, California",0,0,0
1000000US060855043181038,060855043181038,"Block 1038, Block Group 1, Census Tract 5043.18, Santa Clara County, California",0,0,0
1000000US060855043181039,060855043181039,"Block 1039, Block Group 1, Census Tract 5043.18, Santa Clara County, California",2,2,0
1000000US060855043181040,060855043181040,"Block 1040, Block Group 1, Census Tract 5043.18, Santa Clara County, California",0,0,0
1000000US060855043181041,060855043181041,"Block 1041, Block Group 1, Census Tract 5043.18, Santa Clara County, California",47,36,11
1000000US060855043181042,060855043181042,"Block 1042, Block Group 1, Census Tract 5043.18, Santa Clara County, California",3,2,1
1000000US060855043181043,060855043181043,"Block 1043, Block Group 1, Census Tract 5043.18, Santa Clara County, California",0,0,0
1000000US060855043181044,060855043181044,"Block 1044, Block Group 1, Census Tract 5043.18, Santa Clara County, California",71,65,6
1000000US060855043181045,060855043181045,"Block 1045, Block Group 1, Census Tract 5043.18, Santa Clara County, California",39,31,8
1000000US060855043181046,060855043181046,"Block 1046, Block Group 1, Census Tract 5043.18, Santa Clara County, California",9,0,9
1000000US060855043181047,060855043181047,"Block 1047, Block Group 1, Census Tract 5043.18, Santa Clara County, California",25,21,4
1000000US060855043181048,060855043181048,"Block 1048, Block Group 1, Census Tract 5043.18, Santa Clara County, California",1,1,0
1000000US060855043181049,060855043181049,"Block 1049, Block Group 1, Census Tract 5043.18, Santa Clara County, California",2,1,1
1000000US060855043181050,060855043181050,"Block 1050, Block Group 1, Census Tract 5043.18, Santa Clara County, California",23,23,0
1000000US060855043181051,060855043181051,"Block 1051, Block Group 1, Census Tract 5043.18, Santa Clara County, California",34,33,1
1000000US060855043181052,060855043181052,"Block 1052, Block Group 1, Census Tract 5043.18, Santa Clara County, California",25,25,0
1000000US060855043181053,060855043181053,"Block 1053, Block Group 1, Census Tract 5043.18, Santa Clara County, California",0,0,0
1000000US060855043181054,060855043181054,"Block 1054, Block Group 1, Census Tract 5043.18, Santa Clara County, California",20,19,1
1000000US060855043181055,060855043181055,"Block 1055, Block Group 1, Census Tract 5043.18, Santa Clara County, California",16,16,0
1000000US060855043181056,060855043181056,"Block 1056, Block Group 1, Census Tract 5043.18, Santa Clara County, California",17,16,1
1000000US060855043181057,060855043181057,"Block 1057, Block Group 1, Census Tract 5043.18, Santa Clara County, California",36,31,5
1000000US060855043182000,060855043182000,"Block 2000, Block Group 2, Census Tract 5043.18, Santa Clara County, California",48,45,3
1000000US060855043182001,060855043182001,"Block 2001, Block Group 2, Census Tract 5043.18, Santa Clara County, California",47,47,0
1000000US060855043182002,060855043182002,"Block 2002, Block Group 2, Census Tract 5043.18, Santa Clara County, California",41,41,0
1000000US060855043182003,060855043182003,"Block 2003, Block Group 2, Census Tract 5043.18, Santa Clara County, California",4,2,2
1000000US060855043182004,060855043182004,"Block 2004, Block Group 2, Census Tract 5043.18, Santa Clara County, California",0,0,0
1000000US060855043182005,060855043182005,"Block 2005, Block Group 2, Census Tract 5043.18, Santa Clara County, California",1,1,0
1000000US060855043182006,060855043182006,"Block 2006, Block Group 2, Census Tract 5043.18, Santa Clara County, California",0,0,0
1000000US060855043182007,060855043182007,"Block 2007, Block Group 2, Census Tract 5043.18, Santa Clara County, California",0,0,0
1000000US060855043182008,060855043182008,"Block 2008, Block Group 2, Census Tract 5043.18, Santa Clara County, California",0,0,0
1000000US060855043182009,060855043182009,"Block 2009, Block Group 2, Census Tract 5043.18, Santa Clara County, California",0,0,0
1000000US060855043182010,060855043182010,"Block 2010, Block Group 2, Census Tract 5043.18, Santa Clara County, California",0,0,0
1000000US060855043182011,060855043182011,"Block 2011, Block Group 2, Census Tract 5043.18, Santa Clara County, California",0,0,0
1000000US060855043182012,060855043182012,"Block 2012, Block Group 2, Census Tract 5043.18, Santa Clara County, California",0,0,0
1000000US060855043182013,060855043182013,"Block 2013, Block Group 2, Census Tract 5043.18, Santa Clara County, California",15,15,0
1000000US060855043183000,060855043183000,"Block 3000, Block Group 3, Census Tract 5043.18, Santa Clara County, California",43,42,1
1000000US060855043183001,060855043183001,"Block 3001, Block Group 3, Census Tract 5043.18, Santa Clara County, California",13,12,1
1000000US060855043183002,060855043183002,"Block 3002, Block Group 3, Census Tract 5043.18, Santa Clara County, California",9,9,0
1000000US060855043183003,060855043183003,"Block 3003, Block Group 3, Census Tract 5043.18, Santa Clara County, California",25,25,0
1000000US060855043183004,060855043183004,"Block 3004, Block Group 3, Census Tract 5043.18, Santa Clara County, California",24,23,1
1000000US060855043183005,060855043183005,"Block 3005, Block Group 3, Census Tract 5043.18, Santa Clara County, California",0,0,0
1000000US060855043183006,060855043183006,"Block 3006, Block Group 3, Census Tract 5043.18, Santa Clara County, California",0,0,0
1000000US060855043183007,060855043183007,"Block 3007, Block Group 3, Census Tract 5043.18, Santa Clara County, California",10,10,0
1000000US060855043183008,060855043183008,"Block 3008, Block Group 3, Census Tract 5043.18, Santa Clara County, California",30,30,0
1000000US060855043183009,060855043183009,"Block 3009, Block Group 3, Census Tract 5043.18, Santa Clara County, California",13,13,0
1000000US060855043183010,060855043183010,"Block 3010, Block Group 3, Census Tract 5043.18, Santa Clara County, California",125,122,3
1000000US060855043183011,060855043183011,"Block 3011, Block Group 3, Census Tract 5043.18, Santa Clara County, California",38,34,4
1000000US060855043183012,060855043183012,"Block 3012, Block Group 3, Census Tract 5043.18, Santa Clara County, California",9,9,0
1000000US060855043183013,060855043183013,"Block 3013, Block Group 3, Census Tract 5043.18, Santa Clara County, California",16,15,1
1000000US060855043183014,060855043183014,"Block 3014, Block Group 3, Census Tract 5043.18, Santa Clara County, California",10,10,0
1000000US060855043183015,060855043183015,"Block 3015, Block Group 3, Census Tract 5043.18, Santa Clara County, California",18,18,0
1000000US060855043183016,060855043183016,"Block 3016, Block Group 3, Census Tract 5043.18, Santa Clara County, California",8,7,1
1000000US060855043183017,060855043183017,"Block 3017, Block Group 3, Census Tract 5043.18, Santa Clara County, California",12,12,0
1000000US060855043183018,060855043183018,"Block 3018, Block Group 3, Census Tract 5043.18, Santa Clara County, California",49,47,2
1000000US060855043183019,060855043183019,"Block 3019, Block Group 3, Census Tract 5043.18, Santa Clara County, California",18,17,1
1000000US060855043183020,060855043183020,"Block 3020, Block Group 3, Census Tract 5043.18, Santa Clara County, California",15,15,0
1000000US060855043183021,060855043183021,"Block 3021, Block Group 3, Census Tract 5043.18, Santa Clara County, California",13,13,0
1000000US060855043183022,060855043183022,"Block 3022, Block Group 3, Census Tract 5043.18, Santa Clara County, California",13,13,0
1000000US060855043183023,060855043183023,"Block 3023, Block Group 3, Census Tract 5043.18, Santa Clara County, California",13,13,0
1000000US060855043191000,060855043191000,"Block 1000, Block Group 1, Census Tract 5043.19, Santa Clara County, California",35,35,0
1000000US060855043191001,060855043191001,"Block 1001, Block Group 1, Census Tract 5043.19, Santa Clara County, California",46,46,0
1000000US060855043191002,060855043191002,"Block 1002, Block Group 1, Census Tract 5043.19, Santa Clara County, California",0,0,0
1000000US060855043191003,060855043191003,"Block 1003, Block Group 1, Census Tract 5043.19, Santa Clara County, California",61,59,2
1000000US060855043191004,060855043191004,"Block 1004, Block Group 1, Census Tract 5043.19, Santa Clara County, California",49,48,1
1000000US060855043191005,060855043191005,"Block 1005, Block Group 1, Census Tract 5043.19, Santa Clara County, California",0,0,0
1000000US060855043191006,060855043191006,"Block 1006, Block Group 1, Census Tract 5043.19, Santa Clara County, California",17,17,0
1000000US060855043191007,060855043191007,"Block 1007, Block Group 1, Census Tract 5043.19, Santa Clara County, California",1,1,0
1000000US060855043191008,060855043191008,"Block 1008, Block Group 1, Census Tract 5043.19, Santa Clara County, California",124,123,1
1000000US060855043191009,060855043191009,"Block 1009, Block Group 1, Census Tract 5043.19, Santa Clara County, California",1,1,0
1000000US060855043191010,060855043191010,"Block 1010, Block Group 1, Census Tract 5043.19, Santa Clara County, California",0,0,0
1000000US060855043191011,060855043191011,"Block 1011, Block Group 1, Census Tract 5043.19, Santa Clara County, California",192,192,0
1000000US060855043191012,060855043191012,"Block 1012, Block Group 1, Census Tract 5043.19, Santa Clara County, California",62,62,0
1000000US060855043191013,060855043191013,"Block 1013, Block Group 1, Census Tract 5043.19, Santa Clara County, California",31,30,1
1000000US060855043191014,060855043191014,"Block 1014, Block Group 1, Census Tract 5043.19, Santa Clara County, California",190,182,8
1000000US060855043191015,060855043191015,"Block 1015, Block Group 1, Census Tract 5043.19, Santa Clara County, California",46,46,0
1000000US060855043191016,060855043191016,"Block 1016, Block Group 1, Census Tract 5043.19, Santa Clara County, California",31,31,0
1000000US060855043191017,060855043191017,"Block 1017, Block Group 1, Census Tract 5043.19, Santa Clara County, California",7,7,0
1000000US060855043191018,060855043191018,"Block 1018, Block Group 1, Census Tract 5043.19, Santa Clara County, California",37,37,0
1000000US060855043192000,060855043192000,"Block 2000, Block Group 2, Census Tract 5043.19, Santa Clara County, California",61,59,2
1000000US060855043192001,060855043192001,"Block 2001, Block Group 2, Census Tract 5043.19, Santa Clara County, California",41,40,1
1000000US060855043192002,060855043192002,"Block 2002, Block Group 2, Census Tract 5043.19, Santa Clara County, California",54,52,2
1000000US060855043192003,060855043192003,"Block 2003, Block Group 2, Census Tract 5043.19, Santa Clara County, California",78,77,1
1000000US060855043192004,060855043192004,"Block 2004, Block Group 2, Census Tract 5043.19, Santa Clara County, California",51,49,2
1000000US060855043192005,060855043192005,"Block 2005, Block Group 2, Census Tract 5043.19, Santa Clara County, California",56,55,1
1000000US060855043192006,060855043192006,"Block 2006, Block Group 2, Census Tract 5043.19, Santa Clara County, California",32,31,1
1000000US060855043192007,060855043192007,"Block 2007, Block Group 2, Census Tract 5043.19, Santa Clara County, California",9,8,1
1000000US060855043192008,060855043192008,"Block 2008, Block Group 2, Census Tract 5043.19, Santa Clara County, California",67,66,1
1000000US060855043192009,060855043192009,"Block 2009, Block Group 2, Census Tract 5043.19, Santa Clara County, California",10,10,0
1000000US060855043192010,060855043192010,"Block 2010, Block Group 2, Census Tract 5043.19, Santa Clara County, California",57,57,0
1000000US060855043192011,060855043192011,"Block 2011, Block Group 2, Census Tract 5043.19, Santa Clara County, California",17,17,0
1000000US060855043192012,060855043192012,"Block 2012, Block Group 2, Census Tract 5043.19, Santa Clara County, California",0,0,0
1000000US060855043193000,060855043193000,"Block 3000, Block Group 3, Census Tract 5043.19, Santa Clara County, California",130,129,1
1000000US060855043193001,060855043193001,"Block 3001, Block Group 3, Census Tract 5043.19, Santa Clara County, California",48,48,0
1000000US060855043193002,060855043193002,"Block 3002, Block Group 3, Census Tract 5043.19, Santa Clara County, California",58,58,0
1000000US060855043193003,060855043193003,"Block 3003, Block Group 3, Census Tract 5043.19, Santa Clara County, California",12,12,0
1000000US060855043193004,060855043193004,"Block 3004, Block Group 3, Census Tract 5043.19, Santa Clara County, California",9,9,0
1000000US060855043193005,060855043193005,"Block 3005, Block Group 3, Census Tract 5043.19, Santa Clara County, California",55,50,5
1000000US060855043193006,060855043193006,"Block 3006, Block Group 3, Census Tract 5043.19, Santa Clara County, California",43,42,1
1000000US060855043193007,060855043193007,"Block 3007, Block Group 3, Census Tract 5043.19, Santa Clara County, California",15,15,0
1000000US060855043193008,060855043193008,"Block 3008, Block Group 3, Census Tract 5043.19, Santa Clara County, California",64,63,1
1000000US060855043193009,060855043193009,"Block 3009, Block Group 3, Census Tract 5043.19, Santa Clara County, California",75,74,1
1000000US060855043193010,060855043193010,"Block 3010, Block Group 3, Census Tract 5043.19, Santa Clara County, California",14,14,0
1000000US060855043193011,060855043193011,"Block 3011, Block Group 3, Census Tract 5043.19, Santa Clara County, California",9,9,0
1000000US060855043193012,060855043193012,"Block 3012, Block Group 3, Census Tract 5043.19, Santa Clara County, California",22,21,1
1000000US060855043201000,060855043201000,"Block 1000, Block Group 1, Census Tract 5043.20, Santa Clara County, California",12,12,0
1000000US060855043201001,060855043201001,"Block 1001, Block Group 1, Census Tract 5043.20, Santa Clara County, California",12,11,1
1000000US060855043201002,060855043201002,"Block 1002, Block Group 1, Census Tract 5043.20, Santa Clara County, California",46,44,2
1000000US060855043201003,060855043201003,"Block 1003, Block Group 1, Census Tract 5043.20, Santa Clara County, California",42,42,0
1000000US060855043201004,060855043201004,"Block 1004, Block Group 1, Census Tract 5043.20, Santa Clara County, California",22,22,0
1000000US060855043201005,060855043201005,"Block 1005, Block Group 1, Census Tract 5043.20, Santa Clara County, California",50,48,2
1000000US060855043201006,060855043201006,"Block 1006, Block Group 1, Census Tract 5043.20, Santa Clara County, California",39,37,2
1000000US060855043201007,060855043201007,"Block 1007, Block Group 1, Census Tract 5043.20, Santa Clara County, California",51,49,2
1000000US060855043201008,060855043201008,"Block 1008, Block Group 1, Census Tract 5043.20, Santa Clara County, California",32,32,0
1000000US060855043201009,060855043201009,"Block 1009, Block Group 1, Census Tract 5043.20, Santa Clara County, California",47,47,0
1000000US060855043201010,060855043201010,"Block 1010, Block Group 1, Census Tract 5043.20, Santa Clara County, California",41,41,0
1000000US060855043201011,060855043201011,"Block 1011, Block Group 1, Census Tract 5043.20, Santa Clara County, California",64,62,2
1000000US060855043201012,060855043201012,"Block 1012, Block Group 1, Census Tract 5043.20, Santa Clara County, California",57,56,1
1000000US060855043201013,060855043201013,"Block 1013, Block Group 1, Census Tract 5043.20, Santa Clara County, California",27,27,0
1000000US060855043202000,060855043202000,"Block 2000, Block Group 2, Census Tract 5043.20, Santa Clara County, California",50,50,0
1000000US060855043202001,060855043202001,"Block 2001, Block Group 2, Census Tract 5043.20, Santa Clara County, California",77,75,2
1000000US060855043202002,060855043202002,"Block 2002, Block Group 2, Census Tract 5043.20, Santa Clara County, California",40,38,2
1000000US060855043202003,060855043202003,"Block 2003, Block Group 2, Census Tract 5043.20, Santa Clara County, California",37,37,0
1000000US060855043202004,060855043202004,"Block 2004, Block Group 2, Census Tract 5043.20, Santa Clara County, California",25,24,1
1000000US060855043202005,060855043202005,"Block 2005, Block Group 2, Census Tract 5043.20, Santa Clara County, California",53,50,3
1000000US060855043202006,060855043202006,"Block 2006, Block Group 2, Census Tract 5043.20, Santa Clara County, California",20,19,1
1000000US060855043211000,060855043211000,"Block 1000, Block Group 1, Census Tract 5043.21, Santa Clara County, California",59,56,3
1000000US060855043211001,060855043211001,"Block 1001, Block Group 1, Census Tract 5043.21, Santa Clara County, California",39,38,1
1000000US060855043211002,060855043211002,"Block 1002, Block Group 1, Census Tract 5043.21, Santa Clara County, California",28,28,0
1000000US060855043211003,060855043211003,"Block 1003, Block Group 1, Census Tract 5043.21, Santa Clara County, California",40,39,1
1000000US060855043211004,060855043211004,"Block 1004, Block Group 1, Census Tract 5043.21, Santa Clara County, California",51,51,0
1000000US060855043211005,060855043211005,"Block 1005, Block Group 1, Census Tract 5043.21, Santa Clara County, California",35,35,0
1000000US060855043211006,060855043211006,"Block 1006, Block Group 1, Census Tract 5043.21, Santa Clara County, California",37,37,0
1000000US060855043211007,060855043211007,"Block 1007, Block Group 1, Census Tract 5043.21, Santa Clara County, California",51,51,0
1000000US060855043211008,060855043211008,"Block 1008, Block Group 1, Census Tract 5043.21, Santa Clara County, California",35,35,0
1000000US060855043211009,060855043211009,"Block 1009, Block Group 1, Census Tract 5043.21, Santa Clara County, California",34,32,2
1000000US060855043211010,060855043211010,"Block 1010, Block Group 1, Census Tract 5043.21, Santa Clara County, California",96,93,3
1000000US060855043211011,060855043211011,"Block 1011, Block Group 1, Census Tract 5043.21, Santa Clara County, California",27,26,1
1000000US060855043211012,060855043211012,"Block 1012, Block Group 1, Census Tract 5043.21, Santa Clara County, California",128,120,8
1000000US060855043211013,060855043211013,"Block 1013, Block Group 1, Census Tract 5043.21, Santa Clara County, California",21,20,1
1000000US060855043211014,060855043211014,"Block 1014, Block Group 1, Census Tract 5043.21, Santa Clara County, California",43,40,3
1000000US060855043212000,060855043212000,"Block 2000, Block Group 2, Census Tract 5043.21, Santa Clara County, California",0,0,0
1000000US060855043212001,060855043212001,"Block 2001, Block Group 2, Census Tract 5043.21, Santa Clara County, California",158,153,5
1000000US060855043212002,060855043212002,"Block 2002, Block Group 2, Census Tract 5043.21, Santa Clara County, California",21,21,0
1000000US060855043212003,060855043212003,"Block 2003, Block Group 2, Census Tract 5043.21, Santa Clara County, California",0,0,0
1000000US060855043212004,060855043212004,"Block 2004, Block Group 2, Census Tract 5043.21, Santa Clara County, California",38,38,0
1000000US060855043212005,060855043212005,"Block 2005, Block Group 2, Census Tract 5043.21, Santa Clara County, California",220,217,3
1000000US060855043212006,060855043212006,"Block 2006, Block Group 2, Census Tract 5043.21, Santa Clara County, California",26,26,0
1000000US060855043212007,060855043212007,"Block 2007, Block Group 2, Census Tract 5043.21, Santa Clara County, California",26,25,1
1000000US060855043213000,060855043213000,"Block 3000, Block Group 3, Census Tract 5043.21, Santa Clara County, California",54,51,3
1000000US060855043213001,060855043213001,"Block 3001, Block Group 3, Census Tract 5043.21, Santa Clara County, California",22,21,1
1000000US060855043213002,060855043213002,"Block 3002, Block Group 3, Census Tract 5043.21, Santa Clara County, California",33,30,3
1000000US060855043213003,060855043213003,"Block 3003, Block Group 3, Census Tract 5043.21, Santa Clara County, California",29,28,1
1000000US060855043213004,060855043213004,"Block 3004, Block Group 3, Census Tract 5043.21, Santa Clara County, California",58,58,0
1000000US060855043213005,060855043213005,"Block 3005, Block Group 3, Census Tract 5043.21, Santa Clara County, California",13,13,0
1000000US060855043213006,060855043213006,"Block 3006, Block Group 3, Census Tract 5043.21, Santa Clara County, California",43,43,0
1000000US060855043213007,060855043213007,"Block 3007, Block Group 3, Census Tract 5043.21, Santa Clara County, California",46,44,2
1000000US060855043213008,060855043213008,"Block 3008, Block Group 3, Census Tract 5043.21, Santa Clara County, California",8,8,0
1000000US060855043213009,060855043213009,"Block 3009, Block Group 3, Census Tract 5043.21, Santa Clara County, California",11,11,0
1000000US060855043213010,060855043213010,"Block 3010, Block Group 3, Census Tract 5043.21, Santa Clara County, California",11,11,0
1000000US060855043213011,060855043213011,"Block 3011, Block Group 3, Census Tract 5043.21, Santa Clara County, California",11,11,0
1000000US060855043221000,060855043221000,"Block 1000, Block Group 1, Census Tract 5043.22, Santa Clara County, California",92,92,0
1000000US060855043221001,060855043221001,"Block 1001, Block Group 1, Census Tract 5043.22, Santa Clara County, California",2,1,1
1000000US060855043221002,060855043221002,"Block 1002, Block Group 1, Census Tract 5043.22, Santa Clara County, California",0,0,0
1000000US060855043221003,060855043221003,"Block 1003, Block Group 1, Census Tract 5043.22, Santa Clara County, California",0,0,0
1000000US060855043221004,060855043221004,"Block 1004, Block Group 1, Census Tract 5043.22, Santa Clara County, California",8,8,0
1000000US060855043221005,060855043221005,"Block 1005, Block Group 1, Census Tract 5043.22, Santa Clara County, California",335,330,5
1000000US060855043221006,060855043221006,"Block 1006, Block Group 1, Census Tract 5043.22, Santa Clara County, California",11,11,0
1000000US060855043221007,060855043221007,"Block 1007, Block Group 1, Census Tract 5043.22, Santa Clara County, California",18,18,0
1000000US060855043222000,060855043222000,"Block 2000, Block Group 2, Census Tract 5043.22, Santa Clara County, California",0,0,0
1000000US060855043222001,060855043222001,"Block 2001, Block Group 2, Census Tract 5043.22, Santa Clara County, California",0,0,0
1000000US060855043222002,060855043222002,"Block 2002, Block Group 2, Census Tract 5043.22, Santa Clara County, California",0,0,0
1000000US060855043222003,060855043222003,"Block 2003, Block Group 2, Census Tract 5043.22, Santa Clara County, California",0,0,0
1000000US060855043222004,060855043222004,"Block 2004, Block Group 2, Census Tract 5043.22, Santa Clara County, California",0,0,0
1000000US060855043222005,060855043222005,"Block 2005, Block Group 2, Census Tract 5043.22, Santa Clara County, California",0,0,0
1000000US060855043222006,060855043222006,"Block 2006, Block Group 2, Census Tract 5043.22, Santa Clara County, California",0,0,0
1000000US060855043222007,060855043222007,"Block 2007, Block Group 2, Census Tract 5043.22, Santa Clara County, California",0,0,0
1000000US060855043222008,060855043222008,"Block 2008, Block Group 2, Census Tract 5043.22, Santa Clara County, California",0,0,0
1000000US060855043222009,060855043222009,"Block 2009, Block Group 2, Census Tract 5043.22, Santa Clara County, California",0,0,0
1000000US060855043222010,060855043222010,"Block 2010, Block Group 2, Census Tract 5043.22, Santa Clara County, California",0,0,0
1000000US060855043222011,060855043222011,"Block 2011, Block Group 2, Census Tract 5043.22, Santa Clara County, California",42,41,1
1000000US060855043222012,060855043222012,"Block 2012, Block Group 2, Census Tract 5043.22, Santa Clara County, California",17,16,1
1000000US060855043222013,060855043222013,"Block 2013, Block Group 2, Census Tract 5043.22, Santa Clara County, California",102,80,22
1000000US060855043222014,060855043222014,"Block 2014, Block Group 2, Census Tract 5043.22, Santa Clara County, California",0,0,0
1000000US060855043222015,060855043222015,"Block 2015, Block Group 2, Census Tract 5043.22, Santa Clara County, California",44,44,0
1000000US060855043222016,060855043222016,"Block 2016, Block Group 2, Census Tract 5043.22, Santa Clara County, California",0,0,0
1000000US060855043222017,060855043222017,"Block 2017, Block Group 2, Census Tract 5043.22, Santa Clara County, California",16,16,0
1000000US060855043222018,060855043222018,"Block 2018, Block Group 2, Census Tract 5043.22, Santa Clara County, California",74,69,5
1000000US060855043222019,060855043222019,"Block 2019, Block Group 2, Census Tract 5043.22, Santa Clara County, California",14,14,0
1000000US060855043222020,060855043222020,"Block 2020, Block Group 2, Census Tract 5043.22, Santa Clara County, California",0,0,0
1000000US060855043222021,060855043222021,"Block 2021, Block Group 2, Census Tract 5043.22, Santa Clara County, California",20,19,1
1000000US060855043222022,060855043222022,"Block 2022, Block Group 2, Census Tract 5043.22, Santa Clara County, California",75,69,6
1000000US060855043222023,060855043222023,"Block 2023, Block Group 2, Census Tract 5043.22, Santa Clara County, California",35,35,0
1000000US060855043222024,060855043222024,"Block 2024, Block Group 2, Census Tract 5043.22, Santa Clara County, California",340,324,16
1000000US060855043223000,060855043223000,"Block 3000, Block Group 3, Census Tract 5043.22, Santa Clara County, California",56,55,1
1000000US060855043223001,060855043223001,"Block 3001, Block Group 3, Census Tract 5043.22, Santa Clara County, California",26,26,0
1000000US060855043223002,060855043223002,"Block 3002, Block Group 3, Census Tract 5043.22, Santa Clara County, California",100,96,4
1000000US060855043223003,060855043223003,"Block 3003, Block Group 3, Census Tract 5043.22, Santa Clara County, California",17,17,0
1000000US060855043223004,060855043223004,"Block 3004, Block Group 3, Census Tract 5043.22, Santa Clara County, California",72,68,4
1000000US060855043223005,060855043223005,"Block 3005, Block Group 3, Census Tract 5043.22, Santa Clara County, California",69,66,3
1000000US060855043223006,060855043223006,"Block 3006, Block Group 3, Census Tract 5043.22, Santa Clara County, California",127,118,9
1000000US060855043223007,060855043223007,"Block 3007, Block Group 3, Census Tract 5043.22, Santa Clara County, California",187,180,7
1000000US060855043223008,060855043223008,"Block 3008, Block Group 3, Census Tract 5043.22, Santa Clara County, California",99,96,3
1000000US060855043223009,060855043223009,"Block 3009, Block Group 3, Census Tract 5043.22, Santa Clara County, California",24,22,2
1000000US060855043223010,060855043223010,"Block 3010, Block Group 3, Census Tract 5043.22, Santa Clara County, California",53,52,1
1000000US060855043223011,060855043223011,"Block 3011, Block Group 3, Census Tract 5043.22, Santa Clara County, California",41,36,5
1000000US060855043231000,060855043231000,"Block 1000, Block Group 1, Census Tract 5043.23, Santa Clara County, California",67,65,2
1000000US060855043231001,060855043231001,"Block 1001, Block Group 1, Census Tract 5043.23, Santa Clara County, California",42,41,1
1000000US060855043231002,060855043231002,"Block 1002, Block Group 1, Census Tract 5043.23, Santa Clara County, California",72,69,3
1000000US060855043231003,060855043231003,"Block 1003, Block Group 1, Census Tract 5043.23, Santa Clara County, California",126,125,1
1000000US060855043231004,060855043231004,"Block 1004, Block Group 1, Census Tract 5043.23, Santa Clara County, California",0,0,0
1000000US060855043231005,060855043231005,"Block 1005, Block Group 1, Census Tract 5043.23, Santa Clara County, California",30,29,1
1000000US060855043231006,060855043231006,"Block 1006, Block Group 1, Census Tract 5043.23, Santa Clara County, California",40,39,1
1000000US060855043231007,060855043231007,"Block 1007, Block Group 1, Census Tract 5043.23, Santa Clara County, California",30,30,0
1000000US060855043231008,060855043231008,"Block 1008, Block Group 1, Census Tract 5043.23, Santa Clara County, California",46,45,1
1000000US060855043232000,060855043232000,"Block 2000, Block Group 2, Census Tract 5043.23, Santa Clara County, California",0,0,0
1000000US060855043232001,060855043232001,"Block 2001, Block Group 2, Census Tract 5043.23, Santa Clara County, California",0,0,0
1000000US060855043232002,060855043232002,"Block 2002, Block Group 2, Census Tract 5043.23, Santa Clara County, California",179,176,3
1000000US060855043232003,060855043232003,"Block 2003, Block Group 2, Census Tract 5043.23, Santa Clara County, California",16,16,0
1000000US060855043232004,060855043232004,"Block 2004, Block Group 2, Census Tract 5043.23, Santa Clara County, California",16,16,0
1000000US060855043232005,060855043232005,"Block 2005, Block Group 2, Census Tract 5043.23, Santa Clara County, California",52,47,5
1000000US060855043232006,060855043232006,"Block 2006, Block Group 2, Census Tract 5043.23, Santa Clara County, California",146,133,13
1000000US060855043232007,060855043232007,"Block 2007, Block Group 2, Census Tract 5043.23, Santa Clara County, California",24,24,0
1000000US060855043232008,060855043232008,"Block 2008, Block Group 2, Census Tract 5043.23, Santa Clara County, California",25,25,0
1000000US060855043232009,060855043232009,"Block 2009, Block Group 2, Census Tract 5043.23, Santa Clara County, California",0,0,0
1000000US060855043232010,060855043232010,"Block 2010, Block Group 2, Census Tract 5043.23, Santa Clara County, California",84,84,0
1000000US060855043232011,060855043232011,"Block 2011, Block Group 2, Census Tract 5043.23, Santa Clara County, California",19,19,0
1000000US060855043232012,060855043232012,"Block 2012, Block Group 2, Census Tract 5043.23, Santa Clara County, California",330,327,3
1000000US060855043232013,060855043232013,"Block 2013, Block Group 2, Census Tract 5043.23, Santa Clara County, California",40,40,0
1000000US060855043232014,060855043232014,"Block 2014, Block Group 2, Census Tract 5043.23, Santa Clara County, California",32,31,1
1000000US060855043232015,060855043232015,"Block 2015, Block Group 2, Census Tract 5043.23, Santa Clara County, California",88,86,2
1000000US060855043232016,060855043232016,"Block 2016, Block Group 2, Census Tract 5043.23, Santa Clara County, California",88,83,5
1000000US060855043232017,060855043232017,"Block 2017, Block Group 2, Census Tract 5043.23, Santa Clara County, California",57,53,4
1000000US060855043233000,060855043233000,"Block 3000, Block Group 3, Census Tract 5043.23, Santa Clara County, California",34,34,0
1000000US060855043233001,060855043233001,"Block 3001, Block Group 3, Census Tract 5043.23, Santa Clara County, California",27,26,1
1000000US060855043233002,060855043233002,"Block 3002, Block Group 3, Census Tract 5043.23, Santa Clara County, California",50,48,2
1000000US060855043233003,060855043233003,"Block 3003, Block Group 3, Census Tract 5043.23, Santa Clara County, California",40,40,0
1000000US060855043233004,060855043233004,"Block 3004, Block Group 3, Census Tract 5043.23, Santa Clara County, California",35,34,1
1000000US060855044101000,060855044101000,"Block 1000, Block Group 1, Census Tract 5044.10, Santa Clara County, California",45,44,1
1000000US060855044101001,060855044101001,"Block 1001, Block Group 1, Census Tract 5044.10, Santa Clara County, California",39,36,3
1000000US060855044101002,060855044101002,"Block 1002, Block Group 1, Census Tract 5044.10, Santa Clara County, California",47,46,1
1000000US060855044101003,060855044101003,"Block 1003, Block Group 1, Census Tract 5044.10, Santa Clara County, California",48,45,3
1000000US060855044101004,060855044101004,"Block 1004, Block Group 1, Census Tract 5044.10, Santa Clara County, California",0,0,0
1000000US060855044101005,060855044101005,"Block 1005, Block Group 1, Census Tract 5044.10, Santa Clara County, California",23,23,0
1000000US060855044101006,060855044101006,"Block 1006, Block Group 1, Census Tract 5044.10, Santa Clara County, California",58,57,1
1000000US060855044101007,060855044101007,"Block 1007, Block Group 1, Census Tract 5044.10, Santa Clara County, California",52,52,0
1000000US060855044101008,060855044101008,"Block 1008, Block Group 1, Census Tract 5044.10, Santa Clara County, California",54,51,3
1000000US060855044101009,060855044101009,"Block 1009, Block Group 1, Census Tract 5044.10, Santa Clara County, California",29,28,1
1000000US060855044101010,060855044101010,"Block 1010, Block Group 1, Census Tract 5044.10, Santa Clara County, California",25,24,1
1000000US060855044101011,060855044101011,"Block 1011, Block Group 1, Census Tract 5044.10, Santa Clara County, California",30,28,2
1000000US060855044101012,060855044101012,"Block 1012, Block Group 1, Census Tract 5044.10, Santa Clara County, California",29,27,2
1000000US060855044101013,060855044101013,"Block 1013, Block Group 1, Census Tract 5044.10, Santa Clara County, California",40,38,2
1000000US060855044101014,060855044101014,"Block 1014, Block Group 1, Census Tract 5044.10, Santa Clara County, California",27,26,1
1000000US060855044102000,060855044102000,"Block 2000, Block Group 2, Census Tract 5044.10, Santa Clara County, California",244,244,0
1000000US060855044102001,060855044102001,"Block 2001, Block Group 2, Census Tract 5044.10, Santa Clara County, California",21,21,0
1000000US060855044102002,060855044102002,"Block 2002, Block Group 2, Census Tract 5044.10, Santa Clara County, California",11,11,0
1000000US060855044102003,060855044102003,"Block 2003, Block Group 2, Census Tract 5044.10, Santa Clara County, California",14,14,0
1000000US060855044102004,060855044102004,"Block 2004, Block Group 2, Census Tract 5044.10, Santa Clara County, California",23,23,0
1000000US060855044102005,060855044102005,"Block 2005, Block Group 2, Census Tract 5044.10, Santa Clara County, California",72,70,2
1000000US060855044102006,060855044102006,"Block 2006, Block Group 2, Census Tract 5044.10, Santa Clara County, California",97,96,1
1000000US060855044102007,060855044102007,"Block 2007, Block Group 2, Census Tract 5044.10, Santa Clara County, California",50,49,1
1000000US060855044102008,060855044102008,"Block 2008, Block Group 2, Census Tract 5044.10, Santa Clara County, California",33,32,1
1000000US060855044102009,060855044102009,"Block 2009, Block Group 2, Census Tract 5044.10, Santa Clara County, California",26,26,0
1000000US060855044102010,060855044102010,"Block 2010, Block Group 2, Census Tract 5044.10, Santa Clara County, California",40,37,3
1000000US060855044102011,060855044102011,"Block 2011, Block Group 2, Census Tract 5044.10, Santa Clara County, California",44,43,1
1000000US060855044111000,060855044111000,"Block 1000, Block Group 1, Census Tract 5044.11, Santa Clara County, California",58,57,1
1000000US060855044111001,060855044111001,"Block 1001, Block Group 1, Census Tract 5044.11, Santa Clara County, California",3,2,1
1000000US060855044111002,060855044111002,"Block 1002, Block Group 1, Census Tract 5044.11, Santa Clara County, California",94,90,4
1000000US060855044111003,060855044111003,"Block 1003, Block Group 1, Census Tract 5044.11, Santa Clara County, California",44,44,0
1000000US060855044111004,060855044111004,"Block 1004, Block Group 1, Census Tract 5044.11, Santa Clara County, California",34,34,0
1000000US060855044111005,060855044111005,"Block 1005, Block Group 1, Census Tract 5044.11, Santa Clara County, California",33,32,1
1000000US060855044111006,060855044111006,"Block 1006, Block Group 1, Census Tract 5044.11, Santa Clara County, California",69,68,1
1000000US060855044111007,060855044111007,"Block 1007, Block Group 1, Census Tract 5044.11, Santa Clara County, California",14,14,0
1000000US060855044111008,060855044111008,"Block 1008, Block Group 1, Census Tract 5044.11, Santa Clara County, California",70,69,1
1000000US060855044111009,060855044111009,"Block 1009, Block Group 1, Census Tract 5044.11, Santa Clara County, California",20,20,0
1000000US060855044111010,060855044111010,"Block 1010, Block Group 1, Census Tract 5044.11, Santa Clara County, California",8,8,0
1000000US060855044111011,060855044111011,"Block 1011, Block Group 1, Census Tract 5044.11, Santa Clara County, California",14,14,0
1000000US060855044111012,060855044111012,"Block 1012, Block Group 1, Census Tract 5044.11, Santa Clara County, California",29,29,0
1000000US060855044111013,060855044111013,"Block 1013, Block Group 1, Census Tract 5044.11, Santa Clara County, California",15,15,0
1000000US060855044111014,060855044111014,"Block 1014, Block Group 1, Census Tract 5044.11, Santa Clara County, California",66,64,2
1000000US060855044111015,060855044111015,"Block 1015, Block Group 1, Census Tract 5044.11, Santa Clara County, California",26,26,0
1000000US060855044111016,060855044111016,"Block 1016, Block Group 1, Census Tract 5044.11, Santa Clara County, California",16,16,0
1000000US060855044111017,060855044111017,"Block 1017, Block Group 1, Census Tract 5044.11, Santa Clara County, California",37,36,1
1000000US060855044111018,060855044111018,"Block 1018, Block Group 1, Census Tract 5044.11, Santa Clara County, California",48,44,4
1000000US060855044111019,060855044111019,"Block 1019, Block Group 1, Census Tract 5044.11, Santa Clara County, California",33,33,0
1000000US060855044111020,060855044111020,"Block 1020, Block Group 1, Census Tract 5044.11, Santa Clara County, California",37,37,0
1000000US060855044111021,060855044111021,"Block 1021, Block Group 1, Census Tract 5044.11, Santa Clara County, California",41,41,0
1000000US060855044112000,060855044112000,"Block 2000, Block Group 2, Census Tract 5044.11, Santa Clara County, California",44,42,2
1000000US060855044112001,060855044112001,"Block 2001, Block Group 2, Census Tract 5044.11, Santa Clara County, California",28,23,5
1000000US060855044112002,060855044112002,"Block 2002, Block Group 2, Census Tract 5044.11, Santa Clara County, California",48,47,1
1000000US060855044112003,060855044112003,"Block 2003, Block Group 2, Census Tract 5044.11, Santa Clara County, California",38,35,3
1000000US060855044112004,060855044112004,"Block 2004, Block Group 2, Census Tract 5044.11, Santa Clara County, California",43,43,0
1000000US060855044112005,060855044112005,"Block 2005, Block Group 2, Census Tract 5044.11, Santa Clara County, California",56,54,2
1000000US060855044112006,060855044112006,"Block 2006, Block Group 2, Census Tract 5044.11, Santa Clara County, California",36,36,0
1000000US060855044112007,060855044112007,"Block 2007, Block Group 2, Census Tract 5044.11, Santa Clara County, California",21,21,0
1000000US060855044112008,060855044112008,"Block 2008, Block Group 2, Census Tract 5044.11, Santa Clara County, California",39,36,3
1000000US060855044112009,060855044112009,"Block 2009, Block Group 2, Census Tract 5044.11, Santa Clara County, California",39,39,0
1000000US060855044112010,060855044112010,"Block 2010, Block Group 2, Census Tract 5044.11, Santa Clara County, California",35,34,1
1000000US060855044112011,060855044112011,"Block 2011, Block Group 2, Census Tract 5044.11, Santa Clara County, California",45,45,0
1000000US060855044112012,060855044112012,"Block 2012, Block Group 2, Census Tract 5044.11, Santa Clara County, California",49,48,1
1000000US060855044112013,060855044112013,"Block 2013, Block Group 2, Census Tract 5044.11, Santa Clara County, California",53,52,1
1000000US060855044112014,060855044112014,"Block 2014, Block Group 2, Census Tract 5044.11, Santa Clara County, California",47,47,0
1000000US060855044112015,060855044112015,"Block 2015, Block Group 2, Census Tract 5044.11, Santa Clara County, California",26,24,2
1000000US060855044112016,060855044112016,"Block 2016, Block Group 2, Census Tract 5044.11, Santa Clara County, California",44,43,1
1000000US060855044112017,060855044112017,"Block 2017, Block Group 2, Census Tract 5044.11, Santa Clara County, California",35,33,2
1000000US060855044121000,060855044121000,"Block 1000, Block Group 1, Census Tract 5044.12, Santa Clara County, California",155,153,2
1000000US060855044121001,060855044121001,"Block 1001, Block Group 1, Census Tract 5044.12, Santa Clara County, California",62,62,0
1000000US060855044121002,060855044121002,"Block 1002, Block Group 1, Census Tract 5044.12, Santa Clara County, California",10,9,1
1000000US060855044121003,060855044121003,"Block 1003, Block Group 1, Census Tract 5044.12, Santa Clara County, California",63,61,2
1000000US060855044121004,060855044121004,"Block 1004, Block Group 1, Census Tract 5044.12, Santa Clara County, California",0,0,0
1000000US060855044121005,060855044121005,"Block 1005, Block Group 1, Census Tract 5044.12, Santa Clara County, California",0,0,0
1000000US060855044122000,060855044122000,"Block 2000, Block Group 2, Census Tract 5044.12, Santa Clara County, California",49,49,0
1000000US060855044122001,060855044122001,"Block 2001, Block Group 2, Census Tract 5044.12, Santa Clara County, California",152,149,3
1000000US060855044122002,060855044122002,"Block 2002, Block Group 2, Census Tract 5044.12, Santa Clara County, California",35,35,0
1000000US060855044122003,060855044122003,"Block 2003, Block Group 2, Census Tract 5044.12, Santa Clara County, California",20,20,0
1000000US060855044122004,060855044122004,"Block 2004, Block Group 2, Census Tract 5044.12, Santa Clara County, California",20,20,0
1000000US060855044122005,060855044122005,"Block 2005, Block Group 2, Census Tract 5044.12, Santa Clara County, California",22,22,0
1000000US060855044122006,060855044122006,"Block 2006, Block Group 2, Census Tract 5044.12, Santa Clara County, California",22,21,1
1000000US060855044123000,060855044123000,"Block 3000, Block Group 3, Census Tract 5044.12, Santa Clara County, California",150,145,5
1000000US060855044123001,060855044123001,"Block 3001, Block Group 3, Census Tract 5044.12, Santa Clara County, California",120,119,1
1000000US060855044123002,060855044123002,"Block 3002, Block Group 3, Census Tract 5044.12, Santa Clara County, California",120,118,2
1000000US060855044124000,060855044124000,"Block 4000, Block Group 4, Census Tract 5044.12, Santa Clara County, California",99,94,5
1000000US060855044124001,060855044124001,"Block 4001, Block Group 4, Census Tract 5044.12, Santa Clara County, California",39,38,1
1000000US060855044124002,060855044124002,"Block 4002, Block Group 4, Census Tract 5044.12, Santa Clara County, California",42,42,0
1000000US060855044124003,060855044124003,"Block 4003, Block Group 4, Census Tract 5044.12, Santa Clara County, California",19,19,0
1000000US060855044124004,060855044124004,"Block 4004, Block Group 4, Census Tract 5044.12, Santa Clara County, California",72,70,2
1000000US060855044124005,060855044124005,"Block 4005, Block Group 4, Census Tract 5044.12, Santa Clara County, California",26,26,0
1000000US060855044131000,060855044131000,"Block 1000, Block Group 1, Census Tract 5044.13, Santa Clara County, California",50,50,0
1000000US060855044131001,060855044131001,"Block 1001, Block Group 1, Census Tract 5044.13, Santa Clara County, California",0,0,0
1000000US060855044131002,060855044131002,"Block 1002, Block Group 1, Census Tract 5044.13, Santa Clara County, California",20,17,3
1000000US060855044131003,060855044131003,"Block 1003, Block Group 1, Census Tract 5044.13, Santa Clara County, California",20,20,0
1000000US060855044131004,060855044131004,"Block 1004, Block Group 1, Census Tract 5044.13, Santa Clara County, California",18,18,0
1000000US060855044131005,060855044131005,"Block 1005, Block Group 1, Census Tract 5044.13, Santa Clara County, California",34,33,1
1000000US060855044131006,060855044131006,"Block 1006, Block Group 1, Census Tract 5044.13, Santa Clara County, California",27,26,1
1000000US060855044131007,060855044131007,"Block 1007, Block Group 1, Census Tract 5044.13, Santa Clara County, California",7,7,0
1000000US060855044131008,060855044131008,"Block 1008, Block Group 1, Census Tract 5044.13, Santa Clara County, California",15,15,0
1000000US060855044131009,060855044131009,"Block 1009, Block Group 1, Census Tract 5044.13, Santa Clara County, California",17,17,0
1000000US060855044131010,060855044131010,"Block 1010, Block Group 1, Census Tract 5044.13, Santa Clara County, California",36,35,1
1000000US060855044131011,060855044131011,"Block 1011, Block Group 1, Census Tract 5044.13, Santa Clara County, California",20,20,0
1000000US060855044131012,060855044131012,"Block 1012, Block Group 1, Census Tract 5044.13, Santa Clara County, California",20,20,0
1000000US060855044131013,060855044131013,"Block 1013, Block Group 1, Census Tract 5044.13, Santa Clara County, California",0,0,0
1000000US060855044131014,060855044131014,"Block 1014, Block Group 1, Census Tract 5044.13, Santa Clara County, California",74,70,4
1000000US060855044131015,060855044131015,"Block 1015, Block Group 1, Census Tract 5044.13, Santa Clara County, California",84,80,4
1000000US060855044131016,060855044131016,"Block 1016, Block Group 1, Census Tract 5044.13, Santa Clara County, California",33,33,0
1000000US060855044131017,060855044131017,"Block 1017, Block Group 1, Census Tract 5044.13, Santa Clara County, California",18,16,2
1000000US060855044131018,060855044131018,"Block 1018, Block Group 1, Census Tract 5044.13, Santa Clara County, California",0,0,0
1000000US060855044131019,060855044131019,"Block 1019, Block Group 1, Census Tract 5044.13, Santa Clara County, California",0,0,0
1000000US060855044131020,060855044131020,"Block 1020, Block Group 1, Census Tract 5044.13, Santa Clara County, California",0,0,0
1000000US060855044131021,060855044131021,"Block 1021, Block Group 1, Census Tract 5044.13, Santa Clara County, California",0,0,0
1000000US060855044131022,060855044131022,"Block 1022, Block Group 1, Census Tract 5044.13, Santa Clara County, California",169,165,4
1000000US060855044131023,060855044131023,"Block 1023, Block Group 1, Census Tract 5044.13, Santa Clara County, California",8,8,0
1000000US060855044131024,060855044131024,"Block 1024, Block Group 1, Census Tract 5044.13, Santa Clara County, California",0,0,0
1000000US060855044131025,060855044131025,"Block 1025, Block Group 1, Census Tract 5044.13, Santa Clara County, California",0,0,0
1000000US060855044131026,060855044131026,"Block 1026, Block Group 1, Census Tract 5044.13, Santa Clara County, California",6,6,0
1000000US060855044131027,060855044131027,"Block 1027, Block Group 1, Census Tract 5044.13, Santa Clara County, California",16,16,0
1000000US060855044141000,060855044141000,"Block 1000, Block Group 1, Census Tract 5044.14, Santa Clara County, California",110,107,3
1000000US060855044141001,060855044141001,"Block 1001, Block Group 1, Census Tract 5044.14, Santa Clara County, California",36,34,2
1000000US060855044141002,060855044141002,"Block 1002, Block Group 1, Census Tract 5044.14, Santa Clara County, California",17,17,0
1000000US060855044141003,060855044141003,"Block 1003, Block Group 1, Census Tract 5044.14, Santa Clara County, California",39,38,1
1000000US060855044141004,060855044141004,"Block 1004, Block Group 1, Census Tract 5044.14, Santa Clara County, California",125,121,4
1000000US060855044141005,060855044141005,"Block 1005, Block Group 1, Census Tract 5044.14, Santa Clara County, California",19,19,0
1000000US060855044141006,060855044141006,"Block 1006, Block Group 1, Census Tract 5044.14, Santa Clara County, California",21,21,0
1000000US060855044141007,060855044141007,"Block 1007, Block Group 1, Census Tract 5044.14, Santa Clara County, California",14,14,0
1000000US060855044141008,060855044141008,"Block 1008, Block Group 1, Census Tract 5044.14, Santa Clara County, California",68,67,1
1000000US060855044141009,060855044141009,"Block 1009, Block Group 1, Census Tract 5044.14, Santa Clara County, California",11,11,0
1000000US060855044141010,060855044141010,"Block 1010, Block Group 1, Census Tract 5044.14, Santa Clara County, California",40,40,0
1000000US060855044141011,060855044141011,"Block 1011, Block Group 1, Census Tract 5044.14, Santa Clara County, California",52,52,0
1000000US060855044141012,060855044141012,"Block 1012, Block Group 1, Census Tract 5044.14, Santa Clara County, California",44,44,0
1000000US060855044141013,060855044141013,"Block 1013, Block Group 1, Census Tract 5044.14, Santa Clara County, California",40,40,0
1000000US060855044141014,060855044141014,"Block 1014, Block Group 1, Census Tract 5044.14, Santa Clara County, California",71,70,1
1000000US060855044141015,060855044141015,"Block 1015, Block Group 1, Census Tract 5044.14, Santa Clara County, California",0,0,0
1000000US060855044142000,060855044142000,"Block 2000, Block Group 2, Census Tract 5044.14, Santa Clara County, California",0,0,0
1000000US060855044142001,060855044142001,"Block 2001, Block Group 2, Census Tract 5044.14, Santa Clara County, California",51,50,1
1000000US060855044142002,060855044142002,"Block 2002, Block Group 2, Census Tract 5044.14, Santa Clara County, California",33,32,1
1000000US060855044142003,060855044142003,"Block 2003, Block Group 2, Census Tract 5044.14, Santa Clara County, California",74,72,2
1000000US060855044142004,060855044142004,"Block 2004, Block Group 2, Census Tract 5044.14, Santa Clara County, California",8,7,1
1000000US060855044142005,060855044142005,"Block 2005, Block Group 2, Census Tract 5044.14, Santa Clara County, California",95,95,0
1000000US060855044142006,060855044142006,"Block 2006, Block Group 2, Census Tract 5044.14, Santa Clara County, California",0,0,0
1000000US060855044142007,060855044142007,"Block 2007, Block Group 2, Census Tract 5044.14, Santa Clara County, California",49,34,15
1000000US060855044142008,060855044142008,"Block 2008, Block Group 2, Census Tract 5044.14, Santa Clara County, California",29,29,0
1000000US060855044142009,060855044142009,"Block 2009, Block Group 2, Census Tract 5044.14, Santa Clara County, California",45,27,18
1000000US060855044142010,060855044142010,"Block 2010, Block Group 2, Census Tract 5044.14, Santa Clara County, California",16,15,1
1000000US060855044142011,060855044142011,"Block 2011, Block Group 2, Census Tract 5044.14, Santa Clara County, California",28,26,2
1000000US060855044142012,060855044142012,"Block 2012, Block Group 2, Census Tract 5044.14, Santa Clara County, California",16,16,0
1000000US060855044142013,060855044142013,"Block 2013, Block Group 2, Census Tract 5044.14, Santa Clara County, California",0,0,0
1000000US060855044143000,060855044143000,"Block 3000, Block Group 3, Census Tract 5044.14, Santa Clara County, California",0,0,0
1000000US060855044143001,060855044143001,"Block 3001, Block Group 3, Census Tract 5044.14, Santa Clara County, California",0,0,0
1000000US060855044143002,060855044143002,"Block 3002, Block Group 3, Census Tract 5044.14, Santa Clara County, California",7,7,0
1000000US060855044143003,060855044143003,"Block 3003, Block Group 3, Census Tract 5044.14, Santa Clara County, California",0,0,0
1000000US060855044143004,060855044143004,"Block 3004, Block Group 3, Census Tract 5044.14, Santa Clara County, California",0,0,0
1000000US060855044143005,060855044143005,"Block 3005, Block Group 3, Census Tract 5044.14, Santa Clara County, California",0,0,0
1000000US060855044143006,060855044143006,"Block 3006, Block Group 3, Census Tract 5044.14, Santa Clara County, California",12,12,0
1000000US060855044143007,060855044143007,"Block 3007, Block Group 3, Census Tract 5044.14, Santa Clara County, California",16,16,0
1000000US060855044143008,060855044143008,"Block 3008, Block Group 3, Census Tract 5044.14, Santa Clara County, California",41,40,1
1000000US060855044143009,060855044143009,"Block 3009, Block Group 3, Census Tract 5044.14, Santa Clara County, California",165,161,4
1000000US060855044143010,060855044143010,"Block 3010, Block Group 3, Census Tract 5044.14, Santa Clara County, California",29,29,0
1000000US060855044143011,060855044143011,"Block 3011, Block Group 3, Census Tract 5044.14, Santa Clara County, California",36,36,0
1000000US060855044143012,060855044143012,"Block 3012, Block Group 3, Census Tract 5044.14, Santa Clara County, California",52,52,0
1000000US060855044143013,060855044143013,"Block 3013, Block Group 3, Census Tract 5044.14, Santa Clara County, California",0,0,0
1000000US060855044143014,060855044143014,"Block 3014, Block Group 3, Census Tract 5044.14, Santa Clara County, California",0,0,0
1000000US060855044151000,060855044151000,"Block 1000, Block Group 1, Census Tract 5044.15, Santa Clara County, California",74,74,0
1000000US060855044151001,060855044151001,"Block 1001, Block Group 1, Census Tract 5044.15, Santa Clara County, California",44,43,1
1000000US060855044151002,060855044151002,"Block 1002, Block Group 1, Census Tract 5044.15, Santa Clara County, California",38,38,0
1000000US060855044151003,060855044151003,"Block 1003, Block Group 1, Census Tract 5044.15, Santa Clara County, California",27,27,0
1000000US060855044151004,060855044151004,"Block 1004, Block Group 1, Census Tract 5044.15, Santa Clara County, California",6,6,0
1000000US060855044151005,060855044151005,"Block 1005, Block Group 1, Census Tract 5044.15, Santa Clara County, California",195,187,8
1000000US060855044151006,060855044151006,"Block 1006, Block Group 1, Census Tract 5044.15, Santa Clara County, California",15,15,0
1000000US060855044151007,060855044151007,"Block 1007, Block Group 1, Census Tract 5044.15, Santa Clara County, California",11,11,0
1000000US060855044151008,060855044151008,"Block 1008, Block Group 1, Census Tract 5044.15, Santa Clara County, California",13,13,0
1000000US060855044151009,060855044151009,"Block 1009, Block Group 1, Census Tract 5044.15, Santa Clara County, California",43,43,0
1000000US060855044151010,060855044151010,"Block 1010, Block Group 1, Census Tract 5044.15, Santa Clara County, California",25,25,0
1000000US060855044151011,060855044151011,"Block 1011, Block Group 1, Census Tract 5044.15, Santa Clara County, California",12,12,0
1000000US060855044151012,060855044151012,"Block 1012, Block Group 1, Census Tract 5044.15, Santa Clara County, California",22,22,0
1000000US060855044151013,060855044151013,"Block 1013, Block Group 1, Census Tract 5044.15, Santa Clara County, California",2,2,0
1000000US060855044151014,060855044151014,"Block 1014, Block Group 1, Census Tract 5044.15, Santa Clara County, California",16,16,0
1000000US060855044151015,060855044151015,"Block 1015, Block Group 1, Census Tract 5044.15, Santa Clara County, California",31,31,0
1000000US060855044151016,060855044151016,"Block 1016, Block Group 1, Census Tract 5044.15, Santa Clara County, California",10,10,0
1000000US060855044151017,060855044151017,"Block 1017, Block Group 1, Census Tract 5044.15, Santa Clara County, California",24,24,0
1000000US060855044151018,060855044151018,"Block 1018, Block Group 1, Census Tract 5044.15, Santa Clara County, California",21,20,1
1000000US060855044152000,060855044152000,"Block 2000, Block Group 2, Census Tract 5044.15, Santa Clara County, California",11,11,0
1000000US060855044152001,060855044152001,"Block 2001, Block Group 2, Census Tract 5044.15, Santa Clara County, California",32,32,0
1000000US060855044152002,060855044152002,"Block 2002, Block Group 2, Census Tract 5044.15, Santa Clara County, California",249,239,10
1000000US060855044152003,060855044152003,"Block 2003, Block Group 2, Census Tract 5044.15, Santa Clara County, California",30,30,0
1000000US060855044152004,060855044152004,"Block 2004, Block Group 2, Census Tract 5044.15, Santa Clara County, California",32,32,0
1000000US060855044152005,060855044152005,"Block 2005, Block Group 2, Census Tract 5044.15, Santa Clara County, California",30,29,1
1000000US060855044152006,060855044152006,"Block 2006, Block Group 2, Census Tract 5044.15, Santa Clara County, California",32,32,0
1000000US060855044152007,060855044152007,"Block 2007, Block Group 2, Census Tract 5044.15, Santa Clara County, California",29,29,0
1000000US060855044153000,060855044153000,"Block 3000, Block Group 3, Census Tract 5044.15, Santa Clara County, California",216,211,5
1000000US060855044153001,060855044153001,"Block 3001, Block Group 3, Census Tract 5044.15, Santa Clara County, California",32,32,0
1000000US060855044153002,060855044153002,"Block 3002, Block Group 3, Census Tract 5044.15, Santa Clara County, California",18,18,0
1000000US060855044153003,060855044153003,"Block 3003, Block Group 3, Census Tract 5044.15, Santa Clara County, California",30,29,1
1000000US060855044153004,060855044153004,"Block 3004, Block Group 3, Census Tract 5044.15, Santa Clara County, California",14,14,0
1000000US060855044153005,060855044153005,"Block 3005, Block Group 3, Census Tract 5044.15, Santa Clara County, California",30,30,0
1000000US060855044153006,060855044153006,"Block 3006, Block Group 3, Census Tract 5044.15, Santa Clara County, California",34,34,0
1000000US060855044153007,060855044153007,"Block 3007, Block Group 3, Census Tract 5044.15, Santa Clara County, California",0,0,0
1000000US060855044153008,060855044153008,"Block 3008, Block Group 3, Census Tract 5044.15, Santa Clara County, California",62,61,1
1000000US060855044153009,060855044153009,"Block 3009, Block Group 3, Census Tract 5044.15, Santa Clara County, California",19,19,0
1000000US060855044153010,060855044153010,"Block 3010, Block Group 3, Census Tract 5044.15, Santa Clara County, California",1,1,0
1000000US060855044161000,060855044161000,"Block 1000, Block Group 1, Census Tract 5044.16, Santa Clara County, California",240,234,6
1000000US060855044161001,060855044161001,"Block 1001, Block Group 1, Census Tract 5044.16, Santa Clara County, California",21,21,0
1000000US060855044161002,060855044161002,"Block 1002, Block Group 1, Census Tract 5044.16, Santa Clara County, California",18,18,0
1000000US060855044161003,060855044161003,"Block 1003, Block Group 1, Census Tract 5044.16, Santa Clara County, California",24,24,0
1000000US060855044161004,060855044161004,"Block 1004, Block Group 1, Census Tract 5044.16, Santa Clara County, California",0,0,0
1000000US060855044161005,060855044161005,"Block 1005, Block Group 1, Census Tract 5044.16, Santa Clara County, California",8,8,0
1000000US060855044161006,060855044161006,"Block 1006, Block Group 1, Census Tract 5044.16, Santa Clara County, California",71,70,1
1000000US060855044161007,060855044161007,"Block 1007, Block Group 1, Census Tract 5044.16, Santa Clara County, California",3,3,0
1000000US060855044161008,060855044161008,"Block 1008, Block Group 1, Census Tract 5044.16, Santa Clara County, California",21,21,0
1000000US060855044161009,060855044161009,"Block 1009, Block Group 1, Census Tract 5044.16, Santa Clara County, California",14,13,1
1000000US060855044161010,060855044161010,"Block 1010, Block Group 1, Census Tract 5044.16, Santa Clara County, California",75,72,3
1000000US060855044161011,060855044161011,"Block 1011, Block Group 1, Census Tract 5044.16, Santa Clara County, California",124,116,8
1000000US060855044161012,060855044161012,"Block 1012, Block Group 1, Census Tract 5044.16, Santa Clara County, California",0,0,0
1000000US060855044162000,060855044162000,"Block 2000, Block Group 2, Census Tract 5044.16, Santa Clara County, California",245,235,10
1000000US060855044162001,060855044162001,"Block 2001, Block Group 2, Census Tract 5044.16, Santa Clara County, California",32,31,1
1000000US060855044162002,060855044162002,"Block 2002, Block Group 2, Census Tract 5044.16, Santa Clara County, California",32,32,0
1000000US060855044162003,060855044162003,"Block 2003, Block Group 2, Census Tract 5044.16, Santa Clara County, California",35,35,0
1000000US060855044162004,060855044162004,"Block 2004, Block Group 2, Census Tract 5044.16, Santa Clara County, California",35,34,1
1000000US060855044162005,060855044162005,"Block 2005, Block Group 2, Census Tract 5044.16, Santa Clara County, California",58,56,2
1000000US060855044162006,060855044162006,"Block 2006, Block Group 2, Census Tract 5044.16, Santa Clara County, California",33,33,0
1000000US060855044171000,060855044171000,"Block 1000, Block Group 1, Census Tract 5044.17, Santa Clara County, California",7,6,1
1000000US060855044171001,060855044171001,"Block 1001, Block Group 1, Census Tract 5044.17, Santa Clara County, California",0,0,0
1000000US060855044171002,060855044171002,"Block 1002, Block Group 1, Census Tract 5044.17, Santa Clara County, California",0,0,0
1000000US060855044171003,060855044171003,"Block 1003, Block Group 1, Census Tract 5044.17, Santa Clara County, California",2,1,1
1000000US060855044171004,060855044171004,"Block 1004, Block Group 1, Census Tract 5044.17, Santa Clara County, California",9,8,1
1000000US060855044171005,060855044171005,"Block 1005, Block Group 1, Census Tract 5044.17, Santa Clara County, California",0,0,0
1000000US060855044171006,060855044171006,"Block 1006, Block Group 1, Census Tract 5044.17, Santa Clara County, California",24,23,1
1000000US060855044171007,060855044171007,"Block 1007, Block Group 1, Census Tract 5044.17, Santa Clara County, California",0,0,0
1000000US060855044171008,060855044171008,"Block 1008, Block Group 1, Census Tract 5044.17, Santa Clara County, California",0,0,0
1000000US060855044171009,060855044171009,"Block 1009, Block Group 1, Census Tract 5044.17, Santa Clara County, California",7,6,1
1000000US060855044171010,060855044171010,"Block 1010, Block Group 1, Census Tract 5044.17, Santa Clara County, California",9,9,0
1000000US060855044171011,060855044171011,"Block 1011, Block Group 1, Census Tract 5044.17, Santa Clara County, California",0,0,0
1000000US060855044171012,060855044171012,"Block 1012, Block Group 1, Census Tract 5044.17, Santa Clara County, California",6,4,2
1000000US060855044171013,060855044171013,"Block 1013, Block Group 1, Census Tract 5044.17, Santa Clara County, California",19,17,2
1000000US060855044171014,060855044171014,"Block 1014, Block Group 1, Census Tract 5044.17, Santa Clara County, California",7,6,1
1000000US060855044171015,060855044171015,"Block 1015, Block Group 1, Census Tract 5044.17, Santa Clara County, California",19,19,0
1000000US060855044171016,060855044171016,"Block 1016, Block Group 1, Census Tract 5044.17, Santa Clara County, California",5,5,0
1000000US060855044171017,060855044171017,"Block 1017, Block Group 1, Census Tract 5044.17, Santa Clara County, California",0,0,0
1000000US060855044171018,060855044171018,"Block 1018, Block Group 1, Census Tract 5044.17, Santa Clara County, California",1,1,0
1000000US060855044171019,060855044171019,"Block 1019, Block Group 1, Census Tract 5044.17, Santa Clara County, California",1,1,0
1000000US060855044181000,060855044181000,"Block 1000, Block Group 1, Census Tract 5044.18, Santa Clara County, California",0,0,0
1000000US060855044181001,060855044181001,"Block 1001, Block Group 1, Census Tract 5044.18, Santa Clara County, California",0,0,0
1000000US060855044181002,060855044181002,"Block 1002, Block Group 1, Census Tract 5044.18, Santa Clara County, California",0,0,0
1000000US060855044181003,060855044181003,"Block 1003, Block Group 1, Census Tract 5044.18, Santa Clara County, California",0,0,0
1000000US060855044181004,060855044181004,"Block 1004, Block Group 1, Census Tract 5044.18, Santa Clara County, California",0,0,0
1000000US060855044181005,060855044181005,"Block 1005, Block Group 1, Census Tract 5044.18, Santa Clara County, California",166,161,5
1000000US060855044181006,060855044181006,"Block 1006, Block Group 1, Census Tract 5044.18, Santa Clara County, California",52,51,1
1000000US060855044181007,060855044181007,"Block 1007, Block Group 1, Census Tract 5044.18, Santa Clara County, California",0,0,0
1000000US060855044181008,060855044181008,"Block 1008, Block Group 1, Census Tract 5044.18, Santa Clara County, California",249,232,17
1000000US060855044181009,060855044181009,"Block 1009, Block Group 1, Census Tract 5044.18, Santa Clara County, California",48,48,0
1000000US060855044181010,060855044181010,"Block 1010, Block Group 1, Census Tract 5044.18, Santa Clara County, California",0,0,0
1000000US060855044181011,060855044181011,"Block 1011, Block Group 1, Census Tract 5044.18, Santa Clara County, California",137,127,10
1000000US060855044182000,060855044182000,"Block 2000, Block Group 2, Census Tract 5044.18, Santa Clara County, California",20,20,0
1000000US060855044182001,060855044182001,"Block 2001, Block Group 2, Census Tract 5044.18, Santa Clara County, California",17,17,0
1000000US060855044182002,060855044182002,"Block 2002, Block Group 2, Census Tract 5044.18, Santa Clara County, California",29,29,0
1000000US060855044182003,060855044182003,"Block 2003, Block Group 2, Census Tract 5044.18, Santa Clara County, California",22,22,0
1000000US060855044182004,060855044182004,"Block 2004, Block Group 2, Census Tract 5044.18, Santa Clara County, California",23,23,0
1000000US060855044182005,060855044182005,"Block 2005, Block Group 2, Census Tract 5044.18, Santa Clara County, California",25,24,1
1000000US060855044182006,060855044182006,"Block 2006, Block Group 2, Census Tract 5044.18, Santa Clara County, California",38,36,2
1000000US060855044182007,060855044182007,"Block 2007, Block Group 2, Census Tract 5044.18, Santa Clara County, California",30,30,0
1000000US060855044182008,060855044182008,"Block 2008, Block Group 2, Census Tract 5044.18, Santa Clara County, California",31,31,0
1000000US060855044182009,060855044182009,"Block 2009, Block Group 2, Census Tract 5044.18, Santa Clara County, California",75,74,1
1000000US060855044182010,060855044182010,"Block 2010, Block Group 2, Census Tract 5044.18, Santa Clara County, California",40,37,3
1000000US060855044182011,060855044182011,"Block 2011, Block Group 2, Census Tract 5044.18, Santa Clara County, California",27,26,1
1000000US060855044182012,060855044182012,"Block 2012, Block Group 2, Census Tract 5044.18, Santa Clara County, California",18,17,1
1000000US060855044182013,060855044182013,"Block 2013, Block Group 2, Census Tract 5044.18, Santa Clara County, California",15,15,0
1000000US060855044182014,060855044182014,"Block 2014, Block Group 2, Census Tract 5044.18, Santa Clara County, California",27,26,1
1000000US060855044182015,060855044182015,"Block 2015, Block Group 2, Census Tract 5044.18, Santa Clara County, California",5,5,0
1000000US060855044182016,060855044182016,"Block 2016, Block Group 2, Census Tract 5044.18, Santa Clara County, California",10,10,0
1000000US060855044182017,060855044182017,"Block 2017, Block Group 2, Census Tract 5044.18, Santa Clara County, California",12,12,0
1000000US060855044182018,060855044182018,"Block 2018, Block Group 2, Census Tract 5044.18, Santa Clara County, California",26,26,0
1000000US060855044183000,060855044183000,"Block 3000, Block Group 3, Census Tract 5044.18, Santa Clara County, California",8,8,0
1000000US060855044183001,060855044183001,"Block 3001, Block Group 3, Census Tract 5044.18, Santa Clara County, California",14,13,1
1000000US060855044183002,060855044183002,"Block 3002, Block Group 3, Census Tract 5044.18, Santa Clara County, California",27,25,2
1000000US060855044183003,060855044183003,"Block 3003, Block Group 3, Census Tract 5044.18, Santa Clara County, California",50,48,2
1000000US060855044183004,060855044183004,"Block 3004, Block Group 3, Census Tract 5044.18, Santa Clara County, California",42,42,0
1000000US060855044183005,060855044183005,"Block 3005, Block Group 3, Census Tract 5044.18, Santa Clara County, California",14,13,1
1000000US060855044183006,060855044183006,"Block 3006, Block Group 3, Census Tract 5044.18, Santa Clara County, California",14,14,0
1000000US060855044183007,060855044183007,"Block 3007, Block Group 3, Census Tract 5044.18, Santa Clara County, California",12,11,1
1000000US060855044201000,060855044201000,"Block 1000, Block Group 1, Census Tract 5044.20, Santa Clara County, California",0,0,0
1000000US060855044201001,060855044201001,"Block 1001, Block Group 1, Census Tract 5044.20, Santa Clara County, California",0,0,0
1000000US060855044201002,060855044201002,"Block 1002, Block Group 1, Census Tract 5044.20, Santa Clara County, California",31,30,1
1000000US060855044201003,060855044201003,"Block 1003, Block Group 1, Census Tract 5044.20, Santa Clara County, California",45,44,1
1000000US060855044201004,060855044201004,"Block 1004, Block Group 1, Census Tract 5044.20, Santa Clara County, California",25,25,0
1000000US060855044201005,060855044201005,"Block 1005, Block Group 1, Census Tract 5044.20, Santa Clara County, California",44,43,1
1000000US060855044201006,060855044201006,"Block 1006, Block Group 1, Census Tract 5044.20, Santa Clara County, California",58,56,2
1000000US060855044201007,060855044201007,"Block 1007, Block Group 1, Census Tract 5044.20, Santa Clara County, California",38,37,1
1000000US060855044201008,060855044201008,"Block 1008, Block Group 1, Census Tract 5044.20, Santa Clara County, California",72,71,1
1000000US060855044201009,060855044201009,"Block 1009, Block Group 1, Census Tract 5044.20, Santa Clara County, California",17,17,0
1000000US060855044201010,060855044201010,"Block 1010, Block Group 1, Census Tract 5044.20, Santa Clara County, California",42,40,2
1000000US060855044201011,060855044201011,"Block 1011, Block Group 1, Census Tract 5044.20, Santa Clara County, California",1,0,1
1000000US060855044201012,060855044201012,"Block 1012, Block Group 1, Census Tract 5044.20, Santa Clara County, California",143,139,4
1000000US060855044201013,060855044201013,"Block 1013, Block Group 1, Census Tract 5044.20, Santa Clara County, California",0,0,0
1000000US060855044201014,060855044201014,"Block 1014, Block Group 1, Census Tract 5044.20, Santa Clara County, California",0,0,0
1000000US060855044201015,060855044201015,"Block 1015, Block Group 1, Census Tract 5044.20, Santa Clara County, California",5,5,0
1000000US060855044201016,060855044201016,"Block 1016, Block Group 1, Census Tract 5044.20, Santa Clara County, California",71,68,3
1000000US060855044201017,060855044201017,"Block 1017, Block Group 1, Census Tract 5044.20, Santa Clara County, California",27,27,0
1000000US060855044201018,060855044201018,"Block 1018, Block Group 1, Census Tract 5044.20, Santa Clara County, California",22,22,0
1000000US060855044201019,060855044201019,"Block 1019, Block Group 1, Census Tract 5044.20, Santa Clara County, California",26,25,1
1000000US060855044202000,060855044202000,"Block 2000, Block Group 2, Census Tract 5044.20, Santa Clara County, California",52,51,1
1000000US060855044202001,060855044202001,"Block 2001, Block Group 2, Census Tract 5044.20, Santa Clara County, California",28,27,1
1000000US060855044202002,060855044202002,"Block 2002, Block Group 2, Census Tract 5044.20, Santa Clara County, California",152,151,1
1000000US060855044202003,060855044202003,"Block 2003, Block Group 2, Census Tract 5044.20, Santa Clara County, California",86,85,1
1000000US060855044202004,060855044202004,"Block 2004, Block Group 2, Census Tract 5044.20, Santa Clara County, California",59,59,0
1000000US060855044202005,060855044202005,"Block 2005, Block Group 2, Census Tract 5044.20, Santa Clara County, California",73,71,2
1000000US060855044202006,060855044202006,"Block 2006, Block Group 2, Census Tract 5044.20, Santa Clara County, California",45,43,2
1000000US060855044202007,060855044202007,"Block 2007, Block Group 2, Census Tract 5044.20, Santa Clara County, California",7,7,0
1000000US060855044203000,060855044203000,"Block 3000, Block Group 3, Census Tract 5044.20, Santa Clara County, California",0,0,0
1000000US060855044203001,060855044203001,"Block 3001, Block Group 3, Census Tract 5044.20, Santa Clara County, California",0,0,0
1000000US060855044203002,060855044203002,"Block 3002, Block Group 3, Census Tract 5044.20, Santa Clara County, California",1,1,0
1000000US060855044203003,060855044203003,"Block 3003, Block Group 3, Census Tract 5044.20, Santa Clara County, California",19,14,5
1000000US060855044203004,060855044203004,"Block 3004, Block Group 3, Census Tract 5044.20, Santa Clara County, California",1,0,1
1000000US060855044203005,060855044203005,"Block 3005, Block Group 3, Census Tract 5044.20, Santa Clara County, California",0,0,0
1000000US060855044203006,060855044203006,"Block 3006, Block Group 3, Census Tract 5044.20, Santa Clara County, California",0,0,0
1000000US060855044203007,060855044203007,"Block 3007, Block Group 3, Census Tract 5044.20, Santa Clara County, California",0,0,0
1000000US060855044203008,060855044203008,"Block 3008, Block Group 3, Census Tract 5044.20, Santa Clara County, California",2,0,2
1000000US060855044203009,060855044203009,"Block 3009, Block Group 3, Census Tract 5044.20, Santa Clara County, California",0,0,0
1000000US060855044203010,060855044203010,"Block 3010, Block Group 3, Census Tract 5044.20, Santa Clara County, California",2,1,1
1000000US060855044203011,060855044203011,"Block 3011, Block Group 3, Census Tract 5044.20, Santa Clara County, California",0,0,0
1000000US060855044203012,060855044203012,"Block 3012, Block Group 3, Census Tract 5044.20, Santa Clara County, California",0,0,0
1000000US060855044203013,060855044203013,"Block 3013, Block Group 3, Census Tract 5044.20, Santa Clara County, California",0,0,0
1000000US060855044203014,060855044203014,"Block 3014, Block Group 3, Census Tract 5044.20, Santa Clara County, California",5,5,0
1000000US060855044203015,060855044203015,"Block 3015, Block Group 3, Census Tract 5044.20, Santa Clara County, California",3,3,0
1000000US060855044203016,060855044203016,"Block 3016, Block Group 3, Census Tract 5044.20, Santa Clara County, California",2,0,2
1000000US060855044203017,060855044203017,"Block 3017, Block Group 3, Census Tract 5044.20, Santa Clara County, California",26,25,1
1000000US060855044203018,060855044203018,"Block 3018, Block Group 3, Census Tract 5044.20, Santa Clara County, California",46,42,4
1000000US060855044203019,060855044203019,"Block 3019, Block Group 3, Census Tract 5044.20, Santa Clara County, California",5,5,0
1000000US060855044203020,060855044203020,"Block 3020, Block Group 3, Census Tract 5044.20, Santa Clara County, California",62,60,2
1000000US060855044203021,060855044203021,"Block 3021, Block Group 3, Census Tract 5044.20, Santa Clara County, California",0,0,0
1000000US060855044203022,060855044203022,"Block 3022, Block Group 3, Census Tract 5044.20, Santa Clara County, California",24,24,0
1000000US060855044203023,060855044203023,"Block 3023, Block Group 3, Census Tract 5044.20, Santa Clara County, California",6,5,1
1000000US060855044203024,060855044203024,"Block 3024, Block Group 3, Census Tract 5044.20, Santa Clara County, California",0,0,0
1000000US060855044203025,060855044203025,"Block 3025, Block Group 3, Census Tract 5044.20, Santa Clara County, California",1,1,0
1000000US060855044203026,060855044203026,"Block 3026, Block Group 3, Census Tract 5044.20, Santa Clara County, California",0,0,0
1000000US060855044203027,060855044203027,"Block 3027, Block Group 3, Census Tract 5044.20, Santa Clara County, California",0,0,0
1000000US060855044203028,060855044203028,"Block 3028, Block Group 3, Census Tract 5044.20, Santa Clara County, California",0,0,0
1000000US060855044203029,060855044203029,"Block 3029, Block Group 3, Census Tract 5044.20, Santa Clara County, California",0,0,0
1000000US060855044203030,060855044203030,"Block 3030, Block Group 3, Census Tract 5044.20, Santa Clara County, California",1,1,0
1000000US060855044203031,060855044203031,"Block 3031, Block Group 3, Census Tract 5044.20, Santa Clara County, California",0,0,0
1000000US060855044203032,060855044203032,"Block 3032, Block Group 3, Census Tract 5044.20, Santa Clara County, California",0,0,0
1000000US060855044203033,060855044203033,"Block 3033, Block Group 3, Census Tract 5044.20, Santa Clara County, California",0,0,0
1000000US060855044203034,060855044203034,"Block 3034, Block Group 3, Census Tract 5044.20, Santa Clara County, California",0,0,0
1000000US060855044203035,060855044203035,"Block 3035, Block Group 3, Census Tract 5044.20, Santa Clara County, California",5,4,1
1000000US060855044203036,060855044203036,"Block 3036, Block Group 3, Census Tract 5044.20, Santa Clara County, California",1,1,0
1000000US060855044203037,060855044203037,"Block 3037, Block Group 3, Census Tract 5044.20, Santa Clara County, California",2,2,0
1000000US060855044211000,060855044211000,"Block 1000, Block Group 1, Census Tract 5044.21, Santa Clara County, California",0,0,0
1000000US060855044211001,060855044211001,"Block 1001, Block Group 1, Census Tract 5044.21, Santa Clara County, California",117,115,2
1000000US060855044211002,060855044211002,"Block 1002, Block Group 1, Census Tract 5044.21, Santa Clara County, California",71,69,2
1000000US060855044211003,060855044211003,"Block 1003, Block Group 1, Census Tract 5044.21, Santa Clara County, California",47,46,1
1000000US060855044211004,060855044211004,"Block 1004, Block Group 1, Census Tract 5044.21, Santa Clara County, California",17,17,0
1000000US060855044211005,060855044211005,"Block 1005, Block Group 1, Census Tract 5044.21, Santa Clara County, California",12,12,0
1000000US060855044211006,060855044211006,"Block 1006, Block Group 1, Census Tract 5044.21, Santa Clara County, California",75,73,2
1000000US060855044211007,060855044211007,"Block 1007, Block Group 1, Census Tract 5044.21, Santa Clara County, California",24,24,0
1000000US060855044212000,060855044212000,"Block 2000, Block Group 2, Census Tract 5044.21, Santa Clara County, California",0,0,0
1000000US060855044212001,060855044212001,"Block 2001, Block Group 2, Census Tract 5044.21, Santa Clara County, California",100,98,2
1000000US060855044212002,060855044212002,"Block 2002, Block Group 2, Census Tract 5044.21, Santa Clara County, California",24,24,0
1000000US060855044212003,060855044212003,"Block 2003, Block Group 2, Census Tract 5044.21, Santa Clara County, California",59,58,1
1000000US060855044212004,060855044212004,"Block 2004, Block Group 2, Census Tract 5044.21, Santa Clara County, California",20,20,0
1000000US060855044212005,060855044212005,"Block 2005, Block Group 2, Census Tract 5044.21, Santa Clara County, California",39,38,1
1000000US060855044212006,060855044212006,"Block 2006, Block Group 2, Census Tract 5044.21, Santa Clara County, California",18,18,0
1000000US060855044212007,060855044212007,"Block 2007, Block Group 2, Census Tract 5044.21, Santa Clara County, California",71,68,3
1000000US060855044212008,060855044212008,"Block 2008, Block Group 2, Census Tract 5044.21, Santa Clara County, California",21,21,0
1000000US060855044212009,060855044212009,"Block 2009, Block Group 2, Census Tract 5044.21, Santa Clara County, California",17,17,0
1000000US060855044212010,060855044212010,"Block 2010, Block Group 2, Census Tract 5044.21, Santa Clara County, California",9,9,0
1000000US060855044212011,060855044212011,"Block 2011, Block Group 2, Census Tract 5044.21, Santa Clara County, California",25,25,0
1000000US060855044212012,060855044212012,"Block 2012, Block Group 2, Census Tract 5044.21, Santa Clara County, California",31,31,0
1000000US060855044212013,060855044212013,"Block 2013, Block Group 2, Census Tract 5044.21, Santa Clara County, California",14,14,0
1000000US060855044212014,060855044212014,"Block 2014, Block Group 2, Census Tract 5044.21, Santa Clara County, California",19,19,0
1000000US060855044212015,060855044212015,"Block 2015, Block Group 2, Census Tract 5044.21, Santa Clara County, California",23,21,2
1000000US060855044212016,060855044212016,"Block 2016, Block Group 2, Census Tract 5044.21, Santa Clara County, California",0,0,0
1000000US060855044213000,060855044213000,"Block 3000, Block Group 3, Census Tract 5044.21, Santa Clara County, California",52,51,1
1000000US060855044213001,060855044213001,"Block 3001, Block Group 3, Census Tract 5044.21, Santa Clara County, California",67,66,1
1000000US060855044213002,060855044213002,"Block 3002, Block Group 3, Census Tract 5044.21, Santa Clara County, California",48,43,5
1000000US060855044213003,060855044213003,"Block 3003, Block Group 3, Census Tract 5044.21, Santa Clara County, California",18,17,1
1000000US060855044213004,060855044213004,"Block 3004, Block Group 3, Census Tract 5044.21, Santa Clara County, California",40,40,0
1000000US060855044213005,060855044213005,"Block 3005, Block Group 3, Census Tract 5044.21, Santa Clara County, California",29,28,1
1000000US060855044213006,060855044213006,"Block 3006, Block Group 3, Census Tract 5044.21, Santa Clara County, California",46,46,0
1000000US060855044213007,060855044213007,"Block 3007, Block Group 3, Census Tract 5044.21, Santa Clara County, California",55,55,0
1000000US060855044213008,060855044213008,"Block 3008, Block Group 3, Census Tract 5044.21, Santa Clara County, California",84,84,0
1000000US060855044213009,060855044213009,"Block 3009, Block Group 3, Census Tract 5044.21, Santa Clara County, California",21,19,2
1000000US060855044213010,060855044213010,"Block 3010, Block Group 3, Census Tract 5044.21, Santa Clara County, California",20,19,1
1000000US060855044213011,060855044213011,"Block 3011, Block Group 3, Census Tract 5044.21, Santa Clara County, California",11,11,0
1000000US060855044221000,060855044221000,"Block 1000, Block Group 1, Census Tract 5044.22, Santa Clara County, California",48,47,1
1000000US060855044221001,060855044221001,"Block 1001, Block Group 1, Census Tract 5044.22, Santa Clara County, California",28,28,0
1000000US060855044221002,060855044221002,"Block 1002, Block Group 1, Census Tract 5044.22, Santa Clara County, California",19,19,0
1000000US060855044221003,060855044221003,"Block 1003, Block Group 1, Census Tract 5044.22, Santa Clara County, California",193,187,6
1000000US060855044221004,060855044221004,"Block 1004, Block Group 1, Census Tract 5044.22, Santa Clara County, California",12,12,0
1000000US060855044221005,060855044221005,"Block 1005, Block Group 1, Census Tract 5044.22, Santa Clara County, California",19,18,1
1000000US060855044221006,060855044221006,"Block 1006, Block Group 1, Census Tract 5044.22, Santa Clara County, California",101,100,1
1000000US060855044221007,060855044221007,"Block 1007, Block Group 1, Census Tract 5044.22, Santa Clara County, California",29,29,0
1000000US060855044221008,060855044221008,"Block 1008, Block Group 1, Census Tract 5044.22, Santa Clara County, California",28,27,1
1000000US060855044221009,060855044221009,"Block 1009, Block Group 1, Census Tract 5044.22, Santa Clara County, California",40,40,0
1000000US060855044221010,060855044221010,"Block 1010, Block Group 1, Census Tract 5044.22, Santa Clara County, California",25,24,1
1000000US060855044222000,060855044222000,"Block 2000, Block Group 2, Census Tract 5044.22, Santa Clara County, California",214,211,3
1000000US060855044222001,060855044222001,"Block 2001, Block Group 2, Census Tract 5044.22, Santa Clara County, California",26,26,0
1000000US060855044222002,060855044222002,"Block 2002, Block Group 2, Census Tract 5044.22, Santa Clara County, California",5,5,0
1000000US060855044222003,060855044222003,"Block 2003, Block Group 2, Census Tract 5044.22, Santa Clara County, California",21,20,1
1000000US060855044222004,060855044222004,"Block 2004, Block Group 2, Census Tract 5044.22, Santa Clara County, California",106,105,1
1000000US060855044222005,060855044222005,"Block 2005, Block Group 2, Census Tract 5044.22, Santa Clara County, California",14,14,0
1000000US060855044222006,060855044222006,"Block 2006, Block Group 2, Census Tract 5044.22, Santa Clara County, California",17,17,0
1000000US060855044222007,060855044222007,"Block 2007, Block Group 2, Census Tract 5044.22, Santa Clara County, California",22,22,0
1000000US060855044222008,060855044222008,"Block 2008, Block Group 2, Census Tract 5044.22, Santa Clara County, California",22,20,2
1000000US060855044222009,060855044222009,"Block 2009, Block Group 2, Census Tract 5044.22, Santa Clara County, California",26,26,0
1000000US060855044231000,060855044231000,"Block 1000, Block Group 1, Census Tract 5044.23, Santa Clara County, California",10,10,0
1000000US060855044231001,060855044231001,"Block 1001, Block Group 1, Census Tract 5044.23, Santa Clara County, California",76,75,1
1000000US060855044231002,060855044231002,"Block 1002, Block Group 1, Census Tract 5044.23, Santa Clara County, California",17,15,2
1000000US060855044231003,060855044231003,"Block 1003, Block Group 1, Census Tract 5044.23, Santa Clara County, California",20,20,0
1000000US060855044231004,060855044231004,"Block 1004, Block Group 1, Census Tract 5044.23, Santa Clara County, California",20,20,0
1000000US060855044231005,060855044231005,"Block 1005, Block Group 1, Census Tract 5044.23, Santa Clara County, California",20,20,0
1000000US060855044231006,060855044231006,"Block 1006, Block Group 1, Census Tract 5044.23, Santa Clara County, California",25,23,2
1000000US060855044231007,060855044231007,"Block 1007, Block Group 1, Census Tract 5044.23, Santa Clara County, California",15,15,0
1000000US060855044231008,060855044231008,"Block 1008, Block Group 1, Census Tract 5044.23, Santa Clara County, California",20,20,0
1000000US060855044231009,060855044231009,"Block 1009, Block Group 1, Census Tract 5044.23, Santa Clara County, California",24,23,1
1000000US060855044231010,060855044231010,"Block 1010, Block Group 1, Census Tract 5044.23, Santa Clara County, California",29,29,0
1000000US060855044231011,060855044231011,"Block 1011, Block Group 1, Census Tract 5044.23, Santa Clara County, California",73,72,1
1000000US060855044231012,060855044231012,"Block 1012, Block Group 1, Census Tract 5044.23, Santa Clara County, California",0,0,0
1000000US060855044231013,060855044231013,"Block 1013, Block Group 1, Census Tract 5044.23, Santa Clara County, California",65,63,2
1000000US060855044231014,060855044231014,"Block 1014, Block Group 1, Census Tract 5044.23, Santa Clara County, California",18,18,0
1000000US060855044231015,060855044231015,"Block 1015, Block Group 1, Census Tract 5044.23, Santa Clara County, California",21,21,0
1000000US060855044231016,060855044231016,"Block 1016, Block Group 1, Census Tract 5044.23, Santa Clara County, California",40,37,3
1000000US060855044231017,060855044231017,"Block 1017, Block Group 1, Census Tract 5044.23, Santa Clara County, California",23,22,1
1000000US060855044231018,060855044231018,"Block 1018, Block Group 1, Census Tract 5044.23, Santa Clara County, California",22,21,1
1000000US060855044231019,060855044231019,"Block 1019, Block Group 1, Census Tract 5044.23, Santa Clara County, California",9,9,0
1000000US060855044231020,060855044231020,"Block 1020, Block Group 1, Census Tract 5044.23, Santa Clara County, California",21,21,0
1000000US060855044231021,060855044231021,"Block 1021, Block Group 1, Census Tract 5044.23, Santa Clara County, California",21,20,1
1000000US060855044231022,060855044231022,"Block 1022, Block Group 1, Census Tract 5044.23, Santa Clara County, California",20,19,1
1000000US060855044231023,060855044231023,"Block 1023, Block Group 1, Census Tract 5044.23, Santa Clara County, California",21,20,1
1000000US060855044231024,060855044231024,"Block 1024, Block Group 1, Census Tract 5044.23, Santa Clara County, California",24,22,2
1000000US060855045041000,060855045041000,"Block 1000, Block Group 1, Census Tract 5045.04, Santa Clara County, California",0,0,0
1000000US060855045041001,060855045041001,"Block 1001, Block Group 1, Census Tract 5045.04, Santa Clara County, California",0,0,0
1000000US060855045041002,060855045041002,"Block 1002, Block Group 1, Census Tract 5045.04, Santa Clara County, California",0,0,0
1000000US060855045041003,060855045041003,"Block 1003, Block Group 1, Census Tract 5045.04, Santa Clara County, California",0,0,0
1000000US060855045041004,060855045041004,"Block 1004, Block Group 1, Census Tract 5045.04, Santa Clara County, California",228,214,14
1000000US060855045041005,060855045041005,"Block 1005, Block Group 1, Census Tract 5045.04, Santa Clara County, California",0,0,0
1000000US060855045041006,060855045041006,"Block 1006, Block Group 1, Census Tract 5045.04, Santa Clara County, California",28,28,0
1000000US060855045041007,060855045041007,"Block 1007, Block Group 1, Census Tract 5045.04, Santa Clara County, California",44,42,2
1000000US060855045041008,060855045041008,"Block 1008, Block Group 1, Census Tract 5045.04, Santa Clara County, California",46,45,1
1000000US060855045042000,060855045042000,"Block 2000, Block Group 2, Census Tract 5045.04, Santa Clara County, California",0,0,0
1000000US060855045043000,060855045043000,"Block 3000, Block Group 3, Census Tract 5045.04, Santa Clara County, California",0,0,0
1000000US060855045043001,060855045043001,"Block 3001, Block Group 3, Census Tract 5045.04, Santa Clara County, California",145,142,3
1000000US060855045043002,060855045043002,"Block 3002, Block Group 3, Census Tract 5045.04, Santa Clara County, California",35,34,1
1000000US060855045043003,060855045043003,"Block 3003, Block Group 3, Census Tract 5045.04, Santa Clara County, California",38,38,0
1000000US060855045043004,060855045043004,"Block 3004, Block Group 3, Census Tract 5045.04, Santa Clara County, California",20,19,1
1000000US060855045043005,060855045043005,"Block 3005, Block Group 3, Census Tract 5045.04, Santa Clara County, California",82,78,4
1000000US060855045043006,060855045043006,"Block 3006, Block Group 3, Census Tract 5045.04, Santa Clara County, California",31,31,0
1000000US060855045043007,060855045043007,"Block 3007, Block Group 3, Census Tract 5045.04, Santa Clara County, California",31,31,0
1000000US060855045043008,060855045043008,"Block 3008, Block Group 3, Census Tract 5045.04, Santa Clara County, California",17,17,0
1000000US060855045043009,060855045043009,"Block 3009, Block Group 3, Census Tract 5045.04, Santa Clara County, California",0,0,0
1000000US060855045044000,060855045044000,"Block 4000, Block Group 4, Census Tract 5045.04, Santa Clara County, California",0,0,0
1000000US060855045044001,060855045044001,"Block 4001, Block Group 4, Census Tract 5045.04, Santa Clara County, California",0,0,0
1000000US060855045044002,060855045044002,"Block 4002, Block Group 4, Census Tract 5045.04, Santa Clara County, California",0,0,0
1000000US060855045044003,060855045044003,"Block 4003, Block Group 4, Census Tract 5045.04, Santa Clara County, California",0,0,0
1000000US060855045044004,060855045044004,"Block 4004, Block Group 4, Census Tract 5045.04, Santa Clara County, California",0,0,0
1000000US060855045044005,060855045044005,"Block 4005, Block Group 4, Census Tract 5045.04, Santa Clara County, California",0,0,0
1000000US060855045044006,060855045044006,"Block 4006, Block Group 4, Census Tract 5045.04, Santa Clara County, California",0,0,0
1000000US060855045044007,060855045044007,"Block 4007, Block Group 4, Census Tract 5045.04, Santa Clara County, California",0,0,0
1000000US060855045044008,060855045044008,"Block 4008, Block Group 4, Census Tract 5045.04, Santa Clara County, California",0,0,0
1000000US060855045044009,060855045044009,"Block 4009, Block Group 4, Census Tract 5045.04, Santa Clara County, California",0,0,0
1000000US060855045044010,060855045044010,"Block 4010, Block Group 4, Census Tract 5045.04, Santa Clara County, California",0,0,0
1000000US060855045044011,060855045044011,"Block 4011, Block Group 4, Census Tract 5045.04, Santa Clara County, California",0,0,0
1000000US060855045044012,060855045044012,"Block 4012, Block Group 4, Census Tract 5045.04, Santa Clara County, California",308,299,9
1000000US060855045044013,060855045044013,"Block 4013, Block Group 4, Census Tract 5045.04, Santa Clara County, California",0,0,0
1000000US060855045044014,060855045044014,"Block 4014, Block Group 4, Census Tract 5045.04, Santa Clara County, California",96,93,3
1000000US060855045044015,060855045044015,"Block 4015, Block Group 4, Census Tract 5045.04, Santa Clara County, California",90,88,2
1000000US060855045044016,060855045044016,"Block 4016, Block Group 4, Census Tract 5045.04, Santa Clara County, California",0,0,0
1000000US060855045044017,060855045044017,"Block 4017, Block Group 4, Census Tract 5045.04, Santa Clara County, California",6,5,1
1000000US060855045044018,060855045044018,"Block 4018, Block Group 4, Census Tract 5045.04, Santa Clara County, California",5,5,0
1000000US060855045044019,060855045044019,"Block 4019, Block Group 4, Census Tract 5045.04, Santa Clara County, California",2,2,0
1000000US060855045044020,060855045044020,"Block 4020, Block Group 4, Census Tract 5045.04, Santa Clara County, California",0,0,0
1000000US060855045044021,060855045044021,"Block 4021, Block Group 4, Census Tract 5045.04, Santa Clara County, California",0,0,0
1000000US060855045044022,060855045044022,"Block 4022, Block Group 4, Census Tract 5045.04, Santa Clara County, California",5,4,1
1000000US060855045044023,060855045044023,"Block 4023, Block Group 4, Census Tract 5045.04, Santa Clara County, California",1,1,0
1000000US060855045044024,060855045044024,"Block 4024, Block Group 4, Census Tract 5045.04, Santa Clara County, California",468,457,11
1000000US060855045044025,060855045044025,"Block 4025, Block Group 4, Census Tract 5045.04, Santa Clara County, California",0,0,0
1000000US060855045044026,060855045044026,"Block 4026, Block Group 4, Census Tract 5045.04, Santa Clara County, California",0,0,0
1000000US060855045044027,060855045044027,"Block 4027, Block Group 4, Census Tract 5045.04, Santa Clara County, California",0,0,0
1000000US060855045044028,060855045044028,"Block 4028, Block Group 4, Census Tract 5045.04, Santa Clara County, California",0,0,0
1000000US060855045044029,060855045044029,"Block 4029, Block Group 4, Census Tract 5045.04, Santa Clara County, California",0,0,0
1000000US060855045044030,060855045044030,"Block 4030, Block Group 4, Census Tract 5045.04, Santa Clara County, California",21,20,1
1000000US060855045044031,060855045044031,"Block 4031, Block Group 4, Census Tract 5045.04, Santa Clara County, California",0,0,0
1000000US060855045044032,060855045044032,"Block 4032, Block Group 4, Census Tract 5045.04, Santa Clara County, California",0,0,0
1000000US060855045044033,060855045044033,"Block 4033, Block Group 4, Census Tract 5045.04, Santa Clara County, California",0,0,0
1000000US060855045044034,060855045044034,"Block 4034, Block Group 4, Census Tract 5045.04, Santa Clara County, California",0,0,0
1000000US060855045044035,060855045044035,"Block 4035, Block Group 4, Census Tract 5045.04, Santa Clara County, California",0,0,0
1000000US060855045044036,060855045044036,"Block 4036, Block Group 4, Census Tract 5045.04, Santa Clara County, California",0,0,0
1000000US060855045044037,060855045044037,"Block 4037, Block Group 4, Census Tract 5045.04, Santa Clara County, California",0,0,0
1000000US060855045044038,060855045044038,"Block 4038, Block Group 4, Census Tract 5045.04, Santa Clara County, California",0,0,0
1000000US060855045044039,060855045044039,"Block 4039, Block Group 4, Census Tract 5045.04, Santa Clara County, California",32,32,0
1000000US060855045044040,060855045044040,"Block 4040, Block Group 4, Census Tract 5045.04, Santa Clara County, California",10,10,0
1000000US060855045044041,060855045044041,"Block 4041, Block Group 4, Census Tract 5045.04, Santa Clara County, California",10,10,0
1000000US060855045044042,060855045044042,"Block 4042, Block Group 4, Census Tract 5045.04, Santa Clara County, California",10,10,0
1000000US060855045044043,060855045044043,"Block 4043, Block Group 4, Census Tract 5045.04, Santa Clara County, California",16,16,0
1000000US060855045044044,060855045044044,"Block 4044, Block Group 4, Census Tract 5045.04, Santa Clara County, California",0,0,0
1000000US060855045044045,060855045044045,"Block 4045, Block Group 4, Census Tract 5045.04, Santa Clara County, California",0,0,0
1000000US060855045044046,060855045044046,"Block 4046, Block Group 4, Census Tract 5045.04, Santa Clara County, California",0,0,0
1000000US060855045044047,060855045044047,"Block 4047, Block Group 4, Census Tract 5045.04, Santa Clara County, California",0,0,0
1000000US060855045044048,060855045044048,"Block 4048, Block Group 4, Census Tract 5045.04, Santa Clara County, California",0,0,0
1000000US060855045044049,060855045044049,"Block 4049, Block Group 4, Census Tract 5045.04, Santa Clara County, California",55,52,3
1000000US060855045044050,060855045044050,"Block 4050, Block Group 4, Census Tract 5045.04, Santa Clara County, California",25,24,1
1000000US060855045044051,060855045044051,"Block 4051, Block Group 4, Census Tract 5045.04, Santa Clara County, California",29,27,2
1000000US060855045044052,060855045044052,"Block 4052, Block Group 4, Census Tract 5045.04, Santa Clara County, California",0,0,0
1000000US060855045044053,060855045044053,"Block 4053, Block Group 4, Census Tract 5045.04, Santa Clara County, California",8,8,0
1000000US060855045044054,060855045044054,"Block 4054, Block Group 4, Census Tract 5045.04, Santa Clara County, California",4,4,0
1000000US060855045044055,060855045044055,"Block 4055, Block Group 4, Census Tract 5045.04, Santa Clara County, California",23,23,0
1000000US060855045044056,060855045044056,"Block 4056, Block Group 4, Census Tract 5045.04, Santa Clara County, California",11,11,0
1000000US060855045044057,060855045044057,"Block 4057, Block Group 4, Census Tract 5045.04, Santa Clara County, California",4,4,0
1000000US060855045044058,060855045044058,"Block 4058, Block Group 4, Census Tract 5045.04, Santa Clara County, California",87,83,4
1000000US060855045044059,060855045044059,"Block 4059, Block Group 4, Census Tract 5045.04, Santa Clara County, California",1,1,0
1000000US060855045044060,060855045044060,"Block 4060, Block Group 4, Census Tract 5045.04, Santa Clara County, California",362,327,35
1000000US060855045044061,060855045044061,"Block 4061, Block Group 4, Census Tract 5045.04, Santa Clara County, California",6,5,1
1000000US060855045044062,060855045044062,"Block 4062, Block Group 4, Census Tract 5045.04, Santa Clara County, California",309,297,12
1000000US060855045044063,060855045044063,"Block 4063, Block Group 4, Census Tract 5045.04, Santa Clara County, California",0,0,0
1000000US060855045044064,060855045044064,"Block 4064, Block Group 4, Census Tract 5045.04, Santa Clara County, California",0,0,0
1000000US060855045051000,060855045051000,"Block 1000, Block Group 1, Census Tract 5045.05, Santa Clara County, California",158,155,3
1000000US060855045051001,060855045051001,"Block 1001, Block Group 1, Census Tract 5045.05, Santa Clara County, California",29,29,0
1000000US060855045051002,060855045051002,"Block 1002, Block Group 1, Census Tract 5045.05, Santa Clara County, California",23,23,0
1000000US060855045051003,060855045051003,"Block 1003, Block Group 1, Census Tract 5045.05, Santa Clara County, California",0,0,0
1000000US060855045051004,060855045051004,"Block 1004, Block Group 1, Census Tract 5045.05, Santa Clara County, California",0,0,0
1000000US060855045051005,060855045051005,"Block 1005, Block Group 1, Census Tract 5045.05, Santa Clara County, California",11,10,1
1000000US060855045052000,060855045052000,"Block 2000, Block Group 2, Census Tract 5045.05, Santa Clara County, California",34,33,1
1000000US060855045052001,060855045052001,"Block 2001, Block Group 2, Census Tract 5045.05, Santa Clara County, California",43,42,1
1000000US060855045052002,060855045052002,"Block 2002, Block Group 2, Census Tract 5045.05, Santa Clara County, California",38,37,1
1000000US060855045052003,060855045052003,"Block 2003, Block Group 2, Census Tract 5045.05, Santa Clara County, California",207,204,3
1000000US060855045052004,060855045052004,"Block 2004, Block Group 2, Census Tract 5045.05, Santa Clara County, California",36,35,1
1000000US060855045052005,060855045052005,"Block 2005, Block Group 2, Census Tract 5045.05, Santa Clara County, California",25,24,1
1000000US060855045052006,060855045052006,"Block 2006, Block Group 2, Census Tract 5045.05, Santa Clara County, California",9,9,0
1000000US060855045052007,060855045052007,"Block 2007, Block Group 2, Census Tract 5045.05, Santa Clara County, California",37,37,0
1000000US060855045052008,060855045052008,"Block 2008, Block Group 2, Census Tract 5045.05, Santa Clara County, California",38,36,2
1000000US060855045052009,060855045052009,"Block 2009, Block Group 2, Census Tract 5045.05, Santa Clara County, California",150,145,5
1000000US060855045052010,060855045052010,"Block 2010, Block Group 2, Census Tract 5045.05, Santa Clara County, California",0,0,0
1000000US060855045053000,060855045053000,"Block 3000, Block Group 3, Census Tract 5045.05, Santa Clara County, California",137,134,3
1000000US060855045053001,060855045053001,"Block 3001, Block Group 3, Census Tract 5045.05, Santa Clara County, California",0,0,0
1000000US060855045053002,060855045053002,"Block 3002, Block Group 3, Census Tract 5045.05, Santa Clara County, California",0,0,0
1000000US060855045053003,060855045053003,"Block 3003, Block Group 3, Census Tract 5045.05, Santa Clara County, California",56,53,3
1000000US060855045053004,060855045053004,"Block 3004, Block Group 3, Census Tract 5045.05, Santa Clara County, California",32,32,0
1000000US060855045053005,060855045053005,"Block 3005, Block Group 3, Census Tract 5045.05, Santa Clara County, California",26,25,1
1000000US060855045053006,060855045053006,"Block 3006, Block Group 3, Census Tract 5045.05, Santa Clara County, California",4,4,0
1000000US060855045053007,060855045053007,"Block 3007, Block Group 3, Census Tract 5045.05, Santa Clara County, California",188,162,26
1000000US060855045053008,060855045053008,"Block 3008, Block Group 3, Census Tract 5045.05, Santa Clara County, California",0,0,0
1000000US060855045053009,060855045053009,"Block 3009, Block Group 3, Census Tract 5045.05, Santa Clara County, California",0,0,0
1000000US060855045053010,060855045053010,"Block 3010, Block Group 3, Census Tract 5045.05, Santa Clara County, California",0,0,0
1000000US060855045053011,060855045053011,"Block 3011, Block Group 3, Census Tract 5045.05, Santa Clara County, California",0,0,0
1000000US060855045053012,060855045053012,"Block 3012, Block Group 3, Census Tract 5045.05, Santa Clara County, California",0,0,0
1000000US060855045053013,060855045053013,"Block 3013, Block Group 3, Census Tract 5045.05, Santa Clara County, California",0,0,0
1000000US060855045053014,060855045053014,"Block 3014, Block Group 3, Census Tract 5045.05, Santa Clara County, California",0,0,0
1000000US060855045053015,060855045053015,"Block 3015, Block Group 3, Census Tract 5045.05, Santa Clara County, California",29,29,0
1000000US060855045053016,060855045053016,"Block 3016, Block Group 3, Census Tract 5045.05, Santa Clara County, California",0,0,0
1000000US060855045053017,060855045053017,"Block 3017, Block Group 3, Census Tract 5045.05, Santa Clara County, California",0,0,0
1000000US060855045053018,060855045053018,"Block 3018, Block Group 3, Census Tract 5045.05, Santa Clara County, California",0,0,0
1000000US060855045053019,060855045053019,"Block 3019, Block Group 3, Census Tract 5045.05, Santa Clara County, California",0,0,0
1000000US060855045061000,060855045061000,"Block 1000, Block Group 1, Census Tract 5045.06, Santa Clara County, California",0,0,0
1000000US060855045061001,060855045061001,"Block 1001, Block Group 1, Census Tract 5045.06, Santa Clara County, California",267,252,15
1000000US060855045061002,060855045061002,"Block 1002, Block Group 1, Census Tract 5045.06, Santa Clara County, California",34,34,0
1000000US060855045061003,060855045061003,"Block 1003, Block Group 1, Census Tract 5045.06, Santa Clara County, California",0,0,0
1000000US060855045061004,060855045061004,"Block 1004, Block Group 1, Census Tract 5045.06, Santa Clara County, California",15,15,0
1000000US060855045062000,060855045062000,"Block 2000, Block Group 2, Census Tract 5045.06, Santa Clara County, California",0,0,0
1000000US060855045062001,060855045062001,"Block 2001, Block Group 2, Census Tract 5045.06, Santa Clara County, California",0,0,0
1000000US060855045062002,060855045062002,"Block 2002, Block Group 2, Census Tract 5045.06, Santa Clara County, California",0,0,0
1000000US060855045062003,060855045062003,"Block 2003, Block Group 2, Census Tract 5045.06, Santa Clara County, California",0,0,0
1000000US060855045062004,060855045062004,"Block 2004, Block Group 2, Census Tract 5045.06, Santa Clara County, California",0,0,0
1000000US060855045062005,060855045062005,"Block 2005, Block Group 2, Census Tract 5045.06, Santa Clara County, California",626,594,32
1000000US060855045062006,060855045062006,"Block 2006, Block Group 2, Census Tract 5045.06, Santa Clara County, California",0,0,0
1000000US060855045062007,060855045062007,"Block 2007, Block Group 2, Census Tract 5045.06, Santa Clara County, California",0,0,0
1000000US060855045062008,060855045062008,"Block 2008, Block Group 2, Census Tract 5045.06, Santa Clara County, California",24,23,1
1000000US060855045062009,060855045062009,"Block 2009, Block Group 2, Census Tract 5045.06, Santa Clara County, California",85,79,6
1000000US060855045062010,060855045062010,"Block 2010, Block Group 2, Census Tract 5045.06, Santa Clara County, California",22,21,1
1000000US060855045062011,060855045062011,"Block 2011, Block Group 2, Census Tract 5045.06, Santa Clara County, California",35,35,0
1000000US060855045062012,060855045062012,"Block 2012, Block Group 2, Census Tract 5045.06, Santa Clara County, California",45,45,0
1000000US060855045062013,060855045062013,"Block 2013, Block Group 2, Census Tract 5045.06, Santa Clara County, California",7,7,0
1000000US060855045062014,060855045062014,"Block 2014, Block Group 2, Census Tract 5045.06, Santa Clara County, California",37,37,0
1000000US060855045062015,060855045062015,"Block 2015, Block Group 2, Census Tract 5045.06, Santa Clara County, California",56,56,0
1000000US060855045062016,060855045062016,"Block 2016, Block Group 2, Census Tract 5045.06, Santa Clara County, California",26,24,2
1000000US060855045062017,060855045062017,"Block 2017, Block Group 2, Census Tract 5045.06, Santa Clara County, California",26,26,0
1000000US060855045062018,060855045062018,"Block 2018, Block Group 2, Census Tract 5045.06, Santa Clara County, California",12,11,1
1000000US060855045062019,060855045062019,"Block 2019, Block Group 2, Census Tract 5045.06, Santa Clara County, California",14,14,0
1000000US060855045063000,060855045063000,"Block 3000, Block Group 3, Census Tract 5045.06, Santa Clara County, California",497,472,25
1000000US060855045063001,060855045063001,"Block 3001, Block Group 3, Census Tract 5045.06, Santa Clara County, California",0,0,0
1000000US060855045063002,060855045063002,"Block 3002, Block Group 3, Census Tract 5045.06, Santa Clara County, California",233,225,8
1000000US060855045063003,060855045063003,"Block 3003, Block Group 3, Census Tract 5045.06, Santa Clara County, California",19,19,0
1000000US060855045063004,060855045063004,"Block 3004, Block Group 3, Census Tract 5045.06, Santa Clara County, California",19,19,0
1000000US060855045063005,060855045063005,"Block 3005, Block Group 3, Census Tract 5045.06, Santa Clara County, California",14,14,0
1000000US060855045063006,060855045063006,"Block 3006, Block Group 3, Census Tract 5045.06, Santa Clara County, California",8,8,0
1000000US060855045063007,060855045063007,"Block 3007, Block Group 3, Census Tract 5045.06, Santa Clara County, California",20,19,1
1000000US060855045063008,060855045063008,"Block 3008, Block Group 3, Census Tract 5045.06, Santa Clara County, California",0,0,0
1000000US060855045063009,060855045063009,"Block 3009, Block Group 3, Census Tract 5045.06, Santa Clara County, California",17,16,1
1000000US060855045063010,060855045063010,"Block 3010, Block Group 3, Census Tract 5045.06, Santa Clara County, California",11,10,1
1000000US060855045071000,060855045071000,"Block 1000, Block Group 1, Census Tract 5045.07, Santa Clara County, California",41,40,1
1000000US060855045071001,060855045071001,"Block 1001, Block Group 1, Census Tract 5045.07, Santa Clara County, California",41,40,1
1000000US060855045071002,060855045071002,"Block 1002, Block Group 1, Census Tract 5045.07, Santa Clara County, California",38,36,2
1000000US060855045071003,060855045071003,"Block 1003, Block Group 1, Census Tract 5045.07, Santa Clara County, California",23,20,3
1000000US060855045071004,060855045071004,"Block 1004, Block Group 1, Census Tract 5045.07, Santa Clara County, California",33,33,0
1000000US060855045071005,060855045071005,"Block 1005, Block Group 1, Census Tract 5045.07, Santa Clara County, California",18,18,0
1000000US060855045071006,060855045071006,"Block 1006, Block Group 1, Census Tract 5045.07, Santa Clara County, California",45,45,0
1000000US060855045071007,060855045071007,"Block 1007, Block Group 1, Census Tract 5045.07, Santa Clara County, California",25,25,0
1000000US060855045072000,060855045072000,"Block 2000, Block Group 2, Census Tract 5045.07, Santa Clara County, California",0,0,0
1000000US060855045072001,060855045072001,"Block 2001, Block Group 2, Census Tract 5045.07, Santa Clara County, California",0,0,0
1000000US060855045072002,060855045072002,"Block 2002, Block Group 2, Census Tract 5045.07, Santa Clara County, California",0,0,0
1000000US060855045072003,060855045072003,"Block 2003, Block Group 2, Census Tract 5045.07, Santa Clara County, California",50,50,0
1000000US060855045072004,060855045072004,"Block 2004, Block Group 2, Census Tract 5045.07, Santa Clara County, California",30,30,0
1000000US060855045072005,060855045072005,"Block 2005, Block Group 2, Census Tract 5045.07, Santa Clara County, California",75,75,0
1000000US060855045072006,060855045072006,"Block 2006, Block Group 2, Census Tract 5045.07, Santa Clara County, California",23,20,3
1000000US060855045072007,060855045072007,"Block 2007, Block Group 2, Census Tract 5045.07, Santa Clara County, California",47,47,0
1000000US060855045072008,060855045072008,"Block 2008, Block Group 2, Census Tract 5045.07, Santa Clara County, California",69,68,1
1000000US060855045072009,060855045072009,"Block 2009, Block Group 2, Census Tract 5045.07, Santa Clara County, California",46,46,0
1000000US060855045072010,060855045072010,"Block 2010, Block Group 2, Census Tract 5045.07, Santa Clara County, California",90,90,0
1000000US060855045072011,060855045072011,"Block 2011, Block Group 2, Census Tract 5045.07, Santa Clara County, California",39,39,0
1000000US060855045073000,060855045073000,"Block 3000, Block Group 3, Census Tract 5045.07, Santa Clara County, California",86,84,2
1000000US060855045073001,060855045073001,"Block 3001, Block Group 3, Census Tract 5045.07, Santa Clara County, California",40,39,1
1000000US060855045073002,060855045073002,"Block 3002, Block Group 3, Census Tract 5045.07, Santa Clara County, California",31,31,0
1000000US060855045073003,060855045073003,"Block 3003, Block Group 3, Census Tract 5045.07, Santa Clara County, California",19,18,1
1000000US060855045073004,060855045073004,"Block 3004, Block Group 3, Census Tract 5045.07, Santa Clara County, California",22,22,0
1000000US060855045073005,060855045073005,"Block 3005, Block Group 3, Census Tract 5045.07, Santa Clara County, California",85,80,5
1000000US060855045073006,060855045073006,"Block 3006, Block Group 3, Census Tract 5045.07, Santa Clara County, California",15,15,0
1000000US060855045073007,060855045073007,"Block 3007, Block Group 3, Census Tract 5045.07, Santa Clara County, California",47,45,2
1000000US060855045073008,060855045073008,"Block 3008, Block Group 3, Census Tract 5045.07, Santa Clara County, California",23,23,0
1000000US060855045073009,060855045073009,"Block 3009, Block Group 3, Census Tract 5045.07, Santa Clara County, California",0,0,0
1000000US060855045073010,060855045073010,"Block 3010, Block Group 3, Census Tract 5045.07, Santa Clara County, California",0,0,0
1000000US060855045073011,060855045073011,"Block 3011, Block Group 3, Census Tract 5045.07, Santa Clara County, California",103,103,0
1000000US060855045073012,060855045073012,"Block 3012, Block Group 3, Census Tract 5045.07, Santa Clara County, California",0,0,0
1000000US060855045074000,060855045074000,"Block 4000, Block Group 4, Census Tract 5045.07, Santa Clara County, California",78,74,4
1000000US060855045074001,060855045074001,"Block 4001, Block Group 4, Census Tract 5045.07, Santa Clara County, California",33,32,1
1000000US060855045074002,060855045074002,"Block 4002, Block Group 4, Census Tract 5045.07, Santa Clara County, California",49,48,1
1000000US060855045074003,060855045074003,"Block 4003, Block Group 4, Census Tract 5045.07, Santa Clara County, California",27,26,1
1000000US060855045074004,060855045074004,"Block 4004, Block Group 4, Census Tract 5045.07, Santa Clara County, California",42,40,2
1000000US060855045074005,060855045074005,"Block 4005, Block Group 4, Census Tract 5045.07, Santa Clara County, California",40,39,1
1000000US060855045074006,060855045074006,"Block 4006, Block Group 4, Census Tract 5045.07, Santa Clara County, California",18,18,0
1000000US060855045074007,060855045074007,"Block 4007, Block Group 4, Census Tract 5045.07, Santa Clara County, California",36,35,1
1000000US060855045074008,060855045074008,"Block 4008, Block Group 4, Census Tract 5045.07, Santa Clara County, California",31,29,2
1000000US060855045074009,060855045074009,"Block 4009, Block Group 4, Census Tract 5045.07, Santa Clara County, California",22,21,1
1000000US060855045074010,060855045074010,"Block 4010, Block Group 4, Census Tract 5045.07, Santa Clara County, California",46,45,1
1000000US060855045074011,060855045074011,"Block 4011, Block Group 4, Census Tract 5045.07, Santa Clara County, California",33,32,1
1000000US060855045074012,060855045074012,"Block 4012, Block Group 4, Census Tract 5045.07, Santa Clara County, California",12,11,1
1000000US060855045074013,060855045074013,"Block 4013, Block Group 4, Census Tract 5045.07, Santa Clara County, California",23,22,1
1000000US060855046011000,060855046011000,"Block 1000, Block Group 1, Census Tract 5046.01, Santa Clara County, California",0,0,0
1000000US060855046011001,060855046011001,"Block 1001, Block Group 1, Census Tract 5046.01, Santa Clara County, California",0,0,0
1000000US060855046011002,060855046011002,"Block 1002, Block Group 1, Census Tract 5046.01, Santa Clara County, California",0,0,0
1000000US060855046011003,060855046011003,"Block 1003, Block Group 1, Census Tract 5046.01, Santa Clara County, California",0,0,0
1000000US060855046011004,060855046011004,"Block 1004, Block Group 1, Census Tract 5046.01, Santa Clara County, California",0,0,0
1000000US060855046011005,060855046011005,"Block 1005, Block Group 1, Census Tract 5046.01, Santa Clara County, California",0,0,0
1000000US060855046011006,060855046011006,"Block 1006, Block Group 1, Census Tract 5046.01, Santa Clara County, California",0,0,0
1000000US060855046011007,060855046011007,"Block 1007, Block Group 1, Census Tract 5046.01, Santa Clara County, California",0,0,0
1000000US060855046011008,060855046011008,"Block 1008, Block Group 1, Census Tract 5046.01, Santa Clara County, California",0,0,0
1000000US060855046011009,060855046011009,"Block 1009, Block Group 1, Census Tract 5046.01, Santa Clara County, California",0,0,0
1000000US060855046011010,060855046011010,"Block 1010, Block Group 1, Census Tract 5046.01, Santa Clara County, California",0,0,0
1000000US060855046011011,060855046011011,"Block 1011, Block Group 1, Census Tract 5046.01, Santa Clara County, California",0,0,0
1000000US060855046011012,060855046011012,"Block 1012, Block Group 1, Census Tract 5046.01, Santa Clara County, California",0,0,0
1000000US060855046011013,060855046011013,"Block 1013, Block Group 1, Census Tract 5046.01, Santa Clara County, California",0,0,0
1000000US060855046011014,060855046011014,"Block 1014, Block Group 1, Census Tract 5046.01, Santa Clara County, California",0,0,0
1000000US060855046011015,060855046011015,"Block 1015, Block Group 1, Census Tract 5046.01, Santa Clara County, California",0,0,0
1000000US060855046011016,060855046011016,"Block 1016, Block Group 1, Census Tract 5046.01, Santa Clara County, California",0,0,0
1000000US060855046011017,060855046011017,"Block 1017, Block Group 1, Census Tract 5046.01, Santa Clara County, California",0,0,0
1000000US060855046011018,060855046011018,"Block 1018, Block Group 1, Census Tract 5046.01, Santa Clara County, California",0,0,0
1000000US060855046011019,060855046011019,"Block 1019, Block Group 1, Census Tract 5046.01, Santa Clara County, California",0,0,0
1000000US060855046011020,060855046011020,"Block 1020, Block Group 1, Census Tract 5046.01, Santa Clara County, California",0,0,0
1000000US060855046011021,060855046011021,"Block 1021, Block Group 1, Census Tract 5046.01, Santa Clara County, California",0,0,0
1000000US060855046011022,060855046011022,"Block 1022, Block Group 1, Census Tract 5046.01, Santa Clara County, California",0,0,0
1000000US060855046011023,060855046011023,"Block 1023, Block Group 1, Census Tract 5046.01, Santa Clara County, California",1,1,0
1000000US060855046011024,060855046011024,"Block 1024, Block Group 1, Census Tract 5046.01, Santa Clara County, California",0,0,0
1000000US060855046011025,060855046011025,"Block 1025, Block Group 1, Census Tract 5046.01, Santa Clara County, California",0,0,0
1000000US060855046011026,060855046011026,"Block 1026, Block Group 1, Census Tract 5046.01, Santa Clara County, California",0,0,0
1000000US060855046011027,060855046011027,"Block 1027, Block Group 1, Census Tract 5046.01, Santa Clara County, California",0,0,0
1000000US060855046011028,060855046011028,"Block 1028, Block Group 1, Census Tract 5046.01, Santa Clara County, California",0,0,0
1000000US060855046011029,060855046011029,"Block 1029, Block Group 1, Census Tract 5046.01, Santa Clara County, California",0,0,0
1000000US060855046011030,060855046011030,"Block 1030, Block Group 1, Census Tract 5046.01, Santa Clara County, California",0,0,0
1000000US060855046011031,060855046011031,"Block 1031, Block Group 1, Census Tract 5046.01, Santa Clara County, California",0,0,0
1000000US060855046011032,060855046011032,"Block 1032, Block Group 1, Census Tract 5046.01, Santa Clara County, California",0,0,0
1000000US060855046011033,060855046011033,"Block 1033, Block Group 1, Census Tract 5046.01, Santa Clara County, California",0,0,0
1000000US060855046011034,060855046011034,"Block 1034, Block Group 1, Census Tract 5046.01, Santa Clara County, California",0,0,0
1000000US060855046011035,060855046011035,"Block 1035, Block Group 1, Census Tract 5046.01, Santa Clara County, California",0,0,0
1000000US060855046011036,060855046011036,"Block 1036, Block Group 1, Census Tract 5046.01, Santa Clara County, California",0,0,0
1000000US060855046011037,060855046011037,"Block 1037, Block Group 1, Census Tract 5046.01, Santa Clara County, California",0,0,0
1000000US060855046011038,060855046011038,"Block 1038, Block Group 1, Census Tract 5046.01, Santa Clara County, California",0,0,0
1000000US060855046011039,060855046011039,"Block 1039, Block Group 1, Census Tract 5046.01, Santa Clara County, California",0,0,0
1000000US060855046011040,060855046011040,"Block 1040, Block Group 1, Census Tract 5046.01, Santa Clara County, California",0,0,0
1000000US060855046011041,060855046011041,"Block 1041, Block Group 1, Census Tract 5046.01, Santa Clara County, California",0,0,0
1000000US060855046011042,060855046011042,"Block 1042, Block Group 1, Census Tract 5046.01, Santa Clara County, California",0,0,0
1000000US060855046011043,060855046011043,"Block 1043, Block Group 1, Census Tract 5046.01, Santa Clara County, California",0,0,0
1000000US060855046011044,060855046011044,"Block 1044, Block Group 1, Census Tract 5046.01, Santa Clara County, California",0,0,0
1000000US060855046011045,060855046011045,"Block 1045, Block Group 1, Census Tract 5046.01, Santa Clara County, California",0,0,0
1000000US060855046011046,060855046011046,"Block 1046, Block Group 1, Census Tract 5046.01, Santa Clara County, California",0,0,0
1000000US060855046011047,060855046011047,"Block 1047, Block Group 1, Census Tract 5046.01, Santa Clara County, California",0,0,0
1000000US060855046011048,060855046011048,"Block 1048, Block Group 1, Census Tract 5046.01, Santa Clara County, California",0,0,0
1000000US060855046011049,060855046011049,"Block 1049, Block Group 1, Census Tract 5046.01, Santa Clara County, California",0,0,0
1000000US060855046011050,060855046011050,"Block 1050, Block Group 1, Census Tract 5046.01, Santa Clara County, California",0,0,0
1000000US060855046011051,060855046011051,"Block 1051, Block Group 1, Census Tract 5046.01, Santa Clara County, California",0,0,0
1000000US060855046011052,060855046011052,"Block 1052, Block Group 1, Census Tract 5046.01, Santa Clara County, California",0,0,0
1000000US060855046011053,060855046011053,"Block 1053, Block Group 1, Census Tract 5046.01, Santa Clara County, California",0,0,0
1000000US060855046011054,060855046011054,"Block 1054, Block Group 1, Census Tract 5046.01, Santa Clara County, California",0,0,0
1000000US060855046011055,060855046011055,"Block 1055, Block Group 1, Census Tract 5046.01, Santa Clara County, California",0,0,0
1000000US060855046011056,060855046011056,"Block 1056, Block Group 1, Census Tract 5046.01, Santa Clara County, California",0,0,0
1000000US060855046011057,060855046011057,"Block 1057, Block Group 1, Census Tract 5046.01, Santa Clara County, California",4,3,1
1000000US060855046011058,060855046011058,"Block 1058, Block Group 1, Census Tract 5046.01, Santa Clara County, California",0,0,0
1000000US060855046011059,060855046011059,"Block 1059, Block Group 1, Census Tract 5046.01, Santa Clara County, California",0,0,0
1000000US060855046011060,060855046011060,"Block 1060, Block Group 1, Census Tract 5046.01, Santa Clara County, California",0,0,0
1000000US060855046011061,060855046011061,"Block 1061, Block Group 1, Census Tract 5046.01, Santa Clara County, California",0,0,0
1000000US060855046011062,060855046011062,"Block 1062, Block Group 1, Census Tract 5046.01, Santa Clara County, California",0,0,0
1000000US060855046011063,060855046011063,"Block 1063, Block Group 1, Census Tract 5046.01, Santa Clara County, California",0,0,0
1000000US060855046011064,060855046011064,"Block 1064, Block Group 1, Census Tract 5046.01, Santa Clara County, California",0,0,0
1000000US060855046011065,060855046011065,"Block 1065, Block Group 1, Census Tract 5046.01, Santa Clara County, California",0,0,0
1000000US060855046011066,060855046011066,"Block 1066, Block Group 1, Census Tract 5046.01, Santa Clara County, California",0,0,0
1000000US060855046011067,060855046011067,"Block 1067, Block Group 1, Census Tract 5046.01, Santa Clara County, California",0,0,0
1000000US060855046011068,060855046011068,"Block 1068, Block Group 1, Census Tract 5046.01, Santa Clara County, California",0,0,0
1000000US060855046011069,060855046011069,"Block 1069, Block Group 1, Census Tract 5046.01, Santa Clara County, California",0,0,0
1000000US060855046011070,060855046011070,"Block 1070, Block Group 1, Census Tract 5046.01, Santa Clara County, California",0,0,0
1000000US060855046011071,060855046011071,"Block 1071, Block Group 1, Census Tract 5046.01, Santa Clara County, California",0,0,0
1000000US060855046011072,060855046011072,"Block 1072, Block Group 1, Census Tract 5046.01, Santa Clara County, California",0,0,0
1000000US060855046011073,060855046011073,"Block 1073, Block Group 1, Census Tract 5046.01, Santa Clara County, California",0,0,0
1000000US060855046011074,060855046011074,"Block 1074, Block Group 1, Census Tract 5046.01, Santa Clara County, California",0,0,0
1000000US060855046011075,060855046011075,"Block 1075, Block Group 1, Census Tract 5046.01, Santa Clara County, California",0,0,0
1000000US060855046011076,060855046011076,"Block 1076, Block Group 1, Census Tract 5046.01, Santa Clara County, California",0,0,0
1000000US060855046011077,060855046011077,"Block 1077, Block Group 1, Census Tract 5046.01, Santa Clara County, California",0,0,0
1000000US060855046011078,060855046011078,"Block 1078, Block Group 1, Census Tract 5046.01, Santa Clara County, California",0,0,0
1000000US060855046011079,060855046011079,"Block 1079, Block Group 1, Census Tract 5046.01, Santa Clara County, California",0,0,0
1000000US060855046011080,060855046011080,"Block 1080, Block Group 1, Census Tract 5046.01, Santa Clara County, California",0,0,0
1000000US060855046011081,060855046011081,"Block 1081, Block Group 1, Census Tract 5046.01, Santa Clara County, California",0,0,0
1000000US060855046011082,060855046011082,"Block 1082, Block Group 1, Census Tract 5046.01, Santa Clara County, California",0,0,0
1000000US060855046011083,060855046011083,"Block 1083, Block Group 1, Census Tract 5046.01, Santa Clara County, California",38,37,1
1000000US060855046011084,060855046011084,"Block 1084, Block Group 1, Census Tract 5046.01, Santa Clara County, California",0,0,0
1000000US060855046011085,060855046011085,"Block 1085, Block Group 1, Census Tract 5046.01, Santa Clara County, California",0,0,0
1000000US060855046011086,060855046011086,"Block 1086, Block Group 1, Census Tract 5046.01, Santa Clara County, California",42,38,4
1000000US060855046011087,060855046011087,"Block 1087, Block Group 1, Census Tract 5046.01, Santa Clara County, California",0,0,0
1000000US060855046011088,060855046011088,"Block 1088, Block Group 1, Census Tract 5046.01, Santa Clara County, California",0,0,0
1000000US060855046011089,060855046011089,"Block 1089, Block Group 1, Census Tract 5046.01, Santa Clara County, California",0,0,0
1000000US060855046011090,060855046011090,"Block 1090, Block Group 1, Census Tract 5046.01, Santa Clara County, California",14,14,0
1000000US060855046011091,060855046011091,"Block 1091, Block Group 1, Census Tract 5046.01, Santa Clara County, California",0,0,0
1000000US060855046011092,060855046011092,"Block 1092, Block Group 1, Census Tract 5046.01, Santa Clara County, California",29,28,1
1000000US060855046011093,060855046011093,"Block 1093, Block Group 1, Census Tract 5046.01, Santa Clara County, California",33,33,0
1000000US060855046011094,060855046011094,"Block 1094, Block Group 1, Census Tract 5046.01, Santa Clara County, California",36,34,2
1000000US060855046011095,060855046011095,"Block 1095, Block Group 1, Census Tract 5046.01, Santa Clara County, California",0,0,0
1000000US060855046011096,060855046011096,"Block 1096, Block Group 1, Census Tract 5046.01, Santa Clara County, California",0,0,0
1000000US060855046011097,060855046011097,"Block 1097, Block Group 1, Census Tract 5046.01, Santa Clara County, California",0,0,0
1000000US060855046011098,060855046011098,"Block 1098, Block Group 1, Census Tract 5046.01, Santa Clara County, California",11,10,1
1000000US060855046011099,060855046011099,"Block 1099, Block Group 1, Census Tract 5046.01, Santa Clara County, California",21,20,1
1000000US060855046011100,060855046011100,"Block 1100, Block Group 1, Census Tract 5046.01, Santa Clara County, California",0,0,0
1000000US060855046011101,060855046011101,"Block 1101, Block Group 1, Census Tract 5046.01, Santa Clara County, California",0,0,0
1000000US060855046011102,060855046011102,"Block 1102, Block Group 1, Census Tract 5046.01, Santa Clara County, California",0,0,0
1000000US060855046011103,060855046011103,"Block 1103, Block Group 1, Census Tract 5046.01, Santa Clara County, California",0,0,0
1000000US060855046011104,060855046011104,"Block 1104, Block Group 1, Census Tract 5046.01, Santa Clara County, California",0,0,0
1000000US060855046011105,060855046011105,"Block 1105, Block Group 1, Census Tract 5046.01, Santa Clara County, California",30,29,1
1000000US060855046011106,060855046011106,"Block 1106, Block Group 1, Census Tract 5046.01, Santa Clara County, California",30,29,1
1000000US060855046011107,060855046011107,"Block 1107, Block Group 1, Census Tract 5046.01, Santa Clara County, California",0,0,0
1000000US060855046011108,060855046011108,"Block 1108, Block Group 1, Census Tract 5046.01, Santa Clara County, California",30,26,4
1000000US060855046011109,060855046011109,"Block 1109, Block Group 1, Census Tract 5046.01, Santa Clara County, California",30,29,1
1000000US060855046011110,060855046011110,"Block 1110, Block Group 1, Census Tract 5046.01, Santa Clara County, California",0,0,0
1000000US060855046011111,060855046011111,"Block 1111, Block Group 1, Census Tract 5046.01, Santa Clara County, California",0,0,0
1000000US060855046011112,060855046011112,"Block 1112, Block Group 1, Census Tract 5046.01, Santa Clara County, California",0,0,0
1000000US060855046011113,060855046011113,"Block 1113, Block Group 1, Census Tract 5046.01, Santa Clara County, California",0,0,0
1000000US060855046011114,060855046011114,"Block 1114, Block Group 1, Census Tract 5046.01, Santa Clara County, California",0,0,0
1000000US060855046011115,060855046011115,"Block 1115, Block Group 1, Census Tract 5046.01, Santa Clara County, California",0,0,0
1000000US060855046011116,060855046011116,"Block 1116, Block Group 1, Census Tract 5046.01, Santa Clara County, California",0,0,0
1000000US060855046011117,060855046011117,"Block 1117, Block Group 1, Census Tract 5046.01, Santa Clara County, California",0,0,0
1000000US060855046011118,060855046011118,"Block 1118, Block Group 1, Census Tract 5046.01, Santa Clara County, California",0,0,0
1000000US060855046011119,060855046011119,"Block 1119, Block Group 1, Census Tract 5046.01, Santa Clara County, California",0,0,0
1000000US060855046011120,060855046011120,"Block 1120, Block Group 1, Census Tract 5046.01, Santa Clara County, California",0,0,0
1000000US060855046011121,060855046011121,"Block 1121, Block Group 1, Census Tract 5046.01, Santa Clara County, California",0,0,0
1000000US060855046011122,060855046011122,"Block 1122, Block Group 1, Census Tract 5046.01, Santa Clara County, California",0,0,0
1000000US060855046011123,060855046011123,"Block 1123, Block Group 1, Census Tract 5046.01, Santa Clara County, California",0,0,0
1000000US060855046011124,060855046011124,"Block 1124, Block Group 1, Census Tract 5046.01, Santa Clara County, California",0,0,0
1000000US060855046011125,060855046011125,"Block 1125, Block Group 1, Census Tract 5046.01, Santa Clara County, California",0,0,0
1000000US060855046011126,060855046011126,"Block 1126, Block Group 1, Census Tract 5046.01, Santa Clara County, California",0,0,0
1000000US060855046011127,060855046011127,"Block 1127, Block Group 1, Census Tract 5046.01, Santa Clara County, California",0,0,0
1000000US060855046011128,060855046011128,"Block 1128, Block Group 1, Census Tract 5046.01, Santa Clara County, California",0,0,0
1000000US060855046011129,060855046011129,"Block 1129, Block Group 1, Census Tract 5046.01, Santa Clara County, California",0,0,0
1000000US060855046011130,060855046011130,"Block 1130, Block Group 1, Census Tract 5046.01, Santa Clara County, California",0,0,0
1000000US060855046011131,060855046011131,"Block 1131, Block Group 1, Census Tract 5046.01, Santa Clara County, California",0,0,0
1000000US060855046011132,060855046011132,"Block 1132, Block Group 1, Census Tract 5046.01, Santa Clara County, California",0,0,0
1000000US060855046011133,060855046011133,"Block 1133, Block Group 1, Census Tract 5046.01, Santa Clara County, California",0,0,0
1000000US060855046011134,060855046011134,"Block 1134, Block Group 1, Census Tract 5046.01, Santa Clara County, California",0,0,0
1000000US060855046011135,060855046011135,"Block 1135, Block Group 1, Census Tract 5046.01, Santa Clara County, California",0,0,0
1000000US060855046011136,060855046011136,"Block 1136, Block Group 1, Census Tract 5046.01, Santa Clara County, California",0,0,0
1000000US060855046011137,060855046011137,"Block 1137, Block Group 1, Census Tract 5046.01, Santa Clara County, California",0,0,0
1000000US060855046011138,060855046011138,"Block 1138, Block Group 1, Census Tract 5046.01, Santa Clara County, California",0,0,0
1000000US060855046011139,060855046011139,"Block 1139, Block Group 1, Census Tract 5046.01, Santa Clara County, California",0,0,0
1000000US060855046011140,060855046011140,"Block 1140, Block Group 1, Census Tract 5046.01, Santa Clara County, California",0,0,0
1000000US060855046011141,060855046011141,"Block 1141, Block Group 1, Census Tract 5046.01, Santa Clara County, California",0,0,0
1000000US060855046011142,060855046011142,"Block 1142, Block Group 1, Census Tract 5046.01, Santa Clara County, California",0,0,0
1000000US060855046011143,060855046011143,"Block 1143, Block Group 1, Census Tract 5046.01, Santa Clara County, California",0,0,0
1000000US060855046011144,060855046011144,"Block 1144, Block Group 1, Census Tract 5046.01, Santa Clara County, California",0,0,0
1000000US060855046011145,060855046011145,"Block 1145, Block Group 1, Census Tract 5046.01, Santa Clara County, California",0,0,0
1000000US060855046011146,060855046011146,"Block 1146, Block Group 1, Census Tract 5046.01, Santa Clara County, California",0,0,0
1000000US060855046011147,060855046011147,"Block 1147, Block Group 1, Census Tract 5046.01, Santa Clara County, California",0,0,0
1000000US060855046011148,060855046011148,"Block 1148, Block Group 1, Census Tract 5046.01, Santa Clara County, California",0,0,0
1000000US060855046011149,060855046011149,"Block 1149, Block Group 1, Census Tract 5046.01, Santa Clara County, California",0,0,0
1000000US060855046011150,060855046011150,"Block 1150, Block Group 1, Census Tract 5046.01, Santa Clara County, California",0,0,0
1000000US060855046011151,060855046011151,"Block 1151, Block Group 1, Census Tract 5046.01, Santa Clara County, California",0,0,0
1000000US060855046011152,060855046011152,"Block 1152, Block Group 1, Census Tract 5046.01, Santa Clara County, California",0,0,0
1000000US060855046011153,060855046011153,"Block 1153, Block Group 1, Census Tract 5046.01, Santa Clara County, California",0,0,0
1000000US060855046011154,060855046011154,"Block 1154, Block Group 1, Census Tract 5046.01, Santa Clara County, California",0,0,0
1000000US060855046011155,060855046011155,"Block 1155, Block Group 1, Census Tract 5046.01, Santa Clara County, California",0,0,0
1000000US060855046011156,060855046011156,"Block 1156, Block Group 1, Census Tract 5046.01, Santa Clara County, California",0,0,0
1000000US060855046011157,060855046011157,"Block 1157, Block Group 1, Census Tract 5046.01, Santa Clara County, California",0,0,0
1000000US060855046011158,060855046011158,"Block 1158, Block Group 1, Census Tract 5046.01, Santa Clara County, California",0,0,0
1000000US060855046011159,060855046011159,"Block 1159, Block Group 1, Census Tract 5046.01, Santa Clara County, California",0,0,0
1000000US060855046011160,060855046011160,"Block 1160, Block Group 1, Census Tract 5046.01, Santa Clara County, California",1,1,0
1000000US060855046011161,060855046011161,"Block 1161, Block Group 1, Census Tract 5046.01, Santa Clara County, California",0,0,0
1000000US060855046011162,060855046011162,"Block 1162, Block Group 1, Census Tract 5046.01, Santa Clara County, California",0,0,0
1000000US060855046011163,060855046011163,"Block 1163, Block Group 1, Census Tract 5046.01, Santa Clara County, California",1,1,0
1000000US060855046011164,060855046011164,"Block 1164, Block Group 1, Census Tract 5046.01, Santa Clara County, California",0,0,0
1000000US060855046011165,060855046011165,"Block 1165, Block Group 1, Census Tract 5046.01, Santa Clara County, California",0,0,0
1000000US060855046011166,060855046011166,"Block 1166, Block Group 1, Census Tract 5046.01, Santa Clara County, California",0,0,0
1000000US060855046011167,060855046011167,"Block 1167, Block Group 1, Census Tract 5046.01, Santa Clara County, California",0,0,0
1000000US060855046011168,060855046011168,"Block 1168, Block Group 1, Census Tract 5046.01, Santa Clara County, California",0,0,0
1000000US060855046011169,060855046011169,"Block 1169, Block Group 1, Census Tract 5046.01, Santa Clara County, California",0,0,0
1000000US060855046011170,060855046011170,"Block 1170, Block Group 1, Census Tract 5046.01, Santa Clara County, California",0,0,0
1000000US060855046011171,060855046011171,"Block 1171, Block Group 1, Census Tract 5046.01, Santa Clara County, California",0,0,0
1000000US060855046011172,060855046011172,"Block 1172, Block Group 1, Census Tract 5046.01, Santa Clara County, California",0,0,0
1000000US060855046011173,060855046011173,"Block 1173, Block Group 1, Census Tract 5046.01, Santa Clara County, California",0,0,0
1000000US060855046011174,060855046011174,"Block 1174, Block Group 1, Census Tract 5046.01, Santa Clara County, California",0,0,0
1000000US060855046011175,060855046011175,"Block 1175, Block Group 1, Census Tract 5046.01, Santa Clara County, California",0,0,0
1000000US060855046011176,060855046011176,"Block 1176, Block Group 1, Census Tract 5046.01, Santa Clara County, California",0,0,0
1000000US060855046011177,060855046011177,"Block 1177, Block Group 1, Census Tract 5046.01, Santa Clara County, California",0,0,0
1000000US060855046011178,060855046011178,"Block 1178, Block Group 1, Census Tract 5046.01, Santa Clara County, California",0,0,0
1000000US060855046011179,060855046011179,"Block 1179, Block Group 1, Census Tract 5046.01, Santa Clara County, California",0,0,0
1000000US060855046011180,060855046011180,"Block 1180, Block Group 1, Census Tract 5046.01, Santa Clara County, California",0,0,0
1000000US060855046011181,060855046011181,"Block 1181, Block Group 1, Census Tract 5046.01, Santa Clara County, California",0,0,0
1000000US060855046011182,060855046011182,"Block 1182, Block Group 1, Census Tract 5046.01, Santa Clara County, California",0,0,0
1000000US060855046011183,060855046011183,"Block 1183, Block Group 1, Census Tract 5046.01, Santa Clara County, California",0,0,0
1000000US060855046011184,060855046011184,"Block 1184, Block Group 1, Census Tract 5046.01, Santa Clara County, California",0,0,0
1000000US060855046011185,060855046011185,"Block 1185, Block Group 1, Census Tract 5046.01, Santa Clara County, California",0,0,0
1000000US060855046011186,060855046011186,"Block 1186, Block Group 1, Census Tract 5046.01, Santa Clara County, California",0,0,0
1000000US060855046011187,060855046011187,"Block 1187, Block Group 1, Census Tract 5046.01, Santa Clara County, California",0,0,0
1000000US060855046011188,060855046011188,"Block 1188, Block Group 1, Census Tract 5046.01, Santa Clara County, California",0,0,0
1000000US060855046011189,060855046011189,"Block 1189, Block Group 1, Census Tract 5046.01, Santa Clara County, California",0,0,0
1000000US060855046011190,060855046011190,"Block 1190, Block Group 1, Census Tract 5046.01, Santa Clara County, California",0,0,0
1000000US060855046011191,060855046011191,"Block 1191, Block Group 1, Census Tract 5046.01, Santa Clara County, California",0,0,0
1000000US060855046011192,060855046011192,"Block 1192, Block Group 1, Census Tract 5046.01, Santa Clara County, California",0,0,0
1000000US060855046011193,060855046011193,"Block 1193, Block Group 1, Census Tract 5046.01, Santa Clara County, California",0,0,0
1000000US060855046011194,060855046011194,"Block 1194, Block Group 1, Census Tract 5046.01, Santa Clara County, California",0,0,0
1000000US060855046011195,060855046011195,"Block 1195, Block Group 1, Census Tract 5046.01, Santa Clara County, California",0,0,0
1000000US060855046011196,060855046011196,"Block 1196, Block Group 1, Census Tract 5046.01, Santa Clara County, California",0,0,0
1000000US060855046011197,060855046011197,"Block 1197, Block Group 1, Census Tract 5046.01, Santa Clara County, California",0,0,0
1000000US060855046011198,060855046011198,"Block 1198, Block Group 1, Census Tract 5046.01, Santa Clara County, California",0,0,0
1000000US060855046011199,060855046011199,"Block 1199, Block Group 1, Census Tract 5046.01, Santa Clara County, California",0,0,0
1000000US060855046011200,060855046011200,"Block 1200, Block Group 1, Census Tract 5046.01, Santa Clara County, California",0,0,0
1000000US060855046011201,060855046011201,"Block 1201, Block Group 1, Census Tract 5046.01, Santa Clara County, California",0,0,0
1000000US060855046011202,060855046011202,"Block 1202, Block Group 1, Census Tract 5046.01, Santa Clara County, California",0,0,0
1000000US060855046011203,060855046011203,"Block 1203, Block Group 1, Census Tract 5046.01, Santa Clara County, California",14,13,1
1000000US060855046021000,060855046021000,"Block 1000, Block Group 1, Census Tract 5046.02, Santa Clara County, California",3,2,1
1000000US060855046021001,060855046021001,"Block 1001, Block Group 1, Census Tract 5046.02, Santa Clara County, California",0,0,0
1000000US060855046021002,060855046021002,"Block 1002, Block Group 1, Census Tract 5046.02, Santa Clara County, California",0,0,0
1000000US060855046021003,060855046021003,"Block 1003, Block Group 1, Census Tract 5046.02, Santa Clara County, California",0,0,0
1000000US060855046021004,060855046021004,"Block 1004, Block Group 1, Census Tract 5046.02, Santa Clara County, California",0,0,0
1000000US060855046021005,060855046021005,"Block 1005, Block Group 1, Census Tract 5046.02, Santa Clara County, California",0,0,0
1000000US060855046021006,060855046021006,"Block 1006, Block Group 1, Census Tract 5046.02, Santa Clara County, California",0,0,0
1000000US060855046021007,060855046021007,"Block 1007, Block Group 1, Census Tract 5046.02, Santa Clara County, California",0,0,0
1000000US060855046021008,060855046021008,"Block 1008, Block Group 1, Census Tract 5046.02, Santa Clara County, California",0,0,0
1000000US060855046021009,060855046021009,"Block 1009, Block Group 1, Census Tract 5046.02, Santa Clara County, California",0,0,0
1000000US060855046021010,060855046021010,"Block 1010, Block Group 1, Census Tract 5046.02, Santa Clara County, California",0,0,0
1000000US060855046021011,060855046021011,"Block 1011, Block Group 1, Census Tract 5046.02, Santa Clara County, California",0,0,0
1000000US060855046021012,060855046021012,"Block 1012, Block Group 1, Census Tract 5046.02, Santa Clara County, California",0,0,0
1000000US060855046021013,060855046021013,"Block 1013, Block Group 1, Census Tract 5046.02, Santa Clara County, California",0,0,0
1000000US060855046021014,060855046021014,"Block 1014, Block Group 1, Census Tract 5046.02, Santa Clara County, California",0,0,0
1000000US060855046021015,060855046021015,"Block 1015, Block Group 1, Census Tract 5046.02, Santa Clara County, California",0,0,0
1000000US060855046021016,060855046021016,"Block 1016, Block Group 1, Census Tract 5046.02, Santa Clara County, California",0,0,0
1000000US060855046021017,060855046021017,"Block 1017, Block Group 1, Census Tract 5046.02, Santa Clara County, California",0,0,0
1000000US060855046021018,060855046021018,"Block 1018, Block Group 1, Census Tract 5046.02, Santa Clara County, California",0,0,0
1000000US060855046021019,060855046021019,"Block 1019, Block Group 1, Census Tract 5046.02, Santa Clara County, California",0,0,0
1000000US060855046021020,060855046021020,"Block 1020, Block Group 1, Census Tract 5046.02, Santa Clara County, California",0,0,0
1000000US060855046021021,060855046021021,"Block 1021, Block Group 1, Census Tract 5046.02, Santa Clara County, California",0,0,0
1000000US060855046021022,060855046021022,"Block 1022, Block Group 1, Census Tract 5046.02, Santa Clara County, California",0,0,0
1000000US060855046021023,060855046021023,"Block 1023, Block Group 1, Census Tract 5046.02, Santa Clara County, California",0,0,0
1000000US060855046021024,060855046021024,"Block 1024, Block Group 1, Census Tract 5046.02, Santa Clara County, California",4,4,0
1000000US060855046021025,060855046021025,"Block 1025, Block Group 1, Census Tract 5046.02, Santa Clara County, California",0,0,0
1000000US060855046021026,060855046021026,"Block 1026, Block Group 1, Census Tract 5046.02, Santa Clara County, California",8,7,1
1000000US060855046021027,060855046021027,"Block 1027, Block Group 1, Census Tract 5046.02, Santa Clara County, California",2,2,0
1000000US060855046021028,060855046021028,"Block 1028, Block Group 1, Census Tract 5046.02, Santa Clara County, California",0,0,0
1000000US060855046021029,060855046021029,"Block 1029, Block Group 1, Census Tract 5046.02, Santa Clara County, California",0,0,0
1000000US060855046021030,060855046021030,"Block 1030, Block Group 1, Census Tract 5046.02, Santa Clara County, California",0,0,0
1000000US060855046021031,060855046021031,"Block 1031, Block Group 1, Census Tract 5046.02, Santa Clara County, California",0,0,0
1000000US060855046021032,060855046021032,"Block 1032, Block Group 1, Census Tract 5046.02, Santa Clara County, California",0,0,0
1000000US060855046021033,060855046021033,"Block 1033, Block Group 1, Census Tract 5046.02, Santa Clara County, California",0,0,0
1000000US060855046021034,060855046021034,"Block 1034, Block Group 1, Census Tract 5046.02, Santa Clara County, California",0,0,0
1000000US060855046021035,060855046021035,"Block 1035, Block Group 1, Census Tract 5046.02, Santa Clara County, California",0,0,0
1000000US060855046021036,060855046021036,"Block 1036, Block Group 1, Census Tract 5046.02, Santa Clara County, California",0,0,0
1000000US060855046021037,060855046021037,"Block 1037, Block Group 1, Census Tract 5046.02, Santa Clara County, California",4,3,1
1000000US060855046021038,060855046021038,"Block 1038, Block Group 1, Census Tract 5046.02, Santa Clara County, California",9,9,0
1000000US060855046021039,060855046021039,"Block 1039, Block Group 1, Census Tract 5046.02, Santa Clara County, California",8,8,0
1000000US060855046021040,060855046021040,"Block 1040, Block Group 1, Census Tract 5046.02, Santa Clara County, California",2,2,0
1000000US060855046021041,060855046021041,"Block 1041, Block Group 1, Census Tract 5046.02, Santa Clara County, California",39,39,0
1000000US060855046021042,060855046021042,"Block 1042, Block Group 1, Census Tract 5046.02, Santa Clara County, California",45,44,1
1000000US060855046021043,060855046021043,"Block 1043, Block Group 1, Census Tract 5046.02, Santa Clara County, California",31,28,3
1000000US060855046021044,060855046021044,"Block 1044, Block Group 1, Census Tract 5046.02, Santa Clara County, California",38,37,1
1000000US060855046021045,060855046021045,"Block 1045, Block Group 1, Census Tract 5046.02, Santa Clara County, California",26,25,1
1000000US060855046021046,060855046021046,"Block 1046, Block Group 1, Census Tract 5046.02, Santa Clara County, California",0,0,0
1000000US060855046021047,060855046021047,"Block 1047, Block Group 1, Census Tract 5046.02, Santa Clara County, California",0,0,0
1000000US060855046021048,060855046021048,"Block 1048, Block Group 1, Census Tract 5046.02, Santa Clara County, California",8,8,0
1000000US060855046021049,060855046021049,"Block 1049, Block Group 1, Census Tract 5046.02, Santa Clara County, California",13,9,4
1000000US060855046021050,060855046021050,"Block 1050, Block Group 1, Census Tract 5046.02, Santa Clara County, California",54,47,7
1000000US060855046021051,060855046021051,"Block 1051, Block Group 1, Census Tract 5046.02, Santa Clara County, California",29,27,2
1000000US060855046021052,060855046021052,"Block 1052, Block Group 1, Census Tract 5046.02, Santa Clara County, California",28,27,1
1000000US060855046021053,060855046021053,"Block 1053, Block Group 1, Census Tract 5046.02, Santa Clara County, California",31,31,0
1000000US060855046021054,060855046021054,"Block 1054, Block Group 1, Census Tract 5046.02, Santa Clara County, California",2,2,0
1000000US060855046021055,060855046021055,"Block 1055, Block Group 1, Census Tract 5046.02, Santa Clara County, California",0,0,0
1000000US060855046021056,060855046021056,"Block 1056, Block Group 1, Census Tract 5046.02, Santa Clara County, California",18,15,3
1000000US060855046021057,060855046021057,"Block 1057, Block Group 1, Census Tract 5046.02, Santa Clara County, California",0,0,0
1000000US060855046021058,060855046021058,"Block 1058, Block Group 1, Census Tract 5046.02, Santa Clara County, California",34,33,1
1000000US060855046021059,060855046021059,"Block 1059, Block Group 1, Census Tract 5046.02, Santa Clara County, California",0,0,0
1000000US060855046021060,060855046021060,"Block 1060, Block Group 1, Census Tract 5046.02, Santa Clara County, California",13,13,0
1000000US060855046021061,060855046021061,"Block 1061, Block Group 1, Census Tract 5046.02, Santa Clara County, California",21,20,1
1000000US060855046021062,060855046021062,"Block 1062, Block Group 1, Census Tract 5046.02, Santa Clara County, California",14,14,0
1000000US060855046021063,060855046021063,"Block 1063, Block Group 1, Census Tract 5046.02, Santa Clara County, California",11,11,0
1000000US060855046021064,060855046021064,"Block 1064, Block Group 1, Census Tract 5046.02, Santa Clara County, California",10,7,3
1000000US060855046021065,060855046021065,"Block 1065, Block Group 1, Census Tract 5046.02, Santa Clara County, California",0,0,0
1000000US060855046021066,060855046021066,"Block 1066, Block Group 1, Census Tract 5046.02, Santa Clara County, California",88,86,2
1000000US060855046021067,060855046021067,"Block 1067, Block Group 1, Census Tract 5046.02, Santa Clara County, California",0,0,0
1000000US060855046021068,060855046021068,"Block 1068, Block Group 1, Census Tract 5046.02, Santa Clara County, California",0,0,0
1000000US060855046021069,060855046021069,"Block 1069, Block Group 1, Census Tract 5046.02, Santa Clara County, California",0,0,0
1000000US060855046021070,060855046021070,"Block 1070, Block Group 1, Census Tract 5046.02, Santa Clara County, California",0,0,0
1000000US060855046021071,060855046021071,"Block 1071, Block Group 1, Census Tract 5046.02, Santa Clara County, California",0,0,0
1000000US060855046021072,060855046021072,"Block 1072, Block Group 1, Census Tract 5046.02, Santa Clara County, California",0,0,0
1000000US060855046021073,060855046021073,"Block 1073, Block Group 1, Census Tract 5046.02, Santa Clara County, California",0,0,0
1000000US060855046021074,060855046021074,"Block 1074, Block Group 1, Census Tract 5046.02, Santa Clara County, California",0,0,0
1000000US060855046021075,060855046021075,"Block 1075, Block Group 1, Census Tract 5046.02, Santa Clara County, California",0,0,0
1000000US060855046021076,060855046021076,"Block 1076, Block Group 1, Census Tract 5046.02, Santa Clara County, California",0,0,0
1000000US060855046021077,060855046021077,"Block 1077, Block Group 1, Census Tract 5046.02, Santa Clara County, California",0,0,0
1000000US060855046021078,060855046021078,"Block 1078, Block Group 1, Census Tract 5046.02, Santa Clara County, California",0,0,0
1000000US060855046021079,060855046021079,"Block 1079, Block Group 1, Census Tract 5046.02, Santa Clara County, California",0,0,0
1000000US060855046021080,060855046021080,"Block 1080, Block Group 1, Census Tract 5046.02, Santa Clara County, California",0,0,0
1000000US060855046021081,060855046021081,"Block 1081, Block Group 1, Census Tract 5046.02, Santa Clara County, California",0,0,0
1000000US060855046021082,060855046021082,"Block 1082, Block Group 1, Census Tract 5046.02, Santa Clara County, California",0,0,0
1000000US060855046021083,060855046021083,"Block 1083, Block Group 1, Census Tract 5046.02, Santa Clara County, California",0,0,0
1000000US060855046021084,060855046021084,"Block 1084, Block Group 1, Census Tract 5046.02, Santa Clara County, California",0,0,0
1000000US060855046021085,060855046021085,"Block 1085, Block Group 1, Census Tract 5046.02, Santa Clara County, California",0,0,0
1000000US060855046021086,060855046021086,"Block 1086, Block Group 1, Census Tract 5046.02, Santa Clara County, California",0,0,0
1000000US060855046021087,060855046021087,"Block 1087, Block Group 1, Census Tract 5046.02, Santa Clara County, California",0,0,0
1000000US060855046021088,060855046021088,"Block 1088, Block Group 1, Census Tract 5046.02, Santa Clara County, California",0,0,0
1000000US060855046021089,060855046021089,"Block 1089, Block Group 1, Census Tract 5046.02, Santa Clara County, California",0,0,0
1000000US060855046021090,060855046021090,"Block 1090, Block Group 1, Census Tract 5046.02, Santa Clara County, California",0,0,0
1000000US060855046021091,060855046021091,"Block 1091, Block Group 1, Census Tract 5046.02, Santa Clara County, California",0,0,0
1000000US060855046021092,060855046021092,"Block 1092, Block Group 1, Census Tract 5046.02, Santa Clara County, California",0,0,0
1000000US060855046021093,060855046021093,"Block 1093, Block Group 1, Census Tract 5046.02, Santa Clara County, California",0,0,0
1000000US060855046021094,060855046021094,"Block 1094, Block Group 1, Census Tract 5046.02, Santa Clara County, California",0,0,0
1000000US060855046021095,060855046021095,"Block 1095, Block Group 1, Census Tract 5046.02, Santa Clara County, California",0,0,0
1000000US060855046021096,060855046021096,"Block 1096, Block Group 1, Census Tract 5046.02, Santa Clara County, California",0,0,0
1000000US060855046021097,060855046021097,"Block 1097, Block Group 1, Census Tract 5046.02, Santa Clara County, California",0,0,0
1000000US060855046021098,060855046021098,"Block 1098, Block Group 1, Census Tract 5046.02, Santa Clara County, California",0,0,0
1000000US060855046021099,060855046021099,"Block 1099, Block Group 1, Census Tract 5046.02, Santa Clara County, California",0,0,0
1000000US060855046021100,060855046021100,"Block 1100, Block Group 1, Census Tract 5046.02, Santa Clara County, California",0,0,0
1000000US060855046021101,060855046021101,"Block 1101, Block Group 1, Census Tract 5046.02, Santa Clara County, California",0,0,0
1000000US060855046021102,060855046021102,"Block 1102, Block Group 1, Census Tract 5046.02, Santa Clara County, California",0,0,0
1000000US060855046021103,060855046021103,"Block 1103, Block Group 1, Census Tract 5046.02, Santa Clara County, California",0,0,0
1000000US060855046021104,060855046021104,"Block 1104, Block Group 1, Census Tract 5046.02, Santa Clara County, California",0,0,0
1000000US060855046021105,060855046021105,"Block 1105, Block Group 1, Census Tract 5046.02, Santa Clara County, California",0,0,0
1000000US060855046021106,060855046021106,"Block 1106, Block Group 1, Census Tract 5046.02, Santa Clara County, California",0,0,0
1000000US060855046021107,060855046021107,"Block 1107, Block Group 1, Census Tract 5046.02, Santa Clara County, California",0,0,0
1000000US060855046021108,060855046021108,"Block 1108, Block Group 1, Census Tract 5046.02, Santa Clara County, California",1,1,0
1000000US060855046021109,060855046021109,"Block 1109, Block Group 1, Census Tract 5046.02, Santa Clara County, California",14,14,0
1000000US060855046021110,060855046021110,"Block 1110, Block Group 1, Census Tract 5046.02, Santa Clara County, California",0,0,0
1000000US060855046021111,060855046021111,"Block 1111, Block Group 1, Census Tract 5046.02, Santa Clara County, California",0,0,0
1000000US060855046021112,060855046021112,"Block 1112, Block Group 1, Census Tract 5046.02, Santa Clara County, California",0,0,0
1000000US060855046021113,060855046021113,"Block 1113, Block Group 1, Census Tract 5046.02, Santa Clara County, California",0,0,0
1000000US060855046021114,060855046021114,"Block 1114, Block Group 1, Census Tract 5046.02, Santa Clara County, California",0,0,0
1000000US060855046021115,060855046021115,"Block 1115, Block Group 1, Census Tract 5046.02, Santa Clara County, California",0,0,0
1000000US060855046021116,060855046021116,"Block 1116, Block Group 1, Census Tract 5046.02, Santa Clara County, California",0,0,0
1000000US060855046021117,060855046021117,"Block 1117, Block Group 1, Census Tract 5046.02, Santa Clara County, California",0,0,0
1000000US060855046021118,060855046021118,"Block 1118, Block Group 1, Census Tract 5046.02, Santa Clara County, California",0,0,0
1000000US060855046021119,060855046021119,"Block 1119, Block Group 1, Census Tract 5046.02, Santa Clara County, California",0,0,0
1000000US060855046021120,060855046021120,"Block 1120, Block Group 1, Census Tract 5046.02, Santa Clara County, California",0,0,0
1000000US060855046021121,060855046021121,"Block 1121, Block Group 1, Census Tract 5046.02, Santa Clara County, California",0,0,0
1000000US060855046021122,060855046021122,"Block 1122, Block Group 1, Census Tract 5046.02, Santa Clara County, California",0,0,0
1000000US060855046021123,060855046021123,"Block 1123, Block Group 1, Census Tract 5046.02, Santa Clara County, California",0,0,0
1000000US060855046021124,060855046021124,"Block 1124, Block Group 1, Census Tract 5046.02, Santa Clara County, California",0,0,0
1000000US060855046021125,060855046021125,"Block 1125, Block Group 1, Census Tract 5046.02, Santa Clara County, California",0,0,0
1000000US060855046021126,060855046021126,"Block 1126, Block Group 1, Census Tract 5046.02, Santa Clara County, California",0,0,0
1000000US060855046021127,060855046021127,"Block 1127, Block Group 1, Census Tract 5046.02, Santa Clara County, California",0,0,0
1000000US060855046021128,060855046021128,"Block 1128, Block Group 1, Census Tract 5046.02, Santa Clara County, California",0,0,0
1000000US060855046021129,060855046021129,"Block 1129, Block Group 1, Census Tract 5046.02, Santa Clara County, California",0,0,0
1000000US060855046021130,060855046021130,"Block 1130, Block Group 1, Census Tract 5046.02, Santa Clara County, California",0,0,0
1000000US060855046021131,060855046021131,"Block 1131, Block Group 1, Census Tract 5046.02, Santa Clara County, California",0,0,0
1000000US060855046021132,060855046021132,"Block 1132, Block Group 1, Census Tract 5046.02, Santa Clara County, California",0,0,0
1000000US060855046021133,060855046021133,"Block 1133, Block Group 1, Census Tract 5046.02, Santa Clara County, California",0,0,0
1000000US060855046021134,060855046021134,"Block 1134, Block Group 1, Census Tract 5046.02, Santa Clara County, California",0,0,0
1000000US060855046021135,060855046021135,"Block 1135, Block Group 1, Census Tract 5046.02, Santa Clara County, California",0,0,0
1000000US060855046021136,060855046021136,"Block 1136, Block Group 1, Census Tract 5046.02, Santa Clara County, California",0,0,0
1000000US060855046021137,060855046021137,"Block 1137, Block Group 1, Census Tract 5046.02, Santa Clara County, California",0,0,0
1000000US060855046021138,060855046021138,"Block 1138, Block Group 1, Census Tract 5046.02, Santa Clara County, California",0,0,0
1000000US060855046021139,060855046021139,"Block 1139, Block Group 1, Census Tract 5046.02, Santa Clara County, California",0,0,0
1000000US060855046021140,060855046021140,"Block 1140, Block Group 1, Census Tract 5046.02, Santa Clara County, California",0,0,0
1000000US060855046021141,060855046021141,"Block 1141, Block Group 1, Census Tract 5046.02, Santa Clara County, California",0,0,0
1000000US060855046021142,060855046021142,"Block 1142, Block Group 1, Census Tract 5046.02, Santa Clara County, California",0,0,0
1000000US060855046021143,060855046021143,"Block 1143, Block Group 1, Census Tract 5046.02, Santa Clara County, California",0,0,0
1000000US060855046021144,060855046021144,"Block 1144, Block Group 1, Census Tract 5046.02, Santa Clara County, California",0,0,0
1000000US060855046021145,060855046021145,"Block 1145, Block Group 1, Census Tract 5046.02, Santa Clara County, California",0,0,0
1000000US060855046021146,060855046021146,"Block 1146, Block Group 1, Census Tract 5046.02, Santa Clara County, California",0,0,0
1000000US060855046021147,060855046021147,"Block 1147, Block Group 1, Census Tract 5046.02, Santa Clara County, California",0,0,0
1000000US060855046021148,060855046021148,"Block 1148, Block Group 1, Census Tract 5046.02, Santa Clara County, California",0,0,0
1000000US060855046021149,060855046021149,"Block 1149, Block Group 1, Census Tract 5046.02, Santa Clara County, California",0,0,0
1000000US060855046021150,060855046021150,"Block 1150, Block Group 1, Census Tract 5046.02, Santa Clara County, California",0,0,0
1000000US060855046021151,060855046021151,"Block 1151, Block Group 1, Census Tract 5046.02, Santa Clara County, California",0,0,0
1000000US060855046021152,060855046021152,"Block 1152, Block Group 1, Census Tract 5046.02, Santa Clara County, California",0,0,0
1000000US060855046021153,060855046021153,"Block 1153, Block Group 1, Census Tract 5046.02, Santa Clara County, California",0,0,0
1000000US060855046021154,060855046021154,"Block 1154, Block Group 1, Census Tract 5046.02, Santa Clara County, California",0,0,0
1000000US060855046021155,060855046021155,"Block 1155, Block Group 1, Census Tract 5046.02, Santa Clara County, California",0,0,0
1000000US060855046021156,060855046021156,"Block 1156, Block Group 1, Census Tract 5046.02, Santa Clara County, California",0,0,0
1000000US060855046021157,060855046021157,"Block 1157, Block Group 1, Census Tract 5046.02, Santa Clara County, California",0,0,0
1000000US060855046021158,060855046021158,"Block 1158, Block Group 1, Census Tract 5046.02, Santa Clara County, California",0,0,0
1000000US060855046021159,060855046021159,"Block 1159, Block Group 1, Census Tract 5046.02, Santa Clara County, California",0,0,0
1000000US060855046021160,060855046021160,"Block 1160, Block Group 1, Census Tract 5046.02, Santa Clara County, California",0,0,0
1000000US060855046021161,060855046021161,"Block 1161, Block Group 1, Census Tract 5046.02, Santa Clara County, California",0,0,0
1000000US060855046021162,060855046021162,"Block 1162, Block Group 1, Census Tract 5046.02, Santa Clara County, California",0,0,0
1000000US060855046021163,060855046021163,"Block 1163, Block Group 1, Census Tract 5046.02, Santa Clara County, California",0,0,0
1000000US060855046021164,060855046021164,"Block 1164, Block Group 1, Census Tract 5046.02, Santa Clara County, California",0,0,0
1000000US060855046021165,060855046021165,"Block 1165, Block Group 1, Census Tract 5046.02, Santa Clara County, California",0,0,0
1000000US060855046021166,060855046021166,"Block 1166, Block Group 1, Census Tract 5046.02, Santa Clara County, California",0,0,0
1000000US060855046021167,060855046021167,"Block 1167, Block Group 1, Census Tract 5046.02, Santa Clara County, California",0,0,0
1000000US060855046021168,060855046021168,"Block 1168, Block Group 1, Census Tract 5046.02, Santa Clara County, California",0,0,0
1000000US060855046021169,060855046021169,"Block 1169, Block Group 1, Census Tract 5046.02, Santa Clara County, California",0,0,0
1000000US060855046021170,060855046021170,"Block 1170, Block Group 1, Census Tract 5046.02, Santa Clara County, California",0,0,0
1000000US060855046021171,060855046021171,"Block 1171, Block Group 1, Census Tract 5046.02, Santa Clara County, California",0,0,0
1000000US060855046021172,060855046021172,"Block 1172, Block Group 1, Census Tract 5046.02, Santa Clara County, California",0,0,0
1000000US060855046021173,060855046021173,"Block 1173, Block Group 1, Census Tract 5046.02, Santa Clara County, California",0,0,0
1000000US060855046021174,060855046021174,"Block 1174, Block Group 1, Census Tract 5046.02, Santa Clara County, California",0,0,0
1000000US060855046021175,060855046021175,"Block 1175, Block Group 1, Census Tract 5046.02, Santa Clara County, California",0,0,0
1000000US060855046021176,060855046021176,"Block 1176, Block Group 1, Census Tract 5046.02, Santa Clara County, California",0,0,0
1000000US060855046021177,060855046021177,"Block 1177, Block Group 1, Census Tract 5046.02, Santa Clara County, California",0,0,0
1000000US060855046021178,060855046021178,"Block 1178, Block Group 1, Census Tract 5046.02, Santa Clara County, California",0,0,0
1000000US060855046021179,060855046021179,"Block 1179, Block Group 1, Census Tract 5046.02, Santa Clara County, California",0,0,0
1000000US060855046021180,060855046021180,"Block 1180, Block Group 1, Census Tract 5046.02, Santa Clara County, California",0,0,0
1000000US060855046021181,060855046021181,"Block 1181, Block Group 1, Census Tract 5046.02, Santa Clara County, California",0,0,0
1000000US060855046021182,060855046021182,"Block 1182, Block Group 1, Census Tract 5046.02, Santa Clara County, California",0,0,0
1000000US060855046021183,060855046021183,"Block 1183, Block Group 1, Census Tract 5046.02, Santa Clara County, California",0,0,0
1000000US060855046021184,060855046021184,"Block 1184, Block Group 1, Census Tract 5046.02, Santa Clara County, California",0,0,0
1000000US060855046021185,060855046021185,"Block 1185, Block Group 1, Census Tract 5046.02, Santa Clara County, California",0,0,0
1000000US060855046021186,060855046021186,"Block 1186, Block Group 1, Census Tract 5046.02, Santa Clara County, California",0,0,0
1000000US060855046021187,060855046021187,"Block 1187, Block Group 1, Census Tract 5046.02, Santa Clara County, California",0,0,0
1000000US060855046021188,060855046021188,"Block 1188, Block Group 1, Census Tract 5046.02, Santa Clara County, California",0,0,0
1000000US060855046021189,060855046021189,"Block 1189, Block Group 1, Census Tract 5046.02, Santa Clara County, California",0,0,0
1000000US060855046021190,060855046021190,"Block 1190, Block Group 1, Census Tract 5046.02, Santa Clara County, California",0,0,0
1000000US060855046021191,060855046021191,"Block 1191, Block Group 1, Census Tract 5046.02, Santa Clara County, California",0,0,0
1000000US060855046021192,060855046021192,"Block 1192, Block Group 1, Census Tract 5046.02, Santa Clara County, California",0,0,0
1000000US060855046021193,060855046021193,"Block 1193, Block Group 1, Census Tract 5046.02, Santa Clara County, California",0,0,0
1000000US060855046021194,060855046021194,"Block 1194, Block Group 1, Census Tract 5046.02, Santa Clara County, California",0,0,0
1000000US060855046021195,060855046021195,"Block 1195, Block Group 1, Census Tract 5046.02, Santa Clara County, California",0,0,0
1000000US060855046021196,060855046021196,"Block 1196, Block Group 1, Census Tract 5046.02, Santa Clara County, California",0,0,0
1000000US060855046021197,060855046021197,"Block 1197, Block Group 1, Census Tract 5046.02, Santa Clara County, California",0,0,0
1000000US060855046021198,060855046021198,"Block 1198, Block Group 1, Census Tract 5046.02, Santa Clara County, California",0,0,0
1000000US060855046021199,060855046021199,"Block 1199, Block Group 1, Census Tract 5046.02, Santa Clara County, California",3,3,0
1000000US060855046021200,060855046021200,"Block 1200, Block Group 1, Census Tract 5046.02, Santa Clara County, California",0,0,0
1000000US060855046021201,060855046021201,"Block 1201, Block Group 1, Census Tract 5046.02, Santa Clara County, California",0,0,0
1000000US060855046021202,060855046021202,"Block 1202, Block Group 1, Census Tract 5046.02, Santa Clara County, California",0,0,0
1000000US060855046021203,060855046021203,"Block 1203, Block Group 1, Census Tract 5046.02, Santa Clara County, California",0,0,0
1000000US060855046021204,060855046021204,"Block 1204, Block Group 1, Census Tract 5046.02, Santa Clara County, California",0,0,0
1000000US060855046021205,060855046021205,"Block 1205, Block Group 1, Census Tract 5046.02, Santa Clara County, California",0,0,0
1000000US060855046021206,060855046021206,"Block 1206, Block Group 1, Census Tract 5046.02, Santa Clara County, California",0,0,0
1000000US060855046021207,060855046021207,"Block 1207, Block Group 1, Census Tract 5046.02, Santa Clara County, California",0,0,0
1000000US060855046021208,060855046021208,"Block 1208, Block Group 1, Census Tract 5046.02, Santa Clara County, California",0,0,0
1000000US060855046021209,060855046021209,"Block 1209, Block Group 1, Census Tract 5046.02, Santa Clara County, California",0,0,0
1000000US060855046021210,060855046021210,"Block 1210, Block Group 1, Census Tract 5046.02, Santa Clara County, California",11,9,2
1000000US060855046021211,060855046021211,"Block 1211, Block Group 1, Census Tract 5046.02, Santa Clara County, California",15,14,1
1000000US060855047001000,060855047001000,"Block 1000, Block Group 1, Census Tract 5047, Santa Clara County, California",0,0,0
1000000US060855047001001,060855047001001,"Block 1001, Block Group 1, Census Tract 5047, Santa Clara County, California",0,0,0
1000000US060855047001002,060855047001002,"Block 1002, Block Group 1, Census Tract 5047, Santa Clara County, California",0,0,0
1000000US060855047001003,060855047001003,"Block 1003, Block Group 1, Census Tract 5047, Santa Clara County, California",0,0,0
1000000US060855047001004,060855047001004,"Block 1004, Block Group 1, Census Tract 5047, Santa Clara County, California",0,0,0
1000000US060855047001005,060855047001005,"Block 1005, Block Group 1, Census Tract 5047, Santa Clara County, California",0,0,0
1000000US060855047001006,060855047001006,"Block 1006, Block Group 1, Census Tract 5047, Santa Clara County, California",0,0,0
1000000US060855047001007,060855047001007,"Block 1007, Block Group 1, Census Tract 5047, Santa Clara County, California",0,0,0
1000000US060855047001008,060855047001008,"Block 1008, Block Group 1, Census Tract 5047, Santa Clara County, California",0,0,0
1000000US060855047001009,060855047001009,"Block 1009, Block Group 1, Census Tract 5047, Santa Clara County, California",0,0,0
1000000US060855047001010,060855047001010,"Block 1010, Block Group 1, Census Tract 5047, Santa Clara County, California",0,0,0
1000000US060855047001011,060855047001011,"Block 1011, Block Group 1, Census Tract 5047, Santa Clara County, California",0,0,0
1000000US060855047001012,060855047001012,"Block 1012, Block Group 1, Census Tract 5047, Santa Clara County, California",0,0,0
1000000US060855047001013,060855047001013,"Block 1013, Block Group 1, Census Tract 5047, Santa Clara County, California",0,0,0
1000000US060855047001014,060855047001014,"Block 1014, Block Group 1, Census Tract 5047, Santa Clara County, California",0,0,0
1000000US060855047001015,060855047001015,"Block 1015, Block Group 1, Census Tract 5047, Santa Clara County, California",0,0,0
1000000US060855047001016,060855047001016,"Block 1016, Block Group 1, Census Tract 5047, Santa Clara County, California",0,0,0
1000000US060855047001017,060855047001017,"Block 1017, Block Group 1, Census Tract 5047, Santa Clara County, California",0,0,0
1000000US060855047001018,060855047001018,"Block 1018, Block Group 1, Census Tract 5047, Santa Clara County, California",0,0,0
1000000US060855047001019,060855047001019,"Block 1019, Block Group 1, Census Tract 5047, Santa Clara County, California",0,0,0
1000000US060855047001020,060855047001020,"Block 1020, Block Group 1, Census Tract 5047, Santa Clara County, California",0,0,0
1000000US060855047001021,060855047001021,"Block 1021, Block Group 1, Census Tract 5047, Santa Clara County, California",0,0,0
1000000US060855047001022,060855047001022,"Block 1022, Block Group 1, Census Tract 5047, Santa Clara County, California",0,0,0
1000000US060855047001023,060855047001023,"Block 1023, Block Group 1, Census Tract 5047, Santa Clara County, California",0,0,0
1000000US060855047001024,060855047001024,"Block 1024, Block Group 1, Census Tract 5047, Santa Clara County, California",0,0,0
1000000US060855047001025,060855047001025,"Block 1025, Block Group 1, Census Tract 5047, Santa Clara County, California",0,0,0
1000000US060855047001026,060855047001026,"Block 1026, Block Group 1, Census Tract 5047, Santa Clara County, California",0,0,0
1000000US060855047001027,060855047001027,"Block 1027, Block Group 1, Census Tract 5047, Santa Clara County, California",0,0,0
1000000US060855047001028,060855047001028,"Block 1028, Block Group 1, Census Tract 5047, Santa Clara County, California",0,0,0
1000000US060855047001029,060855047001029,"Block 1029, Block Group 1, Census Tract 5047, Santa Clara County, California",0,0,0
1000000US060855047001030,060855047001030,"Block 1030, Block Group 1, Census Tract 5047, Santa Clara County, California",0,0,0
1000000US060855047001031,060855047001031,"Block 1031, Block Group 1, Census Tract 5047, Santa Clara County, California",0,0,0
1000000US060855047001032,060855047001032,"Block 1032, Block Group 1, Census Tract 5047, Santa Clara County, California",0,0,0
1000000US060855047001033,060855047001033,"Block 1033, Block Group 1, Census Tract 5047, Santa Clara County, California",0,0,0
1000000US060855047001034,060855047001034,"Block 1034, Block Group 1, Census Tract 5047, Santa Clara County, California",0,0,0
1000000US060855047001035,060855047001035,"Block 1035, Block Group 1, Census Tract 5047, Santa Clara County, California",0,0,0
1000000US060855047001036,060855047001036,"Block 1036, Block Group 1, Census Tract 5047, Santa Clara County, California",0,0,0
1000000US060855047001037,060855047001037,"Block 1037, Block Group 1, Census Tract 5047, Santa Clara County, California",0,0,0
1000000US060855047001038,060855047001038,"Block 1038, Block Group 1, Census Tract 5047, Santa Clara County, California",0,0,0
1000000US060855047001039,060855047001039,"Block 1039, Block Group 1, Census Tract 5047, Santa Clara County, California",0,0,0
1000000US060855047001040,060855047001040,"Block 1040, Block Group 1, Census Tract 5047, Santa Clara County, California",0,0,0
1000000US060855047001041,060855047001041,"Block 1041, Block Group 1, Census Tract 5047, Santa Clara County, California",0,0,0
1000000US060855047001042,060855047001042,"Block 1042, Block Group 1, Census Tract 5047, Santa Clara County, California",0,0,0
1000000US060855047001043,060855047001043,"Block 1043, Block Group 1, Census Tract 5047, Santa Clara County, California",0,0,0
1000000US060855047001044,060855047001044,"Block 1044, Block Group 1, Census Tract 5047, Santa Clara County, California",0,0,0
1000000US060855047001045,060855047001045,"Block 1045, Block Group 1, Census Tract 5047, Santa Clara County, California",0,0,0
1000000US060855047001046,060855047001046,"Block 1046, Block Group 1, Census Tract 5047, Santa Clara County, California",0,0,0
1000000US060855047001047,060855047001047,"Block 1047, Block Group 1, Census Tract 5047, Santa Clara County, California",0,0,0
1000000US060855047001048,060855047001048,"Block 1048, Block Group 1, Census Tract 5047, Santa Clara County, California",0,0,0
1000000US060855047001049,060855047001049,"Block 1049, Block Group 1, Census Tract 5047, Santa Clara County, California",0,0,0
1000000US060855047001050,060855047001050,"Block 1050, Block Group 1, Census Tract 5047, Santa Clara County, California",0,0,0
1000000US060855047001051,060855047001051,"Block 1051, Block Group 1, Census Tract 5047, Santa Clara County, California",0,0,0
1000000US060855047001052,060855047001052,"Block 1052, Block Group 1, Census Tract 5047, Santa Clara County, California",0,0,0
1000000US060855047001053,060855047001053,"Block 1053, Block Group 1, Census Tract 5047, Santa Clara County, California",0,0,0
1000000US060855047001054,060855047001054,"Block 1054, Block Group 1, Census Tract 5047, Santa Clara County, California",0,0,0
1000000US060855047001055,060855047001055,"Block 1055, Block Group 1, Census Tract 5047, Santa Clara County, California",0,0,0
1000000US060855047001056,060855047001056,"Block 1056, Block Group 1, Census Tract 5047, Santa Clara County, California",0,0,0
1000000US060855047001057,060855047001057,"Block 1057, Block Group 1, Census Tract 5047, Santa Clara County, California",0,0,0
1000000US060855047001058,060855047001058,"Block 1058, Block Group 1, Census Tract 5047, Santa Clara County, California",0,0,0
1000000US060855047001059,060855047001059,"Block 1059, Block Group 1, Census Tract 5047, Santa Clara County, California",3,3,0
1000000US060855047001060,060855047001060,"Block 1060, Block Group 1, Census Tract 5047, Santa Clara County, California",50,48,2
1000000US060855047001061,060855047001061,"Block 1061, Block Group 1, Census Tract 5047, Santa Clara County, California",0,0,0
1000000US060855047001062,060855047001062,"Block 1062, Block Group 1, Census Tract 5047, Santa Clara County, California",0,0,0
1000000US060855047001063,060855047001063,"Block 1063, Block Group 1, Census Tract 5047, Santa Clara County, California",0,0,0
1000000US060855047001064,060855047001064,"Block 1064, Block Group 1, Census Tract 5047, Santa Clara County, California",0,0,0
1000000US060855047001065,060855047001065,"Block 1065, Block Group 1, Census Tract 5047, Santa Clara County, California",0,0,0
1000000US060855047001066,060855047001066,"Block 1066, Block Group 1, Census Tract 5047, Santa Clara County, California",0,0,0
1000000US060855047001067,060855047001067,"Block 1067, Block Group 1, Census Tract 5047, Santa Clara County, California",16,16,0
1000000US060855047001068,060855047001068,"Block 1068, Block Group 1, Census Tract 5047, Santa Clara County, California",20,19,1
1000000US060855047001069,060855047001069,"Block 1069, Block Group 1, Census Tract 5047, Santa Clara County, California",89,87,2
1000000US060855047001070,060855047001070,"Block 1070, Block Group 1, Census Tract 5047, Santa Clara County, California",0,0,0
1000000US060855047001071,060855047001071,"Block 1071, Block Group 1, Census Tract 5047, Santa Clara County, California",0,0,0
1000000US060855047001072,060855047001072,"Block 1072, Block Group 1, Census Tract 5047, Santa Clara County, California",0,0,0
1000000US060855047001073,060855047001073,"Block 1073, Block Group 1, Census Tract 5047, Santa Clara County, California",0,0,0
1000000US060855047001074,060855047001074,"Block 1074, Block Group 1, Census Tract 5047, Santa Clara County, California",10,9,1
1000000US060855047001075,060855047001075,"Block 1075, Block Group 1, Census Tract 5047, Santa Clara County, California",0,0,0
1000000US060855047001076,060855047001076,"Block 1076, Block Group 1, Census Tract 5047, Santa Clara County, California",0,0,0
1000000US060855047001077,060855047001077,"Block 1077, Block Group 1, Census Tract 5047, Santa Clara County, California",0,0,0
1000000US060855047001078,060855047001078,"Block 1078, Block Group 1, Census Tract 5047, Santa Clara County, California",0,0,0
1000000US060855047001079,060855047001079,"Block 1079, Block Group 1, Census Tract 5047, Santa Clara County, California",0,0,0
1000000US060855047001080,060855047001080,"Block 1080, Block Group 1, Census Tract 5047, Santa Clara County, California",0,0,0
1000000US060855047001081,060855047001081,"Block 1081, Block Group 1, Census Tract 5047, Santa Clara County, California",0,0,0
1000000US060855047001082,060855047001082,"Block 1082, Block Group 1, Census Tract 5047, Santa Clara County, California",0,0,0
1000000US060855047001083,060855047001083,"Block 1083, Block Group 1, Census Tract 5047, Santa Clara County, California",0,0,0
1000000US060855047001084,060855047001084,"Block 1084, Block Group 1, Census Tract 5047, Santa Clara County, California",0,0,0
1000000US060855047001085,060855047001085,"Block 1085, Block Group 1, Census Tract 5047, Santa Clara County, California",0,0,0
1000000US060855047001086,060855047001086,"Block 1086, Block Group 1, Census Tract 5047, Santa Clara County, California",0,0,0
1000000US060855047001087,060855047001087,"Block 1087, Block Group 1, Census Tract 5047, Santa Clara County, California",0,0,0
1000000US060855047001088,060855047001088,"Block 1088, Block Group 1, Census Tract 5047, Santa Clara County, California",0,0,0
1000000US060855047001089,060855047001089,"Block 1089, Block Group 1, Census Tract 5047, Santa Clara County, California",0,0,0
1000000US060855047001090,060855047001090,"Block 1090, Block Group 1, Census Tract 5047, Santa Clara County, California",0,0,0
1000000US060855047001091,060855047001091,"Block 1091, Block Group 1, Census Tract 5047, Santa Clara County, California",0,0,0
1000000US060855047001092,060855047001092,"Block 1092, Block Group 1, Census Tract 5047, Santa Clara County, California",0,0,0
1000000US060855047001093,060855047001093,"Block 1093, Block Group 1, Census Tract 5047, Santa Clara County, California",0,0,0
1000000US060855047001094,060855047001094,"Block 1094, Block Group 1, Census Tract 5047, Santa Clara County, California",0,0,0
1000000US060855047001095,060855047001095,"Block 1095, Block Group 1, Census Tract 5047, Santa Clara County, California",0,0,0
1000000US060855047001096,060855047001096,"Block 1096, Block Group 1, Census Tract 5047, Santa Clara County, California",0,0,0
1000000US060855047001097,060855047001097,"Block 1097, Block Group 1, Census Tract 5047, Santa Clara County, California",0,0,0
1000000US060855047001098,060855047001098,"Block 1098, Block Group 1, Census Tract 5047, Santa Clara County, California",0,0,0
1000000US060855047001099,060855047001099,"Block 1099, Block Group 1, Census Tract 5047, Santa Clara County, California",0,0,0
1000000US060855047001100,060855047001100,"Block 1100, Block Group 1, Census Tract 5047, Santa Clara County, California",0,0,0
1000000US060855047001101,060855047001101,"Block 1101, Block Group 1, Census Tract 5047, Santa Clara County, California",0,0,0
1000000US060855047001102,060855047001102,"Block 1102, Block Group 1, Census Tract 5047, Santa Clara County, California",0,0,0
1000000US060855047001103,060855047001103,"Block 1103, Block Group 1, Census Tract 5047, Santa Clara County, California",0,0,0
1000000US060855047001104,060855047001104,"Block 1104, Block Group 1, Census Tract 5047, Santa Clara County, California",0,0,0
1000000US060855047001105,060855047001105,"Block 1105, Block Group 1, Census Tract 5047, Santa Clara County, California",0,0,0
1000000US060855047001106,060855047001106,"Block 1106, Block Group 1, Census Tract 5047, Santa Clara County, California",0,0,0
1000000US060855048021000,060855048021000,"Block 1000, Block Group 1, Census Tract 5048.02, Santa Clara County, California",0,0,0
1000000US060855048021001,060855048021001,"Block 1001, Block Group 1, Census Tract 5048.02, Santa Clara County, California",0,0,0
1000000US060855048021002,060855048021002,"Block 1002, Block Group 1, Census Tract 5048.02, Santa Clara County, California",0,0,0
1000000US060855048021003,060855048021003,"Block 1003, Block Group 1, Census Tract 5048.02, Santa Clara County, California",0,0,0
1000000US060855048021004,060855048021004,"Block 1004, Block Group 1, Census Tract 5048.02, Santa Clara County, California",0,0,0
1000000US060855048021005,060855048021005,"Block 1005, Block Group 1, Census Tract 5048.02, Santa Clara County, California",0,0,0
1000000US060855048021006,060855048021006,"Block 1006, Block Group 1, Census Tract 5048.02, Santa Clara County, California",0,0,0
1000000US060855048021007,060855048021007,"Block 1007, Block Group 1, Census Tract 5048.02, Santa Clara County, California",0,0,0
1000000US060855048021008,060855048021008,"Block 1008, Block Group 1, Census Tract 5048.02, Santa Clara County, California",0,0,0
1000000US060855048021009,060855048021009,"Block 1009, Block Group 1, Census Tract 5048.02, Santa Clara County, California",0,0,0
1000000US060855048021010,060855048021010,"Block 1010, Block Group 1, Census Tract 5048.02, Santa Clara County, California",0,0,0
1000000US060855048021011,060855048021011,"Block 1011, Block Group 1, Census Tract 5048.02, Santa Clara County, California",0,0,0
1000000US060855048021012,060855048021012,"Block 1012, Block Group 1, Census Tract 5048.02, Santa Clara County, California",0,0,0
1000000US060855048021013,060855048021013,"Block 1013, Block Group 1, Census Tract 5048.02, Santa Clara County, California",0,0,0
1000000US060855048021014,060855048021014,"Block 1014, Block Group 1, Census Tract 5048.02, Santa Clara County, California",0,0,0
1000000US060855048021015,060855048021015,"Block 1015, Block Group 1, Census Tract 5048.02, Santa Clara County, California",0,0,0
1000000US060855048021016,060855048021016,"Block 1016, Block Group 1, Census Tract 5048.02, Santa Clara County, California",0,0,0
1000000US060855048021017,060855048021017,"Block 1017, Block Group 1, Census Tract 5048.02, Santa Clara County, California",0,0,0
1000000US060855048021018,060855048021018,"Block 1018, Block Group 1, Census Tract 5048.02, Santa Clara County, California",0,0,0
1000000US060855048021019,060855048021019,"Block 1019, Block Group 1, Census Tract 5048.02, Santa Clara County, California",0,0,0
1000000US060855048021020,060855048021020,"Block 1020, Block Group 1, Census Tract 5048.02, Santa Clara County, California",0,0,0
1000000US060855048021021,060855048021021,"Block 1021, Block Group 1, Census Tract 5048.02, Santa Clara County, California",0,0,0
1000000US060855048021022,060855048021022,"Block 1022, Block Group 1, Census Tract 5048.02, Santa Clara County, California",0,0,0
1000000US060855048021023,060855048021023,"Block 1023, Block Group 1, Census Tract 5048.02, Santa Clara County, California",0,0,0
1000000US060855048021024,060855048021024,"Block 1024, Block Group 1, Census Tract 5048.02, Santa Clara County, California",0,0,0
1000000US060855048021025,060855048021025,"Block 1025, Block Group 1, Census Tract 5048.02, Santa Clara County, California",0,0,0
1000000US060855048021026,060855048021026,"Block 1026, Block Group 1, Census Tract 5048.02, Santa Clara County, California",160,154,6
1000000US060855048021027,060855048021027,"Block 1027, Block Group 1, Census Tract 5048.02, Santa Clara County, California",18,15,3
1000000US060855048021028,060855048021028,"Block 1028, Block Group 1, Census Tract 5048.02, Santa Clara County, California",19,19,0
1000000US060855048021029,060855048021029,"Block 1029, Block Group 1, Census Tract 5048.02, Santa Clara County, California",17,17,0
1000000US060855048021030,060855048021030,"Block 1030, Block Group 1, Census Tract 5048.02, Santa Clara County, California",46,45,1
1000000US060855048021031,060855048021031,"Block 1031, Block Group 1, Census Tract 5048.02, Santa Clara County, California",18,18,0
1000000US060855048021032,060855048021032,"Block 1032, Block Group 1, Census Tract 5048.02, Santa Clara County, California",11,9,2
1000000US060855048021033,060855048021033,"Block 1033, Block Group 1, Census Tract 5048.02, Santa Clara County, California",0,0,0
1000000US060855048021034,060855048021034,"Block 1034, Block Group 1, Census Tract 5048.02, Santa Clara County, California",38,35,3
1000000US060855048021035,060855048021035,"Block 1035, Block Group 1, Census Tract 5048.02, Santa Clara County, California",26,26,0
1000000US060855048021036,060855048021036,"Block 1036, Block Group 1, Census Tract 5048.02, Santa Clara County, California",5,5,0
1000000US060855048021037,060855048021037,"Block 1037, Block Group 1, Census Tract 5048.02, Santa Clara County, California",17,15,2
1000000US060855048021038,060855048021038,"Block 1038, Block Group 1, Census Tract 5048.02, Santa Clara County, California",10,9,1
1000000US060855048021039,060855048021039,"Block 1039, Block Group 1, Census Tract 5048.02, Santa Clara County, California",18,17,1
1000000US060855048021040,060855048021040,"Block 1040, Block Group 1, Census Tract 5048.02, Santa Clara County, California",17,16,1
1000000US060855048021041,060855048021041,"Block 1041, Block Group 1, Census Tract 5048.02, Santa Clara County, California",19,18,1
1000000US060855048021042,060855048021042,"Block 1042, Block Group 1, Census Tract 5048.02, Santa Clara County, California",18,17,1
1000000US060855048021043,060855048021043,"Block 1043, Block Group 1, Census Tract 5048.02, Santa Clara County, California",18,18,0
1000000US060855048021044,060855048021044,"Block 1044, Block Group 1, Census Tract 5048.02, Santa Clara County, California",35,33,2
1000000US060855048021045,060855048021045,"Block 1045, Block Group 1, Census Tract 5048.02, Santa Clara County, California",0,0,0
1000000US060855048021046,060855048021046,"Block 1046, Block Group 1, Census Tract 5048.02, Santa Clara County, California",70,67,3
1000000US060855048021047,060855048021047,"Block 1047, Block Group 1, Census Tract 5048.02, Santa Clara County, California",0,0,0
1000000US060855048021048,060855048021048,"Block 1048, Block Group 1, Census Tract 5048.02, Santa Clara County, California",31,30,1
1000000US060855048021049,060855048021049,"Block 1049, Block Group 1, Census Tract 5048.02, Santa Clara County, California",0,0,0
1000000US060855048021050,060855048021050,"Block 1050, Block Group 1, Census Tract 5048.02, Santa Clara County, California",26,26,0
1000000US060855048021051,060855048021051,"Block 1051, Block Group 1, Census Tract 5048.02, Santa Clara County, California",26,24,2
1000000US060855048021052,060855048021052,"Block 1052, Block Group 1, Census Tract 5048.02, Santa Clara County, California",20,18,2
1000000US060855048022000,060855048022000,"Block 2000, Block Group 2, Census Tract 5048.02, Santa Clara County, California",48,47,1
1000000US060855048022001,060855048022001,"Block 2001, Block Group 2, Census Tract 5048.02, Santa Clara County, California",18,18,0
1000000US060855048022002,060855048022002,"Block 2002, Block Group 2, Census Tract 5048.02, Santa Clara County, California",21,20,1
1000000US060855048022003,060855048022003,"Block 2003, Block Group 2, Census Tract 5048.02, Santa Clara County, California",28,27,1
1000000US060855048022004,060855048022004,"Block 2004, Block Group 2, Census Tract 5048.02, Santa Clara County, California",17,17,0
1000000US060855048022005,060855048022005,"Block 2005, Block Group 2, Census Tract 5048.02, Santa Clara County, California",38,38,0
1000000US060855048022006,060855048022006,"Block 2006, Block Group 2, Census Tract 5048.02, Santa Clara County, California",60,60,0
1000000US060855048022007,060855048022007,"Block 2007, Block Group 2, Census Tract 5048.02, Santa Clara County, California",38,36,2
1000000US060855048022008,060855048022008,"Block 2008, Block Group 2, Census Tract 5048.02, Santa Clara County, California",50,49,1
1000000US060855048023000,060855048023000,"Block 3000, Block Group 3, Census Tract 5048.02, Santa Clara County, California",54,54,0
1000000US060855048023001,060855048023001,"Block 3001, Block Group 3, Census Tract 5048.02, Santa Clara County, California",21,21,0
1000000US060855048023002,060855048023002,"Block 3002, Block Group 3, Census Tract 5048.02, Santa Clara County, California",30,29,1
1000000US060855048023003,060855048023003,"Block 3003, Block Group 3, Census Tract 5048.02, Santa Clara County, California",25,24,1
1000000US060855048023004,060855048023004,"Block 3004, Block Group 3, Census Tract 5048.02, Santa Clara County, California",13,13,0
1000000US060855048023005,060855048023005,"Block 3005, Block Group 3, Census Tract 5048.02, Santa Clara County, California",27,26,1
1000000US060855048023006,060855048023006,"Block 3006, Block Group 3, Census Tract 5048.02, Santa Clara County, California",36,35,1
1000000US060855048023007,060855048023007,"Block 3007, Block Group 3, Census Tract 5048.02, Santa Clara County, California",42,42,0
1000000US060855048023008,060855048023008,"Block 3008, Block Group 3, Census Tract 5048.02, Santa Clara County, California",0,0,0
1000000US060855048023009,060855048023009,"Block 3009, Block Group 3, Census Tract 5048.02, Santa Clara County, California",49,49,0
1000000US060855048023010,060855048023010,"Block 3010, Block Group 3, Census Tract 5048.02, Santa Clara County, California",30,30,0
1000000US060855048023011,060855048023011,"Block 3011, Block Group 3, Census Tract 5048.02, Santa Clara County, California",8,8,0
1000000US060855048023012,060855048023012,"Block 3012, Block Group 3, Census Tract 5048.02, Santa Clara County, California",32,32,0
1000000US060855048023013,060855048023013,"Block 3013, Block Group 3, Census Tract 5048.02, Santa Clara County, California",445,425,20
1000000US060855048023014,060855048023014,"Block 3014, Block Group 3, Census Tract 5048.02, Santa Clara County, California",0,0,0
1000000US060855048023015,060855048023015,"Block 3015, Block Group 3, Census Tract 5048.02, Santa Clara County, California",0,0,0
1000000US060855048031000,060855048031000,"Block 1000, Block Group 1, Census Tract 5048.03, Santa Clara County, California",0,0,0
1000000US060855048031001,060855048031001,"Block 1001, Block Group 1, Census Tract 5048.03, Santa Clara County, California",0,0,0
1000000US060855048031002,060855048031002,"Block 1002, Block Group 1, Census Tract 5048.03, Santa Clara County, California",12,11,1
1000000US060855048031003,060855048031003,"Block 1003, Block Group 1, Census Tract 5048.03, Santa Clara County, California",0,0,0
1000000US060855048031004,060855048031004,"Block 1004, Block Group 1, Census Tract 5048.03, Santa Clara County, California",26,24,2
1000000US060855048031005,060855048031005,"Block 1005, Block Group 1, Census Tract 5048.03, Santa Clara County, California",0,0,0
1000000US060855048031006,060855048031006,"Block 1006, Block Group 1, Census Tract 5048.03, Santa Clara County, California",0,0,0
1000000US060855048031007,060855048031007,"Block 1007, Block Group 1, Census Tract 5048.03, Santa Clara County, California",0,0,0
1000000US060855048031008,060855048031008,"Block 1008, Block Group 1, Census Tract 5048.03, Santa Clara County, California",0,0,0
1000000US060855048031009,060855048031009,"Block 1009, Block Group 1, Census Tract 5048.03, Santa Clara County, California",1,1,0
1000000US060855048031010,060855048031010,"Block 1010, Block Group 1, Census Tract 5048.03, Santa Clara County, California",418,402,16
1000000US060855048031011,060855048031011,"Block 1011, Block Group 1, Census Tract 5048.03, Santa Clara County, California",23,23,0
1000000US060855048031012,060855048031012,"Block 1012, Block Group 1, Census Tract 5048.03, Santa Clara County, California",30,30,0
1000000US060855048031013,060855048031013,"Block 1013, Block Group 1, Census Tract 5048.03, Santa Clara County, California",38,38,0
1000000US060855048031014,060855048031014,"Block 1014, Block Group 1, Census Tract 5048.03, Santa Clara County, California",44,42,2
1000000US060855048031015,060855048031015,"Block 1015, Block Group 1, Census Tract 5048.03, Santa Clara County, California",39,39,0
1000000US060855048031016,060855048031016,"Block 1016, Block Group 1, Census Tract 5048.03, Santa Clara County, California",0,0,0
1000000US060855048031017,060855048031017,"Block 1017, Block Group 1, Census Tract 5048.03, Santa Clara County, California",0,0,0
1000000US060855048031018,060855048031018,"Block 1018, Block Group 1, Census Tract 5048.03, Santa Clara County, California",0,0,0
1000000US060855048031019,060855048031019,"Block 1019, Block Group 1, Census Tract 5048.03, Santa Clara County, California",0,0,0
1000000US060855048031020,060855048031020,"Block 1020, Block Group 1, Census Tract 5048.03, Santa Clara County, California",0,0,0
1000000US060855048032000,060855048032000,"Block 2000, Block Group 2, Census Tract 5048.03, Santa Clara County, California",0,0,0
1000000US060855048032001,060855048032001,"Block 2001, Block Group 2, Census Tract 5048.03, Santa Clara County, California",0,0,0
1000000US060855048032002,060855048032002,"Block 2002, Block Group 2, Census Tract 5048.03, Santa Clara County, California",0,0,0
1000000US060855048032003,060855048032003,"Block 2003, Block Group 2, Census Tract 5048.03, Santa Clara County, California",0,0,0
1000000US060855048032004,060855048032004,"Block 2004, Block Group 2, Census Tract 5048.03, Santa Clara County, California",0,0,0
1000000US060855048032005,060855048032005,"Block 2005, Block Group 2, Census Tract 5048.03, Santa Clara County, California",0,0,0
1000000US060855048032006,060855048032006,"Block 2006, Block Group 2, Census Tract 5048.03, Santa Clara County, California",0,0,0
1000000US060855048032007,060855048032007,"Block 2007, Block Group 2, Census Tract 5048.03, Santa Clara County, California",136,135,1
1000000US060855048032008,060855048032008,"Block 2008, Block Group 2, Census Tract 5048.03, Santa Clara County, California",12,12,0
1000000US060855048032009,060855048032009,"Block 2009, Block Group 2, Census Tract 5048.03, Santa Clara County, California",0,0,0
1000000US060855048032010,060855048032010,"Block 2010, Block Group 2, Census Tract 5048.03, Santa Clara County, California",217,209,8
1000000US060855048032011,060855048032011,"Block 2011, Block Group 2, Census Tract 5048.03, Santa Clara County, California",22,22,0
1000000US060855048032012,060855048032012,"Block 2012, Block Group 2, Census Tract 5048.03, Santa Clara County, California",21,21,0
1000000US060855048032013,060855048032013,"Block 2013, Block Group 2, Census Tract 5048.03, Santa Clara County, California",10,9,1
1000000US060855048032014,060855048032014,"Block 2014, Block Group 2, Census Tract 5048.03, Santa Clara County, California",68,66,2
1000000US060855048032015,060855048032015,"Block 2015, Block Group 2, Census Tract 5048.03, Santa Clara County, California",27,24,3
1000000US060855048032016,060855048032016,"Block 2016, Block Group 2, Census Tract 5048.03, Santa Clara County, California",17,17,0
1000000US060855048032017,060855048032017,"Block 2017, Block Group 2, Census Tract 5048.03, Santa Clara County, California",21,21,0
1000000US060855048032018,060855048032018,"Block 2018, Block Group 2, Census Tract 5048.03, Santa Clara County, California",14,14,0
1000000US060855048032019,060855048032019,"Block 2019, Block Group 2, Census Tract 5048.03, Santa Clara County, California",10,9,1
1000000US060855048032020,060855048032020,"Block 2020, Block Group 2, Census Tract 5048.03, Santa Clara County, California",384,369,15
1000000US060855048032021,060855048032021,"Block 2021, Block Group 2, Census Tract 5048.03, Santa Clara County, California",13,12,1
1000000US060855048032022,060855048032022,"Block 2022, Block Group 2, Census Tract 5048.03, Santa Clara County, California",13,13,0
1000000US060855048032023,060855048032023,"Block 2023, Block Group 2, Census Tract 5048.03, Santa Clara County, California",1,1,0
1000000US060855048032024,060855048032024,"Block 2024, Block Group 2, Census Tract 5048.03, Santa Clara County, California",18,17,1
1000000US060855048032025,060855048032025,"Block 2025, Block Group 2, Census Tract 5048.03, Santa Clara County, California",0,0,0
1000000US060855048032026,060855048032026,"Block 2026, Block Group 2, Census Tract 5048.03, Santa Clara County, California",16,14,2
1000000US060855048032027,060855048032027,"Block 2027, Block Group 2, Census Tract 5048.03, Santa Clara County, California",23,22,1
1000000US060855048032028,060855048032028,"Block 2028, Block Group 2, Census Tract 5048.03, Santa Clara County, California",17,16,1
1000000US060855048032029,060855048032029,"Block 2029, Block Group 2, Census Tract 5048.03, Santa Clara County, California",23,19,4
1000000US060855048032030,060855048032030,"Block 2030, Block Group 2, Census Tract 5048.03, Santa Clara County, California",103,101,2
1000000US060855048032031,060855048032031,"Block 2031, Block Group 2, Census Tract 5048.03, Santa Clara County, California",49,42,7
1000000US060855048032032,060855048032032,"Block 2032, Block Group 2, Census Tract 5048.03, Santa Clara County, California",60,58,2
1000000US060855048032033,060855048032033,"Block 2033, Block Group 2, Census Tract 5048.03, Santa Clara County, California",0,0,0
1000000US060855048032034,060855048032034,"Block 2034, Block Group 2, Census Tract 5048.03, Santa Clara County, California",0,0,0
1000000US060855048032035,060855048032035,"Block 2035, Block Group 2, Census Tract 5048.03, Santa Clara County, California",43,43,0
1000000US060855048032036,060855048032036,"Block 2036, Block Group 2, Census Tract 5048.03, Santa Clara County, California",57,56,1
1000000US060855048032037,060855048032037,"Block 2037, Block Group 2, Census Tract 5048.03, Santa Clara County, California",40,40,0
1000000US060855048032038,060855048032038,"Block 2038, Block Group 2, Census Tract 5048.03, Santa Clara County, California",22,21,1
1000000US060855048032039,060855048032039,"Block 2039, Block Group 2, Census Tract 5048.03, Santa Clara County, California",0,0,0
1000000US060855048032040,060855048032040,"Block 2040, Block Group 2, Census Tract 5048.03, Santa Clara County, California",0,0,0
1000000US060855048032041,060855048032041,"Block 2041, Block Group 2, Census Tract 5048.03, Santa Clara County, California",73,73,0
1000000US060855048032042,060855048032042,"Block 2042, Block Group 2, Census Tract 5048.03, Santa Clara County, California",12,12,0
1000000US060855048032043,060855048032043,"Block 2043, Block Group 2, Census Tract 5048.03, Santa Clara County, California",56,54,2
1000000US060855048032044,060855048032044,"Block 2044, Block Group 2, Census Tract 5048.03, Santa Clara County, California",0,0,0
1000000US060855048032045,060855048032045,"Block 2045, Block Group 2, Census Tract 5048.03, Santa Clara County, California",12,12,0
1000000US060855048032046,060855048032046,"Block 2046, Block Group 2, Census Tract 5048.03, Santa Clara County, California",0,0,0
1000000US060855048032047,060855048032047,"Block 2047, Block Group 2, Census Tract 5048.03, Santa Clara County, California",81,80,1
1000000US060855048032048,060855048032048,"Block 2048, Block Group 2, Census Tract 5048.03, Santa Clara County, California",23,23,0
1000000US060855048032049,060855048032049,"Block 2049, Block Group 2, Census Tract 5048.03, Santa Clara County, California",22,22,0
1000000US060855048032050,060855048032050,"Block 2050, Block Group 2, Census Tract 5048.03, Santa Clara County, California",0,0,0
1000000US060855048032051,060855048032051,"Block 2051, Block Group 2, Census Tract 5048.03, Santa Clara County, California",0,0,0
1000000US060855048032052,060855048032052,"Block 2052, Block Group 2, Census Tract 5048.03, Santa Clara County, California",0,0,0
1000000US060855048032053,060855048032053,"Block 2053, Block Group 2, Census Tract 5048.03, Santa Clara County, California",0,0,0
1000000US060855048032054,060855048032054,"Block 2054, Block Group 2, Census Tract 5048.03, Santa Clara County, California",20,20,0
1000000US060855048032055,060855048032055,"Block 2055, Block Group 2, Census Tract 5048.03, Santa Clara County, California",0,0,0
1000000US060855048032056,060855048032056,"Block 2056, Block Group 2, Census Tract 5048.03, Santa Clara County, California",0,0,0
1000000US060855048032057,060855048032057,"Block 2057, Block Group 2, Census Tract 5048.03, Santa Clara County, California",0,0,0
1000000US060855048032058,060855048032058,"Block 2058, Block Group 2, Census Tract 5048.03, Santa Clara County, California",47,45,2
1000000US060855048032059,060855048032059,"Block 2059, Block Group 2, Census Tract 5048.03, Santa Clara County, California",0,0,0
1000000US060855048032060,060855048032060,"Block 2060, Block Group 2, Census Tract 5048.03, Santa Clara County, California",0,0,0
1000000US060855048032061,060855048032061,"Block 2061, Block Group 2, Census Tract 5048.03, Santa Clara County, California",0,0,0
1000000US060855048032062,060855048032062,"Block 2062, Block Group 2, Census Tract 5048.03, Santa Clara County, California",48,47,1
1000000US060855048032063,060855048032063,"Block 2063, Block Group 2, Census Tract 5048.03, Santa Clara County, California",14,14,0
1000000US060855048032064,060855048032064,"Block 2064, Block Group 2, Census Tract 5048.03, Santa Clara County, California",5,5,0
1000000US060855048032065,060855048032065,"Block 2065, Block Group 2, Census Tract 5048.03, Santa Clara County, California",25,25,0
1000000US060855048032066,060855048032066,"Block 2066, Block Group 2, Census Tract 5048.03, Santa Clara County, California",0,0,0
1000000US060855048032067,060855048032067,"Block 2067, Block Group 2, Census Tract 5048.03, Santa Clara County, California",22,22,0
1000000US060855048051000,060855048051000,"Block 1000, Block Group 1, Census Tract 5048.05, Santa Clara County, California",0,0,0
1000000US060855048051001,060855048051001,"Block 1001, Block Group 1, Census Tract 5048.05, Santa Clara County, California",0,0,0
1000000US060855048051002,060855048051002,"Block 1002, Block Group 1, Census Tract 5048.05, Santa Clara County, California",0,0,0
1000000US060855048051003,060855048051003,"Block 1003, Block Group 1, Census Tract 5048.05, Santa Clara County, California",0,0,0
1000000US060855048051004,060855048051004,"Block 1004, Block Group 1, Census Tract 5048.05, Santa Clara County, California",0,0,0
1000000US060855048051005,060855048051005,"Block 1005, Block Group 1, Census Tract 5048.05, Santa Clara County, California",0,0,0
1000000US060855048051006,060855048051006,"Block 1006, Block Group 1, Census Tract 5048.05, Santa Clara County, California",0,0,0
1000000US060855048051007,060855048051007,"Block 1007, Block Group 1, Census Tract 5048.05, Santa Clara County, California",0,0,0
1000000US060855048051008,060855048051008,"Block 1008, Block Group 1, Census Tract 5048.05, Santa Clara County, California",0,0,0
1000000US060855048051009,060855048051009,"Block 1009, Block Group 1, Census Tract 5048.05, Santa Clara County, California",0,0,0
1000000US060855048051010,060855048051010,"Block 1010, Block Group 1, Census Tract 5048.05, Santa Clara County, California",0,0,0
1000000US060855048051011,060855048051011,"Block 1011, Block Group 1, Census Tract 5048.05, Santa Clara County, California",0,0,0
1000000US060855048051012,060855048051012,"Block 1012, Block Group 1, Census Tract 5048.05, Santa Clara County, California",0,0,0
1000000US060855048051013,060855048051013,"Block 1013, Block Group 1, Census Tract 5048.05, Santa Clara County, California",37,33,4
1000000US060855048051014,060855048051014,"Block 1014, Block Group 1, Census Tract 5048.05, Santa Clara County, California",22,21,1
1000000US060855048051015,060855048051015,"Block 1015, Block Group 1, Census Tract 5048.05, Santa Clara County, California",15,14,1
1000000US060855048051016,060855048051016,"Block 1016, Block Group 1, Census Tract 5048.05, Santa Clara County, California",19,17,2
1000000US060855048051017,060855048051017,"Block 1017, Block Group 1, Census Tract 5048.05, Santa Clara County, California",36,35,1
1000000US060855048051018,060855048051018,"Block 1018, Block Group 1, Census Tract 5048.05, Santa Clara County, California",81,78,3
1000000US060855048051019,060855048051019,"Block 1019, Block Group 1, Census Tract 5048.05, Santa Clara County, California",21,21,0
1000000US060855048051020,060855048051020,"Block 1020, Block Group 1, Census Tract 5048.05, Santa Clara County, California",23,23,0
1000000US060855048051021,060855048051021,"Block 1021, Block Group 1, Census Tract 5048.05, Santa Clara County, California",54,52,2
1000000US060855048051022,060855048051022,"Block 1022, Block Group 1, Census Tract 5048.05, Santa Clara County, California",26,25,1
1000000US060855048051023,060855048051023,"Block 1023, Block Group 1, Census Tract 5048.05, Santa Clara County, California",18,17,1
1000000US060855048051024,060855048051024,"Block 1024, Block Group 1, Census Tract 5048.05, Santa Clara County, California",23,23,0
1000000US060855048051025,060855048051025,"Block 1025, Block Group 1, Census Tract 5048.05, Santa Clara County, California",0,0,0
1000000US060855048051026,060855048051026,"Block 1026, Block Group 1, Census Tract 5048.05, Santa Clara County, California",0,0,0
1000000US060855048051027,060855048051027,"Block 1027, Block Group 1, Census Tract 5048.05, Santa Clara County, California",0,0,0
1000000US060855048051028,060855048051028,"Block 1028, Block Group 1, Census Tract 5048.05, Santa Clara County, California",24,24,0
1000000US060855048051029,060855048051029,"Block 1029, Block Group 1, Census Tract 5048.05, Santa Clara County, California",19,17,2
1000000US060855048051030,060855048051030,"Block 1030, Block Group 1, Census Tract 5048.05, Santa Clara County, California",1,0,1
1000000US060855048051031,060855048051031,"Block 1031, Block Group 1, Census Tract 5048.05, Santa Clara County, California",10,9,1
1000000US060855048051032,060855048051032,"Block 1032, Block Group 1, Census Tract 5048.05, Santa Clara County, California",20,20,0
1000000US060855048051033,060855048051033,"Block 1033, Block Group 1, Census Tract 5048.05, Santa Clara County, California",9,9,0
1000000US060855048051034,060855048051034,"Block 1034, Block Group 1, Census Tract 5048.05, Santa Clara County, California",36,35,1
1000000US060855048051035,060855048051035,"Block 1035, Block Group 1, Census Tract 5048.05, Santa Clara County, California",14,13,1
1000000US060855048051036,060855048051036,"Block 1036, Block Group 1, Census Tract 5048.05, Santa Clara County, California",17,17,0
1000000US060855048051037,060855048051037,"Block 1037, Block Group 1, Census Tract 5048.05, Santa Clara County, California",24,24,0
1000000US060855048051038,060855048051038,"Block 1038, Block Group 1, Census Tract 5048.05, Santa Clara County, California",6,6,0
1000000US060855048051039,060855048051039,"Block 1039, Block Group 1, Census Tract 5048.05, Santa Clara County, California",19,17,2
1000000US060855048051040,060855048051040,"Block 1040, Block Group 1, Census Tract 5048.05, Santa Clara County, California",28,28,0
1000000US060855048051041,060855048051041,"Block 1041, Block Group 1, Census Tract 5048.05, Santa Clara County, California",21,20,1
1000000US060855048051042,060855048051042,"Block 1042, Block Group 1, Census Tract 5048.05, Santa Clara County, California",186,164,22
1000000US060855048051043,060855048051043,"Block 1043, Block Group 1, Census Tract 5048.05, Santa Clara County, California",0,0,0
1000000US060855048051044,060855048051044,"Block 1044, Block Group 1, Census Tract 5048.05, Santa Clara County, California",2,2,0
1000000US060855048051045,060855048051045,"Block 1045, Block Group 1, Census Tract 5048.05, Santa Clara County, California",11,11,0
1000000US060855048051046,060855048051046,"Block 1046, Block Group 1, Census Tract 5048.05, Santa Clara County, California",2,2,0
1000000US060855048051047,060855048051047,"Block 1047, Block Group 1, Census Tract 5048.05, Santa Clara County, California",0,0,0
1000000US060855048051048,060855048051048,"Block 1048, Block Group 1, Census Tract 5048.05, Santa Clara County, California",0,0,0
1000000US060855048051049,060855048051049,"Block 1049, Block Group 1, Census Tract 5048.05, Santa Clara County, California",0,0,0
1000000US060855048051050,060855048051050,"Block 1050, Block Group 1, Census Tract 5048.05, Santa Clara County, California",32,32,0
1000000US060855048051051,060855048051051,"Block 1051, Block Group 1, Census Tract 5048.05, Santa Clara County, California",14,14,0
1000000US060855048051052,060855048051052,"Block 1052, Block Group 1, Census Tract 5048.05, Santa Clara County, California",15,14,1
1000000US060855048051053,060855048051053,"Block 1053, Block Group 1, Census Tract 5048.05, Santa Clara County, California",9,9,0
1000000US060855048051054,060855048051054,"Block 1054, Block Group 1, Census Tract 5048.05, Santa Clara County, California",0,0,0
1000000US060855048051055,060855048051055,"Block 1055, Block Group 1, Census Tract 5048.05, Santa Clara County, California",0,0,0
1000000US060855048051056,060855048051056,"Block 1056, Block Group 1, Census Tract 5048.05, Santa Clara County, California",13,13,0
1000000US060855048051057,060855048051057,"Block 1057, Block Group 1, Census Tract 5048.05, Santa Clara County, California",20,19,1
1000000US060855048051058,060855048051058,"Block 1058, Block Group 1, Census Tract 5048.05, Santa Clara County, California",55,53,2
1000000US060855048051059,060855048051059,"Block 1059, Block Group 1, Census Tract 5048.05, Santa Clara County, California",20,19,1
1000000US060855048051060,060855048051060,"Block 1060, Block Group 1, Census Tract 5048.05, Santa Clara County, California",0,0,0
1000000US060855048051061,060855048051061,"Block 1061, Block Group 1, Census Tract 5048.05, Santa Clara County, California",11,11,0
1000000US060855048051062,060855048051062,"Block 1062, Block Group 1, Census Tract 5048.05, Santa Clara County, California",14,13,1
1000000US060855048051063,060855048051063,"Block 1063, Block Group 1, Census Tract 5048.05, Santa Clara County, California",10,9,1
1000000US060855048051064,060855048051064,"Block 1064, Block Group 1, Census Tract 5048.05, Santa Clara County, California",14,14,0
1000000US060855048051065,060855048051065,"Block 1065, Block Group 1, Census Tract 5048.05, Santa Clara County, California",15,15,0
1000000US060855048051066,060855048051066,"Block 1066, Block Group 1, Census Tract 5048.05, Santa Clara County, California",10,10,0
1000000US060855048051067,060855048051067,"Block 1067, Block Group 1, Census Tract 5048.05, Santa Clara County, California",14,14,0
1000000US060855048051068,060855048051068,"Block 1068, Block Group 1, Census Tract 5048.05, Santa Clara County, California",0,0,0
1000000US060855048051069,060855048051069,"Block 1069, Block Group 1, Census Tract 5048.05, Santa Clara County, California",43,42,1
1000000US060855048051070,060855048051070,"Block 1070, Block Group 1, Census Tract 5048.05, Santa Clara County, California",13,13,0
1000000US060855048051071,060855048051071,"Block 1071, Block Group 1, Census Tract 5048.05, Santa Clara County, California",19,18,1
1000000US060855048051072,060855048051072,"Block 1072, Block Group 1, Census Tract 5048.05, Santa Clara County, California",0,0,0
1000000US060855048051073,060855048051073,"Block 1073, Block Group 1, Census Tract 5048.05, Santa Clara County, California",0,0,0
1000000US060855048051074,060855048051074,"Block 1074, Block Group 1, Census Tract 5048.05, Santa Clara County, California",24,23,1
1000000US060855048051075,060855048051075,"Block 1075, Block Group 1, Census Tract 5048.05, Santa Clara County, California",22,22,0
1000000US060855048051076,060855048051076,"Block 1076, Block Group 1, Census Tract 5048.05, Santa Clara County, California",18,18,0
1000000US060855048051077,060855048051077,"Block 1077, Block Group 1, Census Tract 5048.05, Santa Clara County, California",17,16,1
1000000US060855048051078,060855048051078,"Block 1078, Block Group 1, Census Tract 5048.05, Santa Clara County, California",0,0,0
1000000US060855048051079,060855048051079,"Block 1079, Block Group 1, Census Tract 5048.05, Santa Clara County, California",13,12,1
1000000US060855048051080,060855048051080,"Block 1080, Block Group 1, Census Tract 5048.05, Santa Clara County, California",3,3,0
1000000US060855048051081,060855048051081,"Block 1081, Block Group 1, Census Tract 5048.05, Santa Clara County, California",0,0,0
1000000US060855048051082,060855048051082,"Block 1082, Block Group 1, Census Tract 5048.05, Santa Clara County, California",0,0,0
1000000US060855048051083,060855048051083,"Block 1083, Block Group 1, Census Tract 5048.05, Santa Clara County, California",22,22,0
1000000US060855048051084,060855048051084,"Block 1084, Block Group 1, Census Tract 5048.05, Santa Clara County, California",12,11,1
1000000US060855048051085,060855048051085,"Block 1085, Block Group 1, Census Tract 5048.05, Santa Clara County, California",17,15,2
1000000US060855048051086,060855048051086,"Block 1086, Block Group 1, Census Tract 5048.05, Santa Clara County, California",19,19,0
1000000US060855048051087,060855048051087,"Block 1087, Block Group 1, Census Tract 5048.05, Santa Clara County, California",19,19,0
1000000US060855048051088,060855048051088,"Block 1088, Block Group 1, Census Tract 5048.05, Santa Clara County, California",21,21,0
1000000US060855048051089,060855048051089,"Block 1089, Block Group 1, Census Tract 5048.05, Santa Clara County, California",15,14,1
1000000US060855048051090,060855048051090,"Block 1090, Block Group 1, Census Tract 5048.05, Santa Clara County, California",37,35,2
1000000US060855048051091,060855048051091,"Block 1091, Block Group 1, Census Tract 5048.05, Santa Clara County, California",20,20,0
1000000US060855048051092,060855048051092,"Block 1092, Block Group 1, Census Tract 5048.05, Santa Clara County, California",16,15,1
1000000US060855048051093,060855048051093,"Block 1093, Block Group 1, Census Tract 5048.05, Santa Clara County, California",22,22,0
1000000US060855048052000,060855048052000,"Block 2000, Block Group 2, Census Tract 5048.05, Santa Clara County, California",0,0,0
1000000US060855048052001,060855048052001,"Block 2001, Block Group 2, Census Tract 5048.05, Santa Clara County, California",84,82,2
1000000US060855048052002,060855048052002,"Block 2002, Block Group 2, Census Tract 5048.05, Santa Clara County, California",28,28,0
1000000US060855048052003,060855048052003,"Block 2003, Block Group 2, Census Tract 5048.05, Santa Clara County, California",16,15,1
1000000US060855048052004,060855048052004,"Block 2004, Block Group 2, Census Tract 5048.05, Santa Clara County, California",16,16,0
1000000US060855048052005,060855048052005,"Block 2005, Block Group 2, Census Tract 5048.05, Santa Clara County, California",26,26,0
1000000US060855048052006,060855048052006,"Block 2006, Block Group 2, Census Tract 5048.05, Santa Clara County, California",12,11,1
1000000US060855048052007,060855048052007,"Block 2007, Block Group 2, Census Tract 5048.05, Santa Clara County, California",24,23,1
1000000US060855048052008,060855048052008,"Block 2008, Block Group 2, Census Tract 5048.05, Santa Clara County, California",17,17,0
1000000US060855048052009,060855048052009,"Block 2009, Block Group 2, Census Tract 5048.05, Santa Clara County, California",0,0,0
1000000US060855048052010,060855048052010,"Block 2010, Block Group 2, Census Tract 5048.05, Santa Clara County, California",29,27,2
1000000US060855048052011,060855048052011,"Block 2011, Block Group 2, Census Tract 5048.05, Santa Clara County, California",43,42,1
1000000US060855048052012,060855048052012,"Block 2012, Block Group 2, Census Tract 5048.05, Santa Clara County, California",13,12,1
1000000US060855048052013,060855048052013,"Block 2013, Block Group 2, Census Tract 5048.05, Santa Clara County, California",19,19,0
1000000US060855048052014,060855048052014,"Block 2014, Block Group 2, Census Tract 5048.05, Santa Clara County, California",5,5,0
1000000US060855048052015,060855048052015,"Block 2015, Block Group 2, Census Tract 5048.05, Santa Clara County, California",16,16,0
1000000US060855048052016,060855048052016,"Block 2016, Block Group 2, Census Tract 5048.05, Santa Clara County, California",17,16,1
1000000US060855048052017,060855048052017,"Block 2017, Block Group 2, Census Tract 5048.05, Santa Clara County, California",32,32,0
1000000US060855048052018,060855048052018,"Block 2018, Block Group 2, Census Tract 5048.05, Santa Clara County, California",30,30,0
1000000US060855048052019,060855048052019,"Block 2019, Block Group 2, Census Tract 5048.05, Santa Clara County, California",83,78,5
1000000US060855048052020,060855048052020,"Block 2020, Block Group 2, Census Tract 5048.05, Santa Clara County, California",20,20,0
1000000US060855048052021,060855048052021,"Block 2021, Block Group 2, Census Tract 5048.05, Santa Clara County, California",7,7,0
1000000US060855048052022,060855048052022,"Block 2022, Block Group 2, Census Tract 5048.05, Santa Clara County, California",5,5,0
1000000US060855048052023,060855048052023,"Block 2023, Block Group 2, Census Tract 5048.05, Santa Clara County, California",17,17,0
1000000US060855048052024,060855048052024,"Block 2024, Block Group 2, Census Tract 5048.05, Santa Clara County, California",107,104,3
1000000US060855048052025,060855048052025,"Block 2025, Block Group 2, Census Tract 5048.05, Santa Clara County, California",24,24,0
1000000US060855048052026,060855048052026,"Block 2026, Block Group 2, Census Tract 5048.05, Santa Clara County, California",24,24,0
1000000US060855048052027,060855048052027,"Block 2027, Block Group 2, Census Tract 5048.05, Santa Clara County, California",19,19,0
1000000US060855048052028,060855048052028,"Block 2028, Block Group 2, Census Tract 5048.05, Santa Clara County, California",20,19,1
1000000US060855048052029,060855048052029,"Block 2029, Block Group 2, Census Tract 5048.05, Santa Clara County, California",20,18,2
1000000US060855048052030,060855048052030,"Block 2030, Block Group 2, Census Tract 5048.05, Santa Clara County, California",0,0,0
1000000US060855048052031,060855048052031,"Block 2031, Block Group 2, Census Tract 5048.05, Santa Clara County, California",0,0,0
1000000US060855048052032,060855048052032,"Block 2032, Block Group 2, Census Tract 5048.05, Santa Clara County, California",20,18,2
1000000US060855048052033,060855048052033,"Block 2033, Block Group 2, Census Tract 5048.05, Santa Clara County, California",6,5,1
1000000US060855048052034,060855048052034,"Block 2034, Block Group 2, Census Tract 5048.05, Santa Clara County, California",34,32,2
1000000US060855048052035,060855048052035,"Block 2035, Block Group 2, Census Tract 5048.05, Santa Clara County, California",0,0,0
1000000US060855048052036,060855048052036,"Block 2036, Block Group 2, Census Tract 5048.05, Santa Clara County, California",0,0,0
1000000US060855048052037,060855048052037,"Block 2037, Block Group 2, Census Tract 5048.05, Santa Clara County, California",0,0,0
1000000US060855048052038,060855048052038,"Block 2038, Block Group 2, Census Tract 5048.05, Santa Clara County, California",0,0,0
1000000US060855048052039,060855048052039,"Block 2039, Block Group 2, Census Tract 5048.05, Santa Clara County, California",0,0,0
1000000US060855048052040,060855048052040,"Block 2040, Block Group 2, Census Tract 5048.05, Santa Clara County, California",14,14,0
1000000US060855048052041,060855048052041,"Block 2041, Block Group 2, Census Tract 5048.05, Santa Clara County, California",15,15,0
1000000US060855048052042,060855048052042,"Block 2042, Block Group 2, Census Tract 5048.05, Santa Clara County, California",0,0,0
1000000US060855048052043,060855048052043,"Block 2043, Block Group 2, Census Tract 5048.05, Santa Clara County, California",17,16,1
1000000US060855048052044,060855048052044,"Block 2044, Block Group 2, Census Tract 5048.05, Santa Clara County, California",0,0,0
1000000US060855048052045,060855048052045,"Block 2045, Block Group 2, Census Tract 5048.05, Santa Clara County, California",0,0,0
1000000US060855048052046,060855048052046,"Block 2046, Block Group 2, Census Tract 5048.05, Santa Clara County, California",0,0,0
1000000US060855048052047,060855048052047,"Block 2047, Block Group 2, Census Tract 5048.05, Santa Clara County, California",0,0,0
1000000US060855048052048,060855048052048,"Block 2048, Block Group 2, Census Tract 5048.05, Santa Clara County, California",14,14,0
1000000US060855048052049,060855048052049,"Block 2049, Block Group 2, Census Tract 5048.05, Santa Clara County, California",0,0,0
1000000US060855048052050,060855048052050,"Block 2050, Block Group 2, Census Tract 5048.05, Santa Clara County, California",0,0,0
1000000US060855048052051,060855048052051,"Block 2051, Block Group 2, Census Tract 5048.05, Santa Clara County, California",0,0,0
1000000US060855048061000,060855048061000,"Block 1000, Block Group 1, Census Tract 5048.06, Santa Clara County, California",0,0,0
1000000US060855048061001,060855048061001,"Block 1001, Block Group 1, Census Tract 5048.06, Santa Clara County, California",35,34,1
1000000US060855048061002,060855048061002,"Block 1002, Block Group 1, Census Tract 5048.06, Santa Clara County, California",49,49,0
1000000US060855048061003,060855048061003,"Block 1003, Block Group 1, Census Tract 5048.06, Santa Clara County, California",22,21,1
1000000US060855048061004,060855048061004,"Block 1004, Block Group 1, Census Tract 5048.06, Santa Clara County, California",0,0,0
1000000US060855048061005,060855048061005,"Block 1005, Block Group 1, Census Tract 5048.06, Santa Clara County, California",53,53,0
1000000US060855048061006,060855048061006,"Block 1006, Block Group 1, Census Tract 5048.06, Santa Clara County, California",51,50,1
1000000US060855048061007,060855048061007,"Block 1007, Block Group 1, Census Tract 5048.06, Santa Clara County, California",32,29,3
1000000US060855048061008,060855048061008,"Block 1008, Block Group 1, Census Tract 5048.06, Santa Clara County, California",50,48,2
1000000US060855048061009,060855048061009,"Block 1009, Block Group 1, Census Tract 5048.06, Santa Clara County, California",33,32,1
1000000US060855048062000,060855048062000,"Block 2000, Block Group 2, Census Tract 5048.06, Santa Clara County, California",0,0,0
1000000US060855048062001,060855048062001,"Block 2001, Block Group 2, Census Tract 5048.06, Santa Clara County, California",14,14,0
1000000US060855048062002,060855048062002,"Block 2002, Block Group 2, Census Tract 5048.06, Santa Clara County, California",35,35,0
1000000US060855048062003,060855048062003,"Block 2003, Block Group 2, Census Tract 5048.06, Santa Clara County, California",32,32,0
1000000US060855048062004,060855048062004,"Block 2004, Block Group 2, Census Tract 5048.06, Santa Clara County, California",14,14,0
1000000US060855048062005,060855048062005,"Block 2005, Block Group 2, Census Tract 5048.06, Santa Clara County, California",54,52,2
1000000US060855048062006,060855048062006,"Block 2006, Block Group 2, Census Tract 5048.06, Santa Clara County, California",28,26,2
1000000US060855048062007,060855048062007,"Block 2007, Block Group 2, Census Tract 5048.06, Santa Clara County, California",110,102,8
1000000US060855048062008,060855048062008,"Block 2008, Block Group 2, Census Tract 5048.06, Santa Clara County, California",63,63,0
1000000US060855048062009,060855048062009,"Block 2009, Block Group 2, Census Tract 5048.06, Santa Clara County, California",18,17,1
1000000US060855048062010,060855048062010,"Block 2010, Block Group 2, Census Tract 5048.06, Santa Clara County, California",25,24,1
1000000US060855048062011,060855048062011,"Block 2011, Block Group 2, Census Tract 5048.06, Santa Clara County, California",24,24,0
1000000US060855048062012,060855048062012,"Block 2012, Block Group 2, Census Tract 5048.06, Santa Clara County, California",0,0,0
1000000US060855048062013,060855048062013,"Block 2013, Block Group 2, Census Tract 5048.06, Santa Clara County, California",0,0,0
1000000US060855048062014,060855048062014,"Block 2014, Block Group 2, Census Tract 5048.06, Santa Clara County, California",0,0,0
1000000US060855048062015,060855048062015,"Block 2015, Block Group 2, Census Tract 5048.06, Santa Clara County, California",37,36,1
1000000US060855049011000,060855049011000,"Block 1000, Block Group 1, Census Tract 5049.01, Santa Clara County, California",974,904,70
1000000US060855049011001,060855049011001,"Block 1001, Block Group 1, Census Tract 5049.01, Santa Clara County, California",29,28,1
1000000US060855049011002,060855049011002,"Block 1002, Block Group 1, Census Tract 5049.01, Santa Clara County, California",264,254,10
1000000US060855049011003,060855049011003,"Block 1003, Block Group 1, Census Tract 5049.01, Santa Clara County, California",41,41,0
1000000US060855049011004,060855049011004,"Block 1004, Block Group 1, Census Tract 5049.01, Santa Clara County, California",24,24,0
1000000US060855049011005,060855049011005,"Block 1005, Block Group 1, Census Tract 5049.01, Santa Clara County, California",208,194,14
1000000US060855049011006,060855049011006,"Block 1006, Block Group 1, Census Tract 5049.01, Santa Clara County, California",25,24,1
1000000US060855049011007,060855049011007,"Block 1007, Block Group 1, Census Tract 5049.01, Santa Clara County, California",22,22,0
1000000US060855049011008,060855049011008,"Block 1008, Block Group 1, Census Tract 5049.01, Santa Clara County, California",36,36,0
1000000US060855049011009,060855049011009,"Block 1009, Block Group 1, Census Tract 5049.01, Santa Clara County, California",12,12,0
1000000US060855049011010,060855049011010,"Block 1010, Block Group 1, Census Tract 5049.01, Santa Clara County, California",25,25,0
1000000US060855049011011,060855049011011,"Block 1011, Block Group 1, Census Tract 5049.01, Santa Clara County, California",892,861,31
1000000US060855049011012,060855049011012,"Block 1012, Block Group 1, Census Tract 5049.01, Santa Clara County, California",0,0,0
1000000US060855049011013,060855049011013,"Block 1013, Block Group 1, Census Tract 5049.01, Santa Clara County, California",151,150,1
1000000US060855049011014,060855049011014,"Block 1014, Block Group 1, Census Tract 5049.01, Santa Clara County, California",0,0,0
1000000US060855049011015,060855049011015,"Block 1015, Block Group 1, Census Tract 5049.01, Santa Clara County, California",0,0,0
1000000US060855049011016,060855049011016,"Block 1016, Block Group 1, Census Tract 5049.01, Santa Clara County, California",0,0,0
1000000US060855049011017,060855049011017,"Block 1017, Block Group 1, Census Tract 5049.01, Santa Clara County, California",78,46,32
1000000US060855049011018,060855049011018,"Block 1018, Block Group 1, Census Tract 5049.01, Santa Clara County, California",15,15,0
1000000US060855049011019,060855049011019,"Block 1019, Block Group 1, Census Tract 5049.01, Santa Clara County, California",12,12,0
1000000US060855049011020,060855049011020,"Block 1020, Block Group 1, Census Tract 5049.01, Santa Clara County, California",26,26,0
1000000US060855049011021,060855049011021,"Block 1021, Block Group 1, Census Tract 5049.01, Santa Clara County, California",20,20,0
1000000US060855049011022,060855049011022,"Block 1022, Block Group 1, Census Tract 5049.01, Santa Clara County, California",12,12,0
1000000US060855049011023,060855049011023,"Block 1023, Block Group 1, Census Tract 5049.01, Santa Clara County, California",18,18,0
1000000US060855049011024,060855049011024,"Block 1024, Block Group 1, Census Tract 5049.01, Santa Clara County, California",12,12,0
1000000US060855049011025,060855049011025,"Block 1025, Block Group 1, Census Tract 5049.01, Santa Clara County, California",20,19,1
1000000US060855049011026,060855049011026,"Block 1026, Block Group 1, Census Tract 5049.01, Santa Clara County, California",13,13,0
1000000US060855049011027,060855049011027,"Block 1027, Block Group 1, Census Tract 5049.01, Santa Clara County, California",35,35,0
1000000US060855049011028,060855049011028,"Block 1028, Block Group 1, Census Tract 5049.01, Santa Clara County, California",58,57,1
1000000US060855049011029,060855049011029,"Block 1029, Block Group 1, Census Tract 5049.01, Santa Clara County, California",11,11,0
1000000US060855049011030,060855049011030,"Block 1030, Block Group 1, Census Tract 5049.01, Santa Clara County, California",8,8,0
1000000US060855049011031,060855049011031,"Block 1031, Block Group 1, Census Tract 5049.01, Santa Clara County, California",32,31,1
1000000US060855049011032,060855049011032,"Block 1032, Block Group 1, Census Tract 5049.01, Santa Clara County, California",12,12,0
1000000US060855049011033,060855049011033,"Block 1033, Block Group 1, Census Tract 5049.01, Santa Clara County, California",26,26,0
1000000US060855049011034,060855049011034,"Block 1034, Block Group 1, Census Tract 5049.01, Santa Clara County, California",20,20,0
1000000US060855049011035,060855049011035,"Block 1035, Block Group 1, Census Tract 5049.01, Santa Clara County, California",18,18,0
1000000US060855049011036,060855049011036,"Block 1036, Block Group 1, Census Tract 5049.01, Santa Clara County, California",13,12,1
1000000US060855049011037,060855049011037,"Block 1037, Block Group 1, Census Tract 5049.01, Santa Clara County, California",8,8,0
1000000US060855049011038,060855049011038,"Block 1038, Block Group 1, Census Tract 5049.01, Santa Clara County, California",72,71,1
1000000US060855049011039,060855049011039,"Block 1039, Block Group 1, Census Tract 5049.01, Santa Clara County, California",0,0,0
1000000US060855049011040,060855049011040,"Block 1040, Block Group 1, Census Tract 5049.01, Santa Clara County, California",27,26,1
1000000US060855049011041,060855049011041,"Block 1041, Block Group 1, Census Tract 5049.01, Santa Clara County, California",0,0,0
1000000US060855049011042,060855049011042,"Block 1042, Block Group 1, Census Tract 5049.01, Santa Clara County, California",0,0,0
1000000US060855049011043,060855049011043,"Block 1043, Block Group 1, Census Tract 5049.01, Santa Clara County, California",0,0,0
1000000US060855049011044,060855049011044,"Block 1044, Block Group 1, Census Tract 5049.01, Santa Clara County, California",0,0,0
1000000US060855049011045,060855049011045,"Block 1045, Block Group 1, Census Tract 5049.01, Santa Clara County, California",0,0,0
1000000US060855049011046,060855049011046,"Block 1046, Block Group 1, Census Tract 5049.01, Santa Clara County, California",0,0,0
1000000US060855049011047,060855049011047,"Block 1047, Block Group 1, Census Tract 5049.01, Santa Clara County, California",0,0,0
1000000US060855049011048,060855049011048,"Block 1048, Block Group 1, Census Tract 5049.01, Santa Clara County, California",0,0,0
1000000US060855049011049,060855049011049,"Block 1049, Block Group 1, Census Tract 5049.01, Santa Clara County, California",0,0,0
1000000US060855049011050,060855049011050,"Block 1050, Block Group 1, Census Tract 5049.01, Santa Clara County, California",0,0,0
1000000US060855049011051,060855049011051,"Block 1051, Block Group 1, Census Tract 5049.01, Santa Clara County, California",0,0,0
1000000US060855049011052,060855049011052,"Block 1052, Block Group 1, Census Tract 5049.01, Santa Clara County, California",0,0,0
1000000US060855049011053,060855049011053,"Block 1053, Block Group 1, Census Tract 5049.01, Santa Clara County, California",0,0,0
1000000US060855049011054,060855049011054,"Block 1054, Block Group 1, Census Tract 5049.01, Santa Clara County, California",0,0,0
1000000US060855049011055,060855049011055,"Block 1055, Block Group 1, Census Tract 5049.01, Santa Clara County, California",0,0,0
1000000US060855049011056,060855049011056,"Block 1056, Block Group 1, Census Tract 5049.01, Santa Clara County, California",0,0,0
1000000US060855049011057,060855049011057,"Block 1057, Block Group 1, Census Tract 5049.01, Santa Clara County, California",0,0,0
1000000US060855049011058,060855049011058,"Block 1058, Block Group 1, Census Tract 5049.01, Santa Clara County, California",0,0,0
1000000US060855049011059,060855049011059,"Block 1059, Block Group 1, Census Tract 5049.01, Santa Clara County, California",0,0,0
1000000US060855049011060,060855049011060,"Block 1060, Block Group 1, Census Tract 5049.01, Santa Clara County, California",0,0,0
1000000US060855049011061,060855049011061,"Block 1061, Block Group 1, Census Tract 5049.01, Santa Clara County, California",249,235,14
1000000US060855049011062,060855049011062,"Block 1062, Block Group 1, Census Tract 5049.01, Santa Clara County, California",105,100,5
1000000US060855049011063,060855049011063,"Block 1063, Block Group 1, Census Tract 5049.01, Santa Clara County, California",0,0,0
1000000US060855049011064,060855049011064,"Block 1064, Block Group 1, Census Tract 5049.01, Santa Clara County, California",0,0,0
1000000US060855049011065,060855049011065,"Block 1065, Block Group 1, Census Tract 5049.01, Santa Clara County, California",0,0,0
1000000US060855049011066,060855049011066,"Block 1066, Block Group 1, Census Tract 5049.01, Santa Clara County, California",94,92,2
1000000US060855049011067,060855049011067,"Block 1067, Block Group 1, Census Tract 5049.01, Santa Clara County, California",1,1,0
1000000US060855049011068,060855049011068,"Block 1068, Block Group 1, Census Tract 5049.01, Santa Clara County, California",6,6,0
1000000US060855049011069,060855049011069,"Block 1069, Block Group 1, Census Tract 5049.01, Santa Clara County, California",0,0,0
1000000US060855049011070,060855049011070,"Block 1070, Block Group 1, Census Tract 5049.01, Santa Clara County, California",0,0,0
1000000US060855049011071,060855049011071,"Block 1071, Block Group 1, Census Tract 5049.01, Santa Clara County, California",0,0,0
1000000US060855049011072,060855049011072,"Block 1072, Block Group 1, Census Tract 5049.01, Santa Clara County, California",0,0,0
1000000US060855049011073,060855049011073,"Block 1073, Block Group 1, Census Tract 5049.01, Santa Clara County, California",0,0,0
1000000US060855049011074,060855049011074,"Block 1074, Block Group 1, Census Tract 5049.01, Santa Clara County, California",0,0,0
1000000US060855049011075,060855049011075,"Block 1075, Block Group 1, Census Tract 5049.01, Santa Clara County, California",0,0,0
1000000US060855049011076,060855049011076,"Block 1076, Block Group 1, Census Tract 5049.01, Santa Clara County, California",0,0,0
1000000US060855049011077,060855049011077,"Block 1077, Block Group 1, Census Tract 5049.01, Santa Clara County, California",430,403,27
1000000US060855049011078,060855049011078,"Block 1078, Block Group 1, Census Tract 5049.01, Santa Clara County, California",0,0,0
1000000US060855049011079,060855049011079,"Block 1079, Block Group 1, Census Tract 5049.01, Santa Clara County, California",1,1,0
1000000US060855049011080,060855049011080,"Block 1080, Block Group 1, Census Tract 5049.01, Santa Clara County, California",21,21,0
1000000US060855050011000,060855050011000,"Block 1000, Block Group 1, Census Tract 5050.01, Santa Clara County, California",0,0,0
1000000US060855050011001,060855050011001,"Block 1001, Block Group 1, Census Tract 5050.01, Santa Clara County, California",0,0,0
1000000US060855050011002,060855050011002,"Block 1002, Block Group 1, Census Tract 5050.01, Santa Clara County, California",0,0,0
1000000US060855050011003,060855050011003,"Block 1003, Block Group 1, Census Tract 5050.01, Santa Clara County, California",0,0,0
1000000US060855050011004,060855050011004,"Block 1004, Block Group 1, Census Tract 5050.01, Santa Clara County, California",0,0,0
1000000US060855050011005,060855050011005,"Block 1005, Block Group 1, Census Tract 5050.01, Santa Clara County, California",0,0,0
1000000US060855050011006,060855050011006,"Block 1006, Block Group 1, Census Tract 5050.01, Santa Clara County, California",0,0,0
1000000US060855050011007,060855050011007,"Block 1007, Block Group 1, Census Tract 5050.01, Santa Clara County, California",0,0,0
1000000US060855050011008,060855050011008,"Block 1008, Block Group 1, Census Tract 5050.01, Santa Clara County, California",0,0,0
1000000US060855050011009,060855050011009,"Block 1009, Block Group 1, Census Tract 5050.01, Santa Clara County, California",0,0,0
1000000US060855050011010,060855050011010,"Block 1010, Block Group 1, Census Tract 5050.01, Santa Clara County, California",0,0,0
1000000US060855050011011,060855050011011,"Block 1011, Block Group 1, Census Tract 5050.01, Santa Clara County, California",0,0,0
1000000US060855050011012,060855050011012,"Block 1012, Block Group 1, Census Tract 5050.01, Santa Clara County, California",0,0,0
1000000US060855050011013,060855050011013,"Block 1013, Block Group 1, Census Tract 5050.01, Santa Clara County, California",0,0,0
1000000US060855050011014,060855050011014,"Block 1014, Block Group 1, Census Tract 5050.01, Santa Clara County, California",0,0,0
1000000US060855050011015,060855050011015,"Block 1015, Block Group 1, Census Tract 5050.01, Santa Clara County, California",0,0,0
1000000US060855050011016,060855050011016,"Block 1016, Block Group 1, Census Tract 5050.01, Santa Clara County, California",0,0,0
1000000US060855050011017,060855050011017,"Block 1017, Block Group 1, Census Tract 5050.01, Santa Clara County, California",0,0,0
1000000US060855050011018,060855050011018,"Block 1018, Block Group 1, Census Tract 5050.01, Santa Clara County, California",0,0,0
1000000US060855050011019,060855050011019,"Block 1019, Block Group 1, Census Tract 5050.01, Santa Clara County, California",0,0,0
1000000US060855050011020,060855050011020,"Block 1020, Block Group 1, Census Tract 5050.01, Santa Clara County, California",0,0,0
1000000US060855050011021,060855050011021,"Block 1021, Block Group 1, Census Tract 5050.01, Santa Clara County, California",0,0,0
1000000US060855050011022,060855050011022,"Block 1022, Block Group 1, Census Tract 5050.01, Santa Clara County, California",0,0,0
1000000US060855050011023,060855050011023,"Block 1023, Block Group 1, Census Tract 5050.01, Santa Clara County, California",0,0,0
1000000US060855050011024,060855050011024,"Block 1024, Block Group 1, Census Tract 5050.01, Santa Clara County, California",0,0,0
1000000US060855050011025,060855050011025,"Block 1025, Block Group 1, Census Tract 5050.01, Santa Clara County, California",0,0,0
1000000US060855050011026,060855050011026,"Block 1026, Block Group 1, Census Tract 5050.01, Santa Clara County, California",0,0,0
1000000US060855050011027,060855050011027,"Block 1027, Block Group 1, Census Tract 5050.01, Santa Clara County, California",0,0,0
1000000US060855050011028,060855050011028,"Block 1028, Block Group 1, Census Tract 5050.01, Santa Clara County, California",0,0,0
1000000US060855050011029,060855050011029,"Block 1029, Block Group 1, Census Tract 5050.01, Santa Clara County, California",0,0,0
1000000US060855050011030,060855050011030,"Block 1030, Block Group 1, Census Tract 5050.01, Santa Clara County, California",0,0,0
1000000US060855050011031,060855050011031,"Block 1031, Block Group 1, Census Tract 5050.01, Santa Clara County, California",0,0,0
1000000US060855050011032,060855050011032,"Block 1032, Block Group 1, Census Tract 5050.01, Santa Clara County, California",0,0,0
1000000US060855050011033,060855050011033,"Block 1033, Block Group 1, Census Tract 5050.01, Santa Clara County, California",0,0,0
1000000US060855050011034,060855050011034,"Block 1034, Block Group 1, Census Tract 5050.01, Santa Clara County, California",0,0,0
1000000US060855050011035,060855050011035,"Block 1035, Block Group 1, Census Tract 5050.01, Santa Clara County, California",0,0,0
1000000US060855050011036,060855050011036,"Block 1036, Block Group 1, Census Tract 5050.01, Santa Clara County, California",0,0,0
1000000US060855050011037,060855050011037,"Block 1037, Block Group 1, Census Tract 5050.01, Santa Clara County, California",0,0,0
1000000US060855050011038,060855050011038,"Block 1038, Block Group 1, Census Tract 5050.01, Santa Clara County, California",0,0,0
1000000US060855050011039,060855050011039,"Block 1039, Block Group 1, Census Tract 5050.01, Santa Clara County, California",0,0,0
1000000US060855050011040,060855050011040,"Block 1040, Block Group 1, Census Tract 5050.01, Santa Clara County, California",0,0,0
1000000US060855050011041,060855050011041,"Block 1041, Block Group 1, Census Tract 5050.01, Santa Clara County, California",0,0,0
1000000US060855050011042,060855050011042,"Block 1042, Block Group 1, Census Tract 5050.01, Santa Clara County, California",0,0,0
1000000US060855050011043,060855050011043,"Block 1043, Block Group 1, Census Tract 5050.01, Santa Clara County, California",0,0,0
1000000US060855050011044,060855050011044,"Block 1044, Block Group 1, Census Tract 5050.01, Santa Clara County, California",0,0,0
1000000US060855050011045,060855050011045,"Block 1045, Block Group 1, Census Tract 5050.01, Santa Clara County, California",0,0,0
1000000US060855050011046,060855050011046,"Block 1046, Block Group 1, Census Tract 5050.01, Santa Clara County, California",0,0,0
1000000US060855050011047,060855050011047,"Block 1047, Block Group 1, Census Tract 5050.01, Santa Clara County, California",0,0,0
1000000US060855050011048,060855050011048,"Block 1048, Block Group 1, Census Tract 5050.01, Santa Clara County, California",0,0,0
1000000US060855050011049,060855050011049,"Block 1049, Block Group 1, Census Tract 5050.01, Santa Clara County, California",0,0,0
1000000US060855050011050,060855050011050,"Block 1050, Block Group 1, Census Tract 5050.01, Santa Clara County, California",0,0,0
1000000US060855050011051,060855050011051,"Block 1051, Block Group 1, Census Tract 5050.01, Santa Clara County, California",57,55,2
1000000US060855050011052,060855050011052,"Block 1052, Block Group 1, Census Tract 5050.01, Santa Clara County, California",0,0,0
1000000US060855050011053,060855050011053,"Block 1053, Block Group 1, Census Tract 5050.01, Santa Clara County, California",0,0,0
1000000US060855050011054,060855050011054,"Block 1054, Block Group 1, Census Tract 5050.01, Santa Clara County, California",0,0,0
1000000US060855050011055,060855050011055,"Block 1055, Block Group 1, Census Tract 5050.01, Santa Clara County, California",0,0,0
1000000US060855050011056,060855050011056,"Block 1056, Block Group 1, Census Tract 5050.01, Santa Clara County, California",76,74,2
1000000US060855050011057,060855050011057,"Block 1057, Block Group 1, Census Tract 5050.01, Santa Clara County, California",24,23,1
1000000US060855050011058,060855050011058,"Block 1058, Block Group 1, Census Tract 5050.01, Santa Clara County, California",158,153,5
1000000US060855050011059,060855050011059,"Block 1059, Block Group 1, Census Tract 5050.01, Santa Clara County, California",40,39,1
1000000US060855050011060,060855050011060,"Block 1060, Block Group 1, Census Tract 5050.01, Santa Clara County, California",52,52,0
1000000US060855050011061,060855050011061,"Block 1061, Block Group 1, Census Tract 5050.01, Santa Clara County, California",19,18,1
1000000US060855050011062,060855050011062,"Block 1062, Block Group 1, Census Tract 5050.01, Santa Clara County, California",20,20,0
1000000US060855050011063,060855050011063,"Block 1063, Block Group 1, Census Tract 5050.01, Santa Clara County, California",30,30,0
1000000US060855050011064,060855050011064,"Block 1064, Block Group 1, Census Tract 5050.01, Santa Clara County, California",0,0,0
1000000US060855050011065,060855050011065,"Block 1065, Block Group 1, Census Tract 5050.01, Santa Clara County, California",0,0,0
1000000US060855050011066,060855050011066,"Block 1066, Block Group 1, Census Tract 5050.01, Santa Clara County, California",0,0,0
1000000US060855050011067,060855050011067,"Block 1067, Block Group 1, Census Tract 5050.01, Santa Clara County, California",0,0,0
1000000US060855050011068,060855050011068,"Block 1068, Block Group 1, Census Tract 5050.01, Santa Clara County, California",0,0,0
1000000US060855050011069,060855050011069,"Block 1069, Block Group 1, Census Tract 5050.01, Santa Clara County, California",0,0,0
1000000US060855050011070,060855050011070,"Block 1070, Block Group 1, Census Tract 5050.01, Santa Clara County, California",1,1,0
1000000US060855050011071,060855050011071,"Block 1071, Block Group 1, Census Tract 5050.01, Santa Clara County, California",0,0,0
1000000US060855050011072,060855050011072,"Block 1072, Block Group 1, Census Tract 5050.01, Santa Clara County, California",0,0,0
1000000US060855050011073,060855050011073,"Block 1073, Block Group 1, Census Tract 5050.01, Santa Clara County, California",0,0,0
1000000US060855050011074,060855050011074,"Block 1074, Block Group 1, Census Tract 5050.01, Santa Clara County, California",0,0,0
1000000US060855050011075,060855050011075,"Block 1075, Block Group 1, Census Tract 5050.01, Santa Clara County, California",0,0,0
1000000US060855050011076,060855050011076,"Block 1076, Block Group 1, Census Tract 5050.01, Santa Clara County, California",0,0,0
1000000US060855050011077,060855050011077,"Block 1077, Block Group 1, Census Tract 5050.01, Santa Clara County, California",0,0,0
1000000US060855050011078,060855050011078,"Block 1078, Block Group 1, Census Tract 5050.01, Santa Clara County, California",0,0,0
1000000US060855050011079,060855050011079,"Block 1079, Block Group 1, Census Tract 5050.01, Santa Clara County, California",0,0,0
1000000US060855050011080,060855050011080,"Block 1080, Block Group 1, Census Tract 5050.01, Santa Clara County, California",0,0,0
1000000US060855050011081,060855050011081,"Block 1081, Block Group 1, Census Tract 5050.01, Santa Clara County, California",0,0,0
1000000US060855050011082,060855050011082,"Block 1082, Block Group 1, Census Tract 5050.01, Santa Clara County, California",0,0,0
1000000US060855050011083,060855050011083,"Block 1083, Block Group 1, Census Tract 5050.01, Santa Clara County, California",0,0,0
1000000US060855050011084,060855050011084,"Block 1084, Block Group 1, Census Tract 5050.01, Santa Clara County, California",0,0,0
1000000US060855050011085,060855050011085,"Block 1085, Block Group 1, Census Tract 5050.01, Santa Clara County, California",0,0,0
1000000US060855050011086,060855050011086,"Block 1086, Block Group 1, Census Tract 5050.01, Santa Clara County, California",0,0,0
1000000US060855050011087,060855050011087,"Block 1087, Block Group 1, Census Tract 5050.01, Santa Clara County, California",0,0,0
1000000US060855050011088,060855050011088,"Block 1088, Block Group 1, Census Tract 5050.01, Santa Clara County, California",0,0,0
1000000US060855050011089,060855050011089,"Block 1089, Block Group 1, Census Tract 5050.01, Santa Clara County, California",0,0,0
1000000US060855050011090,060855050011090,"Block 1090, Block Group 1, Census Tract 5050.01, Santa Clara County, California",0,0,0
1000000US060855050011091,060855050011091,"Block 1091, Block Group 1, Census Tract 5050.01, Santa Clara County, California",0,0,0
1000000US060855050011092,060855050011092,"Block 1092, Block Group 1, Census Tract 5050.01, Santa Clara County, California",0,0,0
1000000US060855050011093,060855050011093,"Block 1093, Block Group 1, Census Tract 5050.01, Santa Clara County, California",0,0,0
1000000US060855050011094,060855050011094,"Block 1094, Block Group 1, Census Tract 5050.01, Santa Clara County, California",0,0,0
1000000US060855050011095,060855050011095,"Block 1095, Block Group 1, Census Tract 5050.01, Santa Clara County, California",0,0,0
1000000US060855050011096,060855050011096,"Block 1096, Block Group 1, Census Tract 5050.01, Santa Clara County, California",0,0,0
1000000US060855050011097,060855050011097,"Block 1097, Block Group 1, Census Tract 5050.01, Santa Clara County, California",0,0,0
1000000US060855050011098,060855050011098,"Block 1098, Block Group 1, Census Tract 5050.01, Santa Clara County, California",0,0,0
1000000US060855050011099,060855050011099,"Block 1099, Block Group 1, Census Tract 5050.01, Santa Clara County, California",0,0,0
1000000US060855050011100,060855050011100,"Block 1100, Block Group 1, Census Tract 5050.01, Santa Clara County, California",0,0,0
1000000US060855050011101,060855050011101,"Block 1101, Block Group 1, Census Tract 5050.01, Santa Clara County, California",0,0,0
1000000US060855050011102,060855050011102,"Block 1102, Block Group 1, Census Tract 5050.01, Santa Clara County, California",0,0,0
1000000US060855050011103,060855050011103,"Block 1103, Block Group 1, Census Tract 5050.01, Santa Clara County, California",0,0,0
1000000US060855050011104,060855050011104,"Block 1104, Block Group 1, Census Tract 5050.01, Santa Clara County, California",0,0,0
1000000US060855050011105,060855050011105,"Block 1105, Block Group 1, Census Tract 5050.01, Santa Clara County, California",0,0,0
1000000US060855050011106,060855050011106,"Block 1106, Block Group 1, Census Tract 5050.01, Santa Clara County, California",0,0,0
1000000US060855050011107,060855050011107,"Block 1107, Block Group 1, Census Tract 5050.01, Santa Clara County, California",0,0,0
1000000US060855050011108,060855050011108,"Block 1108, Block Group 1, Census Tract 5050.01, Santa Clara County, California",0,0,0
1000000US060855050011109,060855050011109,"Block 1109, Block Group 1, Census Tract 5050.01, Santa Clara County, California",0,0,0
1000000US060855050011110,060855050011110,"Block 1110, Block Group 1, Census Tract 5050.01, Santa Clara County, California",0,0,0
1000000US060855050011111,060855050011111,"Block 1111, Block Group 1, Census Tract 5050.01, Santa Clara County, California",0,0,0
1000000US060855050011112,060855050011112,"Block 1112, Block Group 1, Census Tract 5050.01, Santa Clara County, California",0,0,0
1000000US060855050011113,060855050011113,"Block 1113, Block Group 1, Census Tract 5050.01, Santa Clara County, California",0,0,0
1000000US060855050011114,060855050011114,"Block 1114, Block Group 1, Census Tract 5050.01, Santa Clara County, California",0,0,0
1000000US060855050011115,060855050011115,"Block 1115, Block Group 1, Census Tract 5050.01, Santa Clara County, California",0,0,0
1000000US060855050011116,060855050011116,"Block 1116, Block Group 1, Census Tract 5050.01, Santa Clara County, California",0,0,0
1000000US060855050011117,060855050011117,"Block 1117, Block Group 1, Census Tract 5050.01, Santa Clara County, California",0,0,0
1000000US060855050011118,060855050011118,"Block 1118, Block Group 1, Census Tract 5050.01, Santa Clara County, California",0,0,0
1000000US060855050011119,060855050011119,"Block 1119, Block Group 1, Census Tract 5050.01, Santa Clara County, California",0,0,0
1000000US060855050011120,060855050011120,"Block 1120, Block Group 1, Census Tract 5050.01, Santa Clara County, California",0,0,0
1000000US060855050011121,060855050011121,"Block 1121, Block Group 1, Census Tract 5050.01, Santa Clara County, California",0,0,0
1000000US060855050011122,060855050011122,"Block 1122, Block Group 1, Census Tract 5050.01, Santa Clara County, California",0,0,0
1000000US060855050011123,060855050011123,"Block 1123, Block Group 1, Census Tract 5050.01, Santa Clara County, California",0,0,0
1000000US060855050011124,060855050011124,"Block 1124, Block Group 1, Census Tract 5050.01, Santa Clara County, California",0,0,0
1000000US060855050011125,060855050011125,"Block 1125, Block Group 1, Census Tract 5050.01, Santa Clara County, California",0,0,0
1000000US060855050011126,060855050011126,"Block 1126, Block Group 1, Census Tract 5050.01, Santa Clara County, California",0,0,0
1000000US060855050011127,060855050011127,"Block 1127, Block Group 1, Census Tract 5050.01, Santa Clara County, California",0,0,0
1000000US060855050011128,060855050011128,"Block 1128, Block Group 1, Census Tract 5050.01, Santa Clara County, California",0,0,0
1000000US060855050011129,060855050011129,"Block 1129, Block Group 1, Census Tract 5050.01, Santa Clara County, California",0,0,0
1000000US060855050011130,060855050011130,"Block 1130, Block Group 1, Census Tract 5050.01, Santa Clara County, California",0,0,0
1000000US060855050011131,060855050011131,"Block 1131, Block Group 1, Census Tract 5050.01, Santa Clara County, California",0,0,0
1000000US060855050011132,060855050011132,"Block 1132, Block Group 1, Census Tract 5050.01, Santa Clara County, California",0,0,0
1000000US060855050011133,060855050011133,"Block 1133, Block Group 1, Census Tract 5050.01, Santa Clara County, California",0,0,0
1000000US060855050011134,060855050011134,"Block 1134, Block Group 1, Census Tract 5050.01, Santa Clara County, California",0,0,0
1000000US060855050011135,060855050011135,"Block 1135, Block Group 1, Census Tract 5050.01, Santa Clara County, California",12,12,0
1000000US060855050011136,060855050011136,"Block 1136, Block Group 1, Census Tract 5050.01, Santa Clara County, California",77,76,1
1000000US060855050011137,060855050011137,"Block 1137, Block Group 1, Census Tract 5050.01, Santa Clara County, California",31,31,0
1000000US060855050011138,060855050011138,"Block 1138, Block Group 1, Census Tract 5050.01, Santa Clara County, California",86,84,2
1000000US060855050011139,060855050011139,"Block 1139, Block Group 1, Census Tract 5050.01, Santa Clara County, California",44,41,3
1000000US060855050011140,060855050011140,"Block 1140, Block Group 1, Census Tract 5050.01, Santa Clara County, California",18,17,1
1000000US060855050011141,060855050011141,"Block 1141, Block Group 1, Census Tract 5050.01, Santa Clara County, California",17,17,0
1000000US060855050011142,060855050011142,"Block 1142, Block Group 1, Census Tract 5050.01, Santa Clara County, California",23,22,1
1000000US060855050011143,060855050011143,"Block 1143, Block Group 1, Census Tract 5050.01, Santa Clara County, California",70,66,4
1000000US060855050011144,060855050011144,"Block 1144, Block Group 1, Census Tract 5050.01, Santa Clara County, California",0,0,0
1000000US060855050011145,060855050011145,"Block 1145, Block Group 1, Census Tract 5050.01, Santa Clara County, California",15,13,2
1000000US060855050011146,060855050011146,"Block 1146, Block Group 1, Census Tract 5050.01, Santa Clara County, California",28,25,3
1000000US060855050011147,060855050011147,"Block 1147, Block Group 1, Census Tract 5050.01, Santa Clara County, California",18,17,1
1000000US060855050011148,060855050011148,"Block 1148, Block Group 1, Census Tract 5050.01, Santa Clara County, California",42,41,1
1000000US060855050011149,060855050011149,"Block 1149, Block Group 1, Census Tract 5050.01, Santa Clara County, California",0,0,0
1000000US060855050011150,060855050011150,"Block 1150, Block Group 1, Census Tract 5050.01, Santa Clara County, California",145,139,6
1000000US060855050011151,060855050011151,"Block 1151, Block Group 1, Census Tract 5050.01, Santa Clara County, California",0,0,0
1000000US060855050011152,060855050011152,"Block 1152, Block Group 1, Census Tract 5050.01, Santa Clara County, California",0,0,0
1000000US060855050011153,060855050011153,"Block 1153, Block Group 1, Census Tract 5050.01, Santa Clara County, California",0,0,0
1000000US060855050011154,060855050011154,"Block 1154, Block Group 1, Census Tract 5050.01, Santa Clara County, California",0,0,0
1000000US060855050011155,060855050011155,"Block 1155, Block Group 1, Census Tract 5050.01, Santa Clara County, California",0,0,0
1000000US060855050011156,060855050011156,"Block 1156, Block Group 1, Census Tract 5050.01, Santa Clara County, California",0,0,0
1000000US060855050011157,060855050011157,"Block 1157, Block Group 1, Census Tract 5050.01, Santa Clara County, California",0,0,0
1000000US060855050011158,060855050011158,"Block 1158, Block Group 1, Census Tract 5050.01, Santa Clara County, California",0,0,0
1000000US060855050011159,060855050011159,"Block 1159, Block Group 1, Census Tract 5050.01, Santa Clara County, California",0,0,0
1000000US060855050011160,060855050011160,"Block 1160, Block Group 1, Census Tract 5050.01, Santa Clara County, California",0,0,0
1000000US060855050011161,060855050011161,"Block 1161, Block Group 1, Census Tract 5050.01, Santa Clara County, California",0,0,0
1000000US060855050012000,060855050012000,"Block 2000, Block Group 2, Census Tract 5050.01, Santa Clara County, California",0,0,0
1000000US060855050012001,060855050012001,"Block 2001, Block Group 2, Census Tract 5050.01, Santa Clara County, California",148,137,11
1000000US060855050012002,060855050012002,"Block 2002, Block Group 2, Census Tract 5050.01, Santa Clara County, California",38,38,0
1000000US060855050012003,060855050012003,"Block 2003, Block Group 2, Census Tract 5050.01, Santa Clara County, California",295,279,16
1000000US060855050012004,060855050012004,"Block 2004, Block Group 2, Census Tract 5050.01, Santa Clara County, California",43,42,1
1000000US060855050012005,060855050012005,"Block 2005, Block Group 2, Census Tract 5050.01, Santa Clara County, California",23,23,0
1000000US060855050012006,060855050012006,"Block 2006, Block Group 2, Census Tract 5050.01, Santa Clara County, California",0,0,0
1000000US060855050012007,060855050012007,"Block 2007, Block Group 2, Census Tract 5050.01, Santa Clara County, California",0,0,0
1000000US060855050012008,060855050012008,"Block 2008, Block Group 2, Census Tract 5050.01, Santa Clara County, California",230,212,18
1000000US060855050012009,060855050012009,"Block 2009, Block Group 2, Census Tract 5050.01, Santa Clara County, California",33,31,2
1000000US060855050012010,060855050012010,"Block 2010, Block Group 2, Census Tract 5050.01, Santa Clara County, California",24,24,0
1000000US060855050012011,060855050012011,"Block 2011, Block Group 2, Census Tract 5050.01, Santa Clara County, California",0,0,0
1000000US060855050012012,060855050012012,"Block 2012, Block Group 2, Census Tract 5050.01, Santa Clara County, California",49,47,2
1000000US060855050012013,060855050012013,"Block 2013, Block Group 2, Census Tract 5050.01, Santa Clara County, California",27,26,1
1000000US060855050012014,060855050012014,"Block 2014, Block Group 2, Census Tract 5050.01, Santa Clara County, California",0,0,0
1000000US060855050012015,060855050012015,"Block 2015, Block Group 2, Census Tract 5050.01, Santa Clara County, California",0,0,0
1000000US060855050012016,060855050012016,"Block 2016, Block Group 2, Census Tract 5050.01, Santa Clara County, California",52,51,1
1000000US060855050013000,060855050013000,"Block 3000, Block Group 3, Census Tract 5050.01, Santa Clara County, California",0,0,0
1000000US060855050013001,060855050013001,"Block 3001, Block Group 3, Census Tract 5050.01, Santa Clara County, California",197,190,7
1000000US060855050013002,060855050013002,"Block 3002, Block Group 3, Census Tract 5050.01, Santa Clara County, California",0,0,0
1000000US060855050013003,060855050013003,"Block 3003, Block Group 3, Census Tract 5050.01, Santa Clara County, California",0,0,0
1000000US060855050013004,060855050013004,"Block 3004, Block Group 3, Census Tract 5050.01, Santa Clara County, California",91,90,1
1000000US060855050013005,060855050013005,"Block 3005, Block Group 3, Census Tract 5050.01, Santa Clara County, California",27,27,0
1000000US060855050013006,060855050013006,"Block 3006, Block Group 3, Census Tract 5050.01, Santa Clara County, California",35,34,1
1000000US060855050013007,060855050013007,"Block 3007, Block Group 3, Census Tract 5050.01, Santa Clara County, California",437,397,40
1000000US060855050013008,060855050013008,"Block 3008, Block Group 3, Census Tract 5050.01, Santa Clara County, California",34,34,0
1000000US060855050013009,060855050013009,"Block 3009, Block Group 3, Census Tract 5050.01, Santa Clara County, California",4,4,0
1000000US060855050013010,060855050013010,"Block 3010, Block Group 3, Census Tract 5050.01, Santa Clara County, California",28,26,2
1000000US060855050013011,060855050013011,"Block 3011, Block Group 3, Census Tract 5050.01, Santa Clara County, California",28,28,0
1000000US060855050013012,060855050013012,"Block 3012, Block Group 3, Census Tract 5050.01, Santa Clara County, California",28,28,0
1000000US060855050013013,060855050013013,"Block 3013, Block Group 3, Census Tract 5050.01, Santa Clara County, California",0,0,0
1000000US060855050014000,060855050014000,"Block 4000, Block Group 4, Census Tract 5050.01, Santa Clara County, California",0,0,0
1000000US060855050014001,060855050014001,"Block 4001, Block Group 4, Census Tract 5050.01, Santa Clara County, California",40,39,1
1000000US060855050014002,060855050014002,"Block 4002, Block Group 4, Census Tract 5050.01, Santa Clara County, California",24,22,2
1000000US060855050014003,060855050014003,"Block 4003, Block Group 4, Census Tract 5050.01, Santa Clara County, California",25,24,1
1000000US060855050014004,060855050014004,"Block 4004, Block Group 4, Census Tract 5050.01, Santa Clara County, California",85,84,1
1000000US060855050014005,060855050014005,"Block 4005, Block Group 4, Census Tract 5050.01, Santa Clara County, California",4,4,0
1000000US060855050014006,060855050014006,"Block 4006, Block Group 4, Census Tract 5050.01, Santa Clara County, California",0,0,0
1000000US060855050014007,060855050014007,"Block 4007, Block Group 4, Census Tract 5050.01, Santa Clara County, California",23,23,0
1000000US060855050014008,060855050014008,"Block 4008, Block Group 4, Census Tract 5050.01, Santa Clara County, California",24,22,2
1000000US060855050014009,060855050014009,"Block 4009, Block Group 4, Census Tract 5050.01, Santa Clara County, California",51,50,1
1000000US060855050014010,060855050014010,"Block 4010, Block Group 4, Census Tract 5050.01, Santa Clara County, California",0,0,0
1000000US060855050014011,060855050014011,"Block 4011, Block Group 4, Census Tract 5050.01, Santa Clara County, California",0,0,0
1000000US060855050014012,060855050014012,"Block 4012, Block Group 4, Census Tract 5050.01, Santa Clara County, California",0,0,0
1000000US060855050014013,060855050014013,"Block 4013, Block Group 4, Census Tract 5050.01, Santa Clara County, California",0,0,0
1000000US060855050014014,060855050014014,"Block 4014, Block Group 4, Census Tract 5050.01, Santa Clara County, California",0,0,0
1000000US060855050014015,060855050014015,"Block 4015, Block Group 4, Census Tract 5050.01, Santa Clara County, California",0,0,0
1000000US060855050014016,060855050014016,"Block 4016, Block Group 4, Census Tract 5050.01, Santa Clara County, California",0,0,0
1000000US060855050014017,060855050014017,"Block 4017, Block Group 4, Census Tract 5050.01, Santa Clara County, California",0,0,0
1000000US060855050014018,060855050014018,"Block 4018, Block Group 4, Census Tract 5050.01, Santa Clara County, California",0,0,0
1000000US060855050014019,060855050014019,"Block 4019, Block Group 4, Census Tract 5050.01, Santa Clara County, California",0,0,0
1000000US060855050014020,060855050014020,"Block 4020, Block Group 4, Census Tract 5050.01, Santa Clara County, California",0,0,0
1000000US060855050014021,060855050014021,"Block 4021, Block Group 4, Census Tract 5050.01, Santa Clara County, California",0,0,0
1000000US060855050014022,060855050014022,"Block 4022, Block Group 4, Census Tract 5050.01, Santa Clara County, California",0,0,0
1000000US060855050014023,060855050014023,"Block 4023, Block Group 4, Census Tract 5050.01, Santa Clara County, California",0,0,0
1000000US060855050014024,060855050014024,"Block 4024, Block Group 4, Census Tract 5050.01, Santa Clara County, California",0,0,0
1000000US060855050014025,060855050014025,"Block 4025, Block Group 4, Census Tract 5050.01, Santa Clara County, California",0,0,0
1000000US060855050014026,060855050014026,"Block 4026, Block Group 4, Census Tract 5050.01, Santa Clara County, California",0,0,0
1000000US060855050014027,060855050014027,"Block 4027, Block Group 4, Census Tract 5050.01, Santa Clara County, California",0,0,0
1000000US060855050014028,060855050014028,"Block 4028, Block Group 4, Census Tract 5050.01, Santa Clara County, California",0,0,0
1000000US060855050014029,060855050014029,"Block 4029, Block Group 4, Census Tract 5050.01, Santa Clara County, California",0,0,0
1000000US060855050014030,060855050014030,"Block 4030, Block Group 4, Census Tract 5050.01, Santa Clara County, California",0,0,0
1000000US060855050014031,060855050014031,"Block 4031, Block Group 4, Census Tract 5050.01, Santa Clara County, California",0,0,0
1000000US060855050014032,060855050014032,"Block 4032, Block Group 4, Census Tract 5050.01, Santa Clara County, California",0,0,0
1000000US060855050014033,060855050014033,"Block 4033, Block Group 4, Census Tract 5050.01, Santa Clara County, California",0,0,0
1000000US060855050014034,060855050014034,"Block 4034, Block Group 4, Census Tract 5050.01, Santa Clara County, California",1,0,1
1000000US060855050014035,060855050014035,"Block 4035, Block Group 4, Census Tract 5050.01, Santa Clara County, California",0,0,0
1000000US060855050014036,060855050014036,"Block 4036, Block Group 4, Census Tract 5050.01, Santa Clara County, California",0,0,0
1000000US060855050014037,060855050014037,"Block 4037, Block Group 4, Census Tract 5050.01, Santa Clara County, California",0,0,0
1000000US060855050014038,060855050014038,"Block 4038, Block Group 4, Census Tract 5050.01, Santa Clara County, California",0,0,0
1000000US060855050014039,060855050014039,"Block 4039, Block Group 4, Census Tract 5050.01, Santa Clara County, California",0,0,0
1000000US060855050014040,060855050014040,"Block 4040, Block Group 4, Census Tract 5050.01, Santa Clara County, California",0,0,0
1000000US060855050014041,060855050014041,"Block 4041, Block Group 4, Census Tract 5050.01, Santa Clara County, California",0,0,0
1000000US060855050014042,060855050014042,"Block 4042, Block Group 4, Census Tract 5050.01, Santa Clara County, California",0,0,0
1000000US060855050014043,060855050014043,"Block 4043, Block Group 4, Census Tract 5050.01, Santa Clara County, California",0,0,0
1000000US060855050014044,060855050014044,"Block 4044, Block Group 4, Census Tract 5050.01, Santa Clara County, California",0,0,0
1000000US060855050014045,060855050014045,"Block 4045, Block Group 4, Census Tract 5050.01, Santa Clara County, California",0,0,0
1000000US060855050014046,060855050014046,"Block 4046, Block Group 4, Census Tract 5050.01, Santa Clara County, California",0,0,0
1000000US060855050014047,060855050014047,"Block 4047, Block Group 4, Census Tract 5050.01, Santa Clara County, California",19,19,0
1000000US060855050014048,060855050014048,"Block 4048, Block Group 4, Census Tract 5050.01, Santa Clara County, California",0,0,0
1000000US060855050015000,060855050015000,"Block 5000, Block Group 5, Census Tract 5050.01, Santa Clara County, California",179,173,6
1000000US060855050015001,060855050015001,"Block 5001, Block Group 5, Census Tract 5050.01, Santa Clara County, California",20,20,0
1000000US060855050015002,060855050015002,"Block 5002, Block Group 5, Census Tract 5050.01, Santa Clara County, California",36,36,0
1000000US060855050015003,060855050015003,"Block 5003, Block Group 5, Census Tract 5050.01, Santa Clara County, California",208,169,39
1000000US060855050015004,060855050015004,"Block 5004, Block Group 5, Census Tract 5050.01, Santa Clara County, California",0,0,0
1000000US060855050061000,060855050061000,"Block 1000, Block Group 1, Census Tract 5050.06, Santa Clara County, California",19,19,0
1000000US060855050061001,060855050061001,"Block 1001, Block Group 1, Census Tract 5050.06, Santa Clara County, California",0,0,0
1000000US060855050061002,060855050061002,"Block 1002, Block Group 1, Census Tract 5050.06, Santa Clara County, California",0,0,0
1000000US060855050061003,060855050061003,"Block 1003, Block Group 1, Census Tract 5050.06, Santa Clara County, California",0,0,0
1000000US060855050061004,060855050061004,"Block 1004, Block Group 1, Census Tract 5050.06, Santa Clara County, California",0,0,0
1000000US060855050061005,060855050061005,"Block 1005, Block Group 1, Census Tract 5050.06, Santa Clara County, California",0,0,0
1000000US060855050061006,060855050061006,"Block 1006, Block Group 1, Census Tract 5050.06, Santa Clara County, California",0,0,0
1000000US060855050061007,060855050061007,"Block 1007, Block Group 1, Census Tract 5050.06, Santa Clara County, California",0,0,0
1000000US060855050061008,060855050061008,"Block 1008, Block Group 1, Census Tract 5050.06, Santa Clara County, California",0,0,0
1000000US060855050061009,060855050061009,"Block 1009, Block Group 1, Census Tract 5050.06, Santa Clara County, California",0,0,0
1000000US060855050061010,060855050061010,"Block 1010, Block Group 1, Census Tract 5050.06, Santa Clara County, California",0,0,0
1000000US060855050061011,060855050061011,"Block 1011, Block Group 1, Census Tract 5050.06, Santa Clara County, California",0,0,0
1000000US060855050061012,060855050061012,"Block 1012, Block Group 1, Census Tract 5050.06, Santa Clara County, California",54,53,1
1000000US060855050061013,060855050061013,"Block 1013, Block Group 1, Census Tract 5050.06, Santa Clara County, California",0,0,0
1000000US060855050061014,060855050061014,"Block 1014, Block Group 1, Census Tract 5050.06, Santa Clara County, California",179,174,5
1000000US060855050061015,060855050061015,"Block 1015, Block Group 1, Census Tract 5050.06, Santa Clara County, California",24,24,0
1000000US060855050061016,060855050061016,"Block 1016, Block Group 1, Census Tract 5050.06, Santa Clara County, California",0,0,0
1000000US060855050061017,060855050061017,"Block 1017, Block Group 1, Census Tract 5050.06, Santa Clara County, California",0,0,0
1000000US060855050061018,060855050061018,"Block 1018, Block Group 1, Census Tract 5050.06, Santa Clara County, California",0,0,0
1000000US060855050061019,060855050061019,"Block 1019, Block Group 1, Census Tract 5050.06, Santa Clara County, California",0,0,0
1000000US060855050061020,060855050061020,"Block 1020, Block Group 1, Census Tract 5050.06, Santa Clara County, California",1,0,1
1000000US060855050061021,060855050061021,"Block 1021, Block Group 1, Census Tract 5050.06, Santa Clara County, California",0,0,0
1000000US060855050061022,060855050061022,"Block 1022, Block Group 1, Census Tract 5050.06, Santa Clara County, California",0,0,0
1000000US060855050061023,060855050061023,"Block 1023, Block Group 1, Census Tract 5050.06, Santa Clara County, California",0,0,0
1000000US060855050061024,060855050061024,"Block 1024, Block Group 1, Census Tract 5050.06, Santa Clara County, California",0,0,0
1000000US060855050061025,060855050061025,"Block 1025, Block Group 1, Census Tract 5050.06, Santa Clara County, California",75,73,2
1000000US060855050061026,060855050061026,"Block 1026, Block Group 1, Census Tract 5050.06, Santa Clara County, California",14,13,1
1000000US060855050061027,060855050061027,"Block 1027, Block Group 1, Census Tract 5050.06, Santa Clara County, California",30,30,0
1000000US060855050061028,060855050061028,"Block 1028, Block Group 1, Census Tract 5050.06, Santa Clara County, California",44,43,1
1000000US060855050061029,060855050061029,"Block 1029, Block Group 1, Census Tract 5050.06, Santa Clara County, California",0,0,0
1000000US060855050061030,060855050061030,"Block 1030, Block Group 1, Census Tract 5050.06, Santa Clara County, California",0,0,0
1000000US060855050061031,060855050061031,"Block 1031, Block Group 1, Census Tract 5050.06, Santa Clara County, California",0,0,0
1000000US060855050062000,060855050062000,"Block 2000, Block Group 2, Census Tract 5050.06, Santa Clara County, California",0,0,0
1000000US060855050062001,060855050062001,"Block 2001, Block Group 2, Census Tract 5050.06, Santa Clara County, California",0,0,0
1000000US060855050062002,060855050062002,"Block 2002, Block Group 2, Census Tract 5050.06, Santa Clara County, California",0,0,0
1000000US060855050062003,060855050062003,"Block 2003, Block Group 2, Census Tract 5050.06, Santa Clara County, California",0,0,0
1000000US060855050062004,060855050062004,"Block 2004, Block Group 2, Census Tract 5050.06, Santa Clara County, California",0,0,0
1000000US060855050062005,060855050062005,"Block 2005, Block Group 2, Census Tract 5050.06, Santa Clara County, California",0,0,0
1000000US060855050062006,060855050062006,"Block 2006, Block Group 2, Census Tract 5050.06, Santa Clara County, California",0,0,0
1000000US060855050062007,060855050062007,"Block 2007, Block Group 2, Census Tract 5050.06, Santa Clara County, California",0,0,0
1000000US060855050062008,060855050062008,"Block 2008, Block Group 2, Census Tract 5050.06, Santa Clara County, California",0,0,0
1000000US060855050062009,060855050062009,"Block 2009, Block Group 2, Census Tract 5050.06, Santa Clara County, California",0,0,0
1000000US060855050062010,060855050062010,"Block 2010, Block Group 2, Census Tract 5050.06, Santa Clara County, California",0,0,0
1000000US060855050062011,060855050062011,"Block 2011, Block Group 2, Census Tract 5050.06, Santa Clara County, California",0,0,0
1000000US060855050062012,060855050062012,"Block 2012, Block Group 2, Census Tract 5050.06, Santa Clara County, California",0,0,0
1000000US060855050062013,060855050062013,"Block 2013, Block Group 2, Census Tract 5050.06, Santa Clara County, California",0,0,0
1000000US060855050062014,060855050062014,"Block 2014, Block Group 2, Census Tract 5050.06, Santa Clara County, California",0,0,0
1000000US060855050062015,060855050062015,"Block 2015, Block Group 2, Census Tract 5050.06, Santa Clara County, California",0,0,0
1000000US060855050062016,060855050062016,"Block 2016, Block Group 2, Census Tract 5050.06, Santa Clara County, California",0,0,0
1000000US060855050062017,060855050062017,"Block 2017, Block Group 2, Census Tract 5050.06, Santa Clara County, California",0,0,0
1000000US060855050062018,060855050062018,"Block 2018, Block Group 2, Census Tract 5050.06, Santa Clara County, California",0,0,0
1000000US060855050062019,060855050062019,"Block 2019, Block Group 2, Census Tract 5050.06, Santa Clara County, California",0,0,0
1000000US060855050062020,060855050062020,"Block 2020, Block Group 2, Census Tract 5050.06, Santa Clara County, California",0,0,0
1000000US060855050062021,060855050062021,"Block 2021, Block Group 2, Census Tract 5050.06, Santa Clara County, California",0,0,0
1000000US060855050062022,060855050062022,"Block 2022, Block Group 2, Census Tract 5050.06, Santa Clara County, California",0,0,0
1000000US060855050062023,060855050062023,"Block 2023, Block Group 2, Census Tract 5050.06, Santa Clara County, California",0,0,0
1000000US060855050062024,060855050062024,"Block 2024, Block Group 2, Census Tract 5050.06, Santa Clara County, California",0,0,0
1000000US060855050062025,060855050062025,"Block 2025, Block Group 2, Census Tract 5050.06, Santa Clara County, California",0,0,0
1000000US060855050062026,060855050062026,"Block 2026, Block Group 2, Census Tract 5050.06, Santa Clara County, California",0,0,0
1000000US060855050062027,060855050062027,"Block 2027, Block Group 2, Census Tract 5050.06, Santa Clara County, California",0,0,0
1000000US060855050062028,060855050062028,"Block 2028, Block Group 2, Census Tract 5050.06, Santa Clara County, California",0,0,0
1000000US060855050062029,060855050062029,"Block 2029, Block Group 2, Census Tract 5050.06, Santa Clara County, California",0,0,0
1000000US060855050062030,060855050062030,"Block 2030, Block Group 2, Census Tract 5050.06, Santa Clara County, California",0,0,0
1000000US060855050062031,060855050062031,"Block 2031, Block Group 2, Census Tract 5050.06, Santa Clara County, California",0,0,0
1000000US060855050062032,060855050062032,"Block 2032, Block Group 2, Census Tract 5050.06, Santa Clara County, California",0,0,0
1000000US060855050062033,060855050062033,"Block 2033, Block Group 2, Census Tract 5050.06, Santa Clara County, California",0,0,0
1000000US060855050062034,060855050062034,"Block 2034, Block Group 2, Census Tract 5050.06, Santa Clara County, California",0,0,0
1000000US060855050062035,060855050062035,"Block 2035, Block Group 2, Census Tract 5050.06, Santa Clara County, California",0,0,0
1000000US060855050062036,060855050062036,"Block 2036, Block Group 2, Census Tract 5050.06, Santa Clara County, California",0,0,0
1000000US060855050062037,060855050062037,"Block 2037, Block Group 2, Census Tract 5050.06, Santa Clara County, California",0,0,0
1000000US060855050062038,060855050062038,"Block 2038, Block Group 2, Census Tract 5050.06, Santa Clara County, California",0,0,0
1000000US060855050062039,060855050062039,"Block 2039, Block Group 2, Census Tract 5050.06, Santa Clara County, California",589,572,17
1000000US060855050062040,060855050062040,"Block 2040, Block Group 2, Census Tract 5050.06, Santa Clara County, California",346,330,16
1000000US060855050062041,060855050062041,"Block 2041, Block Group 2, Census Tract 5050.06, Santa Clara County, California",0,0,0
1000000US060855050062042,060855050062042,"Block 2042, Block Group 2, Census Tract 5050.06, Santa Clara County, California",146,145,1
1000000US060855050062043,060855050062043,"Block 2043, Block Group 2, Census Tract 5050.06, Santa Clara County, California",336,325,11
1000000US060855050062044,060855050062044,"Block 2044, Block Group 2, Census Tract 5050.06, Santa Clara County, California",51,49,2
1000000US060855050062045,060855050062045,"Block 2045, Block Group 2, Census Tract 5050.06, Santa Clara County, California",0,0,0
1000000US060855050062046,060855050062046,"Block 2046, Block Group 2, Census Tract 5050.06, Santa Clara County, California",0,0,0
1000000US060855050062047,060855050062047,"Block 2047, Block Group 2, Census Tract 5050.06, Santa Clara County, California",0,0,0
1000000US060855050062048,060855050062048,"Block 2048, Block Group 2, Census Tract 5050.06, Santa Clara County, California",0,0,0
1000000US060855050062049,060855050062049,"Block 2049, Block Group 2, Census Tract 5050.06, Santa Clara County, California",0,0,0
1000000US060855050062050,060855050062050,"Block 2050, Block Group 2, Census Tract 5050.06, Santa Clara County, California",0,0,0
1000000US060855050062051,060855050062051,"Block 2051, Block Group 2, Census Tract 5050.06, Santa Clara County, California",0,0,0
1000000US060855050062052,060855050062052,"Block 2052, Block Group 2, Census Tract 5050.06, Santa Clara County, California",0,0,0
1000000US060855050062053,060855050062053,"Block 2053, Block Group 2, Census Tract 5050.06, Santa Clara County, California",0,0,0
1000000US060855050062054,060855050062054,"Block 2054, Block Group 2, Census Tract 5050.06, Santa Clara County, California",0,0,0
1000000US060855050062055,060855050062055,"Block 2055, Block Group 2, Census Tract 5050.06, Santa Clara County, California",0,0,0
1000000US060855050062056,060855050062056,"Block 2056, Block Group 2, Census Tract 5050.06, Santa Clara County, California",0,0,0
1000000US060855050062057,060855050062057,"Block 2057, Block Group 2, Census Tract 5050.06, Santa Clara County, California",0,0,0
1000000US060855050062058,060855050062058,"Block 2058, Block Group 2, Census Tract 5050.06, Santa Clara County, California",0,0,0
1000000US060855050062059,060855050062059,"Block 2059, Block Group 2, Census Tract 5050.06, Santa Clara County, California",0,0,0
1000000US060855050062060,060855050062060,"Block 2060, Block Group 2, Census Tract 5050.06, Santa Clara County, California",0,0,0
1000000US060855050062061,060855050062061,"Block 2061, Block Group 2, Census Tract 5050.06, Santa Clara County, California",0,0,0
1000000US060855050062062,060855050062062,"Block 2062, Block Group 2, Census Tract 5050.06, Santa Clara County, California",1,1,0
1000000US060855050062063,060855050062063,"Block 2063, Block Group 2, Census Tract 5050.06, Santa Clara County, California",1,1,0
1000000US060855050062064,060855050062064,"Block 2064, Block Group 2, Census Tract 5050.06, Santa Clara County, California",0,0,0
1000000US060855050062065,060855050062065,"Block 2065, Block Group 2, Census Tract 5050.06, Santa Clara County, California",0,0,0
1000000US060855050062066,060855050062066,"Block 2066, Block Group 2, Census Tract 5050.06, Santa Clara County, California",0,0,0
1000000US060855050062067,060855050062067,"Block 2067, Block Group 2, Census Tract 5050.06, Santa Clara County, California",96,96,0
1000000US060855050062068,060855050062068,"Block 2068, Block Group 2, Census Tract 5050.06, Santa Clara County, California",0,0,0
1000000US060855050062069,060855050062069,"Block 2069, Block Group 2, Census Tract 5050.06, Santa Clara County, California",0,0,0
1000000US060855050062070,060855050062070,"Block 2070, Block Group 2, Census Tract 5050.06, Santa Clara County, California",0,0,0
1000000US060855050062071,060855050062071,"Block 2071, Block Group 2, Census Tract 5050.06, Santa Clara County, California",0,0,0
1000000US060855050062072,060855050062072,"Block 2072, Block Group 2, Census Tract 5050.06, Santa Clara County, California",0,0,0
1000000US060855050062073,060855050062073,"Block 2073, Block Group 2, Census Tract 5050.06, Santa Clara County, California",0,0,0
1000000US060855050062074,060855050062074,"Block 2074, Block Group 2, Census Tract 5050.06, Santa Clara County, California",0,0,0
1000000US060855050062075,060855050062075,"Block 2075, Block Group 2, Census Tract 5050.06, Santa Clara County, California",2,2,0
1000000US060855050062076,060855050062076,"Block 2076, Block Group 2, Census Tract 5050.06, Santa Clara County, California",0,0,0
1000000US060855050062077,060855050062077,"Block 2077, Block Group 2, Census Tract 5050.06, Santa Clara County, California",0,0,0
1000000US060855050071000,060855050071000,"Block 1000, Block Group 1, Census Tract 5050.07, Santa Clara County, California",102,100,2
1000000US060855050071001,060855050071001,"Block 1001, Block Group 1, Census Tract 5050.07, Santa Clara County, California",29,28,1
1000000US060855050071002,060855050071002,"Block 1002, Block Group 1, Census Tract 5050.07, Santa Clara County, California",64,64,0
1000000US060855050071003,060855050071003,"Block 1003, Block Group 1, Census Tract 5050.07, Santa Clara County, California",0,0,0
1000000US060855050071004,060855050071004,"Block 1004, Block Group 1, Census Tract 5050.07, Santa Clara County, California",0,0,0
1000000US060855050071005,060855050071005,"Block 1005, Block Group 1, Census Tract 5050.07, Santa Clara County, California",0,0,0
1000000US060855050071006,060855050071006,"Block 1006, Block Group 1, Census Tract 5050.07, Santa Clara County, California",1,1,0
1000000US060855050071007,060855050071007,"Block 1007, Block Group 1, Census Tract 5050.07, Santa Clara County, California",42,39,3
1000000US060855050071008,060855050071008,"Block 1008, Block Group 1, Census Tract 5050.07, Santa Clara County, California",0,0,0
1000000US060855050071009,060855050071009,"Block 1009, Block Group 1, Census Tract 5050.07, Santa Clara County, California",41,41,0
1000000US060855050071010,060855050071010,"Block 1010, Block Group 1, Census Tract 5050.07, Santa Clara County, California",0,0,0
1000000US060855050071011,060855050071011,"Block 1011, Block Group 1, Census Tract 5050.07, Santa Clara County, California",0,0,0
1000000US060855050071012,060855050071012,"Block 1012, Block Group 1, Census Tract 5050.07, Santa Clara County, California",0,0,0
1000000US060855050071013,060855050071013,"Block 1013, Block Group 1, Census Tract 5050.07, Santa Clara County, California",0,0,0
1000000US060855050071014,060855050071014,"Block 1014, Block Group 1, Census Tract 5050.07, Santa Clara County, California",0,0,0
1000000US060855050071015,060855050071015,"Block 1015, Block Group 1, Census Tract 5050.07, Santa Clara County, California",0,0,0
1000000US060855050071016,060855050071016,"Block 1016, Block Group 1, Census Tract 5050.07, Santa Clara County, California",0,0,0
1000000US060855050071017,060855050071017,"Block 1017, Block Group 1, Census Tract 5050.07, Santa Clara County, California",0,0,0
1000000US060855050071018,060855050071018,"Block 1018, Block Group 1, Census Tract 5050.07, Santa Clara County, California",0,0,0
1000000US060855050071019,060855050071019,"Block 1019, Block Group 1, Census Tract 5050.07, Santa Clara County, California",0,0,0
1000000US060855050071020,060855050071020,"Block 1020, Block Group 1, Census Tract 5050.07, Santa Clara County, California",0,0,0
1000000US060855050071021,060855050071021,"Block 1021, Block Group 1, Census Tract 5050.07, Santa Clara County, California",0,0,0
1000000US060855050071022,060855050071022,"Block 1022, Block Group 1, Census Tract 5050.07, Santa Clara County, California",0,0,0
1000000US060855050071023,060855050071023,"Block 1023, Block Group 1, Census Tract 5050.07, Santa Clara County, California",0,0,0
1000000US060855050071024,060855050071024,"Block 1024, Block Group 1, Census Tract 5050.07, Santa Clara County, California",0,0,0
1000000US060855050071025,060855050071025,"Block 1025, Block Group 1, Census Tract 5050.07, Santa Clara County, California",12,12,0
1000000US060855050071026,060855050071026,"Block 1026, Block Group 1, Census Tract 5050.07, Santa Clara County, California",0,0,0
1000000US060855050071027,060855050071027,"Block 1027, Block Group 1, Census Tract 5050.07, Santa Clara County, California",0,0,0
1000000US060855050071028,060855050071028,"Block 1028, Block Group 1, Census Tract 5050.07, Santa Clara County, California",0,0,0
1000000US060855050071029,060855050071029,"Block 1029, Block Group 1, Census Tract 5050.07, Santa Clara County, California",0,0,0
1000000US060855050071030,060855050071030,"Block 1030, Block Group 1, Census Tract 5050.07, Santa Clara County, California",0,0,0
1000000US060855050071031,060855050071031,"Block 1031, Block Group 1, Census Tract 5050.07, Santa Clara County, California",0,0,0
1000000US060855050071032,060855050071032,"Block 1032, Block Group 1, Census Tract 5050.07, Santa Clara County, California",0,0,0
1000000US060855050071033,060855050071033,"Block 1033, Block Group 1, Census Tract 5050.07, Santa Clara County, California",0,0,0
1000000US060855050071034,060855050071034,"Block 1034, Block Group 1, Census Tract 5050.07, Santa Clara County, California",0,0,0
1000000US060855050071035,060855050071035,"Block 1035, Block Group 1, Census Tract 5050.07, Santa Clara County, California",0,0,0
1000000US060855050071036,060855050071036,"Block 1036, Block Group 1, Census Tract 5050.07, Santa Clara County, California",0,0,0
1000000US060855050071037,060855050071037,"Block 1037, Block Group 1, Census Tract 5050.07, Santa Clara County, California",1,0,1
1000000US060855050071038,060855050071038,"Block 1038, Block Group 1, Census Tract 5050.07, Santa Clara County, California",0,0,0
1000000US060855050071039,060855050071039,"Block 1039, Block Group 1, Census Tract 5050.07, Santa Clara County, California",0,0,0
1000000US060855050071040,060855050071040,"Block 1040, Block Group 1, Census Tract 5050.07, Santa Clara County, California",2,1,1
1000000US060855050071041,060855050071041,"Block 1041, Block Group 1, Census Tract 5050.07, Santa Clara County, California",0,0,0
1000000US060855050071042,060855050071042,"Block 1042, Block Group 1, Census Tract 5050.07, Santa Clara County, California",0,0,0
1000000US060855050071043,060855050071043,"Block 1043, Block Group 1, Census Tract 5050.07, Santa Clara County, California",0,0,0
1000000US060855050071044,060855050071044,"Block 1044, Block Group 1, Census Tract 5050.07, Santa Clara County, California",0,0,0
1000000US060855050071045,060855050071045,"Block 1045, Block Group 1, Census Tract 5050.07, Santa Clara County, California",0,0,0
1000000US060855050071046,060855050071046,"Block 1046, Block Group 1, Census Tract 5050.07, Santa Clara County, California",0,0,0
1000000US060855050071047,060855050071047,"Block 1047, Block Group 1, Census Tract 5050.07, Santa Clara County, California",0,0,0
1000000US060855050071048,060855050071048,"Block 1048, Block Group 1, Census Tract 5050.07, Santa Clara County, California",0,0,0
1000000US060855050071049,060855050071049,"Block 1049, Block Group 1, Census Tract 5050.07, Santa Clara County, California",35,34,1
1000000US060855050071050,060855050071050,"Block 1050, Block Group 1, Census Tract 5050.07, Santa Clara County, California",35,34,1
1000000US060855050072000,060855050072000,"Block 2000, Block Group 2, Census Tract 5050.07, Santa Clara County, California",0,0,0
1000000US060855050072001,060855050072001,"Block 2001, Block Group 2, Census Tract 5050.07, Santa Clara County, California",0,0,0
1000000US060855050072002,060855050072002,"Block 2002, Block Group 2, Census Tract 5050.07, Santa Clara County, California",0,0,0
1000000US060855050072003,060855050072003,"Block 2003, Block Group 2, Census Tract 5050.07, Santa Clara County, California",79,75,4
1000000US060855050072004,060855050072004,"Block 2004, Block Group 2, Census Tract 5050.07, Santa Clara County, California",31,30,1
1000000US060855050072005,060855050072005,"Block 2005, Block Group 2, Census Tract 5050.07, Santa Clara County, California",27,24,3
1000000US060855050072006,060855050072006,"Block 2006, Block Group 2, Census Tract 5050.07, Santa Clara County, California",27,27,0
1000000US060855050072007,060855050072007,"Block 2007, Block Group 2, Census Tract 5050.07, Santa Clara County, California",10,9,1
1000000US060855050072008,060855050072008,"Block 2008, Block Group 2, Census Tract 5050.07, Santa Clara County, California",29,29,0
1000000US060855050072009,060855050072009,"Block 2009, Block Group 2, Census Tract 5050.07, Santa Clara County, California",19,18,1
1000000US060855050072010,060855050072010,"Block 2010, Block Group 2, Census Tract 5050.07, Santa Clara County, California",6,6,0
1000000US060855050072011,060855050072011,"Block 2011, Block Group 2, Census Tract 5050.07, Santa Clara County, California",107,107,0
1000000US060855050072012,060855050072012,"Block 2012, Block Group 2, Census Tract 5050.07, Santa Clara County, California",15,15,0
1000000US060855050072013,060855050072013,"Block 2013, Block Group 2, Census Tract 5050.07, Santa Clara County, California",30,30,0
1000000US060855050072014,060855050072014,"Block 2014, Block Group 2, Census Tract 5050.07, Santa Clara County, California",30,29,1
1000000US060855050072015,060855050072015,"Block 2015, Block Group 2, Census Tract 5050.07, Santa Clara County, California",57,55,2
1000000US060855050072016,060855050072016,"Block 2016, Block Group 2, Census Tract 5050.07, Santa Clara County, California",25,20,5
1000000US060855050072017,060855050072017,"Block 2017, Block Group 2, Census Tract 5050.07, Santa Clara County, California",36,35,1
1000000US060855050072018,060855050072018,"Block 2018, Block Group 2, Census Tract 5050.07, Santa Clara County, California",16,15,1
1000000US060855050072019,060855050072019,"Block 2019, Block Group 2, Census Tract 5050.07, Santa Clara County, California",4,4,0
1000000US060855050072020,060855050072020,"Block 2020, Block Group 2, Census Tract 5050.07, Santa Clara County, California",0,0,0
1000000US060855050072021,060855050072021,"Block 2021, Block Group 2, Census Tract 5050.07, Santa Clara County, California",0,0,0
1000000US060855050072022,060855050072022,"Block 2022, Block Group 2, Census Tract 5050.07, Santa Clara County, California",0,0,0
1000000US060855050072023,060855050072023,"Block 2023, Block Group 2, Census Tract 5050.07, Santa Clara County, California",0,0,0
1000000US060855050072024,060855050072024,"Block 2024, Block Group 2, Census Tract 5050.07, Santa Clara County, California",64,61,3
1000000US060855050072025,060855050072025,"Block 2025, Block Group 2, Census Tract 5050.07, Santa Clara County, California",0,0,0
1000000US060855050072026,060855050072026,"Block 2026, Block Group 2, Census Tract 5050.07, Santa Clara County, California",0,0,0
1000000US060855050072027,060855050072027,"Block 2027, Block Group 2, Census Tract 5050.07, Santa Clara County, California",0,0,0
1000000US060855050072028,060855050072028,"Block 2028, Block Group 2, Census Tract 5050.07, Santa Clara County, California",19,17,2
1000000US060855050081000,060855050081000,"Block 1000, Block Group 1, Census Tract 5050.08, Santa Clara County, California",226,216,10
1000000US060855050081001,060855050081001,"Block 1001, Block Group 1, Census Tract 5050.08, Santa Clara County, California",0,0,0
1000000US060855050081002,060855050081002,"Block 1002, Block Group 1, Census Tract 5050.08, Santa Clara County, California",0,0,0
1000000US060855050081003,060855050081003,"Block 1003, Block Group 1, Census Tract 5050.08, Santa Clara County, California",2,1,1
1000000US060855050081004,060855050081004,"Block 1004, Block Group 1, Census Tract 5050.08, Santa Clara County, California",125,118,7
1000000US060855050081005,060855050081005,"Block 1005, Block Group 1, Census Tract 5050.08, Santa Clara County, California",475,449,26
1000000US060855050081006,060855050081006,"Block 1006, Block Group 1, Census Tract 5050.08, Santa Clara County, California",312,290,22
1000000US060855050081007,060855050081007,"Block 1007, Block Group 1, Census Tract 5050.08, Santa Clara County, California",370,353,17
1000000US060855050081008,060855050081008,"Block 1008, Block Group 1, Census Tract 5050.08, Santa Clara County, California",0,0,0
1000000US060855050081009,060855050081009,"Block 1009, Block Group 1, Census Tract 5050.08, Santa Clara County, California",76,72,4
1000000US060855050081010,060855050081010,"Block 1010, Block Group 1, Census Tract 5050.08, Santa Clara County, California",1182,1101,81
1000000US060855050081011,060855050081011,"Block 1011, Block Group 1, Census Tract 5050.08, Santa Clara County, California",3,2,1
1000000US060855050081012,060855050081012,"Block 1012, Block Group 1, Census Tract 5050.08, Santa Clara County, California",0,0,0
1000000US060855050082000,060855050082000,"Block 2000, Block Group 2, Census Tract 5050.08, Santa Clara County, California",0,0,0
1000000US060855050082001,060855050082001,"Block 2001, Block Group 2, Census Tract 5050.08, Santa Clara County, California",0,0,0
1000000US060855050091000,060855050091000,"Block 1000, Block Group 1, Census Tract 5050.09, Santa Clara County, California",0,0,0
1000000US060855050091001,060855050091001,"Block 1001, Block Group 1, Census Tract 5050.09, Santa Clara County, California",0,0,0
1000000US060855050091002,060855050091002,"Block 1002, Block Group 1, Census Tract 5050.09, Santa Clara County, California",0,0,0
1000000US060855050091003,060855050091003,"Block 1003, Block Group 1, Census Tract 5050.09, Santa Clara County, California",0,0,0
1000000US060855050091004,060855050091004,"Block 1004, Block Group 1, Census Tract 5050.09, Santa Clara County, California",0,0,0
1000000US060855050091005,060855050091005,"Block 1005, Block Group 1, Census Tract 5050.09, Santa Clara County, California",0,0,0
1000000US060855050091006,060855050091006,"Block 1006, Block Group 1, Census Tract 5050.09, Santa Clara County, California",0,0,0
1000000US060855050091007,060855050091007,"Block 1007, Block Group 1, Census Tract 5050.09, Santa Clara County, California",0,0,0
1000000US060855050091008,060855050091008,"Block 1008, Block Group 1, Census Tract 5050.09, Santa Clara County, California",0,0,0
1000000US060855050091009,060855050091009,"Block 1009, Block Group 1, Census Tract 5050.09, Santa Clara County, California",232,223,9
1000000US060855050091010,060855050091010,"Block 1010, Block Group 1, Census Tract 5050.09, Santa Clara County, California",21,21,0
1000000US060855050091011,060855050091011,"Block 1011, Block Group 1, Census Tract 5050.09, Santa Clara County, California",16,16,0
1000000US060855050091012,060855050091012,"Block 1012, Block Group 1, Census Tract 5050.09, Santa Clara County, California",19,19,0
1000000US060855050091013,060855050091013,"Block 1013, Block Group 1, Census Tract 5050.09, Santa Clara County, California",29,27,2
1000000US060855050091014,060855050091014,"Block 1014, Block Group 1, Census Tract 5050.09, Santa Clara County, California",14,13,1
1000000US060855050091015,060855050091015,"Block 1015, Block Group 1, Census Tract 5050.09, Santa Clara County, California",24,24,0
1000000US060855050091016,060855050091016,"Block 1016, Block Group 1, Census Tract 5050.09, Santa Clara County, California",27,27,0
1000000US060855050091017,060855050091017,"Block 1017, Block Group 1, Census Tract 5050.09, Santa Clara County, California",31,30,1
1000000US060855050091018,060855050091018,"Block 1018, Block Group 1, Census Tract 5050.09, Santa Clara County, California",30,30,0
1000000US060855050091019,060855050091019,"Block 1019, Block Group 1, Census Tract 5050.09, Santa Clara County, California",18,18,0
1000000US060855050091020,060855050091020,"Block 1020, Block Group 1, Census Tract 5050.09, Santa Clara County, California",23,23,0
1000000US060855050091021,060855050091021,"Block 1021, Block Group 1, Census Tract 5050.09, Santa Clara County, California",48,48,0
1000000US060855050091022,060855050091022,"Block 1022, Block Group 1, Census Tract 5050.09, Santa Clara County, California",13,12,1
1000000US060855050091023,060855050091023,"Block 1023, Block Group 1, Census Tract 5050.09, Santa Clara County, California",0,0,0
1000000US060855050091024,060855050091024,"Block 1024, Block Group 1, Census Tract 5050.09, Santa Clara County, California",0,0,0
1000000US060855050091025,060855050091025,"Block 1025, Block Group 1, Census Tract 5050.09, Santa Clara County, California",30,30,0
1000000US060855050091026,060855050091026,"Block 1026, Block Group 1, Census Tract 5050.09, Santa Clara County, California",23,22,1
1000000US060855050091027,060855050091027,"Block 1027, Block Group 1, Census Tract 5050.09, Santa Clara County, California",25,25,0
1000000US060855050091028,060855050091028,"Block 1028, Block Group 1, Census Tract 5050.09, Santa Clara County, California",0,0,0
1000000US060855050091029,060855050091029,"Block 1029, Block Group 1, Census Tract 5050.09, Santa Clara County, California",2,2,0
1000000US060855050091030,060855050091030,"Block 1030, Block Group 1, Census Tract 5050.09, Santa Clara County, California",0,0,0
1000000US060855050091031,060855050091031,"Block 1031, Block Group 1, Census Tract 5050.09, Santa Clara County, California",0,0,0
1000000US060855050091032,060855050091032,"Block 1032, Block Group 1, Census Tract 5050.09, Santa Clara County, California",0,0,0
1000000US060855050091033,060855050091033,"Block 1033, Block Group 1, Census Tract 5050.09, Santa Clara County, California",0,0,0
1000000US060855050091034,060855050091034,"Block 1034, Block Group 1, Census Tract 5050.09, Santa Clara County, California",15,15,0
1000000US060855050091035,060855050091035,"Block 1035, Block Group 1, Census Tract 5050.09, Santa Clara County, California",19,19,0
1000000US060855050091036,060855050091036,"Block 1036, Block Group 1, Census Tract 5050.09, Santa Clara County, California",17,17,0
1000000US060855050092000,060855050092000,"Block 2000, Block Group 2, Census Tract 5050.09, Santa Clara County, California",0,0,0
1000000US060855050092001,060855050092001,"Block 2001, Block Group 2, Census Tract 5050.09, Santa Clara County, California",0,0,0
1000000US060855050092002,060855050092002,"Block 2002, Block Group 2, Census Tract 5050.09, Santa Clara County, California",133,122,11
1000000US060855050092003,060855050092003,"Block 2003, Block Group 2, Census Tract 5050.09, Santa Clara County, California",13,13,0
1000000US060855050092004,060855050092004,"Block 2004, Block Group 2, Census Tract 5050.09, Santa Clara County, California",41,41,0
1000000US060855050092005,060855050092005,"Block 2005, Block Group 2, Census Tract 5050.09, Santa Clara County, California",10,10,0
1000000US060855050092006,060855050092006,"Block 2006, Block Group 2, Census Tract 5050.09, Santa Clara County, California",11,10,1
1000000US060855050092007,060855050092007,"Block 2007, Block Group 2, Census Tract 5050.09, Santa Clara County, California",28,27,1
1000000US060855050092008,060855050092008,"Block 2008, Block Group 2, Census Tract 5050.09, Santa Clara County, California",16,12,4
1000000US060855050092009,060855050092009,"Block 2009, Block Group 2, Census Tract 5050.09, Santa Clara County, California",27,27,0
1000000US060855050092010,060855050092010,"Block 2010, Block Group 2, Census Tract 5050.09, Santa Clara County, California",46,45,1
1000000US060855050092011,060855050092011,"Block 2011, Block Group 2, Census Tract 5050.09, Santa Clara County, California",30,28,2
1000000US060855050092012,060855050092012,"Block 2012, Block Group 2, Census Tract 5050.09, Santa Clara County, California",36,33,3
1000000US060855050092013,060855050092013,"Block 2013, Block Group 2, Census Tract 5050.09, Santa Clara County, California",42,36,6
1000000US060855050092014,060855050092014,"Block 2014, Block Group 2, Census Tract 5050.09, Santa Clara County, California",19,18,1
1000000US060855050093000,060855050093000,"Block 3000, Block Group 3, Census Tract 5050.09, Santa Clara County, California",858,830,28
1000000US060855050093001,060855050093001,"Block 3001, Block Group 3, Census Tract 5050.09, Santa Clara County, California",20,19,1
1000000US060855050093002,060855050093002,"Block 3002, Block Group 3, Census Tract 5050.09, Santa Clara County, California",26,26,0
1000000US060855050093003,060855050093003,"Block 3003, Block Group 3, Census Tract 5050.09, Santa Clara County, California",16,16,0
1000000US060855050093004,060855050093004,"Block 3004, Block Group 3, Census Tract 5050.09, Santa Clara County, California",16,16,0
1000000US060855050093005,060855050093005,"Block 3005, Block Group 3, Census Tract 5050.09, Santa Clara County, California",0,0,0
1000000US060855050093006,060855050093006,"Block 3006, Block Group 3, Census Tract 5050.09, Santa Clara County, California",250,244,6
1000000US060855050093007,060855050093007,"Block 3007, Block Group 3, Census Tract 5050.09, Santa Clara County, California",26,26,0
1000000US060855050093008,060855050093008,"Block 3008, Block Group 3, Census Tract 5050.09, Santa Clara County, California",3,3,0
1000000US060855050093009,060855050093009,"Block 3009, Block Group 3, Census Tract 5050.09, Santa Clara County, California",0,0,0
1000000US060855050093010,060855050093010,"Block 3010, Block Group 3, Census Tract 5050.09, Santa Clara County, California",47,45,2
1000000US060855050093011,060855050093011,"Block 3011, Block Group 3, Census Tract 5050.09, Santa Clara County, California",13,13,0
1000000US060855051001000,060855051001000,"Block 1000, Block Group 1, Census Tract 5051, Santa Clara County, California",0,0,0
1000000US060855051001001,060855051001001,"Block 1001, Block Group 1, Census Tract 5051, Santa Clara County, California",0,0,0
1000000US060855051001002,060855051001002,"Block 1002, Block Group 1, Census Tract 5051, Santa Clara County, California",0,0,0
1000000US060855051001003,060855051001003,"Block 1003, Block Group 1, Census Tract 5051, Santa Clara County, California",0,0,0
1000000US060855051001004,060855051001004,"Block 1004, Block Group 1, Census Tract 5051, Santa Clara County, California",0,0,0
1000000US060855051001005,060855051001005,"Block 1005, Block Group 1, Census Tract 5051, Santa Clara County, California",0,0,0
1000000US060855051001006,060855051001006,"Block 1006, Block Group 1, Census Tract 5051, Santa Clara County, California",0,0,0
1000000US060855051001007,060855051001007,"Block 1007, Block Group 1, Census Tract 5051, Santa Clara County, California",0,0,0
1000000US060855051001008,060855051001008,"Block 1008, Block Group 1, Census Tract 5051, Santa Clara County, California",0,0,0
1000000US060855051001009,060855051001009,"Block 1009, Block Group 1, Census Tract 5051, Santa Clara County, California",0,0,0
1000000US060855051001010,060855051001010,"Block 1010, Block Group 1, Census Tract 5051, Santa Clara County, California",0,0,0
1000000US060855051001011,060855051001011,"Block 1011, Block Group 1, Census Tract 5051, Santa Clara County, California",4,4,0
1000000US060855051001012,060855051001012,"Block 1012, Block Group 1, Census Tract 5051, Santa Clara County, California",234,226,8
1000000US060855051001013,060855051001013,"Block 1013, Block Group 1, Census Tract 5051, Santa Clara County, California",0,0,0
1000000US060855051001014,060855051001014,"Block 1014, Block Group 1, Census Tract 5051, Santa Clara County, California",0,0,0
1000000US060855051001015,060855051001015,"Block 1015, Block Group 1, Census Tract 5051, Santa Clara County, California",316,289,27
1000000US060855051001016,060855051001016,"Block 1016, Block Group 1, Census Tract 5051, Santa Clara County, California",36,35,1
1000000US060855051001017,060855051001017,"Block 1017, Block Group 1, Census Tract 5051, Santa Clara County, California",105,93,12
1000000US060855051001018,060855051001018,"Block 1018, Block Group 1, Census Tract 5051, Santa Clara County, California",154,149,5
1000000US060855051001019,060855051001019,"Block 1019, Block Group 1, Census Tract 5051, Santa Clara County, California",0,0,0
1000000US060855051001020,060855051001020,"Block 1020, Block Group 1, Census Tract 5051, Santa Clara County, California",0,0,0
1000000US060855051001021,060855051001021,"Block 1021, Block Group 1, Census Tract 5051, Santa Clara County, California",0,0,0
1000000US060855051001022,060855051001022,"Block 1022, Block Group 1, Census Tract 5051, Santa Clara County, California",0,0,0
1000000US060855051001023,060855051001023,"Block 1023, Block Group 1, Census Tract 5051, Santa Clara County, California",160,157,3
1000000US060855051001024,060855051001024,"Block 1024, Block Group 1, Census Tract 5051, Santa Clara County, California",0,0,0
1000000US060855051001025,060855051001025,"Block 1025, Block Group 1, Census Tract 5051, Santa Clara County, California",0,0,0
1000000US060855051001026,060855051001026,"Block 1026, Block Group 1, Census Tract 5051, Santa Clara County, California",12,12,0
1000000US060855051001027,060855051001027,"Block 1027, Block Group 1, Census Tract 5051, Santa Clara County, California",80,76,4
1000000US060855051001028,060855051001028,"Block 1028, Block Group 1, Census Tract 5051, Santa Clara County, California",25,22,3
1000000US060855051001029,060855051001029,"Block 1029, Block Group 1, Census Tract 5051, Santa Clara County, California",19,19,0
1000000US060855051001030,060855051001030,"Block 1030, Block Group 1, Census Tract 5051, Santa Clara County, California",32,30,2
1000000US060855051001031,060855051001031,"Block 1031, Block Group 1, Census Tract 5051, Santa Clara County, California",26,26,0
1000000US060855051001032,060855051001032,"Block 1032, Block Group 1, Census Tract 5051, Santa Clara County, California",23,23,0
1000000US060855051001033,060855051001033,"Block 1033, Block Group 1, Census Tract 5051, Santa Clara County, California",25,24,1
1000000US060855051001034,060855051001034,"Block 1034, Block Group 1, Census Tract 5051, Santa Clara County, California",32,31,1
1000000US060855051001035,060855051001035,"Block 1035, Block Group 1, Census Tract 5051, Santa Clara County, California",24,24,0
1000000US060855051001036,060855051001036,"Block 1036, Block Group 1, Census Tract 5051, Santa Clara County, California",34,34,0
1000000US060855051001037,060855051001037,"Block 1037, Block Group 1, Census Tract 5051, Santa Clara County, California",26,25,1
1000000US060855051001038,060855051001038,"Block 1038, Block Group 1, Census Tract 5051, Santa Clara County, California",26,26,0
1000000US060855051001039,060855051001039,"Block 1039, Block Group 1, Census Tract 5051, Santa Clara County, California",26,26,0
1000000US060855051001040,060855051001040,"Block 1040, Block Group 1, Census Tract 5051, Santa Clara County, California",25,23,2
1000000US060855051002000,060855051002000,"Block 2000, Block Group 2, Census Tract 5051, Santa Clara County, California",0,0,0
1000000US060855051002001,060855051002001,"Block 2001, Block Group 2, Census Tract 5051, Santa Clara County, California",0,0,0
1000000US060855051002002,060855051002002,"Block 2002, Block Group 2, Census Tract 5051, Santa Clara County, California",0,0,0
1000000US060855051002003,060855051002003,"Block 2003, Block Group 2, Census Tract 5051, Santa Clara County, California",0,0,0
1000000US060855051002004,060855051002004,"Block 2004, Block Group 2, Census Tract 5051, Santa Clara County, California",0,0,0
1000000US060855051002005,060855051002005,"Block 2005, Block Group 2, Census Tract 5051, Santa Clara County, California",0,0,0
1000000US060855051002006,060855051002006,"Block 2006, Block Group 2, Census Tract 5051, Santa Clara County, California",0,0,0
1000000US060855051002007,060855051002007,"Block 2007, Block Group 2, Census Tract 5051, Santa Clara County, California",0,0,0
1000000US060855051002008,060855051002008,"Block 2008, Block Group 2, Census Tract 5051, Santa Clara County, California",0,0,0
1000000US060855051002009,060855051002009,"Block 2009, Block Group 2, Census Tract 5051, Santa Clara County, California",0,0,0
1000000US060855051002010,060855051002010,"Block 2010, Block Group 2, Census Tract 5051, Santa Clara County, California",0,0,0
1000000US060855051002011,060855051002011,"Block 2011, Block Group 2, Census Tract 5051, Santa Clara County, California",0,0,0
1000000US060855051002012,060855051002012,"Block 2012, Block Group 2, Census Tract 5051, Santa Clara County, California",0,0,0
1000000US060855051002013,060855051002013,"Block 2013, Block Group 2, Census Tract 5051, Santa Clara County, California",0,0,0
1000000US060855051002014,060855051002014,"Block 2014, Block Group 2, Census Tract 5051, Santa Clara County, California",0,0,0
1000000US060855051002015,060855051002015,"Block 2015, Block Group 2, Census Tract 5051, Santa Clara County, California",0,0,0
1000000US060855051002016,060855051002016,"Block 2016, Block Group 2, Census Tract 5051, Santa Clara County, California",0,0,0
1000000US060855051002017,060855051002017,"Block 2017, Block Group 2, Census Tract 5051, Santa Clara County, California",0,0,0
1000000US060855051002018,060855051002018,"Block 2018, Block Group 2, Census Tract 5051, Santa Clara County, California",0,0,0
1000000US060855051002019,060855051002019,"Block 2019, Block Group 2, Census Tract 5051, Santa Clara County, California",0,0,0
1000000US060855051002020,060855051002020,"Block 2020, Block Group 2, Census Tract 5051, Santa Clara County, California",0,0,0
1000000US060855051002021,060855051002021,"Block 2021, Block Group 2, Census Tract 5051, Santa Clara County, California",0,0,0
1000000US060855051002022,060855051002022,"Block 2022, Block Group 2, Census Tract 5051, Santa Clara County, California",0,0,0
1000000US060855051002023,060855051002023,"Block 2023, Block Group 2, Census Tract 5051, Santa Clara County, California",0,0,0
1000000US060855051002024,060855051002024,"Block 2024, Block Group 2, Census Tract 5051, Santa Clara County, California",0,0,0
1000000US060855051002025,060855051002025,"Block 2025, Block Group 2, Census Tract 5051, Santa Clara County, California",0,0,0
1000000US060855051002026,060855051002026,"Block 2026, Block Group 2, Census Tract 5051, Santa Clara County, California",0,0,0
1000000US060855051002027,060855051002027,"Block 2027, Block Group 2, Census Tract 5051, Santa Clara County, California",0,0,0
1000000US060855051002028,060855051002028,"Block 2028, Block Group 2, Census Tract 5051, Santa Clara County, California",0,0,0
1000000US060855051002029,060855051002029,"Block 2029, Block Group 2, Census Tract 5051, Santa Clara County, California",19,18,1
1000000US060855051002030,060855051002030,"Block 2030, Block Group 2, Census Tract 5051, Santa Clara County, California",18,17,1
1000000US060855051002031,060855051002031,"Block 2031, Block Group 2, Census Tract 5051, Santa Clara County, California",0,0,0
1000000US060855051002032,060855051002032,"Block 2032, Block Group 2, Census Tract 5051, Santa Clara County, California",0,0,0
1000000US060855051002033,060855051002033,"Block 2033, Block Group 2, Census Tract 5051, Santa Clara County, California",0,0,0
1000000US060855052021000,060855052021000,"Block 1000, Block Group 1, Census Tract 5052.02, Santa Clara County, California",126,118,8
1000000US060855052021001,060855052021001,"Block 1001, Block Group 1, Census Tract 5052.02, Santa Clara County, California",71,70,1
1000000US060855052021002,060855052021002,"Block 1002, Block Group 1, Census Tract 5052.02, Santa Clara County, California",122,111,11
1000000US060855052021003,060855052021003,"Block 1003, Block Group 1, Census Tract 5052.02, Santa Clara County, California",19,19,0
1000000US060855052021004,060855052021004,"Block 1004, Block Group 1, Census Tract 5052.02, Santa Clara County, California",20,20,0
1000000US060855052021005,060855052021005,"Block 1005, Block Group 1, Census Tract 5052.02, Santa Clara County, California",3,3,0
1000000US060855052021006,060855052021006,"Block 1006, Block Group 1, Census Tract 5052.02, Santa Clara County, California",23,22,1
1000000US060855052021007,060855052021007,"Block 1007, Block Group 1, Census Tract 5052.02, Santa Clara County, California",30,27,3
1000000US060855052021008,060855052021008,"Block 1008, Block Group 1, Census Tract 5052.02, Santa Clara County, California",20,20,0
1000000US060855052021009,060855052021009,"Block 1009, Block Group 1, Census Tract 5052.02, Santa Clara County, California",19,19,0
1000000US060855052021010,060855052021010,"Block 1010, Block Group 1, Census Tract 5052.02, Santa Clara County, California",26,24,2
1000000US060855052021011,060855052021011,"Block 1011, Block Group 1, Census Tract 5052.02, Santa Clara County, California",18,18,0
1000000US060855052021012,060855052021012,"Block 1012, Block Group 1, Census Tract 5052.02, Santa Clara County, California",75,72,3
1000000US060855052021013,060855052021013,"Block 1013, Block Group 1, Census Tract 5052.02, Santa Clara County, California",20,19,1
1000000US060855052021014,060855052021014,"Block 1014, Block Group 1, Census Tract 5052.02, Santa Clara County, California",19,18,1
1000000US060855052022000,060855052022000,"Block 2000, Block Group 2, Census Tract 5052.02, Santa Clara County, California",19,18,1
1000000US060855052022001,060855052022001,"Block 2001, Block Group 2, Census Tract 5052.02, Santa Clara County, California",0,0,0
1000000US060855052022002,060855052022002,"Block 2002, Block Group 2, Census Tract 5052.02, Santa Clara County, California",116,110,6
1000000US060855052022003,060855052022003,"Block 2003, Block Group 2, Census Tract 5052.02, Santa Clara County, California",60,60,0
1000000US060855052022004,060855052022004,"Block 2004, Block Group 2, Census Tract 5052.02, Santa Clara County, California",210,185,25
1000000US060855052022005,060855052022005,"Block 2005, Block Group 2, Census Tract 5052.02, Santa Clara County, California",183,172,11
1000000US060855052022006,060855052022006,"Block 2006, Block Group 2, Census Tract 5052.02, Santa Clara County, California",0,0,0
1000000US060855052022007,060855052022007,"Block 2007, Block Group 2, Census Tract 5052.02, Santa Clara County, California",0,0,0
1000000US060855052022008,060855052022008,"Block 2008, Block Group 2, Census Tract 5052.02, Santa Clara County, California",37,37,0
1000000US060855052022009,060855052022009,"Block 2009, Block Group 2, Census Tract 5052.02, Santa Clara County, California",0,0,0
1000000US060855052022010,060855052022010,"Block 2010, Block Group 2, Census Tract 5052.02, Santa Clara County, California",0,0,0
1000000US060855052022011,060855052022011,"Block 2011, Block Group 2, Census Tract 5052.02, Santa Clara County, California",0,0,0
1000000US060855052022012,060855052022012,"Block 2012, Block Group 2, Census Tract 5052.02, Santa Clara County, California",0,0,0
1000000US060855052022013,060855052022013,"Block 2013, Block Group 2, Census Tract 5052.02, Santa Clara County, California",98,90,8
1000000US060855052022014,060855052022014,"Block 2014, Block Group 2, Census Tract 5052.02, Santa Clara County, California",12,11,1
1000000US060855052022015,060855052022015,"Block 2015, Block Group 2, Census Tract 5052.02, Santa Clara County, California",0,0,0
1000000US060855052022016,060855052022016,"Block 2016, Block Group 2, Census Tract 5052.02, Santa Clara County, California",0,0,0
1000000US060855052022017,060855052022017,"Block 2017, Block Group 2, Census Tract 5052.02, Santa Clara County, California",0,0,0
1000000US060855052022018,060855052022018,"Block 2018, Block Group 2, Census Tract 5052.02, Santa Clara County, California",100,94,6
1000000US060855052022019,060855052022019,"Block 2019, Block Group 2, Census Tract 5052.02, Santa Clara County, California",0,0,0
1000000US060855052022020,060855052022020,"Block 2020, Block Group 2, Census Tract 5052.02, Santa Clara County, California",0,0,0
1000000US060855052022021,060855052022021,"Block 2021, Block Group 2, Census Tract 5052.02, Santa Clara County, California",0,0,0
1000000US060855052022022,060855052022022,"Block 2022, Block Group 2, Census Tract 5052.02, Santa Clara County, California",15,15,0
1000000US060855052022023,060855052022023,"Block 2023, Block Group 2, Census Tract 5052.02, Santa Clara County, California",0,0,0
1000000US060855052022024,060855052022024,"Block 2024, Block Group 2, Census Tract 5052.02, Santa Clara County, California",312,242,70
1000000US060855052022025,060855052022025,"Block 2025, Block Group 2, Census Tract 5052.02, Santa Clara County, California",0,0,0
1000000US060855052022026,060855052022026,"Block 2026, Block Group 2, Census Tract 5052.02, Santa Clara County, California",19,19,0
1000000US060855052022027,060855052022027,"Block 2027, Block Group 2, Census Tract 5052.02, Santa Clara County, California",6,5,1
1000000US060855052022028,060855052022028,"Block 2028, Block Group 2, Census Tract 5052.02, Santa Clara County, California",55,25,30
1000000US060855052022029,060855052022029,"Block 2029, Block Group 2, Census Tract 5052.02, Santa Clara County, California",0,0,0
1000000US060855052022030,060855052022030,"Block 2030, Block Group 2, Census Tract 5052.02, Santa Clara County, California",0,0,0
1000000US060855052022031,060855052022031,"Block 2031, Block Group 2, Census Tract 5052.02, Santa Clara County, California",1,1,0
1000000US060855052023000,060855052023000,"Block 3000, Block Group 3, Census Tract 5052.02, Santa Clara County, California",5,5,0
1000000US060855052023001,060855052023001,"Block 3001, Block Group 3, Census Tract 5052.02, Santa Clara County, California",0,0,0
1000000US060855052023002,060855052023002,"Block 3002, Block Group 3, Census Tract 5052.02, Santa Clara County, California",0,0,0
1000000US060855052023003,060855052023003,"Block 3003, Block Group 3, Census Tract 5052.02, Santa Clara County, California",0,0,0
1000000US060855052023004,060855052023004,"Block 3004, Block Group 3, Census Tract 5052.02, Santa Clara County, California",0,0,0
1000000US060855052023005,060855052023005,"Block 3005, Block Group 3, Census Tract 5052.02, Santa Clara County, California",1,0,1
1000000US060855052023006,060855052023006,"Block 3006, Block Group 3, Census Tract 5052.02, Santa Clara County, California",0,0,0
1000000US060855052023007,060855052023007,"Block 3007, Block Group 3, Census Tract 5052.02, Santa Clara County, California",0,0,0
1000000US060855052023008,060855052023008,"Block 3008, Block Group 3, Census Tract 5052.02, Santa Clara County, California",0,0,0
1000000US060855052023009,060855052023009,"Block 3009, Block Group 3, Census Tract 5052.02, Santa Clara County, California",0,0,0
1000000US060855052023010,060855052023010,"Block 3010, Block Group 3, Census Tract 5052.02, Santa Clara County, California",0,0,0
1000000US060855052023011,060855052023011,"Block 3011, Block Group 3, Census Tract 5052.02, Santa Clara County, California",0,0,0
1000000US060855052023012,060855052023012,"Block 3012, Block Group 3, Census Tract 5052.02, Santa Clara County, California",0,0,0
1000000US060855052023013,060855052023013,"Block 3013, Block Group 3, Census Tract 5052.02, Santa Clara County, California",0,0,0
1000000US060855052023014,060855052023014,"Block 3014, Block Group 3, Census Tract 5052.02, Santa Clara County, California",0,0,0
1000000US060855052023015,060855052023015,"Block 3015, Block Group 3, Census Tract 5052.02, Santa Clara County, California",0,0,0
1000000US060855052023016,060855052023016,"Block 3016, Block Group 3, Census Tract 5052.02, Santa Clara County, California",0,0,0
1000000US060855052023017,060855052023017,"Block 3017, Block Group 3, Census Tract 5052.02, Santa Clara County, California",0,0,0
1000000US060855052023018,060855052023018,"Block 3018, Block Group 3, Census Tract 5052.02, Santa Clara County, California",0,0,0
1000000US060855052023019,060855052023019,"Block 3019, Block Group 3, Census Tract 5052.02, Santa Clara County, California",0,0,0
1000000US060855052023020,060855052023020,"Block 3020, Block Group 3, Census Tract 5052.02, Santa Clara County, California",0,0,0
1000000US060855052023021,060855052023021,"Block 3021, Block Group 3, Census Tract 5052.02, Santa Clara County, California",0,0,0
1000000US060855052023022,060855052023022,"Block 3022, Block Group 3, Census Tract 5052.02, Santa Clara County, California",0,0,0
1000000US060855052023023,060855052023023,"Block 3023, Block Group 3, Census Tract 5052.02, Santa Clara County, California",0,0,0
1000000US060855052023024,060855052023024,"Block 3024, Block Group 3, Census Tract 5052.02, Santa Clara County, California",0,0,0
1000000US060855052023025,060855052023025,"Block 3025, Block Group 3, Census Tract 5052.02, Santa Clara County, California",0,0,0
1000000US060855052023026,060855052023026,"Block 3026, Block Group 3, Census Tract 5052.02, Santa Clara County, California",0,0,0
1000000US060855052023027,060855052023027,"Block 3027, Block Group 3, Census Tract 5052.02, Santa Clara County, California",0,0,0
1000000US060855052023028,060855052023028,"Block 3028, Block Group 3, Census Tract 5052.02, Santa Clara County, California",0,0,0
1000000US060855052023029,060855052023029,"Block 3029, Block Group 3, Census Tract 5052.02, Santa Clara County, California",0,0,0
1000000US060855052023030,060855052023030,"Block 3030, Block Group 3, Census Tract 5052.02, Santa Clara County, California",0,0,0
1000000US060855052023031,060855052023031,"Block 3031, Block Group 3, Census Tract 5052.02, Santa Clara County, California",0,0,0
1000000US060855052023032,060855052023032,"Block 3032, Block Group 3, Census Tract 5052.02, Santa Clara County, California",0,0,0
1000000US060855052023033,060855052023033,"Block 3033, Block Group 3, Census Tract 5052.02, Santa Clara County, California",0,0,0
1000000US060855052023034,060855052023034,"Block 3034, Block Group 3, Census Tract 5052.02, Santa Clara County, California",0,0,0
1000000US060855052023035,060855052023035,"Block 3035, Block Group 3, Census Tract 5052.02, Santa Clara County, California",0,0,0
1000000US060855052023036,060855052023036,"Block 3036, Block Group 3, Census Tract 5052.02, Santa Clara County, California",0,0,0
1000000US060855052023037,060855052023037,"Block 3037, Block Group 3, Census Tract 5052.02, Santa Clara County, California",0,0,0
1000000US060855052023038,060855052023038,"Block 3038, Block Group 3, Census Tract 5052.02, Santa Clara County, California",0,0,0
1000000US060855052023039,060855052023039,"Block 3039, Block Group 3, Census Tract 5052.02, Santa Clara County, California",0,0,0
1000000US060855052023040,060855052023040,"Block 3040, Block Group 3, Census Tract 5052.02, Santa Clara County, California",0,0,0
1000000US060855052023041,060855052023041,"Block 3041, Block Group 3, Census Tract 5052.02, Santa Clara County, California",0,0,0
1000000US060855052023042,060855052023042,"Block 3042, Block Group 3, Census Tract 5052.02, Santa Clara County, California",0,0,0
1000000US060855052023043,060855052023043,"Block 3043, Block Group 3, Census Tract 5052.02, Santa Clara County, California",0,0,0
1000000US060855052023044,060855052023044,"Block 3044, Block Group 3, Census Tract 5052.02, Santa Clara County, California",0,0,0
1000000US060855052023045,060855052023045,"Block 3045, Block Group 3, Census Tract 5052.02, Santa Clara County, California",0,0,0
1000000US060855052023046,060855052023046,"Block 3046, Block Group 3, Census Tract 5052.02, Santa Clara County, California",0,0,0
1000000US060855052023047,060855052023047,"Block 3047, Block Group 3, Census Tract 5052.02, Santa Clara County, California",0,0,0
1000000US060855052023048,060855052023048,"Block 3048, Block Group 3, Census Tract 5052.02, Santa Clara County, California",0,0,0
1000000US060855052023049,060855052023049,"Block 3049, Block Group 3, Census Tract 5052.02, Santa Clara County, California",0,0,0
1000000US060855052023050,060855052023050,"Block 3050, Block Group 3, Census Tract 5052.02, Santa Clara County, California",0,0,0
1000000US060855052023051,060855052023051,"Block 3051, Block Group 3, Census Tract 5052.02, Santa Clara County, California",0,0,0
1000000US060855052023052,060855052023052,"Block 3052, Block Group 3, Census Tract 5052.02, Santa Clara County, California",0,0,0
1000000US060855052023053,060855052023053,"Block 3053, Block Group 3, Census Tract 5052.02, Santa Clara County, California",0,0,0
1000000US060855052023054,060855052023054,"Block 3054, Block Group 3, Census Tract 5052.02, Santa Clara County, California",0,0,0
1000000US060855052023055,060855052023055,"Block 3055, Block Group 3, Census Tract 5052.02, Santa Clara County, California",0,0,0
1000000US060855052023056,060855052023056,"Block 3056, Block Group 3, Census Tract 5052.02, Santa Clara County, California",0,0,0
1000000US060855052023057,060855052023057,"Block 3057, Block Group 3, Census Tract 5052.02, Santa Clara County, California",0,0,0
1000000US060855052023058,060855052023058,"Block 3058, Block Group 3, Census Tract 5052.02, Santa Clara County, California",0,0,0
1000000US060855052023059,060855052023059,"Block 3059, Block Group 3, Census Tract 5052.02, Santa Clara County, California",0,0,0
1000000US060855052023060,060855052023060,"Block 3060, Block Group 3, Census Tract 5052.02, Santa Clara County, California",0,0,0
1000000US060855052023061,060855052023061,"Block 3061, Block Group 3, Census Tract 5052.02, Santa Clara County, California",0,0,0
1000000US060855052023062,060855052023062,"Block 3062, Block Group 3, Census Tract 5052.02, Santa Clara County, California",0,0,0
1000000US060855052023063,060855052023063,"Block 3063, Block Group 3, Census Tract 5052.02, Santa Clara County, California",0,0,0
1000000US060855052023064,060855052023064,"Block 3064, Block Group 3, Census Tract 5052.02, Santa Clara County, California",0,0,0
1000000US060855052023065,060855052023065,"Block 3065, Block Group 3, Census Tract 5052.02, Santa Clara County, California",0,0,0
1000000US060855052023066,060855052023066,"Block 3066, Block Group 3, Census Tract 5052.02, Santa Clara County, California",0,0,0
1000000US060855052023067,060855052023067,"Block 3067, Block Group 3, Census Tract 5052.02, Santa Clara County, California",0,0,0
1000000US060855052023068,060855052023068,"Block 3068, Block Group 3, Census Tract 5052.02, Santa Clara County, California",0,0,0
1000000US060855052023069,060855052023069,"Block 3069, Block Group 3, Census Tract 5052.02, Santa Clara County, California",0,0,0
1000000US060855052023070,060855052023070,"Block 3070, Block Group 3, Census Tract 5052.02, Santa Clara County, California",0,0,0
1000000US060855052023071,060855052023071,"Block 3071, Block Group 3, Census Tract 5052.02, Santa Clara County, California",0,0,0
1000000US060855052023072,060855052023072,"Block 3072, Block Group 3, Census Tract 5052.02, Santa Clara County, California",0,0,0
1000000US060855052023073,060855052023073,"Block 3073, Block Group 3, Census Tract 5052.02, Santa Clara County, California",0,0,0
1000000US060855052023074,060855052023074,"Block 3074, Block Group 3, Census Tract 5052.02, Santa Clara County, California",0,0,0
1000000US060855052023075,060855052023075,"Block 3075, Block Group 3, Census Tract 5052.02, Santa Clara County, California",0,0,0
1000000US060855052023076,060855052023076,"Block 3076, Block Group 3, Census Tract 5052.02, Santa Clara County, California",0,0,0
1000000US060855052023077,060855052023077,"Block 3077, Block Group 3, Census Tract 5052.02, Santa Clara County, California",0,0,0
1000000US060855052023078,060855052023078,"Block 3078, Block Group 3, Census Tract 5052.02, Santa Clara County, California",0,0,0
1000000US060855052023079,060855052023079,"Block 3079, Block Group 3, Census Tract 5052.02, Santa Clara County, California",0,0,0
1000000US060855052023080,060855052023080,"Block 3080, Block Group 3, Census Tract 5052.02, Santa Clara County, California",0,0,0
1000000US060855052023081,060855052023081,"Block 3081, Block Group 3, Census Tract 5052.02, Santa Clara County, California",0,0,0
1000000US060855052023082,060855052023082,"Block 3082, Block Group 3, Census Tract 5052.02, Santa Clara County, California",0,0,0
1000000US060855052023083,060855052023083,"Block 3083, Block Group 3, Census Tract 5052.02, Santa Clara County, California",0,0,0
1000000US060855052023084,060855052023084,"Block 3084, Block Group 3, Census Tract 5052.02, Santa Clara County, California",0,0,0
1000000US060855052023085,060855052023085,"Block 3085, Block Group 3, Census Tract 5052.02, Santa Clara County, California",0,0,0
1000000US060855052023086,060855052023086,"Block 3086, Block Group 3, Census Tract 5052.02, Santa Clara County, California",0,0,0
1000000US060855052023087,060855052023087,"Block 3087, Block Group 3, Census Tract 5052.02, Santa Clara County, California",0,0,0
1000000US060855052023088,060855052023088,"Block 3088, Block Group 3, Census Tract 5052.02, Santa Clara County, California",0,0,0
1000000US060855052023089,060855052023089,"Block 3089, Block Group 3, Census Tract 5052.02, Santa Clara County, California",0,0,0
1000000US060855052023090,060855052023090,"Block 3090, Block Group 3, Census Tract 5052.02, Santa Clara County, California",0,0,0
1000000US060855052023091,060855052023091,"Block 3091, Block Group 3, Census Tract 5052.02, Santa Clara County, California",0,0,0
1000000US060855052023092,060855052023092,"Block 3092, Block Group 3, Census Tract 5052.02, Santa Clara County, California",0,0,0
1000000US060855052023093,060855052023093,"Block 3093, Block Group 3, Census Tract 5052.02, Santa Clara County, California",0,0,0
1000000US060855052023094,060855052023094,"Block 3094, Block Group 3, Census Tract 5052.02, Santa Clara County, California",0,0,0
1000000US060855052023095,060855052023095,"Block 3095, Block Group 3, Census Tract 5052.02, Santa Clara County, California",0,0,0
1000000US060855052023096,060855052023096,"Block 3096, Block Group 3, Census Tract 5052.02, Santa Clara County, California",0,0,0
1000000US060855052023097,060855052023097,"Block 3097, Block Group 3, Census Tract 5052.02, Santa Clara County, California",0,0,0
1000000US060855052023098,060855052023098,"Block 3098, Block Group 3, Census Tract 5052.02, Santa Clara County, California",0,0,0
1000000US060855052023099,060855052023099,"Block 3099, Block Group 3, Census Tract 5052.02, Santa Clara County, California",0,0,0
1000000US060855052023100,060855052023100,"Block 3100, Block Group 3, Census Tract 5052.02, Santa Clara County, California",0,0,0
1000000US060855052023101,060855052023101,"Block 3101, Block Group 3, Census Tract 5052.02, Santa Clara County, California",0,0,0
1000000US060855052023102,060855052023102,"Block 3102, Block Group 3, Census Tract 5052.02, Santa Clara County, California",0,0,0
1000000US060855052023103,060855052023103,"Block 3103, Block Group 3, Census Tract 5052.02, Santa Clara County, California",0,0,0
1000000US060855052023104,060855052023104,"Block 3104, Block Group 3, Census Tract 5052.02, Santa Clara County, California",0,0,0
1000000US060855052023105,060855052023105,"Block 3105, Block Group 3, Census Tract 5052.02, Santa Clara County, California",0,0,0
1000000US060855052023106,060855052023106,"Block 3106, Block Group 3, Census Tract 5052.02, Santa Clara County, California",0,0,0
1000000US060855052023107,060855052023107,"Block 3107, Block Group 3, Census Tract 5052.02, Santa Clara County, California",0,0,0
1000000US060855052023108,060855052023108,"Block 3108, Block Group 3, Census Tract 5052.02, Santa Clara County, California",0,0,0
1000000US060855052023109,060855052023109,"Block 3109, Block Group 3, Census Tract 5052.02, Santa Clara County, California",1,1,0
1000000US060855052023110,060855052023110,"Block 3110, Block Group 3, Census Tract 5052.02, Santa Clara County, California",0,0,0
1000000US060855052023111,060855052023111,"Block 3111, Block Group 3, Census Tract 5052.02, Santa Clara County, California",0,0,0
1000000US060855052023112,060855052023112,"Block 3112, Block Group 3, Census Tract 5052.02, Santa Clara County, California",0,0,0
1000000US060855052023113,060855052023113,"Block 3113, Block Group 3, Census Tract 5052.02, Santa Clara County, California",1,1,0
1000000US060855052023114,060855052023114,"Block 3114, Block Group 3, Census Tract 5052.02, Santa Clara County, California",0,0,0
1000000US060855052023115,060855052023115,"Block 3115, Block Group 3, Census Tract 5052.02, Santa Clara County, California",0,0,0
1000000US060855052023116,060855052023116,"Block 3116, Block Group 3, Census Tract 5052.02, Santa Clara County, California",0,0,0
1000000US060855052023117,060855052023117,"Block 3117, Block Group 3, Census Tract 5052.02, Santa Clara County, California",0,0,0
1000000US060855052023118,060855052023118,"Block 3118, Block Group 3, Census Tract 5052.02, Santa Clara County, California",0,0,0
1000000US060855052023119,060855052023119,"Block 3119, Block Group 3, Census Tract 5052.02, Santa Clara County, California",0,0,0
1000000US060855052023120,060855052023120,"Block 3120, Block Group 3, Census Tract 5052.02, Santa Clara County, California",0,0,0
1000000US060855052023121,060855052023121,"Block 3121, Block Group 3, Census Tract 5052.02, Santa Clara County, California",0,0,0
1000000US060855052023122,060855052023122,"Block 3122, Block Group 3, Census Tract 5052.02, Santa Clara County, California",0,0,0
1000000US060855052023123,060855052023123,"Block 3123, Block Group 3, Census Tract 5052.02, Santa Clara County, California",0,0,0
1000000US060855052023124,060855052023124,"Block 3124, Block Group 3, Census Tract 5052.02, Santa Clara County, California",0,0,0
1000000US060855052023125,060855052023125,"Block 3125, Block Group 3, Census Tract 5052.02, Santa Clara County, California",0,0,0
1000000US060855052023126,060855052023126,"Block 3126, Block Group 3, Census Tract 5052.02, Santa Clara County, California",0,0,0
1000000US060855052023127,060855052023127,"Block 3127, Block Group 3, Census Tract 5052.02, Santa Clara County, California",0,0,0
1000000US060855052023128,060855052023128,"Block 3128, Block Group 3, Census Tract 5052.02, Santa Clara County, California",0,0,0
1000000US060855052023129,060855052023129,"Block 3129, Block Group 3, Census Tract 5052.02, Santa Clara County, California",0,0,0
1000000US060855052023130,060855052023130,"Block 3130, Block Group 3, Census Tract 5052.02, Santa Clara County, California",0,0,0
1000000US060855052023131,060855052023131,"Block 3131, Block Group 3, Census Tract 5052.02, Santa Clara County, California",0,0,0
1000000US060855052023132,060855052023132,"Block 3132, Block Group 3, Census Tract 5052.02, Santa Clara County, California",0,0,0
1000000US060855052023133,060855052023133,"Block 3133, Block Group 3, Census Tract 5052.02, Santa Clara County, California",0,0,0
1000000US060855052023134,060855052023134,"Block 3134, Block Group 3, Census Tract 5052.02, Santa Clara County, California",0,0,0
1000000US060855052023135,060855052023135,"Block 3135, Block Group 3, Census Tract 5052.02, Santa Clara County, California",1,1,0
1000000US060855052023136,060855052023136,"Block 3136, Block Group 3, Census Tract 5052.02, Santa Clara County, California",0,0,0
1000000US060855052023137,060855052023137,"Block 3137, Block Group 3, Census Tract 5052.02, Santa Clara County, California",0,0,0
1000000US060855052023138,060855052023138,"Block 3138, Block Group 3, Census Tract 5052.02, Santa Clara County, California",0,0,0
1000000US060855052023139,060855052023139,"Block 3139, Block Group 3, Census Tract 5052.02, Santa Clara County, California",0,0,0
1000000US060855052023140,060855052023140,"Block 3140, Block Group 3, Census Tract 5052.02, Santa Clara County, California",0,0,0
1000000US060855052023141,060855052023141,"Block 3141, Block Group 3, Census Tract 5052.02, Santa Clara County, California",0,0,0
1000000US060855052023142,060855052023142,"Block 3142, Block Group 3, Census Tract 5052.02, Santa Clara County, California",0,0,0
1000000US060855052023143,060855052023143,"Block 3143, Block Group 3, Census Tract 5052.02, Santa Clara County, California",0,0,0
1000000US060855052023144,060855052023144,"Block 3144, Block Group 3, Census Tract 5052.02, Santa Clara County, California",0,0,0
1000000US060855052023145,060855052023145,"Block 3145, Block Group 3, Census Tract 5052.02, Santa Clara County, California",0,0,0
1000000US060855052023146,060855052023146,"Block 3146, Block Group 3, Census Tract 5052.02, Santa Clara County, California",0,0,0
1000000US060855052023147,060855052023147,"Block 3147, Block Group 3, Census Tract 5052.02, Santa Clara County, California",0,0,0
1000000US060855052023148,060855052023148,"Block 3148, Block Group 3, Census Tract 5052.02, Santa Clara County, California",0,0,0
1000000US060855052023149,060855052023149,"Block 3149, Block Group 3, Census Tract 5052.02, Santa Clara County, California",0,0,0
1000000US060855052023150,060855052023150,"Block 3150, Block Group 3, Census Tract 5052.02, Santa Clara County, California",0,0,0
1000000US060855052023151,060855052023151,"Block 3151, Block Group 3, Census Tract 5052.02, Santa Clara County, California",0,0,0
1000000US060855052023152,060855052023152,"Block 3152, Block Group 3, Census Tract 5052.02, Santa Clara County, California",0,0,0
1000000US060855052023153,060855052023153,"Block 3153, Block Group 3, Census Tract 5052.02, Santa Clara County, California",0,0,0
1000000US060855052023154,060855052023154,"Block 3154, Block Group 3, Census Tract 5052.02, Santa Clara County, California",42,40,2
1000000US060855052023155,060855052023155,"Block 3155, Block Group 3, Census Tract 5052.02, Santa Clara County, California",15,15,0
1000000US060855052023156,060855052023156,"Block 3156, Block Group 3, Census Tract 5052.02, Santa Clara County, California",13,13,0
1000000US060855052023157,060855052023157,"Block 3157, Block Group 3, Census Tract 5052.02, Santa Clara County, California",0,0,0
1000000US060855052023158,060855052023158,"Block 3158, Block Group 3, Census Tract 5052.02, Santa Clara County, California",0,0,0
1000000US060855052023159,060855052023159,"Block 3159, Block Group 3, Census Tract 5052.02, Santa Clara County, California",0,0,0
1000000US060855052023160,060855052023160,"Block 3160, Block Group 3, Census Tract 5052.02, Santa Clara County, California",0,0,0
1000000US060855052023161,060855052023161,"Block 3161, Block Group 3, Census Tract 5052.02, Santa Clara County, California",0,0,0
1000000US060855052023162,060855052023162,"Block 3162, Block Group 3, Census Tract 5052.02, Santa Clara County, California",0,0,0
1000000US060855052023163,060855052023163,"Block 3163, Block Group 3, Census Tract 5052.02, Santa Clara County, California",0,0,0
1000000US060855052023164,060855052023164,"Block 3164, Block Group 3, Census Tract 5052.02, Santa Clara County, California",3,3,0
1000000US060855052023165,060855052023165,"Block 3165, Block Group 3, Census Tract 5052.02, Santa Clara County, California",0,0,0
1000000US060855052023166,060855052023166,"Block 3166, Block Group 3, Census Tract 5052.02, Santa Clara County, California",4,4,0
1000000US060855052023167,060855052023167,"Block 3167, Block Group 3, Census Tract 5052.02, Santa Clara County, California",0,0,0
1000000US060855052023168,060855052023168,"Block 3168, Block Group 3, Census Tract 5052.02, Santa Clara County, California",0,0,0
1000000US060855052023169,060855052023169,"Block 3169, Block Group 3, Census Tract 5052.02, Santa Clara County, California",0,0,0
1000000US060855052023170,060855052023170,"Block 3170, Block Group 3, Census Tract 5052.02, Santa Clara County, California",0,0,0
1000000US060855052023171,060855052023171,"Block 3171, Block Group 3, Census Tract 5052.02, Santa Clara County, California",0,0,0
1000000US060855052023172,060855052023172,"Block 3172, Block Group 3, Census Tract 5052.02, Santa Clara County, California",0,0,0
1000000US060855052023173,060855052023173,"Block 3173, Block Group 3, Census Tract 5052.02, Santa Clara County, California",0,0,0
1000000US060855052023174,060855052023174,"Block 3174, Block Group 3, Census Tract 5052.02, Santa Clara County, California",0,0,0
1000000US060855052023175,060855052023175,"Block 3175, Block Group 3, Census Tract 5052.02, Santa Clara County, California",0,0,0
1000000US060855052023176,060855052023176,"Block 3176, Block Group 3, Census Tract 5052.02, Santa Clara County, California",0,0,0
1000000US060855052023177,060855052023177,"Block 3177, Block Group 3, Census Tract 5052.02, Santa Clara County, California",0,0,0
1000000US060855052023178,060855052023178,"Block 3178, Block Group 3, Census Tract 5052.02, Santa Clara County, California",0,0,0
1000000US060855052023179,060855052023179,"Block 3179, Block Group 3, Census Tract 5052.02, Santa Clara County, California",0,0,0
1000000US060855052023180,060855052023180,"Block 3180, Block Group 3, Census Tract 5052.02, Santa Clara County, California",0,0,0
1000000US060855052023181,060855052023181,"Block 3181, Block Group 3, Census Tract 5052.02, Santa Clara County, California",0,0,0
1000000US060855052023182,060855052023182,"Block 3182, Block Group 3, Census Tract 5052.02, Santa Clara County, California",0,0,0
1000000US060855052023183,060855052023183,"Block 3183, Block Group 3, Census Tract 5052.02, Santa Clara County, California",0,0,0
1000000US060855052023184,060855052023184,"Block 3184, Block Group 3, Census Tract 5052.02, Santa Clara County, California",0,0,0
1000000US060855052023185,060855052023185,"Block 3185, Block Group 3, Census Tract 5052.02, Santa Clara County, California",30,28,2
1000000US060855052023186,060855052023186,"Block 3186, Block Group 3, Census Tract 5052.02, Santa Clara County, California",265,247,18
1000000US060855052023187,060855052023187,"Block 3187, Block Group 3, Census Tract 5052.02, Santa Clara County, California",0,0,0
1000000US060855052023188,060855052023188,"Block 3188, Block Group 3, Census Tract 5052.02, Santa Clara County, California",0,0,0
1000000US060855052023189,060855052023189,"Block 3189, Block Group 3, Census Tract 5052.02, Santa Clara County, California",1,1,0
1000000US060855052023190,060855052023190,"Block 3190, Block Group 3, Census Tract 5052.02, Santa Clara County, California",0,0,0
1000000US060855052023191,060855052023191,"Block 3191, Block Group 3, Census Tract 5052.02, Santa Clara County, California",0,0,0
1000000US060855052023192,060855052023192,"Block 3192, Block Group 3, Census Tract 5052.02, Santa Clara County, California",0,0,0
1000000US060855052023193,060855052023193,"Block 3193, Block Group 3, Census Tract 5052.02, Santa Clara County, California",0,0,0
1000000US060855052023194,060855052023194,"Block 3194, Block Group 3, Census Tract 5052.02, Santa Clara County, California",0,0,0
1000000US060855052023195,060855052023195,"Block 3195, Block Group 3, Census Tract 5052.02, Santa Clara County, California",0,0,0
1000000US060855052023196,060855052023196,"Block 3196, Block Group 3, Census Tract 5052.02, Santa Clara County, California",43,41,2
1000000US060855052023197,060855052023197,"Block 3197, Block Group 3, Census Tract 5052.02, Santa Clara County, California",0,0,0
1000000US060855052023198,060855052023198,"Block 3198, Block Group 3, Census Tract 5052.02, Santa Clara County, California",0,0,0
1000000US060855052023199,060855052023199,"Block 3199, Block Group 3, Census Tract 5052.02, Santa Clara County, California",0,0,0
1000000US060855052023200,060855052023200,"Block 3200, Block Group 3, Census Tract 5052.02, Santa Clara County, California",0,0,0
1000000US060855052023201,060855052023201,"Block 3201, Block Group 3, Census Tract 5052.02, Santa Clara County, California",0,0,0
1000000US060855052023202,060855052023202,"Block 3202, Block Group 3, Census Tract 5052.02, Santa Clara County, California",0,0,0
1000000US060855052023203,060855052023203,"Block 3203, Block Group 3, Census Tract 5052.02, Santa Clara County, California",0,0,0
1000000US060855052023204,060855052023204,"Block 3204, Block Group 3, Census Tract 5052.02, Santa Clara County, California",0,0,0
1000000US060855052023205,060855052023205,"Block 3205, Block Group 3, Census Tract 5052.02, Santa Clara County, California",12,10,2
1000000US060855052023206,060855052023206,"Block 3206, Block Group 3, Census Tract 5052.02, Santa Clara County, California",6,6,0
1000000US060855052023207,060855052023207,"Block 3207, Block Group 3, Census Tract 5052.02, Santa Clara County, California",0,0,0
1000000US060855052023208,060855052023208,"Block 3208, Block Group 3, Census Tract 5052.02, Santa Clara County, California",0,0,0
1000000US060855052023209,060855052023209,"Block 3209, Block Group 3, Census Tract 5052.02, Santa Clara County, California",0,0,0
1000000US060855052023210,060855052023210,"Block 3210, Block Group 3, Census Tract 5052.02, Santa Clara County, California",0,0,0
1000000US060855052023211,060855052023211,"Block 3211, Block Group 3, Census Tract 5052.02, Santa Clara County, California",0,0,0
1000000US060855052023212,060855052023212,"Block 3212, Block Group 3, Census Tract 5052.02, Santa Clara County, California",0,0,0
1000000US060855052023213,060855052023213,"Block 3213, Block Group 3, Census Tract 5052.02, Santa Clara County, California",0,0,0
1000000US060855052023214,060855052023214,"Block 3214, Block Group 3, Census Tract 5052.02, Santa Clara County, California",0,0,0
1000000US060855052023215,060855052023215,"Block 3215, Block Group 3, Census Tract 5052.02, Santa Clara County, California",0,0,0
1000000US060855052031000,060855052031000,"Block 1000, Block Group 1, Census Tract 5052.03, Santa Clara County, California",16,16,0
1000000US060855052031001,060855052031001,"Block 1001, Block Group 1, Census Tract 5052.03, Santa Clara County, California",0,0,0
1000000US060855052031002,060855052031002,"Block 1002, Block Group 1, Census Tract 5052.03, Santa Clara County, California",0,0,0
1000000US060855052031003,060855052031003,"Block 1003, Block Group 1, Census Tract 5052.03, Santa Clara County, California",0,0,0
1000000US060855052031004,060855052031004,"Block 1004, Block Group 1, Census Tract 5052.03, Santa Clara County, California",0,0,0
1000000US060855052031005,060855052031005,"Block 1005, Block Group 1, Census Tract 5052.03, Santa Clara County, California",0,0,0
1000000US060855052031006,060855052031006,"Block 1006, Block Group 1, Census Tract 5052.03, Santa Clara County, California",0,0,0
1000000US060855052031007,060855052031007,"Block 1007, Block Group 1, Census Tract 5052.03, Santa Clara County, California",0,0,0
1000000US060855052031008,060855052031008,"Block 1008, Block Group 1, Census Tract 5052.03, Santa Clara County, California",110,108,2
1000000US060855052031009,060855052031009,"Block 1009, Block Group 1, Census Tract 5052.03, Santa Clara County, California",46,46,0
1000000US060855052031010,060855052031010,"Block 1010, Block Group 1, Census Tract 5052.03, Santa Clara County, California",22,22,0
1000000US060855052031011,060855052031011,"Block 1011, Block Group 1, Census Tract 5052.03, Santa Clara County, California",24,23,1
1000000US060855052031012,060855052031012,"Block 1012, Block Group 1, Census Tract 5052.03, Santa Clara County, California",33,28,5
1000000US060855052031013,060855052031013,"Block 1013, Block Group 1, Census Tract 5052.03, Santa Clara County, California",23,23,0
1000000US060855052031014,060855052031014,"Block 1014, Block Group 1, Census Tract 5052.03, Santa Clara County, California",14,14,0
1000000US060855052031015,060855052031015,"Block 1015, Block Group 1, Census Tract 5052.03, Santa Clara County, California",38,38,0
1000000US060855052031016,060855052031016,"Block 1016, Block Group 1, Census Tract 5052.03, Santa Clara County, California",8,8,0
1000000US060855052031017,060855052031017,"Block 1017, Block Group 1, Census Tract 5052.03, Santa Clara County, California",60,51,9
1000000US060855052031018,060855052031018,"Block 1018, Block Group 1, Census Tract 5052.03, Santa Clara County, California",4,4,0
1000000US060855052031019,060855052031019,"Block 1019, Block Group 1, Census Tract 5052.03, Santa Clara County, California",0,0,0
1000000US060855052031020,060855052031020,"Block 1020, Block Group 1, Census Tract 5052.03, Santa Clara County, California",0,0,0
1000000US060855052031021,060855052031021,"Block 1021, Block Group 1, Census Tract 5052.03, Santa Clara County, California",0,0,0
1000000US060855052031022,060855052031022,"Block 1022, Block Group 1, Census Tract 5052.03, Santa Clara County, California",0,0,0
1000000US060855052031023,060855052031023,"Block 1023, Block Group 1, Census Tract 5052.03, Santa Clara County, California",0,0,0
1000000US060855052031024,060855052031024,"Block 1024, Block Group 1, Census Tract 5052.03, Santa Clara County, California",0,0,0
1000000US060855052031025,060855052031025,"Block 1025, Block Group 1, Census Tract 5052.03, Santa Clara County, California",0,0,0
1000000US060855052031026,060855052031026,"Block 1026, Block Group 1, Census Tract 5052.03, Santa Clara County, California",0,0,0
1000000US060855052031027,060855052031027,"Block 1027, Block Group 1, Census Tract 5052.03, Santa Clara County, California",6,6,0
1000000US060855052031028,060855052031028,"Block 1028, Block Group 1, Census Tract 5052.03, Santa Clara County, California",11,10,1
1000000US060855052031029,060855052031029,"Block 1029, Block Group 1, Census Tract 5052.03, Santa Clara County, California",301,292,9
1000000US060855052031030,060855052031030,"Block 1030, Block Group 1, Census Tract 5052.03, Santa Clara County, California",8,8,0
1000000US060855052031031,060855052031031,"Block 1031, Block Group 1, Census Tract 5052.03, Santa Clara County, California",21,13,8
1000000US060855052031032,060855052031032,"Block 1032, Block Group 1, Census Tract 5052.03, Santa Clara County, California",0,0,0
1000000US060855052031033,060855052031033,"Block 1033, Block Group 1, Census Tract 5052.03, Santa Clara County, California",26,20,6
1000000US060855052031034,060855052031034,"Block 1034, Block Group 1, Census Tract 5052.03, Santa Clara County, California",0,0,0
1000000US060855052031035,060855052031035,"Block 1035, Block Group 1, Census Tract 5052.03, Santa Clara County, California",0,0,0
1000000US060855052031036,060855052031036,"Block 1036, Block Group 1, Census Tract 5052.03, Santa Clara County, California",0,0,0
1000000US060855052031037,060855052031037,"Block 1037, Block Group 1, Census Tract 5052.03, Santa Clara County, California",0,0,0
1000000US060855052031038,060855052031038,"Block 1038, Block Group 1, Census Tract 5052.03, Santa Clara County, California",0,0,0
1000000US060855052031039,060855052031039,"Block 1039, Block Group 1, Census Tract 5052.03, Santa Clara County, California",0,0,0
1000000US060855052031040,060855052031040,"Block 1040, Block Group 1, Census Tract 5052.03, Santa Clara County, California",0,0,0
1000000US060855052031041,060855052031041,"Block 1041, Block Group 1, Census Tract 5052.03, Santa Clara County, California",0,0,0
1000000US060855052031042,060855052031042,"Block 1042, Block Group 1, Census Tract 5052.03, Santa Clara County, California",16,16,0
1000000US060855052031043,060855052031043,"Block 1043, Block Group 1, Census Tract 5052.03, Santa Clara County, California",0,0,0
1000000US060855052031044,060855052031044,"Block 1044, Block Group 1, Census Tract 5052.03, Santa Clara County, California",21,21,0
1000000US060855052031045,060855052031045,"Block 1045, Block Group 1, Census Tract 5052.03, Santa Clara County, California",46,42,4
1000000US060855052031046,060855052031046,"Block 1046, Block Group 1, Census Tract 5052.03, Santa Clara County, California",29,29,0
1000000US060855052031047,060855052031047,"Block 1047, Block Group 1, Census Tract 5052.03, Santa Clara County, California",13,12,1
1000000US060855052031048,060855052031048,"Block 1048, Block Group 1, Census Tract 5052.03, Santa Clara County, California",10,10,0
1000000US060855052031049,060855052031049,"Block 1049, Block Group 1, Census Tract 5052.03, Santa Clara County, California",0,0,0
1000000US060855052031050,060855052031050,"Block 1050, Block Group 1, Census Tract 5052.03, Santa Clara County, California",24,23,1
1000000US060855052031051,060855052031051,"Block 1051, Block Group 1, Census Tract 5052.03, Santa Clara County, California",63,61,2
1000000US060855052031052,060855052031052,"Block 1052, Block Group 1, Census Tract 5052.03, Santa Clara County, California",15,15,0
1000000US060855052031053,060855052031053,"Block 1053, Block Group 1, Census Tract 5052.03, Santa Clara County, California",38,37,1
1000000US060855052031054,060855052031054,"Block 1054, Block Group 1, Census Tract 5052.03, Santa Clara County, California",0,0,0
1000000US060855052031055,060855052031055,"Block 1055, Block Group 1, Census Tract 5052.03, Santa Clara County, California",11,11,0
1000000US060855052031056,060855052031056,"Block 1056, Block Group 1, Census Tract 5052.03, Santa Clara County, California",1,1,0
1000000US060855052031057,060855052031057,"Block 1057, Block Group 1, Census Tract 5052.03, Santa Clara County, California",7,7,0
1000000US060855052031058,060855052031058,"Block 1058, Block Group 1, Census Tract 5052.03, Santa Clara County, California",0,0,0
1000000US060855052031059,060855052031059,"Block 1059, Block Group 1, Census Tract 5052.03, Santa Clara County, California",0,0,0
1000000US060855052032000,060855052032000,"Block 2000, Block Group 2, Census Tract 5052.03, Santa Clara County, California",26,21,5
1000000US060855052032001,060855052032001,"Block 2001, Block Group 2, Census Tract 5052.03, Santa Clara County, California",25,25,0
1000000US060855052032002,060855052032002,"Block 2002, Block Group 2, Census Tract 5052.03, Santa Clara County, California",43,42,1
1000000US060855052032003,060855052032003,"Block 2003, Block Group 2, Census Tract 5052.03, Santa Clara County, California",17,16,1
1000000US060855052032004,060855052032004,"Block 2004, Block Group 2, Census Tract 5052.03, Santa Clara County, California",63,59,4
1000000US060855052032005,060855052032005,"Block 2005, Block Group 2, Census Tract 5052.03, Santa Clara County, California",23,20,3
1000000US060855052032006,060855052032006,"Block 2006, Block Group 2, Census Tract 5052.03, Santa Clara County, California",9,9,0
1000000US060855052032007,060855052032007,"Block 2007, Block Group 2, Census Tract 5052.03, Santa Clara County, California",32,32,0
1000000US060855052032008,060855052032008,"Block 2008, Block Group 2, Census Tract 5052.03, Santa Clara County, California",43,39,4
1000000US060855052032009,060855052032009,"Block 2009, Block Group 2, Census Tract 5052.03, Santa Clara County, California",12,12,0
1000000US060855052032010,060855052032010,"Block 2010, Block Group 2, Census Tract 5052.03, Santa Clara County, California",21,20,1
1000000US060855052032011,060855052032011,"Block 2011, Block Group 2, Census Tract 5052.03, Santa Clara County, California",79,74,5
1000000US060855052032012,060855052032012,"Block 2012, Block Group 2, Census Tract 5052.03, Santa Clara County, California",5,5,0
1000000US060855052032013,060855052032013,"Block 2013, Block Group 2, Census Tract 5052.03, Santa Clara County, California",28,24,4
1000000US060855052032014,060855052032014,"Block 2014, Block Group 2, Census Tract 5052.03, Santa Clara County, California",25,24,1
1000000US060855052032015,060855052032015,"Block 2015, Block Group 2, Census Tract 5052.03, Santa Clara County, California",17,15,2
1000000US060855053011000,060855053011000,"Block 1000, Block Group 1, Census Tract 5053.01, Santa Clara County, California",60,57,3
1000000US060855053011001,060855053011001,"Block 1001, Block Group 1, Census Tract 5053.01, Santa Clara County, California",16,16,0
1000000US060855053011002,060855053011002,"Block 1002, Block Group 1, Census Tract 5053.01, Santa Clara County, California",52,46,6
1000000US060855053011003,060855053011003,"Block 1003, Block Group 1, Census Tract 5053.01, Santa Clara County, California",0,0,0
1000000US060855053011004,060855053011004,"Block 1004, Block Group 1, Census Tract 5053.01, Santa Clara County, California",63,61,2
1000000US060855053011005,060855053011005,"Block 1005, Block Group 1, Census Tract 5053.01, Santa Clara County, California",54,53,1
1000000US060855053011006,060855053011006,"Block 1006, Block Group 1, Census Tract 5053.01, Santa Clara County, California",50,46,4
1000000US060855053011007,060855053011007,"Block 1007, Block Group 1, Census Tract 5053.01, Santa Clara County, California",55,51,4
1000000US060855053012000,060855053012000,"Block 2000, Block Group 2, Census Tract 5053.01, Santa Clara County, California",88,87,1
1000000US060855053012001,060855053012001,"Block 2001, Block Group 2, Census Tract 5053.01, Santa Clara County, California",26,25,1
1000000US060855053012002,060855053012002,"Block 2002, Block Group 2, Census Tract 5053.01, Santa Clara County, California",31,31,0
1000000US060855053012003,060855053012003,"Block 2003, Block Group 2, Census Tract 5053.01, Santa Clara County, California",17,17,0
1000000US060855053012004,060855053012004,"Block 2004, Block Group 2, Census Tract 5053.01, Santa Clara County, California",44,44,0
1000000US060855053012005,060855053012005,"Block 2005, Block Group 2, Census Tract 5053.01, Santa Clara County, California",33,33,0
1000000US060855053013000,060855053013000,"Block 3000, Block Group 3, Census Tract 5053.01, Santa Clara County, California",40,38,2
1000000US060855053013001,060855053013001,"Block 3001, Block Group 3, Census Tract 5053.01, Santa Clara County, California",38,37,1
1000000US060855053013002,060855053013002,"Block 3002, Block Group 3, Census Tract 5053.01, Santa Clara County, California",34,31,3
1000000US060855053013003,060855053013003,"Block 3003, Block Group 3, Census Tract 5053.01, Santa Clara County, California",28,26,2
1000000US060855053013004,060855053013004,"Block 3004, Block Group 3, Census Tract 5053.01, Santa Clara County, California",26,26,0
1000000US060855053013005,060855053013005,"Block 3005, Block Group 3, Census Tract 5053.01, Santa Clara County, California",34,33,1
1000000US060855053014000,060855053014000,"Block 4000, Block Group 4, Census Tract 5053.01, Santa Clara County, California",152,140,12
1000000US060855053014001,060855053014001,"Block 4001, Block Group 4, Census Tract 5053.01, Santa Clara County, California",55,55,0
1000000US060855053014002,060855053014002,"Block 4002, Block Group 4, Census Tract 5053.01, Santa Clara County, California",0,0,0
1000000US060855053014003,060855053014003,"Block 4003, Block Group 4, Census Tract 5053.01, Santa Clara County, California",0,0,0
1000000US060855053014004,060855053014004,"Block 4004, Block Group 4, Census Tract 5053.01, Santa Clara County, California",0,0,0
1000000US060855053014005,060855053014005,"Block 4005, Block Group 4, Census Tract 5053.01, Santa Clara County, California",23,22,1
1000000US060855053014006,060855053014006,"Block 4006, Block Group 4, Census Tract 5053.01, Santa Clara County, California",45,45,0
1000000US060855053014007,060855053014007,"Block 4007, Block Group 4, Census Tract 5053.01, Santa Clara County, California",29,29,0
1000000US060855053014008,060855053014008,"Block 4008, Block Group 4, Census Tract 5053.01, Santa Clara County, California",172,168,4
1000000US060855053014009,060855053014009,"Block 4009, Block Group 4, Census Tract 5053.01, Santa Clara County, California",0,0,0
1000000US060855053014010,060855053014010,"Block 4010, Block Group 4, Census Tract 5053.01, Santa Clara County, California",0,0,0
1000000US060855053014011,060855053014011,"Block 4011, Block Group 4, Census Tract 5053.01, Santa Clara County, California",0,0,0
1000000US060855053014012,060855053014012,"Block 4012, Block Group 4, Census Tract 5053.01, Santa Clara County, California",89,87,2
1000000US060855053014013,060855053014013,"Block 4013, Block Group 4, Census Tract 5053.01, Santa Clara County, California",19,19,0
1000000US060855053021000,060855053021000,"Block 1000, Block Group 1, Census Tract 5053.02, Santa Clara County, California",6,5,1
1000000US060855053021001,060855053021001,"Block 1001, Block Group 1, Census Tract 5053.02, Santa Clara County, California",175,169,6
1000000US060855053021002,060855053021002,"Block 1002, Block Group 1, Census Tract 5053.02, Santa Clara County, California",0,0,0
1000000US060855053021003,060855053021003,"Block 1003, Block Group 1, Census Tract 5053.02, Santa Clara County, California",44,42,2
1000000US060855053021004,060855053021004,"Block 1004, Block Group 1, Census Tract 5053.02, Santa Clara County, California",0,0,0
1000000US060855053021005,060855053021005,"Block 1005, Block Group 1, Census Tract 5053.02, Santa Clara County, California",0,0,0
1000000US060855053021006,060855053021006,"Block 1006, Block Group 1, Census Tract 5053.02, Santa Clara County, California",0,0,0
1000000US060855053021007,060855053021007,"Block 1007, Block Group 1, Census Tract 5053.02, Santa Clara County, California",179,169,10
1000000US060855053021008,060855053021008,"Block 1008, Block Group 1, Census Tract 5053.02, Santa Clara County, California",16,16,0
1000000US060855053021009,060855053021009,"Block 1009, Block Group 1, Census Tract 5053.02, Santa Clara County, California",17,15,2
1000000US060855053021010,060855053021010,"Block 1010, Block Group 1, Census Tract 5053.02, Santa Clara County, California",84,83,1
1000000US060855053021011,060855053021011,"Block 1011, Block Group 1, Census Tract 5053.02, Santa Clara County, California",32,31,1
1000000US060855053021012,060855053021012,"Block 1012, Block Group 1, Census Tract 5053.02, Santa Clara County, California",16,16,0
1000000US060855053021013,060855053021013,"Block 1013, Block Group 1, Census Tract 5053.02, Santa Clara County, California",0,0,0
1000000US060855053021014,060855053021014,"Block 1014, Block Group 1, Census Tract 5053.02, Santa Clara County, California",34,32,2
1000000US060855053021015,060855053021015,"Block 1015, Block Group 1, Census Tract 5053.02, Santa Clara County, California",26,26,0
1000000US060855053021016,060855053021016,"Block 1016, Block Group 1, Census Tract 5053.02, Santa Clara County, California",42,42,0
1000000US060855053021017,060855053021017,"Block 1017, Block Group 1, Census Tract 5053.02, Santa Clara County, California",27,27,0
1000000US060855053021018,060855053021018,"Block 1018, Block Group 1, Census Tract 5053.02, Santa Clara County, California",0,0,0
1000000US060855053021019,060855053021019,"Block 1019, Block Group 1, Census Tract 5053.02, Santa Clara County, California",0,0,0
1000000US060855053021020,060855053021020,"Block 1020, Block Group 1, Census Tract 5053.02, Santa Clara County, California",0,0,0
1000000US060855053021021,060855053021021,"Block 1021, Block Group 1, Census Tract 5053.02, Santa Clara County, California",46,46,0
1000000US060855053021022,060855053021022,"Block 1022, Block Group 1, Census Tract 5053.02, Santa Clara County, California",23,22,1
1000000US060855053021023,060855053021023,"Block 1023, Block Group 1, Census Tract 5053.02, Santa Clara County, California",61,58,3
1000000US060855053021024,060855053021024,"Block 1024, Block Group 1, Census Tract 5053.02, Santa Clara County, California",0,0,0
1000000US060855053021025,060855053021025,"Block 1025, Block Group 1, Census Tract 5053.02, Santa Clara County, California",0,0,0
1000000US060855053021026,060855053021026,"Block 1026, Block Group 1, Census Tract 5053.02, Santa Clara County, California",54,53,1
1000000US060855053021027,060855053021027,"Block 1027, Block Group 1, Census Tract 5053.02, Santa Clara County, California",35,34,1
1000000US060855053021028,060855053021028,"Block 1028, Block Group 1, Census Tract 5053.02, Santa Clara County, California",0,0,0
1000000US060855053021029,060855053021029,"Block 1029, Block Group 1, Census Tract 5053.02, Santa Clara County, California",0,0,0
1000000US060855053021030,060855053021030,"Block 1030, Block Group 1, Census Tract 5053.02, Santa Clara County, California",0,0,0
1000000US060855053021031,060855053021031,"Block 1031, Block Group 1, Census Tract 5053.02, Santa Clara County, California",49,48,1
1000000US060855053021032,060855053021032,"Block 1032, Block Group 1, Census Tract 5053.02, Santa Clara County, California",27,26,1
1000000US060855053022000,060855053022000,"Block 2000, Block Group 2, Census Tract 5053.02, Santa Clara County, California",9,9,0
1000000US060855053022001,060855053022001,"Block 2001, Block Group 2, Census Tract 5053.02, Santa Clara County, California",0,0,0
1000000US060855053022002,060855053022002,"Block 2002, Block Group 2, Census Tract 5053.02, Santa Clara County, California",12,12,0
1000000US060855053022003,060855053022003,"Block 2003, Block Group 2, Census Tract 5053.02, Santa Clara County, California",29,28,1
1000000US060855053022004,060855053022004,"Block 2004, Block Group 2, Census Tract 5053.02, Santa Clara County, California",27,27,0
1000000US060855053022005,060855053022005,"Block 2005, Block Group 2, Census Tract 5053.02, Santa Clara County, California",44,41,3
1000000US060855053022006,060855053022006,"Block 2006, Block Group 2, Census Tract 5053.02, Santa Clara County, California",0,0,0
1000000US060855053022007,060855053022007,"Block 2007, Block Group 2, Census Tract 5053.02, Santa Clara County, California",0,0,0
1000000US060855053022008,060855053022008,"Block 2008, Block Group 2, Census Tract 5053.02, Santa Clara County, California",0,0,0
1000000US060855053022009,060855053022009,"Block 2009, Block Group 2, Census Tract 5053.02, Santa Clara County, California",34,34,0
1000000US060855053022010,060855053022010,"Block 2010, Block Group 2, Census Tract 5053.02, Santa Clara County, California",37,36,1
1000000US060855053022011,060855053022011,"Block 2011, Block Group 2, Census Tract 5053.02, Santa Clara County, California",21,21,0
1000000US060855053022012,060855053022012,"Block 2012, Block Group 2, Census Tract 5053.02, Santa Clara County, California",0,0,0
1000000US060855053022013,060855053022013,"Block 2013, Block Group 2, Census Tract 5053.02, Santa Clara County, California",0,0,0
1000000US060855053022014,060855053022014,"Block 2014, Block Group 2, Census Tract 5053.02, Santa Clara County, California",10,10,0
1000000US060855053022015,060855053022015,"Block 2015, Block Group 2, Census Tract 5053.02, Santa Clara County, California",22,21,1
1000000US060855053022016,060855053022016,"Block 2016, Block Group 2, Census Tract 5053.02, Santa Clara County, California",43,42,1
1000000US060855053022017,060855053022017,"Block 2017, Block Group 2, Census Tract 5053.02, Santa Clara County, California",62,55,7
1000000US060855053022018,060855053022018,"Block 2018, Block Group 2, Census Tract 5053.02, Santa Clara County, California",24,21,3
1000000US060855053022019,060855053022019,"Block 2019, Block Group 2, Census Tract 5053.02, Santa Clara County, California",24,23,1
1000000US060855053022020,060855053022020,"Block 2020, Block Group 2, Census Tract 5053.02, Santa Clara County, California",24,22,2
1000000US060855053022021,060855053022021,"Block 2021, Block Group 2, Census Tract 5053.02, Santa Clara County, California",13,12,1
1000000US060855053022022,060855053022022,"Block 2022, Block Group 2, Census Tract 5053.02, Santa Clara County, California",25,24,1
1000000US060855053022023,060855053022023,"Block 2023, Block Group 2, Census Tract 5053.02, Santa Clara County, California",22,22,0
1000000US060855053022024,060855053022024,"Block 2024, Block Group 2, Census Tract 5053.02, Santa Clara County, California",0,0,0
1000000US060855053022025,060855053022025,"Block 2025, Block Group 2, Census Tract 5053.02, Santa Clara County, California",0,0,0
1000000US060855053022026,060855053022026,"Block 2026, Block Group 2, Census Tract 5053.02, Santa Clara County, California",0,0,0
1000000US060855053022027,060855053022027,"Block 2027, Block Group 2, Census Tract 5053.02, Santa Clara County, California",0,0,0
1000000US060855053022028,060855053022028,"Block 2028, Block Group 2, Census Tract 5053.02, Santa Clara County, California",0,0,0
1000000US060855053022029,060855053022029,"Block 2029, Block Group 2, Census Tract 5053.02, Santa Clara County, California",0,0,0
1000000US060855053022030,060855053022030,"Block 2030, Block Group 2, Census Tract 5053.02, Santa Clara County, California",0,0,0
1000000US060855053031000,060855053031000,"Block 1000, Block Group 1, Census Tract 5053.03, Santa Clara County, California",0,0,0
1000000US060855053031001,060855053031001,"Block 1001, Block Group 1, Census Tract 5053.03, Santa Clara County, California",0,0,0
1000000US060855053031002,060855053031002,"Block 1002, Block Group 1, Census Tract 5053.03, Santa Clara County, California",265,249,16
1000000US060855053031003,060855053031003,"Block 1003, Block Group 1, Census Tract 5053.03, Santa Clara County, California",0,0,0
1000000US060855053031004,060855053031004,"Block 1004, Block Group 1, Census Tract 5053.03, Santa Clara County, California",0,0,0
1000000US060855053031005,060855053031005,"Block 1005, Block Group 1, Census Tract 5053.03, Santa Clara County, California",0,0,0
1000000US060855053031006,060855053031006,"Block 1006, Block Group 1, Census Tract 5053.03, Santa Clara County, California",0,0,0
1000000US060855053031007,060855053031007,"Block 1007, Block Group 1, Census Tract 5053.03, Santa Clara County, California",0,0,0
1000000US060855053031008,060855053031008,"Block 1008, Block Group 1, Census Tract 5053.03, Santa Clara County, California",0,0,0
1000000US060855053031009,060855053031009,"Block 1009, Block Group 1, Census Tract 5053.03, Santa Clara County, California",0,0,0
1000000US060855053031010,060855053031010,"Block 1010, Block Group 1, Census Tract 5053.03, Santa Clara County, California",50,48,2
1000000US060855053031011,060855053031011,"Block 1011, Block Group 1, Census Tract 5053.03, Santa Clara County, California",40,40,0
1000000US060855053031012,060855053031012,"Block 1012, Block Group 1, Census Tract 5053.03, Santa Clara County, California",246,234,12
1000000US060855053031013,060855053031013,"Block 1013, Block Group 1, Census Tract 5053.03, Santa Clara County, California",35,35,0
1000000US060855053031014,060855053031014,"Block 1014, Block Group 1, Census Tract 5053.03, Santa Clara County, California",86,81,5
1000000US060855053032000,060855053032000,"Block 2000, Block Group 2, Census Tract 5053.03, Santa Clara County, California",0,0,0
1000000US060855053032001,060855053032001,"Block 2001, Block Group 2, Census Tract 5053.03, Santa Clara County, California",139,136,3
1000000US060855053032002,060855053032002,"Block 2002, Block Group 2, Census Tract 5053.03, Santa Clara County, California",42,41,1
1000000US060855053032003,060855053032003,"Block 2003, Block Group 2, Census Tract 5053.03, Santa Clara County, California",98,91,7
1000000US060855053032004,060855053032004,"Block 2004, Block Group 2, Census Tract 5053.03, Santa Clara County, California",209,196,13
1000000US060855053032005,060855053032005,"Block 2005, Block Group 2, Census Tract 5053.03, Santa Clara County, California",0,0,0
1000000US060855053032006,060855053032006,"Block 2006, Block Group 2, Census Tract 5053.03, Santa Clara County, California",25,22,3
1000000US060855053032007,060855053032007,"Block 2007, Block Group 2, Census Tract 5053.03, Santa Clara County, California",24,24,0
1000000US060855053032008,060855053032008,"Block 2008, Block Group 2, Census Tract 5053.03, Santa Clara County, California",24,23,1
1000000US060855053032009,060855053032009,"Block 2009, Block Group 2, Census Tract 5053.03, Santa Clara County, California",24,24,0
1000000US060855053032010,060855053032010,"Block 2010, Block Group 2, Census Tract 5053.03, Santa Clara County, California",24,24,0
1000000US060855053032011,060855053032011,"Block 2011, Block Group 2, Census Tract 5053.03, Santa Clara County, California",25,25,0
1000000US060855053032012,060855053032012,"Block 2012, Block Group 2, Census Tract 5053.03, Santa Clara County, California",9,8,1
1000000US060855053032013,060855053032013,"Block 2013, Block Group 2, Census Tract 5053.03, Santa Clara County, California",0,0,0
1000000US060855053033000,060855053033000,"Block 3000, Block Group 3, Census Tract 5053.03, Santa Clara County, California",24,24,0
1000000US060855053033001,060855053033001,"Block 3001, Block Group 3, Census Tract 5053.03, Santa Clara County, California",17,16,1
1000000US060855053033002,060855053033002,"Block 3002, Block Group 3, Census Tract 5053.03, Santa Clara County, California",0,0,0
1000000US060855053033003,060855053033003,"Block 3003, Block Group 3, Census Tract 5053.03, Santa Clara County, California",0,0,0
1000000US060855053033004,060855053033004,"Block 3004, Block Group 3, Census Tract 5053.03, Santa Clara County, California",27,23,4
1000000US060855053033005,060855053033005,"Block 3005, Block Group 3, Census Tract 5053.03, Santa Clara County, California",24,24,0
1000000US060855053033006,060855053033006,"Block 3006, Block Group 3, Census Tract 5053.03, Santa Clara County, California",0,0,0
1000000US060855053033007,060855053033007,"Block 3007, Block Group 3, Census Tract 5053.03, Santa Clara County, California",24,24,0
1000000US060855053033008,060855053033008,"Block 3008, Block Group 3, Census Tract 5053.03, Santa Clara County, California",24,24,0
1000000US060855053033009,060855053033009,"Block 3009, Block Group 3, Census Tract 5053.03, Santa Clara County, California",24,24,0
1000000US060855053033010,060855053033010,"Block 3010, Block Group 3, Census Tract 5053.03, Santa Clara County, California",0,0,0
1000000US060855053033011,060855053033011,"Block 3011, Block Group 3, Census Tract 5053.03, Santa Clara County, California",0,0,0
1000000US060855053033012,060855053033012,"Block 3012, Block Group 3, Census Tract 5053.03, Santa Clara County, California",25,24,1
1000000US060855053033013,060855053033013,"Block 3013, Block Group 3, Census Tract 5053.03, Santa Clara County, California",24,24,0
1000000US060855053033014,060855053033014,"Block 3014, Block Group 3, Census Tract 5053.03, Santa Clara County, California",24,24,0
1000000US060855053033015,060855053033015,"Block 3015, Block Group 3, Census Tract 5053.03, Santa Clara County, California",24,24,0
1000000US060855053034000,060855053034000,"Block 4000, Block Group 4, Census Tract 5053.03, Santa Clara County, California",0,0,0
1000000US060855053034001,060855053034001,"Block 4001, Block Group 4, Census Tract 5053.03, Santa Clara County, California",331,314,17
1000000US060855053034002,060855053034002,"Block 4002, Block Group 4, Census Tract 5053.03, Santa Clara County, California",16,16,0
1000000US060855053034003,060855053034003,"Block 4003, Block Group 4, Census Tract 5053.03, Santa Clara County, California",88,86,2
1000000US060855053034004,060855053034004,"Block 4004, Block Group 4, Census Tract 5053.03, Santa Clara County, California",28,25,3
1000000US060855053034005,060855053034005,"Block 4005, Block Group 4, Census Tract 5053.03, Santa Clara County, California",107,104,3
1000000US060855053034006,060855053034006,"Block 4006, Block Group 4, Census Tract 5053.03, Santa Clara County, California",0,0,0
1000000US060855053034007,060855053034007,"Block 4007, Block Group 4, Census Tract 5053.03, Santa Clara County, California",2,2,0
1000000US060855053041000,060855053041000,"Block 1000, Block Group 1, Census Tract 5053.04, Santa Clara County, California",0,0,0
1000000US060855053041001,060855053041001,"Block 1001, Block Group 1, Census Tract 5053.04, Santa Clara County, California",0,0,0
1000000US060855053041002,060855053041002,"Block 1002, Block Group 1, Census Tract 5053.04, Santa Clara County, California",0,0,0
1000000US060855053041003,060855053041003,"Block 1003, Block Group 1, Census Tract 5053.04, Santa Clara County, California",0,0,0
1000000US060855053041004,060855053041004,"Block 1004, Block Group 1, Census Tract 5053.04, Santa Clara County, California",0,0,0
1000000US060855053041005,060855053041005,"Block 1005, Block Group 1, Census Tract 5053.04, Santa Clara County, California",0,0,0
1000000US060855053041006,060855053041006,"Block 1006, Block Group 1, Census Tract 5053.04, Santa Clara County, California",0,0,0
1000000US060855053041007,060855053041007,"Block 1007, Block Group 1, Census Tract 5053.04, Santa Clara County, California",0,0,0
1000000US060855053041008,060855053041008,"Block 1008, Block Group 1, Census Tract 5053.04, Santa Clara County, California",27,27,0
1000000US060855053041009,060855053041009,"Block 1009, Block Group 1, Census Tract 5053.04, Santa Clara County, California",57,55,2
1000000US060855053041010,060855053041010,"Block 1010, Block Group 1, Census Tract 5053.04, Santa Clara County, California",16,15,1
1000000US060855053041011,060855053041011,"Block 1011, Block Group 1, Census Tract 5053.04, Santa Clara County, California",0,0,0
1000000US060855053041012,060855053041012,"Block 1012, Block Group 1, Census Tract 5053.04, Santa Clara County, California",43,42,1
1000000US060855053041013,060855053041013,"Block 1013, Block Group 1, Census Tract 5053.04, Santa Clara County, California",38,37,1
1000000US060855053041014,060855053041014,"Block 1014, Block Group 1, Census Tract 5053.04, Santa Clara County, California",18,17,1
1000000US060855053041015,060855053041015,"Block 1015, Block Group 1, Census Tract 5053.04, Santa Clara County, California",29,29,0
1000000US060855053041016,060855053041016,"Block 1016, Block Group 1, Census Tract 5053.04, Santa Clara County, California",37,37,0
1000000US060855053041017,060855053041017,"Block 1017, Block Group 1, Census Tract 5053.04, Santa Clara County, California",38,37,1
1000000US060855053041018,060855053041018,"Block 1018, Block Group 1, Census Tract 5053.04, Santa Clara County, California",0,0,0
1000000US060855053042000,060855053042000,"Block 2000, Block Group 2, Census Tract 5053.04, Santa Clara County, California",54,54,0
1000000US060855053042001,060855053042001,"Block 2001, Block Group 2, Census Tract 5053.04, Santa Clara County, California",0,0,0
1000000US060855053042002,060855053042002,"Block 2002, Block Group 2, Census Tract 5053.04, Santa Clara County, California",27,26,1
1000000US060855053042003,060855053042003,"Block 2003, Block Group 2, Census Tract 5053.04, Santa Clara County, California",14,14,0
1000000US060855053042004,060855053042004,"Block 2004, Block Group 2, Census Tract 5053.04, Santa Clara County, California",18,18,0
1000000US060855053042005,060855053042005,"Block 2005, Block Group 2, Census Tract 5053.04, Santa Clara County, California",18,18,0
1000000US060855053042006,060855053042006,"Block 2006, Block Group 2, Census Tract 5053.04, Santa Clara County, California",38,36,2
1000000US060855053042007,060855053042007,"Block 2007, Block Group 2, Census Tract 5053.04, Santa Clara County, California",89,86,3
1000000US060855053042008,060855053042008,"Block 2008, Block Group 2, Census Tract 5053.04, Santa Clara County, California",19,18,1
1000000US060855053042009,060855053042009,"Block 2009, Block Group 2, Census Tract 5053.04, Santa Clara County, California",6,6,0
1000000US060855053042010,060855053042010,"Block 2010, Block Group 2, Census Tract 5053.04, Santa Clara County, California",6,6,0
1000000US060855053042011,060855053042011,"Block 2011, Block Group 2, Census Tract 5053.04, Santa Clara County, California",7,6,1
1000000US060855053042012,060855053042012,"Block 2012, Block Group 2, Census Tract 5053.04, Santa Clara County, California",0,0,0
1000000US060855053042013,060855053042013,"Block 2013, Block Group 2, Census Tract 5053.04, Santa Clara County, California",0,0,0
1000000US060855053042014,060855053042014,"Block 2014, Block Group 2, Census Tract 5053.04, Santa Clara County, California",0,0,0
1000000US060855053042015,060855053042015,"Block 2015, Block Group 2, Census Tract 5053.04, Santa Clara County, California",0,0,0
1000000US060855053043000,060855053043000,"Block 3000, Block Group 3, Census Tract 5053.04, Santa Clara County, California",25,25,0
1000000US060855053043001,060855053043001,"Block 3001, Block Group 3, Census Tract 5053.04, Santa Clara County, California",48,46,2
1000000US060855053043002,060855053043002,"Block 3002, Block Group 3, Census Tract 5053.04, Santa Clara County, California",21,21,0
1000000US060855053043003,060855053043003,"Block 3003, Block Group 3, Census Tract 5053.04, Santa Clara County, California",32,28,4
1000000US060855053043004,060855053043004,"Block 3004, Block Group 3, Census Tract 5053.04, Santa Clara County, California",34,34,0
1000000US060855053043005,060855053043005,"Block 3005, Block Group 3, Census Tract 5053.04, Santa Clara County, California",32,32,0
1000000US060855053043006,060855053043006,"Block 3006, Block Group 3, Census Tract 5053.04, Santa Clara County, California",0,0,0
1000000US060855053043007,060855053043007,"Block 3007, Block Group 3, Census Tract 5053.04, Santa Clara County, California",31,30,1
1000000US060855053044000,060855053044000,"Block 4000, Block Group 4, Census Tract 5053.04, Santa Clara County, California",49,47,2
1000000US060855053044001,060855053044001,"Block 4001, Block Group 4, Census Tract 5053.04, Santa Clara County, California",46,46,0
1000000US060855053044002,060855053044002,"Block 4002, Block Group 4, Census Tract 5053.04, Santa Clara County, California",36,35,1
1000000US060855053044003,060855053044003,"Block 4003, Block Group 4, Census Tract 5053.04, Santa Clara County, California",61,61,0
1000000US060855053044004,060855053044004,"Block 4004, Block Group 4, Census Tract 5053.04, Santa Clara County, California",36,35,1
1000000US060855053044005,060855053044005,"Block 4005, Block Group 4, Census Tract 5053.04, Santa Clara County, California",46,45,1
1000000US060855053044006,060855053044006,"Block 4006, Block Group 4, Census Tract 5053.04, Santa Clara County, California",0,0,0
1000000US060855053051000,060855053051000,"Block 1000, Block Group 1, Census Tract 5053.05, Santa Clara County, California",0,0,0
1000000US060855053051001,060855053051001,"Block 1001, Block Group 1, Census Tract 5053.05, Santa Clara County, California",0,0,0
1000000US060855053051002,060855053051002,"Block 1002, Block Group 1, Census Tract 5053.05, Santa Clara County, California",25,24,1
1000000US060855053051003,060855053051003,"Block 1003, Block Group 1, Census Tract 5053.05, Santa Clara County, California",0,0,0
1000000US060855053051004,060855053051004,"Block 1004, Block Group 1, Census Tract 5053.05, Santa Clara County, California",214,179,35
1000000US060855053051005,060855053051005,"Block 1005, Block Group 1, Census Tract 5053.05, Santa Clara County, California",16,16,0
1000000US060855053051006,060855053051006,"Block 1006, Block Group 1, Census Tract 5053.05, Santa Clara County, California",24,23,1
1000000US060855053051007,060855053051007,"Block 1007, Block Group 1, Census Tract 5053.05, Santa Clara County, California",0,0,0
1000000US060855053051008,060855053051008,"Block 1008, Block Group 1, Census Tract 5053.05, Santa Clara County, California",28,26,2
1000000US060855053051009,060855053051009,"Block 1009, Block Group 1, Census Tract 5053.05, Santa Clara County, California",14,14,0
1000000US060855053051010,060855053051010,"Block 1010, Block Group 1, Census Tract 5053.05, Santa Clara County, California",34,34,0
1000000US060855053051011,060855053051011,"Block 1011, Block Group 1, Census Tract 5053.05, Santa Clara County, California",14,14,0
1000000US060855053051012,060855053051012,"Block 1012, Block Group 1, Census Tract 5053.05, Santa Clara County, California",41,40,1
1000000US060855053051013,060855053051013,"Block 1013, Block Group 1, Census Tract 5053.05, Santa Clara County, California",20,20,0
1000000US060855053051014,060855053051014,"Block 1014, Block Group 1, Census Tract 5053.05, Santa Clara County, California",27,26,1
1000000US060855053051015,060855053051015,"Block 1015, Block Group 1, Census Tract 5053.05, Santa Clara County, California",21,21,0
1000000US060855053051016,060855053051016,"Block 1016, Block Group 1, Census Tract 5053.05, Santa Clara County, California",24,22,2
1000000US060855053051017,060855053051017,"Block 1017, Block Group 1, Census Tract 5053.05, Santa Clara County, California",59,59,0
1000000US060855053052000,060855053052000,"Block 2000, Block Group 2, Census Tract 5053.05, Santa Clara County, California",21,21,0
1000000US060855053052001,060855053052001,"Block 2001, Block Group 2, Census Tract 5053.05, Santa Clara County, California",24,22,2
1000000US060855053052002,060855053052002,"Block 2002, Block Group 2, Census Tract 5053.05, Santa Clara County, California",0,0,0
1000000US060855053052003,060855053052003,"Block 2003, Block Group 2, Census Tract 5053.05, Santa Clara County, California",110,106,4
1000000US060855053052004,060855053052004,"Block 2004, Block Group 2, Census Tract 5053.05, Santa Clara County, California",16,16,0
1000000US060855053052005,060855053052005,"Block 2005, Block Group 2, Census Tract 5053.05, Santa Clara County, California",0,0,0
1000000US060855053052006,060855053052006,"Block 2006, Block Group 2, Census Tract 5053.05, Santa Clara County, California",42,42,0
1000000US060855053052007,060855053052007,"Block 2007, Block Group 2, Census Tract 5053.05, Santa Clara County, California",0,0,0
1000000US060855053052008,060855053052008,"Block 2008, Block Group 2, Census Tract 5053.05, Santa Clara County, California",73,73,0
1000000US060855053052009,060855053052009,"Block 2009, Block Group 2, Census Tract 5053.05, Santa Clara County, California",22,22,0
1000000US060855053052010,060855053052010,"Block 2010, Block Group 2, Census Tract 5053.05, Santa Clara County, California",20,19,1
1000000US060855053053000,060855053053000,"Block 3000, Block Group 3, Census Tract 5053.05, Santa Clara County, California",24,23,1
1000000US060855053053001,060855053053001,"Block 3001, Block Group 3, Census Tract 5053.05, Santa Clara County, California",40,38,2
1000000US060855053053002,060855053053002,"Block 3002, Block Group 3, Census Tract 5053.05, Santa Clara County, California",45,45,0
1000000US060855053053003,060855053053003,"Block 3003, Block Group 3, Census Tract 5053.05, Santa Clara County, California",120,118,2
1000000US060855053053004,060855053053004,"Block 3004, Block Group 3, Census Tract 5053.05, Santa Clara County, California",12,12,0
1000000US060855053053005,060855053053005,"Block 3005, Block Group 3, Census Tract 5053.05, Santa Clara County, California",0,0,0
1000000US060855053053006,060855053053006,"Block 3006, Block Group 3, Census Tract 5053.05, Santa Clara County, California",6,4,2
1000000US060855053053007,060855053053007,"Block 3007, Block Group 3, Census Tract 5053.05, Santa Clara County, California",0,0,0
1000000US060855053053008,060855053053008,"Block 3008, Block Group 3, Census Tract 5053.05, Santa Clara County, California",0,0,0
1000000US060855053053009,060855053053009,"Block 3009, Block Group 3, Census Tract 5053.05, Santa Clara County, California",0,0,0
1000000US060855053053010,060855053053010,"Block 3010, Block Group 3, Census Tract 5053.05, Santa Clara County, California",0,0,0
1000000US060855053053011,060855053053011,"Block 3011, Block Group 3, Census Tract 5053.05, Santa Clara County, California",0,0,0
1000000US060855053053012,060855053053012,"Block 3012, Block Group 3, Census Tract 5053.05, Santa Clara County, California",141,140,1
1000000US060855053053013,060855053053013,"Block 3013, Block Group 3, Census Tract 5053.05, Santa Clara County, California",28,28,0
1000000US060855053053014,060855053053014,"Block 3014, Block Group 3, Census Tract 5053.05, Santa Clara County, California",34,33,1
1000000US060855053053015,060855053053015,"Block 3015, Block Group 3, Census Tract 5053.05, Santa Clara County, California",25,24,1
1000000US060855053053016,060855053053016,"Block 3016, Block Group 3, Census Tract 5053.05, Santa Clara County, California",32,32,0
1000000US060855053053017,060855053053017,"Block 3017, Block Group 3, Census Tract 5053.05, Santa Clara County, California",79,77,2
1000000US060855053053018,060855053053018,"Block 3018, Block Group 3, Census Tract 5053.05, Santa Clara County, California",68,65,3
1000000US060855053053019,060855053053019,"Block 3019, Block Group 3, Census Tract 5053.05, Santa Clara County, California",5,5,0
1000000US060855053053020,060855053053020,"Block 3020, Block Group 3, Census Tract 5053.05, Santa Clara County, California",0,0,0
1000000US060855053053021,060855053053021,"Block 3021, Block Group 3, Census Tract 5053.05, Santa Clara County, California",0,0,0
1000000US060855053053022,060855053053022,"Block 3022, Block Group 3, Census Tract 5053.05, Santa Clara County, California",0,0,0
1000000US060855053053023,060855053053023,"Block 3023, Block Group 3, Census Tract 5053.05, Santa Clara County, California",0,0,0
1000000US060855053053024,060855053053024,"Block 3024, Block Group 3, Census Tract 5053.05, Santa Clara County, California",0,0,0
1000000US060855053053025,060855053053025,"Block 3025, Block Group 3, Census Tract 5053.05, Santa Clara County, California",0,0,0
1000000US060855053053026,060855053053026,"Block 3026, Block Group 3, Census Tract 5053.05, Santa Clara County, California",0,0,0
1000000US060855053053027,060855053053027,"Block 3027, Block Group 3, Census Tract 5053.05, Santa Clara County, California",7,7,0
1000000US060855053054000,060855053054000,"Block 4000, Block Group 4, Census Tract 5053.05, Santa Clara County, California",1,1,0
1000000US060855053054001,060855053054001,"Block 4001, Block Group 4, Census Tract 5053.05, Santa Clara County, California",16,15,1
1000000US060855053054002,060855053054002,"Block 4002, Block Group 4, Census Tract 5053.05, Santa Clara County, California",37,37,0
1000000US060855053054003,060855053054003,"Block 4003, Block Group 4, Census Tract 5053.05, Santa Clara County, California",69,68,1
1000000US060855053054004,060855053054004,"Block 4004, Block Group 4, Census Tract 5053.05, Santa Clara County, California",0,0,0
1000000US060855053054005,060855053054005,"Block 4005, Block Group 4, Census Tract 5053.05, Santa Clara County, California",13,13,0
1000000US060855053054006,060855053054006,"Block 4006, Block Group 4, Census Tract 5053.05, Santa Clara County, California",6,6,0
1000000US060855053054007,060855053054007,"Block 4007, Block Group 4, Census Tract 5053.05, Santa Clara County, California",14,14,0
1000000US060855053054008,060855053054008,"Block 4008, Block Group 4, Census Tract 5053.05, Santa Clara County, California",12,12,0
1000000US060855053054009,060855053054009,"Block 4009, Block Group 4, Census Tract 5053.05, Santa Clara County, California",104,104,0
1000000US060855053054010,060855053054010,"Block 4010, Block Group 4, Census Tract 5053.05, Santa Clara County, California",4,4,0
1000000US060855053054011,060855053054011,"Block 4011, Block Group 4, Census Tract 5053.05, Santa Clara County, California",62,61,1
1000000US060855053054012,060855053054012,"Block 4012, Block Group 4, Census Tract 5053.05, Santa Clara County, California",3,3,0
1000000US060855053054013,060855053054013,"Block 4013, Block Group 4, Census Tract 5053.05, Santa Clara County, California",0,0,0
1000000US060855053054014,060855053054014,"Block 4014, Block Group 4, Census Tract 5053.05, Santa Clara County, California",0,0,0
1000000US060855053054015,060855053054015,"Block 4015, Block Group 4, Census Tract 5053.05, Santa Clara County, California",56,56,0
1000000US060855053054016,060855053054016,"Block 4016, Block Group 4, Census Tract 5053.05, Santa Clara County, California",55,53,2
1000000US060855053054017,060855053054017,"Block 4017, Block Group 4, Census Tract 5053.05, Santa Clara County, California",29,28,1
1000000US060855053054018,060855053054018,"Block 4018, Block Group 4, Census Tract 5053.05, Santa Clara County, California",27,27,0
1000000US060855053054019,060855053054019,"Block 4019, Block Group 4, Census Tract 5053.05, Santa Clara County, California",21,20,1
1000000US060855053054020,060855053054020,"Block 4020, Block Group 4, Census Tract 5053.05, Santa Clara County, California",24,24,0
1000000US060855054011000,060855054011000,"Block 1000, Block Group 1, Census Tract 5054.01, Santa Clara County, California",20,17,3
1000000US060855054011001,060855054011001,"Block 1001, Block Group 1, Census Tract 5054.01, Santa Clara County, California",0,0,0
1000000US060855054011002,060855054011002,"Block 1002, Block Group 1, Census Tract 5054.01, Santa Clara County, California",47,46,1
1000000US060855054011003,060855054011003,"Block 1003, Block Group 1, Census Tract 5054.01, Santa Clara County, California",28,27,1
1000000US060855054011004,060855054011004,"Block 1004, Block Group 1, Census Tract 5054.01, Santa Clara County, California",15,14,1
1000000US060855054011005,060855054011005,"Block 1005, Block Group 1, Census Tract 5054.01, Santa Clara County, California",27,27,0
1000000US060855054011006,060855054011006,"Block 1006, Block Group 1, Census Tract 5054.01, Santa Clara County, California",31,30,1
1000000US060855054011007,060855054011007,"Block 1007, Block Group 1, Census Tract 5054.01, Santa Clara County, California",26,26,0
1000000US060855054011008,060855054011008,"Block 1008, Block Group 1, Census Tract 5054.01, Santa Clara County, California",82,81,1
1000000US060855054012000,060855054012000,"Block 2000, Block Group 2, Census Tract 5054.01, Santa Clara County, California",0,0,0
1000000US060855054012001,060855054012001,"Block 2001, Block Group 2, Census Tract 5054.01, Santa Clara County, California",0,0,0
1000000US060855054012002,060855054012002,"Block 2002, Block Group 2, Census Tract 5054.01, Santa Clara County, California",0,0,0
1000000US060855054012003,060855054012003,"Block 2003, Block Group 2, Census Tract 5054.01, Santa Clara County, California",76,73,3
1000000US060855054012004,060855054012004,"Block 2004, Block Group 2, Census Tract 5054.01, Santa Clara County, California",449,436,13
1000000US060855054012005,060855054012005,"Block 2005, Block Group 2, Census Tract 5054.01, Santa Clara County, California",22,22,0
1000000US060855054012006,060855054012006,"Block 2006, Block Group 2, Census Tract 5054.01, Santa Clara County, California",121,120,1
1000000US060855054012007,060855054012007,"Block 2007, Block Group 2, Census Tract 5054.01, Santa Clara County, California",124,28,96
1000000US060855054012008,060855054012008,"Block 2008, Block Group 2, Census Tract 5054.01, Santa Clara County, California",0,0,0
1000000US060855054012009,060855054012009,"Block 2009, Block Group 2, Census Tract 5054.01, Santa Clara County, California",13,13,0
1000000US060855054012010,060855054012010,"Block 2010, Block Group 2, Census Tract 5054.01, Santa Clara County, California",4,4,0
1000000US060855054012011,060855054012011,"Block 2011, Block Group 2, Census Tract 5054.01, Santa Clara County, California",0,0,0
1000000US060855054012012,060855054012012,"Block 2012, Block Group 2, Census Tract 5054.01, Santa Clara County, California",2,0,2
1000000US060855054012013,060855054012013,"Block 2013, Block Group 2, Census Tract 5054.01, Santa Clara County, California",0,0,0
1000000US060855054012014,060855054012014,"Block 2014, Block Group 2, Census Tract 5054.01, Santa Clara County, California",0,0,0
1000000US060855054013000,060855054013000,"Block 3000, Block Group 3, Census Tract 5054.01, Santa Clara County, California",490,477,13
1000000US060855054013001,060855054013001,"Block 3001, Block Group 3, Census Tract 5054.01, Santa Clara County, California",4,4,0
1000000US060855054013002,060855054013002,"Block 3002, Block Group 3, Census Tract 5054.01, Santa Clara County, California",0,0,0
1000000US060855054013003,060855054013003,"Block 3003, Block Group 3, Census Tract 5054.01, Santa Clara County, California",416,395,21
1000000US060855054013004,060855054013004,"Block 3004, Block Group 3, Census Tract 5054.01, Santa Clara County, California",1,1,0
1000000US060855054013005,060855054013005,"Block 3005, Block Group 3, Census Tract 5054.01, Santa Clara County, California",0,0,0
1000000US060855054014000,060855054014000,"Block 4000, Block Group 4, Census Tract 5054.01, Santa Clara County, California",255,237,18
1000000US060855054014001,060855054014001,"Block 4001, Block Group 4, Census Tract 5054.01, Santa Clara County, California",103,101,2
1000000US060855054014002,060855054014002,"Block 4002, Block Group 4, Census Tract 5054.01, Santa Clara County, California",0,0,0
1000000US060855054015000,060855054015000,"Block 5000, Block Group 5, Census Tract 5054.01, Santa Clara County, California",39,38,1
1000000US060855054015001,060855054015001,"Block 5001, Block Group 5, Census Tract 5054.01, Santa Clara County, California",45,45,0
1000000US060855054015002,060855054015002,"Block 5002, Block Group 5, Census Tract 5054.01, Santa Clara County, California",30,29,1
1000000US060855054015003,060855054015003,"Block 5003, Block Group 5, Census Tract 5054.01, Santa Clara County, California",34,33,1
1000000US060855054015004,060855054015004,"Block 5004, Block Group 5, Census Tract 5054.01, Santa Clara County, California",53,51,2
1000000US060855054021000,060855054021000,"Block 1000, Block Group 1, Census Tract 5054.02, Santa Clara County, California",0,0,0
1000000US060855054021001,060855054021001,"Block 1001, Block Group 1, Census Tract 5054.02, Santa Clara County, California",1,1,0
1000000US060855054021002,060855054021002,"Block 1002, Block Group 1, Census Tract 5054.02, Santa Clara County, California",6,6,0
1000000US060855054021003,060855054021003,"Block 1003, Block Group 1, Census Tract 5054.02, Santa Clara County, California",33,33,0
1000000US060855054021004,060855054021004,"Block 1004, Block Group 1, Census Tract 5054.02, Santa Clara County, California",66,65,1
1000000US060855054021005,060855054021005,"Block 1005, Block Group 1, Census Tract 5054.02, Santa Clara County, California",55,55,0
1000000US060855054021006,060855054021006,"Block 1006, Block Group 1, Census Tract 5054.02, Santa Clara County, California",34,34,0
1000000US060855054021007,060855054021007,"Block 1007, Block Group 1, Census Tract 5054.02, Santa Clara County, California",45,44,1
1000000US060855054021008,060855054021008,"Block 1008, Block Group 1, Census Tract 5054.02, Santa Clara County, California",95,86,9
1000000US060855054021009,060855054021009,"Block 1009, Block Group 1, Census Tract 5054.02, Santa Clara County, California",33,33,0
1000000US060855054021010,060855054021010,"Block 1010, Block Group 1, Census Tract 5054.02, Santa Clara County, California",23,23,0
1000000US060855054022000,060855054022000,"Block 2000, Block Group 2, Census Tract 5054.02, Santa Clara County, California",140,134,6
1000000US060855054022001,060855054022001,"Block 2001, Block Group 2, Census Tract 5054.02, Santa Clara County, California",21,21,0
1000000US060855054022002,060855054022002,"Block 2002, Block Group 2, Census Tract 5054.02, Santa Clara County, California",2,1,1
1000000US060855054022003,060855054022003,"Block 2003, Block Group 2, Census Tract 5054.02, Santa Clara County, California",32,30,2
1000000US060855054022004,060855054022004,"Block 2004, Block Group 2, Census Tract 5054.02, Santa Clara County, California",0,0,0
1000000US060855054022005,060855054022005,"Block 2005, Block Group 2, Census Tract 5054.02, Santa Clara County, California",0,0,0
1000000US060855054022006,060855054022006,"Block 2006, Block Group 2, Census Tract 5054.02, Santa Clara County, California",0,0,0
1000000US060855054022007,060855054022007,"Block 2007, Block Group 2, Census Tract 5054.02, Santa Clara County, California",0,0,0
1000000US060855054022008,060855054022008,"Block 2008, Block Group 2, Census Tract 5054.02, Santa Clara County, California",54,52,2
1000000US060855054022009,060855054022009,"Block 2009, Block Group 2, Census Tract 5054.02, Santa Clara County, California",0,0,0
1000000US060855054022010,060855054022010,"Block 2010, Block Group 2, Census Tract 5054.02, Santa Clara County, California",39,39,0
1000000US060855054022011,060855054022011,"Block 2011, Block Group 2, Census Tract 5054.02, Santa Clara County, California",0,0,0
1000000US060855054022012,060855054022012,"Block 2012, Block Group 2, Census Tract 5054.02, Santa Clara County, California",18,18,0
1000000US060855054022013,060855054022013,"Block 2013, Block Group 2, Census Tract 5054.02, Santa Clara County, California",18,16,2
1000000US060855054022014,060855054022014,"Block 2014, Block Group 2, Census Tract 5054.02, Santa Clara County, California",0,0,0
1000000US060855054022015,060855054022015,"Block 2015, Block Group 2, Census Tract 5054.02, Santa Clara County, California",27,25,2
1000000US060855054022016,060855054022016,"Block 2016, Block Group 2, Census Tract 5054.02, Santa Clara County, California",38,36,2
1000000US060855054022017,060855054022017,"Block 2017, Block Group 2, Census Tract 5054.02, Santa Clara County, California",0,0,0
1000000US060855054022018,060855054022018,"Block 2018, Block Group 2, Census Tract 5054.02, Santa Clara County, California",112,112,0
1000000US060855054022019,060855054022019,"Block 2019, Block Group 2, Census Tract 5054.02, Santa Clara County, California",12,11,1
1000000US060855054022020,060855054022020,"Block 2020, Block Group 2, Census Tract 5054.02, Santa Clara County, California",46,46,0
1000000US060855054022021,060855054022021,"Block 2021, Block Group 2, Census Tract 5054.02, Santa Clara County, California",0,0,0
1000000US060855054022022,060855054022022,"Block 2022, Block Group 2, Census Tract 5054.02, Santa Clara County, California",0,0,0
1000000US060855054022023,060855054022023,"Block 2023, Block Group 2, Census Tract 5054.02, Santa Clara County, California",24,24,0
1000000US060855054022024,060855054022024,"Block 2024, Block Group 2, Census Tract 5054.02, Santa Clara County, California",0,0,0
1000000US060855054022025,060855054022025,"Block 2025, Block Group 2, Census Tract 5054.02, Santa Clara County, California",0,0,0
1000000US060855054022026,060855054022026,"Block 2026, Block Group 2, Census Tract 5054.02, Santa Clara County, California",0,0,0
1000000US060855054022027,060855054022027,"Block 2027, Block Group 2, Census Tract 5054.02, Santa Clara County, California",15,15,0
1000000US060855054022028,060855054022028,"Block 2028, Block Group 2, Census Tract 5054.02, Santa Clara County, California",110,108,2
1000000US060855054022029,060855054022029,"Block 2029, Block Group 2, Census Tract 5054.02, Santa Clara County, California",23,21,2
1000000US060855054022030,060855054022030,"Block 2030, Block Group 2, Census Tract 5054.02, Santa Clara County, California",38,36,2
1000000US060855054031000,060855054031000,"Block 1000, Block Group 1, Census Tract 5054.03, Santa Clara County, California",0,0,0
1000000US060855054031001,060855054031001,"Block 1001, Block Group 1, Census Tract 5054.03, Santa Clara County, California",0,0,0
1000000US060855054031002,060855054031002,"Block 1002, Block Group 1, Census Tract 5054.03, Santa Clara County, California",0,0,0
1000000US060855054031003,060855054031003,"Block 1003, Block Group 1, Census Tract 5054.03, Santa Clara County, California",614,581,33
1000000US060855054031004,060855054031004,"Block 1004, Block Group 1, Census Tract 5054.03, Santa Clara County, California",0,0,0
1000000US060855054031005,060855054031005,"Block 1005, Block Group 1, Census Tract 5054.03, Santa Clara County, California",0,0,0
1000000US060855054031006,060855054031006,"Block 1006, Block Group 1, Census Tract 5054.03, Santa Clara County, California",0,0,0
1000000US060855054031007,060855054031007,"Block 1007, Block Group 1, Census Tract 5054.03, Santa Clara County, California",0,0,0
1000000US060855054031008,060855054031008,"Block 1008, Block Group 1, Census Tract 5054.03, Santa Clara County, California",0,0,0
1000000US060855054031009,060855054031009,"Block 1009, Block Group 1, Census Tract 5054.03, Santa Clara County, California",0,0,0
1000000US060855054031010,060855054031010,"Block 1010, Block Group 1, Census Tract 5054.03, Santa Clara County, California",0,0,0
1000000US060855054031011,060855054031011,"Block 1011, Block Group 1, Census Tract 5054.03, Santa Clara County, California",0,0,0
1000000US060855054031012,060855054031012,"Block 1012, Block Group 1, Census Tract 5054.03, Santa Clara County, California",0,0,0
1000000US060855054031013,060855054031013,"Block 1013, Block Group 1, Census Tract 5054.03, Santa Clara County, California",42,41,1
1000000US060855054031014,060855054031014,"Block 1014, Block Group 1, Census Tract 5054.03, Santa Clara County, California",0,0,0
1000000US060855054031015,060855054031015,"Block 1015, Block Group 1, Census Tract 5054.03, Santa Clara County, California",0,0,0
1000000US060855054031016,060855054031016,"Block 1016, Block Group 1, Census Tract 5054.03, Santa Clara County, California",23,22,1
1000000US060855054031017,060855054031017,"Block 1017, Block Group 1, Census Tract 5054.03, Santa Clara County, California",91,87,4
1000000US060855054031018,060855054031018,"Block 1018, Block Group 1, Census Tract 5054.03, Santa Clara County, California",0,0,0
1000000US060855054032000,060855054032000,"Block 2000, Block Group 2, Census Tract 5054.03, Santa Clara County, California",0,0,0
1000000US060855054032001,060855054032001,"Block 2001, Block Group 2, Census Tract 5054.03, Santa Clara County, California",42,41,1
1000000US060855054032002,060855054032002,"Block 2002, Block Group 2, Census Tract 5054.03, Santa Clara County, California",150,142,8
1000000US060855054032003,060855054032003,"Block 2003, Block Group 2, Census Tract 5054.03, Santa Clara County, California",23,22,1
1000000US060855054032004,060855054032004,"Block 2004, Block Group 2, Census Tract 5054.03, Santa Clara County, California",20,19,1
1000000US060855054032005,060855054032005,"Block 2005, Block Group 2, Census Tract 5054.03, Santa Clara County, California",65,59,6
1000000US060855054032006,060855054032006,"Block 2006, Block Group 2, Census Tract 5054.03, Santa Clara County, California",534,508,26
1000000US060855054032007,060855054032007,"Block 2007, Block Group 2, Census Tract 5054.03, Santa Clara County, California",0,0,0
1000000US060855054032008,060855054032008,"Block 2008, Block Group 2, Census Tract 5054.03, Santa Clara County, California",107,101,6
1000000US060855054032009,060855054032009,"Block 2009, Block Group 2, Census Tract 5054.03, Santa Clara County, California",16,15,1
1000000US060855054032010,060855054032010,"Block 2010, Block Group 2, Census Tract 5054.03, Santa Clara County, California",34,33,1
1000000US060855054033000,060855054033000,"Block 3000, Block Group 3, Census Tract 5054.03, Santa Clara County, California",0,0,0
1000000US060855054033001,060855054033001,"Block 3001, Block Group 3, Census Tract 5054.03, Santa Clara County, California",0,0,0
1000000US060855054033002,060855054033002,"Block 3002, Block Group 3, Census Tract 5054.03, Santa Clara County, California",0,0,0
1000000US060855054033003,060855054033003,"Block 3003, Block Group 3, Census Tract 5054.03, Santa Clara County, California",0,0,0
1000000US060855054033004,060855054033004,"Block 3004, Block Group 3, Census Tract 5054.03, Santa Clara County, California",52,51,1
1000000US060855054033005,060855054033005,"Block 3005, Block Group 3, Census Tract 5054.03, Santa Clara County, California",45,45,0
1000000US060855054033006,060855054033006,"Block 3006, Block Group 3, Census Tract 5054.03, Santa Clara County, California",16,15,1
1000000US060855054033007,060855054033007,"Block 3007, Block Group 3, Census Tract 5054.03, Santa Clara County, California",28,27,1
1000000US060855054033008,060855054033008,"Block 3008, Block Group 3, Census Tract 5054.03, Santa Clara County, California",39,39,0
1000000US060855054033009,060855054033009,"Block 3009, Block Group 3, Census Tract 5054.03, Santa Clara County, California",95,89,6
1000000US060855054033010,060855054033010,"Block 3010, Block Group 3, Census Tract 5054.03, Santa Clara County, California",50,48,2
1000000US060855054033011,060855054033011,"Block 3011, Block Group 3, Census Tract 5054.03, Santa Clara County, California",44,41,3
1000000US060855054033012,060855054033012,"Block 3012, Block Group 3, Census Tract 5054.03, Santa Clara County, California",18,17,1
1000000US060855054033013,060855054033013,"Block 3013, Block Group 3, Census Tract 5054.03, Santa Clara County, California",12,11,1
1000000US060855054033014,060855054033014,"Block 3014, Block Group 3, Census Tract 5054.03, Santa Clara County, California",0,0,0
1000000US060855054033015,060855054033015,"Block 3015, Block Group 3, Census Tract 5054.03, Santa Clara County, California",62,51,11
1000000US060855054033016,060855054033016,"Block 3016, Block Group 3, Census Tract 5054.03, Santa Clara County, California",126,124,2
1000000US060855054033017,060855054033017,"Block 3017, Block Group 3, Census Tract 5054.03, Santa Clara County, California",0,0,0
1000000US060855054033018,060855054033018,"Block 3018, Block Group 3, Census Tract 5054.03, Santa Clara County, California",0,0,0
1000000US060855054033019,060855054033019,"Block 3019, Block Group 3, Census Tract 5054.03, Santa Clara County, California",31,28,3
1000000US060855054033020,060855054033020,"Block 3020, Block Group 3, Census Tract 5054.03, Santa Clara County, California",30,28,2
1000000US060855054033021,060855054033021,"Block 3021, Block Group 3, Census Tract 5054.03, Santa Clara County, California",71,65,6
1000000US060855054033022,060855054033022,"Block 3022, Block Group 3, Census Tract 5054.03, Santa Clara County, California",0,0,0
1000000US060855054033023,060855054033023,"Block 3023, Block Group 3, Census Tract 5054.03, Santa Clara County, California",275,269,6
1000000US060855054033024,060855054033024,"Block 3024, Block Group 3, Census Tract 5054.03, Santa Clara County, California",20,18,2
1000000US060855055001000,060855055001000,"Block 1000, Block Group 1, Census Tract 5055, Santa Clara County, California",14,14,0
1000000US060855055001001,060855055001001,"Block 1001, Block Group 1, Census Tract 5055, Santa Clara County, California",27,26,1
1000000US060855055001002,060855055001002,"Block 1002, Block Group 1, Census Tract 5055, Santa Clara County, California",36,36,0
1000000US060855055001003,060855055001003,"Block 1003, Block Group 1, Census Tract 5055, Santa Clara County, California",43,43,0
1000000US060855055001004,060855055001004,"Block 1004, Block Group 1, Census Tract 5055, Santa Clara County, California",19,18,1
1000000US060855055001005,060855055001005,"Block 1005, Block Group 1, Census Tract 5055, Santa Clara County, California",29,24,5
1000000US060855055001006,060855055001006,"Block 1006, Block Group 1, Census Tract 5055, Santa Clara County, California",27,26,1
1000000US060855055001007,060855055001007,"Block 1007, Block Group 1, Census Tract 5055, Santa Clara County, California",30,30,0
1000000US060855055001008,060855055001008,"Block 1008, Block Group 1, Census Tract 5055, Santa Clara County, California",44,42,2
1000000US060855055001009,060855055001009,"Block 1009, Block Group 1, Census Tract 5055, Santa Clara County, California",0,0,0
1000000US060855055001010,060855055001010,"Block 1010, Block Group 1, Census Tract 5055, Santa Clara County, California",12,10,2
1000000US060855055001011,060855055001011,"Block 1011, Block Group 1, Census Tract 5055, Santa Clara County, California",22,22,0
1000000US060855055001012,060855055001012,"Block 1012, Block Group 1, Census Tract 5055, Santa Clara County, California",17,16,1
1000000US060855055001013,060855055001013,"Block 1013, Block Group 1, Census Tract 5055, Santa Clara County, California",0,0,0
1000000US060855055001014,060855055001014,"Block 1014, Block Group 1, Census Tract 5055, Santa Clara County, California",3,3,0
1000000US060855055001015,060855055001015,"Block 1015, Block Group 1, Census Tract 5055, Santa Clara County, California",0,0,0
1000000US060855055001016,060855055001016,"Block 1016, Block Group 1, Census Tract 5055, Santa Clara County, California",0,0,0
1000000US060855055001017,060855055001017,"Block 1017, Block Group 1, Census Tract 5055, Santa Clara County, California",0,0,0
1000000US060855055001018,060855055001018,"Block 1018, Block Group 1, Census Tract 5055, Santa Clara County, California",18,17,1
1000000US060855055002000,060855055002000,"Block 2000, Block Group 2, Census Tract 5055, Santa Clara County, California",0,0,0
1000000US060855055002001,060855055002001,"Block 2001, Block Group 2, Census Tract 5055, Santa Clara County, California",52,52,0
1000000US060855055002002,060855055002002,"Block 2002, Block Group 2, Census Tract 5055, Santa Clara County, California",10,10,0
1000000US060855055002003,060855055002003,"Block 2003, Block Group 2, Census Tract 5055, Santa Clara County, California",26,25,1
1000000US060855055002004,060855055002004,"Block 2004, Block Group 2, Census Tract 5055, Santa Clara County, California",41,41,0
1000000US060855055002005,060855055002005,"Block 2005, Block Group 2, Census Tract 5055, Santa Clara County, California",35,35,0
1000000US060855055002006,060855055002006,"Block 2006, Block Group 2, Census Tract 5055, Santa Clara County, California",34,33,1
1000000US060855055002007,060855055002007,"Block 2007, Block Group 2, Census Tract 5055, Santa Clara County, California",27,26,1
1000000US060855055002008,060855055002008,"Block 2008, Block Group 2, Census Tract 5055, Santa Clara County, California",21,21,0
1000000US060855055002009,060855055002009,"Block 2009, Block Group 2, Census Tract 5055, Santa Clara County, California",230,219,11
1000000US060855055002010,060855055002010,"Block 2010, Block Group 2, Census Tract 5055, Santa Clara County, California",4,4,0
1000000US060855055002011,060855055002011,"Block 2011, Block Group 2, Census Tract 5055, Santa Clara County, California",59,55,4
1000000US060855055002012,060855055002012,"Block 2012, Block Group 2, Census Tract 5055, Santa Clara County, California",0,0,0
1000000US060855055002013,060855055002013,"Block 2013, Block Group 2, Census Tract 5055, Santa Clara County, California",62,58,4
1000000US060855055002014,060855055002014,"Block 2014, Block Group 2, Census Tract 5055, Santa Clara County, California",20,19,1
1000000US060855055002015,060855055002015,"Block 2015, Block Group 2, Census Tract 5055, Santa Clara County, California",19,18,1
1000000US060855055002016,060855055002016,"Block 2016, Block Group 2, Census Tract 5055, Santa Clara County, California",114,111,3
1000000US060855055002017,060855055002017,"Block 2017, Block Group 2, Census Tract 5055, Santa Clara County, California",6,6,0
1000000US060855055002018,060855055002018,"Block 2018, Block Group 2, Census Tract 5055, Santa Clara County, California",7,7,0
1000000US060855055002019,060855055002019,"Block 2019, Block Group 2, Census Tract 5055, Santa Clara County, California",0,0,0
1000000US060855055002020,060855055002020,"Block 2020, Block Group 2, Census Tract 5055, Santa Clara County, California",2,2,0
1000000US060855055003000,060855055003000,"Block 3000, Block Group 3, Census Tract 5055, Santa Clara County, California",20,20,0
1000000US060855055003001,060855055003001,"Block 3001, Block Group 3, Census Tract 5055, Santa Clara County, California",0,0,0
1000000US060855055003002,060855055003002,"Block 3002, Block Group 3, Census Tract 5055, Santa Clara County, California",32,29,3
1000000US060855055003003,060855055003003,"Block 3003, Block Group 3, Census Tract 5055, Santa Clara County, California",27,24,3
1000000US060855055003004,060855055003004,"Block 3004, Block Group 3, Census Tract 5055, Santa Clara County, California",48,48,0
1000000US060855055003005,060855055003005,"Block 3005, Block Group 3, Census Tract 5055, Santa Clara County, California",36,35,1
1000000US060855055003006,060855055003006,"Block 3006, Block Group 3, Census Tract 5055, Santa Clara County, California",22,22,0
1000000US060855055003007,060855055003007,"Block 3007, Block Group 3, Census Tract 5055, Santa Clara County, California",22,22,0
1000000US060855055003008,060855055003008,"Block 3008, Block Group 3, Census Tract 5055, Santa Clara County, California",22,21,1
1000000US060855055003009,060855055003009,"Block 3009, Block Group 3, Census Tract 5055, Santa Clara County, California",85,83,2
1000000US060855055003010,060855055003010,"Block 3010, Block Group 3, Census Tract 5055, Santa Clara County, California",16,16,0
1000000US060855055003011,060855055003011,"Block 3011, Block Group 3, Census Tract 5055, Santa Clara County, California",22,22,0
1000000US060855055003012,060855055003012,"Block 3012, Block Group 3, Census Tract 5055, Santa Clara County, California",0,0,0
1000000US060855055003013,060855055003013,"Block 3013, Block Group 3, Census Tract 5055, Santa Clara County, California",0,0,0
1000000US060855055003014,060855055003014,"Block 3014, Block Group 3, Census Tract 5055, Santa Clara County, California",26,25,1
1000000US060855055003015,060855055003015,"Block 3015, Block Group 3, Census Tract 5055, Santa Clara County, California",36,35,1
1000000US060855055003016,060855055003016,"Block 3016, Block Group 3, Census Tract 5055, Santa Clara County, California",32,32,0
1000000US060855055003017,060855055003017,"Block 3017, Block Group 3, Census Tract 5055, Santa Clara County, California",32,32,0
1000000US060855055003018,060855055003018,"Block 3018, Block Group 3, Census Tract 5055, Santa Clara County, California",27,27,0
1000000US060855055003019,060855055003019,"Block 3019, Block Group 3, Census Tract 5055, Santa Clara County, California",16,16,0
1000000US060855055003020,060855055003020,"Block 3020, Block Group 3, Census Tract 5055, Santa Clara County, California",16,16,0
1000000US060855056001000,060855056001000,"Block 1000, Block Group 1, Census Tract 5056, Santa Clara County, California",4,3,1
1000000US060855056001001,060855056001001,"Block 1001, Block Group 1, Census Tract 5056, Santa Clara County, California",0,0,0
1000000US060855056001002,060855056001002,"Block 1002, Block Group 1, Census Tract 5056, Santa Clara County, California",12,11,1
1000000US060855056001003,060855056001003,"Block 1003, Block Group 1, Census Tract 5056, Santa Clara County, California",21,20,1
1000000US060855056001004,060855056001004,"Block 1004, Block Group 1, Census Tract 5056, Santa Clara County, California",12,10,2
1000000US060855056001005,060855056001005,"Block 1005, Block Group 1, Census Tract 5056, Santa Clara County, California",25,23,2
1000000US060855056001006,060855056001006,"Block 1006, Block Group 1, Census Tract 5056, Santa Clara County, California",0,0,0
1000000US060855056001007,060855056001007,"Block 1007, Block Group 1, Census Tract 5056, Santa Clara County, California",0,0,0
1000000US060855056001008,060855056001008,"Block 1008, Block Group 1, Census Tract 5056, Santa Clara County, California",0,0,0
1000000US060855056001009,060855056001009,"Block 1009, Block Group 1, Census Tract 5056, Santa Clara County, California",1,1,0
1000000US060855056001010,060855056001010,"Block 1010, Block Group 1, Census Tract 5056, Santa Clara County, California",0,0,0
1000000US060855056001011,060855056001011,"Block 1011, Block Group 1, Census Tract 5056, Santa Clara County, California",0,0,0
1000000US060855056001012,060855056001012,"Block 1012, Block Group 1, Census Tract 5056, Santa Clara County, California",0,0,0
1000000US060855056001013,060855056001013,"Block 1013, Block Group 1, Census Tract 5056, Santa Clara County, California",0,0,0
1000000US060855056001014,060855056001014,"Block 1014, Block Group 1, Census Tract 5056, Santa Clara County, California",0,0,0
1000000US060855056001015,060855056001015,"Block 1015, Block Group 1, Census Tract 5056, Santa Clara County, California",0,0,0
1000000US060855056001016,060855056001016,"Block 1016, Block Group 1, Census Tract 5056, Santa Clara County, California",0,0,0
1000000US060855056001017,060855056001017,"Block 1017, Block Group 1, Census Tract 5056, Santa Clara County, California",0,0,0
1000000US060855056001018,060855056001018,"Block 1018, Block Group 1, Census Tract 5056, Santa Clara County, California",0,0,0
1000000US060855056001019,060855056001019,"Block 1019, Block Group 1, Census Tract 5056, Santa Clara County, California",12,12,0
1000000US060855056001020,060855056001020,"Block 1020, Block Group 1, Census Tract 5056, Santa Clara County, California",0,0,0
1000000US060855056001021,060855056001021,"Block 1021, Block Group 1, Census Tract 5056, Santa Clara County, California",7,7,0
1000000US060855056001022,060855056001022,"Block 1022, Block Group 1, Census Tract 5056, Santa Clara County, California",11,10,1
1000000US060855056001023,060855056001023,"Block 1023, Block Group 1, Census Tract 5056, Santa Clara County, California",0,0,0
1000000US060855056001024,060855056001024,"Block 1024, Block Group 1, Census Tract 5056, Santa Clara County, California",6,5,1
1000000US060855056001025,060855056001025,"Block 1025, Block Group 1, Census Tract 5056, Santa Clara County, California",0,0,0
1000000US060855056001026,060855056001026,"Block 1026, Block Group 1, Census Tract 5056, Santa Clara County, California",25,25,0
1000000US060855056001027,060855056001027,"Block 1027, Block Group 1, Census Tract 5056, Santa Clara County, California",24,22,2
1000000US060855056001028,060855056001028,"Block 1028, Block Group 1, Census Tract 5056, Santa Clara County, California",14,12,2
1000000US060855056001029,060855056001029,"Block 1029, Block Group 1, Census Tract 5056, Santa Clara County, California",0,0,0
1000000US060855056001030,060855056001030,"Block 1030, Block Group 1, Census Tract 5056, Santa Clara County, California",0,0,0
1000000US060855056001031,060855056001031,"Block 1031, Block Group 1, Census Tract 5056, Santa Clara County, California",12,11,1
1000000US060855056001032,060855056001032,"Block 1032, Block Group 1, Census Tract 5056, Santa Clara County, California",69,67,2
1000000US060855056001033,060855056001033,"Block 1033, Block Group 1, Census Tract 5056, Santa Clara County, California",14,14,0
1000000US060855056001034,060855056001034,"Block 1034, Block Group 1, Census Tract 5056, Santa Clara County, California",9,9,0
1000000US060855056001035,060855056001035,"Block 1035, Block Group 1, Census Tract 5056, Santa Clara County, California",25,25,0
1000000US060855056001036,060855056001036,"Block 1036, Block Group 1, Census Tract 5056, Santa Clara County, California",15,14,1
1000000US060855056001037,060855056001037,"Block 1037, Block Group 1, Census Tract 5056, Santa Clara County, California",15,13,2
1000000US060855056001038,060855056001038,"Block 1038, Block Group 1, Census Tract 5056, Santa Clara County, California",15,14,1
1000000US060855056001039,060855056001039,"Block 1039, Block Group 1, Census Tract 5056, Santa Clara County, California",22,19,3
1000000US060855056001040,060855056001040,"Block 1040, Block Group 1, Census Tract 5056, Santa Clara County, California",12,9,3
1000000US060855056001041,060855056001041,"Block 1041, Block Group 1, Census Tract 5056, Santa Clara County, California",52,44,8
1000000US060855056001042,060855056001042,"Block 1042, Block Group 1, Census Tract 5056, Santa Clara County, California",39,35,4
1000000US060855056001043,060855056001043,"Block 1043, Block Group 1, Census Tract 5056, Santa Clara County, California",0,0,0
1000000US060855056001044,060855056001044,"Block 1044, Block Group 1, Census Tract 5056, Santa Clara County, California",0,0,0
1000000US060855056001045,060855056001045,"Block 1045, Block Group 1, Census Tract 5056, Santa Clara County, California",0,0,0
1000000US060855056002000,060855056002000,"Block 2000, Block Group 2, Census Tract 5056, Santa Clara County, California",27,26,1
1000000US060855056002001,060855056002001,"Block 2001, Block Group 2, Census Tract 5056, Santa Clara County, California",16,15,1
1000000US060855056002002,060855056002002,"Block 2002, Block Group 2, Census Tract 5056, Santa Clara County, California",36,34,2
1000000US060855056002003,060855056002003,"Block 2003, Block Group 2, Census Tract 5056, Santa Clara County, California",42,41,1
1000000US060855056002004,060855056002004,"Block 2004, Block Group 2, Census Tract 5056, Santa Clara County, California",39,36,3
1000000US060855056002005,060855056002005,"Block 2005, Block Group 2, Census Tract 5056, Santa Clara County, California",21,20,1
1000000US060855056002006,060855056002006,"Block 2006, Block Group 2, Census Tract 5056, Santa Clara County, California",19,16,3
1000000US060855056002007,060855056002007,"Block 2007, Block Group 2, Census Tract 5056, Santa Clara County, California",17,17,0
1000000US060855056002008,060855056002008,"Block 2008, Block Group 2, Census Tract 5056, Santa Clara County, California",12,12,0
1000000US060855056002009,060855056002009,"Block 2009, Block Group 2, Census Tract 5056, Santa Clara County, California",6,4,2
1000000US060855056002010,060855056002010,"Block 2010, Block Group 2, Census Tract 5056, Santa Clara County, California",18,17,1
1000000US060855056002011,060855056002011,"Block 2011, Block Group 2, Census Tract 5056, Santa Clara County, California",23,21,2
1000000US060855056002012,060855056002012,"Block 2012, Block Group 2, Census Tract 5056, Santa Clara County, California",18,17,1
1000000US060855056002013,060855056002013,"Block 2013, Block Group 2, Census Tract 5056, Santa Clara County, California",0,0,0
1000000US060855056002014,060855056002014,"Block 2014, Block Group 2, Census Tract 5056, Santa Clara County, California",21,20,1
1000000US060855056003000,060855056003000,"Block 3000, Block Group 3, Census Tract 5056, Santa Clara County, California",172,165,7
1000000US060855056003001,060855056003001,"Block 3001, Block Group 3, Census Tract 5056, Santa Clara County, California",0,0,0
1000000US060855056003002,060855056003002,"Block 3002, Block Group 3, Census Tract 5056, Santa Clara County, California",0,0,0
1000000US060855056003003,060855056003003,"Block 3003, Block Group 3, Census Tract 5056, Santa Clara County, California",1,1,0
1000000US060855056003004,060855056003004,"Block 3004, Block Group 3, Census Tract 5056, Santa Clara County, California",8,6,2
1000000US060855056003005,060855056003005,"Block 3005, Block Group 3, Census Tract 5056, Santa Clara County, California",10,9,1
1000000US060855056003006,060855056003006,"Block 3006, Block Group 3, Census Tract 5056, Santa Clara County, California",0,0,0
1000000US060855056003007,060855056003007,"Block 3007, Block Group 3, Census Tract 5056, Santa Clara County, California",0,0,0
1000000US060855056003008,060855056003008,"Block 3008, Block Group 3, Census Tract 5056, Santa Clara County, California",0,0,0
1000000US060855056003009,060855056003009,"Block 3009, Block Group 3, Census Tract 5056, Santa Clara County, California",0,0,0
1000000US060855056003010,060855056003010,"Block 3010, Block Group 3, Census Tract 5056, Santa Clara County, California",0,0,0
1000000US060855056003011,060855056003011,"Block 3011, Block Group 3, Census Tract 5056, Santa Clara County, California",2,2,0
1000000US060855056003012,060855056003012,"Block 3012, Block Group 3, Census Tract 5056, Santa Clara County, California",18,15,3
1000000US060855056003013,060855056003013,"Block 3013, Block Group 3, Census Tract 5056, Santa Clara County, California",110,109,1
1000000US060855056003014,060855056003014,"Block 3014, Block Group 3, Census Tract 5056, Santa Clara County, California",19,19,0
1000000US060855056003015,060855056003015,"Block 3015, Block Group 3, Census Tract 5056, Santa Clara County, California",0,0,0
1000000US060855056003016,060855056003016,"Block 3016, Block Group 3, Census Tract 5056, Santa Clara County, California",33,26,7
1000000US060855056003017,060855056003017,"Block 3017, Block Group 3, Census Tract 5056, Santa Clara County, California",19,17,2
1000000US060855056003018,060855056003018,"Block 3018, Block Group 3, Census Tract 5056, Santa Clara County, California",0,0,0
1000000US060855056003019,060855056003019,"Block 3019, Block Group 3, Census Tract 5056, Santa Clara County, California",26,21,5
1000000US060855056003020,060855056003020,"Block 3020, Block Group 3, Census Tract 5056, Santa Clara County, California",20,19,1
1000000US060855056003021,060855056003021,"Block 3021, Block Group 3, Census Tract 5056, Santa Clara County, California",0,0,0
1000000US060855056003022,060855056003022,"Block 3022, Block Group 3, Census Tract 5056, Santa Clara County, California",10,10,0
1000000US060855056003023,060855056003023,"Block 3023, Block Group 3, Census Tract 5056, Santa Clara County, California",1,1,0
1000000US060855056003024,060855056003024,"Block 3024, Block Group 3, Census Tract 5056, Santa Clara County, California",19,17,2
1000000US060855056003025,060855056003025,"Block 3025, Block Group 3, Census Tract 5056, Santa Clara County, California",0,0,0
1000000US060855056003026,060855056003026,"Block 3026, Block Group 3, Census Tract 5056, Santa Clara County, California",0,0,0
1000000US060855056003027,060855056003027,"Block 3027, Block Group 3, Census Tract 5056, Santa Clara County, California",0,0,0
1000000US060855056003028,060855056003028,"Block 3028, Block Group 3, Census Tract 5056, Santa Clara County, California",24,23,1
1000000US060855056003029,060855056003029,"Block 3029, Block Group 3, Census Tract 5056, Santa Clara County, California",35,31,4
1000000US060855056003030,060855056003030,"Block 3030, Block Group 3, Census Tract 5056, Santa Clara County, California",15,14,1
1000000US060855056003031,060855056003031,"Block 3031, Block Group 3, Census Tract 5056, Santa Clara County, California",0,0,0
1000000US060855056003032,060855056003032,"Block 3032, Block Group 3, Census Tract 5056, Santa Clara County, California",18,18,0
1000000US060855057001000,060855057001000,"Block 1000, Block Group 1, Census Tract 5057, Santa Clara County, California",0,0,0
1000000US060855057001001,060855057001001,"Block 1001, Block Group 1, Census Tract 5057, Santa Clara County, California",12,12,0
1000000US060855057001002,060855057001002,"Block 1002, Block Group 1, Census Tract 5057, Santa Clara County, California",25,23,2
1000000US060855057001003,060855057001003,"Block 1003, Block Group 1, Census Tract 5057, Santa Clara County, California",30,30,0
1000000US060855057001004,060855057001004,"Block 1004, Block Group 1, Census Tract 5057, Santa Clara County, California",15,15,0
1000000US060855057001005,060855057001005,"Block 1005, Block Group 1, Census Tract 5057, Santa Clara County, California",11,11,0
1000000US060855057001006,060855057001006,"Block 1006, Block Group 1, Census Tract 5057, Santa Clara County, California",14,13,1
1000000US060855057001007,060855057001007,"Block 1007, Block Group 1, Census Tract 5057, Santa Clara County, California",0,0,0
1000000US060855057001008,060855057001008,"Block 1008, Block Group 1, Census Tract 5057, Santa Clara County, California",38,35,3
1000000US060855057001009,060855057001009,"Block 1009, Block Group 1, Census Tract 5057, Santa Clara County, California",56,51,5
1000000US060855057001010,060855057001010,"Block 1010, Block Group 1, Census Tract 5057, Santa Clara County, California",10,9,1
1000000US060855057001011,060855057001011,"Block 1011, Block Group 1, Census Tract 5057, Santa Clara County, California",26,25,1
1000000US060855057001012,060855057001012,"Block 1012, Block Group 1, Census Tract 5057, Santa Clara County, California",0,0,0
1000000US060855057001013,060855057001013,"Block 1013, Block Group 1, Census Tract 5057, Santa Clara County, California",7,6,1
1000000US060855057001014,060855057001014,"Block 1014, Block Group 1, Census Tract 5057, Santa Clara County, California",27,26,1
1000000US060855057001015,060855057001015,"Block 1015, Block Group 1, Census Tract 5057, Santa Clara County, California",7,7,0
1000000US060855057001016,060855057001016,"Block 1016, Block Group 1, Census Tract 5057, Santa Clara County, California",1,1,0
1000000US060855057001017,060855057001017,"Block 1017, Block Group 1, Census Tract 5057, Santa Clara County, California",46,40,6
1000000US060855057001018,060855057001018,"Block 1018, Block Group 1, Census Tract 5057, Santa Clara County, California",11,10,1
1000000US060855057002000,060855057002000,"Block 2000, Block Group 2, Census Tract 5057, Santa Clara County, California",22,22,0
1000000US060855057002001,060855057002001,"Block 2001, Block Group 2, Census Tract 5057, Santa Clara County, California",34,30,4
1000000US060855057002002,060855057002002,"Block 2002, Block Group 2, Census Tract 5057, Santa Clara County, California",0,0,0
1000000US060855057002003,060855057002003,"Block 2003, Block Group 2, Census Tract 5057, Santa Clara County, California",0,0,0
1000000US060855057002004,060855057002004,"Block 2004, Block Group 2, Census Tract 5057, Santa Clara County, California",41,40,1
1000000US060855057002005,060855057002005,"Block 2005, Block Group 2, Census Tract 5057, Santa Clara County, California",23,23,0
1000000US060855057002006,060855057002006,"Block 2006, Block Group 2, Census Tract 5057, Santa Clara County, California",17,16,1
1000000US060855057002007,060855057002007,"Block 2007, Block Group 2, Census Tract 5057, Santa Clara County, California",116,111,5
1000000US060855057002008,060855057002008,"Block 2008, Block Group 2, Census Tract 5057, Santa Clara County, California",44,44,0
1000000US060855057002009,060855057002009,"Block 2009, Block Group 2, Census Tract 5057, Santa Clara County, California",0,0,0
1000000US060855057002010,060855057002010,"Block 2010, Block Group 2, Census Tract 5057, Santa Clara County, California",6,6,0
1000000US060855057002011,060855057002011,"Block 2011, Block Group 2, Census Tract 5057, Santa Clara County, California",21,21,0
1000000US060855057002012,060855057002012,"Block 2012, Block Group 2, Census Tract 5057, Santa Clara County, California",20,20,0
1000000US060855057002013,060855057002013,"Block 2013, Block Group 2, Census Tract 5057, Santa Clara County, California",35,33,2
1000000US060855057002014,060855057002014,"Block 2014, Block Group 2, Census Tract 5057, Santa Clara County, California",23,21,2
1000000US060855057002015,060855057002015,"Block 2015, Block Group 2, Census Tract 5057, Santa Clara County, California",31,29,2
1000000US060855057002016,060855057002016,"Block 2016, Block Group 2, Census Tract 5057, Santa Clara County, California",37,37,0
1000000US060855057002017,060855057002017,"Block 2017, Block Group 2, Census Tract 5057, Santa Clara County, California",24,21,3
1000000US060855057002018,060855057002018,"Block 2018, Block Group 2, Census Tract 5057, Santa Clara County, California",20,18,2
1000000US060855057002019,060855057002019,"Block 2019, Block Group 2, Census Tract 5057, Santa Clara County, California",1,1,0
1000000US060855057002020,060855057002020,"Block 2020, Block Group 2, Census Tract 5057, Santa Clara County, California",0,0,0
1000000US060855057002021,060855057002021,"Block 2021, Block Group 2, Census Tract 5057, Santa Clara County, California",4,4,0
1000000US060855057003000,060855057003000,"Block 3000, Block Group 3, Census Tract 5057, Santa Clara County, California",23,23,0
1000000US060855057003001,060855057003001,"Block 3001, Block Group 3, Census Tract 5057, Santa Clara County, California",1,1,0
1000000US060855057003002,060855057003002,"Block 3002, Block Group 3, Census Tract 5057, Santa Clara County, California",24,23,1
1000000US060855057003003,060855057003003,"Block 3003, Block Group 3, Census Tract 5057, Santa Clara County, California",0,0,0
1000000US060855057003004,060855057003004,"Block 3004, Block Group 3, Census Tract 5057, Santa Clara County, California",0,0,0
1000000US060855057003005,060855057003005,"Block 3005, Block Group 3, Census Tract 5057, Santa Clara County, California",61,59,2
1000000US060855057003006,060855057003006,"Block 3006, Block Group 3, Census Tract 5057, Santa Clara County, California",0,0,0
1000000US060855057003007,060855057003007,"Block 3007, Block Group 3, Census Tract 5057, Santa Clara County, California",59,58,1
1000000US060855057003008,060855057003008,"Block 3008, Block Group 3, Census Tract 5057, Santa Clara County, California",20,20,0
1000000US060855057003009,060855057003009,"Block 3009, Block Group 3, Census Tract 5057, Santa Clara County, California",7,6,1
1000000US060855057003010,060855057003010,"Block 3010, Block Group 3, Census Tract 5057, Santa Clara County, California",20,20,0
1000000US060855057003011,060855057003011,"Block 3011, Block Group 3, Census Tract 5057, Santa Clara County, California",19,17,2
1000000US060855057003012,060855057003012,"Block 3012, Block Group 3, Census Tract 5057, Santa Clara County, California",9,9,0
1000000US060855057003013,060855057003013,"Block 3013, Block Group 3, Census Tract 5057, Santa Clara County, California",14,14,0
1000000US060855057003014,060855057003014,"Block 3014, Block Group 3, Census Tract 5057, Santa Clara County, California",19,19,0
1000000US060855057003015,060855057003015,"Block 3015, Block Group 3, Census Tract 5057, Santa Clara County, California",13,13,0
1000000US060855057003016,060855057003016,"Block 3016, Block Group 3, Census Tract 5057, Santa Clara County, California",37,33,4
1000000US060855057003017,060855057003017,"Block 3017, Block Group 3, Census Tract 5057, Santa Clara County, California",22,22,0
1000000US060855057003018,060855057003018,"Block 3018, Block Group 3, Census Tract 5057, Santa Clara County, California",0,0,0
1000000US060855057003019,060855057003019,"Block 3019, Block Group 3, Census Tract 5057, Santa Clara County, California",0,0,0
1000000US060855057003020,060855057003020,"Block 3020, Block Group 3, Census Tract 5057, Santa Clara County, California",0,0,0
1000000US060855057003021,060855057003021,"Block 3021, Block Group 3, Census Tract 5057, Santa Clara County, California",0,0,0
1000000US060855057003022,060855057003022,"Block 3022, Block Group 3, Census Tract 5057, Santa Clara County, California",5,5,0
1000000US060855057003023,060855057003023,"Block 3023, Block Group 3, Census Tract 5057, Santa Clara County, California",0,0,0
1000000US060855057003024,060855057003024,"Block 3024, Block Group 3, Census Tract 5057, Santa Clara County, California",23,20,3
1000000US060855057003025,060855057003025,"Block 3025, Block Group 3, Census Tract 5057, Santa Clara County, California",6,6,0
1000000US060855057003026,060855057003026,"Block 3026, Block Group 3, Census Tract 5057, Santa Clara County, California",43,38,5
1000000US060855057003027,060855057003027,"Block 3027, Block Group 3, Census Tract 5057, Santa Clara County, California",26,26,0
1000000US060855057003028,060855057003028,"Block 3028, Block Group 3, Census Tract 5057, Santa Clara County, California",26,25,1
1000000US060855057003029,060855057003029,"Block 3029, Block Group 3, Census Tract 5057, Santa Clara County, California",19,18,1
1000000US060855057003030,060855057003030,"Block 3030, Block Group 3, Census Tract 5057, Santa Clara County, California",7,7,0
1000000US060855057003031,060855057003031,"Block 3031, Block Group 3, Census Tract 5057, Santa Clara County, California",7,7,0
1000000US060855057003032,060855057003032,"Block 3032, Block Group 3, Census Tract 5057, Santa Clara County, California",0,0,0
1000000US060855057003033,060855057003033,"Block 3033, Block Group 3, Census Tract 5057, Santa Clara County, California",14,13,1
1000000US060855057003034,060855057003034,"Block 3034, Block Group 3, Census Tract 5057, Santa Clara County, California",99,86,13
1000000US060855057003035,060855057003035,"Block 3035, Block Group 3, Census Tract 5057, Santa Clara County, California",15,15,0
1000000US060855057003036,060855057003036,"Block 3036, Block Group 3, Census Tract 5057, Santa Clara County, California",12,12,0
1000000US060855057003037,060855057003037,"Block 3037, Block Group 3, Census Tract 5057, Santa Clara County, California",23,23,0
1000000US060855057003038,060855057003038,"Block 3038, Block Group 3, Census Tract 5057, Santa Clara County, California",1,1,0
1000000US060855057003039,060855057003039,"Block 3039, Block Group 3, Census Tract 5057, Santa Clara County, California",1,1,0
1000000US060855057003040,060855057003040,"Block 3040, Block Group 3, Census Tract 5057, Santa Clara County, California",0,0,0
1000000US060855057003041,060855057003041,"Block 3041, Block Group 3, Census Tract 5057, Santa Clara County, California",0,0,0
1000000US060855057003042,060855057003042,"Block 3042, Block Group 3, Census Tract 5057, Santa Clara County, California",0,0,0
1000000US060855057004000,060855057004000,"Block 4000, Block Group 4, Census Tract 5057, Santa Clara County, California",0,0,0
1000000US060855057004001,060855057004001,"Block 4001, Block Group 4, Census Tract 5057, Santa Clara County, California",21,19,2
1000000US060855057004002,060855057004002,"Block 4002, Block Group 4, Census Tract 5057, Santa Clara County, California",3,3,0
1000000US060855057004003,060855057004003,"Block 4003, Block Group 4, Census Tract 5057, Santa Clara County, California",81,78,3
1000000US060855057004004,060855057004004,"Block 4004, Block Group 4, Census Tract 5057, Santa Clara County, California",52,48,4
1000000US060855057004005,060855057004005,"Block 4005, Block Group 4, Census Tract 5057, Santa Clara County, California",244,231,13
1000000US060855057004006,060855057004006,"Block 4006, Block Group 4, Census Tract 5057, Santa Clara County, California",58,58,0
1000000US060855057004007,060855057004007,"Block 4007, Block Group 4, Census Tract 5057, Santa Clara County, California",81,79,2
1000000US060855057004008,060855057004008,"Block 4008, Block Group 4, Census Tract 5057, Santa Clara County, California",0,0,0
1000000US060855057004009,060855057004009,"Block 4009, Block Group 4, Census Tract 5057, Santa Clara County, California",2,2,0
1000000US060855057004010,060855057004010,"Block 4010, Block Group 4, Census Tract 5057, Santa Clara County, California",1,1,0
1000000US060855057004011,060855057004011,"Block 4011, Block Group 4, Census Tract 5057, Santa Clara County, California",135,122,13
1000000US060855057004012,060855057004012,"Block 4012, Block Group 4, Census Tract 5057, Santa Clara County, California",0,0,0
1000000US060855057004013,060855057004013,"Block 4013, Block Group 4, Census Tract 5057, Santa Clara County, California",0,0,0
1000000US060855057004014,060855057004014,"Block 4014, Block Group 4, Census Tract 5057, Santa Clara County, California",3,2,1
1000000US060855057004015,060855057004015,"Block 4015, Block Group 4, Census Tract 5057, Santa Clara County, California",35,35,0
1000000US060855057004016,060855057004016,"Block 4016, Block Group 4, Census Tract 5057, Santa Clara County, California",43,43,0
1000000US060855057004017,060855057004017,"Block 4017, Block Group 4, Census Tract 5057, Santa Clara County, California",32,31,1
1000000US060855057004018,060855057004018,"Block 4018, Block Group 4, Census Tract 5057, Santa Clara County, California",0,0,0
1000000US060855057004019,060855057004019,"Block 4019, Block Group 4, Census Tract 5057, Santa Clara County, California",71,66,5
1000000US060855057004020,060855057004020,"Block 4020, Block Group 4, Census Tract 5057, Santa Clara County, California",0,0,0
1000000US060855057004021,060855057004021,"Block 4021, Block Group 4, Census Tract 5057, Santa Clara County, California",0,0,0
1000000US060855057004022,060855057004022,"Block 4022, Block Group 4, Census Tract 5057, Santa Clara County, California",0,0,0
1000000US060855057004023,060855057004023,"Block 4023, Block Group 4, Census Tract 5057, Santa Clara County, California",24,22,2
1000000US060855057004024,060855057004024,"Block 4024, Block Group 4, Census Tract 5057, Santa Clara County, California",0,0,0
1000000US060855057004025,060855057004025,"Block 4025, Block Group 4, Census Tract 5057, Santa Clara County, California",3,3,0
1000000US060855057004026,060855057004026,"Block 4026, Block Group 4, Census Tract 5057, Santa Clara County, California",1,1,0
1000000US060855057004027,060855057004027,"Block 4027, Block Group 4, Census Tract 5057, Santa Clara County, California",0,0,0
1000000US060855058001000,060855058001000,"Block 1000, Block Group 1, Census Tract 5058, Santa Clara County, California",10,10,0
1000000US060855058001001,060855058001001,"Block 1001, Block Group 1, Census Tract 5058, Santa Clara County, California",2,2,0
1000000US060855058001002,060855058001002,"Block 1002, Block Group 1, Census Tract 5058, Santa Clara County, California",144,115,29
1000000US060855058001003,060855058001003,"Block 1003, Block Group 1, Census Tract 5058, Santa Clara County, California",10,8,2
1000000US060855058001004,060855058001004,"Block 1004, Block Group 1, Census Tract 5058, Santa Clara County, California",9,8,1
1000000US060855058001005,060855058001005,"Block 1005, Block Group 1, Census Tract 5058, Santa Clara County, California",31,26,5
1000000US060855058001006,060855058001006,"Block 1006, Block Group 1, Census Tract 5058, Santa Clara County, California",34,33,1
1000000US060855058001007,060855058001007,"Block 1007, Block Group 1, Census Tract 5058, Santa Clara County, California",66,63,3
1000000US060855058001008,060855058001008,"Block 1008, Block Group 1, Census Tract 5058, Santa Clara County, California",27,27,0
1000000US060855058001009,060855058001009,"Block 1009, Block Group 1, Census Tract 5058, Santa Clara County, California",36,35,1
1000000US060855058001010,060855058001010,"Block 1010, Block Group 1, Census Tract 5058, Santa Clara County, California",24,23,1
1000000US060855058001011,060855058001011,"Block 1011, Block Group 1, Census Tract 5058, Santa Clara County, California",3,3,0
1000000US060855058001012,060855058001012,"Block 1012, Block Group 1, Census Tract 5058, Santa Clara County, California",17,16,1
1000000US060855058001013,060855058001013,"Block 1013, Block Group 1, Census Tract 5058, Santa Clara County, California",4,4,0
1000000US060855058002000,060855058002000,"Block 2000, Block Group 2, Census Tract 5058, Santa Clara County, California",56,49,7
1000000US060855058002001,060855058002001,"Block 2001, Block Group 2, Census Tract 5058, Santa Clara County, California",36,34,2
1000000US060855058002002,060855058002002,"Block 2002, Block Group 2, Census Tract 5058, Santa Clara County, California",25,25,0
1000000US060855058002003,060855058002003,"Block 2003, Block Group 2, Census Tract 5058, Santa Clara County, California",29,27,2
1000000US060855058002004,060855058002004,"Block 2004, Block Group 2, Census Tract 5058, Santa Clara County, California",21,21,0
1000000US060855058002005,060855058002005,"Block 2005, Block Group 2, Census Tract 5058, Santa Clara County, California",67,65,2
1000000US060855058002006,060855058002006,"Block 2006, Block Group 2, Census Tract 5058, Santa Clara County, California",0,0,0
1000000US060855058002007,060855058002007,"Block 2007, Block Group 2, Census Tract 5058, Santa Clara County, California",1,1,0
1000000US060855058002008,060855058002008,"Block 2008, Block Group 2, Census Tract 5058, Santa Clara County, California",35,34,1
1000000US060855058002009,060855058002009,"Block 2009, Block Group 2, Census Tract 5058, Santa Clara County, California",27,27,0
1000000US060855058002010,060855058002010,"Block 2010, Block Group 2, Census Tract 5058, Santa Clara County, California",29,28,1
1000000US060855058002011,060855058002011,"Block 2011, Block Group 2, Census Tract 5058, Santa Clara County, California",32,32,0
1000000US060855058002012,060855058002012,"Block 2012, Block Group 2, Census Tract 5058, Santa Clara County, California",0,0,0
1000000US060855058002013,060855058002013,"Block 2013, Block Group 2, Census Tract 5058, Santa Clara County, California",14,14,0
1000000US060855058002014,060855058002014,"Block 2014, Block Group 2, Census Tract 5058, Santa Clara County, California",0,0,0
1000000US060855058002015,060855058002015,"Block 2015, Block Group 2, Census Tract 5058, Santa Clara County, California",0,0,0
1000000US060855058002016,060855058002016,"Block 2016, Block Group 2, Census Tract 5058, Santa Clara County, California",0,0,0
1000000US060855058002017,060855058002017,"Block 2017, Block Group 2, Census Tract 5058, Santa Clara County, California",0,0,0
1000000US060855058002018,060855058002018,"Block 2018, Block Group 2, Census Tract 5058, Santa Clara County, California",0,0,0
1000000US060855058002019,060855058002019,"Block 2019, Block Group 2, Census Tract 5058, Santa Clara County, California",0,0,0
1000000US060855058002020,060855058002020,"Block 2020, Block Group 2, Census Tract 5058, Santa Clara County, California",0,0,0
1000000US060855058002021,060855058002021,"Block 2021, Block Group 2, Census Tract 5058, Santa Clara County, California",0,0,0
1000000US060855058002022,060855058002022,"Block 2022, Block Group 2, Census Tract 5058, Santa Clara County, California",0,0,0
1000000US060855058002023,060855058002023,"Block 2023, Block Group 2, Census Tract 5058, Santa Clara County, California",0,0,0
1000000US060855058002024,060855058002024,"Block 2024, Block Group 2, Census Tract 5058, Santa Clara County, California",0,0,0
1000000US060855058002025,060855058002025,"Block 2025, Block Group 2, Census Tract 5058, Santa Clara County, California",0,0,0
1000000US060855058002026,060855058002026,"Block 2026, Block Group 2, Census Tract 5058, Santa Clara County, California",0,0,0
1000000US060855058002027,060855058002027,"Block 2027, Block Group 2, Census Tract 5058, Santa Clara County, California",0,0,0
1000000US060855058003000,060855058003000,"Block 3000, Block Group 3, Census Tract 5058, Santa Clara County, California",34,31,3
1000000US060855058003001,060855058003001,"Block 3001, Block Group 3, Census Tract 5058, Santa Clara County, California",29,29,0
1000000US060855058003002,060855058003002,"Block 3002, Block Group 3, Census Tract 5058, Santa Clara County, California",30,30,0
1000000US060855058003003,060855058003003,"Block 3003, Block Group 3, Census Tract 5058, Santa Clara County, California",28,28,0
1000000US060855058003004,060855058003004,"Block 3004, Block Group 3, Census Tract 5058, Santa Clara County, California",30,27,3
1000000US060855058003005,060855058003005,"Block 3005, Block Group 3, Census Tract 5058, Santa Clara County, California",29,27,2
1000000US060855058003006,060855058003006,"Block 3006, Block Group 3, Census Tract 5058, Santa Clara County, California",0,0,0
1000000US060855058003007,060855058003007,"Block 3007, Block Group 3, Census Tract 5058, Santa Clara County, California",28,28,0
1000000US060855058003008,060855058003008,"Block 3008, Block Group 3, Census Tract 5058, Santa Clara County, California",31,30,1
1000000US060855058003009,060855058003009,"Block 3009, Block Group 3, Census Tract 5058, Santa Clara County, California",23,23,0
1000000US060855058003010,060855058003010,"Block 3010, Block Group 3, Census Tract 5058, Santa Clara County, California",32,32,0
1000000US060855058003011,060855058003011,"Block 3011, Block Group 3, Census Tract 5058, Santa Clara County, California",32,31,1
1000000US060855058003012,060855058003012,"Block 3012, Block Group 3, Census Tract 5058, Santa Clara County, California",26,25,1
1000000US060855058003013,060855058003013,"Block 3013, Block Group 3, Census Tract 5058, Santa Clara County, California",0,0,0
1000000US060855058004000,060855058004000,"Block 4000, Block Group 4, Census Tract 5058, Santa Clara County, California",47,47,0
1000000US060855058004001,060855058004001,"Block 4001, Block Group 4, Census Tract 5058, Santa Clara County, California",29,26,3
1000000US060855058004002,060855058004002,"Block 4002, Block Group 4, Census Tract 5058, Santa Clara County, California",43,42,1
1000000US060855058004003,060855058004003,"Block 4003, Block Group 4, Census Tract 5058, Santa Clara County, California",23,21,2
1000000US060855058004004,060855058004004,"Block 4004, Block Group 4, Census Tract 5058, Santa Clara County, California",39,38,1
1000000US060855058004005,060855058004005,"Block 4005, Block Group 4, Census Tract 5058, Santa Clara County, California",37,36,1
1000000US060855058004006,060855058004006,"Block 4006, Block Group 4, Census Tract 5058, Santa Clara County, California",0,0,0
1000000US060855058004007,060855058004007,"Block 4007, Block Group 4, Census Tract 5058, Santa Clara County, California",35,33,2
1000000US060855058004008,060855058004008,"Block 4008, Block Group 4, Census Tract 5058, Santa Clara County, California",19,18,1
1000000US060855058004009,060855058004009,"Block 4009, Block Group 4, Census Tract 5058, Santa Clara County, California",14,14,0
1000000US060855058004010,060855058004010,"Block 4010, Block Group 4, Census Tract 5058, Santa Clara County, California",21,20,1
1000000US060855058004011,060855058004011,"Block 4011, Block Group 4, Census Tract 5058, Santa Clara County, California",16,16,0
1000000US060855058004012,060855058004012,"Block 4012, Block Group 4, Census Tract 5058, Santa Clara County, California",29,29,0
1000000US060855058004013,060855058004013,"Block 4013, Block Group 4, Census Tract 5058, Santa Clara County, California",32,31,1
1000000US060855058004014,060855058004014,"Block 4014, Block Group 4, Census Tract 5058, Santa Clara County, California",33,33,0
1000000US060855058004015,060855058004015,"Block 4015, Block Group 4, Census Tract 5058, Santa Clara County, California",18,18,0
1000000US060855058004016,060855058004016,"Block 4016, Block Group 4, Census Tract 5058, Santa Clara County, California",21,20,1
1000000US060855059001000,060855059001000,"Block 1000, Block Group 1, Census Tract 5059, Santa Clara County, California",0,0,0
1000000US060855059001001,060855059001001,"Block 1001, Block Group 1, Census Tract 5059, Santa Clara County, California",154,148,6
1000000US060855059001002,060855059001002,"Block 1002, Block Group 1, Census Tract 5059, Santa Clara County, California",0,0,0
1000000US060855059001003,060855059001003,"Block 1003, Block Group 1, Census Tract 5059, Santa Clara County, California",2,2,0
1000000US060855059001004,060855059001004,"Block 1004, Block Group 1, Census Tract 5059, Santa Clara County, California",0,0,0
1000000US060855059001005,060855059001005,"Block 1005, Block Group 1, Census Tract 5059, Santa Clara County, California",28,28,0
1000000US060855059001006,060855059001006,"Block 1006, Block Group 1, Census Tract 5059, Santa Clara County, California",176,163,13
1000000US060855059001007,060855059001007,"Block 1007, Block Group 1, Census Tract 5059, Santa Clara County, California",0,0,0
1000000US060855059001008,060855059001008,"Block 1008, Block Group 1, Census Tract 5059, Santa Clara County, California",8,7,1
1000000US060855059001009,060855059001009,"Block 1009, Block Group 1, Census Tract 5059, Santa Clara County, California",0,0,0
1000000US060855059001010,060855059001010,"Block 1010, Block Group 1, Census Tract 5059, Santa Clara County, California",348,339,9
1000000US060855059001011,060855059001011,"Block 1011, Block Group 1, Census Tract 5059, Santa Clara County, California",0,0,0
1000000US060855059001012,060855059001012,"Block 1012, Block Group 1, Census Tract 5059, Santa Clara County, California",6,6,0
1000000US060855059001013,060855059001013,"Block 1013, Block Group 1, Census Tract 5059, Santa Clara County, California",0,0,0
1000000US060855059001014,060855059001014,"Block 1014, Block Group 1, Census Tract 5059, Santa Clara County, California",0,0,0
1000000US060855059001015,060855059001015,"Block 1015, Block Group 1, Census Tract 5059, Santa Clara County, California",0,0,0
1000000US060855059001016,060855059001016,"Block 1016, Block Group 1, Census Tract 5059, Santa Clara County, California",0,0,0
1000000US060855059001017,060855059001017,"Block 1017, Block Group 1, Census Tract 5059, Santa Clara County, California",20,18,2
1000000US060855059001018,060855059001018,"Block 1018, Block Group 1, Census Tract 5059, Santa Clara County, California",45,45,0
1000000US060855059001019,060855059001019,"Block 1019, Block Group 1, Census Tract 5059, Santa Clara County, California",0,0,0
1000000US060855059001020,060855059001020,"Block 1020, Block Group 1, Census Tract 5059, Santa Clara County, California",116,112,4
1000000US060855059001021,060855059001021,"Block 1021, Block Group 1, Census Tract 5059, Santa Clara County, California",22,21,1
1000000US060855059001022,060855059001022,"Block 1022, Block Group 1, Census Tract 5059, Santa Clara County, California",64,55,9
1000000US060855059001023,060855059001023,"Block 1023, Block Group 1, Census Tract 5059, Santa Clara County, California",0,0,0
1000000US060855059001024,060855059001024,"Block 1024, Block Group 1, Census Tract 5059, Santa Clara County, California",0,0,0
1000000US060855059001025,060855059001025,"Block 1025, Block Group 1, Census Tract 5059, Santa Clara County, California",69,69,0
1000000US060855059001026,060855059001026,"Block 1026, Block Group 1, Census Tract 5059, Santa Clara County, California",0,0,0
1000000US060855059001027,060855059001027,"Block 1027, Block Group 1, Census Tract 5059, Santa Clara County, California",0,0,0
1000000US060855059001028,060855059001028,"Block 1028, Block Group 1, Census Tract 5059, Santa Clara County, California",0,0,0
1000000US060855059001029,060855059001029,"Block 1029, Block Group 1, Census Tract 5059, Santa Clara County, California",0,0,0
1000000US060855059002000,060855059002000,"Block 2000, Block Group 2, Census Tract 5059, Santa Clara County, California",0,0,0
1000000US060855059002001,060855059002001,"Block 2001, Block Group 2, Census Tract 5059, Santa Clara County, California",300,269,31
1000000US060855059002002,060855059002002,"Block 2002, Block Group 2, Census Tract 5059, Santa Clara County, California",18,17,1
1000000US060855059002003,060855059002003,"Block 2003, Block Group 2, Census Tract 5059, Santa Clara County, California",28,28,0
1000000US060855059002004,060855059002004,"Block 2004, Block Group 2, Census Tract 5059, Santa Clara County, California",28,28,0
1000000US060855059002005,060855059002005,"Block 2005, Block Group 2, Census Tract 5059, Santa Clara County, California",0,0,0
1000000US060855059002006,060855059002006,"Block 2006, Block Group 2, Census Tract 5059, Santa Clara County, California",13,12,1
1000000US060855059002007,060855059002007,"Block 2007, Block Group 2, Census Tract 5059, Santa Clara County, California",0,0,0
1000000US060855059002008,060855059002008,"Block 2008, Block Group 2, Census Tract 5059, Santa Clara County, California",0,0,0
1000000US060855059002009,060855059002009,"Block 2009, Block Group 2, Census Tract 5059, Santa Clara County, California",0,0,0
1000000US060855059002010,060855059002010,"Block 2010, Block Group 2, Census Tract 5059, Santa Clara County, California",0,0,0
1000000US060855059002011,060855059002011,"Block 2011, Block Group 2, Census Tract 5059, Santa Clara County, California",0,0,0
1000000US060855059002012,060855059002012,"Block 2012, Block Group 2, Census Tract 5059, Santa Clara County, California",28,28,0
1000000US060855059002013,060855059002013,"Block 2013, Block Group 2, Census Tract 5059, Santa Clara County, California",24,24,0
1000000US060855059002014,060855059002014,"Block 2014, Block Group 2, Census Tract 5059, Santa Clara County, California",1,1,0
1000000US060855059002015,060855059002015,"Block 2015, Block Group 2, Census Tract 5059, Santa Clara County, California",0,0,0
1000000US060855059002016,060855059002016,"Block 2016, Block Group 2, Census Tract 5059, Santa Clara County, California",11,11,0
1000000US060855059002017,060855059002017,"Block 2017, Block Group 2, Census Tract 5059, Santa Clara County, California",1,1,0
1000000US060855059002018,060855059002018,"Block 2018, Block Group 2, Census Tract 5059, Santa Clara County, California",36,33,3
1000000US060855059002019,060855059002019,"Block 2019, Block Group 2, Census Tract 5059, Santa Clara County, California",8,8,0
1000000US060855059002020,060855059002020,"Block 2020, Block Group 2, Census Tract 5059, Santa Clara County, California",31,30,1
1000000US060855059002021,060855059002021,"Block 2021, Block Group 2, Census Tract 5059, Santa Clara County, California",22,22,0
1000000US060855059003000,060855059003000,"Block 3000, Block Group 3, Census Tract 5059, Santa Clara County, California",30,29,1
1000000US060855059003001,060855059003001,"Block 3001, Block Group 3, Census Tract 5059, Santa Clara County, California",24,23,1
1000000US060855059003002,060855059003002,"Block 3002, Block Group 3, Census Tract 5059, Santa Clara County, California",87,86,1
1000000US060855059003003,060855059003003,"Block 3003, Block Group 3, Census Tract 5059, Santa Clara County, California",12,12,0
1000000US060855059003004,060855059003004,"Block 3004, Block Group 3, Census Tract 5059, Santa Clara County, California",30,29,1
1000000US060855059003005,060855059003005,"Block 3005, Block Group 3, Census Tract 5059, Santa Clara County, California",31,30,1
1000000US060855059003006,060855059003006,"Block 3006, Block Group 3, Census Tract 5059, Santa Clara County, California",6,6,0
1000000US060855059003007,060855059003007,"Block 3007, Block Group 3, Census Tract 5059, Santa Clara County, California",37,37,0
1000000US060855059003008,060855059003008,"Block 3008, Block Group 3, Census Tract 5059, Santa Clara County, California",0,0,0
1000000US060855059003009,060855059003009,"Block 3009, Block Group 3, Census Tract 5059, Santa Clara County, California",29,27,2
1000000US060855059003010,060855059003010,"Block 3010, Block Group 3, Census Tract 5059, Santa Clara County, California",1,1,0
1000000US060855059003011,060855059003011,"Block 3011, Block Group 3, Census Tract 5059, Santa Clara County, California",0,0,0
1000000US060855059003012,060855059003012,"Block 3012, Block Group 3, Census Tract 5059, Santa Clara County, California",22,21,1
1000000US060855059003013,060855059003013,"Block 3013, Block Group 3, Census Tract 5059, Santa Clara County, California",20,20,0
1000000US060855059003014,060855059003014,"Block 3014, Block Group 3, Census Tract 5059, Santa Clara County, California",0,0,0
1000000US060855059003015,060855059003015,"Block 3015, Block Group 3, Census Tract 5059, Santa Clara County, California",0,0,0
1000000US060855059003016,060855059003016,"Block 3016, Block Group 3, Census Tract 5059, Santa Clara County, California",0,0,0
1000000US060855059003017,060855059003017,"Block 3017, Block Group 3, Census Tract 5059, Santa Clara County, California",0,0,0
1000000US060855059003018,060855059003018,"Block 3018, Block Group 3, Census Tract 5059, Santa Clara County, California",22,22,0
1000000US060855059004000,060855059004000,"Block 4000, Block Group 4, Census Tract 5059, Santa Clara County, California",12,12,0
1000000US060855059004001,060855059004001,"Block 4001, Block Group 4, Census Tract 5059, Santa Clara County, California",77,73,4
1000000US060855059004002,060855059004002,"Block 4002, Block Group 4, Census Tract 5059, Santa Clara County, California",0,0,0
1000000US060855059004003,060855059004003,"Block 4003, Block Group 4, Census Tract 5059, Santa Clara County, California",0,0,0
1000000US060855059004004,060855059004004,"Block 4004, Block Group 4, Census Tract 5059, Santa Clara County, California",185,181,4
1000000US060855059004005,060855059004005,"Block 4005, Block Group 4, Census Tract 5059, Santa Clara County, California",25,25,0
1000000US060855059004006,060855059004006,"Block 4006, Block Group 4, Census Tract 5059, Santa Clara County, California",15,15,0
1000000US060855059004007,060855059004007,"Block 4007, Block Group 4, Census Tract 5059, Santa Clara County, California",35,33,2
1000000US060855059004008,060855059004008,"Block 4008, Block Group 4, Census Tract 5059, Santa Clara County, California",18,18,0
1000000US060855059004009,060855059004009,"Block 4009, Block Group 4, Census Tract 5059, Santa Clara County, California",0,0,0
1000000US060855059004010,060855059004010,"Block 4010, Block Group 4, Census Tract 5059, Santa Clara County, California",30,28,2
1000000US060855059004011,060855059004011,"Block 4011, Block Group 4, Census Tract 5059, Santa Clara County, California",31,30,1
1000000US060855059004012,060855059004012,"Block 4012, Block Group 4, Census Tract 5059, Santa Clara County, California",0,0,0
1000000US060855059004013,060855059004013,"Block 4013, Block Group 4, Census Tract 5059, Santa Clara County, California",0,0,0
1000000US060855059004014,060855059004014,"Block 4014, Block Group 4, Census Tract 5059, Santa Clara County, California",0,0,0
1000000US060855059004015,060855059004015,"Block 4015, Block Group 4, Census Tract 5059, Santa Clara County, California",0,0,0
1000000US060855059004016,060855059004016,"Block 4016, Block Group 4, Census Tract 5059, Santa Clara County, California",0,0,0
1000000US060855059004017,060855059004017,"Block 4017, Block Group 4, Census Tract 5059, Santa Clara County, California",0,0,0
1000000US060855059004018,060855059004018,"Block 4018, Block Group 4, Census Tract 5059, Santa Clara County, California",0,0,0
1000000US060855059004019,060855059004019,"Block 4019, Block Group 4, Census Tract 5059, Santa Clara County, California",340,317,23
1000000US060855059004020,060855059004020,"Block 4020, Block Group 4, Census Tract 5059, Santa Clara County, California",0,0,0
1000000US060855059004021,060855059004021,"Block 4021, Block Group 4, Census Tract 5059, Santa Clara County, California",0,0,0
1000000US060855059004022,060855059004022,"Block 4022, Block Group 4, Census Tract 5059, Santa Clara County, California",0,0,0
1000000US060855059004023,060855059004023,"Block 4023, Block Group 4, Census Tract 5059, Santa Clara County, California",0,0,0
1000000US060855059004024,060855059004024,"Block 4024, Block Group 4, Census Tract 5059, Santa Clara County, California",0,0,0
1000000US060855059004025,060855059004025,"Block 4025, Block Group 4, Census Tract 5059, Santa Clara County, California",0,0,0
1000000US060855059004026,060855059004026,"Block 4026, Block Group 4, Census Tract 5059, Santa Clara County, California",0,0,0
1000000US060855059004027,060855059004027,"Block 4027, Block Group 4, Census Tract 5059, Santa Clara County, California",0,0,0
1000000US060855059005000,060855059005000,"Block 5000, Block Group 5, Census Tract 5059, Santa Clara County, California",34,34,0
1000000US060855059005001,060855059005001,"Block 5001, Block Group 5, Census Tract 5059, Santa Clara County, California",23,23,0
1000000US060855059005002,060855059005002,"Block 5002, Block Group 5, Census Tract 5059, Santa Clara County, California",36,34,2
1000000US060855059005003,060855059005003,"Block 5003, Block Group 5, Census Tract 5059, Santa Clara County, California",0,0,0
1000000US060855059005004,060855059005004,"Block 5004, Block Group 5, Census Tract 5059, Santa Clara County, California",0,0,0
1000000US060855059005005,060855059005005,"Block 5005, Block Group 5, Census Tract 5059, Santa Clara County, California",24,23,1
1000000US060855059005006,060855059005006,"Block 5006, Block Group 5, Census Tract 5059, Santa Clara County, California",8,8,0
1000000US060855059005007,060855059005007,"Block 5007, Block Group 5, Census Tract 5059, Santa Clara County, California",140,134,6
1000000US060855059005008,060855059005008,"Block 5008, Block Group 5, Census Tract 5059, Santa Clara County, California",0,0,0
1000000US060855059005009,060855059005009,"Block 5009, Block Group 5, Census Tract 5059, Santa Clara County, California",0,0,0
1000000US060855059005010,060855059005010,"Block 5010, Block Group 5, Census Tract 5059, Santa Clara County, California",38,36,2
1000000US060855059005011,060855059005011,"Block 5011, Block Group 5, Census Tract 5059, Santa Clara County, California",28,28,0
1000000US060855059005012,060855059005012,"Block 5012, Block Group 5, Census Tract 5059, Santa Clara County, California",25,23,2
1000000US060855059005013,060855059005013,"Block 5013, Block Group 5, Census Tract 5059, Santa Clara County, California",16,16,0
1000000US060855059005014,060855059005014,"Block 5014, Block Group 5, Census Tract 5059, Santa Clara County, California",49,49,0
1000000US060855059005015,060855059005015,"Block 5015, Block Group 5, Census Tract 5059, Santa Clara County, California",40,39,1
1000000US060855059005016,060855059005016,"Block 5016, Block Group 5, Census Tract 5059, Santa Clara County, California",0,0,0
1000000US060855059005017,060855059005017,"Block 5017, Block Group 5, Census Tract 5059, Santa Clara County, California",0,0,0
1000000US060855060001000,060855060001000,"Block 1000, Block Group 1, Census Tract 5060, Santa Clara County, California",26,25,1
1000000US060855060001001,060855060001001,"Block 1001, Block Group 1, Census Tract 5060, Santa Clara County, California",23,23,0
1000000US060855060001002,060855060001002,"Block 1002, Block Group 1, Census Tract 5060, Santa Clara County, California",20,19,1
1000000US060855060001003,060855060001003,"Block 1003, Block Group 1, Census Tract 5060, Santa Clara County, California",16,15,1
1000000US060855060001004,060855060001004,"Block 1004, Block Group 1, Census Tract 5060, Santa Clara County, California",0,0,0
1000000US060855060001005,060855060001005,"Block 1005, Block Group 1, Census Tract 5060, Santa Clara County, California",27,27,0
1000000US060855060001006,060855060001006,"Block 1006, Block Group 1, Census Tract 5060, Santa Clara County, California",17,17,0
1000000US060855060001007,060855060001007,"Block 1007, Block Group 1, Census Tract 5060, Santa Clara County, California",13,13,0
1000000US060855060001008,060855060001008,"Block 1008, Block Group 1, Census Tract 5060, Santa Clara County, California",41,38,3
1000000US060855060001009,060855060001009,"Block 1009, Block Group 1, Census Tract 5060, Santa Clara County, California",121,113,8
1000000US060855060001010,060855060001010,"Block 1010, Block Group 1, Census Tract 5060, Santa Clara County, California",39,38,1
1000000US060855060001011,060855060001011,"Block 1011, Block Group 1, Census Tract 5060, Santa Clara County, California",0,0,0
1000000US060855060001012,060855060001012,"Block 1012, Block Group 1, Census Tract 5060, Santa Clara County, California",62,59,3
1000000US060855060001013,060855060001013,"Block 1013, Block Group 1, Census Tract 5060, Santa Clara County, California",0,0,0
1000000US060855060002000,060855060002000,"Block 2000, Block Group 2, Census Tract 5060, Santa Clara County, California",0,0,0
1000000US060855060002001,060855060002001,"Block 2001, Block Group 2, Census Tract 5060, Santa Clara County, California",0,0,0
1000000US060855060002002,060855060002002,"Block 2002, Block Group 2, Census Tract 5060, Santa Clara County, California",4,4,0
1000000US060855060002003,060855060002003,"Block 2003, Block Group 2, Census Tract 5060, Santa Clara County, California",25,24,1
1000000US060855060002004,060855060002004,"Block 2004, Block Group 2, Census Tract 5060, Santa Clara County, California",20,20,0
1000000US060855060002005,060855060002005,"Block 2005, Block Group 2, Census Tract 5060, Santa Clara County, California",21,21,0
1000000US060855060002006,060855060002006,"Block 2006, Block Group 2, Census Tract 5060, Santa Clara County, California",18,18,0
1000000US060855060002007,060855060002007,"Block 2007, Block Group 2, Census Tract 5060, Santa Clara County, California",38,37,1
1000000US060855060002008,060855060002008,"Block 2008, Block Group 2, Census Tract 5060, Santa Clara County, California",37,37,0
1000000US060855060002009,060855060002009,"Block 2009, Block Group 2, Census Tract 5060, Santa Clara County, California",36,36,0
1000000US060855060002010,060855060002010,"Block 2010, Block Group 2, Census Tract 5060, Santa Clara County, California",18,16,2
1000000US060855060002011,060855060002011,"Block 2011, Block Group 2, Census Tract 5060, Santa Clara County, California",32,32,0
1000000US060855060002012,060855060002012,"Block 2012, Block Group 2, Census Tract 5060, Santa Clara County, California",38,36,2
1000000US060855060002013,060855060002013,"Block 2013, Block Group 2, Census Tract 5060, Santa Clara County, California",17,17,0
1000000US060855060002014,060855060002014,"Block 2014, Block Group 2, Census Tract 5060, Santa Clara County, California",0,0,0
1000000US060855060002015,060855060002015,"Block 2015, Block Group 2, Census Tract 5060, Santa Clara County, California",0,0,0
1000000US060855060002016,060855060002016,"Block 2016, Block Group 2, Census Tract 5060, Santa Clara County, California",0,0,0
1000000US060855060003000,060855060003000,"Block 3000, Block Group 3, Census Tract 5060, Santa Clara County, California",0,0,0
1000000US060855060003001,060855060003001,"Block 3001, Block Group 3, Census Tract 5060, Santa Clara County, California",0,0,0
1000000US060855060003002,060855060003002,"Block 3002, Block Group 3, Census Tract 5060, Santa Clara County, California",0,0,0
1000000US060855060003003,060855060003003,"Block 3003, Block Group 3, Census Tract 5060, Santa Clara County, California",115,110,5
1000000US060855060003004,060855060003004,"Block 3004, Block Group 3, Census Tract 5060, Santa Clara County, California",38,38,0
1000000US060855060003005,060855060003005,"Block 3005, Block Group 3, Census Tract 5060, Santa Clara County, California",22,22,0
1000000US060855060003006,060855060003006,"Block 3006, Block Group 3, Census Tract 5060, Santa Clara County, California",26,25,1
1000000US060855060003007,060855060003007,"Block 3007, Block Group 3, Census Tract 5060, Santa Clara County, California",70,65,5
1000000US060855060003008,060855060003008,"Block 3008, Block Group 3, Census Tract 5060, Santa Clara County, California",65,64,1
1000000US060855060003009,060855060003009,"Block 3009, Block Group 3, Census Tract 5060, Santa Clara County, California",14,14,0
1000000US060855060003010,060855060003010,"Block 3010, Block Group 3, Census Tract 5060, Santa Clara County, California",0,0,0
1000000US060855060003011,060855060003011,"Block 3011, Block Group 3, Census Tract 5060, Santa Clara County, California",0,0,0
1000000US060855060003012,060855060003012,"Block 3012, Block Group 3, Census Tract 5060, Santa Clara County, California",444,435,9
1000000US060855060003013,060855060003013,"Block 3013, Block Group 3, Census Tract 5060, Santa Clara County, California",8,8,0
1000000US060855060003014,060855060003014,"Block 3014, Block Group 3, Census Tract 5060, Santa Clara County, California",67,62,5
1000000US060855060003015,060855060003015,"Block 3015, Block Group 3, Census Tract 5060, Santa Clara County, California",0,0,0
1000000US060855060003016,060855060003016,"Block 3016, Block Group 3, Census Tract 5060, Santa Clara County, California",22,22,0
1000000US060855060003017,060855060003017,"Block 3017, Block Group 3, Census Tract 5060, Santa Clara County, California",0,0,0
1000000US060855060003018,060855060003018,"Block 3018, Block Group 3, Census Tract 5060, Santa Clara County, California",0,0,0
1000000US060855060003019,060855060003019,"Block 3019, Block Group 3, Census Tract 5060, Santa Clara County, California",0,0,0
1000000US060855060003020,060855060003020,"Block 3020, Block Group 3, Census Tract 5060, Santa Clara County, California",0,0,0
1000000US060855060003021,060855060003021,"Block 3021, Block Group 3, Census Tract 5060, Santa Clara County, California",0,0,0
1000000US060855060003022,060855060003022,"Block 3022, Block Group 3, Census Tract 5060, Santa Clara County, California",24,23,1
1000000US060855060004000,060855060004000,"Block 4000, Block Group 4, Census Tract 5060, Santa Clara County, California",0,0,0
1000000US060855060004001,060855060004001,"Block 4001, Block Group 4, Census Tract 5060, Santa Clara County, California",112,105,7
1000000US060855060004002,060855060004002,"Block 4002, Block Group 4, Census Tract 5060, Santa Clara County, California",18,16,2
1000000US060855060004003,060855060004003,"Block 4003, Block Group 4, Census Tract 5060, Santa Clara County, California",16,16,0
1000000US060855060004004,060855060004004,"Block 4004, Block Group 4, Census Tract 5060, Santa Clara County, California",15,15,0
1000000US060855060004005,060855060004005,"Block 4005, Block Group 4, Census Tract 5060, Santa Clara County, California",39,38,1
1000000US060855060004006,060855060004006,"Block 4006, Block Group 4, Census Tract 5060, Santa Clara County, California",41,41,0
1000000US060855060004007,060855060004007,"Block 4007, Block Group 4, Census Tract 5060, Santa Clara County, California",40,39,1
1000000US060855061011000,060855061011000,"Block 1000, Block Group 1, Census Tract 5061.01, Santa Clara County, California",0,0,0
1000000US060855061011001,060855061011001,"Block 1001, Block Group 1, Census Tract 5061.01, Santa Clara County, California",0,0,0
1000000US060855061011002,060855061011002,"Block 1002, Block Group 1, Census Tract 5061.01, Santa Clara County, California",51,50,1
1000000US060855061011003,060855061011003,"Block 1003, Block Group 1, Census Tract 5061.01, Santa Clara County, California",38,38,0
1000000US060855061011004,060855061011004,"Block 1004, Block Group 1, Census Tract 5061.01, Santa Clara County, California",30,30,0
1000000US060855061011005,060855061011005,"Block 1005, Block Group 1, Census Tract 5061.01, Santa Clara County, California",43,42,1
1000000US060855061011006,060855061011006,"Block 1006, Block Group 1, Census Tract 5061.01, Santa Clara County, California",42,41,1
1000000US060855061011007,060855061011007,"Block 1007, Block Group 1, Census Tract 5061.01, Santa Clara County, California",36,35,1
1000000US060855061011008,060855061011008,"Block 1008, Block Group 1, Census Tract 5061.01, Santa Clara County, California",19,19,0
1000000US060855061011009,060855061011009,"Block 1009, Block Group 1, Census Tract 5061.01, Santa Clara County, California",31,31,0
1000000US060855061011010,060855061011010,"Block 1010, Block Group 1, Census Tract 5061.01, Santa Clara County, California",40,38,2
1000000US060855061011011,060855061011011,"Block 1011, Block Group 1, Census Tract 5061.01, Santa Clara County, California",45,45,0
1000000US060855061011012,060855061011012,"Block 1012, Block Group 1, Census Tract 5061.01, Santa Clara County, California",43,43,0
1000000US060855061011013,060855061011013,"Block 1013, Block Group 1, Census Tract 5061.01, Santa Clara County, California",24,23,1
1000000US060855061011014,060855061011014,"Block 1014, Block Group 1, Census Tract 5061.01, Santa Clara County, California",0,0,0
1000000US060855061011015,060855061011015,"Block 1015, Block Group 1, Census Tract 5061.01, Santa Clara County, California",0,0,0
1000000US060855061011016,060855061011016,"Block 1016, Block Group 1, Census Tract 5061.01, Santa Clara County, California",0,0,0
1000000US060855061012000,060855061012000,"Block 2000, Block Group 2, Census Tract 5061.01, Santa Clara County, California",0,0,0
1000000US060855061012001,060855061012001,"Block 2001, Block Group 2, Census Tract 5061.01, Santa Clara County, California",0,0,0
1000000US060855061012002,060855061012002,"Block 2002, Block Group 2, Census Tract 5061.01, Santa Clara County, California",35,35,0
1000000US060855061012003,060855061012003,"Block 2003, Block Group 2, Census Tract 5061.01, Santa Clara County, California",0,0,0
1000000US060855061012004,060855061012004,"Block 2004, Block Group 2, Census Tract 5061.01, Santa Clara County, California",0,0,0
1000000US060855061012005,060855061012005,"Block 2005, Block Group 2, Census Tract 5061.01, Santa Clara County, California",0,0,0
1000000US060855061012006,060855061012006,"Block 2006, Block Group 2, Census Tract 5061.01, Santa Clara County, California",73,69,4
1000000US060855061012007,060855061012007,"Block 2007, Block Group 2, Census Tract 5061.01, Santa Clara County, California",157,152,5
1000000US060855061012008,060855061012008,"Block 2008, Block Group 2, Census Tract 5061.01, Santa Clara County, California",56,52,4
1000000US060855061012009,060855061012009,"Block 2009, Block Group 2, Census Tract 5061.01, Santa Clara County, California",10,10,0
1000000US060855061012010,060855061012010,"Block 2010, Block Group 2, Census Tract 5061.01, Santa Clara County, California",25,25,0
1000000US060855061012011,060855061012011,"Block 2011, Block Group 2, Census Tract 5061.01, Santa Clara County, California",14,14,0
1000000US060855061012012,060855061012012,"Block 2012, Block Group 2, Census Tract 5061.01, Santa Clara County, California",59,59,0
1000000US060855061012013,060855061012013,"Block 2013, Block Group 2, Census Tract 5061.01, Santa Clara County, California",18,18,0
1000000US060855061012014,060855061012014,"Block 2014, Block Group 2, Census Tract 5061.01, Santa Clara County, California",35,35,0
1000000US060855061012015,060855061012015,"Block 2015, Block Group 2, Census Tract 5061.01, Santa Clara County, California",22,21,1
1000000US060855061012016,060855061012016,"Block 2016, Block Group 2, Census Tract 5061.01, Santa Clara County, California",25,23,2
1000000US060855061012017,060855061012017,"Block 2017, Block Group 2, Census Tract 5061.01, Santa Clara County, California",29,28,1
1000000US060855061012018,060855061012018,"Block 2018, Block Group 2, Census Tract 5061.01, Santa Clara County, California",33,33,0
1000000US060855061012019,060855061012019,"Block 2019, Block Group 2, Census Tract 5061.01, Santa Clara County, California",24,24,0
1000000US060855061012020,060855061012020,"Block 2020, Block Group 2, Census Tract 5061.01, Santa Clara County, California",58,54,4
1000000US060855061012021,060855061012021,"Block 2021, Block Group 2, Census Tract 5061.01, Santa Clara County, California",0,0,0
1000000US060855061012022,060855061012022,"Block 2022, Block Group 2, Census Tract 5061.01, Santa Clara County, California",0,0,0
1000000US060855061012023,060855061012023,"Block 2023, Block Group 2, Census Tract 5061.01, Santa Clara County, California",0,0,0
1000000US060855061012024,060855061012024,"Block 2024, Block Group 2, Census Tract 5061.01, Santa Clara County, California",0,0,0
1000000US060855061012025,060855061012025,"Block 2025, Block Group 2, Census Tract 5061.01, Santa Clara County, California",0,0,0
1000000US060855061012026,060855061012026,"Block 2026, Block Group 2, Census Tract 5061.01, Santa Clara County, California",0,0,0
1000000US060855061013000,060855061013000,"Block 3000, Block Group 3, Census Tract 5061.01, Santa Clara County, California",0,0,0
1000000US060855061013001,060855061013001,"Block 3001, Block Group 3, Census Tract 5061.01, Santa Clara County, California",0,0,0
1000000US060855061013002,060855061013002,"Block 3002, Block Group 3, Census Tract 5061.01, Santa Clara County, California",0,0,0
1000000US060855061013003,060855061013003,"Block 3003, Block Group 3, Census Tract 5061.01, Santa Clara County, California",19,19,0
1000000US060855061013004,060855061013004,"Block 3004, Block Group 3, Census Tract 5061.01, Santa Clara County, California",4,4,0
1000000US060855061013005,060855061013005,"Block 3005, Block Group 3, Census Tract 5061.01, Santa Clara County, California",0,0,0
1000000US060855061013006,060855061013006,"Block 3006, Block Group 3, Census Tract 5061.01, Santa Clara County, California",0,0,0
1000000US060855061013007,060855061013007,"Block 3007, Block Group 3, Census Tract 5061.01, Santa Clara County, California",72,72,0
1000000US060855061013008,060855061013008,"Block 3008, Block Group 3, Census Tract 5061.01, Santa Clara County, California",81,80,1
1000000US060855061013009,060855061013009,"Block 3009, Block Group 3, Census Tract 5061.01, Santa Clara County, California",66,63,3
1000000US060855061013010,060855061013010,"Block 3010, Block Group 3, Census Tract 5061.01, Santa Clara County, California",82,79,3
1000000US060855061013011,060855061013011,"Block 3011, Block Group 3, Census Tract 5061.01, Santa Clara County, California",43,43,0
1000000US060855061013012,060855061013012,"Block 3012, Block Group 3, Census Tract 5061.01, Santa Clara County, California",0,0,0
1000000US060855061013013,060855061013013,"Block 3013, Block Group 3, Census Tract 5061.01, Santa Clara County, California",0,0,0
1000000US060855061013014,060855061013014,"Block 3014, Block Group 3, Census Tract 5061.01, Santa Clara County, California",91,90,1
1000000US060855061013015,060855061013015,"Block 3015, Block Group 3, Census Tract 5061.01, Santa Clara County, California",33,32,1
1000000US060855061013016,060855061013016,"Block 3016, Block Group 3, Census Tract 5061.01, Santa Clara County, California",23,23,0
1000000US060855061013017,060855061013017,"Block 3017, Block Group 3, Census Tract 5061.01, Santa Clara County, California",43,43,0
1000000US060855061013018,060855061013018,"Block 3018, Block Group 3, Census Tract 5061.01, Santa Clara County, California",39,39,0
1000000US060855061013019,060855061013019,"Block 3019, Block Group 3, Census Tract 5061.01, Santa Clara County, California",27,27,0
1000000US060855061021000,060855061021000,"Block 1000, Block Group 1, Census Tract 5061.02, Santa Clara County, California",104,104,0
1000000US060855061021001,060855061021001,"Block 1001, Block Group 1, Census Tract 5061.02, Santa Clara County, California",36,35,1
1000000US060855061021002,060855061021002,"Block 1002, Block Group 1, Census Tract 5061.02, Santa Clara County, California",36,35,1
1000000US060855061021003,060855061021003,"Block 1003, Block Group 1, Census Tract 5061.02, Santa Clara County, California",18,18,0
1000000US060855061021004,060855061021004,"Block 1004, Block Group 1, Census Tract 5061.02, Santa Clara County, California",0,0,0
1000000US060855061021005,060855061021005,"Block 1005, Block Group 1, Census Tract 5061.02, Santa Clara County, California",26,26,0
1000000US060855061021006,060855061021006,"Block 1006, Block Group 1, Census Tract 5061.02, Santa Clara County, California",36,34,2
1000000US060855061021007,060855061021007,"Block 1007, Block Group 1, Census Tract 5061.02, Santa Clara County, California",36,36,0
1000000US060855061021008,060855061021008,"Block 1008, Block Group 1, Census Tract 5061.02, Santa Clara County, California",36,34,2
1000000US060855061021009,060855061021009,"Block 1009, Block Group 1, Census Tract 5061.02, Santa Clara County, California",0,0,0
1000000US060855061021010,060855061021010,"Block 1010, Block Group 1, Census Tract 5061.02, Santa Clara County, California",0,0,0
1000000US060855061021011,060855061021011,"Block 1011, Block Group 1, Census Tract 5061.02, Santa Clara County, California",10,10,0
1000000US060855061021012,060855061021012,"Block 1012, Block Group 1, Census Tract 5061.02, Santa Clara County, California",41,40,1
1000000US060855061021013,060855061021013,"Block 1013, Block Group 1, Census Tract 5061.02, Santa Clara County, California",18,16,2
1000000US060855061021014,060855061021014,"Block 1014, Block Group 1, Census Tract 5061.02, Santa Clara County, California",36,36,0
1000000US060855061021015,060855061021015,"Block 1015, Block Group 1, Census Tract 5061.02, Santa Clara County, California",36,35,1
1000000US060855061021016,060855061021016,"Block 1016, Block Group 1, Census Tract 5061.02, Santa Clara County, California",0,0,0
1000000US060855061021017,060855061021017,"Block 1017, Block Group 1, Census Tract 5061.02, Santa Clara County, California",0,0,0
1000000US060855061021018,060855061021018,"Block 1018, Block Group 1, Census Tract 5061.02, Santa Clara County, California",39,36,3
1000000US060855061021019,060855061021019,"Block 1019, Block Group 1, Census Tract 5061.02, Santa Clara County, California",18,18,0
1000000US060855061021020,060855061021020,"Block 1020, Block Group 1, Census Tract 5061.02, Santa Clara County, California",0,0,0
1000000US060855061022000,060855061022000,"Block 2000, Block Group 2, Census Tract 5061.02, Santa Clara County, California",61,61,0
1000000US060855061022001,060855061022001,"Block 2001, Block Group 2, Census Tract 5061.02, Santa Clara County, California",0,0,0
1000000US060855061022002,060855061022002,"Block 2002, Block Group 2, Census Tract 5061.02, Santa Clara County, California",0,0,0
1000000US060855061022003,060855061022003,"Block 2003, Block Group 2, Census Tract 5061.02, Santa Clara County, California",67,66,1
1000000US060855061022004,060855061022004,"Block 2004, Block Group 2, Census Tract 5061.02, Santa Clara County, California",0,0,0
1000000US060855061022005,060855061022005,"Block 2005, Block Group 2, Census Tract 5061.02, Santa Clara County, California",0,0,0
1000000US060855061022006,060855061022006,"Block 2006, Block Group 2, Census Tract 5061.02, Santa Clara County, California",39,38,1
1000000US060855061022007,060855061022007,"Block 2007, Block Group 2, Census Tract 5061.02, Santa Clara County, California",0,0,0
1000000US060855061022008,060855061022008,"Block 2008, Block Group 2, Census Tract 5061.02, Santa Clara County, California",0,0,0
1000000US060855061022009,060855061022009,"Block 2009, Block Group 2, Census Tract 5061.02, Santa Clara County, California",0,0,0
1000000US060855061022010,060855061022010,"Block 2010, Block Group 2, Census Tract 5061.02, Santa Clara County, California",0,0,0
1000000US060855061022011,060855061022011,"Block 2011, Block Group 2, Census Tract 5061.02, Santa Clara County, California",42,42,0
1000000US060855061022012,060855061022012,"Block 2012, Block Group 2, Census Tract 5061.02, Santa Clara County, California",36,35,1
1000000US060855061022013,060855061022013,"Block 2013, Block Group 2, Census Tract 5061.02, Santa Clara County, California",0,0,0
1000000US060855061022014,060855061022014,"Block 2014, Block Group 2, Census Tract 5061.02, Santa Clara County, California",91,90,1
1000000US060855061022015,060855061022015,"Block 2015, Block Group 2, Census Tract 5061.02, Santa Clara County, California",17,17,0
1000000US060855061022016,060855061022016,"Block 2016, Block Group 2, Census Tract 5061.02, Santa Clara County, California",66,64,2
1000000US060855061022017,060855061022017,"Block 2017, Block Group 2, Census Tract 5061.02, Santa Clara County, California",0,0,0
1000000US060855061022018,060855061022018,"Block 2018, Block Group 2, Census Tract 5061.02, Santa Clara County, California",20,18,2
1000000US060855061022019,060855061022019,"Block 2019, Block Group 2, Census Tract 5061.02, Santa Clara County, California",25,25,0
1000000US060855061022020,060855061022020,"Block 2020, Block Group 2, Census Tract 5061.02, Santa Clara County, California",19,19,0
1000000US060855061022021,060855061022021,"Block 2021, Block Group 2, Census Tract 5061.02, Santa Clara County, California",140,125,15
1000000US060855061022022,060855061022022,"Block 2022, Block Group 2, Census Tract 5061.02, Santa Clara County, California",62,59,3
1000000US060855061022023,060855061022023,"Block 2023, Block Group 2, Census Tract 5061.02, Santa Clara County, California",160,149,11
1000000US060855061022024,060855061022024,"Block 2024, Block Group 2, Census Tract 5061.02, Santa Clara County, California",2,2,0
1000000US060855061022025,060855061022025,"Block 2025, Block Group 2, Census Tract 5061.02, Santa Clara County, California",0,0,0
1000000US060855061022026,060855061022026,"Block 2026, Block Group 2, Census Tract 5061.02, Santa Clara County, California",0,0,0
1000000US060855061022027,060855061022027,"Block 2027, Block Group 2, Census Tract 5061.02, Santa Clara County, California",0,0,0
1000000US060855061022028,060855061022028,"Block 2028, Block Group 2, Census Tract 5061.02, Santa Clara County, California",0,0,0
1000000US060855061022029,060855061022029,"Block 2029, Block Group 2, Census Tract 5061.02, Santa Clara County, California",0,0,0
1000000US060855061022030,060855061022030,"Block 2030, Block Group 2, Census Tract 5061.02, Santa Clara County, California",0,0,0
1000000US060855061022031,060855061022031,"Block 2031, Block Group 2, Census Tract 5061.02, Santa Clara County, California",0,0,0
1000000US060855061022032,060855061022032,"Block 2032, Block Group 2, Census Tract 5061.02, Santa Clara County, California",0,0,0
1000000US060855061022033,060855061022033,"Block 2033, Block Group 2, Census Tract 5061.02, Santa Clara County, California",72,70,2
1000000US060855061022034,060855061022034,"Block 2034, Block Group 2, Census Tract 5061.02, Santa Clara County, California",161,147,14
1000000US060855061031000,060855061031000,"Block 1000, Block Group 1, Census Tract 5061.03, Santa Clara County, California",65,65,0
1000000US060855061031001,060855061031001,"Block 1001, Block Group 1, Census Tract 5061.03, Santa Clara County, California",16,16,0
1000000US060855061031002,060855061031002,"Block 1002, Block Group 1, Census Tract 5061.03, Santa Clara County, California",16,16,0
1000000US060855061031003,060855061031003,"Block 1003, Block Group 1, Census Tract 5061.03, Santa Clara County, California",36,35,1
1000000US060855061031004,060855061031004,"Block 1004, Block Group 1, Census Tract 5061.03, Santa Clara County, California",13,13,0
1000000US060855061031005,060855061031005,"Block 1005, Block Group 1, Census Tract 5061.03, Santa Clara County, California",11,11,0
1000000US060855061031006,060855061031006,"Block 1006, Block Group 1, Census Tract 5061.03, Santa Clara County, California",184,170,14
1000000US060855061031007,060855061031007,"Block 1007, Block Group 1, Census Tract 5061.03, Santa Clara County, California",28,26,2
1000000US060855061031008,060855061031008,"Block 1008, Block Group 1, Census Tract 5061.03, Santa Clara County, California",0,0,0
1000000US060855061031009,060855061031009,"Block 1009, Block Group 1, Census Tract 5061.03, Santa Clara County, California",36,33,3
1000000US060855061031010,060855061031010,"Block 1010, Block Group 1, Census Tract 5061.03, Santa Clara County, California",0,0,0
1000000US060855061031011,060855061031011,"Block 1011, Block Group 1, Census Tract 5061.03, Santa Clara County, California",0,0,0
1000000US060855061031012,060855061031012,"Block 1012, Block Group 1, Census Tract 5061.03, Santa Clara County, California",16,16,0
1000000US060855061031013,060855061031013,"Block 1013, Block Group 1, Census Tract 5061.03, Santa Clara County, California",60,60,0
1000000US060855061031014,060855061031014,"Block 1014, Block Group 1, Census Tract 5061.03, Santa Clara County, California",39,38,1
1000000US060855061031015,060855061031015,"Block 1015, Block Group 1, Census Tract 5061.03, Santa Clara County, California",16,16,0
1000000US060855061031016,060855061031016,"Block 1016, Block Group 1, Census Tract 5061.03, Santa Clara County, California",47,46,1
1000000US060855061031017,060855061031017,"Block 1017, Block Group 1, Census Tract 5061.03, Santa Clara County, California",17,16,1
1000000US060855061031018,060855061031018,"Block 1018, Block Group 1, Census Tract 5061.03, Santa Clara County, California",13,13,0
1000000US060855061031019,060855061031019,"Block 1019, Block Group 1, Census Tract 5061.03, Santa Clara County, California",0,0,0
1000000US060855061032000,060855061032000,"Block 2000, Block Group 2, Census Tract 5061.03, Santa Clara County, California",30,30,0
1000000US060855061032001,060855061032001,"Block 2001, Block Group 2, Census Tract 5061.03, Santa Clara County, California",32,31,1
1000000US060855061032002,060855061032002,"Block 2002, Block Group 2, Census Tract 5061.03, Santa Clara County, California",19,19,0
1000000US060855061032003,060855061032003,"Block 2003, Block Group 2, Census Tract 5061.03, Santa Clara County, California",37,37,0
1000000US060855061032004,060855061032004,"Block 2004, Block Group 2, Census Tract 5061.03, Santa Clara County, California",17,16,1
1000000US060855061032005,060855061032005,"Block 2005, Block Group 2, Census Tract 5061.03, Santa Clara County, California",63,61,2
1000000US060855061032006,060855061032006,"Block 2006, Block Group 2, Census Tract 5061.03, Santa Clara County, California",23,23,0
1000000US060855061032007,060855061032007,"Block 2007, Block Group 2, Census Tract 5061.03, Santa Clara County, California",33,33,0
1000000US060855061032008,060855061032008,"Block 2008, Block Group 2, Census Tract 5061.03, Santa Clara County, California",37,36,1
1000000US060855061032009,060855061032009,"Block 2009, Block Group 2, Census Tract 5061.03, Santa Clara County, California",22,22,0
1000000US060855061032010,060855061032010,"Block 2010, Block Group 2, Census Tract 5061.03, Santa Clara County, California",0,0,0
1000000US060855061033000,060855061033000,"Block 3000, Block Group 3, Census Tract 5061.03, Santa Clara County, California",35,33,2
1000000US060855061033001,060855061033001,"Block 3001, Block Group 3, Census Tract 5061.03, Santa Clara County, California",37,35,2
1000000US060855061033002,060855061033002,"Block 3002, Block Group 3, Census Tract 5061.03, Santa Clara County, California",38,37,1
1000000US060855061033003,060855061033003,"Block 3003, Block Group 3, Census Tract 5061.03, Santa Clara County, California",35,35,0
1000000US060855061033004,060855061033004,"Block 3004, Block Group 3, Census Tract 5061.03, Santa Clara County, California",72,56,16
1000000US060855061033005,060855061033005,"Block 3005, Block Group 3, Census Tract 5061.03, Santa Clara County, California",37,37,0
1000000US060855061033006,060855061033006,"Block 3006, Block Group 3, Census Tract 5061.03, Santa Clara County, California",8,8,0
1000000US060855061033007,060855061033007,"Block 3007, Block Group 3, Census Tract 5061.03, Santa Clara County, California",0,0,0
1000000US060855061033008,060855061033008,"Block 3008, Block Group 3, Census Tract 5061.03, Santa Clara County, California",0,0,0
1000000US060855061033009,060855061033009,"Block 3009, Block Group 3, Census Tract 5061.03, Santa Clara County, California",0,0,0
1000000US060855061033010,060855061033010,"Block 3010, Block Group 3, Census Tract 5061.03, Santa Clara County, California",27,27,0
1000000US060855061033011,060855061033011,"Block 3011, Block Group 3, Census Tract 5061.03, Santa Clara County, California",39,38,1
1000000US060855061034000,060855061034000,"Block 4000, Block Group 4, Census Tract 5061.03, Santa Clara County, California",0,0,0
1000000US060855061034001,060855061034001,"Block 4001, Block Group 4, Census Tract 5061.03, Santa Clara County, California",46,46,0
1000000US060855061034002,060855061034002,"Block 4002, Block Group 4, Census Tract 5061.03, Santa Clara County, California",35,35,0
1000000US060855061034003,060855061034003,"Block 4003, Block Group 4, Census Tract 5061.03, Santa Clara County, California",27,26,1
1000000US060855061034004,060855061034004,"Block 4004, Block Group 4, Census Tract 5061.03, Santa Clara County, California",8,7,1
1000000US060855061034005,060855061034005,"Block 4005, Block Group 4, Census Tract 5061.03, Santa Clara County, California",0,0,0
1000000US060855061034006,060855061034006,"Block 4006, Block Group 4, Census Tract 5061.03, Santa Clara County, California",50,50,0
1000000US060855061034007,060855061034007,"Block 4007, Block Group 4, Census Tract 5061.03, Santa Clara County, California",61,60,1
1000000US060855061034008,060855061034008,"Block 4008, Block Group 4, Census Tract 5061.03, Santa Clara County, California",0,0,0
1000000US060855061034009,060855061034009,"Block 4009, Block Group 4, Census Tract 5061.03, Santa Clara County, California",38,38,0
1000000US060855061034010,060855061034010,"Block 4010, Block Group 4, Census Tract 5061.03, Santa Clara County, California",0,0,0
1000000US060855061034011,060855061034011,"Block 4011, Block Group 4, Census Tract 5061.03, Santa Clara County, California",0,0,0
1000000US060855061034012,060855061034012,"Block 4012, Block Group 4, Census Tract 5061.03, Santa Clara County, California",0,0,0
1000000US060855061034013,060855061034013,"Block 4013, Block Group 4, Census Tract 5061.03, Santa Clara County, California",20,20,0
1000000US060855061034014,060855061034014,"Block 4014, Block Group 4, Census Tract 5061.03, Santa Clara County, California",58,57,1
1000000US060855061034015,060855061034015,"Block 4015, Block Group 4, Census Tract 5061.03, Santa Clara County, California",14,13,1
1000000US060855061034016,060855061034016,"Block 4016, Block Group 4, Census Tract 5061.03, Santa Clara County, California",91,85,6
1000000US060855062021000,060855062021000,"Block 1000, Block Group 1, Census Tract 5062.02, Santa Clara County, California",12,11,1
1000000US060855062021001,060855062021001,"Block 1001, Block Group 1, Census Tract 5062.02, Santa Clara County, California",32,32,0
1000000US060855062021002,060855062021002,"Block 1002, Block Group 1, Census Tract 5062.02, Santa Clara County, California",18,18,0
1000000US060855062021003,060855062021003,"Block 1003, Block Group 1, Census Tract 5062.02, Santa Clara County, California",28,27,1
1000000US060855062021004,060855062021004,"Block 1004, Block Group 1, Census Tract 5062.02, Santa Clara County, California",44,44,0
1000000US060855062021005,060855062021005,"Block 1005, Block Group 1, Census Tract 5062.02, Santa Clara County, California",44,44,0
1000000US060855062021006,060855062021006,"Block 1006, Block Group 1, Census Tract 5062.02, Santa Clara County, California",53,53,0
1000000US060855062021007,060855062021007,"Block 1007, Block Group 1, Census Tract 5062.02, Santa Clara County, California",53,52,1
1000000US060855062021008,060855062021008,"Block 1008, Block Group 1, Census Tract 5062.02, Santa Clara County, California",26,23,3
1000000US060855062021009,060855062021009,"Block 1009, Block Group 1, Census Tract 5062.02, Santa Clara County, California",29,29,0
1000000US060855062021010,060855062021010,"Block 1010, Block Group 1, Census Tract 5062.02, Santa Clara County, California",0,0,0
1000000US060855062021011,060855062021011,"Block 1011, Block Group 1, Census Tract 5062.02, Santa Clara County, California",39,38,1
1000000US060855062021012,060855062021012,"Block 1012, Block Group 1, Census Tract 5062.02, Santa Clara County, California",59,57,2
1000000US060855062021013,060855062021013,"Block 1013, Block Group 1, Census Tract 5062.02, Santa Clara County, California",31,31,0
1000000US060855062021014,060855062021014,"Block 1014, Block Group 1, Census Tract 5062.02, Santa Clara County, California",22,21,1
1000000US060855062021015,060855062021015,"Block 1015, Block Group 1, Census Tract 5062.02, Santa Clara County, California",28,27,1
1000000US060855062021016,060855062021016,"Block 1016, Block Group 1, Census Tract 5062.02, Santa Clara County, California",79,79,0
1000000US060855062021017,060855062021017,"Block 1017, Block Group 1, Census Tract 5062.02, Santa Clara County, California",27,26,1
1000000US060855062021018,060855062021018,"Block 1018, Block Group 1, Census Tract 5062.02, Santa Clara County, California",26,25,1
1000000US060855062021019,060855062021019,"Block 1019, Block Group 1, Census Tract 5062.02, Santa Clara County, California",24,23,1
1000000US060855062022000,060855062022000,"Block 2000, Block Group 2, Census Tract 5062.02, Santa Clara County, California",104,100,4
1000000US060855062022001,060855062022001,"Block 2001, Block Group 2, Census Tract 5062.02, Santa Clara County, California",51,50,1
1000000US060855062022002,060855062022002,"Block 2002, Block Group 2, Census Tract 5062.02, Santa Clara County, California",20,20,0
1000000US060855062022003,060855062022003,"Block 2003, Block Group 2, Census Tract 5062.02, Santa Clara County, California",24,23,1
1000000US060855062022004,060855062022004,"Block 2004, Block Group 2, Census Tract 5062.02, Santa Clara County, California",49,48,1
1000000US060855062022005,060855062022005,"Block 2005, Block Group 2, Census Tract 5062.02, Santa Clara County, California",25,24,1
1000000US060855062022006,060855062022006,"Block 2006, Block Group 2, Census Tract 5062.02, Santa Clara County, California",22,22,0
1000000US060855062022007,060855062022007,"Block 2007, Block Group 2, Census Tract 5062.02, Santa Clara County, California",24,24,0
1000000US060855062022008,060855062022008,"Block 2008, Block Group 2, Census Tract 5062.02, Santa Clara County, California",24,24,0
1000000US060855062022009,060855062022009,"Block 2009, Block Group 2, Census Tract 5062.02, Santa Clara County, California",166,148,18
1000000US060855062022010,060855062022010,"Block 2010, Block Group 2, Census Tract 5062.02, Santa Clara County, California",49,48,1
1000000US060855062022011,060855062022011,"Block 2011, Block Group 2, Census Tract 5062.02, Santa Clara County, California",43,42,1
1000000US060855062022012,060855062022012,"Block 2012, Block Group 2, Census Tract 5062.02, Santa Clara County, California",21,19,2
1000000US060855062022013,060855062022013,"Block 2013, Block Group 2, Census Tract 5062.02, Santa Clara County, California",30,29,1
1000000US060855062022014,060855062022014,"Block 2014, Block Group 2, Census Tract 5062.02, Santa Clara County, California",28,28,0
1000000US060855062022015,060855062022015,"Block 2015, Block Group 2, Census Tract 5062.02, Santa Clara County, California",22,22,0
1000000US060855062022016,060855062022016,"Block 2016, Block Group 2, Census Tract 5062.02, Santa Clara County, California",23,22,1
1000000US060855062022017,060855062022017,"Block 2017, Block Group 2, Census Tract 5062.02, Santa Clara County, California",0,0,0
1000000US060855062022018,060855062022018,"Block 2018, Block Group 2, Census Tract 5062.02, Santa Clara County, California",16,15,1
1000000US060855062022019,060855062022019,"Block 2019, Block Group 2, Census Tract 5062.02, Santa Clara County, California",24,24,0
1000000US060855062022020,060855062022020,"Block 2020, Block Group 2, Census Tract 5062.02, Santa Clara County, California",103,102,1
1000000US060855062022021,060855062022021,"Block 2021, Block Group 2, Census Tract 5062.02, Santa Clara County, California",18,18,0
1000000US060855062022022,060855062022022,"Block 2022, Block Group 2, Census Tract 5062.02, Santa Clara County, California",0,0,0
1000000US060855062023000,060855062023000,"Block 3000, Block Group 3, Census Tract 5062.02, Santa Clara County, California",0,0,0
1000000US060855062023001,060855062023001,"Block 3001, Block Group 3, Census Tract 5062.02, Santa Clara County, California",100,100,0
1000000US060855062023002,060855062023002,"Block 3002, Block Group 3, Census Tract 5062.02, Santa Clara County, California",17,17,0
1000000US060855062023003,060855062023003,"Block 3003, Block Group 3, Census Tract 5062.02, Santa Clara County, California",28,26,2
1000000US060855062023004,060855062023004,"Block 3004, Block Group 3, Census Tract 5062.02, Santa Clara County, California",19,19,0
1000000US060855062023005,060855062023005,"Block 3005, Block Group 3, Census Tract 5062.02, Santa Clara County, California",22,21,1
1000000US060855062023006,060855062023006,"Block 3006, Block Group 3, Census Tract 5062.02, Santa Clara County, California",48,47,1
1000000US060855062023007,060855062023007,"Block 3007, Block Group 3, Census Tract 5062.02, Santa Clara County, California",30,29,1
1000000US060855062023008,060855062023008,"Block 3008, Block Group 3, Census Tract 5062.02, Santa Clara County, California",26,26,0
1000000US060855062023009,060855062023009,"Block 3009, Block Group 3, Census Tract 5062.02, Santa Clara County, California",30,30,0
1000000US060855062023010,060855062023010,"Block 3010, Block Group 3, Census Tract 5062.02, Santa Clara County, California",18,18,0
1000000US060855062023011,060855062023011,"Block 3011, Block Group 3, Census Tract 5062.02, Santa Clara County, California",218,151,67
1000000US060855062023012,060855062023012,"Block 3012, Block Group 3, Census Tract 5062.02, Santa Clara County, California",2,2,0
1000000US060855062023013,060855062023013,"Block 3013, Block Group 3, Census Tract 5062.02, Santa Clara County, California",164,156,8
1000000US060855062023014,060855062023014,"Block 3014, Block Group 3, Census Tract 5062.02, Santa Clara County, California",42,42,0
1000000US060855062023015,060855062023015,"Block 3015, Block Group 3, Census Tract 5062.02, Santa Clara County, California",55,53,2
1000000US060855062023016,060855062023016,"Block 3016, Block Group 3, Census Tract 5062.02, Santa Clara County, California",59,59,0
1000000US060855062023017,060855062023017,"Block 3017, Block Group 3, Census Tract 5062.02, Santa Clara County, California",25,25,0
1000000US060855062023018,060855062023018,"Block 3018, Block Group 3, Census Tract 5062.02, Santa Clara County, California",22,22,0
1000000US060855062023019,060855062023019,"Block 3019, Block Group 3, Census Tract 5062.02, Santa Clara County, California",24,24,0
1000000US060855062023020,060855062023020,"Block 3020, Block Group 3, Census Tract 5062.02, Santa Clara County, California",24,24,0
1000000US060855062023021,060855062023021,"Block 3021, Block Group 3, Census Tract 5062.02, Santa Clara County, California",50,49,1
1000000US060855062023022,060855062023022,"Block 3022, Block Group 3, Census Tract 5062.02, Santa Clara County, California",12,12,0
1000000US060855062023023,060855062023023,"Block 3023, Block Group 3, Census Tract 5062.02, Santa Clara County, California",20,20,0
1000000US060855062023024,060855062023024,"Block 3024, Block Group 3, Census Tract 5062.02, Santa Clara County, California",22,21,1
1000000US060855062031000,060855062031000,"Block 1000, Block Group 1, Census Tract 5062.03, Santa Clara County, California",0,0,0
1000000US060855062031001,060855062031001,"Block 1001, Block Group 1, Census Tract 5062.03, Santa Clara County, California",0,0,0
1000000US060855062031002,060855062031002,"Block 1002, Block Group 1, Census Tract 5062.03, Santa Clara County, California",0,0,0
1000000US060855062031003,060855062031003,"Block 1003, Block Group 1, Census Tract 5062.03, Santa Clara County, California",0,0,0
1000000US060855062031004,060855062031004,"Block 1004, Block Group 1, Census Tract 5062.03, Santa Clara County, California",0,0,0
1000000US060855062031005,060855062031005,"Block 1005, Block Group 1, Census Tract 5062.03, Santa Clara County, California",65,60,5
1000000US060855062031006,060855062031006,"Block 1006, Block Group 1, Census Tract 5062.03, Santa Clara County, California",128,122,6
1000000US060855062031007,060855062031007,"Block 1007, Block Group 1, Census Tract 5062.03, Santa Clara County, California",124,116,8
1000000US060855062031008,060855062031008,"Block 1008, Block Group 1, Census Tract 5062.03, Santa Clara County, California",0,0,0
1000000US060855062031009,060855062031009,"Block 1009, Block Group 1, Census Tract 5062.03, Santa Clara County, California",284,265,19
1000000US060855062032000,060855062032000,"Block 2000, Block Group 2, Census Tract 5062.03, Santa Clara County, California",255,245,10
1000000US060855062032001,060855062032001,"Block 2001, Block Group 2, Census Tract 5062.03, Santa Clara County, California",11,11,0
1000000US060855062032002,060855062032002,"Block 2002, Block Group 2, Census Tract 5062.03, Santa Clara County, California",12,12,0
1000000US060855062032003,060855062032003,"Block 2003, Block Group 2, Census Tract 5062.03, Santa Clara County, California",50,49,1
1000000US060855062032004,060855062032004,"Block 2004, Block Group 2, Census Tract 5062.03, Santa Clara County, California",0,0,0
1000000US060855062032005,060855062032005,"Block 2005, Block Group 2, Census Tract 5062.03, Santa Clara County, California",21,21,0
1000000US060855062032006,060855062032006,"Block 2006, Block Group 2, Census Tract 5062.03, Santa Clara County, California",31,30,1
1000000US060855062032007,060855062032007,"Block 2007, Block Group 2, Census Tract 5062.03, Santa Clara County, California",23,22,1
1000000US060855062032008,060855062032008,"Block 2008, Block Group 2, Census Tract 5062.03, Santa Clara County, California",80,77,3
1000000US060855062032009,060855062032009,"Block 2009, Block Group 2, Census Tract 5062.03, Santa Clara County, California",25,25,0
1000000US060855062032010,060855062032010,"Block 2010, Block Group 2, Census Tract 5062.03, Santa Clara County, California",21,21,0
1000000US060855062032011,060855062032011,"Block 2011, Block Group 2, Census Tract 5062.03, Santa Clara County, California",359,342,17
1000000US060855062032012,060855062032012,"Block 2012, Block Group 2, Census Tract 5062.03, Santa Clara County, California",0,0,0
1000000US060855062032013,060855062032013,"Block 2013, Block Group 2, Census Tract 5062.03, Santa Clara County, California",25,25,0
1000000US060855062032014,060855062032014,"Block 2014, Block Group 2, Census Tract 5062.03, Santa Clara County, California",15,14,1
1000000US060855062032015,060855062032015,"Block 2015, Block Group 2, Census Tract 5062.03, Santa Clara County, California",12,12,0
1000000US060855062032016,060855062032016,"Block 2016, Block Group 2, Census Tract 5062.03, Santa Clara County, California",12,12,0
1000000US060855062032017,060855062032017,"Block 2017, Block Group 2, Census Tract 5062.03, Santa Clara County, California",12,11,1
1000000US060855062033000,060855062033000,"Block 3000, Block Group 3, Census Tract 5062.03, Santa Clara County, California",0,0,0
1000000US060855062033001,060855062033001,"Block 3001, Block Group 3, Census Tract 5062.03, Santa Clara County, California",967,926,41
1000000US060855062041000,060855062041000,"Block 1000, Block Group 1, Census Tract 5062.04, Santa Clara County, California",260,253,7
1000000US060855062041001,060855062041001,"Block 1001, Block Group 1, Census Tract 5062.04, Santa Clara County, California",12,12,0
1000000US060855062041002,060855062041002,"Block 1002, Block Group 1, Census Tract 5062.04, Santa Clara County, California",83,79,4
1000000US060855062041003,060855062041003,"Block 1003, Block Group 1, Census Tract 5062.04, Santa Clara County, California",30,28,2
1000000US060855062041004,060855062041004,"Block 1004, Block Group 1, Census Tract 5062.04, Santa Clara County, California",24,24,0
1000000US060855062041005,060855062041005,"Block 1005, Block Group 1, Census Tract 5062.04, Santa Clara County, California",15,12,3
1000000US060855062041006,060855062041006,"Block 1006, Block Group 1, Census Tract 5062.04, Santa Clara County, California",16,15,1
1000000US060855062041007,060855062041007,"Block 1007, Block Group 1, Census Tract 5062.04, Santa Clara County, California",29,29,0
1000000US060855062041008,060855062041008,"Block 1008, Block Group 1, Census Tract 5062.04, Santa Clara County, California",10,10,0
1000000US060855062041009,060855062041009,"Block 1009, Block Group 1, Census Tract 5062.04, Santa Clara County, California",0,0,0
1000000US060855062041010,060855062041010,"Block 1010, Block Group 1, Census Tract 5062.04, Santa Clara County, California",38,36,2
1000000US060855062041011,060855062041011,"Block 1011, Block Group 1, Census Tract 5062.04, Santa Clara County, California",69,67,2
1000000US060855062041012,060855062041012,"Block 1012, Block Group 1, Census Tract 5062.04, Santa Clara County, California",72,71,1
1000000US060855062041013,060855062041013,"Block 1013, Block Group 1, Census Tract 5062.04, Santa Clara County, California",21,20,1
1000000US060855062041014,060855062041014,"Block 1014, Block Group 1, Census Tract 5062.04, Santa Clara County, California",28,28,0
1000000US060855062041015,060855062041015,"Block 1015, Block Group 1, Census Tract 5062.04, Santa Clara County, California",89,86,3
1000000US060855062041016,060855062041016,"Block 1016, Block Group 1, Census Tract 5062.04, Santa Clara County, California",12,12,0
1000000US060855062041017,060855062041017,"Block 1017, Block Group 1, Census Tract 5062.04, Santa Clara County, California",10,10,0
1000000US060855062041018,060855062041018,"Block 1018, Block Group 1, Census Tract 5062.04, Santa Clara County, California",4,4,0
1000000US060855062041019,060855062041019,"Block 1019, Block Group 1, Census Tract 5062.04, Santa Clara County, California",6,6,0
1000000US060855062042000,060855062042000,"Block 2000, Block Group 2, Census Tract 5062.04, Santa Clara County, California",157,151,6
1000000US060855062042001,060855062042001,"Block 2001, Block Group 2, Census Tract 5062.04, Santa Clara County, California",18,18,0
1000000US060855062042002,060855062042002,"Block 2002, Block Group 2, Census Tract 5062.04, Santa Clara County, California",16,16,0
1000000US060855062042003,060855062042003,"Block 2003, Block Group 2, Census Tract 5062.04, Santa Clara County, California",31,31,0
1000000US060855062042004,060855062042004,"Block 2004, Block Group 2, Census Tract 5062.04, Santa Clara County, California",30,30,0
1000000US060855062042005,060855062042005,"Block 2005, Block Group 2, Census Tract 5062.04, Santa Clara County, California",10,10,0
1000000US060855062042006,060855062042006,"Block 2006, Block Group 2, Census Tract 5062.04, Santa Clara County, California",34,32,2
1000000US060855062042007,060855062042007,"Block 2007, Block Group 2, Census Tract 5062.04, Santa Clara County, California",37,36,1
1000000US060855062042008,060855062042008,"Block 2008, Block Group 2, Census Tract 5062.04, Santa Clara County, California",22,21,1
1000000US060855062042009,060855062042009,"Block 2009, Block Group 2, Census Tract 5062.04, Santa Clara County, California",22,21,1
1000000US060855062042010,060855062042010,"Block 2010, Block Group 2, Census Tract 5062.04, Santa Clara County, California",30,28,2
1000000US060855062042011,060855062042011,"Block 2011, Block Group 2, Census Tract 5062.04, Santa Clara County, California",22,19,3
1000000US060855062043000,060855062043000,"Block 3000, Block Group 3, Census Tract 5062.04, Santa Clara County, California",30,30,0
1000000US060855062043001,060855062043001,"Block 3001, Block Group 3, Census Tract 5062.04, Santa Clara County, California",22,22,0
1000000US060855062043002,060855062043002,"Block 3002, Block Group 3, Census Tract 5062.04, Santa Clara County, California",43,42,1
1000000US060855062043003,060855062043003,"Block 3003, Block Group 3, Census Tract 5062.04, Santa Clara County, California",30,30,0
1000000US060855062043004,060855062043004,"Block 3004, Block Group 3, Census Tract 5062.04, Santa Clara County, California",32,31,1
1000000US060855062043005,060855062043005,"Block 3005, Block Group 3, Census Tract 5062.04, Santa Clara County, California",30,30,0
1000000US060855062043006,060855062043006,"Block 3006, Block Group 3, Census Tract 5062.04, Santa Clara County, California",0,0,0
1000000US060855062043007,060855062043007,"Block 3007, Block Group 3, Census Tract 5062.04, Santa Clara County, California",22,22,0
1000000US060855062043008,060855062043008,"Block 3008, Block Group 3, Census Tract 5062.04, Santa Clara County, California",20,20,0
1000000US060855062043009,060855062043009,"Block 3009, Block Group 3, Census Tract 5062.04, Santa Clara County, California",58,58,0
1000000US060855062043010,060855062043010,"Block 3010, Block Group 3, Census Tract 5062.04, Santa Clara County, California",27,26,1
1000000US060855062043011,060855062043011,"Block 3011, Block Group 3, Census Tract 5062.04, Santa Clara County, California",24,23,1
1000000US060855062043012,060855062043012,"Block 3012, Block Group 3, Census Tract 5062.04, Santa Clara County, California",25,25,0
1000000US060855062043013,060855062043013,"Block 3013, Block Group 3, Census Tract 5062.04, Santa Clara County, California",23,23,0
1000000US060855062044000,060855062044000,"Block 4000, Block Group 4, Census Tract 5062.04, Santa Clara County, California",25,25,0
1000000US060855062044001,060855062044001,"Block 4001, Block Group 4, Census Tract 5062.04, Santa Clara County, California",30,29,1
1000000US060855062044002,060855062044002,"Block 4002, Block Group 4, Census Tract 5062.04, Santa Clara County, California",53,51,2
1000000US060855062044003,060855062044003,"Block 4003, Block Group 4, Census Tract 5062.04, Santa Clara County, California",47,47,0
1000000US060855062044004,060855062044004,"Block 4004, Block Group 4, Census Tract 5062.04, Santa Clara County, California",25,23,2
1000000US060855062044005,060855062044005,"Block 4005, Block Group 4, Census Tract 5062.04, Santa Clara County, California",0,0,0
1000000US060855062044006,060855062044006,"Block 4006, Block Group 4, Census Tract 5062.04, Santa Clara County, California",26,25,1
1000000US060855062044007,060855062044007,"Block 4007, Block Group 4, Census Tract 5062.04, Santa Clara County, California",26,26,0
1000000US060855062044008,060855062044008,"Block 4008, Block Group 4, Census Tract 5062.04, Santa Clara County, California",40,40,0
1000000US060855062044009,060855062044009,"Block 4009, Block Group 4, Census Tract 5062.04, Santa Clara County, California",51,50,1
1000000US060855062044010,060855062044010,"Block 4010, Block Group 4, Census Tract 5062.04, Santa Clara County, California",41,39,2
1000000US060855062044011,060855062044011,"Block 4011, Block Group 4, Census Tract 5062.04, Santa Clara County, California",22,22,0
1000000US060855062044012,060855062044012,"Block 4012, Block Group 4, Census Tract 5062.04, Santa Clara County, California",42,39,3
1000000US060855062044013,060855062044013,"Block 4013, Block Group 4, Census Tract 5062.04, Santa Clara County, California",40,39,1
1000000US060855062044014,060855062044014,"Block 4014, Block Group 4, Census Tract 5062.04, Santa Clara County, California",26,26,0
1000000US060855062044015,060855062044015,"Block 4015, Block Group 4, Census Tract 5062.04, Santa Clara County, California",32,31,1
1000000US060855063011000,060855063011000,"Block 1000, Block Group 1, Census Tract 5063.01, Santa Clara County, California",194,183,11
1000000US060855063011001,060855063011001,"Block 1001, Block Group 1, Census Tract 5063.01, Santa Clara County, California",0,0,0
1000000US060855063011002,060855063011002,"Block 1002, Block Group 1, Census Tract 5063.01, Santa Clara County, California",396,375,21
1000000US060855063012000,060855063012000,"Block 2000, Block Group 2, Census Tract 5063.01, Santa Clara County, California",507,490,17
1000000US060855063012001,060855063012001,"Block 2001, Block Group 2, Census Tract 5063.01, Santa Clara County, California",56,56,0
1000000US060855063012002,060855063012002,"Block 2002, Block Group 2, Census Tract 5063.01, Santa Clara County, California",182,179,3
1000000US060855063012003,060855063012003,"Block 2003, Block Group 2, Census Tract 5063.01, Santa Clara County, California",83,79,4
1000000US060855063013000,060855063013000,"Block 3000, Block Group 3, Census Tract 5063.01, Santa Clara County, California",112,110,2
1000000US060855063013001,060855063013001,"Block 3001, Block Group 3, Census Tract 5063.01, Santa Clara County, California",330,307,23
1000000US060855063013002,060855063013002,"Block 3002, Block Group 3, Census Tract 5063.01, Santa Clara County, California",14,14,0
1000000US060855063013003,060855063013003,"Block 3003, Block Group 3, Census Tract 5063.01, Santa Clara County, California",13,12,1
1000000US060855063013004,060855063013004,"Block 3004, Block Group 3, Census Tract 5063.01, Santa Clara County, California",17,17,0
1000000US060855063013005,060855063013005,"Block 3005, Block Group 3, Census Tract 5063.01, Santa Clara County, California",29,27,2
1000000US060855063013006,060855063013006,"Block 3006, Block Group 3, Census Tract 5063.01, Santa Clara County, California",14,13,1
1000000US060855063013007,060855063013007,"Block 3007, Block Group 3, Census Tract 5063.01, Santa Clara County, California",27,27,0
1000000US060855063013008,060855063013008,"Block 3008, Block Group 3, Census Tract 5063.01, Santa Clara County, California",17,17,0
1000000US060855063013009,060855063013009,"Block 3009, Block Group 3, Census Tract 5063.01, Santa Clara County, California",3,3,0
1000000US060855063013010,060855063013010,"Block 3010, Block Group 3, Census Tract 5063.01, Santa Clara County, California",9,9,0
1000000US060855063013011,060855063013011,"Block 3011, Block Group 3, Census Tract 5063.01, Santa Clara County, California",3,3,0
1000000US060855063013012,060855063013012,"Block 3012, Block Group 3, Census Tract 5063.01, Santa Clara County, California",3,3,0
1000000US060855063014000,060855063014000,"Block 4000, Block Group 4, Census Tract 5063.01, Santa Clara County, California",6,5,1
1000000US060855063014001,060855063014001,"Block 4001, Block Group 4, Census Tract 5063.01, Santa Clara County, California",1,1,0
1000000US060855063014002,060855063014002,"Block 4002, Block Group 4, Census Tract 5063.01, Santa Clara County, California",3,3,0
1000000US060855063014003,060855063014003,"Block 4003, Block Group 4, Census Tract 5063.01, Santa Clara County, California",3,3,0
1000000US060855063014004,060855063014004,"Block 4004, Block Group 4, Census Tract 5063.01, Santa Clara County, California",2,2,0
1000000US060855063014005,060855063014005,"Block 4005, Block Group 4, Census Tract 5063.01, Santa Clara County, California",11,11,0
1000000US060855063014006,060855063014006,"Block 4006, Block Group 4, Census Tract 5063.01, Santa Clara County, California",3,3,0
1000000US060855063014007,060855063014007,"Block 4007, Block Group 4, Census Tract 5063.01, Santa Clara County, California",87,85,2
1000000US060855063014008,060855063014008,"Block 4008, Block Group 4, Census Tract 5063.01, Santa Clara County, California",37,35,2
1000000US060855063014009,060855063014009,"Block 4009, Block Group 4, Census Tract 5063.01, Santa Clara County, California",39,38,1
1000000US060855063014010,060855063014010,"Block 4010, Block Group 4, Census Tract 5063.01, Santa Clara County, California",25,25,0
1000000US060855063014011,060855063014011,"Block 4011, Block Group 4, Census Tract 5063.01, Santa Clara County, California",10,10,0
1000000US060855063014012,060855063014012,"Block 4012, Block Group 4, Census Tract 5063.01, Santa Clara County, California",31,31,0
1000000US060855063014013,060855063014013,"Block 4013, Block Group 4, Census Tract 5063.01, Santa Clara County, California",45,43,2
1000000US060855063014014,060855063014014,"Block 4014, Block Group 4, Census Tract 5063.01, Santa Clara County, California",19,17,2
1000000US060855063014015,060855063014015,"Block 4015, Block Group 4, Census Tract 5063.01, Santa Clara County, California",20,19,1
1000000US060855063014016,060855063014016,"Block 4016, Block Group 4, Census Tract 5063.01, Santa Clara County, California",6,6,0
1000000US060855063014017,060855063014017,"Block 4017, Block Group 4, Census Tract 5063.01, Santa Clara County, California",20,19,1
1000000US060855063014018,060855063014018,"Block 4018, Block Group 4, Census Tract 5063.01, Santa Clara County, California",14,11,3
1000000US060855063014019,060855063014019,"Block 4019, Block Group 4, Census Tract 5063.01, Santa Clara County, California",0,0,0
1000000US060855063014020,060855063014020,"Block 4020, Block Group 4, Census Tract 5063.01, Santa Clara County, California",3,3,0
1000000US060855063014021,060855063014021,"Block 4021, Block Group 4, Census Tract 5063.01, Santa Clara County, California",34,33,1
1000000US060855063021000,060855063021000,"Block 1000, Block Group 1, Census Tract 5063.02, Santa Clara County, California",0,0,0
1000000US060855063021001,060855063021001,"Block 1001, Block Group 1, Census Tract 5063.02, Santa Clara County, California",67,64,3
1000000US060855063021002,060855063021002,"Block 1002, Block Group 1, Census Tract 5063.02, Santa Clara County, California",336,322,14
1000000US060855063021003,060855063021003,"Block 1003, Block Group 1, Census Tract 5063.02, Santa Clara County, California",135,132,3
1000000US060855063021004,060855063021004,"Block 1004, Block Group 1, Census Tract 5063.02, Santa Clara County, California",84,80,4
1000000US060855063021005,060855063021005,"Block 1005, Block Group 1, Census Tract 5063.02, Santa Clara County, California",260,249,11
1000000US060855063021006,060855063021006,"Block 1006, Block Group 1, Census Tract 5063.02, Santa Clara County, California",18,16,2
1000000US060855063021007,060855063021007,"Block 1007, Block Group 1, Census Tract 5063.02, Santa Clara County, California",12,12,0
1000000US060855063021008,060855063021008,"Block 1008, Block Group 1, Census Tract 5063.02, Santa Clara County, California",5,5,0
1000000US060855063021009,060855063021009,"Block 1009, Block Group 1, Census Tract 5063.02, Santa Clara County, California",175,168,7
1000000US060855063021010,060855063021010,"Block 1010, Block Group 1, Census Tract 5063.02, Santa Clara County, California",16,15,1
1000000US060855063021011,060855063021011,"Block 1011, Block Group 1, Census Tract 5063.02, Santa Clara County, California",27,27,0
1000000US060855063022000,060855063022000,"Block 2000, Block Group 2, Census Tract 5063.02, Santa Clara County, California",15,15,0
1000000US060855063022001,060855063022001,"Block 2001, Block Group 2, Census Tract 5063.02, Santa Clara County, California",19,19,0
1000000US060855063022002,060855063022002,"Block 2002, Block Group 2, Census Tract 5063.02, Santa Clara County, California",80,79,1
1000000US060855063022003,060855063022003,"Block 2003, Block Group 2, Census Tract 5063.02, Santa Clara County, California",35,35,0
1000000US060855063022004,060855063022004,"Block 2004, Block Group 2, Census Tract 5063.02, Santa Clara County, California",72,71,1
1000000US060855063022005,060855063022005,"Block 2005, Block Group 2, Census Tract 5063.02, Santa Clara County, California",22,22,0
1000000US060855063022006,060855063022006,"Block 2006, Block Group 2, Census Tract 5063.02, Santa Clara County, California",22,22,0
1000000US060855063022007,060855063022007,"Block 2007, Block Group 2, Census Tract 5063.02, Santa Clara County, California",69,69,0
1000000US060855063022008,060855063022008,"Block 2008, Block Group 2, Census Tract 5063.02, Santa Clara County, California",12,12,0
1000000US060855063022009,060855063022009,"Block 2009, Block Group 2, Census Tract 5063.02, Santa Clara County, California",14,14,0
1000000US060855063022010,060855063022010,"Block 2010, Block Group 2, Census Tract 5063.02, Santa Clara County, California",22,22,0
1000000US060855063022011,060855063022011,"Block 2011, Block Group 2, Census Tract 5063.02, Santa Clara County, California",35,33,2
1000000US060855063022012,060855063022012,"Block 2012, Block Group 2, Census Tract 5063.02, Santa Clara County, California",27,26,1
1000000US060855063022013,060855063022013,"Block 2013, Block Group 2, Census Tract 5063.02, Santa Clara County, California",22,22,0
1000000US060855063022014,060855063022014,"Block 2014, Block Group 2, Census Tract 5063.02, Santa Clara County, California",24,24,0
1000000US060855063022015,060855063022015,"Block 2015, Block Group 2, Census Tract 5063.02, Santa Clara County, California",24,24,0
1000000US060855063022016,060855063022016,"Block 2016, Block Group 2, Census Tract 5063.02, Santa Clara County, California",34,33,1
1000000US060855063022017,060855063022017,"Block 2017, Block Group 2, Census Tract 5063.02, Santa Clara County, California",28,28,0
1000000US060855063022018,060855063022018,"Block 2018, Block Group 2, Census Tract 5063.02, Santa Clara County, California",88,88,0
1000000US060855063022019,060855063022019,"Block 2019, Block Group 2, Census Tract 5063.02, Santa Clara County, California",26,26,0
1000000US060855063023000,060855063023000,"Block 3000, Block Group 3, Census Tract 5063.02, Santa Clara County, California",112,105,7
1000000US060855063023001,060855063023001,"Block 3001, Block Group 3, Census Tract 5063.02, Santa Clara County, California",22,22,0
1000000US060855063023002,060855063023002,"Block 3002, Block Group 3, Census Tract 5063.02, Santa Clara County, California",22,22,0
1000000US060855063023003,060855063023003,"Block 3003, Block Group 3, Census Tract 5063.02, Santa Clara County, California",169,164,5
1000000US060855063023004,060855063023004,"Block 3004, Block Group 3, Census Tract 5063.02, Santa Clara County, California",46,45,1
1000000US060855063023005,060855063023005,"Block 3005, Block Group 3, Census Tract 5063.02, Santa Clara County, California",85,83,2
1000000US060855063023006,060855063023006,"Block 3006, Block Group 3, Census Tract 5063.02, Santa Clara County, California",29,27,2
1000000US060855063023007,060855063023007,"Block 3007, Block Group 3, Census Tract 5063.02, Santa Clara County, California",85,84,1
1000000US060855063023008,060855063023008,"Block 3008, Block Group 3, Census Tract 5063.02, Santa Clara County, California",45,44,1
1000000US060855063023009,060855063023009,"Block 3009, Block Group 3, Census Tract 5063.02, Santa Clara County, California",24,24,0
1000000US060855063023010,060855063023010,"Block 3010, Block Group 3, Census Tract 5063.02, Santa Clara County, California",44,44,0
1000000US060855063023011,060855063023011,"Block 3011, Block Group 3, Census Tract 5063.02, Santa Clara County, California",51,49,2
1000000US060855063041000,060855063041000,"Block 1000, Block Group 1, Census Tract 5063.04, Santa Clara County, California",125,124,1
1000000US060855063041001,060855063041001,"Block 1001, Block Group 1, Census Tract 5063.04, Santa Clara County, California",12,12,0
1000000US060855063041002,060855063041002,"Block 1002, Block Group 1, Census Tract 5063.04, Santa Clara County, California",30,30,0
1000000US060855063041003,060855063041003,"Block 1003, Block Group 1, Census Tract 5063.04, Santa Clara County, California",222,207,15
1000000US060855063041004,060855063041004,"Block 1004, Block Group 1, Census Tract 5063.04, Santa Clara County, California",302,292,10
1000000US060855063041005,060855063041005,"Block 1005, Block Group 1, Census Tract 5063.04, Santa Clara County, California",9,8,1
1000000US060855063041006,060855063041006,"Block 1006, Block Group 1, Census Tract 5063.04, Santa Clara County, California",38,38,0
1000000US060855063041007,060855063041007,"Block 1007, Block Group 1, Census Tract 5063.04, Santa Clara County, California",155,140,15
1000000US060855063042000,060855063042000,"Block 2000, Block Group 2, Census Tract 5063.04, Santa Clara County, California",72,72,0
1000000US060855063042001,060855063042001,"Block 2001, Block Group 2, Census Tract 5063.04, Santa Clara County, California",28,27,1
1000000US060855063042002,060855063042002,"Block 2002, Block Group 2, Census Tract 5063.04, Santa Clara County, California",26,25,1
1000000US060855063042003,060855063042003,"Block 2003, Block Group 2, Census Tract 5063.04, Santa Clara County, California",21,21,0
1000000US060855063042004,060855063042004,"Block 2004, Block Group 2, Census Tract 5063.04, Santa Clara County, California",52,52,0
1000000US060855063042005,060855063042005,"Block 2005, Block Group 2, Census Tract 5063.04, Santa Clara County, California",27,26,1
1000000US060855063043000,060855063043000,"Block 3000, Block Group 3, Census Tract 5063.04, Santa Clara County, California",0,0,0
1000000US060855063043001,060855063043001,"Block 3001, Block Group 3, Census Tract 5063.04, Santa Clara County, California",221,218,3
1000000US060855063043002,060855063043002,"Block 3002, Block Group 3, Census Tract 5063.04, Santa Clara County, California",820,779,41
1000000US060855063051000,060855063051000,"Block 1000, Block Group 1, Census Tract 5063.05, Santa Clara County, California",64,57,7
1000000US060855063051001,060855063051001,"Block 1001, Block Group 1, Census Tract 5063.05, Santa Clara County, California",90,89,1
1000000US060855063051002,060855063051002,"Block 1002, Block Group 1, Census Tract 5063.05, Santa Clara County, California",24,24,0
1000000US060855063051003,060855063051003,"Block 1003, Block Group 1, Census Tract 5063.05, Santa Clara County, California",51,50,1
1000000US060855063051004,060855063051004,"Block 1004, Block Group 1, Census Tract 5063.05, Santa Clara County, California",74,72,2
1000000US060855063051005,060855063051005,"Block 1005, Block Group 1, Census Tract 5063.05, Santa Clara County, California",0,0,0
1000000US060855063052000,060855063052000,"Block 2000, Block Group 2, Census Tract 5063.05, Santa Clara County, California",116,103,13
1000000US060855063052001,060855063052001,"Block 2001, Block Group 2, Census Tract 5063.05, Santa Clara County, California",42,37,5
1000000US060855063052002,060855063052002,"Block 2002, Block Group 2, Census Tract 5063.05, Santa Clara County, California",13,13,0
1000000US060855063052003,060855063052003,"Block 2003, Block Group 2, Census Tract 5063.05, Santa Clara County, California",32,32,0
1000000US060855063052004,060855063052004,"Block 2004, Block Group 2, Census Tract 5063.05, Santa Clara County, California",31,31,0
1000000US060855063052005,060855063052005,"Block 2005, Block Group 2, Census Tract 5063.05, Santa Clara County, California",58,57,1
1000000US060855063052006,060855063052006,"Block 2006, Block Group 2, Census Tract 5063.05, Santa Clara County, California",98,91,7
1000000US060855063052007,060855063052007,"Block 2007, Block Group 2, Census Tract 5063.05, Santa Clara County, California",123,121,2
1000000US060855063052008,060855063052008,"Block 2008, Block Group 2, Census Tract 5063.05, Santa Clara County, California",174,168,6
1000000US060855063052009,060855063052009,"Block 2009, Block Group 2, Census Tract 5063.05, Santa Clara County, California",182,173,9
1000000US060855063053000,060855063053000,"Block 3000, Block Group 3, Census Tract 5063.05, Santa Clara County, California",36,36,0
1000000US060855063053001,060855063053001,"Block 3001, Block Group 3, Census Tract 5063.05, Santa Clara County, California",61,59,2
1000000US060855063053002,060855063053002,"Block 3002, Block Group 3, Census Tract 5063.05, Santa Clara County, California",158,147,11
1000000US060855063053003,060855063053003,"Block 3003, Block Group 3, Census Tract 5063.05, Santa Clara County, California",103,100,3
1000000US060855063053004,060855063053004,"Block 3004, Block Group 3, Census Tract 5063.05, Santa Clara County, California",116,111,5
1000000US060855063053005,060855063053005,"Block 3005, Block Group 3, Census Tract 5063.05, Santa Clara County, California",160,160,0
1000000US060855063053006,060855063053006,"Block 3006, Block Group 3, Census Tract 5063.05, Santa Clara County, California",49,49,0
1000000US060855063054000,060855063054000,"Block 4000, Block Group 4, Census Tract 5063.05, Santa Clara County, California",45,45,0
1000000US060855063054001,060855063054001,"Block 4001, Block Group 4, Census Tract 5063.05, Santa Clara County, California",0,0,0
1000000US060855063054002,060855063054002,"Block 4002, Block Group 4, Census Tract 5063.05, Santa Clara County, California",19,19,0
1000000US060855063054003,060855063054003,"Block 4003, Block Group 4, Census Tract 5063.05, Santa Clara County, California",195,189,6
1000000US060855063054004,060855063054004,"Block 4004, Block Group 4, Census Tract 5063.05, Santa Clara County, California",439,420,19
1000000US060855063054005,060855063054005,"Block 4005, Block Group 4, Census Tract 5063.05, Santa Clara County, California",16,16,0
1000000US060855063054006,060855063054006,"Block 4006, Block Group 4, Census Tract 5063.05, Santa Clara County, California",22,21,1
1000000US060855064011000,060855064011000,"Block 1000, Block Group 1, Census Tract 5064.01, Santa Clara County, California",0,0,0
1000000US060855064011001,060855064011001,"Block 1001, Block Group 1, Census Tract 5064.01, Santa Clara County, California",40,40,0
1000000US060855064011002,060855064011002,"Block 1002, Block Group 1, Census Tract 5064.01, Santa Clara County, California",22,22,0
1000000US060855064011003,060855064011003,"Block 1003, Block Group 1, Census Tract 5064.01, Santa Clara County, California",369,357,12
1000000US060855064011004,060855064011004,"Block 1004, Block Group 1, Census Tract 5064.01, Santa Clara County, California",19,19,0
1000000US060855064011005,060855064011005,"Block 1005, Block Group 1, Census Tract 5064.01, Santa Clara County, California",276,264,12
1000000US060855064011006,060855064011006,"Block 1006, Block Group 1, Census Tract 5064.01, Santa Clara County, California",156,141,15
1000000US060855064011007,060855064011007,"Block 1007, Block Group 1, Census Tract 5064.01, Santa Clara County, California",70,66,4
1000000US060855064011008,060855064011008,"Block 1008, Block Group 1, Census Tract 5064.01, Santa Clara County, California",20,20,0
1000000US060855064011009,060855064011009,"Block 1009, Block Group 1, Census Tract 5064.01, Santa Clara County, California",26,25,1
1000000US060855064011010,060855064011010,"Block 1010, Block Group 1, Census Tract 5064.01, Santa Clara County, California",26,24,2
1000000US060855064011011,060855064011011,"Block 1011, Block Group 1, Census Tract 5064.01, Santa Clara County, California",30,30,0
1000000US060855064011012,060855064011012,"Block 1012, Block Group 1, Census Tract 5064.01, Santa Clara County, California",29,29,0
1000000US060855064011013,060855064011013,"Block 1013, Block Group 1, Census Tract 5064.01, Santa Clara County, California",52,48,4
1000000US060855064011014,060855064011014,"Block 1014, Block Group 1, Census Tract 5064.01, Santa Clara County, California",24,24,0
1000000US060855064011015,060855064011015,"Block 1015, Block Group 1, Census Tract 5064.01, Santa Clara County, California",1,1,0
1000000US060855064011016,060855064011016,"Block 1016, Block Group 1, Census Tract 5064.01, Santa Clara County, California",27,27,0
1000000US060855064012000,060855064012000,"Block 2000, Block Group 2, Census Tract 5064.01, Santa Clara County, California",11,11,0
1000000US060855064012001,060855064012001,"Block 2001, Block Group 2, Census Tract 5064.01, Santa Clara County, California",18,18,0
1000000US060855064012002,060855064012002,"Block 2002, Block Group 2, Census Tract 5064.01, Santa Clara County, California",27,26,1
1000000US060855064012003,060855064012003,"Block 2003, Block Group 2, Census Tract 5064.01, Santa Clara County, California",21,21,0
1000000US060855064012004,060855064012004,"Block 2004, Block Group 2, Census Tract 5064.01, Santa Clara County, California",64,9,55
1000000US060855064012005,060855064012005,"Block 2005, Block Group 2, Census Tract 5064.01, Santa Clara County, California",12,11,1
1000000US060855064012006,060855064012006,"Block 2006, Block Group 2, Census Tract 5064.01, Santa Clara County, California",14,13,1
1000000US060855064012007,060855064012007,"Block 2007, Block Group 2, Census Tract 5064.01, Santa Clara County, California",98,71,27
1000000US060855064012008,060855064012008,"Block 2008, Block Group 2, Census Tract 5064.01, Santa Clara County, California",120,83,37
1000000US060855064012009,060855064012009,"Block 2009, Block Group 2, Census Tract 5064.01, Santa Clara County, California",0,0,0
1000000US060855064012010,060855064012010,"Block 2010, Block Group 2, Census Tract 5064.01, Santa Clara County, California",0,0,0
1000000US060855064012011,060855064012011,"Block 2011, Block Group 2, Census Tract 5064.01, Santa Clara County, California",0,0,0
1000000US060855064012012,060855064012012,"Block 2012, Block Group 2, Census Tract 5064.01, Santa Clara County, California",0,0,0
1000000US060855064012013,060855064012013,"Block 2013, Block Group 2, Census Tract 5064.01, Santa Clara County, California",0,0,0
1000000US060855064012014,060855064012014,"Block 2014, Block Group 2, Census Tract 5064.01, Santa Clara County, California",273,247,26
1000000US060855064012015,060855064012015,"Block 2015, Block Group 2, Census Tract 5064.01, Santa Clara County, California",293,244,49
1000000US060855064012016,060855064012016,"Block 2016, Block Group 2, Census Tract 5064.01, Santa Clara County, California",24,24,0
1000000US060855064012017,060855064012017,"Block 2017, Block Group 2, Census Tract 5064.01, Santa Clara County, California",0,0,0
1000000US060855064012018,060855064012018,"Block 2018, Block Group 2, Census Tract 5064.01, Santa Clara County, California",0,0,0
1000000US060855064021000,060855064021000,"Block 1000, Block Group 1, Census Tract 5064.02, Santa Clara County, California",25,25,0
1000000US060855064021001,060855064021001,"Block 1001, Block Group 1, Census Tract 5064.02, Santa Clara County, California",23,23,0
1000000US060855064021002,060855064021002,"Block 1002, Block Group 1, Census Tract 5064.02, Santa Clara County, California",74,74,0
1000000US060855064021003,060855064021003,"Block 1003, Block Group 1, Census Tract 5064.02, Santa Clara County, California",145,142,3
1000000US060855064021004,060855064021004,"Block 1004, Block Group 1, Census Tract 5064.02, Santa Clara County, California",16,16,0
1000000US060855064021005,060855064021005,"Block 1005, Block Group 1, Census Tract 5064.02, Santa Clara County, California",17,16,1
1000000US060855064021006,060855064021006,"Block 1006, Block Group 1, Census Tract 5064.02, Santa Clara County, California",1,1,0
1000000US060855064021007,060855064021007,"Block 1007, Block Group 1, Census Tract 5064.02, Santa Clara County, California",0,0,0
1000000US060855064021008,060855064021008,"Block 1008, Block Group 1, Census Tract 5064.02, Santa Clara County, California",0,0,0
1000000US060855064021009,060855064021009,"Block 1009, Block Group 1, Census Tract 5064.02, Santa Clara County, California",48,46,2
1000000US060855064021010,060855064021010,"Block 1010, Block Group 1, Census Tract 5064.02, Santa Clara County, California",176,162,14
1000000US060855064021011,060855064021011,"Block 1011, Block Group 1, Census Tract 5064.02, Santa Clara County, California",62,61,1
1000000US060855064021012,060855064021012,"Block 1012, Block Group 1, Census Tract 5064.02, Santa Clara County, California",19,19,0
1000000US060855064022000,060855064022000,"Block 2000, Block Group 2, Census Tract 5064.02, Santa Clara County, California",8,7,1
1000000US060855064022001,060855064022001,"Block 2001, Block Group 2, Census Tract 5064.02, Santa Clara County, California",8,8,0
1000000US060855064022002,060855064022002,"Block 2002, Block Group 2, Census Tract 5064.02, Santa Clara County, California",16,16,0
1000000US060855064022003,060855064022003,"Block 2003, Block Group 2, Census Tract 5064.02, Santa Clara County, California",47,46,1
1000000US060855064022004,060855064022004,"Block 2004, Block Group 2, Census Tract 5064.02, Santa Clara County, California",33,33,0
1000000US060855064022005,060855064022005,"Block 2005, Block Group 2, Census Tract 5064.02, Santa Clara County, California",38,36,2
1000000US060855064022006,060855064022006,"Block 2006, Block Group 2, Census Tract 5064.02, Santa Clara County, California",20,20,0
1000000US060855064022007,060855064022007,"Block 2007, Block Group 2, Census Tract 5064.02, Santa Clara County, California",22,19,3
1000000US060855064022008,060855064022008,"Block 2008, Block Group 2, Census Tract 5064.02, Santa Clara County, California",20,20,0
1000000US060855064022009,060855064022009,"Block 2009, Block Group 2, Census Tract 5064.02, Santa Clara County, California",37,37,0
1000000US060855064023000,060855064023000,"Block 3000, Block Group 3, Census Tract 5064.02, Santa Clara County, California",21,20,1
1000000US060855064023001,060855064023001,"Block 3001, Block Group 3, Census Tract 5064.02, Santa Clara County, California",22,22,0
1000000US060855064023002,060855064023002,"Block 3002, Block Group 3, Census Tract 5064.02, Santa Clara County, California",26,26,0
1000000US060855064023003,060855064023003,"Block 3003, Block Group 3, Census Tract 5064.02, Santa Clara County, California",16,16,0
1000000US060855064023004,060855064023004,"Block 3004, Block Group 3, Census Tract 5064.02, Santa Clara County, California",13,12,1
1000000US060855064023005,060855064023005,"Block 3005, Block Group 3, Census Tract 5064.02, Santa Clara County, California",35,33,2
1000000US060855064023006,060855064023006,"Block 3006, Block Group 3, Census Tract 5064.02, Santa Clara County, California",31,31,0
1000000US060855064023007,060855064023007,"Block 3007, Block Group 3, Census Tract 5064.02, Santa Clara County, California",41,39,2
1000000US060855064023008,060855064023008,"Block 3008, Block Group 3, Census Tract 5064.02, Santa Clara County, California",148,145,3
1000000US060855064023009,060855064023009,"Block 3009, Block Group 3, Census Tract 5064.02, Santa Clara County, California",82,78,4
1000000US060855064023010,060855064023010,"Block 3010, Block Group 3, Census Tract 5064.02, Santa Clara County, California",28,27,1
1000000US060855064023011,060855064023011,"Block 3011, Block Group 3, Census Tract 5064.02, Santa Clara County, California",64,60,4
1000000US060855064023012,060855064023012,"Block 3012, Block Group 3, Census Tract 5064.02, Santa Clara County, California",21,20,1
1000000US060855064023013,060855064023013,"Block 3013, Block Group 3, Census Tract 5064.02, Santa Clara County, California",52,51,1
1000000US060855064023014,060855064023014,"Block 3014, Block Group 3, Census Tract 5064.02, Santa Clara County, California",42,42,0
1000000US060855064023015,060855064023015,"Block 3015, Block Group 3, Census Tract 5064.02, Santa Clara County, California",254,215,39
1000000US060855064023016,060855064023016,"Block 3016, Block Group 3, Census Tract 5064.02, Santa Clara County, California",7,7,0
1000000US060855064023017,060855064023017,"Block 3017, Block Group 3, Census Tract 5064.02, Santa Clara County, California",192,185,7
1000000US060855064024000,060855064024000,"Block 4000, Block Group 4, Census Tract 5064.02, Santa Clara County, California",8,8,0
1000000US060855064024001,060855064024001,"Block 4001, Block Group 4, Census Tract 5064.02, Santa Clara County, California",0,0,0
1000000US060855064024002,060855064024002,"Block 4002, Block Group 4, Census Tract 5064.02, Santa Clara County, California",10,9,1
1000000US060855064024003,060855064024003,"Block 4003, Block Group 4, Census Tract 5064.02, Santa Clara County, California",10,9,1
1000000US060855064024004,060855064024004,"Block 4004, Block Group 4, Census Tract 5064.02, Santa Clara County, California",26,25,1
1000000US060855064024005,060855064024005,"Block 4005, Block Group 4, Census Tract 5064.02, Santa Clara County, California",27,27,0
1000000US060855064024006,060855064024006,"Block 4006, Block Group 4, Census Tract 5064.02, Santa Clara County, California",180,164,16
1000000US060855064024007,060855064024007,"Block 4007, Block Group 4, Census Tract 5064.02, Santa Clara County, California",74,74,0
1000000US060855064024008,060855064024008,"Block 4008, Block Group 4, Census Tract 5064.02, Santa Clara County, California",46,45,1
1000000US060855064024009,060855064024009,"Block 4009, Block Group 4, Census Tract 5064.02, Santa Clara County, California",0,0,0
1000000US060855064024010,060855064024010,"Block 4010, Block Group 4, Census Tract 5064.02, Santa Clara County, California",0,0,0
1000000US060855064024011,060855064024011,"Block 4011, Block Group 4, Census Tract 5064.02, Santa Clara County, California",0,0,0
1000000US060855064024012,060855064024012,"Block 4012, Block Group 4, Census Tract 5064.02, Santa Clara County, California",0,0,0
1000000US060855065011000,060855065011000,"Block 1000, Block Group 1, Census Tract 5065.01, Santa Clara County, California",263,257,6
1000000US060855065011001,060855065011001,"Block 1001, Block Group 1, Census Tract 5065.01, Santa Clara County, California",156,152,4
1000000US060855065011002,060855065011002,"Block 1002, Block Group 1, Census Tract 5065.01, Santa Clara County, California",66,62,4
1000000US060855065011003,060855065011003,"Block 1003, Block Group 1, Census Tract 5065.01, Santa Clara County, California",41,41,0
1000000US060855065011004,060855065011004,"Block 1004, Block Group 1, Census Tract 5065.01, Santa Clara County, California",7,7,0
1000000US060855065011005,060855065011005,"Block 1005, Block Group 1, Census Tract 5065.01, Santa Clara County, California",9,9,0
1000000US060855065011006,060855065011006,"Block 1006, Block Group 1, Census Tract 5065.01, Santa Clara County, California",28,28,0
1000000US060855065012000,060855065012000,"Block 2000, Block Group 2, Census Tract 5065.01, Santa Clara County, California",29,28,1
1000000US060855065012001,060855065012001,"Block 2001, Block Group 2, Census Tract 5065.01, Santa Clara County, California",65,65,0
1000000US060855065012002,060855065012002,"Block 2002, Block Group 2, Census Tract 5065.01, Santa Clara County, California",4,4,0
1000000US060855065012003,060855065012003,"Block 2003, Block Group 2, Census Tract 5065.01, Santa Clara County, California",8,8,0
1000000US060855065012004,060855065012004,"Block 2004, Block Group 2, Census Tract 5065.01, Santa Clara County, California",134,127,7
1000000US060855065012005,060855065012005,"Block 2005, Block Group 2, Census Tract 5065.01, Santa Clara County, California",0,0,0
1000000US060855065012006,060855065012006,"Block 2006, Block Group 2, Census Tract 5065.01, Santa Clara County, California",3,3,0
1000000US060855065012007,060855065012007,"Block 2007, Block Group 2, Census Tract 5065.01, Santa Clara County, California",0,0,0
1000000US060855065012008,060855065012008,"Block 2008, Block Group 2, Census Tract 5065.01, Santa Clara County, California",7,7,0
1000000US060855065012009,060855065012009,"Block 2009, Block Group 2, Census Tract 5065.01, Santa Clara County, California",253,229,24
1000000US060855065012010,060855065012010,"Block 2010, Block Group 2, Census Tract 5065.01, Santa Clara County, California",60,57,3
1000000US060855065012011,060855065012011,"Block 2011, Block Group 2, Census Tract 5065.01, Santa Clara County, California",29,26,3
1000000US060855065012012,060855065012012,"Block 2012, Block Group 2, Census Tract 5065.01, Santa Clara County, California",0,0,0
1000000US060855065012013,060855065012013,"Block 2013, Block Group 2, Census Tract 5065.01, Santa Clara County, California",0,0,0
1000000US060855065012014,060855065012014,"Block 2014, Block Group 2, Census Tract 5065.01, Santa Clara County, California",0,0,0
1000000US060855065012015,060855065012015,"Block 2015, Block Group 2, Census Tract 5065.01, Santa Clara County, California",6,6,0
1000000US060855065012016,060855065012016,"Block 2016, Block Group 2, Census Tract 5065.01, Santa Clara County, California",14,14,0
1000000US060855065012017,060855065012017,"Block 2017, Block Group 2, Census Tract 5065.01, Santa Clara County, California",4,4,0
1000000US060855065012018,060855065012018,"Block 2018, Block Group 2, Census Tract 5065.01, Santa Clara County, California",23,23,0
1000000US060855065012019,060855065012019,"Block 2019, Block Group 2, Census Tract 5065.01, Santa Clara County, California",9,9,0
1000000US060855065012020,060855065012020,"Block 2020, Block Group 2, Census Tract 5065.01, Santa Clara County, California",79,75,4
1000000US060855065012021,060855065012021,"Block 2021, Block Group 2, Census Tract 5065.01, Santa Clara County, California",219,216,3
1000000US060855065012022,060855065012022,"Block 2022, Block Group 2, Census Tract 5065.01, Santa Clara County, California",43,43,0
1000000US060855065012023,060855065012023,"Block 2023, Block Group 2, Census Tract 5065.01, Santa Clara County, California",28,28,0
1000000US060855065012024,060855065012024,"Block 2024, Block Group 2, Census Tract 5065.01, Santa Clara County, California",7,7,0
1000000US060855065012025,060855065012025,"Block 2025, Block Group 2, Census Tract 5065.01, Santa Clara County, California",0,0,0
1000000US060855065012026,060855065012026,"Block 2026, Block Group 2, Census Tract 5065.01, Santa Clara County, California",0,0,0
1000000US060855065012027,060855065012027,"Block 2027, Block Group 2, Census Tract 5065.01, Santa Clara County, California",24,23,1
1000000US060855065012028,060855065012028,"Block 2028, Block Group 2, Census Tract 5065.01, Santa Clara County, California",0,0,0
1000000US060855065012029,060855065012029,"Block 2029, Block Group 2, Census Tract 5065.01, Santa Clara County, California",0,0,0
1000000US060855065013000,060855065013000,"Block 3000, Block Group 3, Census Tract 5065.01, Santa Clara County, California",443,436,7
1000000US060855065013001,060855065013001,"Block 3001, Block Group 3, Census Tract 5065.01, Santa Clara County, California",24,24,0
1000000US060855065013002,060855065013002,"Block 3002, Block Group 3, Census Tract 5065.01, Santa Clara County, California",286,266,20
1000000US060855065013003,060855065013003,"Block 3003, Block Group 3, Census Tract 5065.01, Santa Clara County, California",225,216,9
1000000US060855065021000,060855065021000,"Block 1000, Block Group 1, Census Tract 5065.02, Santa Clara County, California",0,0,0
1000000US060855065021001,060855065021001,"Block 1001, Block Group 1, Census Tract 5065.02, Santa Clara County, California",0,0,0
1000000US060855065021002,060855065021002,"Block 1002, Block Group 1, Census Tract 5065.02, Santa Clara County, California",56,40,16
1000000US060855065021003,060855065021003,"Block 1003, Block Group 1, Census Tract 5065.02, Santa Clara County, California",0,0,0
1000000US060855065021004,060855065021004,"Block 1004, Block Group 1, Census Tract 5065.02, Santa Clara County, California",23,23,0
1000000US060855065021005,060855065021005,"Block 1005, Block Group 1, Census Tract 5065.02, Santa Clara County, California",33,33,0
1000000US060855065021006,060855065021006,"Block 1006, Block Group 1, Census Tract 5065.02, Santa Clara County, California",128,122,6
1000000US060855065021007,060855065021007,"Block 1007, Block Group 1, Census Tract 5065.02, Santa Clara County, California",80,76,4
1000000US060855065021008,060855065021008,"Block 1008, Block Group 1, Census Tract 5065.02, Santa Clara County, California",68,62,6
1000000US060855065021009,060855065021009,"Block 1009, Block Group 1, Census Tract 5065.02, Santa Clara County, California",17,17,0
1000000US060855065021010,060855065021010,"Block 1010, Block Group 1, Census Tract 5065.02, Santa Clara County, California",184,178,6
1000000US060855065021011,060855065021011,"Block 1011, Block Group 1, Census Tract 5065.02, Santa Clara County, California",21,20,1
1000000US060855065021012,060855065021012,"Block 1012, Block Group 1, Census Tract 5065.02, Santa Clara County, California",26,24,2
1000000US060855065021013,060855065021013,"Block 1013, Block Group 1, Census Tract 5065.02, Santa Clara County, California",10,10,0
1000000US060855065021014,060855065021014,"Block 1014, Block Group 1, Census Tract 5065.02, Santa Clara County, California",43,43,0
1000000US060855065021015,060855065021015,"Block 1015, Block Group 1, Census Tract 5065.02, Santa Clara County, California",46,46,0
1000000US060855065022000,060855065022000,"Block 2000, Block Group 2, Census Tract 5065.02, Santa Clara County, California",103,100,3
1000000US060855065022001,060855065022001,"Block 2001, Block Group 2, Census Tract 5065.02, Santa Clara County, California",0,0,0
1000000US060855065022002,060855065022002,"Block 2002, Block Group 2, Census Tract 5065.02, Santa Clara County, California",18,16,2
1000000US060855065022003,060855065022003,"Block 2003, Block Group 2, Census Tract 5065.02, Santa Clara County, California",11,11,0
1000000US060855065022004,060855065022004,"Block 2004, Block Group 2, Census Tract 5065.02, Santa Clara County, California",16,14,2
1000000US060855065022005,060855065022005,"Block 2005, Block Group 2, Census Tract 5065.02, Santa Clara County, California",20,20,0
1000000US060855065022006,060855065022006,"Block 2006, Block Group 2, Census Tract 5065.02, Santa Clara County, California",0,0,0
1000000US060855065022007,060855065022007,"Block 2007, Block Group 2, Census Tract 5065.02, Santa Clara County, California",0,0,0
1000000US060855065022008,060855065022008,"Block 2008, Block Group 2, Census Tract 5065.02, Santa Clara County, California",0,0,0
1000000US060855065022009,060855065022009,"Block 2009, Block Group 2, Census Tract 5065.02, Santa Clara County, California",11,11,0
1000000US060855065022010,060855065022010,"Block 2010, Block Group 2, Census Tract 5065.02, Santa Clara County, California",20,20,0
1000000US060855065022011,060855065022011,"Block 2011, Block Group 2, Census Tract 5065.02, Santa Clara County, California",0,0,0
1000000US060855065022012,060855065022012,"Block 2012, Block Group 2, Census Tract 5065.02, Santa Clara County, California",143,128,15
1000000US060855065022013,060855065022013,"Block 2013, Block Group 2, Census Tract 5065.02, Santa Clara County, California",60,59,1
1000000US060855065022014,060855065022014,"Block 2014, Block Group 2, Census Tract 5065.02, Santa Clara County, California",20,19,1
1000000US060855065022015,060855065022015,"Block 2015, Block Group 2, Census Tract 5065.02, Santa Clara County, California",22,16,6
1000000US060855065022016,060855065022016,"Block 2016, Block Group 2, Census Tract 5065.02, Santa Clara County, California",0,0,0
1000000US060855065022017,060855065022017,"Block 2017, Block Group 2, Census Tract 5065.02, Santa Clara County, California",1,1,0
1000000US060855065022018,060855065022018,"Block 2018, Block Group 2, Census Tract 5065.02, Santa Clara County, California",0,0,0
1000000US060855065022019,060855065022019,"Block 2019, Block Group 2, Census Tract 5065.02, Santa Clara County, California",0,0,0
1000000US060855065022020,060855065022020,"Block 2020, Block Group 2, Census Tract 5065.02, Santa Clara County, California",0,0,0
1000000US060855065023000,060855065023000,"Block 3000, Block Group 3, Census Tract 5065.02, Santa Clara County, California",0,0,0
1000000US060855065023001,060855065023001,"Block 3001, Block Group 3, Census Tract 5065.02, Santa Clara County, California",361,346,15
1000000US060855065023002,060855065023002,"Block 3002, Block Group 3, Census Tract 5065.02, Santa Clara County, California",0,0,0
1000000US060855065023003,060855065023003,"Block 3003, Block Group 3, Census Tract 5065.02, Santa Clara County, California",3,3,0
1000000US060855065023004,060855065023004,"Block 3004, Block Group 3, Census Tract 5065.02, Santa Clara County, California",25,24,1
1000000US060855065023005,060855065023005,"Block 3005, Block Group 3, Census Tract 5065.02, Santa Clara County, California",1,1,0
1000000US060855065023006,060855065023006,"Block 3006, Block Group 3, Census Tract 5065.02, Santa Clara County, California",144,142,2
1000000US060855065023007,060855065023007,"Block 3007, Block Group 3, Census Tract 5065.02, Santa Clara County, California",0,0,0
1000000US060855065023008,060855065023008,"Block 3008, Block Group 3, Census Tract 5065.02, Santa Clara County, California",0,0,0
1000000US060855065023009,060855065023009,"Block 3009, Block Group 3, Census Tract 5065.02, Santa Clara County, California",21,20,1
1000000US060855065023010,060855065023010,"Block 3010, Block Group 3, Census Tract 5065.02, Santa Clara County, California",51,49,2
1000000US060855065023011,060855065023011,"Block 3011, Block Group 3, Census Tract 5065.02, Santa Clara County, California",27,26,1
1000000US060855065023012,060855065023012,"Block 3012, Block Group 3, Census Tract 5065.02, Santa Clara County, California",19,17,2
1000000US060855065023013,060855065023013,"Block 3013, Block Group 3, Census Tract 5065.02, Santa Clara County, California",0,0,0
1000000US060855065023014,060855065023014,"Block 3014, Block Group 3, Census Tract 5065.02, Santa Clara County, California",0,0,0
1000000US060855065023015,060855065023015,"Block 3015, Block Group 3, Census Tract 5065.02, Santa Clara County, California",0,0,0
1000000US060855065023016,060855065023016,"Block 3016, Block Group 3, Census Tract 5065.02, Santa Clara County, California",0,0,0
1000000US060855065023017,060855065023017,"Block 3017, Block Group 3, Census Tract 5065.02, Santa Clara County, California",0,0,0
1000000US060855065023018,060855065023018,"Block 3018, Block Group 3, Census Tract 5065.02, Santa Clara County, California",0,0,0
1000000US060855065023019,060855065023019,"Block 3019, Block Group 3, Census Tract 5065.02, Santa Clara County, California",29,24,5
1000000US060855065023020,060855065023020,"Block 3020, Block Group 3, Census Tract 5065.02, Santa Clara County, California",11,11,0
1000000US060855065023021,060855065023021,"Block 3021, Block Group 3, Census Tract 5065.02, Santa Clara County, California",12,11,1
1000000US060855065023022,060855065023022,"Block 3022, Block Group 3, Census Tract 5065.02, Santa Clara County, California",27,16,11
1000000US060855065023023,060855065023023,"Block 3023, Block Group 3, Census Tract 5065.02, Santa Clara County, California",30,29,1
1000000US060855065023024,060855065023024,"Block 3024, Block Group 3, Census Tract 5065.02, Santa Clara County, California",0,0,0
1000000US060855065023025,060855065023025,"Block 3025, Block Group 3, Census Tract 5065.02, Santa Clara County, California",0,0,0
1000000US060855065023026,060855065023026,"Block 3026, Block Group 3, Census Tract 5065.02, Santa Clara County, California",0,0,0
1000000US060855065023027,060855065023027,"Block 3027, Block Group 3, Census Tract 5065.02, Santa Clara County, California",0,0,0
1000000US060855065023028,060855065023028,"Block 3028, Block Group 3, Census Tract 5065.02, Santa Clara County, California",0,0,0
1000000US060855065023029,060855065023029,"Block 3029, Block Group 3, Census Tract 5065.02, Santa Clara County, California",0,0,0
1000000US060855065023030,060855065023030,"Block 3030, Block Group 3, Census Tract 5065.02, Santa Clara County, California",0,0,0
1000000US060855065023031,060855065023031,"Block 3031, Block Group 3, Census Tract 5065.02, Santa Clara County, California",0,0,0
1000000US060855065023032,060855065023032,"Block 3032, Block Group 3, Census Tract 5065.02, Santa Clara County, California",0,0,0
1000000US060855065023033,060855065023033,"Block 3033, Block Group 3, Census Tract 5065.02, Santa Clara County, California",4,4,0
1000000US060855065023034,060855065023034,"Block 3034, Block Group 3, Census Tract 5065.02, Santa Clara County, California",0,0,0
1000000US060855065023035,060855065023035,"Block 3035, Block Group 3, Census Tract 5065.02, Santa Clara County, California",0,0,0
1000000US060855065023036,060855065023036,"Block 3036, Block Group 3, Census Tract 5065.02, Santa Clara County, California",39,38,1
1000000US060855065023037,060855065023037,"Block 3037, Block Group 3, Census Tract 5065.02, Santa Clara County, California",0,0,0
1000000US060855065023038,060855065023038,"Block 3038, Block Group 3, Census Tract 5065.02, Santa Clara County, California",5,5,0
1000000US060855065023039,060855065023039,"Block 3039, Block Group 3, Census Tract 5065.02, Santa Clara County, California",13,10,3
1000000US060855065023040,060855065023040,"Block 3040, Block Group 3, Census Tract 5065.02, Santa Clara County, California",32,30,2
1000000US060855065023041,060855065023041,"Block 3041, Block Group 3, Census Tract 5065.02, Santa Clara County, California",0,0,0
1000000US060855065023042,060855065023042,"Block 3042, Block Group 3, Census Tract 5065.02, Santa Clara County, California",0,0,0
1000000US060855065023043,060855065023043,"Block 3043, Block Group 3, Census Tract 5065.02, Santa Clara County, California",0,0,0
1000000US060855065023044,060855065023044,"Block 3044, Block Group 3, Census Tract 5065.02, Santa Clara County, California",0,0,0
1000000US060855065023045,060855065023045,"Block 3045, Block Group 3, Census Tract 5065.02, Santa Clara County, California",0,0,0
1000000US060855065023046,060855065023046,"Block 3046, Block Group 3, Census Tract 5065.02, Santa Clara County, California",0,0,0
1000000US060855065023047,060855065023047,"Block 3047, Block Group 3, Census Tract 5065.02, Santa Clara County, California",1,1,0
1000000US060855065023048,060855065023048,"Block 3048, Block Group 3, Census Tract 5065.02, Santa Clara County, California",0,0,0
1000000US060855065023049,060855065023049,"Block 3049, Block Group 3, Census Tract 5065.02, Santa Clara County, California",0,0,0
1000000US060855065023050,060855065023050,"Block 3050, Block Group 3, Census Tract 5065.02, Santa Clara County, California",0,0,0
1000000US060855065023051,060855065023051,"Block 3051, Block Group 3, Census Tract 5065.02, Santa Clara County, California",3,2,1
1000000US060855065023052,060855065023052,"Block 3052, Block Group 3, Census Tract 5065.02, Santa Clara County, California",0,0,0
1000000US060855065023053,060855065023053,"Block 3053, Block Group 3, Census Tract 5065.02, Santa Clara County, California",0,0,0
1000000US060855065023054,060855065023054,"Block 3054, Block Group 3, Census Tract 5065.02, Santa Clara County, California",0,0,0
1000000US060855065023055,060855065023055,"Block 3055, Block Group 3, Census Tract 5065.02, Santa Clara County, California",0,0,0
1000000US060855065023056,060855065023056,"Block 3056, Block Group 3, Census Tract 5065.02, Santa Clara County, California",0,0,0
1000000US060855065023057,060855065023057,"Block 3057, Block Group 3, Census Tract 5065.02, Santa Clara County, California",0,0,0
1000000US060855065023058,060855065023058,"Block 3058, Block Group 3, Census Tract 5065.02, Santa Clara County, California",0,0,0
1000000US060855065023059,060855065023059,"Block 3059, Block Group 3, Census Tract 5065.02, Santa Clara County, California",0,0,0
1000000US060855065023060,060855065023060,"Block 3060, Block Group 3, Census Tract 5065.02, Santa Clara County, California",0,0,0
1000000US060855065023061,060855065023061,"Block 3061, Block Group 3, Census Tract 5065.02, Santa Clara County, California",2,2,0
1000000US060855065023062,060855065023062,"Block 3062, Block Group 3, Census Tract 5065.02, Santa Clara County, California",0,0,0
1000000US060855065023063,060855065023063,"Block 3063, Block Group 3, Census Tract 5065.02, Santa Clara County, California",0,0,0
1000000US060855065023064,060855065023064,"Block 3064, Block Group 3, Census Tract 5065.02, Santa Clara County, California",0,0,0
1000000US060855065031000,060855065031000,"Block 1000, Block Group 1, Census Tract 5065.03, Santa Clara County, California",156,156,0
1000000US060855065031001,060855065031001,"Block 1001, Block Group 1, Census Tract 5065.03, Santa Clara County, California",71,69,2
1000000US060855065031002,060855065031002,"Block 1002, Block Group 1, Census Tract 5065.03, Santa Clara County, California",107,104,3
1000000US060855065031003,060855065031003,"Block 1003, Block Group 1, Census Tract 5065.03, Santa Clara County, California",32,29,3
1000000US060855065031004,060855065031004,"Block 1004, Block Group 1, Census Tract 5065.03, Santa Clara County, California",50,48,2
1000000US060855065031005,060855065031005,"Block 1005, Block Group 1, Census Tract 5065.03, Santa Clara County, California",49,48,1
1000000US060855065031006,060855065031006,"Block 1006, Block Group 1, Census Tract 5065.03, Santa Clara County, California",12,12,0
1000000US060855065031007,060855065031007,"Block 1007, Block Group 1, Census Tract 5065.03, Santa Clara County, California",3,3,0
1000000US060855065031008,060855065031008,"Block 1008, Block Group 1, Census Tract 5065.03, Santa Clara County, California",7,7,0
1000000US060855065031009,060855065031009,"Block 1009, Block Group 1, Census Tract 5065.03, Santa Clara County, California",0,0,0
1000000US060855065031010,060855065031010,"Block 1010, Block Group 1, Census Tract 5065.03, Santa Clara County, California",0,0,0
1000000US060855065031011,060855065031011,"Block 1011, Block Group 1, Census Tract 5065.03, Santa Clara County, California",89,87,2
1000000US060855065031012,060855065031012,"Block 1012, Block Group 1, Census Tract 5065.03, Santa Clara County, California",65,61,4
1000000US060855065031013,060855065031013,"Block 1013, Block Group 1, Census Tract 5065.03, Santa Clara County, California",36,35,1
1000000US060855065031014,060855065031014,"Block 1014, Block Group 1, Census Tract 5065.03, Santa Clara County, California",18,17,1
1000000US060855065031015,060855065031015,"Block 1015, Block Group 1, Census Tract 5065.03, Santa Clara County, California",18,18,0
1000000US060855065031016,060855065031016,"Block 1016, Block Group 1, Census Tract 5065.03, Santa Clara County, California",25,24,1
1000000US060855065031017,060855065031017,"Block 1017, Block Group 1, Census Tract 5065.03, Santa Clara County, California",76,74,2
1000000US060855065031018,060855065031018,"Block 1018, Block Group 1, Census Tract 5065.03, Santa Clara County, California",24,23,1
1000000US060855065031019,060855065031019,"Block 1019, Block Group 1, Census Tract 5065.03, Santa Clara County, California",0,0,0
1000000US060855065031020,060855065031020,"Block 1020, Block Group 1, Census Tract 5065.03, Santa Clara County, California",0,0,0
1000000US060855065031021,060855065031021,"Block 1021, Block Group 1, Census Tract 5065.03, Santa Clara County, California",0,0,0
1000000US060855065031022,060855065031022,"Block 1022, Block Group 1, Census Tract 5065.03, Santa Clara County, California",36,36,0
1000000US060855065031023,060855065031023,"Block 1023, Block Group 1, Census Tract 5065.03, Santa Clara County, California",0,0,0
1000000US060855065031024,060855065031024,"Block 1024, Block Group 1, Census Tract 5065.03, Santa Clara County, California",0,0,0
1000000US060855065032000,060855065032000,"Block 2000, Block Group 2, Census Tract 5065.03, Santa Clara County, California",0,0,0
1000000US060855065032001,060855065032001,"Block 2001, Block Group 2, Census Tract 5065.03, Santa Clara County, California",64,57,7
1000000US060855065032002,060855065032002,"Block 2002, Block Group 2, Census Tract 5065.03, Santa Clara County, California",142,138,4
1000000US060855065032003,060855065032003,"Block 2003, Block Group 2, Census Tract 5065.03, Santa Clara County, California",99,98,1
1000000US060855065032004,060855065032004,"Block 2004, Block Group 2, Census Tract 5065.03, Santa Clara County, California",81,77,4
1000000US060855065032005,060855065032005,"Block 2005, Block Group 2, Census Tract 5065.03, Santa Clara County, California",0,0,0
1000000US060855065032006,060855065032006,"Block 2006, Block Group 2, Census Tract 5065.03, Santa Clara County, California",0,0,0
1000000US060855065032007,060855065032007,"Block 2007, Block Group 2, Census Tract 5065.03, Santa Clara County, California",399,386,13
1000000US060855065032008,060855065032008,"Block 2008, Block Group 2, Census Tract 5065.03, Santa Clara County, California",0,0,0
1000000US060855065032009,060855065032009,"Block 2009, Block Group 2, Census Tract 5065.03, Santa Clara County, California",28,28,0
1000000US060855065032010,060855065032010,"Block 2010, Block Group 2, Census Tract 5065.03, Santa Clara County, California",38,37,1
1000000US060855065032011,060855065032011,"Block 2011, Block Group 2, Census Tract 5065.03, Santa Clara County, California",25,25,0
1000000US060855065032012,060855065032012,"Block 2012, Block Group 2, Census Tract 5065.03, Santa Clara County, California",1,1,0
1000000US060855065032013,060855065032013,"Block 2013, Block Group 2, Census Tract 5065.03, Santa Clara County, California",0,0,0
1000000US060855065033000,060855065033000,"Block 3000, Block Group 3, Census Tract 5065.03, Santa Clara County, California",606,561,45
1000000US060855065033001,060855065033001,"Block 3001, Block Group 3, Census Tract 5065.03, Santa Clara County, California",149,143,6
1000000US060855065033002,060855065033002,"Block 3002, Block Group 3, Census Tract 5065.03, Santa Clara County, California",155,145,10
1000000US060855065033003,060855065033003,"Block 3003, Block Group 3, Census Tract 5065.03, Santa Clara County, California",90,84,6
1000000US060855065033004,060855065033004,"Block 3004, Block Group 3, Census Tract 5065.03, Santa Clara County, California",0,0,0
1000000US060855066011000,060855066011000,"Block 1000, Block Group 1, Census Tract 5066.01, Santa Clara County, California",51,50,1
1000000US060855066011001,060855066011001,"Block 1001, Block Group 1, Census Tract 5066.01, Santa Clara County, California",0,0,0
1000000US060855066011002,060855066011002,"Block 1002, Block Group 1, Census Tract 5066.01, Santa Clara County, California",12,12,0
1000000US060855066011003,060855066011003,"Block 1003, Block Group 1, Census Tract 5066.01, Santa Clara County, California",20,20,0
1000000US060855066011004,060855066011004,"Block 1004, Block Group 1, Census Tract 5066.01, Santa Clara County, California",34,34,0
1000000US060855066011005,060855066011005,"Block 1005, Block Group 1, Census Tract 5066.01, Santa Clara County, California",33,32,1
1000000US060855066011006,060855066011006,"Block 1006, Block Group 1, Census Tract 5066.01, Santa Clara County, California",30,30,0
1000000US060855066011007,060855066011007,"Block 1007, Block Group 1, Census Tract 5066.01, Santa Clara County, California",9,9,0
1000000US060855066011008,060855066011008,"Block 1008, Block Group 1, Census Tract 5066.01, Santa Clara County, California",20,19,1
1000000US060855066011009,060855066011009,"Block 1009, Block Group 1, Census Tract 5066.01, Santa Clara County, California",12,12,0
1000000US060855066011010,060855066011010,"Block 1010, Block Group 1, Census Tract 5066.01, Santa Clara County, California",9,9,0
1000000US060855066011011,060855066011011,"Block 1011, Block Group 1, Census Tract 5066.01, Santa Clara County, California",23,23,0
1000000US060855066011012,060855066011012,"Block 1012, Block Group 1, Census Tract 5066.01, Santa Clara County, California",26,26,0
1000000US060855066011013,060855066011013,"Block 1013, Block Group 1, Census Tract 5066.01, Santa Clara County, California",23,23,0
1000000US060855066011014,060855066011014,"Block 1014, Block Group 1, Census Tract 5066.01, Santa Clara County, California",66,64,2
1000000US060855066011015,060855066011015,"Block 1015, Block Group 1, Census Tract 5066.01, Santa Clara County, California",60,55,5
1000000US060855066011016,060855066011016,"Block 1016, Block Group 1, Census Tract 5066.01, Santa Clara County, California",82,78,4
1000000US060855066011017,060855066011017,"Block 1017, Block Group 1, Census Tract 5066.01, Santa Clara County, California",64,61,3
1000000US060855066011018,060855066011018,"Block 1018, Block Group 1, Census Tract 5066.01, Santa Clara County, California",28,28,0
1000000US060855066011019,060855066011019,"Block 1019, Block Group 1, Census Tract 5066.01, Santa Clara County, California",17,16,1
1000000US060855066011020,060855066011020,"Block 1020, Block Group 1, Census Tract 5066.01, Santa Clara County, California",29,29,0
1000000US060855066012000,060855066012000,"Block 2000, Block Group 2, Census Tract 5066.01, Santa Clara County, California",49,49,0
1000000US060855066012001,060855066012001,"Block 2001, Block Group 2, Census Tract 5066.01, Santa Clara County, California",15,15,0
1000000US060855066012002,060855066012002,"Block 2002, Block Group 2, Census Tract 5066.01, Santa Clara County, California",10,10,0
1000000US060855066012003,060855066012003,"Block 2003, Block Group 2, Census Tract 5066.01, Santa Clara County, California",22,21,1
1000000US060855066012004,060855066012004,"Block 2004, Block Group 2, Census Tract 5066.01, Santa Clara County, California",22,21,1
1000000US060855066012005,060855066012005,"Block 2005, Block Group 2, Census Tract 5066.01, Santa Clara County, California",28,27,1
1000000US060855066012006,060855066012006,"Block 2006, Block Group 2, Census Tract 5066.01, Santa Clara County, California",24,23,1
1000000US060855066012007,060855066012007,"Block 2007, Block Group 2, Census Tract 5066.01, Santa Clara County, California",16,16,0
1000000US060855066012008,060855066012008,"Block 2008, Block Group 2, Census Tract 5066.01, Santa Clara County, California",17,17,0
1000000US060855066012009,060855066012009,"Block 2009, Block Group 2, Census Tract 5066.01, Santa Clara County, California",6,6,0
1000000US060855066012010,060855066012010,"Block 2010, Block Group 2, Census Tract 5066.01, Santa Clara County, California",33,33,0
1000000US060855066012011,060855066012011,"Block 2011, Block Group 2, Census Tract 5066.01, Santa Clara County, California",17,17,0
1000000US060855066012012,060855066012012,"Block 2012, Block Group 2, Census Tract 5066.01, Santa Clara County, California",27,27,0
1000000US060855066012013,060855066012013,"Block 2013, Block Group 2, Census Tract 5066.01, Santa Clara County, California",18,18,0
1000000US060855066012014,060855066012014,"Block 2014, Block Group 2, Census Tract 5066.01, Santa Clara County, California",27,27,0
1000000US060855066012015,060855066012015,"Block 2015, Block Group 2, Census Tract 5066.01, Santa Clara County, California",0,0,0
1000000US060855066012016,060855066012016,"Block 2016, Block Group 2, Census Tract 5066.01, Santa Clara County, California",0,0,0
1000000US060855066012017,060855066012017,"Block 2017, Block Group 2, Census Tract 5066.01, Santa Clara County, California",0,0,0
1000000US060855066012018,060855066012018,"Block 2018, Block Group 2, Census Tract 5066.01, Santa Clara County, California",0,0,0
1000000US060855066012019,060855066012019,"Block 2019, Block Group 2, Census Tract 5066.01, Santa Clara County, California",7,6,1
1000000US060855066013000,060855066013000,"Block 3000, Block Group 3, Census Tract 5066.01, Santa Clara County, California",11,10,1
1000000US060855066013001,060855066013001,"Block 3001, Block Group 3, Census Tract 5066.01, Santa Clara County, California",28,28,0
1000000US060855066013002,060855066013002,"Block 3002, Block Group 3, Census Tract 5066.01, Santa Clara County, California",9,9,0
1000000US060855066013003,060855066013003,"Block 3003, Block Group 3, Census Tract 5066.01, Santa Clara County, California",19,16,3
1000000US060855066013004,060855066013004,"Block 3004, Block Group 3, Census Tract 5066.01, Santa Clara County, California",18,16,2
1000000US060855066013005,060855066013005,"Block 3005, Block Group 3, Census Tract 5066.01, Santa Clara County, California",9,9,0
1000000US060855066013006,060855066013006,"Block 3006, Block Group 3, Census Tract 5066.01, Santa Clara County, California",102,99,3
1000000US060855066013007,060855066013007,"Block 3007, Block Group 3, Census Tract 5066.01, Santa Clara County, California",0,0,0
1000000US060855066013008,060855066013008,"Block 3008, Block Group 3, Census Tract 5066.01, Santa Clara County, California",145,118,27
1000000US060855066013009,060855066013009,"Block 3009, Block Group 3, Census Tract 5066.01, Santa Clara County, California",20,20,0
1000000US060855066013010,060855066013010,"Block 3010, Block Group 3, Census Tract 5066.01, Santa Clara County, California",50,48,2
1000000US060855066013011,060855066013011,"Block 3011, Block Group 3, Census Tract 5066.01, Santa Clara County, California",107,103,4
1000000US060855066013012,060855066013012,"Block 3012, Block Group 3, Census Tract 5066.01, Santa Clara County, California",32,32,0
1000000US060855066013013,060855066013013,"Block 3013, Block Group 3, Census Tract 5066.01, Santa Clara County, California",23,23,0
1000000US060855066013014,060855066013014,"Block 3014, Block Group 3, Census Tract 5066.01, Santa Clara County, California",0,0,0
1000000US060855066013015,060855066013015,"Block 3015, Block Group 3, Census Tract 5066.01, Santa Clara County, California",211,199,12
1000000US060855066031000,060855066031000,"Block 1000, Block Group 1, Census Tract 5066.03, Santa Clara County, California",12,12,0
1000000US060855066031001,060855066031001,"Block 1001, Block Group 1, Census Tract 5066.03, Santa Clara County, California",24,24,0
1000000US060855066031002,060855066031002,"Block 1002, Block Group 1, Census Tract 5066.03, Santa Clara County, California",22,22,0
1000000US060855066031003,060855066031003,"Block 1003, Block Group 1, Census Tract 5066.03, Santa Clara County, California",22,22,0
1000000US060855066031004,060855066031004,"Block 1004, Block Group 1, Census Tract 5066.03, Santa Clara County, California",11,11,0
1000000US060855066031005,060855066031005,"Block 1005, Block Group 1, Census Tract 5066.03, Santa Clara County, California",13,13,0
1000000US060855066031006,060855066031006,"Block 1006, Block Group 1, Census Tract 5066.03, Santa Clara County, California",36,36,0
1000000US060855066031007,060855066031007,"Block 1007, Block Group 1, Census Tract 5066.03, Santa Clara County, California",13,13,0
1000000US060855066031008,060855066031008,"Block 1008, Block Group 1, Census Tract 5066.03, Santa Clara County, California",24,24,0
1000000US060855066031009,060855066031009,"Block 1009, Block Group 1, Census Tract 5066.03, Santa Clara County, California",13,13,0
1000000US060855066031010,060855066031010,"Block 1010, Block Group 1, Census Tract 5066.03, Santa Clara County, California",12,12,0
1000000US060855066031011,060855066031011,"Block 1011, Block Group 1, Census Tract 5066.03, Santa Clara County, California",12,12,0
1000000US060855066031012,060855066031012,"Block 1012, Block Group 1, Census Tract 5066.03, Santa Clara County, California",40,40,0
1000000US060855066031013,060855066031013,"Block 1013, Block Group 1, Census Tract 5066.03, Santa Clara County, California",17,16,1
1000000US060855066031014,060855066031014,"Block 1014, Block Group 1, Census Tract 5066.03, Santa Clara County, California",15,15,0
1000000US060855066031015,060855066031015,"Block 1015, Block Group 1, Census Tract 5066.03, Santa Clara County, California",28,28,0
1000000US060855066031016,060855066031016,"Block 1016, Block Group 1, Census Tract 5066.03, Santa Clara County, California",6,6,0
1000000US060855066032000,060855066032000,"Block 2000, Block Group 2, Census Tract 5066.03, Santa Clara County, California",28,28,0
1000000US060855066032001,060855066032001,"Block 2001, Block Group 2, Census Tract 5066.03, Santa Clara County, California",15,15,0
1000000US060855066032002,060855066032002,"Block 2002, Block Group 2, Census Tract 5066.03, Santa Clara County, California",29,29,0
1000000US060855066032003,060855066032003,"Block 2003, Block Group 2, Census Tract 5066.03, Santa Clara County, California",13,13,0
1000000US060855066032004,060855066032004,"Block 2004, Block Group 2, Census Tract 5066.03, Santa Clara County, California",21,21,0
1000000US060855066032005,060855066032005,"Block 2005, Block Group 2, Census Tract 5066.03, Santa Clara County, California",39,37,2
1000000US060855066032006,060855066032006,"Block 2006, Block Group 2, Census Tract 5066.03, Santa Clara County, California",36,35,1
1000000US060855066032007,060855066032007,"Block 2007, Block Group 2, Census Tract 5066.03, Santa Clara County, California",24,24,0
1000000US060855066032008,060855066032008,"Block 2008, Block Group 2, Census Tract 5066.03, Santa Clara County, California",30,30,0
1000000US060855066032009,060855066032009,"Block 2009, Block Group 2, Census Tract 5066.03, Santa Clara County, California",48,47,1
1000000US060855066032010,060855066032010,"Block 2010, Block Group 2, Census Tract 5066.03, Santa Clara County, California",15,15,0
1000000US060855066032011,060855066032011,"Block 2011, Block Group 2, Census Tract 5066.03, Santa Clara County, California",38,38,0
1000000US060855066032012,060855066032012,"Block 2012, Block Group 2, Census Tract 5066.03, Santa Clara County, California",13,13,0
1000000US060855066032013,060855066032013,"Block 2013, Block Group 2, Census Tract 5066.03, Santa Clara County, California",21,21,0
1000000US060855066032014,060855066032014,"Block 2014, Block Group 2, Census Tract 5066.03, Santa Clara County, California",41,40,1
1000000US060855066032015,060855066032015,"Block 2015, Block Group 2, Census Tract 5066.03, Santa Clara County, California",38,37,1
1000000US060855066032016,060855066032016,"Block 2016, Block Group 2, Census Tract 5066.03, Santa Clara County, California",38,38,0
1000000US060855066032017,060855066032017,"Block 2017, Block Group 2, Census Tract 5066.03, Santa Clara County, California",32,32,0
1000000US060855066032018,060855066032018,"Block 2018, Block Group 2, Census Tract 5066.03, Santa Clara County, California",20,20,0
1000000US060855066032019,060855066032019,"Block 2019, Block Group 2, Census Tract 5066.03, Santa Clara County, California",22,22,0
1000000US060855066032020,060855066032020,"Block 2020, Block Group 2, Census Tract 5066.03, Santa Clara County, California",27,27,0
1000000US060855066032021,060855066032021,"Block 2021, Block Group 2, Census Tract 5066.03, Santa Clara County, California",29,29,0
1000000US060855066032022,060855066032022,"Block 2022, Block Group 2, Census Tract 5066.03, Santa Clara County, California",40,39,1
1000000US060855066033000,060855066033000,"Block 3000, Block Group 3, Census Tract 5066.03, Santa Clara County, California",34,33,1
1000000US060855066033001,060855066033001,"Block 3001, Block Group 3, Census Tract 5066.03, Santa Clara County, California",25,25,0
1000000US060855066033002,060855066033002,"Block 3002, Block Group 3, Census Tract 5066.03, Santa Clara County, California",39,34,5
1000000US060855066033003,060855066033003,"Block 3003, Block Group 3, Census Tract 5066.03, Santa Clara County, California",18,18,0
1000000US060855066033004,060855066033004,"Block 3004, Block Group 3, Census Tract 5066.03, Santa Clara County, California",18,18,0
1000000US060855066033005,060855066033005,"Block 3005, Block Group 3, Census Tract 5066.03, Santa Clara County, California",33,32,1
1000000US060855066033006,060855066033006,"Block 3006, Block Group 3, Census Tract 5066.03, Santa Clara County, California",32,31,1
1000000US060855066033007,060855066033007,"Block 3007, Block Group 3, Census Tract 5066.03, Santa Clara County, California",36,36,0
1000000US060855066033008,060855066033008,"Block 3008, Block Group 3, Census Tract 5066.03, Santa Clara County, California",42,42,0
1000000US060855066033009,060855066033009,"Block 3009, Block Group 3, Census Tract 5066.03, Santa Clara County, California",22,21,1
1000000US060855066033010,060855066033010,"Block 3010, Block Group 3, Census Tract 5066.03, Santa Clara County, California",12,12,0
1000000US060855066033011,060855066033011,"Block 3011, Block Group 3, Census Tract 5066.03, Santa Clara County, California",40,37,3
1000000US060855066033012,060855066033012,"Block 3012, Block Group 3, Census Tract 5066.03, Santa Clara County, California",13,13,0
1000000US060855066033013,060855066033013,"Block 3013, Block Group 3, Census Tract 5066.03, Santa Clara County, California",57,56,1
1000000US060855066033014,060855066033014,"Block 3014, Block Group 3, Census Tract 5066.03, Santa Clara County, California",10,10,0
1000000US060855066033015,060855066033015,"Block 3015, Block Group 3, Census Tract 5066.03, Santa Clara County, California",13,12,1
1000000US060855066041000,060855066041000,"Block 1000, Block Group 1, Census Tract 5066.04, Santa Clara County, California",70,65,5
1000000US060855066041001,060855066041001,"Block 1001, Block Group 1, Census Tract 5066.04, Santa Clara County, California",16,16,0
1000000US060855066041002,060855066041002,"Block 1002, Block Group 1, Census Tract 5066.04, Santa Clara County, California",44,43,1
1000000US060855066041003,060855066041003,"Block 1003, Block Group 1, Census Tract 5066.04, Santa Clara County, California",28,27,1
1000000US060855066041004,060855066041004,"Block 1004, Block Group 1, Census Tract 5066.04, Santa Clara County, California",33,32,1
1000000US060855066041005,060855066041005,"Block 1005, Block Group 1, Census Tract 5066.04, Santa Clara County, California",143,124,19
1000000US060855066042000,060855066042000,"Block 2000, Block Group 2, Census Tract 5066.04, Santa Clara County, California",10,10,0
1000000US060855066042001,060855066042001,"Block 2001, Block Group 2, Census Tract 5066.04, Santa Clara County, California",58,57,1
1000000US060855066042002,060855066042002,"Block 2002, Block Group 2, Census Tract 5066.04, Santa Clara County, California",21,21,0
1000000US060855066042003,060855066042003,"Block 2003, Block Group 2, Census Tract 5066.04, Santa Clara County, California",13,13,0
1000000US060855066042004,060855066042004,"Block 2004, Block Group 2, Census Tract 5066.04, Santa Clara County, California",32,32,0
1000000US060855066042005,060855066042005,"Block 2005, Block Group 2, Census Tract 5066.04, Santa Clara County, California",24,24,0
1000000US060855066042006,060855066042006,"Block 2006, Block Group 2, Census Tract 5066.04, Santa Clara County, California",44,42,2
1000000US060855066042007,060855066042007,"Block 2007, Block Group 2, Census Tract 5066.04, Santa Clara County, California",64,64,0
1000000US060855066042008,060855066042008,"Block 2008, Block Group 2, Census Tract 5066.04, Santa Clara County, California",26,24,2
1000000US060855066042009,060855066042009,"Block 2009, Block Group 2, Census Tract 5066.04, Santa Clara County, California",50,50,0
1000000US060855066042010,060855066042010,"Block 2010, Block Group 2, Census Tract 5066.04, Santa Clara County, California",36,36,0
1000000US060855066042011,060855066042011,"Block 2011, Block Group 2, Census Tract 5066.04, Santa Clara County, California",34,32,2
1000000US060855066042012,060855066042012,"Block 2012, Block Group 2, Census Tract 5066.04, Santa Clara County, California",28,27,1
1000000US060855066042013,060855066042013,"Block 2013, Block Group 2, Census Tract 5066.04, Santa Clara County, California",28,27,1
1000000US060855066042014,060855066042014,"Block 2014, Block Group 2, Census Tract 5066.04, Santa Clara County, California",28,28,0
1000000US060855066042015,060855066042015,"Block 2015, Block Group 2, Census Tract 5066.04, Santa Clara County, California",22,21,1
1000000US060855066042016,060855066042016,"Block 2016, Block Group 2, Census Tract 5066.04, Santa Clara County, California",43,42,1
1000000US060855066042017,060855066042017,"Block 2017, Block Group 2, Census Tract 5066.04, Santa Clara County, California",36,35,1
1000000US060855066042018,060855066042018,"Block 2018, Block Group 2, Census Tract 5066.04, Santa Clara County, California",0,0,0
1000000US060855066042019,060855066042019,"Block 2019, Block Group 2, Census Tract 5066.04, Santa Clara County, California",19,19,0
1000000US060855066043000,060855066043000,"Block 3000, Block Group 3, Census Tract 5066.04, Santa Clara County, California",36,36,0
1000000US060855066043001,060855066043001,"Block 3001, Block Group 3, Census Tract 5066.04, Santa Clara County, California",46,45,1
1000000US060855066043002,060855066043002,"Block 3002, Block Group 3, Census Tract 5066.04, Santa Clara County, California",33,33,0
1000000US060855066043003,060855066043003,"Block 3003, Block Group 3, Census Tract 5066.04, Santa Clara County, California",56,55,1
1000000US060855066043004,060855066043004,"Block 3004, Block Group 3, Census Tract 5066.04, Santa Clara County, California",26,26,0
1000000US060855066043005,060855066043005,"Block 3005, Block Group 3, Census Tract 5066.04, Santa Clara County, California",20,20,0
1000000US060855066043006,060855066043006,"Block 3006, Block Group 3, Census Tract 5066.04, Santa Clara County, California",20,20,0
1000000US060855066043007,060855066043007,"Block 3007, Block Group 3, Census Tract 5066.04, Santa Clara County, California",46,44,2
1000000US060855066043008,060855066043008,"Block 3008, Block Group 3, Census Tract 5066.04, Santa Clara County, California",47,47,0
1000000US060855066043009,060855066043009,"Block 3009, Block Group 3, Census Tract 5066.04, Santa Clara County, California",12,12,0
1000000US060855066043010,060855066043010,"Block 3010, Block Group 3, Census Tract 5066.04, Santa Clara County, California",10,10,0
1000000US060855066043011,060855066043011,"Block 3011, Block Group 3, Census Tract 5066.04, Santa Clara County, California",39,39,0
1000000US060855066043012,060855066043012,"Block 3012, Block Group 3, Census Tract 5066.04, Santa Clara County, California",52,50,2
1000000US060855066043013,060855066043013,"Block 3013, Block Group 3, Census Tract 5066.04, Santa Clara County, California",20,18,2
1000000US060855066043014,060855066043014,"Block 3014, Block Group 3, Census Tract 5066.04, Santa Clara County, California",15,15,0
1000000US060855066043015,060855066043015,"Block 3015, Block Group 3, Census Tract 5066.04, Santa Clara County, California",16,15,1
1000000US060855066043016,060855066043016,"Block 3016, Block Group 3, Census Tract 5066.04, Santa Clara County, California",43,41,2
1000000US060855066043017,060855066043017,"Block 3017, Block Group 3, Census Tract 5066.04, Santa Clara County, California",20,20,0
1000000US060855066043018,060855066043018,"Block 3018, Block Group 3, Census Tract 5066.04, Santa Clara County, California",20,20,0
1000000US060855066044000,060855066044000,"Block 4000, Block Group 4, Census Tract 5066.04, Santa Clara County, California",18,18,0
1000000US060855066044001,060855066044001,"Block 4001, Block Group 4, Census Tract 5066.04, Santa Clara County, California",61,59,2
1000000US060855066044002,060855066044002,"Block 4002, Block Group 4, Census Tract 5066.04, Santa Clara County, California",42,41,1
1000000US060855066044003,060855066044003,"Block 4003, Block Group 4, Census Tract 5066.04, Santa Clara County, California",56,56,0
1000000US060855066044004,060855066044004,"Block 4004, Block Group 4, Census Tract 5066.04, Santa Clara County, California",58,57,1
1000000US060855066044005,060855066044005,"Block 4005, Block Group 4, Census Tract 5066.04, Santa Clara County, California",60,59,1
1000000US060855066044006,060855066044006,"Block 4006, Block Group 4, Census Tract 5066.04, Santa Clara County, California",36,36,0
1000000US060855066044007,060855066044007,"Block 4007, Block Group 4, Census Tract 5066.04, Santa Clara County, California",36,36,0
1000000US060855066044008,060855066044008,"Block 4008, Block Group 4, Census Tract 5066.04, Santa Clara County, California",36,36,0
1000000US060855066044009,060855066044009,"Block 4009, Block Group 4, Census Tract 5066.04, Santa Clara County, California",14,14,0
1000000US060855066044010,060855066044010,"Block 4010, Block Group 4, Census Tract 5066.04, Santa Clara County, California",29,28,1
1000000US060855066044011,060855066044011,"Block 4011, Block Group 4, Census Tract 5066.04, Santa Clara County, California",28,28,0
1000000US060855066044012,060855066044012,"Block 4012, Block Group 4, Census Tract 5066.04, Santa Clara County, California",0,0,0
1000000US060855066044013,060855066044013,"Block 4013, Block Group 4, Census Tract 5066.04, Santa Clara County, California",49,45,4
1000000US060855066044014,060855066044014,"Block 4014, Block Group 4, Census Tract 5066.04, Santa Clara County, California",0,0,0
1000000US060855066044015,060855066044015,"Block 4015, Block Group 4, Census Tract 5066.04, Santa Clara County, California",9,8,1
1000000US060855066044016,060855066044016,"Block 4016, Block Group 4, Census Tract 5066.04, Santa Clara County, California",12,12,0
1000000US060855066045000,060855066045000,"Block 5000, Block Group 5, Census Tract 5066.04, Santa Clara County, California",0,0,0
1000000US060855066045001,060855066045001,"Block 5001, Block Group 5, Census Tract 5066.04, Santa Clara County, California",0,0,0
1000000US060855066045002,060855066045002,"Block 5002, Block Group 5, Census Tract 5066.04, Santa Clara County, California",0,0,0
1000000US060855066045003,060855066045003,"Block 5003, Block Group 5, Census Tract 5066.04, Santa Clara County, California",59,51,8
1000000US060855066045004,060855066045004,"Block 5004, Block Group 5, Census Tract 5066.04, Santa Clara County, California",32,32,0
1000000US060855066045005,060855066045005,"Block 5005, Block Group 5, Census Tract 5066.04, Santa Clara County, California",15,15,0
1000000US060855066045006,060855066045006,"Block 5006, Block Group 5, Census Tract 5066.04, Santa Clara County, California",18,18,0
1000000US060855066045007,060855066045007,"Block 5007, Block Group 5, Census Tract 5066.04, Santa Clara County, California",18,17,1
1000000US060855066045008,060855066045008,"Block 5008, Block Group 5, Census Tract 5066.04, Santa Clara County, California",2,2,0
1000000US060855066045009,060855066045009,"Block 5009, Block Group 5, Census Tract 5066.04, Santa Clara County, California",0,0,0
1000000US060855066045010,060855066045010,"Block 5010, Block Group 5, Census Tract 5066.04, Santa Clara County, California",2,2,0
1000000US060855066045011,060855066045011,"Block 5011, Block Group 5, Census Tract 5066.04, Santa Clara County, California",38,37,1
1000000US060855066045012,060855066045012,"Block 5012, Block Group 5, Census Tract 5066.04, Santa Clara County, California",44,42,2
1000000US060855066045013,060855066045013,"Block 5013, Block Group 5, Census Tract 5066.04, Santa Clara County, California",16,16,0
1000000US060855066045014,060855066045014,"Block 5014, Block Group 5, Census Tract 5066.04, Santa Clara County, California",35,34,1
1000000US060855066045015,060855066045015,"Block 5015, Block Group 5, Census Tract 5066.04, Santa Clara County, California",18,17,1
1000000US060855066045016,060855066045016,"Block 5016, Block Group 5, Census Tract 5066.04, Santa Clara County, California",190,187,3
1000000US060855066045017,060855066045017,"Block 5017, Block Group 5, Census Tract 5066.04, Santa Clara County, California",47,46,1
1000000US060855066045018,060855066045018,"Block 5018, Block Group 5, Census Tract 5066.04, Santa Clara County, California",40,40,0
1000000US060855066051000,060855066051000,"Block 1000, Block Group 1, Census Tract 5066.05, Santa Clara County, California",0,0,0
1000000US060855066051001,060855066051001,"Block 1001, Block Group 1, Census Tract 5066.05, Santa Clara County, California",0,0,0
1000000US060855066051002,060855066051002,"Block 1002, Block Group 1, Census Tract 5066.05, Santa Clara County, California",132,126,6
1000000US060855066051003,060855066051003,"Block 1003, Block Group 1, Census Tract 5066.05, Santa Clara County, California",54,54,0
1000000US060855066051004,060855066051004,"Block 1004, Block Group 1, Census Tract 5066.05, Santa Clara County, California",45,44,1
1000000US060855066051005,060855066051005,"Block 1005, Block Group 1, Census Tract 5066.05, Santa Clara County, California",33,33,0
1000000US060855066051006,060855066051006,"Block 1006, Block Group 1, Census Tract 5066.05, Santa Clara County, California",62,62,0
1000000US060855066051007,060855066051007,"Block 1007, Block Group 1, Census Tract 5066.05, Santa Clara County, California",34,33,1
1000000US060855066051008,060855066051008,"Block 1008, Block Group 1, Census Tract 5066.05, Santa Clara County, California",74,73,1
1000000US060855066051009,060855066051009,"Block 1009, Block Group 1, Census Tract 5066.05, Santa Clara County, California",61,59,2
1000000US060855066051010,060855066051010,"Block 1010, Block Group 1, Census Tract 5066.05, Santa Clara County, California",32,32,0
1000000US060855066051011,060855066051011,"Block 1011, Block Group 1, Census Tract 5066.05, Santa Clara County, California",27,23,4
1000000US060855066051012,060855066051012,"Block 1012, Block Group 1, Census Tract 5066.05, Santa Clara County, California",18,18,0
1000000US060855066051013,060855066051013,"Block 1013, Block Group 1, Census Tract 5066.05, Santa Clara County, California",0,0,0
1000000US060855066051014,060855066051014,"Block 1014, Block Group 1, Census Tract 5066.05, Santa Clara County, California",4,4,0
1000000US060855066051015,060855066051015,"Block 1015, Block Group 1, Census Tract 5066.05, Santa Clara County, California",0,0,0
1000000US060855066051016,060855066051016,"Block 1016, Block Group 1, Census Tract 5066.05, Santa Clara County, California",0,0,0
1000000US060855066051017,060855066051017,"Block 1017, Block Group 1, Census Tract 5066.05, Santa Clara County, California",261,250,11
1000000US060855066051018,060855066051018,"Block 1018, Block Group 1, Census Tract 5066.05, Santa Clara County, California",2,2,0
1000000US060855066051019,060855066051019,"Block 1019, Block Group 1, Census Tract 5066.05, Santa Clara County, California",1,1,0
1000000US060855066051020,060855066051020,"Block 1020, Block Group 1, Census Tract 5066.05, Santa Clara County, California",0,0,0
1000000US060855066051021,060855066051021,"Block 1021, Block Group 1, Census Tract 5066.05, Santa Clara County, California",7,7,0
1000000US060855066051022,060855066051022,"Block 1022, Block Group 1, Census Tract 5066.05, Santa Clara County, California",0,0,0
1000000US060855066051023,060855066051023,"Block 1023, Block Group 1, Census Tract 5066.05, Santa Clara County, California",0,0,0
1000000US060855066051024,060855066051024,"Block 1024, Block Group 1, Census Tract 5066.05, Santa Clara County, California",0,0,0
1000000US060855066051025,060855066051025,"Block 1025, Block Group 1, Census Tract 5066.05, Santa Clara County, California",0,0,0
1000000US060855066051026,060855066051026,"Block 1026, Block Group 1, Census Tract 5066.05, Santa Clara County, California",22,22,0
1000000US060855066052000,060855066052000,"Block 2000, Block Group 2, Census Tract 5066.05, Santa Clara County, California",46,44,2
1000000US060855066052001,060855066052001,"Block 2001, Block Group 2, Census Tract 5066.05, Santa Clara County, California",55,55,0
1000000US060855066052002,060855066052002,"Block 2002, Block Group 2, Census Tract 5066.05, Santa Clara County, California",18,18,0
1000000US060855066052003,060855066052003,"Block 2003, Block Group 2, Census Tract 5066.05, Santa Clara County, California",18,18,0
1000000US060855066052004,060855066052004,"Block 2004, Block Group 2, Census Tract 5066.05, Santa Clara County, California",27,26,1
1000000US060855066052005,060855066052005,"Block 2005, Block Group 2, Census Tract 5066.05, Santa Clara County, California",27,25,2
1000000US060855066052006,060855066052006,"Block 2006, Block Group 2, Census Tract 5066.05, Santa Clara County, California",38,37,1
1000000US060855066052007,060855066052007,"Block 2007, Block Group 2, Census Tract 5066.05, Santa Clara County, California",55,54,1
1000000US060855066052008,060855066052008,"Block 2008, Block Group 2, Census Tract 5066.05, Santa Clara County, California",187,180,7
1000000US060855066052009,060855066052009,"Block 2009, Block Group 2, Census Tract 5066.05, Santa Clara County, California",184,176,8
1000000US060855066052010,060855066052010,"Block 2010, Block Group 2, Census Tract 5066.05, Santa Clara County, California",54,52,2
1000000US060855066052011,060855066052011,"Block 2011, Block Group 2, Census Tract 5066.05, Santa Clara County, California",0,0,0
1000000US060855066061000,060855066061000,"Block 1000, Block Group 1, Census Tract 5066.06, Santa Clara County, California",30,29,1
1000000US060855066061001,060855066061001,"Block 1001, Block Group 1, Census Tract 5066.06, Santa Clara County, California",20,20,0
1000000US060855066061002,060855066061002,"Block 1002, Block Group 1, Census Tract 5066.06, Santa Clara County, California",72,70,2
1000000US060855066061003,060855066061003,"Block 1003, Block Group 1, Census Tract 5066.06, Santa Clara County, California",56,54,2
1000000US060855066061004,060855066061004,"Block 1004, Block Group 1, Census Tract 5066.06, Santa Clara County, California",43,39,4
1000000US060855066061005,060855066061005,"Block 1005, Block Group 1, Census Tract 5066.06, Santa Clara County, California",18,18,0
1000000US060855066061006,060855066061006,"Block 1006, Block Group 1, Census Tract 5066.06, Santa Clara County, California",25,24,1
1000000US060855066062000,060855066062000,"Block 2000, Block Group 2, Census Tract 5066.06, Santa Clara County, California",0,0,0
1000000US060855066062001,060855066062001,"Block 2001, Block Group 2, Census Tract 5066.06, Santa Clara County, California",39,39,0
1000000US060855066062002,060855066062002,"Block 2002, Block Group 2, Census Tract 5066.06, Santa Clara County, California",31,31,0
1000000US060855066062003,060855066062003,"Block 2003, Block Group 2, Census Tract 5066.06, Santa Clara County, California",64,64,0
1000000US060855066062004,060855066062004,"Block 2004, Block Group 2, Census Tract 5066.06, Santa Clara County, California",20,18,2
1000000US060855066062005,060855066062005,"Block 2005, Block Group 2, Census Tract 5066.06, Santa Clara County, California",20,20,0
1000000US060855066062006,060855066062006,"Block 2006, Block Group 2, Census Tract 5066.06, Santa Clara County, California",33,33,0
1000000US060855066062007,060855066062007,"Block 2007, Block Group 2, Census Tract 5066.06, Santa Clara County, California",53,53,0
1000000US060855066062008,060855066062008,"Block 2008, Block Group 2, Census Tract 5066.06, Santa Clara County, California",20,20,0
1000000US060855066062009,060855066062009,"Block 2009, Block Group 2, Census Tract 5066.06, Santa Clara County, California",34,33,1
1000000US060855066062010,060855066062010,"Block 2010, Block Group 2, Census Tract 5066.06, Santa Clara County, California",90,88,2
1000000US060855066062011,060855066062011,"Block 2011, Block Group 2, Census Tract 5066.06, Santa Clara County, California",32,31,1
1000000US060855066062012,060855066062012,"Block 2012, Block Group 2, Census Tract 5066.06, Santa Clara County, California",37,36,1
1000000US060855066062013,060855066062013,"Block 2013, Block Group 2, Census Tract 5066.06, Santa Clara County, California",3,3,0
1000000US060855066062014,060855066062014,"Block 2014, Block Group 2, Census Tract 5066.06, Santa Clara County, California",0,0,0
1000000US060855066062015,060855066062015,"Block 2015, Block Group 2, Census Tract 5066.06, Santa Clara County, California",126,118,8
1000000US060855066062016,060855066062016,"Block 2016, Block Group 2, Census Tract 5066.06, Santa Clara County, California",0,0,0
1000000US060855066062017,060855066062017,"Block 2017, Block Group 2, Census Tract 5066.06, Santa Clara County, California",0,0,0
1000000US060855066062018,060855066062018,"Block 2018, Block Group 2, Census Tract 5066.06, Santa Clara County, California",26,26,0
1000000US060855066062019,060855066062019,"Block 2019, Block Group 2, Census Tract 5066.06, Santa Clara County, California",119,114,5
1000000US060855066063000,060855066063000,"Block 3000, Block Group 3, Census Tract 5066.06, Santa Clara County, California",51,47,4
1000000US060855066063001,060855066063001,"Block 3001, Block Group 3, Census Tract 5066.06, Santa Clara County, California",39,38,1
1000000US060855066063002,060855066063002,"Block 3002, Block Group 3, Census Tract 5066.06, Santa Clara County, California",81,78,3
1000000US060855066063003,060855066063003,"Block 3003, Block Group 3, Census Tract 5066.06, Santa Clara County, California",16,16,0
1000000US060855066063004,060855066063004,"Block 3004, Block Group 3, Census Tract 5066.06, Santa Clara County, California",72,72,0
1000000US060855066063005,060855066063005,"Block 3005, Block Group 3, Census Tract 5066.06, Santa Clara County, California",112,110,2
1000000US060855066063006,060855066063006,"Block 3006, Block Group 3, Census Tract 5066.06, Santa Clara County, California",22,22,0
1000000US060855066063007,060855066063007,"Block 3007, Block Group 3, Census Tract 5066.06, Santa Clara County, California",20,20,0
1000000US060855066063008,060855066063008,"Block 3008, Block Group 3, Census Tract 5066.06, Santa Clara County, California",22,22,0
1000000US060855066063009,060855066063009,"Block 3009, Block Group 3, Census Tract 5066.06, Santa Clara County, California",24,24,0
1000000US060855066063010,060855066063010,"Block 3010, Block Group 3, Census Tract 5066.06, Santa Clara County, California",24,24,0
1000000US060855066063011,060855066063011,"Block 3011, Block Group 3, Census Tract 5066.06, Santa Clara County, California",8,8,0
1000000US060855066063012,060855066063012,"Block 3012, Block Group 3, Census Tract 5066.06, Santa Clara County, California",59,59,0
1000000US060855066063013,060855066063013,"Block 3013, Block Group 3, Census Tract 5066.06, Santa Clara County, California",143,121,22
1000000US060855066063014,060855066063014,"Block 3014, Block Group 3, Census Tract 5066.06, Santa Clara County, California",0,0,0
1000000US060855067011000,060855067011000,"Block 1000, Block Group 1, Census Tract 5067.01, Santa Clara County, California",21,20,1
1000000US060855067011001,060855067011001,"Block 1001, Block Group 1, Census Tract 5067.01, Santa Clara County, California",9,9,0
1000000US060855067011002,060855067011002,"Block 1002, Block Group 1, Census Tract 5067.01, Santa Clara County, California",21,20,1
1000000US060855067011003,060855067011003,"Block 1003, Block Group 1, Census Tract 5067.01, Santa Clara County, California",167,165,2
1000000US060855067011004,060855067011004,"Block 1004, Block Group 1, Census Tract 5067.01, Santa Clara County, California",16,16,0
1000000US060855067011005,060855067011005,"Block 1005, Block Group 1, Census Tract 5067.01, Santa Clara County, California",0,0,0
1000000US060855067011006,060855067011006,"Block 1006, Block Group 1, Census Tract 5067.01, Santa Clara County, California",18,18,0
1000000US060855067011007,060855067011007,"Block 1007, Block Group 1, Census Tract 5067.01, Santa Clara County, California",0,0,0
1000000US060855067012000,060855067012000,"Block 2000, Block Group 2, Census Tract 5067.01, Santa Clara County, California",2,2,0
1000000US060855067012001,060855067012001,"Block 2001, Block Group 2, Census Tract 5067.01, Santa Clara County, California",0,0,0
1000000US060855067012002,060855067012002,"Block 2002, Block Group 2, Census Tract 5067.01, Santa Clara County, California",22,21,1
1000000US060855067012003,060855067012003,"Block 2003, Block Group 2, Census Tract 5067.01, Santa Clara County, California",30,30,0
1000000US060855067012004,060855067012004,"Block 2004, Block Group 2, Census Tract 5067.01, Santa Clara County, California",1,1,0
1000000US060855067012005,060855067012005,"Block 2005, Block Group 2, Census Tract 5067.01, Santa Clara County, California",47,46,1
1000000US060855067012006,060855067012006,"Block 2006, Block Group 2, Census Tract 5067.01, Santa Clara County, California",29,29,0
1000000US060855067012007,060855067012007,"Block 2007, Block Group 2, Census Tract 5067.01, Santa Clara County, California",42,42,0
1000000US060855067012008,060855067012008,"Block 2008, Block Group 2, Census Tract 5067.01, Santa Clara County, California",19,18,1
1000000US060855067012009,060855067012009,"Block 2009, Block Group 2, Census Tract 5067.01, Santa Clara County, California",141,137,4
1000000US060855067012010,060855067012010,"Block 2010, Block Group 2, Census Tract 5067.01, Santa Clara County, California",37,37,0
1000000US060855067012011,060855067012011,"Block 2011, Block Group 2, Census Tract 5067.01, Santa Clara County, California",34,34,0
1000000US060855067012012,060855067012012,"Block 2012, Block Group 2, Census Tract 5067.01, Santa Clara County, California",38,38,0
1000000US060855067012013,060855067012013,"Block 2013, Block Group 2, Census Tract 5067.01, Santa Clara County, California",16,15,1
1000000US060855067012014,060855067012014,"Block 2014, Block Group 2, Census Tract 5067.01, Santa Clara County, California",35,34,1
1000000US060855067012015,060855067012015,"Block 2015, Block Group 2, Census Tract 5067.01, Santa Clara County, California",20,19,1
1000000US060855067012016,060855067012016,"Block 2016, Block Group 2, Census Tract 5067.01, Santa Clara County, California",40,37,3
1000000US060855067012017,060855067012017,"Block 2017, Block Group 2, Census Tract 5067.01, Santa Clara County, California",0,0,0
1000000US060855067012018,060855067012018,"Block 2018, Block Group 2, Census Tract 5067.01, Santa Clara County, California",0,0,0
1000000US060855067012019,060855067012019,"Block 2019, Block Group 2, Census Tract 5067.01, Santa Clara County, California",0,0,0
1000000US060855067012020,060855067012020,"Block 2020, Block Group 2, Census Tract 5067.01, Santa Clara County, California",36,36,0
1000000US060855067012021,060855067012021,"Block 2021, Block Group 2, Census Tract 5067.01, Santa Clara County, California",0,0,0
1000000US060855067012022,060855067012022,"Block 2022, Block Group 2, Census Tract 5067.01, Santa Clara County, California",0,0,0
1000000US060855067013000,060855067013000,"Block 3000, Block Group 3, Census Tract 5067.01, Santa Clara County, California",81,76,5
1000000US060855067013001,060855067013001,"Block 3001, Block Group 3, Census Tract 5067.01, Santa Clara County, California",11,11,0
1000000US060855067013002,060855067013002,"Block 3002, Block Group 3, Census Tract 5067.01, Santa Clara County, California",89,86,3
1000000US060855067013003,060855067013003,"Block 3003, Block Group 3, Census Tract 5067.01, Santa Clara County, California",12,12,0
1000000US060855067013004,060855067013004,"Block 3004, Block Group 3, Census Tract 5067.01, Santa Clara County, California",28,27,1
1000000US060855067013005,060855067013005,"Block 3005, Block Group 3, Census Tract 5067.01, Santa Clara County, California",20,19,1
1000000US060855067013006,060855067013006,"Block 3006, Block Group 3, Census Tract 5067.01, Santa Clara County, California",84,82,2
1000000US060855067013007,060855067013007,"Block 3007, Block Group 3, Census Tract 5067.01, Santa Clara County, California",5,5,0
1000000US060855067013008,060855067013008,"Block 3008, Block Group 3, Census Tract 5067.01, Santa Clara County, California",7,7,0
1000000US060855067013009,060855067013009,"Block 3009, Block Group 3, Census Tract 5067.01, Santa Clara County, California",1,1,0
1000000US060855067013010,060855067013010,"Block 3010, Block Group 3, Census Tract 5067.01, Santa Clara County, California",27,27,0
1000000US060855067013011,060855067013011,"Block 3011, Block Group 3, Census Tract 5067.01, Santa Clara County, California",0,0,0
1000000US060855067013012,060855067013012,"Block 3012, Block Group 3, Census Tract 5067.01, Santa Clara County, California",54,53,1
1000000US060855067013013,060855067013013,"Block 3013, Block Group 3, Census Tract 5067.01, Santa Clara County, California",7,7,0
1000000US060855067013014,060855067013014,"Block 3014, Block Group 3, Census Tract 5067.01, Santa Clara County, California",85,84,1
1000000US060855067013015,060855067013015,"Block 3015, Block Group 3, Census Tract 5067.01, Santa Clara County, California",0,0,0
1000000US060855067013016,060855067013016,"Block 3016, Block Group 3, Census Tract 5067.01, Santa Clara County, California",0,0,0
1000000US060855067013017,060855067013017,"Block 3017, Block Group 3, Census Tract 5067.01, Santa Clara County, California",0,0,0
1000000US060855067013018,060855067013018,"Block 3018, Block Group 3, Census Tract 5067.01, Santa Clara County, California",0,0,0
1000000US060855067013019,060855067013019,"Block 3019, Block Group 3, Census Tract 5067.01, Santa Clara County, California",29,28,1
1000000US060855067013020,060855067013020,"Block 3020, Block Group 3, Census Tract 5067.01, Santa Clara County, California",0,0,0
1000000US060855067013021,060855067013021,"Block 3021, Block Group 3, Census Tract 5067.01, Santa Clara County, California",0,0,0
1000000US060855067013022,060855067013022,"Block 3022, Block Group 3, Census Tract 5067.01, Santa Clara County, California",0,0,0
1000000US060855067013023,060855067013023,"Block 3023, Block Group 3, Census Tract 5067.01, Santa Clara County, California",0,0,0
1000000US060855067013024,060855067013024,"Block 3024, Block Group 3, Census Tract 5067.01, Santa Clara County, California",0,0,0
1000000US060855067013025,060855067013025,"Block 3025, Block Group 3, Census Tract 5067.01, Santa Clara County, California",0,0,0
1000000US060855067021000,060855067021000,"Block 1000, Block Group 1, Census Tract 5067.02, Santa Clara County, California",97,93,4
1000000US060855067021001,060855067021001,"Block 1001, Block Group 1, Census Tract 5067.02, Santa Clara County, California",26,25,1
1000000US060855067021002,060855067021002,"Block 1002, Block Group 1, Census Tract 5067.02, Santa Clara County, California",29,28,1
1000000US060855067021003,060855067021003,"Block 1003, Block Group 1, Census Tract 5067.02, Santa Clara County, California",0,0,0
1000000US060855067021004,060855067021004,"Block 1004, Block Group 1, Census Tract 5067.02, Santa Clara County, California",41,39,2
1000000US060855067021005,060855067021005,"Block 1005, Block Group 1, Census Tract 5067.02, Santa Clara County, California",17,17,0
1000000US060855067021006,060855067021006,"Block 1006, Block Group 1, Census Tract 5067.02, Santa Clara County, California",30,28,2
1000000US060855067021007,060855067021007,"Block 1007, Block Group 1, Census Tract 5067.02, Santa Clara County, California",31,29,2
1000000US060855067021008,060855067021008,"Block 1008, Block Group 1, Census Tract 5067.02, Santa Clara County, California",34,34,0
1000000US060855067021009,060855067021009,"Block 1009, Block Group 1, Census Tract 5067.02, Santa Clara County, California",38,37,1
1000000US060855067021010,060855067021010,"Block 1010, Block Group 1, Census Tract 5067.02, Santa Clara County, California",94,87,7
1000000US060855067021011,060855067021011,"Block 1011, Block Group 1, Census Tract 5067.02, Santa Clara County, California",44,39,5
1000000US060855067021012,060855067021012,"Block 1012, Block Group 1, Census Tract 5067.02, Santa Clara County, California",29,28,1
1000000US060855067021013,060855067021013,"Block 1013, Block Group 1, Census Tract 5067.02, Santa Clara County, California",36,35,1
1000000US060855067021014,060855067021014,"Block 1014, Block Group 1, Census Tract 5067.02, Santa Clara County, California",58,57,1
1000000US060855067021015,060855067021015,"Block 1015, Block Group 1, Census Tract 5067.02, Santa Clara County, California",76,71,5
1000000US060855067021016,060855067021016,"Block 1016, Block Group 1, Census Tract 5067.02, Santa Clara County, California",51,47,4
1000000US060855067021017,060855067021017,"Block 1017, Block Group 1, Census Tract 5067.02, Santa Clara County, California",69,60,9
1000000US060855067021018,060855067021018,"Block 1018, Block Group 1, Census Tract 5067.02, Santa Clara County, California",42,40,2
1000000US060855067022000,060855067022000,"Block 2000, Block Group 2, Census Tract 5067.02, Santa Clara County, California",93,84,9
1000000US060855067022001,060855067022001,"Block 2001, Block Group 2, Census Tract 5067.02, Santa Clara County, California",17,14,3
1000000US060855067022002,060855067022002,"Block 2002, Block Group 2, Census Tract 5067.02, Santa Clara County, California",26,25,1
1000000US060855067022003,060855067022003,"Block 2003, Block Group 2, Census Tract 5067.02, Santa Clara County, California",61,56,5
1000000US060855067022004,060855067022004,"Block 2004, Block Group 2, Census Tract 5067.02, Santa Clara County, California",90,88,2
1000000US060855067022005,060855067022005,"Block 2005, Block Group 2, Census Tract 5067.02, Santa Clara County, California",30,30,0
1000000US060855067022006,060855067022006,"Block 2006, Block Group 2, Census Tract 5067.02, Santa Clara County, California",28,28,0
1000000US060855067022007,060855067022007,"Block 2007, Block Group 2, Census Tract 5067.02, Santa Clara County, California",71,68,3
1000000US060855067022008,060855067022008,"Block 2008, Block Group 2, Census Tract 5067.02, Santa Clara County, California",55,55,0
1000000US060855067022009,060855067022009,"Block 2009, Block Group 2, Census Tract 5067.02, Santa Clara County, California",57,57,0
1000000US060855067022010,060855067022010,"Block 2010, Block Group 2, Census Tract 5067.02, Santa Clara County, California",36,36,0
1000000US060855067022011,060855067022011,"Block 2011, Block Group 2, Census Tract 5067.02, Santa Clara County, California",10,10,0
1000000US060855067022012,060855067022012,"Block 2012, Block Group 2, Census Tract 5067.02, Santa Clara County, California",60,58,2
1000000US060855067022013,060855067022013,"Block 2013, Block Group 2, Census Tract 5067.02, Santa Clara County, California",40,39,1
1000000US060855067022014,060855067022014,"Block 2014, Block Group 2, Census Tract 5067.02, Santa Clara County, California",16,16,0
1000000US060855067023000,060855067023000,"Block 3000, Block Group 3, Census Tract 5067.02, Santa Clara County, California",0,0,0
1000000US060855067023001,060855067023001,"Block 3001, Block Group 3, Census Tract 5067.02, Santa Clara County, California",389,359,30
1000000US060855067023002,060855067023002,"Block 3002, Block Group 3, Census Tract 5067.02, Santa Clara County, California",6,6,0
1000000US060855067023003,060855067023003,"Block 3003, Block Group 3, Census Tract 5067.02, Santa Clara County, California",216,209,7
1000000US060855067031000,060855067031000,"Block 1000, Block Group 1, Census Tract 5067.03, Santa Clara County, California",26,24,2
1000000US060855067031001,060855067031001,"Block 1001, Block Group 1, Census Tract 5067.03, Santa Clara County, California",7,7,0
1000000US060855067031002,060855067031002,"Block 1002, Block Group 1, Census Tract 5067.03, Santa Clara County, California",47,45,2
1000000US060855067031003,060855067031003,"Block 1003, Block Group 1, Census Tract 5067.03, Santa Clara County, California",37,36,1
1000000US060855067031004,060855067031004,"Block 1004, Block Group 1, Census Tract 5067.03, Santa Clara County, California",67,66,1
1000000US060855067031005,060855067031005,"Block 1005, Block Group 1, Census Tract 5067.03, Santa Clara County, California",54,54,0
1000000US060855067031006,060855067031006,"Block 1006, Block Group 1, Census Tract 5067.03, Santa Clara County, California",51,50,1
1000000US060855067031007,060855067031007,"Block 1007, Block Group 1, Census Tract 5067.03, Santa Clara County, California",77,75,2
1000000US060855067031008,060855067031008,"Block 1008, Block Group 1, Census Tract 5067.03, Santa Clara County, California",29,29,0
1000000US060855067031009,060855067031009,"Block 1009, Block Group 1, Census Tract 5067.03, Santa Clara County, California",22,22,0
1000000US060855067031010,060855067031010,"Block 1010, Block Group 1, Census Tract 5067.03, Santa Clara County, California",26,23,3
1000000US060855067031011,060855067031011,"Block 1011, Block Group 1, Census Tract 5067.03, Santa Clara County, California",38,35,3
1000000US060855067031012,060855067031012,"Block 1012, Block Group 1, Census Tract 5067.03, Santa Clara County, California",19,18,1
1000000US060855067031013,060855067031013,"Block 1013, Block Group 1, Census Tract 5067.03, Santa Clara County, California",14,14,0
1000000US060855067031014,060855067031014,"Block 1014, Block Group 1, Census Tract 5067.03, Santa Clara County, California",0,0,0
1000000US060855067031015,060855067031015,"Block 1015, Block Group 1, Census Tract 5067.03, Santa Clara County, California",20,16,4
1000000US060855067031016,060855067031016,"Block 1016, Block Group 1, Census Tract 5067.03, Santa Clara County, California",72,70,2
1000000US060855067031017,060855067031017,"Block 1017, Block Group 1, Census Tract 5067.03, Santa Clara County, California",0,0,0
1000000US060855067031018,060855067031018,"Block 1018, Block Group 1, Census Tract 5067.03, Santa Clara County, California",56,55,1
1000000US060855067032000,060855067032000,"Block 2000, Block Group 2, Census Tract 5067.03, Santa Clara County, California",43,43,0
1000000US060855067032001,060855067032001,"Block 2001, Block Group 2, Census Tract 5067.03, Santa Clara County, California",0,0,0
1000000US060855067032002,060855067032002,"Block 2002, Block Group 2, Census Tract 5067.03, Santa Clara County, California",57,53,4
1000000US060855067032003,060855067032003,"Block 2003, Block Group 2, Census Tract 5067.03, Santa Clara County, California",34,33,1
1000000US060855067032004,060855067032004,"Block 2004, Block Group 2, Census Tract 5067.03, Santa Clara County, California",29,28,1
1000000US060855067032005,060855067032005,"Block 2005, Block Group 2, Census Tract 5067.03, Santa Clara County, California",158,154,4
1000000US060855067032006,060855067032006,"Block 2006, Block Group 2, Census Tract 5067.03, Santa Clara County, California",33,32,1
1000000US060855067032007,060855067032007,"Block 2007, Block Group 2, Census Tract 5067.03, Santa Clara County, California",56,53,3
1000000US060855067032008,060855067032008,"Block 2008, Block Group 2, Census Tract 5067.03, Santa Clara County, California",12,11,1
1000000US060855067033000,060855067033000,"Block 3000, Block Group 3, Census Tract 5067.03, Santa Clara County, California",219,213,6
1000000US060855067033001,060855067033001,"Block 3001, Block Group 3, Census Tract 5067.03, Santa Clara County, California",19,19,0
1000000US060855067033002,060855067033002,"Block 3002, Block Group 3, Census Tract 5067.03, Santa Clara County, California",1,1,0
1000000US060855067033003,060855067033003,"Block 3003, Block Group 3, Census Tract 5067.03, Santa Clara County, California",23,23,0
1000000US060855067033004,060855067033004,"Block 3004, Block Group 3, Census Tract 5067.03, Santa Clara County, California",84,79,5
1000000US060855067033005,060855067033005,"Block 3005, Block Group 3, Census Tract 5067.03, Santa Clara County, California",40,37,3
1000000US060855067033006,060855067033006,"Block 3006, Block Group 3, Census Tract 5067.03, Santa Clara County, California",0,0,0
1000000US060855067033007,060855067033007,"Block 3007, Block Group 3, Census Tract 5067.03, Santa Clara County, California",0,0,0
1000000US060855067033008,060855067033008,"Block 3008, Block Group 3, Census Tract 5067.03, Santa Clara County, California",0,0,0
1000000US060855067033009,060855067033009,"Block 3009, Block Group 3, Census Tract 5067.03, Santa Clara County, California",0,0,0
1000000US060855067033010,060855067033010,"Block 3010, Block Group 3, Census Tract 5067.03, Santa Clara County, California",0,0,0
1000000US060855067033011,060855067033011,"Block 3011, Block Group 3, Census Tract 5067.03, Santa Clara County, California",0,0,0
1000000US060855067033012,060855067033012,"Block 3012, Block Group 3, Census Tract 5067.03, Santa Clara County, California",0,0,0
1000000US060855068011000,060855068011000,"Block 1000, Block Group 1, Census Tract 5068.01, Santa Clara County, California",0,0,0
1000000US060855068011001,060855068011001,"Block 1001, Block Group 1, Census Tract 5068.01, Santa Clara County, California",0,0,0
1000000US060855068011002,060855068011002,"Block 1002, Block Group 1, Census Tract 5068.01, Santa Clara County, California",0,0,0
1000000US060855068011003,060855068011003,"Block 1003, Block Group 1, Census Tract 5068.01, Santa Clara County, California",0,0,0
1000000US060855068011004,060855068011004,"Block 1004, Block Group 1, Census Tract 5068.01, Santa Clara County, California",59,58,1
1000000US060855068011005,060855068011005,"Block 1005, Block Group 1, Census Tract 5068.01, Santa Clara County, California",18,18,0
1000000US060855068011006,060855068011006,"Block 1006, Block Group 1, Census Tract 5068.01, Santa Clara County, California",25,25,0
1000000US060855068011007,060855068011007,"Block 1007, Block Group 1, Census Tract 5068.01, Santa Clara County, California",14,14,0
1000000US060855068011008,060855068011008,"Block 1008, Block Group 1, Census Tract 5068.01, Santa Clara County, California",0,0,0
1000000US060855068011009,060855068011009,"Block 1009, Block Group 1, Census Tract 5068.01, Santa Clara County, California",39,38,1
1000000US060855068011010,060855068011010,"Block 1010, Block Group 1, Census Tract 5068.01, Santa Clara County, California",1,1,0
1000000US060855068011011,060855068011011,"Block 1011, Block Group 1, Census Tract 5068.01, Santa Clara County, California",21,21,0
1000000US060855068011012,060855068011012,"Block 1012, Block Group 1, Census Tract 5068.01, Santa Clara County, California",0,0,0
1000000US060855068011013,060855068011013,"Block 1013, Block Group 1, Census Tract 5068.01, Santa Clara County, California",3,3,0
1000000US060855068011014,060855068011014,"Block 1014, Block Group 1, Census Tract 5068.01, Santa Clara County, California",0,0,0
1000000US060855068011015,060855068011015,"Block 1015, Block Group 1, Census Tract 5068.01, Santa Clara County, California",0,0,0
1000000US060855068011016,060855068011016,"Block 1016, Block Group 1, Census Tract 5068.01, Santa Clara County, California",0,0,0
1000000US060855068011017,060855068011017,"Block 1017, Block Group 1, Census Tract 5068.01, Santa Clara County, California",8,8,0
1000000US060855068011018,060855068011018,"Block 1018, Block Group 1, Census Tract 5068.01, Santa Clara County, California",2,2,0
1000000US060855068011019,060855068011019,"Block 1019, Block Group 1, Census Tract 5068.01, Santa Clara County, California",0,0,0
1000000US060855068011020,060855068011020,"Block 1020, Block Group 1, Census Tract 5068.01, Santa Clara County, California",0,0,0
1000000US060855068011021,060855068011021,"Block 1021, Block Group 1, Census Tract 5068.01, Santa Clara County, California",22,22,0
1000000US060855068011022,060855068011022,"Block 1022, Block Group 1, Census Tract 5068.01, Santa Clara County, California",12,12,0
1000000US060855068011023,060855068011023,"Block 1023, Block Group 1, Census Tract 5068.01, Santa Clara County, California",295,288,7
1000000US060855068011024,060855068011024,"Block 1024, Block Group 1, Census Tract 5068.01, Santa Clara County, California",28,28,0
1000000US060855068011025,060855068011025,"Block 1025, Block Group 1, Census Tract 5068.01, Santa Clara County, California",17,14,3
1000000US060855068011026,060855068011026,"Block 1026, Block Group 1, Census Tract 5068.01, Santa Clara County, California",53,51,2
1000000US060855068011027,060855068011027,"Block 1027, Block Group 1, Census Tract 5068.01, Santa Clara County, California",0,0,0
1000000US060855068011028,060855068011028,"Block 1028, Block Group 1, Census Tract 5068.01, Santa Clara County, California",52,49,3
1000000US060855068011029,060855068011029,"Block 1029, Block Group 1, Census Tract 5068.01, Santa Clara County, California",0,0,0
1000000US060855068011030,060855068011030,"Block 1030, Block Group 1, Census Tract 5068.01, Santa Clara County, California",24,24,0
1000000US060855068011031,060855068011031,"Block 1031, Block Group 1, Census Tract 5068.01, Santa Clara County, California",33,33,0
1000000US060855068011032,060855068011032,"Block 1032, Block Group 1, Census Tract 5068.01, Santa Clara County, California",3,3,0
1000000US060855068011033,060855068011033,"Block 1033, Block Group 1, Census Tract 5068.01, Santa Clara County, California",0,0,0
1000000US060855068011034,060855068011034,"Block 1034, Block Group 1, Census Tract 5068.01, Santa Clara County, California",0,0,0
1000000US060855068011035,060855068011035,"Block 1035, Block Group 1, Census Tract 5068.01, Santa Clara County, California",8,7,1
1000000US060855068011036,060855068011036,"Block 1036, Block Group 1, Census Tract 5068.01, Santa Clara County, California",0,0,0
1000000US060855068011037,060855068011037,"Block 1037, Block Group 1, Census Tract 5068.01, Santa Clara County, California",0,0,0
1000000US060855068011038,060855068011038,"Block 1038, Block Group 1, Census Tract 5068.01, Santa Clara County, California",20,20,0
1000000US060855068011039,060855068011039,"Block 1039, Block Group 1, Census Tract 5068.01, Santa Clara County, California",28,28,0
1000000US060855068012000,060855068012000,"Block 2000, Block Group 2, Census Tract 5068.01, Santa Clara County, California",0,0,0
1000000US060855068012001,060855068012001,"Block 2001, Block Group 2, Census Tract 5068.01, Santa Clara County, California",0,0,0
1000000US060855068012002,060855068012002,"Block 2002, Block Group 2, Census Tract 5068.01, Santa Clara County, California",0,0,0
1000000US060855068012003,060855068012003,"Block 2003, Block Group 2, Census Tract 5068.01, Santa Clara County, California",0,0,0
1000000US060855068012004,060855068012004,"Block 2004, Block Group 2, Census Tract 5068.01, Santa Clara County, California",0,0,0
1000000US060855068012005,060855068012005,"Block 2005, Block Group 2, Census Tract 5068.01, Santa Clara County, California",0,0,0
1000000US060855068012006,060855068012006,"Block 2006, Block Group 2, Census Tract 5068.01, Santa Clara County, California",0,0,0
1000000US060855068012007,060855068012007,"Block 2007, Block Group 2, Census Tract 5068.01, Santa Clara County, California",0,0,0
1000000US060855068012008,060855068012008,"Block 2008, Block Group 2, Census Tract 5068.01, Santa Clara County, California",16,14,2
1000000US060855068012009,060855068012009,"Block 2009, Block Group 2, Census Tract 5068.01, Santa Clara County, California",0,0,0
1000000US060855068012010,060855068012010,"Block 2010, Block Group 2, Census Tract 5068.01, Santa Clara County, California",23,21,2
1000000US060855068012011,060855068012011,"Block 2011, Block Group 2, Census Tract 5068.01, Santa Clara County, California",1,1,0
1000000US060855068012012,060855068012012,"Block 2012, Block Group 2, Census Tract 5068.01, Santa Clara County, California",9,9,0
1000000US060855068012013,060855068012013,"Block 2013, Block Group 2, Census Tract 5068.01, Santa Clara County, California",41,38,3
1000000US060855068012014,060855068012014,"Block 2014, Block Group 2, Census Tract 5068.01, Santa Clara County, California",0,0,0
1000000US060855068012015,060855068012015,"Block 2015, Block Group 2, Census Tract 5068.01, Santa Clara County, California",0,0,0
1000000US060855068012016,060855068012016,"Block 2016, Block Group 2, Census Tract 5068.01, Santa Clara County, California",0,0,0
1000000US060855068012017,060855068012017,"Block 2017, Block Group 2, Census Tract 5068.01, Santa Clara County, California",27,25,2
1000000US060855068012018,060855068012018,"Block 2018, Block Group 2, Census Tract 5068.01, Santa Clara County, California",9,9,0
1000000US060855068012019,060855068012019,"Block 2019, Block Group 2, Census Tract 5068.01, Santa Clara County, California",55,55,0
1000000US060855068012020,060855068012020,"Block 2020, Block Group 2, Census Tract 5068.01, Santa Clara County, California",30,29,1
1000000US060855068012021,060855068012021,"Block 2021, Block Group 2, Census Tract 5068.01, Santa Clara County, California",35,32,3
1000000US060855068012022,060855068012022,"Block 2022, Block Group 2, Census Tract 5068.01, Santa Clara County, California",0,0,0
1000000US060855068012023,060855068012023,"Block 2023, Block Group 2, Census Tract 5068.01, Santa Clara County, California",0,0,0
1000000US060855068012024,060855068012024,"Block 2024, Block Group 2, Census Tract 5068.01, Santa Clara County, California",0,0,0
1000000US060855068012025,060855068012025,"Block 2025, Block Group 2, Census Tract 5068.01, Santa Clara County, California",0,0,0
1000000US060855068012026,060855068012026,"Block 2026, Block Group 2, Census Tract 5068.01, Santa Clara County, California",0,0,0
1000000US060855068012027,060855068012027,"Block 2027, Block Group 2, Census Tract 5068.01, Santa Clara County, California",49,47,2
1000000US060855068012028,060855068012028,"Block 2028, Block Group 2, Census Tract 5068.01, Santa Clara County, California",18,18,0
1000000US060855068012029,060855068012029,"Block 2029, Block Group 2, Census Tract 5068.01, Santa Clara County, California",12,12,0
1000000US060855068012030,060855068012030,"Block 2030, Block Group 2, Census Tract 5068.01, Santa Clara County, California",13,12,1
1000000US060855068012031,060855068012031,"Block 2031, Block Group 2, Census Tract 5068.01, Santa Clara County, California",26,26,0
1000000US060855068012032,060855068012032,"Block 2032, Block Group 2, Census Tract 5068.01, Santa Clara County, California",0,0,0
1000000US060855068012033,060855068012033,"Block 2033, Block Group 2, Census Tract 5068.01, Santa Clara County, California",72,69,3
1000000US060855068012034,060855068012034,"Block 2034, Block Group 2, Census Tract 5068.01, Santa Clara County, California",15,15,0
1000000US060855068012035,060855068012035,"Block 2035, Block Group 2, Census Tract 5068.01, Santa Clara County, California",20,20,0
1000000US060855068012036,060855068012036,"Block 2036, Block Group 2, Census Tract 5068.01, Santa Clara County, California",137,129,8
1000000US060855068012037,060855068012037,"Block 2037, Block Group 2, Census Tract 5068.01, Santa Clara County, California",24,24,0
1000000US060855068012038,060855068012038,"Block 2038, Block Group 2, Census Tract 5068.01, Santa Clara County, California",51,51,0
1000000US060855068012039,060855068012039,"Block 2039, Block Group 2, Census Tract 5068.01, Santa Clara County, California",0,0,0
1000000US060855068012040,060855068012040,"Block 2040, Block Group 2, Census Tract 5068.01, Santa Clara County, California",0,0,0
1000000US060855068012041,060855068012041,"Block 2041, Block Group 2, Census Tract 5068.01, Santa Clara County, California",0,0,0
1000000US060855068012042,060855068012042,"Block 2042, Block Group 2, Census Tract 5068.01, Santa Clara County, California",0,0,0
1000000US060855068012043,060855068012043,"Block 2043, Block Group 2, Census Tract 5068.01, Santa Clara County, California",0,0,0
1000000US060855068012044,060855068012044,"Block 2044, Block Group 2, Census Tract 5068.01, Santa Clara County, California",10,9,1
1000000US060855068012045,060855068012045,"Block 2045, Block Group 2, Census Tract 5068.01, Santa Clara County, California",0,0,0
1000000US060855068013000,060855068013000,"Block 3000, Block Group 3, Census Tract 5068.01, Santa Clara County, California",0,0,0
1000000US060855068013001,060855068013001,"Block 3001, Block Group 3, Census Tract 5068.01, Santa Clara County, California",25,25,0
1000000US060855068013002,060855068013002,"Block 3002, Block Group 3, Census Tract 5068.01, Santa Clara County, California",0,0,0
1000000US060855068013003,060855068013003,"Block 3003, Block Group 3, Census Tract 5068.01, Santa Clara County, California",16,16,0
1000000US060855068013004,060855068013004,"Block 3004, Block Group 3, Census Tract 5068.01, Santa Clara County, California",22,22,0
1000000US060855068013005,060855068013005,"Block 3005, Block Group 3, Census Tract 5068.01, Santa Clara County, California",2,2,0
1000000US060855068013006,060855068013006,"Block 3006, Block Group 3, Census Tract 5068.01, Santa Clara County, California",0,0,0
1000000US060855068013007,060855068013007,"Block 3007, Block Group 3, Census Tract 5068.01, Santa Clara County, California",0,0,0
1000000US060855068013008,060855068013008,"Block 3008, Block Group 3, Census Tract 5068.01, Santa Clara County, California",21,21,0
1000000US060855068013009,060855068013009,"Block 3009, Block Group 3, Census Tract 5068.01, Santa Clara County, California",19,18,1
1000000US060855068013010,060855068013010,"Block 3010, Block Group 3, Census Tract 5068.01, Santa Clara County, California",13,13,0
1000000US060855068013011,060855068013011,"Block 3011, Block Group 3, Census Tract 5068.01, Santa Clara County, California",23,23,0
1000000US060855068013012,060855068013012,"Block 3012, Block Group 3, Census Tract 5068.01, Santa Clara County, California",46,46,0
1000000US060855068013013,060855068013013,"Block 3013, Block Group 3, Census Tract 5068.01, Santa Clara County, California",22,21,1
1000000US060855068013014,060855068013014,"Block 3014, Block Group 3, Census Tract 5068.01, Santa Clara County, California",22,22,0
1000000US060855068013015,060855068013015,"Block 3015, Block Group 3, Census Tract 5068.01, Santa Clara County, California",7,7,0
1000000US060855068013016,060855068013016,"Block 3016, Block Group 3, Census Tract 5068.01, Santa Clara County, California",14,14,0
1000000US060855068013017,060855068013017,"Block 3017, Block Group 3, Census Tract 5068.01, Santa Clara County, California",0,0,0
1000000US060855068013018,060855068013018,"Block 3018, Block Group 3, Census Tract 5068.01, Santa Clara County, California",19,19,0
1000000US060855068013019,060855068013019,"Block 3019, Block Group 3, Census Tract 5068.01, Santa Clara County, California",22,21,1
1000000US060855068013020,060855068013020,"Block 3020, Block Group 3, Census Tract 5068.01, Santa Clara County, California",22,22,0
1000000US060855068013021,060855068013021,"Block 3021, Block Group 3, Census Tract 5068.01, Santa Clara County, California",22,22,0
1000000US060855068013022,060855068013022,"Block 3022, Block Group 3, Census Tract 5068.01, Santa Clara County, California",11,11,0
1000000US060855068013023,060855068013023,"Block 3023, Block Group 3, Census Tract 5068.01, Santa Clara County, California",22,22,0
1000000US060855068013024,060855068013024,"Block 3024, Block Group 3, Census Tract 5068.01, Santa Clara County, California",22,22,0
1000000US060855068013025,060855068013025,"Block 3025, Block Group 3, Census Tract 5068.01, Santa Clara County, California",6,6,0
1000000US060855068013026,060855068013026,"Block 3026, Block Group 3, Census Tract 5068.01, Santa Clara County, California",12,12,0
1000000US060855068013027,060855068013027,"Block 3027, Block Group 3, Census Tract 5068.01, Santa Clara County, California",14,14,0
1000000US060855068013028,060855068013028,"Block 3028, Block Group 3, Census Tract 5068.01, Santa Clara County, California",5,5,0
1000000US060855068013029,060855068013029,"Block 3029, Block Group 3, Census Tract 5068.01, Santa Clara County, California",4,4,0
1000000US060855068013030,060855068013030,"Block 3030, Block Group 3, Census Tract 5068.01, Santa Clara County, California",1,1,0
1000000US060855068013031,060855068013031,"Block 3031, Block Group 3, Census Tract 5068.01, Santa Clara County, California",24,23,1
1000000US060855068013032,060855068013032,"Block 3032, Block Group 3, Census Tract 5068.01, Santa Clara County, California",19,19,0
1000000US060855068013033,060855068013033,"Block 3033, Block Group 3, Census Tract 5068.01, Santa Clara County, California",17,15,2
1000000US060855068013034,060855068013034,"Block 3034, Block Group 3, Census Tract 5068.01, Santa Clara County, California",28,28,0
1000000US060855068013035,060855068013035,"Block 3035, Block Group 3, Census Tract 5068.01, Santa Clara County, California",21,21,0
1000000US060855068013036,060855068013036,"Block 3036, Block Group 3, Census Tract 5068.01, Santa Clara County, California",6,6,0
1000000US060855068013037,060855068013037,"Block 3037, Block Group 3, Census Tract 5068.01, Santa Clara County, California",0,0,0
1000000US060855068013038,060855068013038,"Block 3038, Block Group 3, Census Tract 5068.01, Santa Clara County, California",0,0,0
1000000US060855068013039,060855068013039,"Block 3039, Block Group 3, Census Tract 5068.01, Santa Clara County, California",2,2,0
1000000US060855068014000,060855068014000,"Block 4000, Block Group 4, Census Tract 5068.01, Santa Clara County, California",60,59,1
1000000US060855068014001,060855068014001,"Block 4001, Block Group 4, Census Tract 5068.01, Santa Clara County, California",0,0,0
1000000US060855068014002,060855068014002,"Block 4002, Block Group 4, Census Tract 5068.01, Santa Clara County, California",7,7,0
1000000US060855068014003,060855068014003,"Block 4003, Block Group 4, Census Tract 5068.01, Santa Clara County, California",38,37,1
1000000US060855068014004,060855068014004,"Block 4004, Block Group 4, Census Tract 5068.01, Santa Clara County, California",20,19,1
1000000US060855068014005,060855068014005,"Block 4005, Block Group 4, Census Tract 5068.01, Santa Clara County, California",17,16,1
1000000US060855068014006,060855068014006,"Block 4006, Block Group 4, Census Tract 5068.01, Santa Clara County, California",11,10,1
1000000US060855068014007,060855068014007,"Block 4007, Block Group 4, Census Tract 5068.01, Santa Clara County, California",42,40,2
1000000US060855068014008,060855068014008,"Block 4008, Block Group 4, Census Tract 5068.01, Santa Clara County, California",35,34,1
1000000US060855068014009,060855068014009,"Block 4009, Block Group 4, Census Tract 5068.01, Santa Clara County, California",2,2,0
1000000US060855068014010,060855068014010,"Block 4010, Block Group 4, Census Tract 5068.01, Santa Clara County, California",2,1,1
1000000US060855068014011,060855068014011,"Block 4011, Block Group 4, Census Tract 5068.01, Santa Clara County, California",14,13,1
1000000US060855068014012,060855068014012,"Block 4012, Block Group 4, Census Tract 5068.01, Santa Clara County, California",1,1,0
1000000US060855068014013,060855068014013,"Block 4013, Block Group 4, Census Tract 5068.01, Santa Clara County, California",5,5,0
1000000US060855068014014,060855068014014,"Block 4014, Block Group 4, Census Tract 5068.01, Santa Clara County, California",3,3,0
1000000US060855068014015,060855068014015,"Block 4015, Block Group 4, Census Tract 5068.01, Santa Clara County, California",10,9,1
1000000US060855068014016,060855068014016,"Block 4016, Block Group 4, Census Tract 5068.01, Santa Clara County, California",2,2,0
1000000US060855068014017,060855068014017,"Block 4017, Block Group 4, Census Tract 5068.01, Santa Clara County, California",6,6,0
1000000US060855068014018,060855068014018,"Block 4018, Block Group 4, Census Tract 5068.01, Santa Clara County, California",5,4,1
1000000US060855068014019,060855068014019,"Block 4019, Block Group 4, Census Tract 5068.01, Santa Clara County, California",0,0,0
1000000US060855068014020,060855068014020,"Block 4020, Block Group 4, Census Tract 5068.01, Santa Clara County, California",0,0,0
1000000US060855068014021,060855068014021,"Block 4021, Block Group 4, Census Tract 5068.01, Santa Clara County, California",2,2,0
1000000US060855068021000,060855068021000,"Block 1000, Block Group 1, Census Tract 5068.02, Santa Clara County, California",26,25,1
1000000US060855068021001,060855068021001,"Block 1001, Block Group 1, Census Tract 5068.02, Santa Clara County, California",45,45,0
1000000US060855068021002,060855068021002,"Block 1002, Block Group 1, Census Tract 5068.02, Santa Clara County, California",0,0,0
1000000US060855068021003,060855068021003,"Block 1003, Block Group 1, Census Tract 5068.02, Santa Clara County, California",28,28,0
1000000US060855068021004,060855068021004,"Block 1004, Block Group 1, Census Tract 5068.02, Santa Clara County, California",22,22,0
1000000US060855068021005,060855068021005,"Block 1005, Block Group 1, Census Tract 5068.02, Santa Clara County, California",22,22,0
1000000US060855068021006,060855068021006,"Block 1006, Block Group 1, Census Tract 5068.02, Santa Clara County, California",22,22,0
1000000US060855068021007,060855068021007,"Block 1007, Block Group 1, Census Tract 5068.02, Santa Clara County, California",25,25,0
1000000US060855068021008,060855068021008,"Block 1008, Block Group 1, Census Tract 5068.02, Santa Clara County, California",47,46,1
1000000US060855068021009,060855068021009,"Block 1009, Block Group 1, Census Tract 5068.02, Santa Clara County, California",18,18,0
1000000US060855068021010,060855068021010,"Block 1010, Block Group 1, Census Tract 5068.02, Santa Clara County, California",28,25,3
1000000US060855068021011,060855068021011,"Block 1011, Block Group 1, Census Tract 5068.02, Santa Clara County, California",46,44,2
1000000US060855068021012,060855068021012,"Block 1012, Block Group 1, Census Tract 5068.02, Santa Clara County, California",5,5,0
1000000US060855068021013,060855068021013,"Block 1013, Block Group 1, Census Tract 5068.02, Santa Clara County, California",14,14,0
1000000US060855068021014,060855068021014,"Block 1014, Block Group 1, Census Tract 5068.02, Santa Clara County, California",0,0,0
1000000US060855068021015,060855068021015,"Block 1015, Block Group 1, Census Tract 5068.02, Santa Clara County, California",74,72,2
1000000US060855068021016,060855068021016,"Block 1016, Block Group 1, Census Tract 5068.02, Santa Clara County, California",28,25,3
1000000US060855068021017,060855068021017,"Block 1017, Block Group 1, Census Tract 5068.02, Santa Clara County, California",14,14,0
1000000US060855068021018,060855068021018,"Block 1018, Block Group 1, Census Tract 5068.02, Santa Clara County, California",11,10,1
1000000US060855068021019,060855068021019,"Block 1019, Block Group 1, Census Tract 5068.02, Santa Clara County, California",29,27,2
1000000US060855068021020,060855068021020,"Block 1020, Block Group 1, Census Tract 5068.02, Santa Clara County, California",8,8,0
1000000US060855068021021,060855068021021,"Block 1021, Block Group 1, Census Tract 5068.02, Santa Clara County, California",10,10,0
1000000US060855068021022,060855068021022,"Block 1022, Block Group 1, Census Tract 5068.02, Santa Clara County, California",1,1,0
1000000US060855068021023,060855068021023,"Block 1023, Block Group 1, Census Tract 5068.02, Santa Clara County, California",0,0,0
1000000US060855068021024,060855068021024,"Block 1024, Block Group 1, Census Tract 5068.02, Santa Clara County, California",0,0,0
1000000US060855068021025,060855068021025,"Block 1025, Block Group 1, Census Tract 5068.02, Santa Clara County, California",0,0,0
1000000US060855068021026,060855068021026,"Block 1026, Block Group 1, Census Tract 5068.02, Santa Clara County, California",30,30,0
1000000US060855068022000,060855068022000,"Block 2000, Block Group 2, Census Tract 5068.02, Santa Clara County, California",8,7,1
1000000US060855068022001,060855068022001,"Block 2001, Block Group 2, Census Tract 5068.02, Santa Clara County, California",99,98,1
1000000US060855068022002,060855068022002,"Block 2002, Block Group 2, Census Tract 5068.02, Santa Clara County, California",20,20,0
1000000US060855068022003,060855068022003,"Block 2003, Block Group 2, Census Tract 5068.02, Santa Clara County, California",21,19,2
1000000US060855068022004,060855068022004,"Block 2004, Block Group 2, Census Tract 5068.02, Santa Clara County, California",12,12,0
1000000US060855068022005,060855068022005,"Block 2005, Block Group 2, Census Tract 5068.02, Santa Clara County, California",11,11,0
1000000US060855068022006,060855068022006,"Block 2006, Block Group 2, Census Tract 5068.02, Santa Clara County, California",19,19,0
1000000US060855068022007,060855068022007,"Block 2007, Block Group 2, Census Tract 5068.02, Santa Clara County, California",44,44,0
1000000US060855068022008,060855068022008,"Block 2008, Block Group 2, Census Tract 5068.02, Santa Clara County, California",21,21,0
1000000US060855068022009,060855068022009,"Block 2009, Block Group 2, Census Tract 5068.02, Santa Clara County, California",17,17,0
1000000US060855068022010,060855068022010,"Block 2010, Block Group 2, Census Tract 5068.02, Santa Clara County, California",93,91,2
1000000US060855068022011,060855068022011,"Block 2011, Block Group 2, Census Tract 5068.02, Santa Clara County, California",8,8,0
1000000US060855068022012,060855068022012,"Block 2012, Block Group 2, Census Tract 5068.02, Santa Clara County, California",14,14,0
1000000US060855068022013,060855068022013,"Block 2013, Block Group 2, Census Tract 5068.02, Santa Clara County, California",32,31,1
1000000US060855068023000,060855068023000,"Block 3000, Block Group 3, Census Tract 5068.02, Santa Clara County, California",29,29,0
1000000US060855068023001,060855068023001,"Block 3001, Block Group 3, Census Tract 5068.02, Santa Clara County, California",32,30,2
1000000US060855068023002,060855068023002,"Block 3002, Block Group 3, Census Tract 5068.02, Santa Clara County, California",26,26,0
1000000US060855068023003,060855068023003,"Block 3003, Block Group 3, Census Tract 5068.02, Santa Clara County, California",40,39,1
1000000US060855068023004,060855068023004,"Block 3004, Block Group 3, Census Tract 5068.02, Santa Clara County, California",30,29,1
1000000US060855068023005,060855068023005,"Block 3005, Block Group 3, Census Tract 5068.02, Santa Clara County, California",31,31,0
1000000US060855068023006,060855068023006,"Block 3006, Block Group 3, Census Tract 5068.02, Santa Clara County, California",59,59,0
1000000US060855068023007,060855068023007,"Block 3007, Block Group 3, Census Tract 5068.02, Santa Clara County, California",0,0,0
1000000US060855068023008,060855068023008,"Block 3008, Block Group 3, Census Tract 5068.02, Santa Clara County, California",58,58,0
1000000US060855068024000,060855068024000,"Block 4000, Block Group 4, Census Tract 5068.02, Santa Clara County, California",11,11,0
1000000US060855068024001,060855068024001,"Block 4001, Block Group 4, Census Tract 5068.02, Santa Clara County, California",0,0,0
1000000US060855068024002,060855068024002,"Block 4002, Block Group 4, Census Tract 5068.02, Santa Clara County, California",2,2,0
1000000US060855068024003,060855068024003,"Block 4003, Block Group 4, Census Tract 5068.02, Santa Clara County, California",19,18,1
1000000US060855068024004,060855068024004,"Block 4004, Block Group 4, Census Tract 5068.02, Santa Clara County, California",147,141,6
1000000US060855068024005,060855068024005,"Block 4005, Block Group 4, Census Tract 5068.02, Santa Clara County, California",22,22,0
1000000US060855068024006,060855068024006,"Block 4006, Block Group 4, Census Tract 5068.02, Santa Clara County, California",25,25,0
1000000US060855068024007,060855068024007,"Block 4007, Block Group 4, Census Tract 5068.02, Santa Clara County, California",15,15,0
1000000US060855068024008,060855068024008,"Block 4008, Block Group 4, Census Tract 5068.02, Santa Clara County, California",16,16,0
1000000US060855068024009,060855068024009,"Block 4009, Block Group 4, Census Tract 5068.02, Santa Clara County, California",24,24,0
1000000US060855068025000,060855068025000,"Block 5000, Block Group 5, Census Tract 5068.02, Santa Clara County, California",79,77,2
1000000US060855068025001,060855068025001,"Block 5001, Block Group 5, Census Tract 5068.02, Santa Clara County, California",28,27,1
1000000US060855068025002,060855068025002,"Block 5002, Block Group 5, Census Tract 5068.02, Santa Clara County, California",24,24,0
1000000US060855068025003,060855068025003,"Block 5003, Block Group 5, Census Tract 5068.02, Santa Clara County, California",20,19,1
1000000US060855068025004,060855068025004,"Block 5004, Block Group 5, Census Tract 5068.02, Santa Clara County, California",23,23,0
1000000US060855068025005,060855068025005,"Block 5005, Block Group 5, Census Tract 5068.02, Santa Clara County, California",17,17,0
1000000US060855068025006,060855068025006,"Block 5006, Block Group 5, Census Tract 5068.02, Santa Clara County, California",47,44,3
1000000US060855068025007,060855068025007,"Block 5007, Block Group 5, Census Tract 5068.02, Santa Clara County, California",16,15,1
1000000US060855068025008,060855068025008,"Block 5008, Block Group 5, Census Tract 5068.02, Santa Clara County, California",19,18,1
1000000US060855068025009,060855068025009,"Block 5009, Block Group 5, Census Tract 5068.02, Santa Clara County, California",32,31,1
1000000US060855068025010,060855068025010,"Block 5010, Block Group 5, Census Tract 5068.02, Santa Clara County, California",0,0,0
1000000US060855068025011,060855068025011,"Block 5011, Block Group 5, Census Tract 5068.02, Santa Clara County, California",40,40,0
1000000US060855068025012,060855068025012,"Block 5012, Block Group 5, Census Tract 5068.02, Santa Clara County, California",22,22,0
1000000US060855068025013,060855068025013,"Block 5013, Block Group 5, Census Tract 5068.02, Santa Clara County, California",22,21,1
1000000US060855068031000,060855068031000,"Block 1000, Block Group 1, Census Tract 5068.03, Santa Clara County, California",0,0,0
1000000US060855068031001,060855068031001,"Block 1001, Block Group 1, Census Tract 5068.03, Santa Clara County, California",44,42,2
1000000US060855068031002,060855068031002,"Block 1002, Block Group 1, Census Tract 5068.03, Santa Clara County, California",63,62,1
1000000US060855068031003,060855068031003,"Block 1003, Block Group 1, Census Tract 5068.03, Santa Clara County, California",21,21,0
1000000US060855068031004,060855068031004,"Block 1004, Block Group 1, Census Tract 5068.03, Santa Clara County, California",23,22,1
1000000US060855068031005,060855068031005,"Block 1005, Block Group 1, Census Tract 5068.03, Santa Clara County, California",36,36,0
1000000US060855068031006,060855068031006,"Block 1006, Block Group 1, Census Tract 5068.03, Santa Clara County, California",24,24,0
1000000US060855068031007,060855068031007,"Block 1007, Block Group 1, Census Tract 5068.03, Santa Clara County, California",47,46,1
1000000US060855068031008,060855068031008,"Block 1008, Block Group 1, Census Tract 5068.03, Santa Clara County, California",54,54,0
1000000US060855068031009,060855068031009,"Block 1009, Block Group 1, Census Tract 5068.03, Santa Clara County, California",39,38,1
1000000US060855068031010,060855068031010,"Block 1010, Block Group 1, Census Tract 5068.03, Santa Clara County, California",24,24,0
1000000US060855068031011,060855068031011,"Block 1011, Block Group 1, Census Tract 5068.03, Santa Clara County, California",48,47,1
1000000US060855068031012,060855068031012,"Block 1012, Block Group 1, Census Tract 5068.03, Santa Clara County, California",40,39,1
1000000US060855068031013,060855068031013,"Block 1013, Block Group 1, Census Tract 5068.03, Santa Clara County, California",22,21,1
1000000US060855068031014,060855068031014,"Block 1014, Block Group 1, Census Tract 5068.03, Santa Clara County, California",23,23,0
1000000US060855068031015,060855068031015,"Block 1015, Block Group 1, Census Tract 5068.03, Santa Clara County, California",16,15,1
1000000US060855068031016,060855068031016,"Block 1016, Block Group 1, Census Tract 5068.03, Santa Clara County, California",16,16,0
1000000US060855068031017,060855068031017,"Block 1017, Block Group 1, Census Tract 5068.03, Santa Clara County, California",17,16,1
1000000US060855068031018,060855068031018,"Block 1018, Block Group 1, Census Tract 5068.03, Santa Clara County, California",33,31,2
1000000US060855068031019,060855068031019,"Block 1019, Block Group 1, Census Tract 5068.03, Santa Clara County, California",32,31,1
1000000US060855068032000,060855068032000,"Block 2000, Block Group 2, Census Tract 5068.03, Santa Clara County, California",38,38,0
1000000US060855068032001,060855068032001,"Block 2001, Block Group 2, Census Tract 5068.03, Santa Clara County, California",56,56,0
1000000US060855068032002,060855068032002,"Block 2002, Block Group 2, Census Tract 5068.03, Santa Clara County, California",45,45,0
1000000US060855068032003,060855068032003,"Block 2003, Block Group 2, Census Tract 5068.03, Santa Clara County, California",30,30,0
1000000US060855068032004,060855068032004,"Block 2004, Block Group 2, Census Tract 5068.03, Santa Clara County, California",30,30,0
1000000US060855068032005,060855068032005,"Block 2005, Block Group 2, Census Tract 5068.03, Santa Clara County, California",28,28,0
1000000US060855068032006,060855068032006,"Block 2006, Block Group 2, Census Tract 5068.03, Santa Clara County, California",49,49,0
1000000US060855068032007,060855068032007,"Block 2007, Block Group 2, Census Tract 5068.03, Santa Clara County, California",68,66,2
1000000US060855068032008,060855068032008,"Block 2008, Block Group 2, Census Tract 5068.03, Santa Clara County, California",69,69,0
1000000US060855068032009,060855068032009,"Block 2009, Block Group 2, Census Tract 5068.03, Santa Clara County, California",19,18,1
1000000US060855068032010,060855068032010,"Block 2010, Block Group 2, Census Tract 5068.03, Santa Clara County, California",19,18,1
1000000US060855068033000,060855068033000,"Block 3000, Block Group 3, Census Tract 5068.03, Santa Clara County, California",0,0,0
1000000US060855068033001,060855068033001,"Block 3001, Block Group 3, Census Tract 5068.03, Santa Clara County, California",0,0,0
1000000US060855068033002,060855068033002,"Block 3002, Block Group 3, Census Tract 5068.03, Santa Clara County, California",0,0,0
1000000US060855068033003,060855068033003,"Block 3003, Block Group 3, Census Tract 5068.03, Santa Clara County, California",11,10,1
1000000US060855068033004,060855068033004,"Block 3004, Block Group 3, Census Tract 5068.03, Santa Clara County, California",32,32,0
1000000US060855068033005,060855068033005,"Block 3005, Block Group 3, Census Tract 5068.03, Santa Clara County, California",0,0,0
1000000US060855068033006,060855068033006,"Block 3006, Block Group 3, Census Tract 5068.03, Santa Clara County, California",57,56,1
1000000US060855068033007,060855068033007,"Block 3007, Block Group 3, Census Tract 5068.03, Santa Clara County, California",32,31,1
1000000US060855068033008,060855068033008,"Block 3008, Block Group 3, Census Tract 5068.03, Santa Clara County, California",26,26,0
1000000US060855068033009,060855068033009,"Block 3009, Block Group 3, Census Tract 5068.03, Santa Clara County, California",26,25,1
1000000US060855068033010,060855068033010,"Block 3010, Block Group 3, Census Tract 5068.03, Santa Clara County, California",15,15,0
1000000US060855068033011,060855068033011,"Block 3011, Block Group 3, Census Tract 5068.03, Santa Clara County, California",20,20,0
1000000US060855068033012,060855068033012,"Block 3012, Block Group 3, Census Tract 5068.03, Santa Clara County, California",150,149,1
1000000US060855068033013,060855068033013,"Block 3013, Block Group 3, Census Tract 5068.03, Santa Clara County, California",22,22,0
1000000US060855068033014,060855068033014,"Block 3014, Block Group 3, Census Tract 5068.03, Santa Clara County, California",16,16,0
1000000US060855068033015,060855068033015,"Block 3015, Block Group 3, Census Tract 5068.03, Santa Clara County, California",23,23,0
1000000US060855068033016,060855068033016,"Block 3016, Block Group 3, Census Tract 5068.03, Santa Clara County, California",25,25,0
1000000US060855068033017,060855068033017,"Block 3017, Block Group 3, Census Tract 5068.03, Santa Clara County, California",53,49,4
1000000US060855068033018,060855068033018,"Block 3018, Block Group 3, Census Tract 5068.03, Santa Clara County, California",63,61,2
1000000US060855068033019,060855068033019,"Block 3019, Block Group 3, Census Tract 5068.03, Santa Clara County, California",376,342,34
1000000US060855068033020,060855068033020,"Block 3020, Block Group 3, Census Tract 5068.03, Santa Clara County, California",45,45,0
1000000US060855068034000,060855068034000,"Block 4000, Block Group 4, Census Tract 5068.03, Santa Clara County, California",34,32,2
1000000US060855068034001,060855068034001,"Block 4001, Block Group 4, Census Tract 5068.03, Santa Clara County, California",23,22,1
1000000US060855068034002,060855068034002,"Block 4002, Block Group 4, Census Tract 5068.03, Santa Clara County, California",36,36,0
1000000US060855068034003,060855068034003,"Block 4003, Block Group 4, Census Tract 5068.03, Santa Clara County, California",18,18,0
1000000US060855068034004,060855068034004,"Block 4004, Block Group 4, Census Tract 5068.03, Santa Clara County, California",19,18,1
1000000US060855068034005,060855068034005,"Block 4005, Block Group 4, Census Tract 5068.03, Santa Clara County, California",47,47,0
1000000US060855068034006,060855068034006,"Block 4006, Block Group 4, Census Tract 5068.03, Santa Clara County, California",20,20,0
1000000US060855068034007,060855068034007,"Block 4007, Block Group 4, Census Tract 5068.03, Santa Clara County, California",20,19,1
1000000US060855068034008,060855068034008,"Block 4008, Block Group 4, Census Tract 5068.03, Santa Clara County, California",36,36,0
1000000US060855068034009,060855068034009,"Block 4009, Block Group 4, Census Tract 5068.03, Santa Clara County, California",21,19,2
1000000US060855068034010,060855068034010,"Block 4010, Block Group 4, Census Tract 5068.03, Santa Clara County, California",92,85,7
1000000US060855068034011,060855068034011,"Block 4011, Block Group 4, Census Tract 5068.03, Santa Clara County, California",35,34,1
1000000US060855068041000,060855068041000,"Block 1000, Block Group 1, Census Tract 5068.04, Santa Clara County, California",22,22,0
1000000US060855068041001,060855068041001,"Block 1001, Block Group 1, Census Tract 5068.04, Santa Clara County, California",17,14,3
1000000US060855068041002,060855068041002,"Block 1002, Block Group 1, Census Tract 5068.04, Santa Clara County, California",60,58,2
1000000US060855068041003,060855068041003,"Block 1003, Block Group 1, Census Tract 5068.04, Santa Clara County, California",76,74,2
1000000US060855068041004,060855068041004,"Block 1004, Block Group 1, Census Tract 5068.04, Santa Clara County, California",0,0,0
1000000US060855068041005,060855068041005,"Block 1005, Block Group 1, Census Tract 5068.04, Santa Clara County, California",17,17,0
1000000US060855068041006,060855068041006,"Block 1006, Block Group 1, Census Tract 5068.04, Santa Clara County, California",24,23,1
1000000US060855068041007,060855068041007,"Block 1007, Block Group 1, Census Tract 5068.04, Santa Clara County, California",20,19,1
1000000US060855068041008,060855068041008,"Block 1008, Block Group 1, Census Tract 5068.04, Santa Clara County, California",33,32,1
1000000US060855068041009,060855068041009,"Block 1009, Block Group 1, Census Tract 5068.04, Santa Clara County, California",13,13,0
1000000US060855068041010,060855068041010,"Block 1010, Block Group 1, Census Tract 5068.04, Santa Clara County, California",7,7,0
1000000US060855068042000,060855068042000,"Block 2000, Block Group 2, Census Tract 5068.04, Santa Clara County, California",40,37,3
1000000US060855068042001,060855068042001,"Block 2001, Block Group 2, Census Tract 5068.04, Santa Clara County, California",18,18,0
1000000US060855068042002,060855068042002,"Block 2002, Block Group 2, Census Tract 5068.04, Santa Clara County, California",26,26,0
1000000US060855068042003,060855068042003,"Block 2003, Block Group 2, Census Tract 5068.04, Santa Clara County, California",23,23,0
1000000US060855068042004,060855068042004,"Block 2004, Block Group 2, Census Tract 5068.04, Santa Clara County, California",21,20,1
1000000US060855068042005,060855068042005,"Block 2005, Block Group 2, Census Tract 5068.04, Santa Clara County, California",24,23,1
1000000US060855068042006,060855068042006,"Block 2006, Block Group 2, Census Tract 5068.04, Santa Clara County, California",1,1,0
1000000US060855068042007,060855068042007,"Block 2007, Block Group 2, Census Tract 5068.04, Santa Clara County, California",7,6,1
1000000US060855068042008,060855068042008,"Block 2008, Block Group 2, Census Tract 5068.04, Santa Clara County, California",40,39,1
1000000US060855068042009,060855068042009,"Block 2009, Block Group 2, Census Tract 5068.04, Santa Clara County, California",18,17,1
1000000US060855068042010,060855068042010,"Block 2010, Block Group 2, Census Tract 5068.04, Santa Clara County, California",18,17,1
1000000US060855068042011,060855068042011,"Block 2011, Block Group 2, Census Tract 5068.04, Santa Clara County, California",16,16,0
1000000US060855068042012,060855068042012,"Block 2012, Block Group 2, Census Tract 5068.04, Santa Clara County, California",16,16,0
1000000US060855068042013,060855068042013,"Block 2013, Block Group 2, Census Tract 5068.04, Santa Clara County, California",16,16,0
1000000US060855068042014,060855068042014,"Block 2014, Block Group 2, Census Tract 5068.04, Santa Clara County, California",17,17,0
1000000US060855068042015,060855068042015,"Block 2015, Block Group 2, Census Tract 5068.04, Santa Clara County, California",32,32,0
1000000US060855068042016,060855068042016,"Block 2016, Block Group 2, Census Tract 5068.04, Santa Clara County, California",26,26,0
1000000US060855068042017,060855068042017,"Block 2017, Block Group 2, Census Tract 5068.04, Santa Clara County, California",13,13,0
1000000US060855068042018,060855068042018,"Block 2018, Block Group 2, Census Tract 5068.04, Santa Clara County, California",5,5,0
1000000US060855068042019,060855068042019,"Block 2019, Block Group 2, Census Tract 5068.04, Santa Clara County, California",10,10,0
1000000US060855068042020,060855068042020,"Block 2020, Block Group 2, Census Tract 5068.04, Santa Clara County, California",6,6,0
1000000US060855068042021,060855068042021,"Block 2021, Block Group 2, Census Tract 5068.04, Santa Clara County, California",13,12,1
1000000US060855068043000,060855068043000,"Block 3000, Block Group 3, Census Tract 5068.04, Santa Clara County, California",17,17,0
1000000US060855068043001,060855068043001,"Block 3001, Block Group 3, Census Tract 5068.04, Santa Clara County, California",17,17,0
1000000US060855068043002,060855068043002,"Block 3002, Block Group 3, Census Tract 5068.04, Santa Clara County, California",52,52,0
1000000US060855068043003,060855068043003,"Block 3003, Block Group 3, Census Tract 5068.04, Santa Clara County, California",15,15,0
1000000US060855068043004,060855068043004,"Block 3004, Block Group 3, Census Tract 5068.04, Santa Clara County, California",63,62,1
1000000US060855068043005,060855068043005,"Block 3005, Block Group 3, Census Tract 5068.04, Santa Clara County, California",3,3,0
1000000US060855068043006,060855068043006,"Block 3006, Block Group 3, Census Tract 5068.04, Santa Clara County, California",18,17,1
1000000US060855068043007,060855068043007,"Block 3007, Block Group 3, Census Tract 5068.04, Santa Clara County, California",40,39,1
1000000US060855068043008,060855068043008,"Block 3008, Block Group 3, Census Tract 5068.04, Santa Clara County, California",34,34,0
1000000US060855068043009,060855068043009,"Block 3009, Block Group 3, Census Tract 5068.04, Santa Clara County, California",34,34,0
1000000US060855068043010,060855068043010,"Block 3010, Block Group 3, Census Tract 5068.04, Santa Clara County, California",81,80,1
1000000US060855068043011,060855068043011,"Block 3011, Block Group 3, Census Tract 5068.04, Santa Clara County, California",26,25,1
1000000US060855068043012,060855068043012,"Block 3012, Block Group 3, Census Tract 5068.04, Santa Clara County, California",20,20,0
1000000US060855068043013,060855068043013,"Block 3013, Block Group 3, Census Tract 5068.04, Santa Clara County, California",3,3,0
1000000US060855068043014,060855068043014,"Block 3014, Block Group 3, Census Tract 5068.04, Santa Clara County, California",16,16,0
1000000US060855068044000,060855068044000,"Block 4000, Block Group 4, Census Tract 5068.04, Santa Clara County, California",16,16,0
1000000US060855068044001,060855068044001,"Block 4001, Block Group 4, Census Tract 5068.04, Santa Clara County, California",4,4,0
1000000US060855068044002,060855068044002,"Block 4002, Block Group 4, Census Tract 5068.04, Santa Clara County, California",27,26,1
1000000US060855068044003,060855068044003,"Block 4003, Block Group 4, Census Tract 5068.04, Santa Clara County, California",18,18,0
1000000US060855068044004,060855068044004,"Block 4004, Block Group 4, Census Tract 5068.04, Santa Clara County, California",44,44,0
1000000US060855068044005,060855068044005,"Block 4005, Block Group 4, Census Tract 5068.04, Santa Clara County, California",13,13,0
1000000US060855068044006,060855068044006,"Block 4006, Block Group 4, Census Tract 5068.04, Santa Clara County, California",14,14,0
1000000US060855068044007,060855068044007,"Block 4007, Block Group 4, Census Tract 5068.04, Santa Clara County, California",11,11,0
1000000US060855068044008,060855068044008,"Block 4008, Block Group 4, Census Tract 5068.04, Santa Clara County, California",23,23,0
1000000US060855068044009,060855068044009,"Block 4009, Block Group 4, Census Tract 5068.04, Santa Clara County, California",24,24,0
1000000US060855068044010,060855068044010,"Block 4010, Block Group 4, Census Tract 5068.04, Santa Clara County, California",24,24,0
1000000US060855068044011,060855068044011,"Block 4011, Block Group 4, Census Tract 5068.04, Santa Clara County, California",20,20,0
1000000US060855069001000,060855069001000,"Block 1000, Block Group 1, Census Tract 5069, Santa Clara County, California",64,62,2
1000000US060855069001001,060855069001001,"Block 1001, Block Group 1, Census Tract 5069, Santa Clara County, California",110,107,3
1000000US060855069001002,060855069001002,"Block 1002, Block Group 1, Census Tract 5069, Santa Clara County, California",25,23,2
1000000US060855069001003,060855069001003,"Block 1003, Block Group 1, Census Tract 5069, Santa Clara County, California",95,91,4
1000000US060855069001004,060855069001004,"Block 1004, Block Group 1, Census Tract 5069, Santa Clara County, California",47,45,2
1000000US060855069001005,060855069001005,"Block 1005, Block Group 1, Census Tract 5069, Santa Clara County, California",31,31,0
1000000US060855069001006,060855069001006,"Block 1006, Block Group 1, Census Tract 5069, Santa Clara County, California",58,58,0
1000000US060855069001007,060855069001007,"Block 1007, Block Group 1, Census Tract 5069, Santa Clara County, California",12,12,0
1000000US060855069001008,060855069001008,"Block 1008, Block Group 1, Census Tract 5069, Santa Clara County, California",12,12,0
1000000US060855069001009,060855069001009,"Block 1009, Block Group 1, Census Tract 5069, Santa Clara County, California",16,16,0
1000000US060855069001010,060855069001010,"Block 1010, Block Group 1, Census Tract 5069, Santa Clara County, California",8,8,0
1000000US060855069001011,060855069001011,"Block 1011, Block Group 1, Census Tract 5069, Santa Clara County, California",0,0,0
1000000US060855069002000,060855069002000,"Block 2000, Block Group 2, Census Tract 5069, Santa Clara County, California",9,8,1
1000000US060855069002001,060855069002001,"Block 2001, Block Group 2, Census Tract 5069, Santa Clara County, California",33,33,0
1000000US060855069002002,060855069002002,"Block 2002, Block Group 2, Census Tract 5069, Santa Clara County, California",41,40,1
1000000US060855069002003,060855069002003,"Block 2003, Block Group 2, Census Tract 5069, Santa Clara County, California",20,20,0
1000000US060855069002004,060855069002004,"Block 2004, Block Group 2, Census Tract 5069, Santa Clara County, California",100,99,1
1000000US060855069002005,060855069002005,"Block 2005, Block Group 2, Census Tract 5069, Santa Clara County, California",19,19,0
1000000US060855069002006,060855069002006,"Block 2006, Block Group 2, Census Tract 5069, Santa Clara County, California",35,34,1
1000000US060855069002007,060855069002007,"Block 2007, Block Group 2, Census Tract 5069, Santa Clara County, California",0,0,0
1000000US060855069002008,060855069002008,"Block 2008, Block Group 2, Census Tract 5069, Santa Clara County, California",0,0,0
1000000US060855069002009,060855069002009,"Block 2009, Block Group 2, Census Tract 5069, Santa Clara County, California",54,52,2
1000000US060855069002010,060855069002010,"Block 2010, Block Group 2, Census Tract 5069, Santa Clara County, California",16,16,0
1000000US060855069002011,060855069002011,"Block 2011, Block Group 2, Census Tract 5069, Santa Clara County, California",48,48,0
1000000US060855069002012,060855069002012,"Block 2012, Block Group 2, Census Tract 5069, Santa Clara County, California",23,23,0
1000000US060855069002013,060855069002013,"Block 2013, Block Group 2, Census Tract 5069, Santa Clara County, California",29,29,0
1000000US060855069002014,060855069002014,"Block 2014, Block Group 2, Census Tract 5069, Santa Clara County, California",25,25,0
1000000US060855069002015,060855069002015,"Block 2015, Block Group 2, Census Tract 5069, Santa Clara County, California",28,28,0
1000000US060855069002016,060855069002016,"Block 2016, Block Group 2, Census Tract 5069, Santa Clara County, California",21,21,0
1000000US060855069002017,060855069002017,"Block 2017, Block Group 2, Census Tract 5069, Santa Clara County, California",17,17,0
1000000US060855069002018,060855069002018,"Block 2018, Block Group 2, Census Tract 5069, Santa Clara County, California",21,21,0
1000000US060855069002019,060855069002019,"Block 2019, Block Group 2, Census Tract 5069, Santa Clara County, California",17,17,0
1000000US060855069002020,060855069002020,"Block 2020, Block Group 2, Census Tract 5069, Santa Clara County, California",11,11,0
1000000US060855069002021,060855069002021,"Block 2021, Block Group 2, Census Tract 5069, Santa Clara County, California",22,20,2
1000000US060855069002022,060855069002022,"Block 2022, Block Group 2, Census Tract 5069, Santa Clara County, California",27,26,1
1000000US060855069002023,060855069002023,"Block 2023, Block Group 2, Census Tract 5069, Santa Clara County, California",39,39,0
1000000US060855069002024,060855069002024,"Block 2024, Block Group 2, Census Tract 5069, Santa Clara County, California",24,23,1
1000000US060855069003000,060855069003000,"Block 3000, Block Group 3, Census Tract 5069, Santa Clara County, California",17,17,0
1000000US060855069003001,060855069003001,"Block 3001, Block Group 3, Census Tract 5069, Santa Clara County, California",25,24,1
1000000US060855069003002,060855069003002,"Block 3002, Block Group 3, Census Tract 5069, Santa Clara County, California",8,8,0
1000000US060855069003003,060855069003003,"Block 3003, Block Group 3, Census Tract 5069, Santa Clara County, California",159,154,5
1000000US060855069003004,060855069003004,"Block 3004, Block Group 3, Census Tract 5069, Santa Clara County, California",5,5,0
1000000US060855069003005,060855069003005,"Block 3005, Block Group 3, Census Tract 5069, Santa Clara County, California",0,0,0
1000000US060855069003006,060855069003006,"Block 3006, Block Group 3, Census Tract 5069, Santa Clara County, California",14,14,0
1000000US060855069003007,060855069003007,"Block 3007, Block Group 3, Census Tract 5069, Santa Clara County, California",1,1,0
1000000US060855069003008,060855069003008,"Block 3008, Block Group 3, Census Tract 5069, Santa Clara County, California",7,7,0
1000000US060855069003009,060855069003009,"Block 3009, Block Group 3, Census Tract 5069, Santa Clara County, California",13,13,0
1000000US060855069003010,060855069003010,"Block 3010, Block Group 3, Census Tract 5069, Santa Clara County, California",2,2,0
1000000US060855069003011,060855069003011,"Block 3011, Block Group 3, Census Tract 5069, Santa Clara County, California",0,0,0
1000000US060855069003012,060855069003012,"Block 3012, Block Group 3, Census Tract 5069, Santa Clara County, California",5,4,1
1000000US060855069003013,060855069003013,"Block 3013, Block Group 3, Census Tract 5069, Santa Clara County, California",0,0,0
1000000US060855069003014,060855069003014,"Block 3014, Block Group 3, Census Tract 5069, Santa Clara County, California",19,19,0
1000000US060855069003015,060855069003015,"Block 3015, Block Group 3, Census Tract 5069, Santa Clara County, California",0,0,0
1000000US060855069003016,060855069003016,"Block 3016, Block Group 3, Census Tract 5069, Santa Clara County, California",23,20,3
1000000US060855069003017,060855069003017,"Block 3017, Block Group 3, Census Tract 5069, Santa Clara County, California",0,0,0
1000000US060855069003018,060855069003018,"Block 3018, Block Group 3, Census Tract 5069, Santa Clara County, California",0,0,0
1000000US060855069003019,060855069003019,"Block 3019, Block Group 3, Census Tract 5069, Santa Clara County, California",0,0,0
1000000US060855069003020,060855069003020,"Block 3020, Block Group 3, Census Tract 5069, Santa Clara County, California",2,2,0
1000000US060855069003021,060855069003021,"Block 3021, Block Group 3, Census Tract 5069, Santa Clara County, California",0,0,0
1000000US060855069003022,060855069003022,"Block 3022, Block Group 3, Census Tract 5069, Santa Clara County, California",0,0,0
1000000US060855069003023,060855069003023,"Block 3023, Block Group 3, Census Tract 5069, Santa Clara County, California",0,0,0
1000000US060855069003024,060855069003024,"Block 3024, Block Group 3, Census Tract 5069, Santa Clara County, California",1,1,0
1000000US060855069003025,060855069003025,"Block 3025, Block Group 3, Census Tract 5069, Santa Clara County, California",47,45,2
1000000US060855069003026,060855069003026,"Block 3026, Block Group 3, Census Tract 5069, Santa Clara County, California",8,8,0
1000000US060855069003027,060855069003027,"Block 3027, Block Group 3, Census Tract 5069, Santa Clara County, California",7,7,0
1000000US060855069003028,060855069003028,"Block 3028, Block Group 3, Census Tract 5069, Santa Clara County, California",0,0,0
1000000US060855069003029,060855069003029,"Block 3029, Block Group 3, Census Tract 5069, Santa Clara County, California",2,2,0
1000000US060855069003030,060855069003030,"Block 3030, Block Group 3, Census Tract 5069, Santa Clara County, California",74,73,1
1000000US060855069003031,060855069003031,"Block 3031, Block Group 3, Census Tract 5069, Santa Clara County, California",18,18,0
1000000US060855069003032,060855069003032,"Block 3032, Block Group 3, Census Tract 5069, Santa Clara County, California",17,17,0
1000000US060855069003033,060855069003033,"Block 3033, Block Group 3, Census Tract 5069, Santa Clara County, California",15,15,0
1000000US060855069003034,060855069003034,"Block 3034, Block Group 3, Census Tract 5069, Santa Clara County, California",3,3,0
1000000US060855069003035,060855069003035,"Block 3035, Block Group 3, Census Tract 5069, Santa Clara County, California",3,3,0
1000000US060855069003036,060855069003036,"Block 3036, Block Group 3, Census Tract 5069, Santa Clara County, California",12,12,0
1000000US060855069003037,060855069003037,"Block 3037, Block Group 3, Census Tract 5069, Santa Clara County, California",12,11,1
1000000US060855069003038,060855069003038,"Block 3038, Block Group 3, Census Tract 5069, Santa Clara County, California",8,8,0
1000000US060855069003039,060855069003039,"Block 3039, Block Group 3, Census Tract 5069, Santa Clara County, California",15,15,0
1000000US060855069003040,060855069003040,"Block 3040, Block Group 3, Census Tract 5069, Santa Clara County, California",6,6,0
1000000US060855069003041,060855069003041,"Block 3041, Block Group 3, Census Tract 5069, Santa Clara County, California",1,1,0
1000000US060855069003042,060855069003042,"Block 3042, Block Group 3, Census Tract 5069, Santa Clara County, California",6,6,0
1000000US060855069003043,060855069003043,"Block 3043, Block Group 3, Census Tract 5069, Santa Clara County, California",0,0,0
1000000US060855069003044,060855069003044,"Block 3044, Block Group 3, Census Tract 5069, Santa Clara County, California",0,0,0
1000000US060855069003045,060855069003045,"Block 3045, Block Group 3, Census Tract 5069, Santa Clara County, California",5,5,0
1000000US060855069003046,060855069003046,"Block 3046, Block Group 3, Census Tract 5069, Santa Clara County, California",3,3,0
1000000US060855069003047,060855069003047,"Block 3047, Block Group 3, Census Tract 5069, Santa Clara County, California",2,2,0
1000000US060855069003048,060855069003048,"Block 3048, Block Group 3, Census Tract 5069, Santa Clara County, California",0,0,0
1000000US060855069003049,060855069003049,"Block 3049, Block Group 3, Census Tract 5069, Santa Clara County, California",2,2,0
1000000US060855069003050,060855069003050,"Block 3050, Block Group 3, Census Tract 5069, Santa Clara County, California",0,0,0
1000000US060855069003051,060855069003051,"Block 3051, Block Group 3, Census Tract 5069, Santa Clara County, California",66,66,0
1000000US060855069003052,060855069003052,"Block 3052, Block Group 3, Census Tract 5069, Santa Clara County, California",1,1,0
1000000US060855069003053,060855069003053,"Block 3053, Block Group 3, Census Tract 5069, Santa Clara County, California",0,0,0
1000000US060855069003054,060855069003054,"Block 3054, Block Group 3, Census Tract 5069, Santa Clara County, California",0,0,0
1000000US060855069003055,060855069003055,"Block 3055, Block Group 3, Census Tract 5069, Santa Clara County, California",0,0,0
1000000US060855069003056,060855069003056,"Block 3056, Block Group 3, Census Tract 5069, Santa Clara County, California",20,17,3
1000000US060855069003057,060855069003057,"Block 3057, Block Group 3, Census Tract 5069, Santa Clara County, California",1,1,0
1000000US060855069003058,060855069003058,"Block 3058, Block Group 3, Census Tract 5069, Santa Clara County, California",2,2,0
1000000US060855069003059,060855069003059,"Block 3059, Block Group 3, Census Tract 5069, Santa Clara County, California",19,18,1
1000000US060855069003060,060855069003060,"Block 3060, Block Group 3, Census Tract 5069, Santa Clara County, California",0,0,0
1000000US060855069003061,060855069003061,"Block 3061, Block Group 3, Census Tract 5069, Santa Clara County, California",1,1,0
1000000US060855069003062,060855069003062,"Block 3062, Block Group 3, Census Tract 5069, Santa Clara County, California",3,2,1
1000000US060855069003063,060855069003063,"Block 3063, Block Group 3, Census Tract 5069, Santa Clara County, California",0,0,0
1000000US060855069003064,060855069003064,"Block 3064, Block Group 3, Census Tract 5069, Santa Clara County, California",5,5,0
1000000US060855069003065,060855069003065,"Block 3065, Block Group 3, Census Tract 5069, Santa Clara County, California",1,1,0
1000000US060855069003066,060855069003066,"Block 3066, Block Group 3, Census Tract 5069, Santa Clara County, California",24,21,3
1000000US060855069003067,060855069003067,"Block 3067, Block Group 3, Census Tract 5069, Santa Clara County, California",4,3,1
1000000US060855069003068,060855069003068,"Block 3068, Block Group 3, Census Tract 5069, Santa Clara County, California",1,1,0
1000000US060855069003069,060855069003069,"Block 3069, Block Group 3, Census Tract 5069, Santa Clara County, California",0,0,0
1000000US060855069003070,060855069003070,"Block 3070, Block Group 3, Census Tract 5069, Santa Clara County, California",10,10,0
1000000US060855069003071,060855069003071,"Block 3071, Block Group 3, Census Tract 5069, Santa Clara County, California",0,0,0
1000000US060855069004000,060855069004000,"Block 4000, Block Group 4, Census Tract 5069, Santa Clara County, California",1,1,0
1000000US060855069004001,060855069004001,"Block 4001, Block Group 4, Census Tract 5069, Santa Clara County, California",0,0,0
1000000US060855069004002,060855069004002,"Block 4002, Block Group 4, Census Tract 5069, Santa Clara County, California",1,1,0
1000000US060855069004003,060855069004003,"Block 4003, Block Group 4, Census Tract 5069, Santa Clara County, California",0,0,0
1000000US060855069004004,060855069004004,"Block 4004, Block Group 4, Census Tract 5069, Santa Clara County, California",0,0,0
1000000US060855069004005,060855069004005,"Block 4005, Block Group 4, Census Tract 5069, Santa Clara County, California",0,0,0
1000000US060855069004006,060855069004006,"Block 4006, Block Group 4, Census Tract 5069, Santa Clara County, California",0,0,0
1000000US060855069004007,060855069004007,"Block 4007, Block Group 4, Census Tract 5069, Santa Clara County, California",0,0,0
1000000US060855069004008,060855069004008,"Block 4008, Block Group 4, Census Tract 5069, Santa Clara County, California",63,60,3
1000000US060855069004009,060855069004009,"Block 4009, Block Group 4, Census Tract 5069, Santa Clara County, California",0,0,0
1000000US060855069004010,060855069004010,"Block 4010, Block Group 4, Census Tract 5069, Santa Clara County, California",0,0,0
1000000US060855069004011,060855069004011,"Block 4011, Block Group 4, Census Tract 5069, Santa Clara County, California",0,0,0
1000000US060855069004012,060855069004012,"Block 4012, Block Group 4, Census Tract 5069, Santa Clara County, California",0,0,0
1000000US060855069004013,060855069004013,"Block 4013, Block Group 4, Census Tract 5069, Santa Clara County, California",24,24,0
1000000US060855069004014,060855069004014,"Block 4014, Block Group 4, Census Tract 5069, Santa Clara County, California",0,0,0
1000000US060855069004015,060855069004015,"Block 4015, Block Group 4, Census Tract 5069, Santa Clara County, California",0,0,0
1000000US060855069004016,060855069004016,"Block 4016, Block Group 4, Census Tract 5069, Santa Clara County, California",15,14,1
1000000US060855069004017,060855069004017,"Block 4017, Block Group 4, Census Tract 5069, Santa Clara County, California",0,0,0
1000000US060855069004018,060855069004018,"Block 4018, Block Group 4, Census Tract 5069, Santa Clara County, California",1,1,0
1000000US060855069004019,060855069004019,"Block 4019, Block Group 4, Census Tract 5069, Santa Clara County, California",0,0,0
1000000US060855069004020,060855069004020,"Block 4020, Block Group 4, Census Tract 5069, Santa Clara County, California",29,28,1
1000000US060855069004021,060855069004021,"Block 4021, Block Group 4, Census Tract 5069, Santa Clara County, California",0,0,0
1000000US060855069004022,060855069004022,"Block 4022, Block Group 4, Census Tract 5069, Santa Clara County, California",101,99,2
1000000US060855069004023,060855069004023,"Block 4023, Block Group 4, Census Tract 5069, Santa Clara County, California",29,29,0
1000000US060855069004024,060855069004024,"Block 4024, Block Group 4, Census Tract 5069, Santa Clara County, California",35,35,0
1000000US060855069004025,060855069004025,"Block 4025, Block Group 4, Census Tract 5069, Santa Clara County, California",67,63,4
1000000US060855069004026,060855069004026,"Block 4026, Block Group 4, Census Tract 5069, Santa Clara County, California",27,26,1
1000000US060855069004027,060855069004027,"Block 4027, Block Group 4, Census Tract 5069, Santa Clara County, California",0,0,0
1000000US060855069004028,060855069004028,"Block 4028, Block Group 4, Census Tract 5069, Santa Clara County, California",0,0,0
1000000US060855069004029,060855069004029,"Block 4029, Block Group 4, Census Tract 5069, Santa Clara County, California",4,4,0
1000000US060855069004030,060855069004030,"Block 4030, Block Group 4, Census Tract 5069, Santa Clara County, California",32,29,3
1000000US060855069004031,060855069004031,"Block 4031, Block Group 4, Census Tract 5069, Santa Clara County, California",1,1,0
1000000US060855069004032,060855069004032,"Block 4032, Block Group 4, Census Tract 5069, Santa Clara County, California",2,1,1
1000000US060855069004033,060855069004033,"Block 4033, Block Group 4, Census Tract 5069, Santa Clara County, California",127,122,5
1000000US060855069004034,060855069004034,"Block 4034, Block Group 4, Census Tract 5069, Santa Clara County, California",1,1,0
1000000US060855069004035,060855069004035,"Block 4035, Block Group 4, Census Tract 5069, Santa Clara County, California",22,21,1
1000000US060855069004036,060855069004036,"Block 4036, Block Group 4, Census Tract 5069, Santa Clara County, California",0,0,0
1000000US060855069004037,060855069004037,"Block 4037, Block Group 4, Census Tract 5069, Santa Clara County, California",18,18,0
1000000US060855069004038,060855069004038,"Block 4038, Block Group 4, Census Tract 5069, Santa Clara County, California",20,19,1
1000000US060855069004039,060855069004039,"Block 4039, Block Group 4, Census Tract 5069, Santa Clara County, California",23,23,0
1000000US060855069004040,060855069004040,"Block 4040, Block Group 4, Census Tract 5069, Santa Clara County, California",4,3,1
1000000US060855069004041,060855069004041,"Block 4041, Block Group 4, Census Tract 5069, Santa Clara County, California",13,11,2
1000000US060855069004042,060855069004042,"Block 4042, Block Group 4, Census Tract 5069, Santa Clara County, California",21,21,0
1000000US060855069004043,060855069004043,"Block 4043, Block Group 4, Census Tract 5069, Santa Clara County, California",2,1,1
1000000US060855069004044,060855069004044,"Block 4044, Block Group 4, Census Tract 5069, Santa Clara County, California",0,0,0
1000000US060855069004045,060855069004045,"Block 4045, Block Group 4, Census Tract 5069, Santa Clara County, California",1,1,0
1000000US060855069004046,060855069004046,"Block 4046, Block Group 4, Census Tract 5069, Santa Clara County, California",174,164,10
1000000US060855070011000,060855070011000,"Block 1000, Block Group 1, Census Tract 5070.01, Santa Clara County, California",71,69,2
1000000US060855070011001,060855070011001,"Block 1001, Block Group 1, Census Tract 5070.01, Santa Clara County, California",13,13,0
1000000US060855070011002,060855070011002,"Block 1002, Block Group 1, Census Tract 5070.01, Santa Clara County, California",4,4,0
1000000US060855070011003,060855070011003,"Block 1003, Block Group 1, Census Tract 5070.01, Santa Clara County, California",8,8,0
1000000US060855070011004,060855070011004,"Block 1004, Block Group 1, Census Tract 5070.01, Santa Clara County, California",22,20,2
1000000US060855070011005,060855070011005,"Block 1005, Block Group 1, Census Tract 5070.01, Santa Clara County, California",12,12,0
1000000US060855070011006,060855070011006,"Block 1006, Block Group 1, Census Tract 5070.01, Santa Clara County, California",17,16,1
1000000US060855070011007,060855070011007,"Block 1007, Block Group 1, Census Tract 5070.01, Santa Clara County, California",14,14,0
1000000US060855070011008,060855070011008,"Block 1008, Block Group 1, Census Tract 5070.01, Santa Clara County, California",19,17,2
1000000US060855070011009,060855070011009,"Block 1009, Block Group 1, Census Tract 5070.01, Santa Clara County, California",5,5,0
1000000US060855070011010,060855070011010,"Block 1010, Block Group 1, Census Tract 5070.01, Santa Clara County, California",10,9,1
1000000US060855070011011,060855070011011,"Block 1011, Block Group 1, Census Tract 5070.01, Santa Clara County, California",3,3,0
1000000US060855070011012,060855070011012,"Block 1012, Block Group 1, Census Tract 5070.01, Santa Clara County, California",22,22,0
1000000US060855070011013,060855070011013,"Block 1013, Block Group 1, Census Tract 5070.01, Santa Clara County, California",40,36,4
1000000US060855070011014,060855070011014,"Block 1014, Block Group 1, Census Tract 5070.01, Santa Clara County, California",12,10,2
1000000US060855070011015,060855070011015,"Block 1015, Block Group 1, Census Tract 5070.01, Santa Clara County, California",10,9,1
1000000US060855070011016,060855070011016,"Block 1016, Block Group 1, Census Tract 5070.01, Santa Clara County, California",0,0,0
1000000US060855070011017,060855070011017,"Block 1017, Block Group 1, Census Tract 5070.01, Santa Clara County, California",1,1,0
1000000US060855070011018,060855070011018,"Block 1018, Block Group 1, Census Tract 5070.01, Santa Clara County, California",0,0,0
1000000US060855070011019,060855070011019,"Block 1019, Block Group 1, Census Tract 5070.01, Santa Clara County, California",0,0,0
1000000US060855070011020,060855070011020,"Block 1020, Block Group 1, Census Tract 5070.01, Santa Clara County, California",0,0,0
1000000US060855070011021,060855070011021,"Block 1021, Block Group 1, Census Tract 5070.01, Santa Clara County, California",0,0,0
1000000US060855070011022,060855070011022,"Block 1022, Block Group 1, Census Tract 5070.01, Santa Clara County, California",21,18,3
1000000US060855070011023,060855070011023,"Block 1023, Block Group 1, Census Tract 5070.01, Santa Clara County, California",18,16,2
1000000US060855070011024,060855070011024,"Block 1024, Block Group 1, Census Tract 5070.01, Santa Clara County, California",18,14,4
1000000US060855070011025,060855070011025,"Block 1025, Block Group 1, Census Tract 5070.01, Santa Clara County, California",15,14,1
1000000US060855070011026,060855070011026,"Block 1026, Block Group 1, Census Tract 5070.01, Santa Clara County, California",14,13,1
1000000US060855070011027,060855070011027,"Block 1027, Block Group 1, Census Tract 5070.01, Santa Clara County, California",98,89,9
1000000US060855070011028,060855070011028,"Block 1028, Block Group 1, Census Tract 5070.01, Santa Clara County, California",12,11,1
1000000US060855070011029,060855070011029,"Block 1029, Block Group 1, Census Tract 5070.01, Santa Clara County, California",17,17,0
1000000US060855070011030,060855070011030,"Block 1030, Block Group 1, Census Tract 5070.01, Santa Clara County, California",18,18,0
1000000US060855070011031,060855070011031,"Block 1031, Block Group 1, Census Tract 5070.01, Santa Clara County, California",20,17,3
1000000US060855070011032,060855070011032,"Block 1032, Block Group 1, Census Tract 5070.01, Santa Clara County, California",13,8,5
1000000US060855070011033,060855070011033,"Block 1033, Block Group 1, Census Tract 5070.01, Santa Clara County, California",18,15,3
1000000US060855070011034,060855070011034,"Block 1034, Block Group 1, Census Tract 5070.01, Santa Clara County, California",52,51,1
1000000US060855070011035,060855070011035,"Block 1035, Block Group 1, Census Tract 5070.01, Santa Clara County, California",0,0,0
1000000US060855070011036,060855070011036,"Block 1036, Block Group 1, Census Tract 5070.01, Santa Clara County, California",25,23,2
1000000US060855070011037,060855070011037,"Block 1037, Block Group 1, Census Tract 5070.01, Santa Clara County, California",1,1,0
1000000US060855070011038,060855070011038,"Block 1038, Block Group 1, Census Tract 5070.01, Santa Clara County, California",7,7,0
1000000US060855070011039,060855070011039,"Block 1039, Block Group 1, Census Tract 5070.01, Santa Clara County, California",8,8,0
1000000US060855070011040,060855070011040,"Block 1040, Block Group 1, Census Tract 5070.01, Santa Clara County, California",8,7,1
1000000US060855070011041,060855070011041,"Block 1041, Block Group 1, Census Tract 5070.01, Santa Clara County, California",0,0,0
1000000US060855070011042,060855070011042,"Block 1042, Block Group 1, Census Tract 5070.01, Santa Clara County, California",3,3,0
1000000US060855070011043,060855070011043,"Block 1043, Block Group 1, Census Tract 5070.01, Santa Clara County, California",25,24,1
1000000US060855070011044,060855070011044,"Block 1044, Block Group 1, Census Tract 5070.01, Santa Clara County, California",39,35,4
1000000US060855070011045,060855070011045,"Block 1045, Block Group 1, Census Tract 5070.01, Santa Clara County, California",97,93,4
1000000US060855070011046,060855070011046,"Block 1046, Block Group 1, Census Tract 5070.01, Santa Clara County, California",12,12,0
1000000US060855070011047,060855070011047,"Block 1047, Block Group 1, Census Tract 5070.01, Santa Clara County, California",0,0,0
1000000US060855070011048,060855070011048,"Block 1048, Block Group 1, Census Tract 5070.01, Santa Clara County, California",0,0,0
1000000US060855070011049,060855070011049,"Block 1049, Block Group 1, Census Tract 5070.01, Santa Clara County, California",4,4,0
1000000US060855070011050,060855070011050,"Block 1050, Block Group 1, Census Tract 5070.01, Santa Clara County, California",0,0,0
1000000US060855070011051,060855070011051,"Block 1051, Block Group 1, Census Tract 5070.01, Santa Clara County, California",0,0,0
1000000US060855070011052,060855070011052,"Block 1052, Block Group 1, Census Tract 5070.01, Santa Clara County, California",0,0,0
1000000US060855070011053,060855070011053,"Block 1053, Block Group 1, Census Tract 5070.01, Santa Clara County, California",8,7,1
1000000US060855070011054,060855070011054,"Block 1054, Block Group 1, Census Tract 5070.01, Santa Clara County, California",31,31,0
1000000US060855070011055,060855070011055,"Block 1055, Block Group 1, Census Tract 5070.01, Santa Clara County, California",26,22,4
1000000US060855070011056,060855070011056,"Block 1056, Block Group 1, Census Tract 5070.01, Santa Clara County, California",0,0,0
1000000US060855070011057,060855070011057,"Block 1057, Block Group 1, Census Tract 5070.01, Santa Clara County, California",1,0,1
1000000US060855070011058,060855070011058,"Block 1058, Block Group 1, Census Tract 5070.01, Santa Clara County, California",0,0,0
1000000US060855070011059,060855070011059,"Block 1059, Block Group 1, Census Tract 5070.01, Santa Clara County, California",0,0,0
1000000US060855070011060,060855070011060,"Block 1060, Block Group 1, Census Tract 5070.01, Santa Clara County, California",42,38,4
1000000US060855070011061,060855070011061,"Block 1061, Block Group 1, Census Tract 5070.01, Santa Clara County, California",0,0,0
1000000US060855070012000,060855070012000,"Block 2000, Block Group 2, Census Tract 5070.01, Santa Clara County, California",38,33,5
1000000US060855070012001,060855070012001,"Block 2001, Block Group 2, Census Tract 5070.01, Santa Clara County, California",0,0,0
1000000US060855070012002,060855070012002,"Block 2002, Block Group 2, Census Tract 5070.01, Santa Clara County, California",31,31,0
1000000US060855070012003,060855070012003,"Block 2003, Block Group 2, Census Tract 5070.01, Santa Clara County, California",1,1,0
1000000US060855070012004,060855070012004,"Block 2004, Block Group 2, Census Tract 5070.01, Santa Clara County, California",1,1,0
1000000US060855070012005,060855070012005,"Block 2005, Block Group 2, Census Tract 5070.01, Santa Clara County, California",28,26,2
1000000US060855070012006,060855070012006,"Block 2006, Block Group 2, Census Tract 5070.01, Santa Clara County, California",1,1,0
1000000US060855070012007,060855070012007,"Block 2007, Block Group 2, Census Tract 5070.01, Santa Clara County, California",29,25,4
1000000US060855070012008,060855070012008,"Block 2008, Block Group 2, Census Tract 5070.01, Santa Clara County, California",0,0,0
1000000US060855070012009,060855070012009,"Block 2009, Block Group 2, Census Tract 5070.01, Santa Clara County, California",13,13,0
1000000US060855070012010,060855070012010,"Block 2010, Block Group 2, Census Tract 5070.01, Santa Clara County, California",86,77,9
1000000US060855070012011,060855070012011,"Block 2011, Block Group 2, Census Tract 5070.01, Santa Clara County, California",6,5,1
1000000US060855070012012,060855070012012,"Block 2012, Block Group 2, Census Tract 5070.01, Santa Clara County, California",2,2,0
1000000US060855070012013,060855070012013,"Block 2013, Block Group 2, Census Tract 5070.01, Santa Clara County, California",0,0,0
1000000US060855070012014,060855070012014,"Block 2014, Block Group 2, Census Tract 5070.01, Santa Clara County, California",23,20,3
1000000US060855070012015,060855070012015,"Block 2015, Block Group 2, Census Tract 5070.01, Santa Clara County, California",17,16,1
1000000US060855070012016,060855070012016,"Block 2016, Block Group 2, Census Tract 5070.01, Santa Clara County, California",1,1,0
1000000US060855070012017,060855070012017,"Block 2017, Block Group 2, Census Tract 5070.01, Santa Clara County, California",8,7,1
1000000US060855070012018,060855070012018,"Block 2018, Block Group 2, Census Tract 5070.01, Santa Clara County, California",37,36,1
1000000US060855070012019,060855070012019,"Block 2019, Block Group 2, Census Tract 5070.01, Santa Clara County, California",3,3,0
1000000US060855070012020,060855070012020,"Block 2020, Block Group 2, Census Tract 5070.01, Santa Clara County, California",1,0,1
1000000US060855070012021,060855070012021,"Block 2021, Block Group 2, Census Tract 5070.01, Santa Clara County, California",1,0,1
1000000US060855070012022,060855070012022,"Block 2022, Block Group 2, Census Tract 5070.01, Santa Clara County, California",14,11,3
1000000US060855070012023,060855070012023,"Block 2023, Block Group 2, Census Tract 5070.01, Santa Clara County, California",0,0,0
1000000US060855070012024,060855070012024,"Block 2024, Block Group 2, Census Tract 5070.01, Santa Clara County, California",1,0,1
1000000US060855070012025,060855070012025,"Block 2025, Block Group 2, Census Tract 5070.01, Santa Clara County, California",4,4,0
1000000US060855070012026,060855070012026,"Block 2026, Block Group 2, Census Tract 5070.01, Santa Clara County, California",4,4,0
1000000US060855070012027,060855070012027,"Block 2027, Block Group 2, Census Tract 5070.01, Santa Clara County, California",10,9,1
1000000US060855070012028,060855070012028,"Block 2028, Block Group 2, Census Tract 5070.01, Santa Clara County, California",1,1,0
1000000US060855070012029,060855070012029,"Block 2029, Block Group 2, Census Tract 5070.01, Santa Clara County, California",1,0,1
1000000US060855070012030,060855070012030,"Block 2030, Block Group 2, Census Tract 5070.01, Santa Clara County, California",1,1,0
1000000US060855070012031,060855070012031,"Block 2031, Block Group 2, Census Tract 5070.01, Santa Clara County, California",1,1,0
1000000US060855070012032,060855070012032,"Block 2032, Block Group 2, Census Tract 5070.01, Santa Clara County, California",12,11,1
1000000US060855070012033,060855070012033,"Block 2033, Block Group 2, Census Tract 5070.01, Santa Clara County, California",0,0,0
1000000US060855070012034,060855070012034,"Block 2034, Block Group 2, Census Tract 5070.01, Santa Clara County, California",2,2,0
1000000US060855070012035,060855070012035,"Block 2035, Block Group 2, Census Tract 5070.01, Santa Clara County, California",17,15,2
1000000US060855070012036,060855070012036,"Block 2036, Block Group 2, Census Tract 5070.01, Santa Clara County, California",29,29,0
1000000US060855070012037,060855070012037,"Block 2037, Block Group 2, Census Tract 5070.01, Santa Clara County, California",10,10,0
1000000US060855070012038,060855070012038,"Block 2038, Block Group 2, Census Tract 5070.01, Santa Clara County, California",18,16,2
1000000US060855070012039,060855070012039,"Block 2039, Block Group 2, Census Tract 5070.01, Santa Clara County, California",1,1,0
1000000US060855070012040,060855070012040,"Block 2040, Block Group 2, Census Tract 5070.01, Santa Clara County, California",5,3,2
1000000US060855070012041,060855070012041,"Block 2041, Block Group 2, Census Tract 5070.01, Santa Clara County, California",0,0,0
1000000US060855070012042,060855070012042,"Block 2042, Block Group 2, Census Tract 5070.01, Santa Clara County, California",0,0,0
1000000US060855070012043,060855070012043,"Block 2043, Block Group 2, Census Tract 5070.01, Santa Clara County, California",3,1,2
1000000US060855070012044,060855070012044,"Block 2044, Block Group 2, Census Tract 5070.01, Santa Clara County, California",0,0,0
1000000US060855070012045,060855070012045,"Block 2045, Block Group 2, Census Tract 5070.01, Santa Clara County, California",2,2,0
1000000US060855070012046,060855070012046,"Block 2046, Block Group 2, Census Tract 5070.01, Santa Clara County, California",18,18,0
1000000US060855070012047,060855070012047,"Block 2047, Block Group 2, Census Tract 5070.01, Santa Clara County, California",41,37,4
1000000US060855070012048,060855070012048,"Block 2048, Block Group 2, Census Tract 5070.01, Santa Clara County, California",0,0,0
1000000US060855070012049,060855070012049,"Block 2049, Block Group 2, Census Tract 5070.01, Santa Clara County, California",4,3,1
1000000US060855070012050,060855070012050,"Block 2050, Block Group 2, Census Tract 5070.01, Santa Clara County, California",2,2,0
1000000US060855070012051,060855070012051,"Block 2051, Block Group 2, Census Tract 5070.01, Santa Clara County, California",1,1,0
1000000US060855070012052,060855070012052,"Block 2052, Block Group 2, Census Tract 5070.01, Santa Clara County, California",0,0,0
1000000US060855070012053,060855070012053,"Block 2053, Block Group 2, Census Tract 5070.01, Santa Clara County, California",117,114,3
1000000US060855070012054,060855070012054,"Block 2054, Block Group 2, Census Tract 5070.01, Santa Clara County, California",20,19,1
1000000US060855070012055,060855070012055,"Block 2055, Block Group 2, Census Tract 5070.01, Santa Clara County, California",26,20,6
1000000US060855070012056,060855070012056,"Block 2056, Block Group 2, Census Tract 5070.01, Santa Clara County, California",13,8,5
1000000US060855070012057,060855070012057,"Block 2057, Block Group 2, Census Tract 5070.01, Santa Clara County, California",0,0,0
1000000US060855070012058,060855070012058,"Block 2058, Block Group 2, Census Tract 5070.01, Santa Clara County, California",2,0,2
1000000US060855070012059,060855070012059,"Block 2059, Block Group 2, Census Tract 5070.01, Santa Clara County, California",291,239,52
1000000US060855070012060,060855070012060,"Block 2060, Block Group 2, Census Tract 5070.01, Santa Clara County, California",1,1,0
1000000US060855070012061,060855070012061,"Block 2061, Block Group 2, Census Tract 5070.01, Santa Clara County, California",0,0,0
1000000US060855070012062,060855070012062,"Block 2062, Block Group 2, Census Tract 5070.01, Santa Clara County, California",6,4,2
1000000US060855070012063,060855070012063,"Block 2063, Block Group 2, Census Tract 5070.01, Santa Clara County, California",0,0,0
1000000US060855070012064,060855070012064,"Block 2064, Block Group 2, Census Tract 5070.01, Santa Clara County, California",0,0,0
1000000US060855070012065,060855070012065,"Block 2065, Block Group 2, Census Tract 5070.01, Santa Clara County, California",0,0,0
1000000US060855070012066,060855070012066,"Block 2066, Block Group 2, Census Tract 5070.01, Santa Clara County, California",91,86,5
1000000US060855070012067,060855070012067,"Block 2067, Block Group 2, Census Tract 5070.01, Santa Clara County, California",0,0,0
1000000US060855070012068,060855070012068,"Block 2068, Block Group 2, Census Tract 5070.01, Santa Clara County, California",0,0,0
1000000US060855070012069,060855070012069,"Block 2069, Block Group 2, Census Tract 5070.01, Santa Clara County, California",0,0,0
1000000US060855070012070,060855070012070,"Block 2070, Block Group 2, Census Tract 5070.01, Santa Clara County, California",0,0,0
1000000US060855070012071,060855070012071,"Block 2071, Block Group 2, Census Tract 5070.01, Santa Clara County, California",50,40,10
1000000US060855070012072,060855070012072,"Block 2072, Block Group 2, Census Tract 5070.01, Santa Clara County, California",1,1,0
1000000US060855070012073,060855070012073,"Block 2073, Block Group 2, Census Tract 5070.01, Santa Clara County, California",1,1,0
1000000US060855070012074,060855070012074,"Block 2074, Block Group 2, Census Tract 5070.01, Santa Clara County, California",54,50,4
1000000US060855070012075,060855070012075,"Block 2075, Block Group 2, Census Tract 5070.01, Santa Clara County, California",74,70,4
1000000US060855070012076,060855070012076,"Block 2076, Block Group 2, Census Tract 5070.01, Santa Clara County, California",0,0,0
1000000US060855070012077,060855070012077,"Block 2077, Block Group 2, Census Tract 5070.01, Santa Clara County, California",0,0,0
1000000US060855070012078,060855070012078,"Block 2078, Block Group 2, Census Tract 5070.01, Santa Clara County, California",2,2,0
1000000US060855070012079,060855070012079,"Block 2079, Block Group 2, Census Tract 5070.01, Santa Clara County, California",1,1,0
1000000US060855070012080,060855070012080,"Block 2080, Block Group 2, Census Tract 5070.01, Santa Clara County, California",56,53,3
1000000US060855070012081,060855070012081,"Block 2081, Block Group 2, Census Tract 5070.01, Santa Clara County, California",0,0,0
1000000US060855070012082,060855070012082,"Block 2082, Block Group 2, Census Tract 5070.01, Santa Clara County, California",0,0,0
1000000US060855070012083,060855070012083,"Block 2083, Block Group 2, Census Tract 5070.01, Santa Clara County, California",0,0,0
1000000US060855070013000,060855070013000,"Block 3000, Block Group 3, Census Tract 5070.01, Santa Clara County, California",320,296,24
1000000US060855070013001,060855070013001,"Block 3001, Block Group 3, Census Tract 5070.01, Santa Clara County, California",0,0,0
1000000US060855070013002,060855070013002,"Block 3002, Block Group 3, Census Tract 5070.01, Santa Clara County, California",14,12,2
1000000US060855070013003,060855070013003,"Block 3003, Block Group 3, Census Tract 5070.01, Santa Clara County, California",24,23,1
1000000US060855070013004,060855070013004,"Block 3004, Block Group 3, Census Tract 5070.01, Santa Clara County, California",18,18,0
1000000US060855070013005,060855070013005,"Block 3005, Block Group 3, Census Tract 5070.01, Santa Clara County, California",0,0,0
1000000US060855070013006,060855070013006,"Block 3006, Block Group 3, Census Tract 5070.01, Santa Clara County, California",0,0,0
1000000US060855070013007,060855070013007,"Block 3007, Block Group 3, Census Tract 5070.01, Santa Clara County, California",12,12,0
1000000US060855070013008,060855070013008,"Block 3008, Block Group 3, Census Tract 5070.01, Santa Clara County, California",0,0,0
1000000US060855070013009,060855070013009,"Block 3009, Block Group 3, Census Tract 5070.01, Santa Clara County, California",14,14,0
1000000US060855070013010,060855070013010,"Block 3010, Block Group 3, Census Tract 5070.01, Santa Clara County, California",20,20,0
1000000US060855070013011,060855070013011,"Block 3011, Block Group 3, Census Tract 5070.01, Santa Clara County, California",0,0,0
1000000US060855070013012,060855070013012,"Block 3012, Block Group 3, Census Tract 5070.01, Santa Clara County, California",0,0,0
1000000US060855070013013,060855070013013,"Block 3013, Block Group 3, Census Tract 5070.01, Santa Clara County, California",0,0,0
1000000US060855070013014,060855070013014,"Block 3014, Block Group 3, Census Tract 5070.01, Santa Clara County, California",1,1,0
1000000US060855070013015,060855070013015,"Block 3015, Block Group 3, Census Tract 5070.01, Santa Clara County, California",1,1,0
1000000US060855070013016,060855070013016,"Block 3016, Block Group 3, Census Tract 5070.01, Santa Clara County, California",20,19,1
1000000US060855070013017,060855070013017,"Block 3017, Block Group 3, Census Tract 5070.01, Santa Clara County, California",31,31,0
1000000US060855070013018,060855070013018,"Block 3018, Block Group 3, Census Tract 5070.01, Santa Clara County, California",0,0,0
1000000US060855070013019,060855070013019,"Block 3019, Block Group 3, Census Tract 5070.01, Santa Clara County, California",3,3,0
1000000US060855070013020,060855070013020,"Block 3020, Block Group 3, Census Tract 5070.01, Santa Clara County, California",1,1,0
1000000US060855070013021,060855070013021,"Block 3021, Block Group 3, Census Tract 5070.01, Santa Clara County, California",2,2,0
1000000US060855070013022,060855070013022,"Block 3022, Block Group 3, Census Tract 5070.01, Santa Clara County, California",0,0,0
1000000US060855070013023,060855070013023,"Block 3023, Block Group 3, Census Tract 5070.01, Santa Clara County, California",3,3,0
1000000US060855070013024,060855070013024,"Block 3024, Block Group 3, Census Tract 5070.01, Santa Clara County, California",2,2,0
1000000US060855070013025,060855070013025,"Block 3025, Block Group 3, Census Tract 5070.01, Santa Clara County, California",2,2,0
1000000US060855070013026,060855070013026,"Block 3026, Block Group 3, Census Tract 5070.01, Santa Clara County, California",9,9,0
1000000US060855070013027,060855070013027,"Block 3027, Block Group 3, Census Tract 5070.01, Santa Clara County, California",0,0,0
1000000US060855070013028,060855070013028,"Block 3028, Block Group 3, Census Tract 5070.01, Santa Clara County, California",0,0,0
1000000US060855070013029,060855070013029,"Block 3029, Block Group 3, Census Tract 5070.01, Santa Clara County, California",0,0,0
1000000US060855070013030,060855070013030,"Block 3030, Block Group 3, Census Tract 5070.01, Santa Clara County, California",60,54,6
1000000US060855070013031,060855070013031,"Block 3031, Block Group 3, Census Tract 5070.01, Santa Clara County, California",0,0,0
1000000US060855070013032,060855070013032,"Block 3032, Block Group 3, Census Tract 5070.01, Santa Clara County, California",0,0,0
1000000US060855070013033,060855070013033,"Block 3033, Block Group 3, Census Tract 5070.01, Santa Clara County, California",29,26,3
1000000US060855070013034,060855070013034,"Block 3034, Block Group 3, Census Tract 5070.01, Santa Clara County, California",7,7,0
1000000US060855070013035,060855070013035,"Block 3035, Block Group 3, Census Tract 5070.01, Santa Clara County, California",7,5,2
1000000US060855070013036,060855070013036,"Block 3036, Block Group 3, Census Tract 5070.01, Santa Clara County, California",1,1,0
1000000US060855070014000,060855070014000,"Block 4000, Block Group 4, Census Tract 5070.01, Santa Clara County, California",3,2,1
1000000US060855070014001,060855070014001,"Block 4001, Block Group 4, Census Tract 5070.01, Santa Clara County, California",93,83,10
1000000US060855070014002,060855070014002,"Block 4002, Block Group 4, Census Tract 5070.01, Santa Clara County, California",2,1,1
1000000US060855070014003,060855070014003,"Block 4003, Block Group 4, Census Tract 5070.01, Santa Clara County, California",0,0,0
1000000US060855070014004,060855070014004,"Block 4004, Block Group 4, Census Tract 5070.01, Santa Clara County, California",0,0,0
1000000US060855070014005,060855070014005,"Block 4005, Block Group 4, Census Tract 5070.01, Santa Clara County, California",34,33,1
1000000US060855070014006,060855070014006,"Block 4006, Block Group 4, Census Tract 5070.01, Santa Clara County, California",54,52,2
1000000US060855070014007,060855070014007,"Block 4007, Block Group 4, Census Tract 5070.01, Santa Clara County, California",30,30,0
1000000US060855070014008,060855070014008,"Block 4008, Block Group 4, Census Tract 5070.01, Santa Clara County, California",33,30,3
1000000US060855070014009,060855070014009,"Block 4009, Block Group 4, Census Tract 5070.01, Santa Clara County, California",0,0,0
1000000US060855070014010,060855070014010,"Block 4010, Block Group 4, Census Tract 5070.01, Santa Clara County, California",5,5,0
1000000US060855070014011,060855070014011,"Block 4011, Block Group 4, Census Tract 5070.01, Santa Clara County, California",0,0,0
1000000US060855070014012,060855070014012,"Block 4012, Block Group 4, Census Tract 5070.01, Santa Clara County, California",87,36,51
1000000US060855070014013,060855070014013,"Block 4013, Block Group 4, Census Tract 5070.01, Santa Clara County, California",34,33,1
1000000US060855070014014,060855070014014,"Block 4014, Block Group 4, Census Tract 5070.01, Santa Clara County, California",22,22,0
1000000US060855070014015,060855070014015,"Block 4015, Block Group 4, Census Tract 5070.01, Santa Clara County, California",0,0,0
1000000US060855070014016,060855070014016,"Block 4016, Block Group 4, Census Tract 5070.01, Santa Clara County, California",3,2,1
1000000US060855070021000,060855070021000,"Block 1000, Block Group 1, Census Tract 5070.02, Santa Clara County, California",22,19,3
1000000US060855070021001,060855070021001,"Block 1001, Block Group 1, Census Tract 5070.02, Santa Clara County, California",8,8,0
1000000US060855070021002,060855070021002,"Block 1002, Block Group 1, Census Tract 5070.02, Santa Clara County, California",129,122,7
1000000US060855070021003,060855070021003,"Block 1003, Block Group 1, Census Tract 5070.02, Santa Clara County, California",10,10,0
1000000US060855070021004,060855070021004,"Block 1004, Block Group 1, Census Tract 5070.02, Santa Clara County, California",11,11,0
1000000US060855070021005,060855070021005,"Block 1005, Block Group 1, Census Tract 5070.02, Santa Clara County, California",31,31,0
1000000US060855070021006,060855070021006,"Block 1006, Block Group 1, Census Tract 5070.02, Santa Clara County, California",14,14,0
1000000US060855070021007,060855070021007,"Block 1007, Block Group 1, Census Tract 5070.02, Santa Clara County, California",13,11,2
1000000US060855070021008,060855070021008,"Block 1008, Block Group 1, Census Tract 5070.02, Santa Clara County, California",14,13,1
1000000US060855070021009,060855070021009,"Block 1009, Block Group 1, Census Tract 5070.02, Santa Clara County, California",0,0,0
1000000US060855070021010,060855070021010,"Block 1010, Block Group 1, Census Tract 5070.02, Santa Clara County, California",40,38,2
1000000US060855070021011,060855070021011,"Block 1011, Block Group 1, Census Tract 5070.02, Santa Clara County, California",184,175,9
1000000US060855070021012,060855070021012,"Block 1012, Block Group 1, Census Tract 5070.02, Santa Clara County, California",38,37,1
1000000US060855070021013,060855070021013,"Block 1013, Block Group 1, Census Tract 5070.02, Santa Clara County, California",5,5,0
1000000US060855070021014,060855070021014,"Block 1014, Block Group 1, Census Tract 5070.02, Santa Clara County, California",7,7,0
1000000US060855070021015,060855070021015,"Block 1015, Block Group 1, Census Tract 5070.02, Santa Clara County, California",0,0,0
1000000US060855070021016,060855070021016,"Block 1016, Block Group 1, Census Tract 5070.02, Santa Clara County, California",26,24,2
1000000US060855070021017,060855070021017,"Block 1017, Block Group 1, Census Tract 5070.02, Santa Clara County, California",36,34,2
1000000US060855070021018,060855070021018,"Block 1018, Block Group 1, Census Tract 5070.02, Santa Clara County, California",13,13,0
1000000US060855070021019,060855070021019,"Block 1019, Block Group 1, Census Tract 5070.02, Santa Clara County, California",65,59,6
1000000US060855070021020,060855070021020,"Block 1020, Block Group 1, Census Tract 5070.02, Santa Clara County, California",16,15,1
1000000US060855070021021,060855070021021,"Block 1021, Block Group 1, Census Tract 5070.02, Santa Clara County, California",37,36,1
1000000US060855070021022,060855070021022,"Block 1022, Block Group 1, Census Tract 5070.02, Santa Clara County, California",10,9,1
1000000US060855070021023,060855070021023,"Block 1023, Block Group 1, Census Tract 5070.02, Santa Clara County, California",7,7,0
1000000US060855070022000,060855070022000,"Block 2000, Block Group 2, Census Tract 5070.02, Santa Clara County, California",4,4,0
1000000US060855070022001,060855070022001,"Block 2001, Block Group 2, Census Tract 5070.02, Santa Clara County, California",18,15,3
1000000US060855070022002,060855070022002,"Block 2002, Block Group 2, Census Tract 5070.02, Santa Clara County, California",0,0,0
1000000US060855070022003,060855070022003,"Block 2003, Block Group 2, Census Tract 5070.02, Santa Clara County, California",0,0,0
1000000US060855070022004,060855070022004,"Block 2004, Block Group 2, Census Tract 5070.02, Santa Clara County, California",5,5,0
1000000US060855070022005,060855070022005,"Block 2005, Block Group 2, Census Tract 5070.02, Santa Clara County, California",1,1,0
1000000US060855070022006,060855070022006,"Block 2006, Block Group 2, Census Tract 5070.02, Santa Clara County, California",0,0,0
1000000US060855070022007,060855070022007,"Block 2007, Block Group 2, Census Tract 5070.02, Santa Clara County, California",0,0,0
1000000US060855070022008,060855070022008,"Block 2008, Block Group 2, Census Tract 5070.02, Santa Clara County, California",0,0,0
1000000US060855070022009,060855070022009,"Block 2009, Block Group 2, Census Tract 5070.02, Santa Clara County, California",1,1,0
1000000US060855070022010,060855070022010,"Block 2010, Block Group 2, Census Tract 5070.02, Santa Clara County, California",9,9,0
1000000US060855070022011,060855070022011,"Block 2011, Block Group 2, Census Tract 5070.02, Santa Clara County, California",0,0,0
1000000US060855070022012,060855070022012,"Block 2012, Block Group 2, Census Tract 5070.02, Santa Clara County, California",0,0,0
1000000US060855070022013,060855070022013,"Block 2013, Block Group 2, Census Tract 5070.02, Santa Clara County, California",54,45,9
1000000US060855070022014,060855070022014,"Block 2014, Block Group 2, Census Tract 5070.02, Santa Clara County, California",3,2,1
1000000US060855070022015,060855070022015,"Block 2015, Block Group 2, Census Tract 5070.02, Santa Clara County, California",0,0,0
1000000US060855070022016,060855070022016,"Block 2016, Block Group 2, Census Tract 5070.02, Santa Clara County, California",0,0,0
1000000US060855070022017,060855070022017,"Block 2017, Block Group 2, Census Tract 5070.02, Santa Clara County, California",6,6,0
1000000US060855070022018,060855070022018,"Block 2018, Block Group 2, Census Tract 5070.02, Santa Clara County, California",11,10,1
1000000US060855070022019,060855070022019,"Block 2019, Block Group 2, Census Tract 5070.02, Santa Clara County, California",0,0,0
1000000US060855070022020,060855070022020,"Block 2020, Block Group 2, Census Tract 5070.02, Santa Clara County, California",0,0,0
1000000US060855070022021,060855070022021,"Block 2021, Block Group 2, Census Tract 5070.02, Santa Clara County, California",4,4,0
1000000US060855070022022,060855070022022,"Block 2022, Block Group 2, Census Tract 5070.02, Santa Clara County, California",0,0,0
1000000US060855070022023,060855070022023,"Block 2023, Block Group 2, Census Tract 5070.02, Santa Clara County, California",0,0,0
1000000US060855070022024,060855070022024,"Block 2024, Block Group 2, Census Tract 5070.02, Santa Clara County, California",0,0,0
1000000US060855070022025,060855070022025,"Block 2025, Block Group 2, Census Tract 5070.02, Santa Clara County, California",0,0,0
1000000US060855070022026,060855070022026,"Block 2026, Block Group 2, Census Tract 5070.02, Santa Clara County, California",2,2,0
1000000US060855070022027,060855070022027,"Block 2027, Block Group 2, Census Tract 5070.02, Santa Clara County, California",1,1,0
1000000US060855070022028,060855070022028,"Block 2028, Block Group 2, Census Tract 5070.02, Santa Clara County, California",2,2,0
1000000US060855070022029,060855070022029,"Block 2029, Block Group 2, Census Tract 5070.02, Santa Clara County, California",32,32,0
1000000US060855070022030,060855070022030,"Block 2030, Block Group 2, Census Tract 5070.02, Santa Clara County, California",19,18,1
1000000US060855070022031,060855070022031,"Block 2031, Block Group 2, Census Tract 5070.02, Santa Clara County, California",46,44,2
1000000US060855070022032,060855070022032,"Block 2032, Block Group 2, Census Tract 5070.02, Santa Clara County, California",17,17,0
1000000US060855070022033,060855070022033,"Block 2033, Block Group 2, Census Tract 5070.02, Santa Clara County, California",24,23,1
1000000US060855070022034,060855070022034,"Block 2034, Block Group 2, Census Tract 5070.02, Santa Clara County, California",0,0,0
1000000US060855070022035,060855070022035,"Block 2035, Block Group 2, Census Tract 5070.02, Santa Clara County, California",1,1,0
1000000US060855070022036,060855070022036,"Block 2036, Block Group 2, Census Tract 5070.02, Santa Clara County, California",0,0,0
1000000US060855070022037,060855070022037,"Block 2037, Block Group 2, Census Tract 5070.02, Santa Clara County, California",0,0,0
1000000US060855070022038,060855070022038,"Block 2038, Block Group 2, Census Tract 5070.02, Santa Clara County, California",0,0,0
1000000US060855070022039,060855070022039,"Block 2039, Block Group 2, Census Tract 5070.02, Santa Clara County, California",0,0,0
1000000US060855070022040,060855070022040,"Block 2040, Block Group 2, Census Tract 5070.02, Santa Clara County, California",31,31,0
1000000US060855070022041,060855070022041,"Block 2041, Block Group 2, Census Tract 5070.02, Santa Clara County, California",1,1,0
1000000US060855070022042,060855070022042,"Block 2042, Block Group 2, Census Tract 5070.02, Santa Clara County, California",3,2,1
1000000US060855070022043,060855070022043,"Block 2043, Block Group 2, Census Tract 5070.02, Santa Clara County, California",1,1,0
1000000US060855070022044,060855070022044,"Block 2044, Block Group 2, Census Tract 5070.02, Santa Clara County, California",11,9,2
1000000US060855070022045,060855070022045,"Block 2045, Block Group 2, Census Tract 5070.02, Santa Clara County, California",1,1,0
1000000US060855070022046,060855070022046,"Block 2046, Block Group 2, Census Tract 5070.02, Santa Clara County, California",1,0,1
1000000US060855070022047,060855070022047,"Block 2047, Block Group 2, Census Tract 5070.02, Santa Clara County, California",3,3,0
1000000US060855070022048,060855070022048,"Block 2048, Block Group 2, Census Tract 5070.02, Santa Clara County, California",7,6,1
1000000US060855070022049,060855070022049,"Block 2049, Block Group 2, Census Tract 5070.02, Santa Clara County, California",1,1,0
1000000US060855070022050,060855070022050,"Block 2050, Block Group 2, Census Tract 5070.02, Santa Clara County, California",0,0,0
1000000US060855070022051,060855070022051,"Block 2051, Block Group 2, Census Tract 5070.02, Santa Clara County, California",4,4,0
1000000US060855070022052,060855070022052,"Block 2052, Block Group 2, Census Tract 5070.02, Santa Clara County, California",4,3,1
1000000US060855070022053,060855070022053,"Block 2053, Block Group 2, Census Tract 5070.02, Santa Clara County, California",1,1,0
1000000US060855070022054,060855070022054,"Block 2054, Block Group 2, Census Tract 5070.02, Santa Clara County, California",2,2,0
1000000US060855070022055,060855070022055,"Block 2055, Block Group 2, Census Tract 5070.02, Santa Clara County, California",0,0,0
1000000US060855070022056,060855070022056,"Block 2056, Block Group 2, Census Tract 5070.02, Santa Clara County, California",11,11,0
1000000US060855070022057,060855070022057,"Block 2057, Block Group 2, Census Tract 5070.02, Santa Clara County, California",0,0,0
1000000US060855070022058,060855070022058,"Block 2058, Block Group 2, Census Tract 5070.02, Santa Clara County, California",1,1,0
1000000US060855070022059,060855070022059,"Block 2059, Block Group 2, Census Tract 5070.02, Santa Clara County, California",0,0,0
1000000US060855071001000,060855071001000,"Block 1000, Block Group 1, Census Tract 5071, Santa Clara County, California",10,10,0
1000000US060855071001001,060855071001001,"Block 1001, Block Group 1, Census Tract 5071, Santa Clara County, California",0,0,0
1000000US060855071001002,060855071001002,"Block 1002, Block Group 1, Census Tract 5071, Santa Clara County, California",0,0,0
1000000US060855071001003,060855071001003,"Block 1003, Block Group 1, Census Tract 5071, Santa Clara County, California",0,0,0
1000000US060855071001004,060855071001004,"Block 1004, Block Group 1, Census Tract 5071, Santa Clara County, California",0,0,0
1000000US060855071001005,060855071001005,"Block 1005, Block Group 1, Census Tract 5071, Santa Clara County, California",0,0,0
1000000US060855071001006,060855071001006,"Block 1006, Block Group 1, Census Tract 5071, Santa Clara County, California",5,5,0
1000000US060855071001007,060855071001007,"Block 1007, Block Group 1, Census Tract 5071, Santa Clara County, California",5,5,0
1000000US060855071001008,060855071001008,"Block 1008, Block Group 1, Census Tract 5071, Santa Clara County, California",9,9,0
1000000US060855071001009,060855071001009,"Block 1009, Block Group 1, Census Tract 5071, Santa Clara County, California",44,41,3
1000000US060855071001010,060855071001010,"Block 1010, Block Group 1, Census Tract 5071, Santa Clara County, California",139,138,1
1000000US060855071001011,060855071001011,"Block 1011, Block Group 1, Census Tract 5071, Santa Clara County, California",4,2,2
1000000US060855071001012,060855071001012,"Block 1012, Block Group 1, Census Tract 5071, Santa Clara County, California",0,0,0
1000000US060855071001013,060855071001013,"Block 1013, Block Group 1, Census Tract 5071, Santa Clara County, California",2,2,0
1000000US060855071001014,060855071001014,"Block 1014, Block Group 1, Census Tract 5071, Santa Clara County, California",4,4,0
1000000US060855071001015,060855071001015,"Block 1015, Block Group 1, Census Tract 5071, Santa Clara County, California",0,0,0
1000000US060855071001016,060855071001016,"Block 1016, Block Group 1, Census Tract 5071, Santa Clara County, California",38,33,5
1000000US060855071001017,060855071001017,"Block 1017, Block Group 1, Census Tract 5071, Santa Clara County, California",8,8,0
1000000US060855071001018,060855071001018,"Block 1018, Block Group 1, Census Tract 5071, Santa Clara County, California",0,0,0
1000000US060855071001019,060855071001019,"Block 1019, Block Group 1, Census Tract 5071, Santa Clara County, California",0,0,0
1000000US060855071001020,060855071001020,"Block 1020, Block Group 1, Census Tract 5071, Santa Clara County, California",85,81,4
1000000US060855071001021,060855071001021,"Block 1021, Block Group 1, Census Tract 5071, Santa Clara County, California",0,0,0
1000000US060855071001022,060855071001022,"Block 1022, Block Group 1, Census Tract 5071, Santa Clara County, California",0,0,0
1000000US060855071001023,060855071001023,"Block 1023, Block Group 1, Census Tract 5071, Santa Clara County, California",23,22,1
1000000US060855071001024,060855071001024,"Block 1024, Block Group 1, Census Tract 5071, Santa Clara County, California",25,23,2
1000000US060855071001025,060855071001025,"Block 1025, Block Group 1, Census Tract 5071, Santa Clara County, California",23,22,1
1000000US060855071001026,060855071001026,"Block 1026, Block Group 1, Census Tract 5071, Santa Clara County, California",0,0,0
1000000US060855071001027,060855071001027,"Block 1027, Block Group 1, Census Tract 5071, Santa Clara County, California",1,1,0
1000000US060855071001028,060855071001028,"Block 1028, Block Group 1, Census Tract 5071, Santa Clara County, California",0,0,0
1000000US060855071001029,060855071001029,"Block 1029, Block Group 1, Census Tract 5071, Santa Clara County, California",16,15,1
1000000US060855071001030,060855071001030,"Block 1030, Block Group 1, Census Tract 5071, Santa Clara County, California",3,3,0
1000000US060855071001031,060855071001031,"Block 1031, Block Group 1, Census Tract 5071, Santa Clara County, California",0,0,0
1000000US060855071001032,060855071001032,"Block 1032, Block Group 1, Census Tract 5071, Santa Clara County, California",0,0,0
1000000US060855071002000,060855071002000,"Block 2000, Block Group 2, Census Tract 5071, Santa Clara County, California",0,0,0
1000000US060855071002001,060855071002001,"Block 2001, Block Group 2, Census Tract 5071, Santa Clara County, California",33,33,0
1000000US060855071002002,060855071002002,"Block 2002, Block Group 2, Census Tract 5071, Santa Clara County, California",0,0,0
1000000US060855071002003,060855071002003,"Block 2003, Block Group 2, Census Tract 5071, Santa Clara County, California",417,393,24
1000000US060855071002004,060855071002004,"Block 2004, Block Group 2, Census Tract 5071, Santa Clara County, California",8,8,0
1000000US060855071002005,060855071002005,"Block 2005, Block Group 2, Census Tract 5071, Santa Clara County, California",23,21,2
1000000US060855071002006,060855071002006,"Block 2006, Block Group 2, Census Tract 5071, Santa Clara County, California",56,52,4
1000000US060855071002007,060855071002007,"Block 2007, Block Group 2, Census Tract 5071, Santa Clara County, California",76,71,5
1000000US060855071002008,060855071002008,"Block 2008, Block Group 2, Census Tract 5071, Santa Clara County, California",5,5,0
1000000US060855071002009,060855071002009,"Block 2009, Block Group 2, Census Tract 5071, Santa Clara County, California",0,0,0
1000000US060855071002010,060855071002010,"Block 2010, Block Group 2, Census Tract 5071, Santa Clara County, California",61,61,0
1000000US060855071002011,060855071002011,"Block 2011, Block Group 2, Census Tract 5071, Santa Clara County, California",5,5,0
1000000US060855071002012,060855071002012,"Block 2012, Block Group 2, Census Tract 5071, Santa Clara County, California",2,2,0
1000000US060855071002013,060855071002013,"Block 2013, Block Group 2, Census Tract 5071, Santa Clara County, California",1,1,0
1000000US060855071002014,060855071002014,"Block 2014, Block Group 2, Census Tract 5071, Santa Clara County, California",21,19,2
1000000US060855071002015,060855071002015,"Block 2015, Block Group 2, Census Tract 5071, Santa Clara County, California",19,19,0
1000000US060855071002016,060855071002016,"Block 2016, Block Group 2, Census Tract 5071, Santa Clara County, California",1,1,0
1000000US060855071002017,060855071002017,"Block 2017, Block Group 2, Census Tract 5071, Santa Clara County, California",24,21,3
1000000US060855071002018,060855071002018,"Block 2018, Block Group 2, Census Tract 5071, Santa Clara County, California",14,12,2
1000000US060855071002019,060855071002019,"Block 2019, Block Group 2, Census Tract 5071, Santa Clara County, California",47,40,7
1000000US060855071002020,060855071002020,"Block 2020, Block Group 2, Census Tract 5071, Santa Clara County, California",30,28,2
1000000US060855071002021,060855071002021,"Block 2021, Block Group 2, Census Tract 5071, Santa Clara County, California",23,21,2
1000000US060855071002022,060855071002022,"Block 2022, Block Group 2, Census Tract 5071, Santa Clara County, California",0,0,0
1000000US060855071002023,060855071002023,"Block 2023, Block Group 2, Census Tract 5071, Santa Clara County, California",0,0,0
1000000US060855071002024,060855071002024,"Block 2024, Block Group 2, Census Tract 5071, Santa Clara County, California",36,33,3
1000000US060855071002025,060855071002025,"Block 2025, Block Group 2, Census Tract 5071, Santa Clara County, California",0,0,0
1000000US060855071002026,060855071002026,"Block 2026, Block Group 2, Census Tract 5071, Santa Clara County, California",31,28,3
1000000US060855072031000,060855072031000,"Block 1000, Block Group 1, Census Tract 5072.03, Santa Clara County, California",0,0,0
1000000US060855072031001,060855072031001,"Block 1001, Block Group 1, Census Tract 5072.03, Santa Clara County, California",4,2,2
1000000US060855072031002,060855072031002,"Block 1002, Block Group 1, Census Tract 5072.03, Santa Clara County, California",286,258,28
1000000US060855072031003,060855072031003,"Block 1003, Block Group 1, Census Tract 5072.03, Santa Clara County, California",46,46,0
1000000US060855072031004,060855072031004,"Block 1004, Block Group 1, Census Tract 5072.03, Santa Clara County, California",9,9,0
1000000US060855072031005,060855072031005,"Block 1005, Block Group 1, Census Tract 5072.03, Santa Clara County, California",18,16,2
1000000US060855072031006,060855072031006,"Block 1006, Block Group 1, Census Tract 5072.03, Santa Clara County, California",0,0,0
1000000US060855072031007,060855072031007,"Block 1007, Block Group 1, Census Tract 5072.03, Santa Clara County, California",0,0,0
1000000US060855072031008,060855072031008,"Block 1008, Block Group 1, Census Tract 5072.03, Santa Clara County, California",0,0,0
1000000US060855072031009,060855072031009,"Block 1009, Block Group 1, Census Tract 5072.03, Santa Clara County, California",0,0,0
1000000US060855072031010,060855072031010,"Block 1010, Block Group 1, Census Tract 5072.03, Santa Clara County, California",0,0,0
1000000US060855072031011,060855072031011,"Block 1011, Block Group 1, Census Tract 5072.03, Santa Clara County, California",0,0,0
1000000US060855072031012,060855072031012,"Block 1012, Block Group 1, Census Tract 5072.03, Santa Clara County, California",0,0,0
1000000US060855072031013,060855072031013,"Block 1013, Block Group 1, Census Tract 5072.03, Santa Clara County, California",0,0,0
1000000US060855072031014,060855072031014,"Block 1014, Block Group 1, Census Tract 5072.03, Santa Clara County, California",0,0,0
1000000US060855072031015,060855072031015,"Block 1015, Block Group 1, Census Tract 5072.03, Santa Clara County, California",0,0,0
1000000US060855072031016,060855072031016,"Block 1016, Block Group 1, Census Tract 5072.03, Santa Clara County, California",120,115,5
1000000US060855072031017,060855072031017,"Block 1017, Block Group 1, Census Tract 5072.03, Santa Clara County, California",0,0,0
1000000US060855072031018,060855072031018,"Block 1018, Block Group 1, Census Tract 5072.03, Santa Clara County, California",10,10,0
1000000US060855072031019,060855072031019,"Block 1019, Block Group 1, Census Tract 5072.03, Santa Clara County, California",7,7,0
1000000US060855072031020,060855072031020,"Block 1020, Block Group 1, Census Tract 5072.03, Santa Clara County, California",2,2,0
1000000US060855072031021,060855072031021,"Block 1021, Block Group 1, Census Tract 5072.03, Santa Clara County, California",41,38,3
1000000US060855072031022,060855072031022,"Block 1022, Block Group 1, Census Tract 5072.03, Santa Clara County, California",9,8,1
1000000US060855072031023,060855072031023,"Block 1023, Block Group 1, Census Tract 5072.03, Santa Clara County, California",0,0,0
1000000US060855072031024,060855072031024,"Block 1024, Block Group 1, Census Tract 5072.03, Santa Clara County, California",0,0,0
1000000US060855072031025,060855072031025,"Block 1025, Block Group 1, Census Tract 5072.03, Santa Clara County, California",0,0,0
1000000US060855072031026,060855072031026,"Block 1026, Block Group 1, Census Tract 5072.03, Santa Clara County, California",0,0,0
1000000US060855072031027,060855072031027,"Block 1027, Block Group 1, Census Tract 5072.03, Santa Clara County, California",0,0,0
1000000US060855072031028,060855072031028,"Block 1028, Block Group 1, Census Tract 5072.03, Santa Clara County, California",0,0,0
1000000US060855072031029,060855072031029,"Block 1029, Block Group 1, Census Tract 5072.03, Santa Clara County, California",0,0,0
1000000US060855072031030,060855072031030,"Block 1030, Block Group 1, Census Tract 5072.03, Santa Clara County, California",0,0,0
1000000US060855072031031,060855072031031,"Block 1031, Block Group 1, Census Tract 5072.03, Santa Clara County, California",0,0,0
1000000US060855072031032,060855072031032,"Block 1032, Block Group 1, Census Tract 5072.03, Santa Clara County, California",0,0,0
1000000US060855072031033,060855072031033,"Block 1033, Block Group 1, Census Tract 5072.03, Santa Clara County, California",99,93,6
1000000US060855072031034,060855072031034,"Block 1034, Block Group 1, Census Tract 5072.03, Santa Clara County, California",0,0,0
1000000US060855072031035,060855072031035,"Block 1035, Block Group 1, Census Tract 5072.03, Santa Clara County, California",0,0,0
1000000US060855072031036,060855072031036,"Block 1036, Block Group 1, Census Tract 5072.03, Santa Clara County, California",0,0,0
1000000US060855072031037,060855072031037,"Block 1037, Block Group 1, Census Tract 5072.03, Santa Clara County, California",9,9,0
1000000US060855072032000,060855072032000,"Block 2000, Block Group 2, Census Tract 5072.03, Santa Clara County, California",0,0,0
1000000US060855072032001,060855072032001,"Block 2001, Block Group 2, Census Tract 5072.03, Santa Clara County, California",0,0,0
1000000US060855072032002,060855072032002,"Block 2002, Block Group 2, Census Tract 5072.03, Santa Clara County, California",0,0,0
1000000US060855072032003,060855072032003,"Block 2003, Block Group 2, Census Tract 5072.03, Santa Clara County, California",0,0,0
1000000US060855072032004,060855072032004,"Block 2004, Block Group 2, Census Tract 5072.03, Santa Clara County, California",113,102,11
1000000US060855072032005,060855072032005,"Block 2005, Block Group 2, Census Tract 5072.03, Santa Clara County, California",4,4,0
1000000US060855072032006,060855072032006,"Block 2006, Block Group 2, Census Tract 5072.03, Santa Clara County, California",41,41,0
1000000US060855072032007,060855072032007,"Block 2007, Block Group 2, Census Tract 5072.03, Santa Clara County, California",27,26,1
1000000US060855072032008,060855072032008,"Block 2008, Block Group 2, Census Tract 5072.03, Santa Clara County, California",3,3,0
1000000US060855072032009,060855072032009,"Block 2009, Block Group 2, Census Tract 5072.03, Santa Clara County, California",17,16,1
1000000US060855072032010,060855072032010,"Block 2010, Block Group 2, Census Tract 5072.03, Santa Clara County, California",18,17,1
1000000US060855072032011,060855072032011,"Block 2011, Block Group 2, Census Tract 5072.03, Santa Clara County, California",17,16,1
1000000US060855072032012,060855072032012,"Block 2012, Block Group 2, Census Tract 5072.03, Santa Clara County, California",68,62,6
1000000US060855072032013,060855072032013,"Block 2013, Block Group 2, Census Tract 5072.03, Santa Clara County, California",30,28,2
1000000US060855072032014,060855072032014,"Block 2014, Block Group 2, Census Tract 5072.03, Santa Clara County, California",10,10,0
1000000US060855072032015,060855072032015,"Block 2015, Block Group 2, Census Tract 5072.03, Santa Clara County, California",36,35,1
1000000US060855072032016,060855072032016,"Block 2016, Block Group 2, Census Tract 5072.03, Santa Clara County, California",15,14,1
1000000US060855072032017,060855072032017,"Block 2017, Block Group 2, Census Tract 5072.03, Santa Clara County, California",28,28,0
1000000US060855072032018,060855072032018,"Block 2018, Block Group 2, Census Tract 5072.03, Santa Clara County, California",48,47,1
1000000US060855072032019,060855072032019,"Block 2019, Block Group 2, Census Tract 5072.03, Santa Clara County, California",0,0,0
1000000US060855072032020,060855072032020,"Block 2020, Block Group 2, Census Tract 5072.03, Santa Clara County, California",0,0,0
1000000US060855072032021,060855072032021,"Block 2021, Block Group 2, Census Tract 5072.03, Santa Clara County, California",46,46,0
1000000US060855072032022,060855072032022,"Block 2022, Block Group 2, Census Tract 5072.03, Santa Clara County, California",0,0,0
1000000US060855072032023,060855072032023,"Block 2023, Block Group 2, Census Tract 5072.03, Santa Clara County, California",0,0,0
1000000US060855072032024,060855072032024,"Block 2024, Block Group 2, Census Tract 5072.03, Santa Clara County, California",0,0,0
1000000US060855072032025,060855072032025,"Block 2025, Block Group 2, Census Tract 5072.03, Santa Clara County, California",22,22,0
1000000US060855072032026,060855072032026,"Block 2026, Block Group 2, Census Tract 5072.03, Santa Clara County, California",0,0,0
1000000US060855072051000,060855072051000,"Block 1000, Block Group 1, Census Tract 5072.05, Santa Clara County, California",0,0,0
1000000US060855072051001,060855072051001,"Block 1001, Block Group 1, Census Tract 5072.05, Santa Clara County, California",87,77,10
1000000US060855072051002,060855072051002,"Block 1002, Block Group 1, Census Tract 5072.05, Santa Clara County, California",46,42,4
1000000US060855072051003,060855072051003,"Block 1003, Block Group 1, Census Tract 5072.05, Santa Clara County, California",30,27,3
1000000US060855072051004,060855072051004,"Block 1004, Block Group 1, Census Tract 5072.05, Santa Clara County, California",0,0,0
1000000US060855072051005,060855072051005,"Block 1005, Block Group 1, Census Tract 5072.05, Santa Clara County, California",0,0,0
1000000US060855072051006,060855072051006,"Block 1006, Block Group 1, Census Tract 5072.05, Santa Clara County, California",0,0,0
1000000US060855072051007,060855072051007,"Block 1007, Block Group 1, Census Tract 5072.05, Santa Clara County, California",0,0,0
1000000US060855072051008,060855072051008,"Block 1008, Block Group 1, Census Tract 5072.05, Santa Clara County, California",36,35,1
1000000US060855072051009,060855072051009,"Block 1009, Block Group 1, Census Tract 5072.05, Santa Clara County, California",34,34,0
1000000US060855072051010,060855072051010,"Block 1010, Block Group 1, Census Tract 5072.05, Santa Clara County, California",19,19,0
1000000US060855072052000,060855072052000,"Block 2000, Block Group 2, Census Tract 5072.05, Santa Clara County, California",78,76,2
1000000US060855072052001,060855072052001,"Block 2001, Block Group 2, Census Tract 5072.05, Santa Clara County, California",27,27,0
1000000US060855072052002,060855072052002,"Block 2002, Block Group 2, Census Tract 5072.05, Santa Clara County, California",29,28,1
1000000US060855072052003,060855072052003,"Block 2003, Block Group 2, Census Tract 5072.05, Santa Clara County, California",0,0,0
1000000US060855072052004,060855072052004,"Block 2004, Block Group 2, Census Tract 5072.05, Santa Clara County, California",38,36,2
1000000US060855072052005,060855072052005,"Block 2005, Block Group 2, Census Tract 5072.05, Santa Clara County, California",0,0,0
1000000US060855072052006,060855072052006,"Block 2006, Block Group 2, Census Tract 5072.05, Santa Clara County, California",0,0,0
1000000US060855072052007,060855072052007,"Block 2007, Block Group 2, Census Tract 5072.05, Santa Clara County, California",48,45,3
1000000US060855072052008,060855072052008,"Block 2008, Block Group 2, Census Tract 5072.05, Santa Clara County, California",6,6,0
1000000US060855072052009,060855072052009,"Block 2009, Block Group 2, Census Tract 5072.05, Santa Clara County, California",8,8,0
1000000US060855072052010,060855072052010,"Block 2010, Block Group 2, Census Tract 5072.05, Santa Clara County, California",0,0,0
1000000US060855072052011,060855072052011,"Block 2011, Block Group 2, Census Tract 5072.05, Santa Clara County, California",0,0,0
1000000US060855072052012,060855072052012,"Block 2012, Block Group 2, Census Tract 5072.05, Santa Clara County, California",22,22,0
1000000US060855072052013,060855072052013,"Block 2013, Block Group 2, Census Tract 5072.05, Santa Clara County, California",277,267,10
1000000US060855072052014,060855072052014,"Block 2014, Block Group 2, Census Tract 5072.05, Santa Clara County, California",0,0,0
1000000US060855072052015,060855072052015,"Block 2015, Block Group 2, Census Tract 5072.05, Santa Clara County, California",0,0,0
1000000US060855072052016,060855072052016,"Block 2016, Block Group 2, Census Tract 5072.05, Santa Clara County, California",0,0,0
1000000US060855072052017,060855072052017,"Block 2017, Block Group 2, Census Tract 5072.05, Santa Clara County, California",196,192,4
1000000US060855072052018,060855072052018,"Block 2018, Block Group 2, Census Tract 5072.05, Santa Clara County, California",0,0,0
1000000US060855072052019,060855072052019,"Block 2019, Block Group 2, Census Tract 5072.05, Santa Clara County, California",0,0,0
1000000US060855072052020,060855072052020,"Block 2020, Block Group 2, Census Tract 5072.05, Santa Clara County, California",51,47,4
1000000US060855072052021,060855072052021,"Block 2021, Block Group 2, Census Tract 5072.05, Santa Clara County, California",0,0,0
1000000US060855072052022,060855072052022,"Block 2022, Block Group 2, Census Tract 5072.05, Santa Clara County, California",0,0,0
1000000US060855072052023,060855072052023,"Block 2023, Block Group 2, Census Tract 5072.05, Santa Clara County, California",0,0,0
1000000US060855072052024,060855072052024,"Block 2024, Block Group 2, Census Tract 5072.05, Santa Clara County, California",0,0,0
1000000US060855072052025,060855072052025,"Block 2025, Block Group 2, Census Tract 5072.05, Santa Clara County, California",0,0,0
1000000US060855072052026,060855072052026,"Block 2026, Block Group 2, Census Tract 5072.05, Santa Clara County, California",0,0,0
1000000US060855072052027,060855072052027,"Block 2027, Block Group 2, Census Tract 5072.05, Santa Clara County, California",0,0,0
1000000US060855072052028,060855072052028,"Block 2028, Block Group 2, Census Tract 5072.05, Santa Clara County, California",1,1,0
1000000US060855072052029,060855072052029,"Block 2029, Block Group 2, Census Tract 5072.05, Santa Clara County, California",0,0,0
1000000US060855072053000,060855072053000,"Block 3000, Block Group 3, Census Tract 5072.05, Santa Clara County, California",0,0,0
1000000US060855072053001,060855072053001,"Block 3001, Block Group 3, Census Tract 5072.05, Santa Clara County, California",5,5,0
1000000US060855072053002,060855072053002,"Block 3002, Block Group 3, Census Tract 5072.05, Santa Clara County, California",83,74,9
1000000US060855072053003,060855072053003,"Block 3003, Block Group 3, Census Tract 5072.05, Santa Clara County, California",148,133,15
1000000US060855072053004,060855072053004,"Block 3004, Block Group 3, Census Tract 5072.05, Santa Clara County, California",0,0,0
1000000US060855072053005,060855072053005,"Block 3005, Block Group 3, Census Tract 5072.05, Santa Clara County, California",0,0,0
1000000US060855072053006,060855072053006,"Block 3006, Block Group 3, Census Tract 5072.05, Santa Clara County, California",39,38,1
1000000US060855072053007,060855072053007,"Block 3007, Block Group 3, Census Tract 5072.05, Santa Clara County, California",23,22,1
1000000US060855072053008,060855072053008,"Block 3008, Block Group 3, Census Tract 5072.05, Santa Clara County, California",15,15,0
1000000US060855072053009,060855072053009,"Block 3009, Block Group 3, Census Tract 5072.05, Santa Clara County, California",1,1,0
1000000US060855072053010,060855072053010,"Block 3010, Block Group 3, Census Tract 5072.05, Santa Clara County, California",15,15,0
1000000US060855072053011,060855072053011,"Block 3011, Block Group 3, Census Tract 5072.05, Santa Clara County, California",1,1,0
1000000US060855072053012,060855072053012,"Block 3012, Block Group 3, Census Tract 5072.05, Santa Clara County, California",52,51,1
1000000US060855072053013,060855072053013,"Block 3013, Block Group 3, Census Tract 5072.05, Santa Clara County, California",0,0,0
1000000US060855072053014,060855072053014,"Block 3014, Block Group 3, Census Tract 5072.05, Santa Clara County, California",97,94,3
1000000US060855072053015,060855072053015,"Block 3015, Block Group 3, Census Tract 5072.05, Santa Clara County, California",16,16,0
1000000US060855072053016,060855072053016,"Block 3016, Block Group 3, Census Tract 5072.05, Santa Clara County, California",0,0,0
1000000US060855072053017,060855072053017,"Block 3017, Block Group 3, Census Tract 5072.05, Santa Clara County, California",34,33,1
1000000US060855072053018,060855072053018,"Block 3018, Block Group 3, Census Tract 5072.05, Santa Clara County, California",15,14,1
1000000US060855072053019,060855072053019,"Block 3019, Block Group 3, Census Tract 5072.05, Santa Clara County, California",1,1,0
1000000US060855072053020,060855072053020,"Block 3020, Block Group 3, Census Tract 5072.05, Santa Clara County, California",9,6,3
1000000US060855072053021,060855072053021,"Block 3021, Block Group 3, Census Tract 5072.05, Santa Clara County, California",6,6,0
1000000US060855072053022,060855072053022,"Block 3022, Block Group 3, Census Tract 5072.05, Santa Clara County, California",0,0,0
1000000US060855072053023,060855072053023,"Block 3023, Block Group 3, Census Tract 5072.05, Santa Clara County, California",3,3,0
1000000US060855072053024,060855072053024,"Block 3024, Block Group 3, Census Tract 5072.05, Santa Clara County, California",18,17,1
1000000US060855072053025,060855072053025,"Block 3025, Block Group 3, Census Tract 5072.05, Santa Clara County, California",3,3,0
1000000US060855072053026,060855072053026,"Block 3026, Block Group 3, Census Tract 5072.05, Santa Clara County, California",9,9,0
1000000US060855072053027,060855072053027,"Block 3027, Block Group 3, Census Tract 5072.05, Santa Clara County, California",7,7,0
1000000US060855072053028,060855072053028,"Block 3028, Block Group 3, Census Tract 5072.05, Santa Clara County, California",9,7,2
1000000US060855072053029,060855072053029,"Block 3029, Block Group 3, Census Tract 5072.05, Santa Clara County, California",1,1,0
1000000US060855072053030,060855072053030,"Block 3030, Block Group 3, Census Tract 5072.05, Santa Clara County, California",16,16,0
1000000US060855072053031,060855072053031,"Block 3031, Block Group 3, Census Tract 5072.05, Santa Clara County, California",0,0,0
1000000US060855072053032,060855072053032,"Block 3032, Block Group 3, Census Tract 5072.05, Santa Clara County, California",3,3,0
1000000US060855072053033,060855072053033,"Block 3033, Block Group 3, Census Tract 5072.05, Santa Clara County, California",9,8,1
1000000US060855072054000,060855072054000,"Block 4000, Block Group 4, Census Tract 5072.05, Santa Clara County, California",0,0,0
1000000US060855072054001,060855072054001,"Block 4001, Block Group 4, Census Tract 5072.05, Santa Clara County, California",15,15,0
1000000US060855072054002,060855072054002,"Block 4002, Block Group 4, Census Tract 5072.05, Santa Clara County, California",12,11,1
1000000US060855072054003,060855072054003,"Block 4003, Block Group 4, Census Tract 5072.05, Santa Clara County, California",0,0,0
1000000US060855072054004,060855072054004,"Block 4004, Block Group 4, Census Tract 5072.05, Santa Clara County, California",0,0,0
1000000US060855072054005,060855072054005,"Block 4005, Block Group 4, Census Tract 5072.05, Santa Clara County, California",19,18,1
1000000US060855072054006,060855072054006,"Block 4006, Block Group 4, Census Tract 5072.05, Santa Clara County, California",33,32,1
1000000US060855072054007,060855072054007,"Block 4007, Block Group 4, Census Tract 5072.05, Santa Clara County, California",21,21,0
1000000US060855072054008,060855072054008,"Block 4008, Block Group 4, Census Tract 5072.05, Santa Clara County, California",59,59,0
1000000US060855072054009,060855072054009,"Block 4009, Block Group 4, Census Tract 5072.05, Santa Clara County, California",47,46,1
1000000US060855072054010,060855072054010,"Block 4010, Block Group 4, Census Tract 5072.05, Santa Clara County, California",52,52,0
1000000US060855072054011,060855072054011,"Block 4011, Block Group 4, Census Tract 5072.05, Santa Clara County, California",22,22,0
1000000US060855072054012,060855072054012,"Block 4012, Block Group 4, Census Tract 5072.05, Santa Clara County, California",5,4,1
1000000US060855072054013,060855072054013,"Block 4013, Block Group 4, Census Tract 5072.05, Santa Clara County, California",5,5,0
1000000US060855072054014,060855072054014,"Block 4014, Block Group 4, Census Tract 5072.05, Santa Clara County, California",0,0,0
1000000US060855072054015,060855072054015,"Block 4015, Block Group 4, Census Tract 5072.05, Santa Clara County, California",0,0,0
1000000US060855072061000,060855072061000,"Block 1000, Block Group 1, Census Tract 5072.06, Santa Clara County, California",47,46,1
1000000US060855072061001,060855072061001,"Block 1001, Block Group 1, Census Tract 5072.06, Santa Clara County, California",7,7,0
1000000US060855072061002,060855072061002,"Block 1002, Block Group 1, Census Tract 5072.06, Santa Clara County, California",16,16,0
1000000US060855072061003,060855072061003,"Block 1003, Block Group 1, Census Tract 5072.06, Santa Clara County, California",30,28,2
1000000US060855072061004,060855072061004,"Block 1004, Block Group 1, Census Tract 5072.06, Santa Clara County, California",61,59,2
1000000US060855072061005,060855072061005,"Block 1005, Block Group 1, Census Tract 5072.06, Santa Clara County, California",7,7,0
1000000US060855072061006,060855072061006,"Block 1006, Block Group 1, Census Tract 5072.06, Santa Clara County, California",13,11,2
1000000US060855072061007,060855072061007,"Block 1007, Block Group 1, Census Tract 5072.06, Santa Clara County, California",134,128,6
1000000US060855072061008,060855072061008,"Block 1008, Block Group 1, Census Tract 5072.06, Santa Clara County, California",10,10,0
1000000US060855072061009,060855072061009,"Block 1009, Block Group 1, Census Tract 5072.06, Santa Clara County, California",6,5,1
1000000US060855072061010,060855072061010,"Block 1010, Block Group 1, Census Tract 5072.06, Santa Clara County, California",38,34,4
1000000US060855072061011,060855072061011,"Block 1011, Block Group 1, Census Tract 5072.06, Santa Clara County, California",17,17,0
1000000US060855072061012,060855072061012,"Block 1012, Block Group 1, Census Tract 5072.06, Santa Clara County, California",0,0,0
1000000US060855072061013,060855072061013,"Block 1013, Block Group 1, Census Tract 5072.06, Santa Clara County, California",0,0,0
1000000US060855072061014,060855072061014,"Block 1014, Block Group 1, Census Tract 5072.06, Santa Clara County, California",33,32,1
1000000US060855072061015,060855072061015,"Block 1015, Block Group 1, Census Tract 5072.06, Santa Clara County, California",3,2,1
1000000US060855072061016,060855072061016,"Block 1016, Block Group 1, Census Tract 5072.06, Santa Clara County, California",43,41,2
1000000US060855072061017,060855072061017,"Block 1017, Block Group 1, Census Tract 5072.06, Santa Clara County, California",0,0,0
1000000US060855072061018,060855072061018,"Block 1018, Block Group 1, Census Tract 5072.06, Santa Clara County, California",23,23,0
1000000US060855072061019,060855072061019,"Block 1019, Block Group 1, Census Tract 5072.06, Santa Clara County, California",8,8,0
1000000US060855072061020,060855072061020,"Block 1020, Block Group 1, Census Tract 5072.06, Santa Clara County, California",0,0,0
1000000US060855072061021,060855072061021,"Block 1021, Block Group 1, Census Tract 5072.06, Santa Clara County, California",2,2,0
1000000US060855072061022,060855072061022,"Block 1022, Block Group 1, Census Tract 5072.06, Santa Clara County, California",7,6,1
1000000US060855072061023,060855072061023,"Block 1023, Block Group 1, Census Tract 5072.06, Santa Clara County, California",3,3,0
1000000US060855072061024,060855072061024,"Block 1024, Block Group 1, Census Tract 5072.06, Santa Clara County, California",8,8,0
1000000US060855072061025,060855072061025,"Block 1025, Block Group 1, Census Tract 5072.06, Santa Clara County, California",8,8,0
1000000US060855072061026,060855072061026,"Block 1026, Block Group 1, Census Tract 5072.06, Santa Clara County, California",10,10,0
1000000US060855072061027,060855072061027,"Block 1027, Block Group 1, Census Tract 5072.06, Santa Clara County, California",0,0,0
1000000US060855072061028,060855072061028,"Block 1028, Block Group 1, Census Tract 5072.06, Santa Clara County, California",0,0,0
1000000US060855072061029,060855072061029,"Block 1029, Block Group 1, Census Tract 5072.06, Santa Clara County, California",6,6,0
1000000US060855072061030,060855072061030,"Block 1030, Block Group 1, Census Tract 5072.06, Santa Clara County, California",2,2,0
1000000US060855072061031,060855072061031,"Block 1031, Block Group 1, Census Tract 5072.06, Santa Clara County, California",0,0,0
1000000US060855072061032,060855072061032,"Block 1032, Block Group 1, Census Tract 5072.06, Santa Clara County, California",0,0,0
1000000US060855072062000,060855072062000,"Block 2000, Block Group 2, Census Tract 5072.06, Santa Clara County, California",39,36,3
1000000US060855072062001,060855072062001,"Block 2001, Block Group 2, Census Tract 5072.06, Santa Clara County, California",53,51,2
1000000US060855072062002,060855072062002,"Block 2002, Block Group 2, Census Tract 5072.06, Santa Clara County, California",0,0,0
1000000US060855072062003,060855072062003,"Block 2003, Block Group 2, Census Tract 5072.06, Santa Clara County, California",24,23,1
1000000US060855072062004,060855072062004,"Block 2004, Block Group 2, Census Tract 5072.06, Santa Clara County, California",22,21,1
1000000US060855072062005,060855072062005,"Block 2005, Block Group 2, Census Tract 5072.06, Santa Clara County, California",177,160,17
1000000US060855072062006,060855072062006,"Block 2006, Block Group 2, Census Tract 5072.06, Santa Clara County, California",0,0,0
1000000US060855072062007,060855072062007,"Block 2007, Block Group 2, Census Tract 5072.06, Santa Clara County, California",0,0,0
1000000US060855072062008,060855072062008,"Block 2008, Block Group 2, Census Tract 5072.06, Santa Clara County, California",0,0,0
1000000US060855072062009,060855072062009,"Block 2009, Block Group 2, Census Tract 5072.06, Santa Clara County, California",3,3,0
1000000US060855072062010,060855072062010,"Block 2010, Block Group 2, Census Tract 5072.06, Santa Clara County, California",35,34,1
1000000US060855072062011,060855072062011,"Block 2011, Block Group 2, Census Tract 5072.06, Santa Clara County, California",19,18,1
1000000US060855072062012,060855072062012,"Block 2012, Block Group 2, Census Tract 5072.06, Santa Clara County, California",12,12,0
1000000US060855072062013,060855072062013,"Block 2013, Block Group 2, Census Tract 5072.06, Santa Clara County, California",47,44,3
1000000US060855072062014,060855072062014,"Block 2014, Block Group 2, Census Tract 5072.06, Santa Clara County, California",25,24,1
1000000US060855072062015,060855072062015,"Block 2015, Block Group 2, Census Tract 5072.06, Santa Clara County, California",10,10,0
1000000US060855072062016,060855072062016,"Block 2016, Block Group 2, Census Tract 5072.06, Santa Clara County, California",2,2,0
1000000US060855072062017,060855072062017,"Block 2017, Block Group 2, Census Tract 5072.06, Santa Clara County, California",16,16,0
1000000US060855072062018,060855072062018,"Block 2018, Block Group 2, Census Tract 5072.06, Santa Clara County, California",7,7,0
1000000US060855072062019,060855072062019,"Block 2019, Block Group 2, Census Tract 5072.06, Santa Clara County, California",3,3,0
1000000US060855073011000,060855073011000,"Block 1000, Block Group 1, Census Tract 5073.01, Santa Clara County, California",0,0,0
1000000US060855073011001,060855073011001,"Block 1001, Block Group 1, Census Tract 5073.01, Santa Clara County, California",0,0,0
1000000US060855073011002,060855073011002,"Block 1002, Block Group 1, Census Tract 5073.01, Santa Clara County, California",0,0,0
1000000US060855073011003,060855073011003,"Block 1003, Block Group 1, Census Tract 5073.01, Santa Clara County, California",0,0,0
1000000US060855073011004,060855073011004,"Block 1004, Block Group 1, Census Tract 5073.01, Santa Clara County, California",0,0,0
1000000US060855073011005,060855073011005,"Block 1005, Block Group 1, Census Tract 5073.01, Santa Clara County, California",43,43,0
1000000US060855073011006,060855073011006,"Block 1006, Block Group 1, Census Tract 5073.01, Santa Clara County, California",35,35,0
1000000US060855073011007,060855073011007,"Block 1007, Block Group 1, Census Tract 5073.01, Santa Clara County, California",12,12,0
1000000US060855073011008,060855073011008,"Block 1008, Block Group 1, Census Tract 5073.01, Santa Clara County, California",42,41,1
1000000US060855073011009,060855073011009,"Block 1009, Block Group 1, Census Tract 5073.01, Santa Clara County, California",12,12,0
1000000US060855073011010,060855073011010,"Block 1010, Block Group 1, Census Tract 5073.01, Santa Clara County, California",105,103,2
1000000US060855073011011,060855073011011,"Block 1011, Block Group 1, Census Tract 5073.01, Santa Clara County, California",29,29,0
1000000US060855073012000,060855073012000,"Block 2000, Block Group 2, Census Tract 5073.01, Santa Clara County, California",49,47,2
1000000US060855073012001,060855073012001,"Block 2001, Block Group 2, Census Tract 5073.01, Santa Clara County, California",11,10,1
1000000US060855073012002,060855073012002,"Block 2002, Block Group 2, Census Tract 5073.01, Santa Clara County, California",1,1,0
1000000US060855073012003,060855073012003,"Block 2003, Block Group 2, Census Tract 5073.01, Santa Clara County, California",7,7,0
1000000US060855073012004,060855073012004,"Block 2004, Block Group 2, Census Tract 5073.01, Santa Clara County, California",11,11,0
1000000US060855073012005,060855073012005,"Block 2005, Block Group 2, Census Tract 5073.01, Santa Clara County, California",114,110,4
1000000US060855073012006,060855073012006,"Block 2006, Block Group 2, Census Tract 5073.01, Santa Clara County, California",10,9,1
1000000US060855073012007,060855073012007,"Block 2007, Block Group 2, Census Tract 5073.01, Santa Clara County, California",39,38,1
1000000US060855073012008,060855073012008,"Block 2008, Block Group 2, Census Tract 5073.01, Santa Clara County, California",82,79,3
1000000US060855073012009,060855073012009,"Block 2009, Block Group 2, Census Tract 5073.01, Santa Clara County, California",0,0,0
1000000US060855073012010,060855073012010,"Block 2010, Block Group 2, Census Tract 5073.01, Santa Clara County, California",19,19,0
1000000US060855073012011,060855073012011,"Block 2011, Block Group 2, Census Tract 5073.01, Santa Clara County, California",0,0,0
1000000US060855073012012,060855073012012,"Block 2012, Block Group 2, Census Tract 5073.01, Santa Clara County, California",46,43,3
1000000US060855073012013,060855073012013,"Block 2013, Block Group 2, Census Tract 5073.01, Santa Clara County, California",5,5,0
1000000US060855073012014,060855073012014,"Block 2014, Block Group 2, Census Tract 5073.01, Santa Clara County, California",37,37,0
1000000US060855073012015,060855073012015,"Block 2015, Block Group 2, Census Tract 5073.01, Santa Clara County, California",1,1,0
1000000US060855073012016,060855073012016,"Block 2016, Block Group 2, Census Tract 5073.01, Santa Clara County, California",0,0,0
1000000US060855073012017,060855073012017,"Block 2017, Block Group 2, Census Tract 5073.01, Santa Clara County, California",0,0,0
1000000US060855073012018,060855073012018,"Block 2018, Block Group 2, Census Tract 5073.01, Santa Clara County, California",0,0,0
1000000US060855073012019,060855073012019,"Block 2019, Block Group 2, Census Tract 5073.01, Santa Clara County, California",0,0,0
1000000US060855073012020,060855073012020,"Block 2020, Block Group 2, Census Tract 5073.01, Santa Clara County, California",0,0,0
1000000US060855073012021,060855073012021,"Block 2021, Block Group 2, Census Tract 5073.01, Santa Clara County, California",0,0,0
1000000US060855073012022,060855073012022,"Block 2022, Block Group 2, Census Tract 5073.01, Santa Clara County, California",0,0,0
1000000US060855073012023,060855073012023,"Block 2023, Block Group 2, Census Tract 5073.01, Santa Clara County, California",0,0,0
1000000US060855073012024,060855073012024,"Block 2024, Block Group 2, Census Tract 5073.01, Santa Clara County, California",0,0,0
1000000US060855073012025,060855073012025,"Block 2025, Block Group 2, Census Tract 5073.01, Santa Clara County, California",0,0,0
1000000US060855073012026,060855073012026,"Block 2026, Block Group 2, Census Tract 5073.01, Santa Clara County, California",0,0,0
1000000US060855073012027,060855073012027,"Block 2027, Block Group 2, Census Tract 5073.01, Santa Clara County, California",0,0,0
1000000US060855073012028,060855073012028,"Block 2028, Block Group 2, Census Tract 5073.01, Santa Clara County, California",15,14,1
1000000US060855073012029,060855073012029,"Block 2029, Block Group 2, Census Tract 5073.01, Santa Clara County, California",22,18,4
1000000US060855073013000,060855073013000,"Block 3000, Block Group 3, Census Tract 5073.01, Santa Clara County, California",0,0,0
1000000US060855073013001,060855073013001,"Block 3001, Block Group 3, Census Tract 5073.01, Santa Clara County, California",79,77,2
1000000US060855073013002,060855073013002,"Block 3002, Block Group 3, Census Tract 5073.01, Santa Clara County, California",18,18,0
1000000US060855073013003,060855073013003,"Block 3003, Block Group 3, Census Tract 5073.01, Santa Clara County, California",0,0,0
1000000US060855073013004,060855073013004,"Block 3004, Block Group 3, Census Tract 5073.01, Santa Clara County, California",0,0,0
1000000US060855073013005,060855073013005,"Block 3005, Block Group 3, Census Tract 5073.01, Santa Clara County, California",22,22,0
1000000US060855073013006,060855073013006,"Block 3006, Block Group 3, Census Tract 5073.01, Santa Clara County, California",58,56,2
1000000US060855073013007,060855073013007,"Block 3007, Block Group 3, Census Tract 5073.01, Santa Clara County, California",10,9,1
1000000US060855073013008,060855073013008,"Block 3008, Block Group 3, Census Tract 5073.01, Santa Clara County, California",67,66,1
1000000US060855073013009,060855073013009,"Block 3009, Block Group 3, Census Tract 5073.01, Santa Clara County, California",0,0,0
1000000US060855073013010,060855073013010,"Block 3010, Block Group 3, Census Tract 5073.01, Santa Clara County, California",0,0,0
1000000US060855073013011,060855073013011,"Block 3011, Block Group 3, Census Tract 5073.01, Santa Clara County, California",27,25,2
1000000US060855073013012,060855073013012,"Block 3012, Block Group 3, Census Tract 5073.01, Santa Clara County, California",0,0,0
1000000US060855073013013,060855073013013,"Block 3013, Block Group 3, Census Tract 5073.01, Santa Clara County, California",4,4,0
1000000US060855073014000,060855073014000,"Block 4000, Block Group 4, Census Tract 5073.01, Santa Clara County, California",184,176,8
1000000US060855073014001,060855073014001,"Block 4001, Block Group 4, Census Tract 5073.01, Santa Clara County, California",16,15,1
1000000US060855073014002,060855073014002,"Block 4002, Block Group 4, Census Tract 5073.01, Santa Clara County, California",21,21,0
1000000US060855073014003,060855073014003,"Block 4003, Block Group 4, Census Tract 5073.01, Santa Clara County, California",18,18,0
1000000US060855073014004,060855073014004,"Block 4004, Block Group 4, Census Tract 5073.01, Santa Clara County, California",29,27,2
1000000US060855073014005,060855073014005,"Block 4005, Block Group 4, Census Tract 5073.01, Santa Clara County, California",0,0,0
1000000US060855073014006,060855073014006,"Block 4006, Block Group 4, Census Tract 5073.01, Santa Clara County, California",0,0,0
1000000US060855073014007,060855073014007,"Block 4007, Block Group 4, Census Tract 5073.01, Santa Clara County, California",0,0,0
1000000US060855073014008,060855073014008,"Block 4008, Block Group 4, Census Tract 5073.01, Santa Clara County, California",0,0,0
1000000US060855073014009,060855073014009,"Block 4009, Block Group 4, Census Tract 5073.01, Santa Clara County, California",0,0,0
1000000US060855073014010,060855073014010,"Block 4010, Block Group 4, Census Tract 5073.01, Santa Clara County, California",0,0,0
1000000US060855073015000,060855073015000,"Block 5000, Block Group 5, Census Tract 5073.01, Santa Clara County, California",45,44,1
1000000US060855073015001,060855073015001,"Block 5001, Block Group 5, Census Tract 5073.01, Santa Clara County, California",31,29,2
1000000US060855073015002,060855073015002,"Block 5002, Block Group 5, Census Tract 5073.01, Santa Clara County, California",47,47,0
1000000US060855073015003,060855073015003,"Block 5003, Block Group 5, Census Tract 5073.01, Santa Clara County, California",0,0,0
1000000US060855073015004,060855073015004,"Block 5004, Block Group 5, Census Tract 5073.01, Santa Clara County, California",25,24,1
1000000US060855073015005,060855073015005,"Block 5005, Block Group 5, Census Tract 5073.01, Santa Clara County, California",0,0,0
1000000US060855073015006,060855073015006,"Block 5006, Block Group 5, Census Tract 5073.01, Santa Clara County, California",0,0,0
1000000US060855073015007,060855073015007,"Block 5007, Block Group 5, Census Tract 5073.01, Santa Clara County, California",6,5,1
1000000US060855073015008,060855073015008,"Block 5008, Block Group 5, Census Tract 5073.01, Santa Clara County, California",8,8,0
1000000US060855073015009,060855073015009,"Block 5009, Block Group 5, Census Tract 5073.01, Santa Clara County, California",139,132,7
1000000US060855073015010,060855073015010,"Block 5010, Block Group 5, Census Tract 5073.01, Santa Clara County, California",3,2,1
1000000US060855073015011,060855073015011,"Block 5011, Block Group 5, Census Tract 5073.01, Santa Clara County, California",0,0,0
1000000US060855073015012,060855073015012,"Block 5012, Block Group 5, Census Tract 5073.01, Santa Clara County, California",0,0,0
1000000US060855073015013,060855073015013,"Block 5013, Block Group 5, Census Tract 5073.01, Santa Clara County, California",9,9,0
1000000US060855073015014,060855073015014,"Block 5014, Block Group 5, Census Tract 5073.01, Santa Clara County, California",1,1,0
1000000US060855073015015,060855073015015,"Block 5015, Block Group 5, Census Tract 5073.01, Santa Clara County, California",0,0,0
1000000US060855073015016,060855073015016,"Block 5016, Block Group 5, Census Tract 5073.01, Santa Clara County, California",0,0,0
1000000US060855073015017,060855073015017,"Block 5017, Block Group 5, Census Tract 5073.01, Santa Clara County, California",43,43,0
1000000US060855073015018,060855073015018,"Block 5018, Block Group 5, Census Tract 5073.01, Santa Clara County, California",124,118,6
1000000US060855073015019,060855073015019,"Block 5019, Block Group 5, Census Tract 5073.01, Santa Clara County, California",12,12,0
1000000US060855073015020,060855073015020,"Block 5020, Block Group 5, Census Tract 5073.01, Santa Clara County, California",2,2,0
1000000US060855073015021,060855073015021,"Block 5021, Block Group 5, Census Tract 5073.01, Santa Clara County, California",11,11,0
1000000US060855073015022,060855073015022,"Block 5022, Block Group 5, Census Tract 5073.01, Santa Clara County, California",11,11,0
1000000US060855073015023,060855073015023,"Block 5023, Block Group 5, Census Tract 5073.01, Santa Clara County, California",0,0,0
1000000US060855073015024,060855073015024,"Block 5024, Block Group 5, Census Tract 5073.01, Santa Clara County, California",14,11,3
1000000US060855073015025,060855073015025,"Block 5025, Block Group 5, Census Tract 5073.01, Santa Clara County, California",4,3,1
1000000US060855073015026,060855073015026,"Block 5026, Block Group 5, Census Tract 5073.01, Santa Clara County, California",24,23,1
1000000US060855073015027,060855073015027,"Block 5027, Block Group 5, Census Tract 5073.01, Santa Clara County, California",0,0,0
1000000US060855073015028,060855073015028,"Block 5028, Block Group 5, Census Tract 5073.01, Santa Clara County, California",0,0,0
1000000US060855073015029,060855073015029,"Block 5029, Block Group 5, Census Tract 5073.01, Santa Clara County, California",0,0,0
1000000US060855073015030,060855073015030,"Block 5030, Block Group 5, Census Tract 5073.01, Santa Clara County, California",2,1,1
1000000US060855073015031,060855073015031,"Block 5031, Block Group 5, Census Tract 5073.01, Santa Clara County, California",3,3,0
1000000US060855073015032,060855073015032,"Block 5032, Block Group 5, Census Tract 5073.01, Santa Clara County, California",4,4,0
1000000US060855073015033,060855073015033,"Block 5033, Block Group 5, Census Tract 5073.01, Santa Clara County, California",6,6,0
1000000US060855073015034,060855073015034,"Block 5034, Block Group 5, Census Tract 5073.01, Santa Clara County, California",3,3,0
1000000US060855073016000,060855073016000,"Block 6000, Block Group 6, Census Tract 5073.01, Santa Clara County, California",42,42,0
1000000US060855073016001,060855073016001,"Block 6001, Block Group 6, Census Tract 5073.01, Santa Clara County, California",1,1,0
1000000US060855073016002,060855073016002,"Block 6002, Block Group 6, Census Tract 5073.01, Santa Clara County, California",24,23,1
1000000US060855073016003,060855073016003,"Block 6003, Block Group 6, Census Tract 5073.01, Santa Clara County, California",3,3,0
1000000US060855073016004,060855073016004,"Block 6004, Block Group 6, Census Tract 5073.01, Santa Clara County, California",497,482,15
1000000US060855073016005,060855073016005,"Block 6005, Block Group 6, Census Tract 5073.01, Santa Clara County, California",0,0,0
1000000US060855073016006,060855073016006,"Block 6006, Block Group 6, Census Tract 5073.01, Santa Clara County, California",0,0,0
1000000US060855073016007,060855073016007,"Block 6007, Block Group 6, Census Tract 5073.01, Santa Clara County, California",0,0,0
1000000US060855073016008,060855073016008,"Block 6008, Block Group 6, Census Tract 5073.01, Santa Clara County, California",11,11,0
1000000US060855073016009,060855073016009,"Block 6009, Block Group 6, Census Tract 5073.01, Santa Clara County, California",0,0,0
1000000US060855073016010,060855073016010,"Block 6010, Block Group 6, Census Tract 5073.01, Santa Clara County, California",3,2,1
1000000US060855073016011,060855073016011,"Block 6011, Block Group 6, Census Tract 5073.01, Santa Clara County, California",0,0,0
1000000US060855073016012,060855073016012,"Block 6012, Block Group 6, Census Tract 5073.01, Santa Clara County, California",1,1,0
1000000US060855073016013,060855073016013,"Block 6013, Block Group 6, Census Tract 5073.01, Santa Clara County, California",29,27,2
1000000US060855073016014,060855073016014,"Block 6014, Block Group 6, Census Tract 5073.01, Santa Clara County, California",2,2,0
1000000US060855073016015,060855073016015,"Block 6015, Block Group 6, Census Tract 5073.01, Santa Clara County, California",21,18,3
1000000US060855073016016,060855073016016,"Block 6016, Block Group 6, Census Tract 5073.01, Santa Clara County, California",0,0,0
1000000US060855073016017,060855073016017,"Block 6017, Block Group 6, Census Tract 5073.01, Santa Clara County, California",8,8,0
1000000US060855073016018,060855073016018,"Block 6018, Block Group 6, Census Tract 5073.01, Santa Clara County, California",2,2,0
1000000US060855073016019,060855073016019,"Block 6019, Block Group 6, Census Tract 5073.01, Santa Clara County, California",6,6,0
1000000US060855073016020,060855073016020,"Block 6020, Block Group 6, Census Tract 5073.01, Santa Clara County, California",25,24,1
1000000US060855073016021,060855073016021,"Block 6021, Block Group 6, Census Tract 5073.01, Santa Clara County, California",0,0,0
1000000US060855073016022,060855073016022,"Block 6022, Block Group 6, Census Tract 5073.01, Santa Clara County, California",0,0,0
1000000US060855073016023,060855073016023,"Block 6023, Block Group 6, Census Tract 5073.01, Santa Clara County, California",1,1,0
1000000US060855073021000,060855073021000,"Block 1000, Block Group 1, Census Tract 5073.02, Santa Clara County, California",8,8,0
1000000US060855073021001,060855073021001,"Block 1001, Block Group 1, Census Tract 5073.02, Santa Clara County, California",18,18,0
1000000US060855073021002,060855073021002,"Block 1002, Block Group 1, Census Tract 5073.02, Santa Clara County, California",4,3,1
1000000US060855073021003,060855073021003,"Block 1003, Block Group 1, Census Tract 5073.02, Santa Clara County, California",15,14,1
1000000US060855073021004,060855073021004,"Block 1004, Block Group 1, Census Tract 5073.02, Santa Clara County, California",46,39,7
1000000US060855073021005,060855073021005,"Block 1005, Block Group 1, Census Tract 5073.02, Santa Clara County, California",36,35,1
1000000US060855073021006,060855073021006,"Block 1006, Block Group 1, Census Tract 5073.02, Santa Clara County, California",74,71,3
1000000US060855073021007,060855073021007,"Block 1007, Block Group 1, Census Tract 5073.02, Santa Clara County, California",24,23,1
1000000US060855073021008,060855073021008,"Block 1008, Block Group 1, Census Tract 5073.02, Santa Clara County, California",23,23,0
1000000US060855073021009,060855073021009,"Block 1009, Block Group 1, Census Tract 5073.02, Santa Clara County, California",24,21,3
1000000US060855073021010,060855073021010,"Block 1010, Block Group 1, Census Tract 5073.02, Santa Clara County, California",2,2,0
1000000US060855073021011,060855073021011,"Block 1011, Block Group 1, Census Tract 5073.02, Santa Clara County, California",10,10,0
1000000US060855073021012,060855073021012,"Block 1012, Block Group 1, Census Tract 5073.02, Santa Clara County, California",0,0,0
1000000US060855073021013,060855073021013,"Block 1013, Block Group 1, Census Tract 5073.02, Santa Clara County, California",31,27,4
1000000US060855073021014,060855073021014,"Block 1014, Block Group 1, Census Tract 5073.02, Santa Clara County, California",63,60,3
1000000US060855073021015,060855073021015,"Block 1015, Block Group 1, Census Tract 5073.02, Santa Clara County, California",0,0,0
1000000US060855073021016,060855073021016,"Block 1016, Block Group 1, Census Tract 5073.02, Santa Clara County, California",8,8,0
1000000US060855073021017,060855073021017,"Block 1017, Block Group 1, Census Tract 5073.02, Santa Clara County, California",76,68,8
1000000US060855073021018,060855073021018,"Block 1018, Block Group 1, Census Tract 5073.02, Santa Clara County, California",11,10,1
1000000US060855073021019,060855073021019,"Block 1019, Block Group 1, Census Tract 5073.02, Santa Clara County, California",45,44,1
1000000US060855073021020,060855073021020,"Block 1020, Block Group 1, Census Tract 5073.02, Santa Clara County, California",0,0,0
1000000US060855073021021,060855073021021,"Block 1021, Block Group 1, Census Tract 5073.02, Santa Clara County, California",1,1,0
1000000US060855073021022,060855073021022,"Block 1022, Block Group 1, Census Tract 5073.02, Santa Clara County, California",0,0,0
1000000US060855073021023,060855073021023,"Block 1023, Block Group 1, Census Tract 5073.02, Santa Clara County, California",51,47,4
1000000US060855073021024,060855073021024,"Block 1024, Block Group 1, Census Tract 5073.02, Santa Clara County, California",0,0,0
1000000US060855073021025,060855073021025,"Block 1025, Block Group 1, Census Tract 5073.02, Santa Clara County, California",0,0,0
1000000US060855073021026,060855073021026,"Block 1026, Block Group 1, Census Tract 5073.02, Santa Clara County, California",1,1,0
1000000US060855073021027,060855073021027,"Block 1027, Block Group 1, Census Tract 5073.02, Santa Clara County, California",43,42,1
1000000US060855073021028,060855073021028,"Block 1028, Block Group 1, Census Tract 5073.02, Santa Clara County, California",0,0,0
1000000US060855073021029,060855073021029,"Block 1029, Block Group 1, Census Tract 5073.02, Santa Clara County, California",1,0,1
1000000US060855073021030,060855073021030,"Block 1030, Block Group 1, Census Tract 5073.02, Santa Clara County, California",11,7,4
1000000US060855073021031,060855073021031,"Block 1031, Block Group 1, Census Tract 5073.02, Santa Clara County, California",0,0,0
1000000US060855073021032,060855073021032,"Block 1032, Block Group 1, Census Tract 5073.02, Santa Clara County, California",1,1,0
1000000US060855073021033,060855073021033,"Block 1033, Block Group 1, Census Tract 5073.02, Santa Clara County, California",0,0,0
1000000US060855073021034,060855073021034,"Block 1034, Block Group 1, Census Tract 5073.02, Santa Clara County, California",9,7,2
1000000US060855073021035,060855073021035,"Block 1035, Block Group 1, Census Tract 5073.02, Santa Clara County, California",24,21,3
1000000US060855073021036,060855073021036,"Block 1036, Block Group 1, Census Tract 5073.02, Santa Clara County, California",3,3,0
1000000US060855073021037,060855073021037,"Block 1037, Block Group 1, Census Tract 5073.02, Santa Clara County, California",1,1,0
1000000US060855073021038,060855073021038,"Block 1038, Block Group 1, Census Tract 5073.02, Santa Clara County, California",2,2,0
1000000US060855073021039,060855073021039,"Block 1039, Block Group 1, Census Tract 5073.02, Santa Clara County, California",17,16,1
1000000US060855073021040,060855073021040,"Block 1040, Block Group 1, Census Tract 5073.02, Santa Clara County, California",0,0,0
1000000US060855073021041,060855073021041,"Block 1041, Block Group 1, Census Tract 5073.02, Santa Clara County, California",10,9,1
1000000US060855073021042,060855073021042,"Block 1042, Block Group 1, Census Tract 5073.02, Santa Clara County, California",14,13,1
1000000US060855073021043,060855073021043,"Block 1043, Block Group 1, Census Tract 5073.02, Santa Clara County, California",9,9,0
1000000US060855073021044,060855073021044,"Block 1044, Block Group 1, Census Tract 5073.02, Santa Clara County, California",1,1,0
1000000US060855073021045,060855073021045,"Block 1045, Block Group 1, Census Tract 5073.02, Santa Clara County, California",22,19,3
1000000US060855073021046,060855073021046,"Block 1046, Block Group 1, Census Tract 5073.02, Santa Clara County, California",3,3,0
1000000US060855073022000,060855073022000,"Block 2000, Block Group 2, Census Tract 5073.02, Santa Clara County, California",45,45,0
1000000US060855073022001,060855073022001,"Block 2001, Block Group 2, Census Tract 5073.02, Santa Clara County, California",0,0,0
1000000US060855073022002,060855073022002,"Block 2002, Block Group 2, Census Tract 5073.02, Santa Clara County, California",14,14,0
1000000US060855073022003,060855073022003,"Block 2003, Block Group 2, Census Tract 5073.02, Santa Clara County, California",26,25,1
1000000US060855073022004,060855073022004,"Block 2004, Block Group 2, Census Tract 5073.02, Santa Clara County, California",21,21,0
1000000US060855073022005,060855073022005,"Block 2005, Block Group 2, Census Tract 5073.02, Santa Clara County, California",34,33,1
1000000US060855073022006,060855073022006,"Block 2006, Block Group 2, Census Tract 5073.02, Santa Clara County, California",0,0,0
1000000US060855073022007,060855073022007,"Block 2007, Block Group 2, Census Tract 5073.02, Santa Clara County, California",0,0,0
1000000US060855073022008,060855073022008,"Block 2008, Block Group 2, Census Tract 5073.02, Santa Clara County, California",5,5,0
1000000US060855073022009,060855073022009,"Block 2009, Block Group 2, Census Tract 5073.02, Santa Clara County, California",8,7,1
1000000US060855073022010,060855073022010,"Block 2010, Block Group 2, Census Tract 5073.02, Santa Clara County, California",0,0,0
1000000US060855073022011,060855073022011,"Block 2011, Block Group 2, Census Tract 5073.02, Santa Clara County, California",91,83,8
1000000US060855073022012,060855073022012,"Block 2012, Block Group 2, Census Tract 5073.02, Santa Clara County, California",8,8,0
1000000US060855073022013,060855073022013,"Block 2013, Block Group 2, Census Tract 5073.02, Santa Clara County, California",1,1,0
1000000US060855073022014,060855073022014,"Block 2014, Block Group 2, Census Tract 5073.02, Santa Clara County, California",12,11,1
1000000US060855073022015,060855073022015,"Block 2015, Block Group 2, Census Tract 5073.02, Santa Clara County, California",4,3,1
1000000US060855073022016,060855073022016,"Block 2016, Block Group 2, Census Tract 5073.02, Santa Clara County, California",3,2,1
1000000US060855073022017,060855073022017,"Block 2017, Block Group 2, Census Tract 5073.02, Santa Clara County, California",0,0,0
1000000US060855073022018,060855073022018,"Block 2018, Block Group 2, Census Tract 5073.02, Santa Clara County, California",4,4,0
1000000US060855073022019,060855073022019,"Block 2019, Block Group 2, Census Tract 5073.02, Santa Clara County, California",15,14,1
1000000US060855073022020,060855073022020,"Block 2020, Block Group 2, Census Tract 5073.02, Santa Clara County, California",0,0,0
1000000US060855073022021,060855073022021,"Block 2021, Block Group 2, Census Tract 5073.02, Santa Clara County, California",27,26,1
1000000US060855073022022,060855073022022,"Block 2022, Block Group 2, Census Tract 5073.02, Santa Clara County, California",6,6,0
1000000US060855073022023,060855073022023,"Block 2023, Block Group 2, Census Tract 5073.02, Santa Clara County, California",8,8,0
1000000US060855073022024,060855073022024,"Block 2024, Block Group 2, Census Tract 5073.02, Santa Clara County, California",6,6,0
1000000US060855073022025,060855073022025,"Block 2025, Block Group 2, Census Tract 5073.02, Santa Clara County, California",9,8,1
1000000US060855073022026,060855073022026,"Block 2026, Block Group 2, Census Tract 5073.02, Santa Clara County, California",0,0,0
1000000US060855073022027,060855073022027,"Block 2027, Block Group 2, Census Tract 5073.02, Santa Clara County, California",2,1,1
1000000US060855073022028,060855073022028,"Block 2028, Block Group 2, Census Tract 5073.02, Santa Clara County, California",0,0,0
1000000US060855074011000,060855074011000,"Block 1000, Block Group 1, Census Tract 5074.01, Santa Clara County, California",68,65,3
1000000US060855074011001,060855074011001,"Block 1001, Block Group 1, Census Tract 5074.01, Santa Clara County, California",26,26,0
1000000US060855074011002,060855074011002,"Block 1002, Block Group 1, Census Tract 5074.01, Santa Clara County, California",0,0,0
1000000US060855074011003,060855074011003,"Block 1003, Block Group 1, Census Tract 5074.01, Santa Clara County, California",0,0,0
1000000US060855074011004,060855074011004,"Block 1004, Block Group 1, Census Tract 5074.01, Santa Clara County, California",10,10,0
1000000US060855074011005,060855074011005,"Block 1005, Block Group 1, Census Tract 5074.01, Santa Clara County, California",0,0,0
1000000US060855074011006,060855074011006,"Block 1006, Block Group 1, Census Tract 5074.01, Santa Clara County, California",29,29,0
1000000US060855074011007,060855074011007,"Block 1007, Block Group 1, Census Tract 5074.01, Santa Clara County, California",1,1,0
1000000US060855074011008,060855074011008,"Block 1008, Block Group 1, Census Tract 5074.01, Santa Clara County, California",23,23,0
1000000US060855074011009,060855074011009,"Block 1009, Block Group 1, Census Tract 5074.01, Santa Clara County, California",8,8,0
1000000US060855074011010,060855074011010,"Block 1010, Block Group 1, Census Tract 5074.01, Santa Clara County, California",64,64,0
1000000US060855074011011,060855074011011,"Block 1011, Block Group 1, Census Tract 5074.01, Santa Clara County, California",0,0,0
1000000US060855074011012,060855074011012,"Block 1012, Block Group 1, Census Tract 5074.01, Santa Clara County, California",19,18,1
1000000US060855074011013,060855074011013,"Block 1013, Block Group 1, Census Tract 5074.01, Santa Clara County, California",0,0,0
1000000US060855074011014,060855074011014,"Block 1014, Block Group 1, Census Tract 5074.01, Santa Clara County, California",0,0,0
1000000US060855074011015,060855074011015,"Block 1015, Block Group 1, Census Tract 5074.01, Santa Clara County, California",59,59,0
1000000US060855074011016,060855074011016,"Block 1016, Block Group 1, Census Tract 5074.01, Santa Clara County, California",0,0,0
1000000US060855074011017,060855074011017,"Block 1017, Block Group 1, Census Tract 5074.01, Santa Clara County, California",18,18,0
1000000US060855074011018,060855074011018,"Block 1018, Block Group 1, Census Tract 5074.01, Santa Clara County, California",0,0,0
1000000US060855074011019,060855074011019,"Block 1019, Block Group 1, Census Tract 5074.01, Santa Clara County, California",19,19,0
1000000US060855074011020,060855074011020,"Block 1020, Block Group 1, Census Tract 5074.01, Santa Clara County, California",48,48,0
1000000US060855074012000,060855074012000,"Block 2000, Block Group 2, Census Tract 5074.01, Santa Clara County, California",82,78,4
1000000US060855074012001,060855074012001,"Block 2001, Block Group 2, Census Tract 5074.01, Santa Clara County, California",5,5,0
1000000US060855074012002,060855074012002,"Block 2002, Block Group 2, Census Tract 5074.01, Santa Clara County, California",35,35,0
1000000US060855074012003,060855074012003,"Block 2003, Block Group 2, Census Tract 5074.01, Santa Clara County, California",25,25,0
1000000US060855074012004,060855074012004,"Block 2004, Block Group 2, Census Tract 5074.01, Santa Clara County, California",23,23,0
1000000US060855074012005,060855074012005,"Block 2005, Block Group 2, Census Tract 5074.01, Santa Clara County, California",0,0,0
1000000US060855074012006,060855074012006,"Block 2006, Block Group 2, Census Tract 5074.01, Santa Clara County, California",21,21,0
1000000US060855074012007,060855074012007,"Block 2007, Block Group 2, Census Tract 5074.01, Santa Clara County, California",28,28,0
1000000US060855074012008,060855074012008,"Block 2008, Block Group 2, Census Tract 5074.01, Santa Clara County, California",127,125,2
1000000US060855074012009,060855074012009,"Block 2009, Block Group 2, Census Tract 5074.01, Santa Clara County, California",9,9,0
1000000US060855074012010,060855074012010,"Block 2010, Block Group 2, Census Tract 5074.01, Santa Clara County, California",0,0,0
1000000US060855074012011,060855074012011,"Block 2011, Block Group 2, Census Tract 5074.01, Santa Clara County, California",14,14,0
1000000US060855074012012,060855074012012,"Block 2012, Block Group 2, Census Tract 5074.01, Santa Clara County, California",0,0,0
1000000US060855074012013,060855074012013,"Block 2013, Block Group 2, Census Tract 5074.01, Santa Clara County, California",10,10,0
1000000US060855074012014,060855074012014,"Block 2014, Block Group 2, Census Tract 5074.01, Santa Clara County, California",18,17,1
1000000US060855074012015,060855074012015,"Block 2015, Block Group 2, Census Tract 5074.01, Santa Clara County, California",0,0,0
1000000US060855074012016,060855074012016,"Block 2016, Block Group 2, Census Tract 5074.01, Santa Clara County, California",0,0,0
1000000US060855074012017,060855074012017,"Block 2017, Block Group 2, Census Tract 5074.01, Santa Clara County, California",0,0,0
1000000US060855074013000,060855074013000,"Block 3000, Block Group 3, Census Tract 5074.01, Santa Clara County, California",123,118,5
1000000US060855074013001,060855074013001,"Block 3001, Block Group 3, Census Tract 5074.01, Santa Clara County, California",0,0,0
1000000US060855074013002,060855074013002,"Block 3002, Block Group 3, Census Tract 5074.01, Santa Clara County, California",16,15,1
1000000US060855074013003,060855074013003,"Block 3003, Block Group 3, Census Tract 5074.01, Santa Clara County, California",0,0,0
1000000US060855074013004,060855074013004,"Block 3004, Block Group 3, Census Tract 5074.01, Santa Clara County, California",35,33,2
1000000US060855074013005,060855074013005,"Block 3005, Block Group 3, Census Tract 5074.01, Santa Clara County, California",18,17,1
1000000US060855074013006,060855074013006,"Block 3006, Block Group 3, Census Tract 5074.01, Santa Clara County, California",29,29,0
1000000US060855074013007,060855074013007,"Block 3007, Block Group 3, Census Tract 5074.01, Santa Clara County, California",38,38,0
1000000US060855074013008,060855074013008,"Block 3008, Block Group 3, Census Tract 5074.01, Santa Clara County, California",4,4,0
1000000US060855074013009,060855074013009,"Block 3009, Block Group 3, Census Tract 5074.01, Santa Clara County, California",29,28,1
1000000US060855074013010,060855074013010,"Block 3010, Block Group 3, Census Tract 5074.01, Santa Clara County, California",8,8,0
1000000US060855074013011,060855074013011,"Block 3011, Block Group 3, Census Tract 5074.01, Santa Clara County, California",18,18,0
1000000US060855074013012,060855074013012,"Block 3012, Block Group 3, Census Tract 5074.01, Santa Clara County, California",18,18,0
1000000US060855074013013,060855074013013,"Block 3013, Block Group 3, Census Tract 5074.01, Santa Clara County, California",15,15,0
1000000US060855074013014,060855074013014,"Block 3014, Block Group 3, Census Tract 5074.01, Santa Clara County, California",0,0,0
1000000US060855074013015,060855074013015,"Block 3015, Block Group 3, Census Tract 5074.01, Santa Clara County, California",0,0,0
1000000US060855074013016,060855074013016,"Block 3016, Block Group 3, Census Tract 5074.01, Santa Clara County, California",0,0,0
1000000US060855074013017,060855074013017,"Block 3017, Block Group 3, Census Tract 5074.01, Santa Clara County, California",26,26,0
1000000US060855074013018,060855074013018,"Block 3018, Block Group 3, Census Tract 5074.01, Santa Clara County, California",52,51,1
1000000US060855074013019,060855074013019,"Block 3019, Block Group 3, Census Tract 5074.01, Santa Clara County, California",32,30,2
1000000US060855074013020,060855074013020,"Block 3020, Block Group 3, Census Tract 5074.01, Santa Clara County, California",7,7,0
1000000US060855074013021,060855074013021,"Block 3021, Block Group 3, Census Tract 5074.01, Santa Clara County, California",6,6,0
1000000US060855074014000,060855074014000,"Block 4000, Block Group 4, Census Tract 5074.01, Santa Clara County, California",45,44,1
1000000US060855074014001,060855074014001,"Block 4001, Block Group 4, Census Tract 5074.01, Santa Clara County, California",25,25,0
1000000US060855074014002,060855074014002,"Block 4002, Block Group 4, Census Tract 5074.01, Santa Clara County, California",29,29,0
1000000US060855074014003,060855074014003,"Block 4003, Block Group 4, Census Tract 5074.01, Santa Clara County, California",27,27,0
1000000US060855074014004,060855074014004,"Block 4004, Block Group 4, Census Tract 5074.01, Santa Clara County, California",32,31,1
1000000US060855074014005,060855074014005,"Block 4005, Block Group 4, Census Tract 5074.01, Santa Clara County, California",38,38,0
1000000US060855074014006,060855074014006,"Block 4006, Block Group 4, Census Tract 5074.01, Santa Clara County, California",12,12,0
1000000US060855074014007,060855074014007,"Block 4007, Block Group 4, Census Tract 5074.01, Santa Clara County, California",37,37,0
1000000US060855074014008,060855074014008,"Block 4008, Block Group 4, Census Tract 5074.01, Santa Clara County, California",27,26,1
1000000US060855074014009,060855074014009,"Block 4009, Block Group 4, Census Tract 5074.01, Santa Clara County, California",16,16,0
1000000US060855074014010,060855074014010,"Block 4010, Block Group 4, Census Tract 5074.01, Santa Clara County, California",15,15,0
1000000US060855074014011,060855074014011,"Block 4011, Block Group 4, Census Tract 5074.01, Santa Clara County, California",29,28,1
1000000US060855074014012,060855074014012,"Block 4012, Block Group 4, Census Tract 5074.01, Santa Clara County, California",24,23,1
1000000US060855074014013,060855074014013,"Block 4013, Block Group 4, Census Tract 5074.01, Santa Clara County, California",19,19,0
1000000US060855074014014,060855074014014,"Block 4014, Block Group 4, Census Tract 5074.01, Santa Clara County, California",19,19,0
1000000US060855074014015,060855074014015,"Block 4015, Block Group 4, Census Tract 5074.01, Santa Clara County, California",18,18,0
1000000US060855074015000,060855074015000,"Block 5000, Block Group 5, Census Tract 5074.01, Santa Clara County, California",7,7,0
1000000US060855074015001,060855074015001,"Block 5001, Block Group 5, Census Tract 5074.01, Santa Clara County, California",14,13,1
1000000US060855074015002,060855074015002,"Block 5002, Block Group 5, Census Tract 5074.01, Santa Clara County, California",25,25,0
1000000US060855074015003,060855074015003,"Block 5003, Block Group 5, Census Tract 5074.01, Santa Clara County, California",7,7,0
1000000US060855074015004,060855074015004,"Block 5004, Block Group 5, Census Tract 5074.01, Santa Clara County, California",6,6,0
1000000US060855074015005,060855074015005,"Block 5005, Block Group 5, Census Tract 5074.01, Santa Clara County, California",29,28,1
1000000US060855074015006,060855074015006,"Block 5006, Block Group 5, Census Tract 5074.01, Santa Clara County, California",31,31,0
1000000US060855074015007,060855074015007,"Block 5007, Block Group 5, Census Tract 5074.01, Santa Clara County, California",23,22,1
1000000US060855074015008,060855074015008,"Block 5008, Block Group 5, Census Tract 5074.01, Santa Clara County, California",10,10,0
1000000US060855074015009,060855074015009,"Block 5009, Block Group 5, Census Tract 5074.01, Santa Clara County, California",11,11,0
1000000US060855074015010,060855074015010,"Block 5010, Block Group 5, Census Tract 5074.01, Santa Clara County, California",1,1,0
1000000US060855074015011,060855074015011,"Block 5011, Block Group 5, Census Tract 5074.01, Santa Clara County, California",12,12,0
1000000US060855074015012,060855074015012,"Block 5012, Block Group 5, Census Tract 5074.01, Santa Clara County, California",0,0,0
1000000US060855074015013,060855074015013,"Block 5013, Block Group 5, Census Tract 5074.01, Santa Clara County, California",15,15,0
1000000US060855074015014,060855074015014,"Block 5014, Block Group 5, Census Tract 5074.01, Santa Clara County, California",35,35,0
1000000US060855074015015,060855074015015,"Block 5015, Block Group 5, Census Tract 5074.01, Santa Clara County, California",30,30,0
1000000US060855074015016,060855074015016,"Block 5016, Block Group 5, Census Tract 5074.01, Santa Clara County, California",0,0,0
1000000US060855074015017,060855074015017,"Block 5017, Block Group 5, Census Tract 5074.01, Santa Clara County, California",0,0,0
1000000US060855074015018,060855074015018,"Block 5018, Block Group 5, Census Tract 5074.01, Santa Clara County, California",16,16,0
1000000US060855074015019,060855074015019,"Block 5019, Block Group 5, Census Tract 5074.01, Santa Clara County, California",0,0,0
1000000US060855074021000,060855074021000,"Block 1000, Block Group 1, Census Tract 5074.02, Santa Clara County, California",12,11,1
1000000US060855074021001,060855074021001,"Block 1001, Block Group 1, Census Tract 5074.02, Santa Clara County, California",20,20,0
1000000US060855074021002,060855074021002,"Block 1002, Block Group 1, Census Tract 5074.02, Santa Clara County, California",106,101,5
1000000US060855074021003,060855074021003,"Block 1003, Block Group 1, Census Tract 5074.02, Santa Clara County, California",105,97,8
1000000US060855074021004,060855074021004,"Block 1004, Block Group 1, Census Tract 5074.02, Santa Clara County, California",0,0,0
1000000US060855074021005,060855074021005,"Block 1005, Block Group 1, Census Tract 5074.02, Santa Clara County, California",0,0,0
1000000US060855074021006,060855074021006,"Block 1006, Block Group 1, Census Tract 5074.02, Santa Clara County, California",10,10,0
1000000US060855074021007,060855074021007,"Block 1007, Block Group 1, Census Tract 5074.02, Santa Clara County, California",0,0,0
1000000US060855074021008,060855074021008,"Block 1008, Block Group 1, Census Tract 5074.02, Santa Clara County, California",0,0,0
1000000US060855074021009,060855074021009,"Block 1009, Block Group 1, Census Tract 5074.02, Santa Clara County, California",3,3,0
1000000US060855074021010,060855074021010,"Block 1010, Block Group 1, Census Tract 5074.02, Santa Clara County, California",0,0,0
1000000US060855074021011,060855074021011,"Block 1011, Block Group 1, Census Tract 5074.02, Santa Clara County, California",0,0,0
1000000US060855074021012,060855074021012,"Block 1012, Block Group 1, Census Tract 5074.02, Santa Clara County, California",27,26,1
1000000US060855074021013,060855074021013,"Block 1013, Block Group 1, Census Tract 5074.02, Santa Clara County, California",0,0,0
1000000US060855074021014,060855074021014,"Block 1014, Block Group 1, Census Tract 5074.02, Santa Clara County, California",15,15,0
1000000US060855074021015,060855074021015,"Block 1015, Block Group 1, Census Tract 5074.02, Santa Clara County, California",0,0,0
1000000US060855074021016,060855074021016,"Block 1016, Block Group 1, Census Tract 5074.02, Santa Clara County, California",44,43,1
1000000US060855074021017,060855074021017,"Block 1017, Block Group 1, Census Tract 5074.02, Santa Clara County, California",32,31,1
1000000US060855074021018,060855074021018,"Block 1018, Block Group 1, Census Tract 5074.02, Santa Clara County, California",14,13,1
1000000US060855074021019,060855074021019,"Block 1019, Block Group 1, Census Tract 5074.02, Santa Clara County, California",20,20,0
1000000US060855074021020,060855074021020,"Block 1020, Block Group 1, Census Tract 5074.02, Santa Clara County, California",29,27,2
1000000US060855074021021,060855074021021,"Block 1021, Block Group 1, Census Tract 5074.02, Santa Clara County, California",28,27,1
1000000US060855074021022,060855074021022,"Block 1022, Block Group 1, Census Tract 5074.02, Santa Clara County, California",41,41,0
1000000US060855074021023,060855074021023,"Block 1023, Block Group 1, Census Tract 5074.02, Santa Clara County, California",32,31,1
1000000US060855074021024,060855074021024,"Block 1024, Block Group 1, Census Tract 5074.02, Santa Clara County, California",32,31,1
1000000US060855074022000,060855074022000,"Block 2000, Block Group 2, Census Tract 5074.02, Santa Clara County, California",0,0,0
1000000US060855074022001,060855074022001,"Block 2001, Block Group 2, Census Tract 5074.02, Santa Clara County, California",0,0,0
1000000US060855074022002,060855074022002,"Block 2002, Block Group 2, Census Tract 5074.02, Santa Clara County, California",0,0,0
1000000US060855074022003,060855074022003,"Block 2003, Block Group 2, Census Tract 5074.02, Santa Clara County, California",0,0,0
1000000US060855074022004,060855074022004,"Block 2004, Block Group 2, Census Tract 5074.02, Santa Clara County, California",66,64,2
1000000US060855074022005,060855074022005,"Block 2005, Block Group 2, Census Tract 5074.02, Santa Clara County, California",51,50,1
1000000US060855074022006,060855074022006,"Block 2006, Block Group 2, Census Tract 5074.02, Santa Clara County, California",48,46,2
1000000US060855074022007,060855074022007,"Block 2007, Block Group 2, Census Tract 5074.02, Santa Clara County, California",37,37,0
1000000US060855074022008,060855074022008,"Block 2008, Block Group 2, Census Tract 5074.02, Santa Clara County, California",9,9,0
1000000US060855074022009,060855074022009,"Block 2009, Block Group 2, Census Tract 5074.02, Santa Clara County, California",15,14,1
1000000US060855074022010,060855074022010,"Block 2010, Block Group 2, Census Tract 5074.02, Santa Clara County, California",0,0,0
1000000US060855074022011,060855074022011,"Block 2011, Block Group 2, Census Tract 5074.02, Santa Clara County, California",4,4,0
1000000US060855074022012,060855074022012,"Block 2012, Block Group 2, Census Tract 5074.02, Santa Clara County, California",24,24,0
1000000US060855074022013,060855074022013,"Block 2013, Block Group 2, Census Tract 5074.02, Santa Clara County, California",32,31,1
1000000US060855074022014,060855074022014,"Block 2014, Block Group 2, Census Tract 5074.02, Santa Clara County, California",41,40,1
1000000US060855074022015,060855074022015,"Block 2015, Block Group 2, Census Tract 5074.02, Santa Clara County, California",14,13,1
1000000US060855074022016,060855074022016,"Block 2016, Block Group 2, Census Tract 5074.02, Santa Clara County, California",0,0,0
1000000US060855074022017,060855074022017,"Block 2017, Block Group 2, Census Tract 5074.02, Santa Clara County, California",0,0,0
1000000US060855074022018,060855074022018,"Block 2018, Block Group 2, Census Tract 5074.02, Santa Clara County, California",36,36,0
1000000US060855074022019,060855074022019,"Block 2019, Block Group 2, Census Tract 5074.02, Santa Clara County, California",0,0,0
1000000US060855074022020,060855074022020,"Block 2020, Block Group 2, Census Tract 5074.02, Santa Clara County, California",12,12,0
1000000US060855074023000,060855074023000,"Block 3000, Block Group 3, Census Tract 5074.02, Santa Clara County, California",0,0,0
1000000US060855074023001,060855074023001,"Block 3001, Block Group 3, Census Tract 5074.02, Santa Clara County, California",2,2,0
1000000US060855074023002,060855074023002,"Block 3002, Block Group 3, Census Tract 5074.02, Santa Clara County, California",0,0,0
1000000US060855074023003,060855074023003,"Block 3003, Block Group 3, Census Tract 5074.02, Santa Clara County, California",0,0,0
1000000US060855074023004,060855074023004,"Block 3004, Block Group 3, Census Tract 5074.02, Santa Clara County, California",39,35,4
1000000US060855074023005,060855074023005,"Block 3005, Block Group 3, Census Tract 5074.02, Santa Clara County, California",0,0,0
1000000US060855074023006,060855074023006,"Block 3006, Block Group 3, Census Tract 5074.02, Santa Clara County, California",0,0,0
1000000US060855074023007,060855074023007,"Block 3007, Block Group 3, Census Tract 5074.02, Santa Clara County, California",14,13,1
1000000US060855074023008,060855074023008,"Block 3008, Block Group 3, Census Tract 5074.02, Santa Clara County, California",0,0,0
1000000US060855074023009,060855074023009,"Block 3009, Block Group 3, Census Tract 5074.02, Santa Clara County, California",27,27,0
1000000US060855074023010,060855074023010,"Block 3010, Block Group 3, Census Tract 5074.02, Santa Clara County, California",53,52,1
1000000US060855074023011,060855074023011,"Block 3011, Block Group 3, Census Tract 5074.02, Santa Clara County, California",8,8,0
1000000US060855074023012,060855074023012,"Block 3012, Block Group 3, Census Tract 5074.02, Santa Clara County, California",127,120,7
1000000US060855074023013,060855074023013,"Block 3013, Block Group 3, Census Tract 5074.02, Santa Clara County, California",0,0,0
1000000US060855074023014,060855074023014,"Block 3014, Block Group 3, Census Tract 5074.02, Santa Clara County, California",100,88,12
1000000US060855074023015,060855074023015,"Block 3015, Block Group 3, Census Tract 5074.02, Santa Clara County, California",27,26,1
1000000US060855074023016,060855074023016,"Block 3016, Block Group 3, Census Tract 5074.02, Santa Clara County, California",19,19,0
1000000US060855074023017,060855074023017,"Block 3017, Block Group 3, Census Tract 5074.02, Santa Clara County, California",0,0,0
1000000US060855074023018,060855074023018,"Block 3018, Block Group 3, Census Tract 5074.02, Santa Clara County, California",9,9,0
1000000US060855074023019,060855074023019,"Block 3019, Block Group 3, Census Tract 5074.02, Santa Clara County, California",19,18,1
1000000US060855074023020,060855074023020,"Block 3020, Block Group 3, Census Tract 5074.02, Santa Clara County, California",32,32,0
1000000US060855074023021,060855074023021,"Block 3021, Block Group 3, Census Tract 5074.02, Santa Clara County, California",23,22,1
1000000US060855074023022,060855074023022,"Block 3022, Block Group 3, Census Tract 5074.02, Santa Clara County, California",30,29,1
1000000US060855074023023,060855074023023,"Block 3023, Block Group 3, Census Tract 5074.02, Santa Clara County, California",20,20,0
1000000US060855074023024,060855074023024,"Block 3024, Block Group 3, Census Tract 5074.02, Santa Clara County, California",16,16,0
1000000US060855075001000,060855075001000,"Block 1000, Block Group 1, Census Tract 5075, Santa Clara County, California",69,68,1
1000000US060855075001001,060855075001001,"Block 1001, Block Group 1, Census Tract 5075, Santa Clara County, California",27,26,1
1000000US060855075001002,060855075001002,"Block 1002, Block Group 1, Census Tract 5075, Santa Clara County, California",20,20,0
1000000US060855075001003,060855075001003,"Block 1003, Block Group 1, Census Tract 5075, Santa Clara County, California",52,52,0
1000000US060855075001004,060855075001004,"Block 1004, Block Group 1, Census Tract 5075, Santa Clara County, California",18,17,1
1000000US060855075001005,060855075001005,"Block 1005, Block Group 1, Census Tract 5075, Santa Clara County, California",21,21,0
1000000US060855075001006,060855075001006,"Block 1006, Block Group 1, Census Tract 5075, Santa Clara County, California",62,62,0
1000000US060855075001007,060855075001007,"Block 1007, Block Group 1, Census Tract 5075, Santa Clara County, California",10,10,0
1000000US060855075001008,060855075001008,"Block 1008, Block Group 1, Census Tract 5075, Santa Clara County, California",16,16,0
1000000US060855075001009,060855075001009,"Block 1009, Block Group 1, Census Tract 5075, Santa Clara County, California",8,8,0
1000000US060855075001010,060855075001010,"Block 1010, Block Group 1, Census Tract 5075, Santa Clara County, California",21,21,0
1000000US060855075001011,060855075001011,"Block 1011, Block Group 1, Census Tract 5075, Santa Clara County, California",30,30,0
1000000US060855075001012,060855075001012,"Block 1012, Block Group 1, Census Tract 5075, Santa Clara County, California",39,38,1
1000000US060855075001013,060855075001013,"Block 1013, Block Group 1, Census Tract 5075, Santa Clara County, California",96,88,8
1000000US060855075001014,060855075001014,"Block 1014, Block Group 1, Census Tract 5075, Santa Clara County, California",63,46,17
1000000US060855075001015,060855075001015,"Block 1015, Block Group 1, Census Tract 5075, Santa Clara County, California",27,26,1
1000000US060855075001016,060855075001016,"Block 1016, Block Group 1, Census Tract 5075, Santa Clara County, California",25,22,3
1000000US060855075001017,060855075001017,"Block 1017, Block Group 1, Census Tract 5075, Santa Clara County, California",0,0,0
1000000US060855075001018,060855075001018,"Block 1018, Block Group 1, Census Tract 5075, Santa Clara County, California",52,52,0
1000000US060855075001019,060855075001019,"Block 1019, Block Group 1, Census Tract 5075, Santa Clara County, California",10,10,0
1000000US060855075001020,060855075001020,"Block 1020, Block Group 1, Census Tract 5075, Santa Clara County, California",0,0,0
1000000US060855075001021,060855075001021,"Block 1021, Block Group 1, Census Tract 5075, Santa Clara County, California",0,0,0
1000000US060855075001022,060855075001022,"Block 1022, Block Group 1, Census Tract 5075, Santa Clara County, California",0,0,0
1000000US060855075001023,060855075001023,"Block 1023, Block Group 1, Census Tract 5075, Santa Clara County, California",0,0,0
1000000US060855075002000,060855075002000,"Block 2000, Block Group 2, Census Tract 5075, Santa Clara County, California",66,64,2
1000000US060855075002001,060855075002001,"Block 2001, Block Group 2, Census Tract 5075, Santa Clara County, California",33,32,1
1000000US060855075002002,060855075002002,"Block 2002, Block Group 2, Census Tract 5075, Santa Clara County, California",29,29,0
1000000US060855075002003,060855075002003,"Block 2003, Block Group 2, Census Tract 5075, Santa Clara County, California",23,23,0
1000000US060855075002004,060855075002004,"Block 2004, Block Group 2, Census Tract 5075, Santa Clara County, California",9,9,0
1000000US060855075002005,060855075002005,"Block 2005, Block Group 2, Census Tract 5075, Santa Clara County, California",18,18,0
1000000US060855075002006,060855075002006,"Block 2006, Block Group 2, Census Tract 5075, Santa Clara County, California",32,31,1
1000000US060855075002007,060855075002007,"Block 2007, Block Group 2, Census Tract 5075, Santa Clara County, California",58,55,3
1000000US060855075002008,060855075002008,"Block 2008, Block Group 2, Census Tract 5075, Santa Clara County, California",0,0,0
1000000US060855075002009,060855075002009,"Block 2009, Block Group 2, Census Tract 5075, Santa Clara County, California",0,0,0
1000000US060855075002010,060855075002010,"Block 2010, Block Group 2, Census Tract 5075, Santa Clara County, California",46,46,0
1000000US060855075002011,060855075002011,"Block 2011, Block Group 2, Census Tract 5075, Santa Clara County, California",26,26,0
1000000US060855075002012,060855075002012,"Block 2012, Block Group 2, Census Tract 5075, Santa Clara County, California",21,20,1
1000000US060855075002013,060855075002013,"Block 2013, Block Group 2, Census Tract 5075, Santa Clara County, California",11,10,1
1000000US060855075002014,060855075002014,"Block 2014, Block Group 2, Census Tract 5075, Santa Clara County, California",18,18,0
1000000US060855075002015,060855075002015,"Block 2015, Block Group 2, Census Tract 5075, Santa Clara County, California",24,24,0
1000000US060855075002016,060855075002016,"Block 2016, Block Group 2, Census Tract 5075, Santa Clara County, California",23,23,0
1000000US060855075002017,060855075002017,"Block 2017, Block Group 2, Census Tract 5075, Santa Clara County, California",23,23,0
1000000US060855075002018,060855075002018,"Block 2018, Block Group 2, Census Tract 5075, Santa Clara County, California",11,11,0
1000000US060855075002019,060855075002019,"Block 2019, Block Group 2, Census Tract 5075, Santa Clara County, California",6,6,0
1000000US060855075003000,060855075003000,"Block 3000, Block Group 3, Census Tract 5075, Santa Clara County, California",0,0,0
1000000US060855075003001,060855075003001,"Block 3001, Block Group 3, Census Tract 5075, Santa Clara County, California",49,49,0
1000000US060855075003002,060855075003002,"Block 3002, Block Group 3, Census Tract 5075, Santa Clara County, California",30,30,0
1000000US060855075003003,060855075003003,"Block 3003, Block Group 3, Census Tract 5075, Santa Clara County, California",0,0,0
1000000US060855075003004,060855075003004,"Block 3004, Block Group 3, Census Tract 5075, Santa Clara County, California",11,11,0
1000000US060855075003005,060855075003005,"Block 3005, Block Group 3, Census Tract 5075, Santa Clara County, California",21,21,0
1000000US060855075003006,060855075003006,"Block 3006, Block Group 3, Census Tract 5075, Santa Clara County, California",22,22,0
1000000US060855075003007,060855075003007,"Block 3007, Block Group 3, Census Tract 5075, Santa Clara County, California",2,2,0
1000000US060855075003008,060855075003008,"Block 3008, Block Group 3, Census Tract 5075, Santa Clara County, California",0,0,0
1000000US060855075003009,060855075003009,"Block 3009, Block Group 3, Census Tract 5075, Santa Clara County, California",0,0,0
1000000US060855075003010,060855075003010,"Block 3010, Block Group 3, Census Tract 5075, Santa Clara County, California",37,37,0
1000000US060855075003011,060855075003011,"Block 3011, Block Group 3, Census Tract 5075, Santa Clara County, California",0,0,0
1000000US060855075003012,060855075003012,"Block 3012, Block Group 3, Census Tract 5075, Santa Clara County, California",0,0,0
1000000US060855075003013,060855075003013,"Block 3013, Block Group 3, Census Tract 5075, Santa Clara County, California",0,0,0
1000000US060855075003014,060855075003014,"Block 3014, Block Group 3, Census Tract 5075, Santa Clara County, California",0,0,0
1000000US060855075003015,060855075003015,"Block 3015, Block Group 3, Census Tract 5075, Santa Clara County, California",0,0,0
1000000US060855075003016,060855075003016,"Block 3016, Block Group 3, Census Tract 5075, Santa Clara County, California",34,33,1
1000000US060855075003017,060855075003017,"Block 3017, Block Group 3, Census Tract 5075, Santa Clara County, California",25,24,1
1000000US060855075003018,060855075003018,"Block 3018, Block Group 3, Census Tract 5075, Santa Clara County, California",0,0,0
1000000US060855075003019,060855075003019,"Block 3019, Block Group 3, Census Tract 5075, Santa Clara County, California",0,0,0
1000000US060855075003020,060855075003020,"Block 3020, Block Group 3, Census Tract 5075, Santa Clara County, California",88,85,3
1000000US060855075003021,060855075003021,"Block 3021, Block Group 3, Census Tract 5075, Santa Clara County, California",24,24,0
1000000US060855075003022,060855075003022,"Block 3022, Block Group 3, Census Tract 5075, Santa Clara County, California",3,3,0
1000000US060855075003023,060855075003023,"Block 3023, Block Group 3, Census Tract 5075, Santa Clara County, California",36,36,0
1000000US060855075003024,060855075003024,"Block 3024, Block Group 3, Census Tract 5075, Santa Clara County, California",8,7,1
1000000US060855075003025,060855075003025,"Block 3025, Block Group 3, Census Tract 5075, Santa Clara County, California",31,31,0
1000000US060855075003026,060855075003026,"Block 3026, Block Group 3, Census Tract 5075, Santa Clara County, California",0,0,0
1000000US060855075003027,060855075003027,"Block 3027, Block Group 3, Census Tract 5075, Santa Clara County, California",0,0,0
1000000US060855075003028,060855075003028,"Block 3028, Block Group 3, Census Tract 5075, Santa Clara County, California",0,0,0
1000000US060855075004000,060855075004000,"Block 4000, Block Group 4, Census Tract 5075, Santa Clara County, California",0,0,0
1000000US060855075004001,060855075004001,"Block 4001, Block Group 4, Census Tract 5075, Santa Clara County, California",0,0,0
1000000US060855075004002,060855075004002,"Block 4002, Block Group 4, Census Tract 5075, Santa Clara County, California",28,28,0
1000000US060855075004003,060855075004003,"Block 4003, Block Group 4, Census Tract 5075, Santa Clara County, California",23,23,0
1000000US060855075004004,060855075004004,"Block 4004, Block Group 4, Census Tract 5075, Santa Clara County, California",11,11,0
1000000US060855075004005,060855075004005,"Block 4005, Block Group 4, Census Tract 5075, Santa Clara County, California",14,14,0
1000000US060855075004006,060855075004006,"Block 4006, Block Group 4, Census Tract 5075, Santa Clara County, California",41,40,1
1000000US060855075004007,060855075004007,"Block 4007, Block Group 4, Census Tract 5075, Santa Clara County, California",35,35,0
1000000US060855075004008,060855075004008,"Block 4008, Block Group 4, Census Tract 5075, Santa Clara County, California",17,17,0
1000000US060855075004009,060855075004009,"Block 4009, Block Group 4, Census Tract 5075, Santa Clara County, California",27,26,1
1000000US060855075004010,060855075004010,"Block 4010, Block Group 4, Census Tract 5075, Santa Clara County, California",34,32,2
1000000US060855075004011,060855075004011,"Block 4011, Block Group 4, Census Tract 5075, Santa Clara County, California",13,13,0
1000000US060855075004012,060855075004012,"Block 4012, Block Group 4, Census Tract 5075, Santa Clara County, California",29,29,0
1000000US060855075004013,060855075004013,"Block 4013, Block Group 4, Census Tract 5075, Santa Clara County, California",21,20,1
1000000US060855075004014,060855075004014,"Block 4014, Block Group 4, Census Tract 5075, Santa Clara County, California",14,14,0
1000000US060855075004015,060855075004015,"Block 4015, Block Group 4, Census Tract 5075, Santa Clara County, California",21,21,0
1000000US060855075004016,060855075004016,"Block 4016, Block Group 4, Census Tract 5075, Santa Clara County, California",80,76,4
1000000US060855075004017,060855075004017,"Block 4017, Block Group 4, Census Tract 5075, Santa Clara County, California",27,27,0
1000000US060855075004018,060855075004018,"Block 4018, Block Group 4, Census Tract 5075, Santa Clara County, California",18,18,0
1000000US060855075004019,060855075004019,"Block 4019, Block Group 4, Census Tract 5075, Santa Clara County, California",8,7,1
1000000US060855075004020,060855075004020,"Block 4020, Block Group 4, Census Tract 5075, Santa Clara County, California",10,10,0
1000000US060855075004021,060855075004021,"Block 4021, Block Group 4, Census Tract 5075, Santa Clara County, California",12,12,0
1000000US060855076001000,060855076001000,"Block 1000, Block Group 1, Census Tract 5076, Santa Clara County, California",0,0,0
1000000US060855076001001,060855076001001,"Block 1001, Block Group 1, Census Tract 5076, Santa Clara County, California",21,21,0
1000000US060855076001002,060855076001002,"Block 1002, Block Group 1, Census Tract 5076, Santa Clara County, California",1,1,0
1000000US060855076001003,060855076001003,"Block 1003, Block Group 1, Census Tract 5076, Santa Clara County, California",0,0,0
1000000US060855076001004,060855076001004,"Block 1004, Block Group 1, Census Tract 5076, Santa Clara County, California",0,0,0
1000000US060855076001005,060855076001005,"Block 1005, Block Group 1, Census Tract 5076, Santa Clara County, California",0,0,0
1000000US060855076001006,060855076001006,"Block 1006, Block Group 1, Census Tract 5076, Santa Clara County, California",0,0,0
1000000US060855076001007,060855076001007,"Block 1007, Block Group 1, Census Tract 5076, Santa Clara County, California",0,0,0
1000000US060855076001008,060855076001008,"Block 1008, Block Group 1, Census Tract 5076, Santa Clara County, California",0,0,0
1000000US060855076001009,060855076001009,"Block 1009, Block Group 1, Census Tract 5076, Santa Clara County, California",6,6,0
1000000US060855076001010,060855076001010,"Block 1010, Block Group 1, Census Tract 5076, Santa Clara County, California",0,0,0
1000000US060855076001011,060855076001011,"Block 1011, Block Group 1, Census Tract 5076, Santa Clara County, California",0,0,0
1000000US060855076001012,060855076001012,"Block 1012, Block Group 1, Census Tract 5076, Santa Clara County, California",80,75,5
1000000US060855076001013,060855076001013,"Block 1013, Block Group 1, Census Tract 5076, Santa Clara County, California",1,1,0
1000000US060855076001014,060855076001014,"Block 1014, Block Group 1, Census Tract 5076, Santa Clara County, California",2,2,0
1000000US060855076001015,060855076001015,"Block 1015, Block Group 1, Census Tract 5076, Santa Clara County, California",17,16,1
1000000US060855076001016,060855076001016,"Block 1016, Block Group 1, Census Tract 5076, Santa Clara County, California",10,9,1
1000000US060855076001017,060855076001017,"Block 1017, Block Group 1, Census Tract 5076, Santa Clara County, California",56,52,4
1000000US060855076001018,060855076001018,"Block 1018, Block Group 1, Census Tract 5076, Santa Clara County, California",0,0,0
1000000US060855076001019,060855076001019,"Block 1019, Block Group 1, Census Tract 5076, Santa Clara County, California",0,0,0
1000000US060855076001020,060855076001020,"Block 1020, Block Group 1, Census Tract 5076, Santa Clara County, California",0,0,0
1000000US060855076001021,060855076001021,"Block 1021, Block Group 1, Census Tract 5076, Santa Clara County, California",2,2,0
1000000US060855076001022,060855076001022,"Block 1022, Block Group 1, Census Tract 5076, Santa Clara County, California",1,1,0
1000000US060855076001023,060855076001023,"Block 1023, Block Group 1, Census Tract 5076, Santa Clara County, California",1,1,0
1000000US060855076001024,060855076001024,"Block 1024, Block Group 1, Census Tract 5076, Santa Clara County, California",5,5,0
1000000US060855076001025,060855076001025,"Block 1025, Block Group 1, Census Tract 5076, Santa Clara County, California",0,0,0
1000000US060855076001026,060855076001026,"Block 1026, Block Group 1, Census Tract 5076, Santa Clara County, California",1,1,0
1000000US060855076001027,060855076001027,"Block 1027, Block Group 1, Census Tract 5076, Santa Clara County, California",1,1,0
1000000US060855076001028,060855076001028,"Block 1028, Block Group 1, Census Tract 5076, Santa Clara County, California",15,15,0
1000000US060855076001029,060855076001029,"Block 1029, Block Group 1, Census Tract 5076, Santa Clara County, California",10,10,0
1000000US060855076001030,060855076001030,"Block 1030, Block Group 1, Census Tract 5076, Santa Clara County, California",5,5,0
1000000US060855076001031,060855076001031,"Block 1031, Block Group 1, Census Tract 5076, Santa Clara County, California",2,2,0
1000000US060855076001032,060855076001032,"Block 1032, Block Group 1, Census Tract 5076, Santa Clara County, California",2,2,0
1000000US060855076001033,060855076001033,"Block 1033, Block Group 1, Census Tract 5076, Santa Clara County, California",2,2,0
1000000US060855076001034,060855076001034,"Block 1034, Block Group 1, Census Tract 5076, Santa Clara County, California",0,0,0
1000000US060855076001035,060855076001035,"Block 1035, Block Group 1, Census Tract 5076, Santa Clara County, California",0,0,0
1000000US060855076001036,060855076001036,"Block 1036, Block Group 1, Census Tract 5076, Santa Clara County, California",0,0,0
1000000US060855076001037,060855076001037,"Block 1037, Block Group 1, Census Tract 5076, Santa Clara County, California",1,1,0
1000000US060855076001038,060855076001038,"Block 1038, Block Group 1, Census Tract 5076, Santa Clara County, California",29,28,1
1000000US060855076001039,060855076001039,"Block 1039, Block Group 1, Census Tract 5076, Santa Clara County, California",0,0,0
1000000US060855076001040,060855076001040,"Block 1040, Block Group 1, Census Tract 5076, Santa Clara County, California",0,0,0
1000000US060855076001041,060855076001041,"Block 1041, Block Group 1, Census Tract 5076, Santa Clara County, California",11,11,0
1000000US060855076001042,060855076001042,"Block 1042, Block Group 1, Census Tract 5076, Santa Clara County, California",0,0,0
1000000US060855076001043,060855076001043,"Block 1043, Block Group 1, Census Tract 5076, Santa Clara County, California",0,0,0
1000000US060855076001044,060855076001044,"Block 1044, Block Group 1, Census Tract 5076, Santa Clara County, California",0,0,0
1000000US060855076001045,060855076001045,"Block 1045, Block Group 1, Census Tract 5076, Santa Clara County, California",0,0,0
1000000US060855076001046,060855076001046,"Block 1046, Block Group 1, Census Tract 5076, Santa Clara County, California",1,1,0
1000000US060855076002000,060855076002000,"Block 2000, Block Group 2, Census Tract 5076, Santa Clara County, California",0,0,0
1000000US060855076002001,060855076002001,"Block 2001, Block Group 2, Census Tract 5076, Santa Clara County, California",4,4,0
1000000US060855076002002,060855076002002,"Block 2002, Block Group 2, Census Tract 5076, Santa Clara County, California",10,10,0
1000000US060855076002003,060855076002003,"Block 2003, Block Group 2, Census Tract 5076, Santa Clara County, California",166,161,5
1000000US060855076002004,060855076002004,"Block 2004, Block Group 2, Census Tract 5076, Santa Clara County, California",13,12,1
1000000US060855076002005,060855076002005,"Block 2005, Block Group 2, Census Tract 5076, Santa Clara County, California",6,3,3
1000000US060855076002006,060855076002006,"Block 2006, Block Group 2, Census Tract 5076, Santa Clara County, California",1,1,0
1000000US060855076002007,060855076002007,"Block 2007, Block Group 2, Census Tract 5076, Santa Clara County, California",0,0,0
1000000US060855076002008,060855076002008,"Block 2008, Block Group 2, Census Tract 5076, Santa Clara County, California",25,25,0
1000000US060855076002009,060855076002009,"Block 2009, Block Group 2, Census Tract 5076, Santa Clara County, California",18,17,1
1000000US060855076002010,060855076002010,"Block 2010, Block Group 2, Census Tract 5076, Santa Clara County, California",0,0,0
1000000US060855076002011,060855076002011,"Block 2011, Block Group 2, Census Tract 5076, Santa Clara County, California",2,2,0
1000000US060855076002012,060855076002012,"Block 2012, Block Group 2, Census Tract 5076, Santa Clara County, California",0,0,0
1000000US060855076002013,060855076002013,"Block 2013, Block Group 2, Census Tract 5076, Santa Clara County, California",15,14,1
1000000US060855076002014,060855076002014,"Block 2014, Block Group 2, Census Tract 5076, Santa Clara County, California",62,60,2
1000000US060855076002015,060855076002015,"Block 2015, Block Group 2, Census Tract 5076, Santa Clara County, California",0,0,0
1000000US060855076002016,060855076002016,"Block 2016, Block Group 2, Census Tract 5076, Santa Clara County, California",47,45,2
1000000US060855076002017,060855076002017,"Block 2017, Block Group 2, Census Tract 5076, Santa Clara County, California",23,22,1
1000000US060855076002018,060855076002018,"Block 2018, Block Group 2, Census Tract 5076, Santa Clara County, California",17,17,0
1000000US060855076002019,060855076002019,"Block 2019, Block Group 2, Census Tract 5076, Santa Clara County, California",0,0,0
1000000US060855076002020,060855076002020,"Block 2020, Block Group 2, Census Tract 5076, Santa Clara County, California",0,0,0
1000000US060855076002021,060855076002021,"Block 2021, Block Group 2, Census Tract 5076, Santa Clara County, California",8,7,1
1000000US060855076002022,060855076002022,"Block 2022, Block Group 2, Census Tract 5076, Santa Clara County, California",0,0,0
1000000US060855076002023,060855076002023,"Block 2023, Block Group 2, Census Tract 5076, Santa Clara County, California",0,0,0
1000000US060855076002024,060855076002024,"Block 2024, Block Group 2, Census Tract 5076, Santa Clara County, California",16,16,0
1000000US060855076002025,060855076002025,"Block 2025, Block Group 2, Census Tract 5076, Santa Clara County, California",0,0,0
1000000US060855076002026,060855076002026,"Block 2026, Block Group 2, Census Tract 5076, Santa Clara County, California",0,0,0
1000000US060855076002027,060855076002027,"Block 2027, Block Group 2, Census Tract 5076, Santa Clara County, California",3,3,0
1000000US060855076003000,060855076003000,"Block 3000, Block Group 3, Census Tract 5076, Santa Clara County, California",194,188,6
1000000US060855076003001,060855076003001,"Block 3001, Block Group 3, Census Tract 5076, Santa Clara County, California",11,10,1
1000000US060855076003002,060855076003002,"Block 3002, Block Group 3, Census Tract 5076, Santa Clara County, California",0,0,0
1000000US060855076003003,060855076003003,"Block 3003, Block Group 3, Census Tract 5076, Santa Clara County, California",84,82,2
1000000US060855076003004,060855076003004,"Block 3004, Block Group 3, Census Tract 5076, Santa Clara County, California",0,0,0
1000000US060855076003005,060855076003005,"Block 3005, Block Group 3, Census Tract 5076, Santa Clara County, California",16,16,0
1000000US060855076003006,060855076003006,"Block 3006, Block Group 3, Census Tract 5076, Santa Clara County, California",147,139,8
1000000US060855076003007,060855076003007,"Block 3007, Block Group 3, Census Tract 5076, Santa Clara County, California",14,13,1
1000000US060855076003008,060855076003008,"Block 3008, Block Group 3, Census Tract 5076, Santa Clara County, California",11,10,1
1000000US060855076003009,060855076003009,"Block 3009, Block Group 3, Census Tract 5076, Santa Clara County, California",25,23,2
1000000US060855076003010,060855076003010,"Block 3010, Block Group 3, Census Tract 5076, Santa Clara County, California",22,22,0
1000000US060855076003011,060855076003011,"Block 3011, Block Group 3, Census Tract 5076, Santa Clara County, California",83,82,1
1000000US060855076003012,060855076003012,"Block 3012, Block Group 3, Census Tract 5076, Santa Clara County, California",0,0,0
1000000US060855076004000,060855076004000,"Block 4000, Block Group 4, Census Tract 5076, Santa Clara County, California",178,171,7
1000000US060855076004001,060855076004001,"Block 4001, Block Group 4, Census Tract 5076, Santa Clara County, California",41,41,0
1000000US060855076004002,060855076004002,"Block 4002, Block Group 4, Census Tract 5076, Santa Clara County, California",17,16,1
1000000US060855076004003,060855076004003,"Block 4003, Block Group 4, Census Tract 5076, Santa Clara County, California",321,301,20
1000000US060855076004004,060855076004004,"Block 4004, Block Group 4, Census Tract 5076, Santa Clara County, California",22,22,0
1000000US060855076004005,060855076004005,"Block 4005, Block Group 4, Census Tract 5076, Santa Clara County, California",0,0,0
1000000US060855076004006,060855076004006,"Block 4006, Block Group 4, Census Tract 5076, Santa Clara County, California",2,2,0
1000000US060855076004007,060855076004007,"Block 4007, Block Group 4, Census Tract 5076, Santa Clara County, California",0,0,0
1000000US060855076004008,060855076004008,"Block 4008, Block Group 4, Census Tract 5076, Santa Clara County, California",51,44,7
1000000US060855076004009,060855076004009,"Block 4009, Block Group 4, Census Tract 5076, Santa Clara County, California",0,0,0
1000000US060855076004010,060855076004010,"Block 4010, Block Group 4, Census Tract 5076, Santa Clara County, California",103,96,7
1000000US060855076004011,060855076004011,"Block 4011, Block Group 4, Census Tract 5076, Santa Clara County, California",0,0,0
1000000US060855076004012,060855076004012,"Block 4012, Block Group 4, Census Tract 5076, Santa Clara County, California",4,3,1
1000000US060855076004013,060855076004013,"Block 4013, Block Group 4, Census Tract 5076, Santa Clara County, California",0,0,0
1000000US060855077011000,060855077011000,"Block 1000, Block Group 1, Census Tract 5077.01, Santa Clara County, California",131,128,3
1000000US060855077011001,060855077011001,"Block 1001, Block Group 1, Census Tract 5077.01, Santa Clara County, California",122,120,2
1000000US060855077011002,060855077011002,"Block 1002, Block Group 1, Census Tract 5077.01, Santa Clara County, California",0,0,0
1000000US060855077011003,060855077011003,"Block 1003, Block Group 1, Census Tract 5077.01, Santa Clara County, California",52,51,1
1000000US060855077011004,060855077011004,"Block 1004, Block Group 1, Census Tract 5077.01, Santa Clara County, California",2,2,0
1000000US060855077011005,060855077011005,"Block 1005, Block Group 1, Census Tract 5077.01, Santa Clara County, California",0,0,0
1000000US060855077012000,060855077012000,"Block 2000, Block Group 2, Census Tract 5077.01, Santa Clara County, California",129,128,1
1000000US060855077012001,060855077012001,"Block 2001, Block Group 2, Census Tract 5077.01, Santa Clara County, California",14,13,1
1000000US060855077012002,060855077012002,"Block 2002, Block Group 2, Census Tract 5077.01, Santa Clara County, California",24,23,1
1000000US060855077012003,060855077012003,"Block 2003, Block Group 2, Census Tract 5077.01, Santa Clara County, California",15,14,1
1000000US060855077012004,060855077012004,"Block 2004, Block Group 2, Census Tract 5077.01, Santa Clara County, California",15,15,0
1000000US060855077012005,060855077012005,"Block 2005, Block Group 2, Census Tract 5077.01, Santa Clara County, California",15,10,5
1000000US060855077012006,060855077012006,"Block 2006, Block Group 2, Census Tract 5077.01, Santa Clara County, California",49,49,0
1000000US060855077012007,060855077012007,"Block 2007, Block Group 2, Census Tract 5077.01, Santa Clara County, California",30,30,0
1000000US060855077012008,060855077012008,"Block 2008, Block Group 2, Census Tract 5077.01, Santa Clara County, California",30,28,2
1000000US060855077012009,060855077012009,"Block 2009, Block Group 2, Census Tract 5077.01, Santa Clara County, California",29,28,1
1000000US060855077012010,060855077012010,"Block 2010, Block Group 2, Census Tract 5077.01, Santa Clara County, California",16,16,0
1000000US060855077012011,060855077012011,"Block 2011, Block Group 2, Census Tract 5077.01, Santa Clara County, California",111,106,5
1000000US060855077012012,060855077012012,"Block 2012, Block Group 2, Census Tract 5077.01, Santa Clara County, California",31,31,0
1000000US060855077012013,060855077012013,"Block 2013, Block Group 2, Census Tract 5077.01, Santa Clara County, California",35,35,0
1000000US060855077012014,060855077012014,"Block 2014, Block Group 2, Census Tract 5077.01, Santa Clara County, California",23,23,0
1000000US060855077012015,060855077012015,"Block 2015, Block Group 2, Census Tract 5077.01, Santa Clara County, California",41,40,1
1000000US060855077012016,060855077012016,"Block 2016, Block Group 2, Census Tract 5077.01, Santa Clara County, California",27,25,2
1000000US060855077012017,060855077012017,"Block 2017, Block Group 2, Census Tract 5077.01, Santa Clara County, California",0,0,0
1000000US060855077012018,060855077012018,"Block 2018, Block Group 2, Census Tract 5077.01, Santa Clara County, California",0,0,0
1000000US060855077013000,060855077013000,"Block 3000, Block Group 3, Census Tract 5077.01, Santa Clara County, California",0,0,0
1000000US060855077013001,060855077013001,"Block 3001, Block Group 3, Census Tract 5077.01, Santa Clara County, California",75,73,2
1000000US060855077013002,060855077013002,"Block 3002, Block Group 3, Census Tract 5077.01, Santa Clara County, California",2,2,0
1000000US060855077013003,060855077013003,"Block 3003, Block Group 3, Census Tract 5077.01, Santa Clara County, California",0,0,0
1000000US060855077013004,060855077013004,"Block 3004, Block Group 3, Census Tract 5077.01, Santa Clara County, California",28,26,2
1000000US060855077013005,060855077013005,"Block 3005, Block Group 3, Census Tract 5077.01, Santa Clara County, California",0,0,0
1000000US060855077013006,060855077013006,"Block 3006, Block Group 3, Census Tract 5077.01, Santa Clara County, California",14,14,0
1000000US060855077013007,060855077013007,"Block 3007, Block Group 3, Census Tract 5077.01, Santa Clara County, California",0,0,0
1000000US060855077013008,060855077013008,"Block 3008, Block Group 3, Census Tract 5077.01, Santa Clara County, California",0,0,0
1000000US060855077013009,060855077013009,"Block 3009, Block Group 3, Census Tract 5077.01, Santa Clara County, California",0,0,0
1000000US060855077013010,060855077013010,"Block 3010, Block Group 3, Census Tract 5077.01, Santa Clara County, California",0,0,0
1000000US060855077013011,060855077013011,"Block 3011, Block Group 3, Census Tract 5077.01, Santa Clara County, California",0,0,0
1000000US060855077013012,060855077013012,"Block 3012, Block Group 3, Census Tract 5077.01, Santa Clara County, California",0,0,0
1000000US060855077013013,060855077013013,"Block 3013, Block Group 3, Census Tract 5077.01, Santa Clara County, California",0,0,0
1000000US060855077013014,060855077013014,"Block 3014, Block Group 3, Census Tract 5077.01, Santa Clara County, California",0,0,0
1000000US060855077013015,060855077013015,"Block 3015, Block Group 3, Census Tract 5077.01, Santa Clara County, California",0,0,0
1000000US060855077013016,060855077013016,"Block 3016, Block Group 3, Census Tract 5077.01, Santa Clara County, California",1,1,0
1000000US060855077013017,060855077013017,"Block 3017, Block Group 3, Census Tract 5077.01, Santa Clara County, California",0,0,0
1000000US060855077013018,060855077013018,"Block 3018, Block Group 3, Census Tract 5077.01, Santa Clara County, California",91,90,1
1000000US060855077013019,060855077013019,"Block 3019, Block Group 3, Census Tract 5077.01, Santa Clara County, California",5,5,0
1000000US060855077013020,060855077013020,"Block 3020, Block Group 3, Census Tract 5077.01, Santa Clara County, California",51,50,1
1000000US060855077013021,060855077013021,"Block 3021, Block Group 3, Census Tract 5077.01, Santa Clara County, California",29,28,1
1000000US060855077013022,060855077013022,"Block 3022, Block Group 3, Census Tract 5077.01, Santa Clara County, California",64,63,1
1000000US060855077013023,060855077013023,"Block 3023, Block Group 3, Census Tract 5077.01, Santa Clara County, California",50,49,1
1000000US060855077013024,060855077013024,"Block 3024, Block Group 3, Census Tract 5077.01, Santa Clara County, California",0,0,0
1000000US060855077013025,060855077013025,"Block 3025, Block Group 3, Census Tract 5077.01, Santa Clara County, California",0,0,0
1000000US060855077013026,060855077013026,"Block 3026, Block Group 3, Census Tract 5077.01, Santa Clara County, California",20,20,0
1000000US060855077013027,060855077013027,"Block 3027, Block Group 3, Census Tract 5077.01, Santa Clara County, California",26,26,0
1000000US060855077013028,060855077013028,"Block 3028, Block Group 3, Census Tract 5077.01, Santa Clara County, California",0,0,0
1000000US060855077013029,060855077013029,"Block 3029, Block Group 3, Census Tract 5077.01, Santa Clara County, California",0,0,0
1000000US060855077021000,060855077021000,"Block 1000, Block Group 1, Census Tract 5077.02, Santa Clara County, California",7,7,0
1000000US060855077021001,060855077021001,"Block 1001, Block Group 1, Census Tract 5077.02, Santa Clara County, California",36,36,0
1000000US060855077021002,060855077021002,"Block 1002, Block Group 1, Census Tract 5077.02, Santa Clara County, California",130,127,3
1000000US060855077021003,060855077021003,"Block 1003, Block Group 1, Census Tract 5077.02, Santa Clara County, California",42,40,2
1000000US060855077021004,060855077021004,"Block 1004, Block Group 1, Census Tract 5077.02, Santa Clara County, California",29,28,1
1000000US060855077021005,060855077021005,"Block 1005, Block Group 1, Census Tract 5077.02, Santa Clara County, California",117,111,6
1000000US060855077021006,060855077021006,"Block 1006, Block Group 1, Census Tract 5077.02, Santa Clara County, California",21,19,2
1000000US060855077021007,060855077021007,"Block 1007, Block Group 1, Census Tract 5077.02, Santa Clara County, California",26,24,2
1000000US060855077021008,060855077021008,"Block 1008, Block Group 1, Census Tract 5077.02, Santa Clara County, California",34,34,0
1000000US060855077021009,060855077021009,"Block 1009, Block Group 1, Census Tract 5077.02, Santa Clara County, California",83,83,0
1000000US060855077021010,060855077021010,"Block 1010, Block Group 1, Census Tract 5077.02, Santa Clara County, California",44,44,0
1000000US060855077021011,060855077021011,"Block 1011, Block Group 1, Census Tract 5077.02, Santa Clara County, California",22,22,0
1000000US060855077021012,060855077021012,"Block 1012, Block Group 1, Census Tract 5077.02, Santa Clara County, California",30,30,0
1000000US060855077021013,060855077021013,"Block 1013, Block Group 1, Census Tract 5077.02, Santa Clara County, California",11,11,0
1000000US060855077021014,060855077021014,"Block 1014, Block Group 1, Census Tract 5077.02, Santa Clara County, California",39,39,0
1000000US060855077021015,060855077021015,"Block 1015, Block Group 1, Census Tract 5077.02, Santa Clara County, California",28,28,0
1000000US060855077022000,060855077022000,"Block 2000, Block Group 2, Census Tract 5077.02, Santa Clara County, California",39,38,1
1000000US060855077022001,060855077022001,"Block 2001, Block Group 2, Census Tract 5077.02, Santa Clara County, California",0,0,0
1000000US060855077022002,060855077022002,"Block 2002, Block Group 2, Census Tract 5077.02, Santa Clara County, California",0,0,0
1000000US060855077022003,060855077022003,"Block 2003, Block Group 2, Census Tract 5077.02, Santa Clara County, California",31,31,0
1000000US060855077022004,060855077022004,"Block 2004, Block Group 2, Census Tract 5077.02, Santa Clara County, California",63,61,2
1000000US060855077022005,060855077022005,"Block 2005, Block Group 2, Census Tract 5077.02, Santa Clara County, California",35,35,0
1000000US060855077022006,060855077022006,"Block 2006, Block Group 2, Census Tract 5077.02, Santa Clara County, California",60,60,0
1000000US060855077022007,060855077022007,"Block 2007, Block Group 2, Census Tract 5077.02, Santa Clara County, California",23,23,0
1000000US060855077022008,060855077022008,"Block 2008, Block Group 2, Census Tract 5077.02, Santa Clara County, California",34,34,0
1000000US060855077022009,060855077022009,"Block 2009, Block Group 2, Census Tract 5077.02, Santa Clara County, California",39,38,1
1000000US060855077022010,060855077022010,"Block 2010, Block Group 2, Census Tract 5077.02, Santa Clara County, California",24,24,0
1000000US060855077022011,060855077022011,"Block 2011, Block Group 2, Census Tract 5077.02, Santa Clara County, California",86,86,0
1000000US060855077022012,060855077022012,"Block 2012, Block Group 2, Census Tract 5077.02, Santa Clara County, California",37,37,0
1000000US060855077022013,060855077022013,"Block 2013, Block Group 2, Census Tract 5077.02, Santa Clara County, California",18,18,0
1000000US060855077022014,060855077022014,"Block 2014, Block Group 2, Census Tract 5077.02, Santa Clara County, California",32,32,0
1000000US060855077022015,060855077022015,"Block 2015, Block Group 2, Census Tract 5077.02, Santa Clara County, California",27,27,0
1000000US060855077022016,060855077022016,"Block 2016, Block Group 2, Census Tract 5077.02, Santa Clara County, California",27,26,1
1000000US060855077023000,060855077023000,"Block 3000, Block Group 3, Census Tract 5077.02, Santa Clara County, California",150,146,4
1000000US060855077023001,060855077023001,"Block 3001, Block Group 3, Census Tract 5077.02, Santa Clara County, California",3,3,0
1000000US060855077023002,060855077023002,"Block 3002, Block Group 3, Census Tract 5077.02, Santa Clara County, California",39,39,0
1000000US060855077023003,060855077023003,"Block 3003, Block Group 3, Census Tract 5077.02, Santa Clara County, California",0,0,0
1000000US060855077023004,060855077023004,"Block 3004, Block Group 3, Census Tract 5077.02, Santa Clara County, California",2,2,0
1000000US060855077023005,060855077023005,"Block 3005, Block Group 3, Census Tract 5077.02, Santa Clara County, California",58,57,1
1000000US060855077023006,060855077023006,"Block 3006, Block Group 3, Census Tract 5077.02, Santa Clara County, California",32,32,0
1000000US060855077023007,060855077023007,"Block 3007, Block Group 3, Census Tract 5077.02, Santa Clara County, California",0,0,0
1000000US060855077023008,060855077023008,"Block 3008, Block Group 3, Census Tract 5077.02, Santa Clara County, California",0,0,0
1000000US060855077023009,060855077023009,"Block 3009, Block Group 3, Census Tract 5077.02, Santa Clara County, California",0,0,0
1000000US060855077023010,060855077023010,"Block 3010, Block Group 3, Census Tract 5077.02, Santa Clara County, California",0,0,0
1000000US060855077023011,060855077023011,"Block 3011, Block Group 3, Census Tract 5077.02, Santa Clara County, California",0,0,0
1000000US060855077023012,060855077023012,"Block 3012, Block Group 3, Census Tract 5077.02, Santa Clara County, California",0,0,0
1000000US060855077023013,060855077023013,"Block 3013, Block Group 3, Census Tract 5077.02, Santa Clara County, California",260,257,3
1000000US060855077023014,060855077023014,"Block 3014, Block Group 3, Census Tract 5077.02, Santa Clara County, California",0,0,0
1000000US060855077023015,060855077023015,"Block 3015, Block Group 3, Census Tract 5077.02, Santa Clara County, California",0,0,0
1000000US060855077023016,060855077023016,"Block 3016, Block Group 3, Census Tract 5077.02, Santa Clara County, California",19,19,0
1000000US060855077023017,060855077023017,"Block 3017, Block Group 3, Census Tract 5077.02, Santa Clara County, California",0,0,0
1000000US060855077023018,060855077023018,"Block 3018, Block Group 3, Census Tract 5077.02, Santa Clara County, California",0,0,0
1000000US060855077023019,060855077023019,"Block 3019, Block Group 3, Census Tract 5077.02, Santa Clara County, California",1,1,0
1000000US060855077023020,060855077023020,"Block 3020, Block Group 3, Census Tract 5077.02, Santa Clara County, California",0,0,0
1000000US060855077023021,060855077023021,"Block 3021, Block Group 3, Census Tract 5077.02, Santa Clara County, California",0,0,0
1000000US060855077023022,060855077023022,"Block 3022, Block Group 3, Census Tract 5077.02, Santa Clara County, California",0,0,0
1000000US060855077023023,060855077023023,"Block 3023, Block Group 3, Census Tract 5077.02, Santa Clara County, California",18,17,1
1000000US060855077023024,060855077023024,"Block 3024, Block Group 3, Census Tract 5077.02, Santa Clara County, California",0,0,0
1000000US060855077023025,060855077023025,"Block 3025, Block Group 3, Census Tract 5077.02, Santa Clara County, California",0,0,0
1000000US060855077023026,060855077023026,"Block 3026, Block Group 3, Census Tract 5077.02, Santa Clara County, California",66,65,1
1000000US060855077023027,060855077023027,"Block 3027, Block Group 3, Census Tract 5077.02, Santa Clara County, California",0,0,0
1000000US060855077023028,060855077023028,"Block 3028, Block Group 3, Census Tract 5077.02, Santa Clara County, California",0,0,0
1000000US060855077023029,060855077023029,"Block 3029, Block Group 3, Census Tract 5077.02, Santa Clara County, California",0,0,0
1000000US060855077023030,060855077023030,"Block 3030, Block Group 3, Census Tract 5077.02, Santa Clara County, California",0,0,0
1000000US060855077023031,060855077023031,"Block 3031, Block Group 3, Census Tract 5077.02, Santa Clara County, California",0,0,0
1000000US060855077023032,060855077023032,"Block 3032, Block Group 3, Census Tract 5077.02, Santa Clara County, California",6,6,0
1000000US060855077023033,060855077023033,"Block 3033, Block Group 3, Census Tract 5077.02, Santa Clara County, California",0,0,0
1000000US060855077023034,060855077023034,"Block 3034, Block Group 3, Census Tract 5077.02, Santa Clara County, California",0,0,0
1000000US060855077023035,060855077023035,"Block 3035, Block Group 3, Census Tract 5077.02, Santa Clara County, California",80,79,1
1000000US060855077023036,060855077023036,"Block 3036, Block Group 3, Census Tract 5077.02, Santa Clara County, California",0,0,0
1000000US060855077023037,060855077023037,"Block 3037, Block Group 3, Census Tract 5077.02, Santa Clara County, California",14,14,0
1000000US060855077023038,060855077023038,"Block 3038, Block Group 3, Census Tract 5077.02, Santa Clara County, California",0,0,0
1000000US060855077023039,060855077023039,"Block 3039, Block Group 3, Census Tract 5077.02, Santa Clara County, California",50,47,3
1000000US060855077023040,060855077023040,"Block 3040, Block Group 3, Census Tract 5077.02, Santa Clara County, California",3,3,0
1000000US060855077023041,060855077023041,"Block 3041, Block Group 3, Census Tract 5077.02, Santa Clara County, California",0,0,0
1000000US060855077023042,060855077023042,"Block 3042, Block Group 3, Census Tract 5077.02, Santa Clara County, California",3,3,0
1000000US060855077023043,060855077023043,"Block 3043, Block Group 3, Census Tract 5077.02, Santa Clara County, California",0,0,0
1000000US060855077023044,060855077023044,"Block 3044, Block Group 3, Census Tract 5077.02, Santa Clara County, California",0,0,0
1000000US060855077023045,060855077023045,"Block 3045, Block Group 3, Census Tract 5077.02, Santa Clara County, California",0,0,0
1000000US060855077023046,060855077023046,"Block 3046, Block Group 3, Census Tract 5077.02, Santa Clara County, California",13,11,2
1000000US060855077031000,060855077031000,"Block 1000, Block Group 1, Census Tract 5077.03, Santa Clara County, California",0,0,0
1000000US060855077031001,060855077031001,"Block 1001, Block Group 1, Census Tract 5077.03, Santa Clara County, California",0,0,0
1000000US060855077031002,060855077031002,"Block 1002, Block Group 1, Census Tract 5077.03, Santa Clara County, California",1,1,0
1000000US060855077031003,060855077031003,"Block 1003, Block Group 1, Census Tract 5077.03, Santa Clara County, California",0,0,0
1000000US060855077031004,060855077031004,"Block 1004, Block Group 1, Census Tract 5077.03, Santa Clara County, California",19,18,1
1000000US060855077031005,060855077031005,"Block 1005, Block Group 1, Census Tract 5077.03, Santa Clara County, California",0,0,0
1000000US060855077031006,060855077031006,"Block 1006, Block Group 1, Census Tract 5077.03, Santa Clara County, California",0,0,0
1000000US060855077031007,060855077031007,"Block 1007, Block Group 1, Census Tract 5077.03, Santa Clara County, California",0,0,0
1000000US060855077031008,060855077031008,"Block 1008, Block Group 1, Census Tract 5077.03, Santa Clara County, California",2,2,0
1000000US060855077031009,060855077031009,"Block 1009, Block Group 1, Census Tract 5077.03, Santa Clara County, California",147,145,2
1000000US060855077031010,060855077031010,"Block 1010, Block Group 1, Census Tract 5077.03, Santa Clara County, California",29,27,2
1000000US060855077031011,060855077031011,"Block 1011, Block Group 1, Census Tract 5077.03, Santa Clara County, California",6,6,0
1000000US060855077031012,060855077031012,"Block 1012, Block Group 1, Census Tract 5077.03, Santa Clara County, California",20,20,0
1000000US060855077031013,060855077031013,"Block 1013, Block Group 1, Census Tract 5077.03, Santa Clara County, California",9,9,0
1000000US060855077031014,060855077031014,"Block 1014, Block Group 1, Census Tract 5077.03, Santa Clara County, California",27,27,0
1000000US060855077031015,060855077031015,"Block 1015, Block Group 1, Census Tract 5077.03, Santa Clara County, California",0,0,0
1000000US060855077031016,060855077031016,"Block 1016, Block Group 1, Census Tract 5077.03, Santa Clara County, California",78,76,2
1000000US060855077031017,060855077031017,"Block 1017, Block Group 1, Census Tract 5077.03, Santa Clara County, California",10,10,0
1000000US060855077031018,060855077031018,"Block 1018, Block Group 1, Census Tract 5077.03, Santa Clara County, California",0,0,0
1000000US060855077032000,060855077032000,"Block 2000, Block Group 2, Census Tract 5077.03, Santa Clara County, California",22,21,1
1000000US060855077032001,060855077032001,"Block 2001, Block Group 2, Census Tract 5077.03, Santa Clara County, California",2,2,0
1000000US060855077032002,060855077032002,"Block 2002, Block Group 2, Census Tract 5077.03, Santa Clara County, California",2,2,0
1000000US060855077032003,060855077032003,"Block 2003, Block Group 2, Census Tract 5077.03, Santa Clara County, California",0,0,0
1000000US060855077032004,060855077032004,"Block 2004, Block Group 2, Census Tract 5077.03, Santa Clara County, California",4,4,0
1000000US060855077032005,060855077032005,"Block 2005, Block Group 2, Census Tract 5077.03, Santa Clara County, California",1,1,0
1000000US060855077032006,060855077032006,"Block 2006, Block Group 2, Census Tract 5077.03, Santa Clara County, California",1,1,0
1000000US060855077032007,060855077032007,"Block 2007, Block Group 2, Census Tract 5077.03, Santa Clara County, California",54,52,2
1000000US060855077032008,060855077032008,"Block 2008, Block Group 2, Census Tract 5077.03, Santa Clara County, California",21,21,0
1000000US060855077032009,060855077032009,"Block 2009, Block Group 2, Census Tract 5077.03, Santa Clara County, California",16,16,0
1000000US060855077032010,060855077032010,"Block 2010, Block Group 2, Census Tract 5077.03, Santa Clara County, California",33,32,1
1000000US060855077032011,060855077032011,"Block 2011, Block Group 2, Census Tract 5077.03, Santa Clara County, California",13,13,0
1000000US060855077032012,060855077032012,"Block 2012, Block Group 2, Census Tract 5077.03, Santa Clara County, California",1,1,0
1000000US060855077032013,060855077032013,"Block 2013, Block Group 2, Census Tract 5077.03, Santa Clara County, California",0,0,0
1000000US060855077032014,060855077032014,"Block 2014, Block Group 2, Census Tract 5077.03, Santa Clara County, California",1,1,0
1000000US060855077032015,060855077032015,"Block 2015, Block Group 2, Census Tract 5077.03, Santa Clara County, California",476,467,9
1000000US060855077032016,060855077032016,"Block 2016, Block Group 2, Census Tract 5077.03, Santa Clara County, California",82,77,5
1000000US060855077032017,060855077032017,"Block 2017, Block Group 2, Census Tract 5077.03, Santa Clara County, California",14,14,0
1000000US060855077032018,060855077032018,"Block 2018, Block Group 2, Census Tract 5077.03, Santa Clara County, California",118,110,8
1000000US060855077032019,060855077032019,"Block 2019, Block Group 2, Census Tract 5077.03, Santa Clara County, California",12,12,0
1000000US060855077032020,060855077032020,"Block 2020, Block Group 2, Census Tract 5077.03, Santa Clara County, California",0,0,0
1000000US060855077032021,060855077032021,"Block 2021, Block Group 2, Census Tract 5077.03, Santa Clara County, California",20,19,1
1000000US060855077032022,060855077032022,"Block 2022, Block Group 2, Census Tract 5077.03, Santa Clara County, California",0,0,0
1000000US060855077032023,060855077032023,"Block 2023, Block Group 2, Census Tract 5077.03, Santa Clara County, California",0,0,0
1000000US060855077032024,060855077032024,"Block 2024, Block Group 2, Census Tract 5077.03, Santa Clara County, California",0,0,0
1000000US060855077032025,060855077032025,"Block 2025, Block Group 2, Census Tract 5077.03, Santa Clara County, California",18,18,0
1000000US060855077032026,060855077032026,"Block 2026, Block Group 2, Census Tract 5077.03, Santa Clara County, California",8,8,0
1000000US060855077032027,060855077032027,"Block 2027, Block Group 2, Census Tract 5077.03, Santa Clara County, California",15,15,0
1000000US060855077032028,060855077032028,"Block 2028, Block Group 2, Census Tract 5077.03, Santa Clara County, California",2,2,0
1000000US060855077032029,060855077032029,"Block 2029, Block Group 2, Census Tract 5077.03, Santa Clara County, California",0,0,0
1000000US060855077032030,060855077032030,"Block 2030, Block Group 2, Census Tract 5077.03, Santa Clara County, California",0,0,0
1000000US060855077032031,060855077032031,"Block 2031, Block Group 2, Census Tract 5077.03, Santa Clara County, California",0,0,0
1000000US060855077032032,060855077032032,"Block 2032, Block Group 2, Census Tract 5077.03, Santa Clara County, California",0,0,0
1000000US060855077032033,060855077032033,"Block 2033, Block Group 2, Census Tract 5077.03, Santa Clara County, California",0,0,0
1000000US060855077032034,060855077032034,"Block 2034, Block Group 2, Census Tract 5077.03, Santa Clara County, California",1,1,0
1000000US060855077032035,060855077032035,"Block 2035, Block Group 2, Census Tract 5077.03, Santa Clara County, California",42,40,2
1000000US060855077032036,060855077032036,"Block 2036, Block Group 2, Census Tract 5077.03, Santa Clara County, California",0,0,0
1000000US060855077032037,060855077032037,"Block 2037, Block Group 2, Census Tract 5077.03, Santa Clara County, California",0,0,0
1000000US060855077032038,060855077032038,"Block 2038, Block Group 2, Census Tract 5077.03, Santa Clara County, California",0,0,0
1000000US060855077032039,060855077032039,"Block 2039, Block Group 2, Census Tract 5077.03, Santa Clara County, California",0,0,0
1000000US060855077033000,060855077033000,"Block 3000, Block Group 3, Census Tract 5077.03, Santa Clara County, California",76,76,0
1000000US060855077033001,060855077033001,"Block 3001, Block Group 3, Census Tract 5077.03, Santa Clara County, California",1,1,0
1000000US060855077033002,060855077033002,"Block 3002, Block Group 3, Census Tract 5077.03, Santa Clara County, California",40,40,0
1000000US060855077033003,060855077033003,"Block 3003, Block Group 3, Census Tract 5077.03, Santa Clara County, California",43,43,0
1000000US060855077033004,060855077033004,"Block 3004, Block Group 3, Census Tract 5077.03, Santa Clara County, California",75,74,1
1000000US060855077033005,060855077033005,"Block 3005, Block Group 3, Census Tract 5077.03, Santa Clara County, California",17,16,1
1000000US060855077033006,060855077033006,"Block 3006, Block Group 3, Census Tract 5077.03, Santa Clara County, California",30,29,1
1000000US060855077033007,060855077033007,"Block 3007, Block Group 3, Census Tract 5077.03, Santa Clara County, California",30,30,0
1000000US060855077033008,060855077033008,"Block 3008, Block Group 3, Census Tract 5077.03, Santa Clara County, California",30,29,1
1000000US060855077033009,060855077033009,"Block 3009, Block Group 3, Census Tract 5077.03, Santa Clara County, California",23,23,0
1000000US060855077033010,060855077033010,"Block 3010, Block Group 3, Census Tract 5077.03, Santa Clara County, California",35,35,0
1000000US060855077033011,060855077033011,"Block 3011, Block Group 3, Census Tract 5077.03, Santa Clara County, California",29,29,0
1000000US060855077033012,060855077033012,"Block 3012, Block Group 3, Census Tract 5077.03, Santa Clara County, California",20,18,2
1000000US060855077033013,060855077033013,"Block 3013, Block Group 3, Census Tract 5077.03, Santa Clara County, California",64,62,2
1000000US060855077033014,060855077033014,"Block 3014, Block Group 3, Census Tract 5077.03, Santa Clara County, California",0,0,0
1000000US060855077033015,060855077033015,"Block 3015, Block Group 3, Census Tract 5077.03, Santa Clara County, California",4,4,0
1000000US060855077033016,060855077033016,"Block 3016, Block Group 3, Census Tract 5077.03, Santa Clara County, California",67,67,0
1000000US060855077033017,060855077033017,"Block 3017, Block Group 3, Census Tract 5077.03, Santa Clara County, California",31,29,2
1000000US060855077033018,060855077033018,"Block 3018, Block Group 3, Census Tract 5077.03, Santa Clara County, California",12,10,2
1000000US060855077033019,060855077033019,"Block 3019, Block Group 3, Census Tract 5077.03, Santa Clara County, California",36,33,3
1000000US060855077033020,060855077033020,"Block 3020, Block Group 3, Census Tract 5077.03, Santa Clara County, California",30,30,0
1000000US060855077034000,060855077034000,"Block 4000, Block Group 4, Census Tract 5077.03, Santa Clara County, California",62,61,1
1000000US060855077034001,060855077034001,"Block 4001, Block Group 4, Census Tract 5077.03, Santa Clara County, California",15,15,0
1000000US060855077034002,060855077034002,"Block 4002, Block Group 4, Census Tract 5077.03, Santa Clara County, California",20,19,1
1000000US060855077034003,060855077034003,"Block 4003, Block Group 4, Census Tract 5077.03, Santa Clara County, California",22,22,0
1000000US060855077034004,060855077034004,"Block 4004, Block Group 4, Census Tract 5077.03, Santa Clara County, California",88,85,3
1000000US060855077034005,060855077034005,"Block 4005, Block Group 4, Census Tract 5077.03, Santa Clara County, California",40,39,1
1000000US060855077034006,060855077034006,"Block 4006, Block Group 4, Census Tract 5077.03, Santa Clara County, California",55,51,4
1000000US060855077034007,060855077034007,"Block 4007, Block Group 4, Census Tract 5077.03, Santa Clara County, California",48,45,3
1000000US060855077034008,060855077034008,"Block 4008, Block Group 4, Census Tract 5077.03, Santa Clara County, California",23,21,2
1000000US060855077034009,060855077034009,"Block 4009, Block Group 4, Census Tract 5077.03, Santa Clara County, California",2,1,1
1000000US060855077034010,060855077034010,"Block 4010, Block Group 4, Census Tract 5077.03, Santa Clara County, California",0,0,0
1000000US060855077034011,060855077034011,"Block 4011, Block Group 4, Census Tract 5077.03, Santa Clara County, California",0,0,0
1000000US060855077034012,060855077034012,"Block 4012, Block Group 4, Census Tract 5077.03, Santa Clara County, California",0,0,0
1000000US060855077034013,060855077034013,"Block 4013, Block Group 4, Census Tract 5077.03, Santa Clara County, California",0,0,0
1000000US060855077034014,060855077034014,"Block 4014, Block Group 4, Census Tract 5077.03, Santa Clara County, California",0,0,0
1000000US060855077034015,060855077034015,"Block 4015, Block Group 4, Census Tract 5077.03, Santa Clara County, California",0,0,0
1000000US060855077034016,060855077034016,"Block 4016, Block Group 4, Census Tract 5077.03, Santa Clara County, California",0,0,0
1000000US060855077034017,060855077034017,"Block 4017, Block Group 4, Census Tract 5077.03, Santa Clara County, California",0,0,0
1000000US060855077034018,060855077034018,"Block 4018, Block Group 4, Census Tract 5077.03, Santa Clara County, California",0,0,0
1000000US060855077034019,060855077034019,"Block 4019, Block Group 4, Census Tract 5077.03, Santa Clara County, California",0,0,0
1000000US060855077034020,060855077034020,"Block 4020, Block Group 4, Census Tract 5077.03, Santa Clara County, California",0,0,0
1000000US060855077035000,060855077035000,"Block 5000, Block Group 5, Census Tract 5077.03, Santa Clara County, California",236,234,2
1000000US060855077035001,060855077035001,"Block 5001, Block Group 5, Census Tract 5077.03, Santa Clara County, California",0,0,0
1000000US060855077035002,060855077035002,"Block 5002, Block Group 5, Census Tract 5077.03, Santa Clara County, California",35,34,1
1000000US060855077035003,060855077035003,"Block 5003, Block Group 5, Census Tract 5077.03, Santa Clara County, California",109,108,1
1000000US060855077035004,060855077035004,"Block 5004, Block Group 5, Census Tract 5077.03, Santa Clara County, California",0,0,0
1000000US060855077035005,060855077035005,"Block 5005, Block Group 5, Census Tract 5077.03, Santa Clara County, California",0,0,0
1000000US060855077035006,060855077035006,"Block 5006, Block Group 5, Census Tract 5077.03, Santa Clara County, California",18,18,0
1000000US060855077035007,060855077035007,"Block 5007, Block Group 5, Census Tract 5077.03, Santa Clara County, California",19,19,0
1000000US060855077035008,060855077035008,"Block 5008, Block Group 5, Census Tract 5077.03, Santa Clara County, California",0,0,0
1000000US060855077035009,060855077035009,"Block 5009, Block Group 5, Census Tract 5077.03, Santa Clara County, California",0,0,0
1000000US060855078051000,060855078051000,"Block 1000, Block Group 1, Census Tract 5078.05, Santa Clara County, California",0,0,0
1000000US060855078051001,060855078051001,"Block 1001, Block Group 1, Census Tract 5078.05, Santa Clara County, California",0,0,0
1000000US060855078051002,060855078051002,"Block 1002, Block Group 1, Census Tract 5078.05, Santa Clara County, California",0,0,0
1000000US060855078051003,060855078051003,"Block 1003, Block Group 1, Census Tract 5078.05, Santa Clara County, California",0,0,0
1000000US060855078051004,060855078051004,"Block 1004, Block Group 1, Census Tract 5078.05, Santa Clara County, California",3,3,0
1000000US060855078051005,060855078051005,"Block 1005, Block Group 1, Census Tract 5078.05, Santa Clara County, California",0,0,0
1000000US060855078051006,060855078051006,"Block 1006, Block Group 1, Census Tract 5078.05, Santa Clara County, California",0,0,0
1000000US060855078051007,060855078051007,"Block 1007, Block Group 1, Census Tract 5078.05, Santa Clara County, California",0,0,0
1000000US060855078051008,060855078051008,"Block 1008, Block Group 1, Census Tract 5078.05, Santa Clara County, California",53,52,1
1000000US060855078051009,060855078051009,"Block 1009, Block Group 1, Census Tract 5078.05, Santa Clara County, California",1,1,0
1000000US060855078051010,060855078051010,"Block 1010, Block Group 1, Census Tract 5078.05, Santa Clara County, California",0,0,0
1000000US060855078051011,060855078051011,"Block 1011, Block Group 1, Census Tract 5078.05, Santa Clara County, California",0,0,0
1000000US060855078051012,060855078051012,"Block 1012, Block Group 1, Census Tract 5078.05, Santa Clara County, California",1,1,0
1000000US060855078051013,060855078051013,"Block 1013, Block Group 1, Census Tract 5078.05, Santa Clara County, California",96,90,6
1000000US060855078051014,060855078051014,"Block 1014, Block Group 1, Census Tract 5078.05, Santa Clara County, California",0,0,0
1000000US060855078051015,060855078051015,"Block 1015, Block Group 1, Census Tract 5078.05, Santa Clara County, California",605,490,115
1000000US060855078051016,060855078051016,"Block 1016, Block Group 1, Census Tract 5078.05, Santa Clara County, California",0,0,0
1000000US060855078051017,060855078051017,"Block 1017, Block Group 1, Census Tract 5078.05, Santa Clara County, California",30,15,15
1000000US060855078051018,060855078051018,"Block 1018, Block Group 1, Census Tract 5078.05, Santa Clara County, California",0,0,0
1000000US060855078051019,060855078051019,"Block 1019, Block Group 1, Census Tract 5078.05, Santa Clara County, California",0,0,0
1000000US060855078051020,060855078051020,"Block 1020, Block Group 1, Census Tract 5078.05, Santa Clara County, California",1,1,0
1000000US060855078051021,060855078051021,"Block 1021, Block Group 1, Census Tract 5078.05, Santa Clara County, California",0,0,0
1000000US060855078051022,060855078051022,"Block 1022, Block Group 1, Census Tract 5078.05, Santa Clara County, California",0,0,0
1000000US060855078051023,060855078051023,"Block 1023, Block Group 1, Census Tract 5078.05, Santa Clara County, California",72,71,1
1000000US060855078051024,060855078051024,"Block 1024, Block Group 1, Census Tract 5078.05, Santa Clara County, California",0,0,0
1000000US060855078051025,060855078051025,"Block 1025, Block Group 1, Census Tract 5078.05, Santa Clara County, California",64,63,1
1000000US060855078051026,060855078051026,"Block 1026, Block Group 1, Census Tract 5078.05, Santa Clara County, California",4,4,0
1000000US060855078051027,060855078051027,"Block 1027, Block Group 1, Census Tract 5078.05, Santa Clara County, California",123,118,5
1000000US060855078051028,060855078051028,"Block 1028, Block Group 1, Census Tract 5078.05, Santa Clara County, California",0,0,0
1000000US060855078051029,060855078051029,"Block 1029, Block Group 1, Census Tract 5078.05, Santa Clara County, California",0,0,0
1000000US060855078051030,060855078051030,"Block 1030, Block Group 1, Census Tract 5078.05, Santa Clara County, California",0,0,0
1000000US060855078051031,060855078051031,"Block 1031, Block Group 1, Census Tract 5078.05, Santa Clara County, California",71,71,0
1000000US060855078051032,060855078051032,"Block 1032, Block Group 1, Census Tract 5078.05, Santa Clara County, California",15,15,0
1000000US060855078051033,060855078051033,"Block 1033, Block Group 1, Census Tract 5078.05, Santa Clara County, California",13,13,0
1000000US060855078051034,060855078051034,"Block 1034, Block Group 1, Census Tract 5078.05, Santa Clara County, California",0,0,0
1000000US060855078051035,060855078051035,"Block 1035, Block Group 1, Census Tract 5078.05, Santa Clara County, California",17,17,0
1000000US060855078051036,060855078051036,"Block 1036, Block Group 1, Census Tract 5078.05, Santa Clara County, California",34,33,1
1000000US060855078051037,060855078051037,"Block 1037, Block Group 1, Census Tract 5078.05, Santa Clara County, California",10,10,0
1000000US060855078051038,060855078051038,"Block 1038, Block Group 1, Census Tract 5078.05, Santa Clara County, California",0,0,0
1000000US060855078051039,060855078051039,"Block 1039, Block Group 1, Census Tract 5078.05, Santa Clara County, California",0,0,0
1000000US060855078051040,060855078051040,"Block 1040, Block Group 1, Census Tract 5078.05, Santa Clara County, California",21,20,1
1000000US060855078051041,060855078051041,"Block 1041, Block Group 1, Census Tract 5078.05, Santa Clara County, California",0,0,0
1000000US060855078051042,060855078051042,"Block 1042, Block Group 1, Census Tract 5078.05, Santa Clara County, California",0,0,0
1000000US060855078051043,060855078051043,"Block 1043, Block Group 1, Census Tract 5078.05, Santa Clara County, California",0,0,0
1000000US060855078051044,060855078051044,"Block 1044, Block Group 1, Census Tract 5078.05, Santa Clara County, California",0,0,0
1000000US060855078051045,060855078051045,"Block 1045, Block Group 1, Census Tract 5078.05, Santa Clara County, California",0,0,0
1000000US060855078051046,060855078051046,"Block 1046, Block Group 1, Census Tract 5078.05, Santa Clara County, California",30,30,0
1000000US060855078051047,060855078051047,"Block 1047, Block Group 1, Census Tract 5078.05, Santa Clara County, California",26,26,0
1000000US060855078051048,060855078051048,"Block 1048, Block Group 1, Census Tract 5078.05, Santa Clara County, California",0,0,0
1000000US060855078051049,060855078051049,"Block 1049, Block Group 1, Census Tract 5078.05, Santa Clara County, California",1,1,0
1000000US060855078051050,060855078051050,"Block 1050, Block Group 1, Census Tract 5078.05, Santa Clara County, California",0,0,0
1000000US060855078051051,060855078051051,"Block 1051, Block Group 1, Census Tract 5078.05, Santa Clara County, California",0,0,0
1000000US060855078051052,060855078051052,"Block 1052, Block Group 1, Census Tract 5078.05, Santa Clara County, California",0,0,0
1000000US060855078051053,060855078051053,"Block 1053, Block Group 1, Census Tract 5078.05, Santa Clara County, California",0,0,0
1000000US060855078051054,060855078051054,"Block 1054, Block Group 1, Census Tract 5078.05, Santa Clara County, California",0,0,0
1000000US060855078051055,060855078051055,"Block 1055, Block Group 1, Census Tract 5078.05, Santa Clara County, California",0,0,0
1000000US060855078051056,060855078051056,"Block 1056, Block Group 1, Census Tract 5078.05, Santa Clara County, California",0,0,0
1000000US060855078051057,060855078051057,"Block 1057, Block Group 1, Census Tract 5078.05, Santa Clara County, California",0,0,0
1000000US060855078051058,060855078051058,"Block 1058, Block Group 1, Census Tract 5078.05, Santa Clara County, California",12,12,0
1000000US060855078051059,060855078051059,"Block 1059, Block Group 1, Census Tract 5078.05, Santa Clara County, California",0,0,0
1000000US060855078052000,060855078052000,"Block 2000, Block Group 2, Census Tract 5078.05, Santa Clara County, California",0,0,0
1000000US060855078052001,060855078052001,"Block 2001, Block Group 2, Census Tract 5078.05, Santa Clara County, California",42,40,2
1000000US060855078052002,060855078052002,"Block 2002, Block Group 2, Census Tract 5078.05, Santa Clara County, California",0,0,0
1000000US060855078052003,060855078052003,"Block 2003, Block Group 2, Census Tract 5078.05, Santa Clara County, California",0,0,0
1000000US060855078052004,060855078052004,"Block 2004, Block Group 2, Census Tract 5078.05, Santa Clara County, California",0,0,0
1000000US060855078052005,060855078052005,"Block 2005, Block Group 2, Census Tract 5078.05, Santa Clara County, California",0,0,0
1000000US060855078052006,060855078052006,"Block 2006, Block Group 2, Census Tract 5078.05, Santa Clara County, California",67,65,2
1000000US060855078052007,060855078052007,"Block 2007, Block Group 2, Census Tract 5078.05, Santa Clara County, California",22,22,0
1000000US060855078052008,060855078052008,"Block 2008, Block Group 2, Census Tract 5078.05, Santa Clara County, California",27,26,1
1000000US060855078052009,060855078052009,"Block 2009, Block Group 2, Census Tract 5078.05, Santa Clara County, California",33,33,0
1000000US060855078052010,060855078052010,"Block 2010, Block Group 2, Census Tract 5078.05, Santa Clara County, California",1,1,0
1000000US060855078052011,060855078052011,"Block 2011, Block Group 2, Census Tract 5078.05, Santa Clara County, California",0,0,0
1000000US060855078052012,060855078052012,"Block 2012, Block Group 2, Census Tract 5078.05, Santa Clara County, California",0,0,0
1000000US060855078052013,060855078052013,"Block 2013, Block Group 2, Census Tract 5078.05, Santa Clara County, California",0,0,0
1000000US060855078052014,060855078052014,"Block 2014, Block Group 2, Census Tract 5078.05, Santa Clara County, California",0,0,0
1000000US060855078052015,060855078052015,"Block 2015, Block Group 2, Census Tract 5078.05, Santa Clara County, California",102,98,4
1000000US060855078052016,060855078052016,"Block 2016, Block Group 2, Census Tract 5078.05, Santa Clara County, California",48,46,2
1000000US060855078052017,060855078052017,"Block 2017, Block Group 2, Census Tract 5078.05, Santa Clara County, California",72,72,0
1000000US060855078052018,060855078052018,"Block 2018, Block Group 2, Census Tract 5078.05, Santa Clara County, California",0,0,0
1000000US060855078052019,060855078052019,"Block 2019, Block Group 2, Census Tract 5078.05, Santa Clara County, California",0,0,0
1000000US060855078052020,060855078052020,"Block 2020, Block Group 2, Census Tract 5078.05, Santa Clara County, California",0,0,0
1000000US060855078052021,060855078052021,"Block 2021, Block Group 2, Census Tract 5078.05, Santa Clara County, California",1,1,0
1000000US060855078052022,060855078052022,"Block 2022, Block Group 2, Census Tract 5078.05, Santa Clara County, California",0,0,0
1000000US060855078052023,060855078052023,"Block 2023, Block Group 2, Census Tract 5078.05, Santa Clara County, California",0,0,0
1000000US060855078052024,060855078052024,"Block 2024, Block Group 2, Census Tract 5078.05, Santa Clara County, California",0,0,0
1000000US060855078052025,060855078052025,"Block 2025, Block Group 2, Census Tract 5078.05, Santa Clara County, California",0,0,0
1000000US060855078052026,060855078052026,"Block 2026, Block Group 2, Census Tract 5078.05, Santa Clara County, California",0,0,0
1000000US060855078052027,060855078052027,"Block 2027, Block Group 2, Census Tract 5078.05, Santa Clara County, California",67,66,1
1000000US060855078052028,060855078052028,"Block 2028, Block Group 2, Census Tract 5078.05, Santa Clara County, California",0,0,0
1000000US060855078052029,060855078052029,"Block 2029, Block Group 2, Census Tract 5078.05, Santa Clara County, California",0,0,0
1000000US060855078052030,060855078052030,"Block 2030, Block Group 2, Census Tract 5078.05, Santa Clara County, California",0,0,0
1000000US060855078052031,060855078052031,"Block 2031, Block Group 2, Census Tract 5078.05, Santa Clara County, California",0,0,0
1000000US060855078052032,060855078052032,"Block 2032, Block Group 2, Census Tract 5078.05, Santa Clara County, California",0,0,0
1000000US060855078052033,060855078052033,"Block 2033, Block Group 2, Census Tract 5078.05, Santa Clara County, California",0,0,0
1000000US060855078052034,060855078052034,"Block 2034, Block Group 2, Census Tract 5078.05, Santa Clara County, California",0,0,0
1000000US060855078052035,060855078052035,"Block 2035, Block Group 2, Census Tract 5078.05, Santa Clara County, California",0,0,0
1000000US060855078052036,060855078052036,"Block 2036, Block Group 2, Census Tract 5078.05, Santa Clara County, California",0,0,0
1000000US060855078052037,060855078052037,"Block 2037, Block Group 2, Census Tract 5078.05, Santa Clara County, California",0,0,0
1000000US060855078052038,060855078052038,"Block 2038, Block Group 2, Census Tract 5078.05, Santa Clara County, California",0,0,0
1000000US060855078053000,060855078053000,"Block 3000, Block Group 3, Census Tract 5078.05, Santa Clara County, California",31,31,0
1000000US060855078053001,060855078053001,"Block 3001, Block Group 3, Census Tract 5078.05, Santa Clara County, California",18,18,0
1000000US060855078053002,060855078053002,"Block 3002, Block Group 3, Census Tract 5078.05, Santa Clara County, California",2,2,0
1000000US060855078053003,060855078053003,"Block 3003, Block Group 3, Census Tract 5078.05, Santa Clara County, California",0,0,0
1000000US060855078053004,060855078053004,"Block 3004, Block Group 3, Census Tract 5078.05, Santa Clara County, California",0,0,0
1000000US060855078053005,060855078053005,"Block 3005, Block Group 3, Census Tract 5078.05, Santa Clara County, California",30,29,1
1000000US060855078053006,060855078053006,"Block 3006, Block Group 3, Census Tract 5078.05, Santa Clara County, California",42,42,0
1000000US060855078053007,060855078053007,"Block 3007, Block Group 3, Census Tract 5078.05, Santa Clara County, California",0,0,0
1000000US060855078053008,060855078053008,"Block 3008, Block Group 3, Census Tract 5078.05, Santa Clara County, California",0,0,0
1000000US060855078053009,060855078053009,"Block 3009, Block Group 3, Census Tract 5078.05, Santa Clara County, California",0,0,0
1000000US060855078053010,060855078053010,"Block 3010, Block Group 3, Census Tract 5078.05, Santa Clara County, California",0,0,0
1000000US060855078053011,060855078053011,"Block 3011, Block Group 3, Census Tract 5078.05, Santa Clara County, California",101,98,3
1000000US060855078053012,060855078053012,"Block 3012, Block Group 3, Census Tract 5078.05, Santa Clara County, California",9,9,0
1000000US060855078053013,060855078053013,"Block 3013, Block Group 3, Census Tract 5078.05, Santa Clara County, California",9,8,1
1000000US060855078053014,060855078053014,"Block 3014, Block Group 3, Census Tract 5078.05, Santa Clara County, California",44,43,1
1000000US060855078053015,060855078053015,"Block 3015, Block Group 3, Census Tract 5078.05, Santa Clara County, California",28,28,0
1000000US060855078053016,060855078053016,"Block 3016, Block Group 3, Census Tract 5078.05, Santa Clara County, California",43,35,8
1000000US060855078053017,060855078053017,"Block 3017, Block Group 3, Census Tract 5078.05, Santa Clara County, California",17,16,1
1000000US060855078053018,060855078053018,"Block 3018, Block Group 3, Census Tract 5078.05, Santa Clara County, California",0,0,0
1000000US060855078053019,060855078053019,"Block 3019, Block Group 3, Census Tract 5078.05, Santa Clara County, California",0,0,0
1000000US060855078053020,060855078053020,"Block 3020, Block Group 3, Census Tract 5078.05, Santa Clara County, California",0,0,0
1000000US060855078053021,060855078053021,"Block 3021, Block Group 3, Census Tract 5078.05, Santa Clara County, California",0,0,0
1000000US060855078053022,060855078053022,"Block 3022, Block Group 3, Census Tract 5078.05, Santa Clara County, California",0,0,0
1000000US060855078053023,060855078053023,"Block 3023, Block Group 3, Census Tract 5078.05, Santa Clara County, California",0,0,0
1000000US060855078053024,060855078053024,"Block 3024, Block Group 3, Census Tract 5078.05, Santa Clara County, California",0,0,0
1000000US060855078053025,060855078053025,"Block 3025, Block Group 3, Census Tract 5078.05, Santa Clara County, California",0,0,0
1000000US060855078053026,060855078053026,"Block 3026, Block Group 3, Census Tract 5078.05, Santa Clara County, California",0,0,0
1000000US060855078053027,060855078053027,"Block 3027, Block Group 3, Census Tract 5078.05, Santa Clara County, California",0,0,0
1000000US060855078053028,060855078053028,"Block 3028, Block Group 3, Census Tract 5078.05, Santa Clara County, California",32,31,1
1000000US060855078061000,060855078061000,"Block 1000, Block Group 1, Census Tract 5078.06, Santa Clara County, California",40,39,1
1000000US060855078061001,060855078061001,"Block 1001, Block Group 1, Census Tract 5078.06, Santa Clara County, California",24,23,1
1000000US060855078061002,060855078061002,"Block 1002, Block Group 1, Census Tract 5078.06, Santa Clara County, California",86,82,4
1000000US060855078061003,060855078061003,"Block 1003, Block Group 1, Census Tract 5078.06, Santa Clara County, California",26,26,0
1000000US060855078061004,060855078061004,"Block 1004, Block Group 1, Census Tract 5078.06, Santa Clara County, California",71,70,1
1000000US060855078061005,060855078061005,"Block 1005, Block Group 1, Census Tract 5078.06, Santa Clara County, California",23,23,0
1000000US060855078061006,060855078061006,"Block 1006, Block Group 1, Census Tract 5078.06, Santa Clara County, California",22,21,1
1000000US060855078061007,060855078061007,"Block 1007, Block Group 1, Census Tract 5078.06, Santa Clara County, California",28,27,1
1000000US060855078061008,060855078061008,"Block 1008, Block Group 1, Census Tract 5078.06, Santa Clara County, California",47,47,0
1000000US060855078061009,060855078061009,"Block 1009, Block Group 1, Census Tract 5078.06, Santa Clara County, California",14,14,0
1000000US060855078062000,060855078062000,"Block 2000, Block Group 2, Census Tract 5078.06, Santa Clara County, California",242,230,12
1000000US060855078062001,060855078062001,"Block 2001, Block Group 2, Census Tract 5078.06, Santa Clara County, California",34,32,2
1000000US060855078062002,060855078062002,"Block 2002, Block Group 2, Census Tract 5078.06, Santa Clara County, California",23,22,1
1000000US060855078062003,060855078062003,"Block 2003, Block Group 2, Census Tract 5078.06, Santa Clara County, California",88,84,4
1000000US060855078062004,060855078062004,"Block 2004, Block Group 2, Census Tract 5078.06, Santa Clara County, California",71,66,5
1000000US060855078062005,060855078062005,"Block 2005, Block Group 2, Census Tract 5078.06, Santa Clara County, California",158,152,6
1000000US060855078062006,060855078062006,"Block 2006, Block Group 2, Census Tract 5078.06, Santa Clara County, California",25,24,1
1000000US060855078062007,060855078062007,"Block 2007, Block Group 2, Census Tract 5078.06, Santa Clara County, California",0,0,0
1000000US060855078062008,060855078062008,"Block 2008, Block Group 2, Census Tract 5078.06, Santa Clara County, California",0,0,0
1000000US060855078062009,060855078062009,"Block 2009, Block Group 2, Census Tract 5078.06, Santa Clara County, California",12,11,1
1000000US060855078062010,060855078062010,"Block 2010, Block Group 2, Census Tract 5078.06, Santa Clara County, California",35,35,0
1000000US060855078063000,060855078063000,"Block 3000, Block Group 3, Census Tract 5078.06, Santa Clara County, California",0,0,0
1000000US060855078063001,060855078063001,"Block 3001, Block Group 3, Census Tract 5078.06, Santa Clara County, California",280,260,20
1000000US060855078063002,060855078063002,"Block 3002, Block Group 3, Census Tract 5078.06, Santa Clara County, California",0,0,0
1000000US060855078063003,060855078063003,"Block 3003, Block Group 3, Census Tract 5078.06, Santa Clara County, California",25,24,1
1000000US060855078063004,060855078063004,"Block 3004, Block Group 3, Census Tract 5078.06, Santa Clara County, California",0,0,0
1000000US060855078063005,060855078063005,"Block 3005, Block Group 3, Census Tract 5078.06, Santa Clara County, California",1,1,0
1000000US060855078063006,060855078063006,"Block 3006, Block Group 3, Census Tract 5078.06, Santa Clara County, California",0,0,0
1000000US060855078063007,060855078063007,"Block 3007, Block Group 3, Census Tract 5078.06, Santa Clara County, California",133,132,1
1000000US060855078063008,060855078063008,"Block 3008, Block Group 3, Census Tract 5078.06, Santa Clara County, California",31,30,1
1000000US060855078063009,060855078063009,"Block 3009, Block Group 3, Census Tract 5078.06, Santa Clara County, California",45,43,2
1000000US060855078063010,060855078063010,"Block 3010, Block Group 3, Census Tract 5078.06, Santa Clara County, California",27,24,3
1000000US060855078063011,060855078063011,"Block 3011, Block Group 3, Census Tract 5078.06, Santa Clara County, California",251,243,8
1000000US060855078063012,060855078063012,"Block 3012, Block Group 3, Census Tract 5078.06, Santa Clara County, California",16,16,0
1000000US060855078063013,060855078063013,"Block 3013, Block Group 3, Census Tract 5078.06, Santa Clara County, California",0,0,0
1000000US060855078063014,060855078063014,"Block 3014, Block Group 3, Census Tract 5078.06, Santa Clara County, California",0,0,0
1000000US060855078063015,060855078063015,"Block 3015, Block Group 3, Census Tract 5078.06, Santa Clara County, California",0,0,0
1000000US060855078063016,060855078063016,"Block 3016, Block Group 3, Census Tract 5078.06, Santa Clara County, California",87,84,3
1000000US060855078063017,060855078063017,"Block 3017, Block Group 3, Census Tract 5078.06, Santa Clara County, California",26,25,1
1000000US060855078063018,060855078063018,"Block 3018, Block Group 3, Census Tract 5078.06, Santa Clara County, California",0,0,0
1000000US060855078063019,060855078063019,"Block 3019, Block Group 3, Census Tract 5078.06, Santa Clara County, California",0,0,0
1000000US060855078063020,060855078063020,"Block 3020, Block Group 3, Census Tract 5078.06, Santa Clara County, California",8,8,0
1000000US060855078063021,060855078063021,"Block 3021, Block Group 3, Census Tract 5078.06, Santa Clara County, California",0,0,0
1000000US060855078063022,060855078063022,"Block 3022, Block Group 3, Census Tract 5078.06, Santa Clara County, California",0,0,0
1000000US060855078063023,060855078063023,"Block 3023, Block Group 3, Census Tract 5078.06, Santa Clara County, California",0,0,0
1000000US060855078063024,060855078063024,"Block 3024, Block Group 3, Census Tract 5078.06, Santa Clara County, California",0,0,0
1000000US060855078063025,060855078063025,"Block 3025, Block Group 3, Census Tract 5078.06, Santa Clara County, California",20,16,4
1000000US060855078063026,060855078063026,"Block 3026, Block Group 3, Census Tract 5078.06, Santa Clara County, California",20,19,1
1000000US060855078071000,060855078071000,"Block 1000, Block Group 1, Census Tract 5078.07, Santa Clara County, California",20,19,1
1000000US060855078071001,060855078071001,"Block 1001, Block Group 1, Census Tract 5078.07, Santa Clara County, California",21,19,2
1000000US060855078071002,060855078071002,"Block 1002, Block Group 1, Census Tract 5078.07, Santa Clara County, California",20,20,0
1000000US060855078071003,060855078071003,"Block 1003, Block Group 1, Census Tract 5078.07, Santa Clara County, California",23,23,0
1000000US060855078071004,060855078071004,"Block 1004, Block Group 1, Census Tract 5078.07, Santa Clara County, California",37,37,0
1000000US060855078071005,060855078071005,"Block 1005, Block Group 1, Census Tract 5078.07, Santa Clara County, California",76,75,1
1000000US060855078071006,060855078071006,"Block 1006, Block Group 1, Census Tract 5078.07, Santa Clara County, California",30,30,0
1000000US060855078071007,060855078071007,"Block 1007, Block Group 1, Census Tract 5078.07, Santa Clara County, California",24,24,0
1000000US060855078071008,060855078071008,"Block 1008, Block Group 1, Census Tract 5078.07, Santa Clara County, California",26,26,0
1000000US060855078071009,060855078071009,"Block 1009, Block Group 1, Census Tract 5078.07, Santa Clara County, California",4,4,0
1000000US060855078071010,060855078071010,"Block 1010, Block Group 1, Census Tract 5078.07, Santa Clara County, California",66,63,3
1000000US060855078071011,060855078071011,"Block 1011, Block Group 1, Census Tract 5078.07, Santa Clara County, California",5,5,0
1000000US060855078071012,060855078071012,"Block 1012, Block Group 1, Census Tract 5078.07, Santa Clara County, California",16,16,0
1000000US060855078071013,060855078071013,"Block 1013, Block Group 1, Census Tract 5078.07, Santa Clara County, California",38,37,1
1000000US060855078071014,060855078071014,"Block 1014, Block Group 1, Census Tract 5078.07, Santa Clara County, California",17,17,0
1000000US060855078071015,060855078071015,"Block 1015, Block Group 1, Census Tract 5078.07, Santa Clara County, California",9,9,0
1000000US060855078071016,060855078071016,"Block 1016, Block Group 1, Census Tract 5078.07, Santa Clara County, California",0,0,0
1000000US060855078072000,060855078072000,"Block 2000, Block Group 2, Census Tract 5078.07, Santa Clara County, California",162,158,4
1000000US060855078072001,060855078072001,"Block 2001, Block Group 2, Census Tract 5078.07, Santa Clara County, California",81,78,3
1000000US060855078072002,060855078072002,"Block 2002, Block Group 2, Census Tract 5078.07, Santa Clara County, California",16,15,1
1000000US060855078072003,060855078072003,"Block 2003, Block Group 2, Census Tract 5078.07, Santa Clara County, California",0,0,0
1000000US060855078072004,060855078072004,"Block 2004, Block Group 2, Census Tract 5078.07, Santa Clara County, California",23,22,1
1000000US060855078072005,060855078072005,"Block 2005, Block Group 2, Census Tract 5078.07, Santa Clara County, California",75,72,3
1000000US060855078072006,060855078072006,"Block 2006, Block Group 2, Census Tract 5078.07, Santa Clara County, California",92,91,1
1000000US060855078072007,060855078072007,"Block 2007, Block Group 2, Census Tract 5078.07, Santa Clara County, California",102,100,2
1000000US060855078072008,060855078072008,"Block 2008, Block Group 2, Census Tract 5078.07, Santa Clara County, California",38,38,0
1000000US060855078072009,060855078072009,"Block 2009, Block Group 2, Census Tract 5078.07, Santa Clara County, California",32,31,1
1000000US060855078081000,060855078081000,"Block 1000, Block Group 1, Census Tract 5078.08, Santa Clara County, California",0,0,0
1000000US060855078081001,060855078081001,"Block 1001, Block Group 1, Census Tract 5078.08, Santa Clara County, California",0,0,0
1000000US060855078081002,060855078081002,"Block 1002, Block Group 1, Census Tract 5078.08, Santa Clara County, California",0,0,0
1000000US060855078081003,060855078081003,"Block 1003, Block Group 1, Census Tract 5078.08, Santa Clara County, California",143,142,1
1000000US060855078081004,060855078081004,"Block 1004, Block Group 1, Census Tract 5078.08, Santa Clara County, California",43,43,0
1000000US060855078081005,060855078081005,"Block 1005, Block Group 1, Census Tract 5078.08, Santa Clara County, California",23,23,0
1000000US060855078081006,060855078081006,"Block 1006, Block Group 1, Census Tract 5078.08, Santa Clara County, California",39,37,2
1000000US060855078081007,060855078081007,"Block 1007, Block Group 1, Census Tract 5078.08, Santa Clara County, California",29,28,1
1000000US060855078081008,060855078081008,"Block 1008, Block Group 1, Census Tract 5078.08, Santa Clara County, California",1,1,0
1000000US060855078082000,060855078082000,"Block 2000, Block Group 2, Census Tract 5078.08, Santa Clara County, California",0,0,0
1000000US060855078082001,060855078082001,"Block 2001, Block Group 2, Census Tract 5078.08, Santa Clara County, California",0,0,0
1000000US060855078082002,060855078082002,"Block 2002, Block Group 2, Census Tract 5078.08, Santa Clara County, California",151,145,6
1000000US060855078082003,060855078082003,"Block 2003, Block Group 2, Census Tract 5078.08, Santa Clara County, California",16,15,1
1000000US060855078082004,060855078082004,"Block 2004, Block Group 2, Census Tract 5078.08, Santa Clara County, California",46,45,1
1000000US060855078082005,060855078082005,"Block 2005, Block Group 2, Census Tract 5078.08, Santa Clara County, California",95,93,2
1000000US060855078082006,060855078082006,"Block 2006, Block Group 2, Census Tract 5078.08, Santa Clara County, California",0,0,0
1000000US060855078082007,060855078082007,"Block 2007, Block Group 2, Census Tract 5078.08, Santa Clara County, California",107,103,4
1000000US060855078082008,060855078082008,"Block 2008, Block Group 2, Census Tract 5078.08, Santa Clara County, California",22,22,0
1000000US060855078082009,060855078082009,"Block 2009, Block Group 2, Census Tract 5078.08, Santa Clara County, California",14,14,0
1000000US060855078082010,060855078082010,"Block 2010, Block Group 2, Census Tract 5078.08, Santa Clara County, California",12,10,2
1000000US060855078082011,060855078082011,"Block 2011, Block Group 2, Census Tract 5078.08, Santa Clara County, California",0,0,0
1000000US060855078083000,060855078083000,"Block 3000, Block Group 3, Census Tract 5078.08, Santa Clara County, California",35,35,0
1000000US060855078083001,060855078083001,"Block 3001, Block Group 3, Census Tract 5078.08, Santa Clara County, California",116,102,14
1000000US060855078083002,060855078083002,"Block 3002, Block Group 3, Census Tract 5078.08, Santa Clara County, California",159,145,14
1000000US060855078083003,060855078083003,"Block 3003, Block Group 3, Census Tract 5078.08, Santa Clara County, California",23,23,0
1000000US060855078083004,060855078083004,"Block 3004, Block Group 3, Census Tract 5078.08, Santa Clara County, California",25,25,0
1000000US060855078083005,060855078083005,"Block 3005, Block Group 3, Census Tract 5078.08, Santa Clara County, California",17,17,0
1000000US060855078083006,060855078083006,"Block 3006, Block Group 3, Census Tract 5078.08, Santa Clara County, California",28,28,0
1000000US060855078083007,060855078083007,"Block 3007, Block Group 3, Census Tract 5078.08, Santa Clara County, California",30,29,1
1000000US060855078083008,060855078083008,"Block 3008, Block Group 3, Census Tract 5078.08, Santa Clara County, California",0,0,0
1000000US060855078083009,060855078083009,"Block 3009, Block Group 3, Census Tract 5078.08, Santa Clara County, California",0,0,0
1000000US060855078083010,060855078083010,"Block 3010, Block Group 3, Census Tract 5078.08, Santa Clara County, California",1,1,0
1000000US060855078083011,060855078083011,"Block 3011, Block Group 3, Census Tract 5078.08, Santa Clara County, California",9,9,0
1000000US060855078083012,060855078083012,"Block 3012, Block Group 3, Census Tract 5078.08, Santa Clara County, California",3,3,0
1000000US060855078083013,060855078083013,"Block 3013, Block Group 3, Census Tract 5078.08, Santa Clara County, California",0,0,0
1000000US060855078083014,060855078083014,"Block 3014, Block Group 3, Census Tract 5078.08, Santa Clara County, California",2,2,0
1000000US060855078084000,060855078084000,"Block 4000, Block Group 4, Census Tract 5078.08, Santa Clara County, California",0,0,0
1000000US060855078084001,060855078084001,"Block 4001, Block Group 4, Census Tract 5078.08, Santa Clara County, California",116,109,7
1000000US060855078084002,060855078084002,"Block 4002, Block Group 4, Census Tract 5078.08, Santa Clara County, California",33,32,1
1000000US060855078084003,060855078084003,"Block 4003, Block Group 4, Census Tract 5078.08, Santa Clara County, California",40,39,1
1000000US060855078084004,060855078084004,"Block 4004, Block Group 4, Census Tract 5078.08, Santa Clara County, California",72,71,1
1000000US060855078084005,060855078084005,"Block 4005, Block Group 4, Census Tract 5078.08, Santa Clara County, California",30,30,0
1000000US060855078084006,060855078084006,"Block 4006, Block Group 4, Census Tract 5078.08, Santa Clara County, California",30,30,0
1000000US060855078084007,060855078084007,"Block 4007, Block Group 4, Census Tract 5078.08, Santa Clara County, California",0,0,0
1000000US060855078084008,060855078084008,"Block 4008, Block Group 4, Census Tract 5078.08, Santa Clara County, California",40,39,1
1000000US060855078084009,060855078084009,"Block 4009, Block Group 4, Census Tract 5078.08, Santa Clara County, California",26,26,0
1000000US060855078084010,060855078084010,"Block 4010, Block Group 4, Census Tract 5078.08, Santa Clara County, California",54,54,0
1000000US060855078084011,060855078084011,"Block 4011, Block Group 4, Census Tract 5078.08, Santa Clara County, California",19,19,0
1000000US060855078084012,060855078084012,"Block 4012, Block Group 4, Census Tract 5078.08, Santa Clara County, California",57,57,0
1000000US060855078084013,060855078084013,"Block 4013, Block Group 4, Census Tract 5078.08, Santa Clara County, California",0,0,0
1000000US060855078084014,060855078084014,"Block 4014, Block Group 4, Census Tract 5078.08, Santa Clara County, California",20,20,0
1000000US060855078084015,060855078084015,"Block 4015, Block Group 4, Census Tract 5078.08, Santa Clara County, California",31,30,1
1000000US060855078084016,060855078084016,"Block 4016, Block Group 4, Census Tract 5078.08, Santa Clara County, California",33,33,0
1000000US060855078084017,060855078084017,"Block 4017, Block Group 4, Census Tract 5078.08, Santa Clara County, California",32,31,1
1000000US060855079031000,060855079031000,"Block 1000, Block Group 1, Census Tract 5079.03, Santa Clara County, California",23,23,0
1000000US060855079031001,060855079031001,"Block 1001, Block Group 1, Census Tract 5079.03, Santa Clara County, California",39,38,1
1000000US060855079031002,060855079031002,"Block 1002, Block Group 1, Census Tract 5079.03, Santa Clara County, California",13,13,0
1000000US060855079031003,060855079031003,"Block 1003, Block Group 1, Census Tract 5079.03, Santa Clara County, California",15,15,0
1000000US060855079031004,060855079031004,"Block 1004, Block Group 1, Census Tract 5079.03, Santa Clara County, California",31,31,0
1000000US060855079031005,060855079031005,"Block 1005, Block Group 1, Census Tract 5079.03, Santa Clara County, California",33,33,0
1000000US060855079031006,060855079031006,"Block 1006, Block Group 1, Census Tract 5079.03, Santa Clara County, California",22,22,0
1000000US060855079031007,060855079031007,"Block 1007, Block Group 1, Census Tract 5079.03, Santa Clara County, California",46,46,0
1000000US060855079031008,060855079031008,"Block 1008, Block Group 1, Census Tract 5079.03, Santa Clara County, California",30,29,1
1000000US060855079031009,060855079031009,"Block 1009, Block Group 1, Census Tract 5079.03, Santa Clara County, California",60,60,0
1000000US060855079031010,060855079031010,"Block 1010, Block Group 1, Census Tract 5079.03, Santa Clara County, California",67,66,1
1000000US060855079031011,060855079031011,"Block 1011, Block Group 1, Census Tract 5079.03, Santa Clara County, California",14,13,1
1000000US060855079031012,060855079031012,"Block 1012, Block Group 1, Census Tract 5079.03, Santa Clara County, California",43,43,0
1000000US060855079031013,060855079031013,"Block 1013, Block Group 1, Census Tract 5079.03, Santa Clara County, California",21,21,0
1000000US060855079031014,060855079031014,"Block 1014, Block Group 1, Census Tract 5079.03, Santa Clara County, California",51,50,1
1000000US060855079031015,060855079031015,"Block 1015, Block Group 1, Census Tract 5079.03, Santa Clara County, California",16,16,0
1000000US060855079031016,060855079031016,"Block 1016, Block Group 1, Census Tract 5079.03, Santa Clara County, California",26,26,0
1000000US060855079032000,060855079032000,"Block 2000, Block Group 2, Census Tract 5079.03, Santa Clara County, California",73,73,0
1000000US060855079032001,060855079032001,"Block 2001, Block Group 2, Census Tract 5079.03, Santa Clara County, California",50,50,0
1000000US060855079032002,060855079032002,"Block 2002, Block Group 2, Census Tract 5079.03, Santa Clara County, California",37,37,0
1000000US060855079032003,060855079032003,"Block 2003, Block Group 2, Census Tract 5079.03, Santa Clara County, California",22,22,0
1000000US060855079032004,060855079032004,"Block 2004, Block Group 2, Census Tract 5079.03, Santa Clara County, California",164,161,3
1000000US060855079032005,060855079032005,"Block 2005, Block Group 2, Census Tract 5079.03, Santa Clara County, California",18,18,0
1000000US060855079032006,060855079032006,"Block 2006, Block Group 2, Census Tract 5079.03, Santa Clara County, California",18,18,0
1000000US060855079032007,060855079032007,"Block 2007, Block Group 2, Census Tract 5079.03, Santa Clara County, California",17,17,0
1000000US060855079032008,060855079032008,"Block 2008, Block Group 2, Census Tract 5079.03, Santa Clara County, California",18,17,1
1000000US060855079032009,060855079032009,"Block 2009, Block Group 2, Census Tract 5079.03, Santa Clara County, California",49,49,0
1000000US060855079032010,060855079032010,"Block 2010, Block Group 2, Census Tract 5079.03, Santa Clara County, California",40,39,1
1000000US060855079032011,060855079032011,"Block 2011, Block Group 2, Census Tract 5079.03, Santa Clara County, California",36,36,0
1000000US060855079032012,060855079032012,"Block 2012, Block Group 2, Census Tract 5079.03, Santa Clara County, California",18,18,0
1000000US060855079032013,060855079032013,"Block 2013, Block Group 2, Census Tract 5079.03, Santa Clara County, California",48,48,0
1000000US060855079032014,060855079032014,"Block 2014, Block Group 2, Census Tract 5079.03, Santa Clara County, California",22,22,0
1000000US060855079032015,060855079032015,"Block 2015, Block Group 2, Census Tract 5079.03, Santa Clara County, California",40,40,0
1000000US060855079032016,060855079032016,"Block 2016, Block Group 2, Census Tract 5079.03, Santa Clara County, California",45,44,1
1000000US060855079032017,060855079032017,"Block 2017, Block Group 2, Census Tract 5079.03, Santa Clara County, California",29,29,0
1000000US060855079032018,060855079032018,"Block 2018, Block Group 2, Census Tract 5079.03, Santa Clara County, California",39,38,1
1000000US060855079032019,060855079032019,"Block 2019, Block Group 2, Census Tract 5079.03, Santa Clara County, California",41,41,0
1000000US060855079032020,060855079032020,"Block 2020, Block Group 2, Census Tract 5079.03, Santa Clara County, California",76,75,1
1000000US060855079032021,060855079032021,"Block 2021, Block Group 2, Census Tract 5079.03, Santa Clara County, California",28,27,1
1000000US060855079032022,060855079032022,"Block 2022, Block Group 2, Census Tract 5079.03, Santa Clara County, California",45,45,0
1000000US060855079032023,060855079032023,"Block 2023, Block Group 2, Census Tract 5079.03, Santa Clara County, California",42,41,1
1000000US060855079032024,060855079032024,"Block 2024, Block Group 2, Census Tract 5079.03, Santa Clara County, California",45,45,0
1000000US060855079032025,060855079032025,"Block 2025, Block Group 2, Census Tract 5079.03, Santa Clara County, California",24,24,0
1000000US060855079041000,060855079041000,"Block 1000, Block Group 1, Census Tract 5079.04, Santa Clara County, California",49,49,0
1000000US060855079041001,060855079041001,"Block 1001, Block Group 1, Census Tract 5079.04, Santa Clara County, California",26,26,0
1000000US060855079041002,060855079041002,"Block 1002, Block Group 1, Census Tract 5079.04, Santa Clara County, California",31,29,2
1000000US060855079041003,060855079041003,"Block 1003, Block Group 1, Census Tract 5079.04, Santa Clara County, California",21,19,2
1000000US060855079041004,060855079041004,"Block 1004, Block Group 1, Census Tract 5079.04, Santa Clara County, California",29,27,2
1000000US060855079041005,060855079041005,"Block 1005, Block Group 1, Census Tract 5079.04, Santa Clara County, California",61,60,1
1000000US060855079041006,060855079041006,"Block 1006, Block Group 1, Census Tract 5079.04, Santa Clara County, California",16,16,0
1000000US060855079041007,060855079041007,"Block 1007, Block Group 1, Census Tract 5079.04, Santa Clara County, California",50,49,1
1000000US060855079041008,060855079041008,"Block 1008, Block Group 1, Census Tract 5079.04, Santa Clara County, California",52,52,0
1000000US060855079041009,060855079041009,"Block 1009, Block Group 1, Census Tract 5079.04, Santa Clara County, California",51,50,1
1000000US060855079041010,060855079041010,"Block 1010, Block Group 1, Census Tract 5079.04, Santa Clara County, California",16,16,0
1000000US060855079041011,060855079041011,"Block 1011, Block Group 1, Census Tract 5079.04, Santa Clara County, California",64,63,1
1000000US060855079041012,060855079041012,"Block 1012, Block Group 1, Census Tract 5079.04, Santa Clara County, California",31,31,0
1000000US060855079041013,060855079041013,"Block 1013, Block Group 1, Census Tract 5079.04, Santa Clara County, California",37,37,0
1000000US060855079041014,060855079041014,"Block 1014, Block Group 1, Census Tract 5079.04, Santa Clara County, California",36,35,1
1000000US060855079041015,060855079041015,"Block 1015, Block Group 1, Census Tract 5079.04, Santa Clara County, California",19,19,0
1000000US060855079042000,060855079042000,"Block 2000, Block Group 2, Census Tract 5079.04, Santa Clara County, California",36,35,1
1000000US060855079042001,060855079042001,"Block 2001, Block Group 2, Census Tract 5079.04, Santa Clara County, California",50,50,0
1000000US060855079042002,060855079042002,"Block 2002, Block Group 2, Census Tract 5079.04, Santa Clara County, California",134,132,2
1000000US060855079042003,060855079042003,"Block 2003, Block Group 2, Census Tract 5079.04, Santa Clara County, California",19,19,0
1000000US060855079042004,060855079042004,"Block 2004, Block Group 2, Census Tract 5079.04, Santa Clara County, California",9,9,0
1000000US060855079042005,060855079042005,"Block 2005, Block Group 2, Census Tract 5079.04, Santa Clara County, California",22,22,0
1000000US060855079042006,060855079042006,"Block 2006, Block Group 2, Census Tract 5079.04, Santa Clara County, California",43,42,1
1000000US060855079042007,060855079042007,"Block 2007, Block Group 2, Census Tract 5079.04, Santa Clara County, California",20,20,0
1000000US060855079042008,060855079042008,"Block 2008, Block Group 2, Census Tract 5079.04, Santa Clara County, California",10,10,0
1000000US060855079042009,060855079042009,"Block 2009, Block Group 2, Census Tract 5079.04, Santa Clara County, California",35,34,1
1000000US060855079042010,060855079042010,"Block 2010, Block Group 2, Census Tract 5079.04, Santa Clara County, California",22,22,0
1000000US060855079042011,060855079042011,"Block 2011, Block Group 2, Census Tract 5079.04, Santa Clara County, California",25,24,1
1000000US060855079042012,060855079042012,"Block 2012, Block Group 2, Census Tract 5079.04, Santa Clara County, California",17,17,0
1000000US060855079042013,060855079042013,"Block 2013, Block Group 2, Census Tract 5079.04, Santa Clara County, California",9,9,0
1000000US060855079042014,060855079042014,"Block 2014, Block Group 2, Census Tract 5079.04, Santa Clara County, California",11,11,0
1000000US060855079042015,060855079042015,"Block 2015, Block Group 2, Census Tract 5079.04, Santa Clara County, California",0,0,0
1000000US060855079042016,060855079042016,"Block 2016, Block Group 2, Census Tract 5079.04, Santa Clara County, California",0,0,0
1000000US060855079042017,060855079042017,"Block 2017, Block Group 2, Census Tract 5079.04, Santa Clara County, California",11,11,0
1000000US060855079042018,060855079042018,"Block 2018, Block Group 2, Census Tract 5079.04, Santa Clara County, California",30,30,0
1000000US060855079042019,060855079042019,"Block 2019, Block Group 2, Census Tract 5079.04, Santa Clara County, California",22,20,2
1000000US060855079042020,060855079042020,"Block 2020, Block Group 2, Census Tract 5079.04, Santa Clara County, California",0,0,0
1000000US060855079051000,060855079051000,"Block 1000, Block Group 1, Census Tract 5079.05, Santa Clara County, California",375,346,29
1000000US060855079051001,060855079051001,"Block 1001, Block Group 1, Census Tract 5079.05, Santa Clara County, California",222,210,12
1000000US060855079051002,060855079051002,"Block 1002, Block Group 1, Census Tract 5079.05, Santa Clara County, California",144,136,8
1000000US060855079051003,060855079051003,"Block 1003, Block Group 1, Census Tract 5079.05, Santa Clara County, California",44,43,1
1000000US060855079052000,060855079052000,"Block 2000, Block Group 2, Census Tract 5079.05, Santa Clara County, California",28,28,0
1000000US060855079052001,060855079052001,"Block 2001, Block Group 2, Census Tract 5079.05, Santa Clara County, California",36,35,1
1000000US060855079052002,060855079052002,"Block 2002, Block Group 2, Census Tract 5079.05, Santa Clara County, California",30,29,1
1000000US060855079052003,060855079052003,"Block 2003, Block Group 2, Census Tract 5079.05, Santa Clara County, California",28,28,0
1000000US060855079052004,060855079052004,"Block 2004, Block Group 2, Census Tract 5079.05, Santa Clara County, California",28,28,0
1000000US060855079052005,060855079052005,"Block 2005, Block Group 2, Census Tract 5079.05, Santa Clara County, California",20,20,0
1000000US060855079052006,060855079052006,"Block 2006, Block Group 2, Census Tract 5079.05, Santa Clara County, California",24,24,0
1000000US060855079052007,060855079052007,"Block 2007, Block Group 2, Census Tract 5079.05, Santa Clara County, California",34,33,1
1000000US060855079052008,060855079052008,"Block 2008, Block Group 2, Census Tract 5079.05, Santa Clara County, California",21,20,1
1000000US060855079052009,060855079052009,"Block 2009, Block Group 2, Census Tract 5079.05, Santa Clara County, California",30,30,0
1000000US060855079052010,060855079052010,"Block 2010, Block Group 2, Census Tract 5079.05, Santa Clara County, California",43,43,0
1000000US060855079052011,060855079052011,"Block 2011, Block Group 2, Census Tract 5079.05, Santa Clara County, California",34,34,0
1000000US060855079052012,060855079052012,"Block 2012, Block Group 2, Census Tract 5079.05, Santa Clara County, California",26,24,2
1000000US060855079052013,060855079052013,"Block 2013, Block Group 2, Census Tract 5079.05, Santa Clara County, California",0,0,0
1000000US060855079052014,060855079052014,"Block 2014, Block Group 2, Census Tract 5079.05, Santa Clara County, California",30,30,0
1000000US060855079052015,060855079052015,"Block 2015, Block Group 2, Census Tract 5079.05, Santa Clara County, California",25,25,0
1000000US060855079052016,060855079052016,"Block 2016, Block Group 2, Census Tract 5079.05, Santa Clara County, California",20,18,2
1000000US060855079052017,060855079052017,"Block 2017, Block Group 2, Census Tract 5079.05, Santa Clara County, California",127,120,7
1000000US060855079052018,060855079052018,"Block 2018, Block Group 2, Census Tract 5079.05, Santa Clara County, California",0,0,0
1000000US060855079052019,060855079052019,"Block 2019, Block Group 2, Census Tract 5079.05, Santa Clara County, California",45,44,1
1000000US060855079053000,060855079053000,"Block 3000, Block Group 3, Census Tract 5079.05, Santa Clara County, California",102,102,0
1000000US060855079053001,060855079053001,"Block 3001, Block Group 3, Census Tract 5079.05, Santa Clara County, California",14,14,0
1000000US060855079053002,060855079053002,"Block 3002, Block Group 3, Census Tract 5079.05, Santa Clara County, California",38,38,0
1000000US060855079053003,060855079053003,"Block 3003, Block Group 3, Census Tract 5079.05, Santa Clara County, California",29,28,1
1000000US060855079053004,060855079053004,"Block 3004, Block Group 3, Census Tract 5079.05, Santa Clara County, California",28,28,0
1000000US060855079053005,060855079053005,"Block 3005, Block Group 3, Census Tract 5079.05, Santa Clara County, California",22,22,0
1000000US060855079053006,060855079053006,"Block 3006, Block Group 3, Census Tract 5079.05, Santa Clara County, California",29,28,1
1000000US060855079053007,060855079053007,"Block 3007, Block Group 3, Census Tract 5079.05, Santa Clara County, California",172,168,4
1000000US060855079053008,060855079053008,"Block 3008, Block Group 3, Census Tract 5079.05, Santa Clara County, California",139,124,15
1000000US060855079053009,060855079053009,"Block 3009, Block Group 3, Census Tract 5079.05, Santa Clara County, California",15,6,9
1000000US060855079053010,060855079053010,"Block 3010, Block Group 3, Census Tract 5079.05, Santa Clara County, California",147,141,6
1000000US060855079053011,060855079053011,"Block 3011, Block Group 3, Census Tract 5079.05, Santa Clara County, California",38,38,0
1000000US060855079053012,060855079053012,"Block 3012, Block Group 3, Census Tract 5079.05, Santa Clara County, California",24,23,1
1000000US060855079061000,060855079061000,"Block 1000, Block Group 1, Census Tract 5079.06, Santa Clara County, California",71,67,4
1000000US060855079061001,060855079061001,"Block 1001, Block Group 1, Census Tract 5079.06, Santa Clara County, California",40,40,0
1000000US060855079061002,060855079061002,"Block 1002, Block Group 1, Census Tract 5079.06, Santa Clara County, California",55,53,2
1000000US060855079061003,060855079061003,"Block 1003, Block Group 1, Census Tract 5079.06, Santa Clara County, California",37,37,0
1000000US060855079061004,060855079061004,"Block 1004, Block Group 1, Census Tract 5079.06, Santa Clara County, California",52,51,1
1000000US060855079061005,060855079061005,"Block 1005, Block Group 1, Census Tract 5079.06, Santa Clara County, California",13,13,0
1000000US060855079061006,060855079061006,"Block 1006, Block Group 1, Census Tract 5079.06, Santa Clara County, California",41,40,1
1000000US060855079061007,060855079061007,"Block 1007, Block Group 1, Census Tract 5079.06, Santa Clara County, California",11,11,0
1000000US060855079061008,060855079061008,"Block 1008, Block Group 1, Census Tract 5079.06, Santa Clara County, California",49,49,0
1000000US060855079061009,060855079061009,"Block 1009, Block Group 1, Census Tract 5079.06, Santa Clara County, California",26,25,1
1000000US060855079061010,060855079061010,"Block 1010, Block Group 1, Census Tract 5079.06, Santa Clara County, California",41,41,0
1000000US060855079062000,060855079062000,"Block 2000, Block Group 2, Census Tract 5079.06, Santa Clara County, California",43,41,2
1000000US060855079062001,060855079062001,"Block 2001, Block Group 2, Census Tract 5079.06, Santa Clara County, California",38,37,1
1000000US060855079062002,060855079062002,"Block 2002, Block Group 2, Census Tract 5079.06, Santa Clara County, California",39,39,0
1000000US060855079062003,060855079062003,"Block 2003, Block Group 2, Census Tract 5079.06, Santa Clara County, California",41,40,1
1000000US060855079062004,060855079062004,"Block 2004, Block Group 2, Census Tract 5079.06, Santa Clara County, California",20,20,0
1000000US060855079062005,060855079062005,"Block 2005, Block Group 2, Census Tract 5079.06, Santa Clara County, California",20,20,0
1000000US060855079062006,060855079062006,"Block 2006, Block Group 2, Census Tract 5079.06, Santa Clara County, California",27,27,0
1000000US060855079062007,060855079062007,"Block 2007, Block Group 2, Census Tract 5079.06, Santa Clara County, California",22,22,0
1000000US060855079062008,060855079062008,"Block 2008, Block Group 2, Census Tract 5079.06, Santa Clara County, California",43,42,1
1000000US060855079062009,060855079062009,"Block 2009, Block Group 2, Census Tract 5079.06, Santa Clara County, California",54,54,0
1000000US060855079062010,060855079062010,"Block 2010, Block Group 2, Census Tract 5079.06, Santa Clara County, California",24,23,1
1000000US060855079062011,060855079062011,"Block 2011, Block Group 2, Census Tract 5079.06, Santa Clara County, California",23,22,1
1000000US060855079063000,060855079063000,"Block 3000, Block Group 3, Census Tract 5079.06, Santa Clara County, California",35,35,0
1000000US060855079063001,060855079063001,"Block 3001, Block Group 3, Census Tract 5079.06, Santa Clara County, California",29,29,0
1000000US060855079063002,060855079063002,"Block 3002, Block Group 3, Census Tract 5079.06, Santa Clara County, California",63,62,1
1000000US060855079063003,060855079063003,"Block 3003, Block Group 3, Census Tract 5079.06, Santa Clara County, California",26,26,0
1000000US060855079063004,060855079063004,"Block 3004, Block Group 3, Census Tract 5079.06, Santa Clara County, California",22,22,0
1000000US060855079063005,060855079063005,"Block 3005, Block Group 3, Census Tract 5079.06, Santa Clara County, California",18,16,2
1000000US060855079063006,060855079063006,"Block 3006, Block Group 3, Census Tract 5079.06, Santa Clara County, California",42,41,1
1000000US060855079063007,060855079063007,"Block 3007, Block Group 3, Census Tract 5079.06, Santa Clara County, California",34,34,0
1000000US060855079063008,060855079063008,"Block 3008, Block Group 3, Census Tract 5079.06, Santa Clara County, California",25,24,1
1000000US060855079064000,060855079064000,"Block 4000, Block Group 4, Census Tract 5079.06, Santa Clara County, California",34,33,1
1000000US060855079064001,060855079064001,"Block 4001, Block Group 4, Census Tract 5079.06, Santa Clara County, California",53,53,0
1000000US060855079064002,060855079064002,"Block 4002, Block Group 4, Census Tract 5079.06, Santa Clara County, California",26,26,0
1000000US060855079064003,060855079064003,"Block 4003, Block Group 4, Census Tract 5079.06, Santa Clara County, California",24,24,0
1000000US060855079064004,060855079064004,"Block 4004, Block Group 4, Census Tract 5079.06, Santa Clara County, California",26,25,1
1000000US060855079064005,060855079064005,"Block 4005, Block Group 4, Census Tract 5079.06, Santa Clara County, California",43,42,1
1000000US060855079064006,060855079064006,"Block 4006, Block Group 4, Census Tract 5079.06, Santa Clara County, California",30,30,0
1000000US060855079064007,060855079064007,"Block 4007, Block Group 4, Census Tract 5079.06, Santa Clara County, California",32,32,0
1000000US060855079064008,060855079064008,"Block 4008, Block Group 4, Census Tract 5079.06, Santa Clara County, California",21,21,0
1000000US060855079064009,060855079064009,"Block 4009, Block Group 4, Census Tract 5079.06, Santa Clara County, California",36,36,0
1000000US060855080011000,060855080011000,"Block 1000, Block Group 1, Census Tract 5080.01, Santa Clara County, California",0,0,0
1000000US060855080011001,060855080011001,"Block 1001, Block Group 1, Census Tract 5080.01, Santa Clara County, California",0,0,0
1000000US060855080011002,060855080011002,"Block 1002, Block Group 1, Census Tract 5080.01, Santa Clara County, California",42,42,0
1000000US060855080011003,060855080011003,"Block 1003, Block Group 1, Census Tract 5080.01, Santa Clara County, California",44,42,2
1000000US060855080011004,060855080011004,"Block 1004, Block Group 1, Census Tract 5080.01, Santa Clara County, California",82,81,1
1000000US060855080011005,060855080011005,"Block 1005, Block Group 1, Census Tract 5080.01, Santa Clara County, California",34,34,0
1000000US060855080011006,060855080011006,"Block 1006, Block Group 1, Census Tract 5080.01, Santa Clara County, California",38,38,0
1000000US060855080011007,060855080011007,"Block 1007, Block Group 1, Census Tract 5080.01, Santa Clara County, California",0,0,0
1000000US060855080011008,060855080011008,"Block 1008, Block Group 1, Census Tract 5080.01, Santa Clara County, California",0,0,0
1000000US060855080011009,060855080011009,"Block 1009, Block Group 1, Census Tract 5080.01, Santa Clara County, California",51,50,1
1000000US060855080011010,060855080011010,"Block 1010, Block Group 1, Census Tract 5080.01, Santa Clara County, California",9,9,0
1000000US060855080011011,060855080011011,"Block 1011, Block Group 1, Census Tract 5080.01, Santa Clara County, California",24,23,1
1000000US060855080011012,060855080011012,"Block 1012, Block Group 1, Census Tract 5080.01, Santa Clara County, California",65,61,4
1000000US060855080011013,060855080011013,"Block 1013, Block Group 1, Census Tract 5080.01, Santa Clara County, California",21,19,2
1000000US060855080011014,060855080011014,"Block 1014, Block Group 1, Census Tract 5080.01, Santa Clara County, California",29,29,0
1000000US060855080011015,060855080011015,"Block 1015, Block Group 1, Census Tract 5080.01, Santa Clara County, California",4,4,0
1000000US060855080011016,060855080011016,"Block 1016, Block Group 1, Census Tract 5080.01, Santa Clara County, California",63,62,1
1000000US060855080011017,060855080011017,"Block 1017, Block Group 1, Census Tract 5080.01, Santa Clara County, California",46,45,1
1000000US060855080011018,060855080011018,"Block 1018, Block Group 1, Census Tract 5080.01, Santa Clara County, California",25,25,0
1000000US060855080011019,060855080011019,"Block 1019, Block Group 1, Census Tract 5080.01, Santa Clara County, California",83,81,2
1000000US060855080011020,060855080011020,"Block 1020, Block Group 1, Census Tract 5080.01, Santa Clara County, California",36,35,1
1000000US060855080011021,060855080011021,"Block 1021, Block Group 1, Census Tract 5080.01, Santa Clara County, California",52,51,1
1000000US060855080011022,060855080011022,"Block 1022, Block Group 1, Census Tract 5080.01, Santa Clara County, California",27,27,0
1000000US060855080012000,060855080012000,"Block 2000, Block Group 2, Census Tract 5080.01, Santa Clara County, California",27,27,0
1000000US060855080012001,060855080012001,"Block 2001, Block Group 2, Census Tract 5080.01, Santa Clara County, California",18,18,0
1000000US060855080012002,060855080012002,"Block 2002, Block Group 2, Census Tract 5080.01, Santa Clara County, California",17,17,0
1000000US060855080012003,060855080012003,"Block 2003, Block Group 2, Census Tract 5080.01, Santa Clara County, California",24,24,0
1000000US060855080012004,060855080012004,"Block 2004, Block Group 2, Census Tract 5080.01, Santa Clara County, California",29,28,1
1000000US060855080012005,060855080012005,"Block 2005, Block Group 2, Census Tract 5080.01, Santa Clara County, California",28,28,0
1000000US060855080012006,060855080012006,"Block 2006, Block Group 2, Census Tract 5080.01, Santa Clara County, California",31,31,0
1000000US060855080012007,060855080012007,"Block 2007, Block Group 2, Census Tract 5080.01, Santa Clara County, California",22,22,0
1000000US060855080012008,060855080012008,"Block 2008, Block Group 2, Census Tract 5080.01, Santa Clara County, California",20,20,0
1000000US060855080012009,060855080012009,"Block 2009, Block Group 2, Census Tract 5080.01, Santa Clara County, California",17,16,1
1000000US060855080012010,060855080012010,"Block 2010, Block Group 2, Census Tract 5080.01, Santa Clara County, California",33,31,2
1000000US060855080012011,060855080012011,"Block 2011, Block Group 2, Census Tract 5080.01, Santa Clara County, California",6,6,0
1000000US060855080012012,060855080012012,"Block 2012, Block Group 2, Census Tract 5080.01, Santa Clara County, California",19,19,0
1000000US060855080012013,060855080012013,"Block 2013, Block Group 2, Census Tract 5080.01, Santa Clara County, California",30,29,1
1000000US060855080012014,060855080012014,"Block 2014, Block Group 2, Census Tract 5080.01, Santa Clara County, California",26,26,0
1000000US060855080012015,060855080012015,"Block 2015, Block Group 2, Census Tract 5080.01, Santa Clara County, California",21,21,0
1000000US060855080012016,060855080012016,"Block 2016, Block Group 2, Census Tract 5080.01, Santa Clara County, California",17,17,0
1000000US060855080012017,060855080012017,"Block 2017, Block Group 2, Census Tract 5080.01, Santa Clara County, California",34,34,0
1000000US060855080013000,060855080013000,"Block 3000, Block Group 3, Census Tract 5080.01, Santa Clara County, California",0,0,0
1000000US060855080013001,060855080013001,"Block 3001, Block Group 3, Census Tract 5080.01, Santa Clara County, California",371,348,23
1000000US060855080013002,060855080013002,"Block 3002, Block Group 3, Census Tract 5080.01, Santa Clara County, California",167,137,30
1000000US060855080013003,060855080013003,"Block 3003, Block Group 3, Census Tract 5080.01, Santa Clara County, California",99,93,6
1000000US060855080013004,060855080013004,"Block 3004, Block Group 3, Census Tract 5080.01, Santa Clara County, California",208,189,19
1000000US060855080013005,060855080013005,"Block 3005, Block Group 3, Census Tract 5080.01, Santa Clara County, California",0,0,0
1000000US060855080013006,060855080013006,"Block 3006, Block Group 3, Census Tract 5080.01, Santa Clara County, California",0,0,0
1000000US060855080013007,060855080013007,"Block 3007, Block Group 3, Census Tract 5080.01, Santa Clara County, California",104,97,7
1000000US060855080013008,060855080013008,"Block 3008, Block Group 3, Census Tract 5080.01, Santa Clara County, California",0,0,0
1000000US060855080013009,060855080013009,"Block 3009, Block Group 3, Census Tract 5080.01, Santa Clara County, California",0,0,0
1000000US060855080013010,060855080013010,"Block 3010, Block Group 3, Census Tract 5080.01, Santa Clara County, California",45,41,4
1000000US060855080013011,060855080013011,"Block 3011, Block Group 3, Census Tract 5080.01, Santa Clara County, California",0,0,0
1000000US060855080013012,060855080013012,"Block 3012, Block Group 3, Census Tract 5080.01, Santa Clara County, California",0,0,0
1000000US060855080013013,060855080013013,"Block 3013, Block Group 3, Census Tract 5080.01, Santa Clara County, California",0,0,0
1000000US060855080013014,060855080013014,"Block 3014, Block Group 3, Census Tract 5080.01, Santa Clara County, California",79,77,2
1000000US060855080013015,060855080013015,"Block 3015, Block Group 3, Census Tract 5080.01, Santa Clara County, California",52,52,0
1000000US060855080013016,060855080013016,"Block 3016, Block Group 3, Census Tract 5080.01, Santa Clara County, California",0,0,0
1000000US060855080013017,060855080013017,"Block 3017, Block Group 3, Census Tract 5080.01, Santa Clara County, California",0,0,0
1000000US060855080013018,060855080013018,"Block 3018, Block Group 3, Census Tract 5080.01, Santa Clara County, California",0,0,0
1000000US060855080013019,060855080013019,"Block 3019, Block Group 3, Census Tract 5080.01, Santa Clara County, California",41,40,1
1000000US060855080013020,060855080013020,"Block 3020, Block Group 3, Census Tract 5080.01, Santa Clara County, California",27,26,1
1000000US060855080013021,060855080013021,"Block 3021, Block Group 3, Census Tract 5080.01, Santa Clara County, California",32,31,1
1000000US060855080013022,060855080013022,"Block 3022, Block Group 3, Census Tract 5080.01, Santa Clara County, California",0,0,0
1000000US060855080013023,060855080013023,"Block 3023, Block Group 3, Census Tract 5080.01, Santa Clara County, California",20,19,1
1000000US060855080013024,060855080013024,"Block 3024, Block Group 3, Census Tract 5080.01, Santa Clara County, California",45,44,1
1000000US060855080013025,060855080013025,"Block 3025, Block Group 3, Census Tract 5080.01, Santa Clara County, California",42,42,0
1000000US060855080013026,060855080013026,"Block 3026, Block Group 3, Census Tract 5080.01, Santa Clara County, California",40,39,1
1000000US060855080013027,060855080013027,"Block 3027, Block Group 3, Census Tract 5080.01, Santa Clara County, California",12,12,0
1000000US060855080013028,060855080013028,"Block 3028, Block Group 3, Census Tract 5080.01, Santa Clara County, California",13,13,0
1000000US060855080013029,060855080013029,"Block 3029, Block Group 3, Census Tract 5080.01, Santa Clara County, California",2,2,0
1000000US060855080013030,060855080013030,"Block 3030, Block Group 3, Census Tract 5080.01, Santa Clara County, California",0,0,0
1000000US060855080013031,060855080013031,"Block 3031, Block Group 3, Census Tract 5080.01, Santa Clara County, California",0,0,0
1000000US060855080013032,060855080013032,"Block 3032, Block Group 3, Census Tract 5080.01, Santa Clara County, California",0,0,0
1000000US060855080014000,060855080014000,"Block 4000, Block Group 4, Census Tract 5080.01, Santa Clara County, California",17,17,0
1000000US060855080014001,060855080014001,"Block 4001, Block Group 4, Census Tract 5080.01, Santa Clara County, California",22,22,0
1000000US060855080014002,060855080014002,"Block 4002, Block Group 4, Census Tract 5080.01, Santa Clara County, California",21,21,0
1000000US060855080014003,060855080014003,"Block 4003, Block Group 4, Census Tract 5080.01, Santa Clara County, California",60,58,2
1000000US060855080014004,060855080014004,"Block 4004, Block Group 4, Census Tract 5080.01, Santa Clara County, California",11,11,0
1000000US060855080014005,060855080014005,"Block 4005, Block Group 4, Census Tract 5080.01, Santa Clara County, California",0,0,0
1000000US060855080014006,060855080014006,"Block 4006, Block Group 4, Census Tract 5080.01, Santa Clara County, California",43,43,0
1000000US060855080014007,060855080014007,"Block 4007, Block Group 4, Census Tract 5080.01, Santa Clara County, California",21,21,0
1000000US060855080014008,060855080014008,"Block 4008, Block Group 4, Census Tract 5080.01, Santa Clara County, California",19,19,0
1000000US060855080014009,060855080014009,"Block 4009, Block Group 4, Census Tract 5080.01, Santa Clara County, California",46,46,0
1000000US060855080014010,060855080014010,"Block 4010, Block Group 4, Census Tract 5080.01, Santa Clara County, California",0,0,0
1000000US060855080031000,060855080031000,"Block 1000, Block Group 1, Census Tract 5080.03, Santa Clara County, California",98,95,3
1000000US060855080031001,060855080031001,"Block 1001, Block Group 1, Census Tract 5080.03, Santa Clara County, California",1,1,0
1000000US060855080031002,060855080031002,"Block 1002, Block Group 1, Census Tract 5080.03, Santa Clara County, California",200,195,5
1000000US060855080031003,060855080031003,"Block 1003, Block Group 1, Census Tract 5080.03, Santa Clara County, California",27,26,1
1000000US060855080031004,060855080031004,"Block 1004, Block Group 1, Census Tract 5080.03, Santa Clara County, California",0,0,0
1000000US060855080031005,060855080031005,"Block 1005, Block Group 1, Census Tract 5080.03, Santa Clara County, California",0,0,0
1000000US060855080031006,060855080031006,"Block 1006, Block Group 1, Census Tract 5080.03, Santa Clara County, California",0,0,0
1000000US060855080031007,060855080031007,"Block 1007, Block Group 1, Census Tract 5080.03, Santa Clara County, California",45,42,3
1000000US060855080031008,060855080031008,"Block 1008, Block Group 1, Census Tract 5080.03, Santa Clara County, California",76,73,3
1000000US060855080031009,060855080031009,"Block 1009, Block Group 1, Census Tract 5080.03, Santa Clara County, California",43,41,2
1000000US060855080031010,060855080031010,"Block 1010, Block Group 1, Census Tract 5080.03, Santa Clara County, California",28,28,0
1000000US060855080032000,060855080032000,"Block 2000, Block Group 2, Census Tract 5080.03, Santa Clara County, California",37,36,1
1000000US060855080032001,060855080032001,"Block 2001, Block Group 2, Census Tract 5080.03, Santa Clara County, California",51,50,1
1000000US060855080032002,060855080032002,"Block 2002, Block Group 2, Census Tract 5080.03, Santa Clara County, California",42,39,3
1000000US060855080032003,060855080032003,"Block 2003, Block Group 2, Census Tract 5080.03, Santa Clara County, California",0,0,0
1000000US060855080032004,060855080032004,"Block 2004, Block Group 2, Census Tract 5080.03, Santa Clara County, California",30,30,0
1000000US060855080032005,060855080032005,"Block 2005, Block Group 2, Census Tract 5080.03, Santa Clara County, California",30,29,1
1000000US060855080032006,060855080032006,"Block 2006, Block Group 2, Census Tract 5080.03, Santa Clara County, California",55,52,3
1000000US060855080032007,060855080032007,"Block 2007, Block Group 2, Census Tract 5080.03, Santa Clara County, California",0,0,0
1000000US060855080032008,060855080032008,"Block 2008, Block Group 2, Census Tract 5080.03, Santa Clara County, California",0,0,0
1000000US060855080041000,060855080041000,"Block 1000, Block Group 1, Census Tract 5080.04, Santa Clara County, California",542,518,24
1000000US060855080041001,060855080041001,"Block 1001, Block Group 1, Census Tract 5080.04, Santa Clara County, California",25,24,1
1000000US060855080041002,060855080041002,"Block 1002, Block Group 1, Census Tract 5080.04, Santa Clara County, California",32,32,0
1000000US060855080041003,060855080041003,"Block 1003, Block Group 1, Census Tract 5080.04, Santa Clara County, California",30,29,1
1000000US060855080041004,060855080041004,"Block 1004, Block Group 1, Census Tract 5080.04, Santa Clara County, California",26,25,1
1000000US060855080041005,060855080041005,"Block 1005, Block Group 1, Census Tract 5080.04, Santa Clara County, California",31,27,4
1000000US060855080041006,060855080041006,"Block 1006, Block Group 1, Census Tract 5080.04, Santa Clara County, California",28,26,2
1000000US060855080041007,060855080041007,"Block 1007, Block Group 1, Census Tract 5080.04, Santa Clara County, California",34,32,2
1000000US060855080041008,060855080041008,"Block 1008, Block Group 1, Census Tract 5080.04, Santa Clara County, California",39,37,2
1000000US060855080041009,060855080041009,"Block 1009, Block Group 1, Census Tract 5080.04, Santa Clara County, California",30,28,2
1000000US060855080041010,060855080041010,"Block 1010, Block Group 1, Census Tract 5080.04, Santa Clara County, California",49,49,0
1000000US060855080041011,060855080041011,"Block 1011, Block Group 1, Census Tract 5080.04, Santa Clara County, California",41,40,1
1000000US060855080041012,060855080041012,"Block 1012, Block Group 1, Census Tract 5080.04, Santa Clara County, California",31,30,1
1000000US060855080042000,060855080042000,"Block 2000, Block Group 2, Census Tract 5080.04, Santa Clara County, California",66,65,1
1000000US060855080042001,060855080042001,"Block 2001, Block Group 2, Census Tract 5080.04, Santa Clara County, California",39,38,1
1000000US060855080042002,060855080042002,"Block 2002, Block Group 2, Census Tract 5080.04, Santa Clara County, California",66,64,2
1000000US060855080042003,060855080042003,"Block 2003, Block Group 2, Census Tract 5080.04, Santa Clara County, California",36,34,2
1000000US060855080042004,060855080042004,"Block 2004, Block Group 2, Census Tract 5080.04, Santa Clara County, California",42,41,1
1000000US060855080042005,060855080042005,"Block 2005, Block Group 2, Census Tract 5080.04, Santa Clara County, California",22,22,0
1000000US060855080042006,060855080042006,"Block 2006, Block Group 2, Census Tract 5080.04, Santa Clara County, California",59,58,1
1000000US060855080042007,060855080042007,"Block 2007, Block Group 2, Census Tract 5080.04, Santa Clara County, California",25,25,0
1000000US060855080042008,060855080042008,"Block 2008, Block Group 2, Census Tract 5080.04, Santa Clara County, California",63,62,1
1000000US060855080042009,060855080042009,"Block 2009, Block Group 2, Census Tract 5080.04, Santa Clara County, California",38,37,1
1000000US060855080042010,060855080042010,"Block 2010, Block Group 2, Census Tract 5080.04, Santa Clara County, California",0,0,0
1000000US060855080043000,060855080043000,"Block 3000, Block Group 3, Census Tract 5080.04, Santa Clara County, California",0,0,0
1000000US060855080043001,060855080043001,"Block 3001, Block Group 3, Census Tract 5080.04, Santa Clara County, California",200,189,11
1000000US060855080043002,060855080043002,"Block 3002, Block Group 3, Census Tract 5080.04, Santa Clara County, California",86,82,4
1000000US060855080043003,060855080043003,"Block 3003, Block Group 3, Census Tract 5080.04, Santa Clara County, California",13,13,0
1000000US060855080043004,060855080043004,"Block 3004, Block Group 3, Census Tract 5080.04, Santa Clara County, California",23,22,1
1000000US060855080043005,060855080043005,"Block 3005, Block Group 3, Census Tract 5080.04, Santa Clara County, California",77,72,5
1000000US060855080043006,060855080043006,"Block 3006, Block Group 3, Census Tract 5080.04, Santa Clara County, California",20,19,1
1000000US060855080043007,060855080043007,"Block 3007, Block Group 3, Census Tract 5080.04, Santa Clara County, California",60,59,1
1000000US060855080043008,060855080043008,"Block 3008, Block Group 3, Census Tract 5080.04, Santa Clara County, California",19,19,0
1000000US060855080043009,060855080043009,"Block 3009, Block Group 3, Census Tract 5080.04, Santa Clara County, California",47,44,3
1000000US060855080043010,060855080043010,"Block 3010, Block Group 3, Census Tract 5080.04, Santa Clara County, California",16,14,2
1000000US060855080043011,060855080043011,"Block 3011, Block Group 3, Census Tract 5080.04, Santa Clara County, California",33,31,2
1000000US060855080043012,060855080043012,"Block 3012, Block Group 3, Census Tract 5080.04, Santa Clara County, California",41,38,3
1000000US060855080043013,060855080043013,"Block 3013, Block Group 3, Census Tract 5080.04, Santa Clara County, California",0,0,0
1000000US060855080043014,060855080043014,"Block 3014, Block Group 3, Census Tract 5080.04, Santa Clara County, California",0,0,0
1000000US060855080043015,060855080043015,"Block 3015, Block Group 3, Census Tract 5080.04, Santa Clara County, California",21,21,0
1000000US060855080043016,060855080043016,"Block 3016, Block Group 3, Census Tract 5080.04, Santa Clara County, California",28,28,0
1000000US060855080043017,060855080043017,"Block 3017, Block Group 3, Census Tract 5080.04, Santa Clara County, California",10,10,0
1000000US060855080043018,060855080043018,"Block 3018, Block Group 3, Census Tract 5080.04, Santa Clara County, California",24,23,1
1000000US060855080043019,060855080043019,"Block 3019, Block Group 3, Census Tract 5080.04, Santa Clara County, California",35,35,0
1000000US060855080043020,060855080043020,"Block 3020, Block Group 3, Census Tract 5080.04, Santa Clara County, California",17,16,1
1000000US060855080043021,060855080043021,"Block 3021, Block Group 3, Census Tract 5080.04, Santa Clara County, California",0,0,0
1000000US060855080043022,060855080043022,"Block 3022, Block Group 3, Census Tract 5080.04, Santa Clara County, California",0,0,0
1000000US060855080043023,060855080043023,"Block 3023, Block Group 3, Census Tract 5080.04, Santa Clara County, California",12,12,0
1000000US060855080043024,060855080043024,"Block 3024, Block Group 3, Census Tract 5080.04, Santa Clara County, California",0,0,0
1000000US060855080043025,060855080043025,"Block 3025, Block Group 3, Census Tract 5080.04, Santa Clara County, California",0,0,0
1000000US060855080043026,060855080043026,"Block 3026, Block Group 3, Census Tract 5080.04, Santa Clara County, California",0,0,0
1000000US060855080043027,060855080043027,"Block 3027, Block Group 3, Census Tract 5080.04, Santa Clara County, California",0,0,0
1000000US060855080043028,060855080043028,"Block 3028, Block Group 3, Census Tract 5080.04, Santa Clara County, California",0,0,0
1000000US060855081011000,060855081011000,"Block 1000, Block Group 1, Census Tract 5081.01, Santa Clara County, California",241,237,4
1000000US060855081011001,060855081011001,"Block 1001, Block Group 1, Census Tract 5081.01, Santa Clara County, California",0,0,0
1000000US060855081011002,060855081011002,"Block 1002, Block Group 1, Census Tract 5081.01, Santa Clara County, California",0,0,0
1000000US060855081011003,060855081011003,"Block 1003, Block Group 1, Census Tract 5081.01, Santa Clara County, California",0,0,0
1000000US060855081011004,060855081011004,"Block 1004, Block Group 1, Census Tract 5081.01, Santa Clara County, California",25,24,1
1000000US060855081011005,060855081011005,"Block 1005, Block Group 1, Census Tract 5081.01, Santa Clara County, California",30,29,1
1000000US060855081011006,060855081011006,"Block 1006, Block Group 1, Census Tract 5081.01, Santa Clara County, California",0,0,0
1000000US060855081011007,060855081011007,"Block 1007, Block Group 1, Census Tract 5081.01, Santa Clara County, California",0,0,0
1000000US060855081011008,060855081011008,"Block 1008, Block Group 1, Census Tract 5081.01, Santa Clara County, California",97,95,2
1000000US060855081011009,060855081011009,"Block 1009, Block Group 1, Census Tract 5081.01, Santa Clara County, California",20,20,0
1000000US060855081011010,060855081011010,"Block 1010, Block Group 1, Census Tract 5081.01, Santa Clara County, California",29,29,0
1000000US060855081011011,060855081011011,"Block 1011, Block Group 1, Census Tract 5081.01, Santa Clara County, California",48,46,2
1000000US060855081011012,060855081011012,"Block 1012, Block Group 1, Census Tract 5081.01, Santa Clara County, California",29,29,0
1000000US060855081011013,060855081011013,"Block 1013, Block Group 1, Census Tract 5081.01, Santa Clara County, California",0,0,0
1000000US060855081011014,060855081011014,"Block 1014, Block Group 1, Census Tract 5081.01, Santa Clara County, California",1,1,0
1000000US060855081011015,060855081011015,"Block 1015, Block Group 1, Census Tract 5081.01, Santa Clara County, California",20,20,0
1000000US060855081011016,060855081011016,"Block 1016, Block Group 1, Census Tract 5081.01, Santa Clara County, California",36,36,0
1000000US060855081011017,060855081011017,"Block 1017, Block Group 1, Census Tract 5081.01, Santa Clara County, California",0,0,0
1000000US060855081011018,060855081011018,"Block 1018, Block Group 1, Census Tract 5081.01, Santa Clara County, California",0,0,0
1000000US060855081011019,060855081011019,"Block 1019, Block Group 1, Census Tract 5081.01, Santa Clara County, California",0,0,0
1000000US060855081011020,060855081011020,"Block 1020, Block Group 1, Census Tract 5081.01, Santa Clara County, California",0,0,0
1000000US060855081011021,060855081011021,"Block 1021, Block Group 1, Census Tract 5081.01, Santa Clara County, California",59,58,1
1000000US060855081012000,060855081012000,"Block 2000, Block Group 2, Census Tract 5081.01, Santa Clara County, California",17,17,0
1000000US060855081012001,060855081012001,"Block 2001, Block Group 2, Census Tract 5081.01, Santa Clara County, California",34,34,0
1000000US060855081012002,060855081012002,"Block 2002, Block Group 2, Census Tract 5081.01, Santa Clara County, California",0,0,0
1000000US060855081012003,060855081012003,"Block 2003, Block Group 2, Census Tract 5081.01, Santa Clara County, California",0,0,0
1000000US060855081012004,060855081012004,"Block 2004, Block Group 2, Census Tract 5081.01, Santa Clara County, California",0,0,0
1000000US060855081012005,060855081012005,"Block 2005, Block Group 2, Census Tract 5081.01, Santa Clara County, California",0,0,0
1000000US060855081012006,060855081012006,"Block 2006, Block Group 2, Census Tract 5081.01, Santa Clara County, California",0,0,0
1000000US060855081012007,060855081012007,"Block 2007, Block Group 2, Census Tract 5081.01, Santa Clara County, California",0,0,0
1000000US060855081012008,060855081012008,"Block 2008, Block Group 2, Census Tract 5081.01, Santa Clara County, California",54,54,0
1000000US060855081012009,060855081012009,"Block 2009, Block Group 2, Census Tract 5081.01, Santa Clara County, California",0,0,0
1000000US060855081012010,060855081012010,"Block 2010, Block Group 2, Census Tract 5081.01, Santa Clara County, California",18,17,1
1000000US060855081012011,060855081012011,"Block 2011, Block Group 2, Census Tract 5081.01, Santa Clara County, California",150,147,3
1000000US060855081012012,060855081012012,"Block 2012, Block Group 2, Census Tract 5081.01, Santa Clara County, California",0,0,0
1000000US060855081012013,060855081012013,"Block 2013, Block Group 2, Census Tract 5081.01, Santa Clara County, California",22,21,1
1000000US060855081012014,060855081012014,"Block 2014, Block Group 2, Census Tract 5081.01, Santa Clara County, California",100,97,3
1000000US060855081012015,060855081012015,"Block 2015, Block Group 2, Census Tract 5081.01, Santa Clara County, California",0,0,0
1000000US060855081012016,060855081012016,"Block 2016, Block Group 2, Census Tract 5081.01, Santa Clara County, California",31,31,0
1000000US060855081012017,060855081012017,"Block 2017, Block Group 2, Census Tract 5081.01, Santa Clara County, California",0,0,0
1000000US060855081012018,060855081012018,"Block 2018, Block Group 2, Census Tract 5081.01, Santa Clara County, California",0,0,0
1000000US060855081012019,060855081012019,"Block 2019, Block Group 2, Census Tract 5081.01, Santa Clara County, California",0,0,0
1000000US060855081012020,060855081012020,"Block 2020, Block Group 2, Census Tract 5081.01, Santa Clara County, California",0,0,0
1000000US060855081012021,060855081012021,"Block 2021, Block Group 2, Census Tract 5081.01, Santa Clara County, California",0,0,0
1000000US060855081012022,060855081012022,"Block 2022, Block Group 2, Census Tract 5081.01, Santa Clara County, California",0,0,0
1000000US060855081012023,060855081012023,"Block 2023, Block Group 2, Census Tract 5081.01, Santa Clara County, California",34,34,0
1000000US060855081012024,060855081012024,"Block 2024, Block Group 2, Census Tract 5081.01, Santa Clara County, California",20,20,0
1000000US060855081012025,060855081012025,"Block 2025, Block Group 2, Census Tract 5081.01, Santa Clara County, California",20,19,1
1000000US060855081012026,060855081012026,"Block 2026, Block Group 2, Census Tract 5081.01, Santa Clara County, California",46,46,0
1000000US060855081012027,060855081012027,"Block 2027, Block Group 2, Census Tract 5081.01, Santa Clara County, California",0,0,0
1000000US060855081012028,060855081012028,"Block 2028, Block Group 2, Census Tract 5081.01, Santa Clara County, California",0,0,0
1000000US060855081012029,060855081012029,"Block 2029, Block Group 2, Census Tract 5081.01, Santa Clara County, California",83,81,2
1000000US060855081012030,060855081012030,"Block 2030, Block Group 2, Census Tract 5081.01, Santa Clara County, California",41,39,2
1000000US060855081012031,060855081012031,"Block 2031, Block Group 2, Census Tract 5081.01, Santa Clara County, California",23,23,0
1000000US060855081012032,060855081012032,"Block 2032, Block Group 2, Census Tract 5081.01, Santa Clara County, California",0,0,0
1000000US060855081012033,060855081012033,"Block 2033, Block Group 2, Census Tract 5081.01, Santa Clara County, California",0,0,0
1000000US060855081012034,060855081012034,"Block 2034, Block Group 2, Census Tract 5081.01, Santa Clara County, California",0,0,0
1000000US060855081013000,060855081013000,"Block 3000, Block Group 3, Census Tract 5081.01, Santa Clara County, California",0,0,0
1000000US060855081013001,060855081013001,"Block 3001, Block Group 3, Census Tract 5081.01, Santa Clara County, California",0,0,0
1000000US060855081013002,060855081013002,"Block 3002, Block Group 3, Census Tract 5081.01, Santa Clara County, California",0,0,0
1000000US060855081013003,060855081013003,"Block 3003, Block Group 3, Census Tract 5081.01, Santa Clara County, California",0,0,0
1000000US060855081013004,060855081013004,"Block 3004, Block Group 3, Census Tract 5081.01, Santa Clara County, California",0,0,0
1000000US060855081013005,060855081013005,"Block 3005, Block Group 3, Census Tract 5081.01, Santa Clara County, California",0,0,0
1000000US060855081013006,060855081013006,"Block 3006, Block Group 3, Census Tract 5081.01, Santa Clara County, California",0,0,0
1000000US060855081013007,060855081013007,"Block 3007, Block Group 3, Census Tract 5081.01, Santa Clara County, California",0,0,0
1000000US060855081013008,060855081013008,"Block 3008, Block Group 3, Census Tract 5081.01, Santa Clara County, California",0,0,0
1000000US060855081013009,060855081013009,"Block 3009, Block Group 3, Census Tract 5081.01, Santa Clara County, California",0,0,0
1000000US060855081013010,060855081013010,"Block 3010, Block Group 3, Census Tract 5081.01, Santa Clara County, California",0,0,0
1000000US060855081013011,060855081013011,"Block 3011, Block Group 3, Census Tract 5081.01, Santa Clara County, California",0,0,0
1000000US060855081013012,060855081013012,"Block 3012, Block Group 3, Census Tract 5081.01, Santa Clara County, California",0,0,0
1000000US060855081013013,060855081013013,"Block 3013, Block Group 3, Census Tract 5081.01, Santa Clara County, California",0,0,0
1000000US060855081013014,060855081013014,"Block 3014, Block Group 3, Census Tract 5081.01, Santa Clara County, California",0,0,0
1000000US060855081013015,060855081013015,"Block 3015, Block Group 3, Census Tract 5081.01, Santa Clara County, California",0,0,0
1000000US060855081013016,060855081013016,"Block 3016, Block Group 3, Census Tract 5081.01, Santa Clara County, California",0,0,0
1000000US060855081013017,060855081013017,"Block 3017, Block Group 3, Census Tract 5081.01, Santa Clara County, California",40,33,7
1000000US060855081013018,060855081013018,"Block 3018, Block Group 3, Census Tract 5081.01, Santa Clara County, California",110,96,14
1000000US060855081013019,060855081013019,"Block 3019, Block Group 3, Census Tract 5081.01, Santa Clara County, California",20,20,0
1000000US060855081013020,060855081013020,"Block 3020, Block Group 3, Census Tract 5081.01, Santa Clara County, California",20,20,0
1000000US060855081013021,060855081013021,"Block 3021, Block Group 3, Census Tract 5081.01, Santa Clara County, California",18,17,1
1000000US060855081013022,060855081013022,"Block 3022, Block Group 3, Census Tract 5081.01, Santa Clara County, California",0,0,0
1000000US060855081013023,060855081013023,"Block 3023, Block Group 3, Census Tract 5081.01, Santa Clara County, California",0,0,0
1000000US060855081013024,060855081013024,"Block 3024, Block Group 3, Census Tract 5081.01, Santa Clara County, California",22,20,2
1000000US060855081013025,060855081013025,"Block 3025, Block Group 3, Census Tract 5081.01, Santa Clara County, California",0,0,0
1000000US060855081013026,060855081013026,"Block 3026, Block Group 3, Census Tract 5081.01, Santa Clara County, California",19,19,0
1000000US060855081013027,060855081013027,"Block 3027, Block Group 3, Census Tract 5081.01, Santa Clara County, California",28,28,0
1000000US060855081013028,060855081013028,"Block 3028, Block Group 3, Census Tract 5081.01, Santa Clara County, California",12,12,0
1000000US060855081013029,060855081013029,"Block 3029, Block Group 3, Census Tract 5081.01, Santa Clara County, California",304,299,5
1000000US060855081013030,060855081013030,"Block 3030, Block Group 3, Census Tract 5081.01, Santa Clara County, California",10,10,0
1000000US060855081013031,060855081013031,"Block 3031, Block Group 3, Census Tract 5081.01, Santa Clara County, California",13,13,0
1000000US060855081013032,060855081013032,"Block 3032, Block Group 3, Census Tract 5081.01, Santa Clara County, California",0,0,0
1000000US060855081013033,060855081013033,"Block 3033, Block Group 3, Census Tract 5081.01, Santa Clara County, California",0,0,0
1000000US060855081013034,060855081013034,"Block 3034, Block Group 3, Census Tract 5081.01, Santa Clara County, California",0,0,0
1000000US060855081013035,060855081013035,"Block 3035, Block Group 3, Census Tract 5081.01, Santa Clara County, California",10,10,0
1000000US060855081013036,060855081013036,"Block 3036, Block Group 3, Census Tract 5081.01, Santa Clara County, California",0,0,0
1000000US060855081013037,060855081013037,"Block 3037, Block Group 3, Census Tract 5081.01, Santa Clara County, California",0,0,0
1000000US060855081013038,060855081013038,"Block 3038, Block Group 3, Census Tract 5081.01, Santa Clara County, California",8,7,1
1000000US060855081013039,060855081013039,"Block 3039, Block Group 3, Census Tract 5081.01, Santa Clara County, California",0,0,0
1000000US060855081013040,060855081013040,"Block 3040, Block Group 3, Census Tract 5081.01, Santa Clara County, California",10,9,1
1000000US060855081013041,060855081013041,"Block 3041, Block Group 3, Census Tract 5081.01, Santa Clara County, California",0,0,0
1000000US060855081013042,060855081013042,"Block 3042, Block Group 3, Census Tract 5081.01, Santa Clara County, California",22,22,0
1000000US060855081013043,060855081013043,"Block 3043, Block Group 3, Census Tract 5081.01, Santa Clara County, California",0,0,0
1000000US060855081013044,060855081013044,"Block 3044, Block Group 3, Census Tract 5081.01, Santa Clara County, California",0,0,0
1000000US060855081013045,060855081013045,"Block 3045, Block Group 3, Census Tract 5081.01, Santa Clara County, California",0,0,0
1000000US060855081013046,060855081013046,"Block 3046, Block Group 3, Census Tract 5081.01, Santa Clara County, California",1,1,0
1000000US060855081013047,060855081013047,"Block 3047, Block Group 3, Census Tract 5081.01, Santa Clara County, California",0,0,0
1000000US060855081013048,060855081013048,"Block 3048, Block Group 3, Census Tract 5081.01, Santa Clara County, California",39,39,0
1000000US060855081013049,060855081013049,"Block 3049, Block Group 3, Census Tract 5081.01, Santa Clara County, California",0,0,0
1000000US060855081013050,060855081013050,"Block 3050, Block Group 3, Census Tract 5081.01, Santa Clara County, California",41,41,0
1000000US060855081013051,060855081013051,"Block 3051, Block Group 3, Census Tract 5081.01, Santa Clara County, California",16,16,0
1000000US060855081013052,060855081013052,"Block 3052, Block Group 3, Census Tract 5081.01, Santa Clara County, California",0,0,0
1000000US060855081013053,060855081013053,"Block 3053, Block Group 3, Census Tract 5081.01, Santa Clara County, California",0,0,0
1000000US060855081013054,060855081013054,"Block 3054, Block Group 3, Census Tract 5081.01, Santa Clara County, California",0,0,0
1000000US060855081013055,060855081013055,"Block 3055, Block Group 3, Census Tract 5081.01, Santa Clara County, California",28,27,1
1000000US060855081013056,060855081013056,"Block 3056, Block Group 3, Census Tract 5081.01, Santa Clara County, California",200,182,18
1000000US060855081013057,060855081013057,"Block 3057, Block Group 3, Census Tract 5081.01, Santa Clara County, California",15,12,3
1000000US060855081013058,060855081013058,"Block 3058, Block Group 3, Census Tract 5081.01, Santa Clara County, California",0,0,0
1000000US060855081013059,060855081013059,"Block 3059, Block Group 3, Census Tract 5081.01, Santa Clara County, California",0,0,0
1000000US060855081013060,060855081013060,"Block 3060, Block Group 3, Census Tract 5081.01, Santa Clara County, California",0,0,0
1000000US060855081013061,060855081013061,"Block 3061, Block Group 3, Census Tract 5081.01, Santa Clara County, California",0,0,0
1000000US060855081013062,060855081013062,"Block 3062, Block Group 3, Census Tract 5081.01, Santa Clara County, California",30,29,1
1000000US060855081021000,060855081021000,"Block 1000, Block Group 1, Census Tract 5081.02, Santa Clara County, California",0,0,0
1000000US060855081021001,060855081021001,"Block 1001, Block Group 1, Census Tract 5081.02, Santa Clara County, California",14,14,0
1000000US060855081021002,060855081021002,"Block 1002, Block Group 1, Census Tract 5081.02, Santa Clara County, California",0,0,0
1000000US060855081021003,060855081021003,"Block 1003, Block Group 1, Census Tract 5081.02, Santa Clara County, California",0,0,0
1000000US060855081021004,060855081021004,"Block 1004, Block Group 1, Census Tract 5081.02, Santa Clara County, California",0,0,0
1000000US060855081021005,060855081021005,"Block 1005, Block Group 1, Census Tract 5081.02, Santa Clara County, California",0,0,0
1000000US060855081021006,060855081021006,"Block 1006, Block Group 1, Census Tract 5081.02, Santa Clara County, California",0,0,0
1000000US060855081021007,060855081021007,"Block 1007, Block Group 1, Census Tract 5081.02, Santa Clara County, California",0,0,0
1000000US060855081021008,060855081021008,"Block 1008, Block Group 1, Census Tract 5081.02, Santa Clara County, California",0,0,0
1000000US060855081021009,060855081021009,"Block 1009, Block Group 1, Census Tract 5081.02, Santa Clara County, California",0,0,0
1000000US060855081021010,060855081021010,"Block 1010, Block Group 1, Census Tract 5081.02, Santa Clara County, California",0,0,0
1000000US060855081021011,060855081021011,"Block 1011, Block Group 1, Census Tract 5081.02, Santa Clara County, California",8,8,0
1000000US060855081021012,060855081021012,"Block 1012, Block Group 1, Census Tract 5081.02, Santa Clara County, California",0,0,0
1000000US060855081021013,060855081021013,"Block 1013, Block Group 1, Census Tract 5081.02, Santa Clara County, California",0,0,0
1000000US060855081021014,060855081021014,"Block 1014, Block Group 1, Census Tract 5081.02, Santa Clara County, California",0,0,0
1000000US060855081021015,060855081021015,"Block 1015, Block Group 1, Census Tract 5081.02, Santa Clara County, California",0,0,0
1000000US060855081021016,060855081021016,"Block 1016, Block Group 1, Census Tract 5081.02, Santa Clara County, California",0,0,0
1000000US060855081021017,060855081021017,"Block 1017, Block Group 1, Census Tract 5081.02, Santa Clara County, California",1,1,0
1000000US060855081021018,060855081021018,"Block 1018, Block Group 1, Census Tract 5081.02, Santa Clara County, California",10,10,0
1000000US060855081021019,060855081021019,"Block 1019, Block Group 1, Census Tract 5081.02, Santa Clara County, California",10,10,0
1000000US060855081021020,060855081021020,"Block 1020, Block Group 1, Census Tract 5081.02, Santa Clara County, California",8,8,0
1000000US060855081021021,060855081021021,"Block 1021, Block Group 1, Census Tract 5081.02, Santa Clara County, California",22,22,0
1000000US060855081021022,060855081021022,"Block 1022, Block Group 1, Census Tract 5081.02, Santa Clara County, California",9,9,0
1000000US060855081021023,060855081021023,"Block 1023, Block Group 1, Census Tract 5081.02, Santa Clara County, California",0,0,0
1000000US060855081021024,060855081021024,"Block 1024, Block Group 1, Census Tract 5081.02, Santa Clara County, California",0,0,0
1000000US060855081021025,060855081021025,"Block 1025, Block Group 1, Census Tract 5081.02, Santa Clara County, California",0,0,0
1000000US060855081021026,060855081021026,"Block 1026, Block Group 1, Census Tract 5081.02, Santa Clara County, California",0,0,0
1000000US060855081021027,060855081021027,"Block 1027, Block Group 1, Census Tract 5081.02, Santa Clara County, California",23,23,0
1000000US060855081021028,060855081021028,"Block 1028, Block Group 1, Census Tract 5081.02, Santa Clara County, California",0,0,0
1000000US060855081021029,060855081021029,"Block 1029, Block Group 1, Census Tract 5081.02, Santa Clara County, California",0,0,0
1000000US060855081021030,060855081021030,"Block 1030, Block Group 1, Census Tract 5081.02, Santa Clara County, California",0,0,0
1000000US060855081021031,060855081021031,"Block 1031, Block Group 1, Census Tract 5081.02, Santa Clara County, California",0,0,0
1000000US060855081021032,060855081021032,"Block 1032, Block Group 1, Census Tract 5081.02, Santa Clara County, California",0,0,0
1000000US060855081021033,060855081021033,"Block 1033, Block Group 1, Census Tract 5081.02, Santa Clara County, California",0,0,0
1000000US060855081021034,060855081021034,"Block 1034, Block Group 1, Census Tract 5081.02, Santa Clara County, California",0,0,0
1000000US060855081021035,060855081021035,"Block 1035, Block Group 1, Census Tract 5081.02, Santa Clara County, California",0,0,0
1000000US060855081021036,060855081021036,"Block 1036, Block Group 1, Census Tract 5081.02, Santa Clara County, California",0,0,0
1000000US060855081021037,060855081021037,"Block 1037, Block Group 1, Census Tract 5081.02, Santa Clara County, California",0,0,0
1000000US060855081021038,060855081021038,"Block 1038, Block Group 1, Census Tract 5081.02, Santa Clara County, California",0,0,0
1000000US060855081021039,060855081021039,"Block 1039, Block Group 1, Census Tract 5081.02, Santa Clara County, California",0,0,0
1000000US060855081021040,060855081021040,"Block 1040, Block Group 1, Census Tract 5081.02, Santa Clara County, California",0,0,0
1000000US060855081021041,060855081021041,"Block 1041, Block Group 1, Census Tract 5081.02, Santa Clara County, California",0,0,0
1000000US060855081021042,060855081021042,"Block 1042, Block Group 1, Census Tract 5081.02, Santa Clara County, California",21,21,0
1000000US060855081021043,060855081021043,"Block 1043, Block Group 1, Census Tract 5081.02, Santa Clara County, California",17,17,0
1000000US060855081021044,060855081021044,"Block 1044, Block Group 1, Census Tract 5081.02, Santa Clara County, California",0,0,0
1000000US060855081021045,060855081021045,"Block 1045, Block Group 1, Census Tract 5081.02, Santa Clara County, California",2,2,0
1000000US060855081021046,060855081021046,"Block 1046, Block Group 1, Census Tract 5081.02, Santa Clara County, California",5,5,0
1000000US060855081021047,060855081021047,"Block 1047, Block Group 1, Census Tract 5081.02, Santa Clara County, California",23,23,0
1000000US060855081021048,060855081021048,"Block 1048, Block Group 1, Census Tract 5081.02, Santa Clara County, California",6,6,0
1000000US060855081021049,060855081021049,"Block 1049, Block Group 1, Census Tract 5081.02, Santa Clara County, California",21,21,0
1000000US060855081021050,060855081021050,"Block 1050, Block Group 1, Census Tract 5081.02, Santa Clara County, California",6,6,0
1000000US060855081021051,060855081021051,"Block 1051, Block Group 1, Census Tract 5081.02, Santa Clara County, California",257,243,14
1000000US060855081021052,060855081021052,"Block 1052, Block Group 1, Census Tract 5081.02, Santa Clara County, California",8,8,0
1000000US060855081021053,060855081021053,"Block 1053, Block Group 1, Census Tract 5081.02, Santa Clara County, California",0,0,0
1000000US060855081021054,060855081021054,"Block 1054, Block Group 1, Census Tract 5081.02, Santa Clara County, California",0,0,0
1000000US060855081021055,060855081021055,"Block 1055, Block Group 1, Census Tract 5081.02, Santa Clara County, California",0,0,0
1000000US060855081021056,060855081021056,"Block 1056, Block Group 1, Census Tract 5081.02, Santa Clara County, California",1,1,0
1000000US060855081021057,060855081021057,"Block 1057, Block Group 1, Census Tract 5081.02, Santa Clara County, California",33,32,1
1000000US060855081021058,060855081021058,"Block 1058, Block Group 1, Census Tract 5081.02, Santa Clara County, California",20,19,1
1000000US060855081021059,060855081021059,"Block 1059, Block Group 1, Census Tract 5081.02, Santa Clara County, California",15,13,2
1000000US060855081021060,060855081021060,"Block 1060, Block Group 1, Census Tract 5081.02, Santa Clara County, California",18,18,0
1000000US060855081021061,060855081021061,"Block 1061, Block Group 1, Census Tract 5081.02, Santa Clara County, California",62,62,0
1000000US060855081021062,060855081021062,"Block 1062, Block Group 1, Census Tract 5081.02, Santa Clara County, California",23,23,0
1000000US060855081021063,060855081021063,"Block 1063, Block Group 1, Census Tract 5081.02, Santa Clara County, California",18,18,0
1000000US060855081021064,060855081021064,"Block 1064, Block Group 1, Census Tract 5081.02, Santa Clara County, California",47,46,1
1000000US060855081021065,060855081021065,"Block 1065, Block Group 1, Census Tract 5081.02, Santa Clara County, California",17,16,1
1000000US060855081021066,060855081021066,"Block 1066, Block Group 1, Census Tract 5081.02, Santa Clara County, California",0,0,0
1000000US060855081021067,060855081021067,"Block 1067, Block Group 1, Census Tract 5081.02, Santa Clara County, California",0,0,0
1000000US060855081021068,060855081021068,"Block 1068, Block Group 1, Census Tract 5081.02, Santa Clara County, California",0,0,0
1000000US060855081021069,060855081021069,"Block 1069, Block Group 1, Census Tract 5081.02, Santa Clara County, California",0,0,0
1000000US060855081021070,060855081021070,"Block 1070, Block Group 1, Census Tract 5081.02, Santa Clara County, California",33,33,0
1000000US060855081021071,060855081021071,"Block 1071, Block Group 1, Census Tract 5081.02, Santa Clara County, California",16,16,0
1000000US060855081021072,060855081021072,"Block 1072, Block Group 1, Census Tract 5081.02, Santa Clara County, California",25,25,0
1000000US060855081021073,060855081021073,"Block 1073, Block Group 1, Census Tract 5081.02, Santa Clara County, California",29,28,1
1000000US060855081021074,060855081021074,"Block 1074, Block Group 1, Census Tract 5081.02, Santa Clara County, California",0,0,0
1000000US060855081021075,060855081021075,"Block 1075, Block Group 1, Census Tract 5081.02, Santa Clara County, California",0,0,0
1000000US060855081021076,060855081021076,"Block 1076, Block Group 1, Census Tract 5081.02, Santa Clara County, California",0,0,0
1000000US060855081021077,060855081021077,"Block 1077, Block Group 1, Census Tract 5081.02, Santa Clara County, California",0,0,0
1000000US060855081021078,060855081021078,"Block 1078, Block Group 1, Census Tract 5081.02, Santa Clara County, California",0,0,0
1000000US060855081021079,060855081021079,"Block 1079, Block Group 1, Census Tract 5081.02, Santa Clara County, California",0,0,0
1000000US060855081021080,060855081021080,"Block 1080, Block Group 1, Census Tract 5081.02, Santa Clara County, California",0,0,0
1000000US060855081021081,060855081021081,"Block 1081, Block Group 1, Census Tract 5081.02, Santa Clara County, California",0,0,0
1000000US060855081021082,060855081021082,"Block 1082, Block Group 1, Census Tract 5081.02, Santa Clara County, California",0,0,0
1000000US060855081021083,060855081021083,"Block 1083, Block Group 1, Census Tract 5081.02, Santa Clara County, California",3,3,0
1000000US060855081021084,060855081021084,"Block 1084, Block Group 1, Census Tract 5081.02, Santa Clara County, California",0,0,0
1000000US060855081021085,060855081021085,"Block 1085, Block Group 1, Census Tract 5081.02, Santa Clara County, California",334,312,22
1000000US060855081021086,060855081021086,"Block 1086, Block Group 1, Census Tract 5081.02, Santa Clara County, California",0,0,0
1000000US060855081021087,060855081021087,"Block 1087, Block Group 1, Census Tract 5081.02, Santa Clara County, California",0,0,0
1000000US060855081021088,060855081021088,"Block 1088, Block Group 1, Census Tract 5081.02, Santa Clara County, California",0,0,0
1000000US060855081021089,060855081021089,"Block 1089, Block Group 1, Census Tract 5081.02, Santa Clara County, California",0,0,0
1000000US060855081021090,060855081021090,"Block 1090, Block Group 1, Census Tract 5081.02, Santa Clara County, California",0,0,0
1000000US060855081021091,060855081021091,"Block 1091, Block Group 1, Census Tract 5081.02, Santa Clara County, California",0,0,0
1000000US060855081021092,060855081021092,"Block 1092, Block Group 1, Census Tract 5081.02, Santa Clara County, California",0,0,0
1000000US060855081021093,060855081021093,"Block 1093, Block Group 1, Census Tract 5081.02, Santa Clara County, California",0,0,0
1000000US060855081021094,060855081021094,"Block 1094, Block Group 1, Census Tract 5081.02, Santa Clara County, California",0,0,0
1000000US060855081021095,060855081021095,"Block 1095, Block Group 1, Census Tract 5081.02, Santa Clara County, California",0,0,0
1000000US060855081021096,060855081021096,"Block 1096, Block Group 1, Census Tract 5081.02, Santa Clara County, California",0,0,0
1000000US060855081021097,060855081021097,"Block 1097, Block Group 1, Census Tract 5081.02, Santa Clara County, California",0,0,0
1000000US060855081021098,060855081021098,"Block 1098, Block Group 1, Census Tract 5081.02, Santa Clara County, California",0,0,0
1000000US060855081021099,060855081021099,"Block 1099, Block Group 1, Census Tract 5081.02, Santa Clara County, California",0,0,0
1000000US060855081021100,060855081021100,"Block 1100, Block Group 1, Census Tract 5081.02, Santa Clara County, California",0,0,0
1000000US060855081021101,060855081021101,"Block 1101, Block Group 1, Census Tract 5081.02, Santa Clara County, California",0,0,0
1000000US060855081021102,060855081021102,"Block 1102, Block Group 1, Census Tract 5081.02, Santa Clara County, California",0,0,0
1000000US060855081021103,060855081021103,"Block 1103, Block Group 1, Census Tract 5081.02, Santa Clara County, California",107,100,7
1000000US060855081021104,060855081021104,"Block 1104, Block Group 1, Census Tract 5081.02, Santa Clara County, California",0,0,0
1000000US060855081021105,060855081021105,"Block 1105, Block Group 1, Census Tract 5081.02, Santa Clara County, California",0,0,0
1000000US060855081021106,060855081021106,"Block 1106, Block Group 1, Census Tract 5081.02, Santa Clara County, California",0,0,0
1000000US060855081021107,060855081021107,"Block 1107, Block Group 1, Census Tract 5081.02, Santa Clara County, California",0,0,0
1000000US060855081021108,060855081021108,"Block 1108, Block Group 1, Census Tract 5081.02, Santa Clara County, California",0,0,0
1000000US060855081021109,060855081021109,"Block 1109, Block Group 1, Census Tract 5081.02, Santa Clara County, California",0,0,0
1000000US060855081021110,060855081021110,"Block 1110, Block Group 1, Census Tract 5081.02, Santa Clara County, California",0,0,0
1000000US060855081021111,060855081021111,"Block 1111, Block Group 1, Census Tract 5081.02, Santa Clara County, California",0,0,0
1000000US060855081021112,060855081021112,"Block 1112, Block Group 1, Census Tract 5081.02, Santa Clara County, California",0,0,0
1000000US060855081021113,060855081021113,"Block 1113, Block Group 1, Census Tract 5081.02, Santa Clara County, California",0,0,0
1000000US060855081021114,060855081021114,"Block 1114, Block Group 1, Census Tract 5081.02, Santa Clara County, California",0,0,0
1000000US060855081021115,060855081021115,"Block 1115, Block Group 1, Census Tract 5081.02, Santa Clara County, California",0,0,0
1000000US060855081021116,060855081021116,"Block 1116, Block Group 1, Census Tract 5081.02, Santa Clara County, California",0,0,0
1000000US060855081021117,060855081021117,"Block 1117, Block Group 1, Census Tract 5081.02, Santa Clara County, California",0,0,0
1000000US060855081021118,060855081021118,"Block 1118, Block Group 1, Census Tract 5081.02, Santa Clara County, California",0,0,0
1000000US060855081021119,060855081021119,"Block 1119, Block Group 1, Census Tract 5081.02, Santa Clara County, California",1,1,0
1000000US060855081021120,060855081021120,"Block 1120, Block Group 1, Census Tract 5081.02, Santa Clara County, California",4,3,1
1000000US060855081021121,060855081021121,"Block 1121, Block Group 1, Census Tract 5081.02, Santa Clara County, California",0,0,0
1000000US060855081021122,060855081021122,"Block 1122, Block Group 1, Census Tract 5081.02, Santa Clara County, California",0,0,0
1000000US060855081021123,060855081021123,"Block 1123, Block Group 1, Census Tract 5081.02, Santa Clara County, California",0,0,0
1000000US060855081021124,060855081021124,"Block 1124, Block Group 1, Census Tract 5081.02, Santa Clara County, California",0,0,0
1000000US060855081021125,060855081021125,"Block 1125, Block Group 1, Census Tract 5081.02, Santa Clara County, California",0,0,0
1000000US060855081021126,060855081021126,"Block 1126, Block Group 1, Census Tract 5081.02, Santa Clara County, California",0,0,0
1000000US060855081021127,060855081021127,"Block 1127, Block Group 1, Census Tract 5081.02, Santa Clara County, California",0,0,0
1000000US060855081021128,060855081021128,"Block 1128, Block Group 1, Census Tract 5081.02, Santa Clara County, California",33,33,0
1000000US060855082021000,060855082021000,"Block 1000, Block Group 1, Census Tract 5082.02, Santa Clara County, California",83,81,2
1000000US060855082021001,060855082021001,"Block 1001, Block Group 1, Census Tract 5082.02, Santa Clara County, California",24,22,2
1000000US060855082021002,060855082021002,"Block 1002, Block Group 1, Census Tract 5082.02, Santa Clara County, California",0,0,0
1000000US060855082021003,060855082021003,"Block 1003, Block Group 1, Census Tract 5082.02, Santa Clara County, California",0,0,0
1000000US060855082021004,060855082021004,"Block 1004, Block Group 1, Census Tract 5082.02, Santa Clara County, California",18,17,1
1000000US060855082021005,060855082021005,"Block 1005, Block Group 1, Census Tract 5082.02, Santa Clara County, California",51,50,1
1000000US060855082021006,060855082021006,"Block 1006, Block Group 1, Census Tract 5082.02, Santa Clara County, California",53,53,0
1000000US060855082021007,060855082021007,"Block 1007, Block Group 1, Census Tract 5082.02, Santa Clara County, California",9,9,0
1000000US060855082021008,060855082021008,"Block 1008, Block Group 1, Census Tract 5082.02, Santa Clara County, California",12,11,1
1000000US060855082021009,060855082021009,"Block 1009, Block Group 1, Census Tract 5082.02, Santa Clara County, California",9,9,0
1000000US060855082021010,060855082021010,"Block 1010, Block Group 1, Census Tract 5082.02, Santa Clara County, California",24,23,1
1000000US060855082021011,060855082021011,"Block 1011, Block Group 1, Census Tract 5082.02, Santa Clara County, California",20,19,1
1000000US060855082021012,060855082021012,"Block 1012, Block Group 1, Census Tract 5082.02, Santa Clara County, California",16,16,0
1000000US060855082021013,060855082021013,"Block 1013, Block Group 1, Census Tract 5082.02, Santa Clara County, California",28,28,0
1000000US060855082021014,060855082021014,"Block 1014, Block Group 1, Census Tract 5082.02, Santa Clara County, California",29,29,0
1000000US060855082021015,060855082021015,"Block 1015, Block Group 1, Census Tract 5082.02, Santa Clara County, California",39,37,2
1000000US060855082021016,060855082021016,"Block 1016, Block Group 1, Census Tract 5082.02, Santa Clara County, California",15,14,1
1000000US060855082021017,060855082021017,"Block 1017, Block Group 1, Census Tract 5082.02, Santa Clara County, California",25,23,2
1000000US060855082021018,060855082021018,"Block 1018, Block Group 1, Census Tract 5082.02, Santa Clara County, California",25,23,2
1000000US060855082022000,060855082022000,"Block 2000, Block Group 2, Census Tract 5082.02, Santa Clara County, California",58,57,1
1000000US060855082022001,060855082022001,"Block 2001, Block Group 2, Census Tract 5082.02, Santa Clara County, California",0,0,0
1000000US060855082022002,060855082022002,"Block 2002, Block Group 2, Census Tract 5082.02, Santa Clara County, California",7,7,0
1000000US060855082022003,060855082022003,"Block 2003, Block Group 2, Census Tract 5082.02, Santa Clara County, California",16,16,0
1000000US060855082022004,060855082022004,"Block 2004, Block Group 2, Census Tract 5082.02, Santa Clara County, California",0,0,0
1000000US060855082022005,060855082022005,"Block 2005, Block Group 2, Census Tract 5082.02, Santa Clara County, California",25,24,1
1000000US060855082022006,060855082022006,"Block 2006, Block Group 2, Census Tract 5082.02, Santa Clara County, California",9,9,0
1000000US060855082022007,060855082022007,"Block 2007, Block Group 2, Census Tract 5082.02, Santa Clara County, California",31,29,2
1000000US060855082022008,060855082022008,"Block 2008, Block Group 2, Census Tract 5082.02, Santa Clara County, California",9,9,0
1000000US060855082022009,060855082022009,"Block 2009, Block Group 2, Census Tract 5082.02, Santa Clara County, California",30,28,2
1000000US060855082022010,060855082022010,"Block 2010, Block Group 2, Census Tract 5082.02, Santa Clara County, California",18,18,0
1000000US060855082022011,060855082022011,"Block 2011, Block Group 2, Census Tract 5082.02, Santa Clara County, California",20,20,0
1000000US060855082022012,060855082022012,"Block 2012, Block Group 2, Census Tract 5082.02, Santa Clara County, California",19,19,0
1000000US060855082022013,060855082022013,"Block 2013, Block Group 2, Census Tract 5082.02, Santa Clara County, California",410,366,44
1000000US060855082022014,060855082022014,"Block 2014, Block Group 2, Census Tract 5082.02, Santa Clara County, California",22,21,1
1000000US060855082022015,060855082022015,"Block 2015, Block Group 2, Census Tract 5082.02, Santa Clara County, California",77,74,3
1000000US060855082022016,060855082022016,"Block 2016, Block Group 2, Census Tract 5082.02, Santa Clara County, California",21,21,0
1000000US060855082022017,060855082022017,"Block 2017, Block Group 2, Census Tract 5082.02, Santa Clara County, California",30,30,0
1000000US060855082022018,060855082022018,"Block 2018, Block Group 2, Census Tract 5082.02, Santa Clara County, California",24,24,0
1000000US060855082022019,060855082022019,"Block 2019, Block Group 2, Census Tract 5082.02, Santa Clara County, California",0,0,0
1000000US060855082022020,060855082022020,"Block 2020, Block Group 2, Census Tract 5082.02, Santa Clara County, California",23,23,0
1000000US060855082023000,060855082023000,"Block 3000, Block Group 3, Census Tract 5082.02, Santa Clara County, California",0,0,0
1000000US060855082023001,060855082023001,"Block 3001, Block Group 3, Census Tract 5082.02, Santa Clara County, California",0,0,0
1000000US060855082023002,060855082023002,"Block 3002, Block Group 3, Census Tract 5082.02, Santa Clara County, California",0,0,0
1000000US060855082023003,060855082023003,"Block 3003, Block Group 3, Census Tract 5082.02, Santa Clara County, California",0,0,0
1000000US060855082023004,060855082023004,"Block 3004, Block Group 3, Census Tract 5082.02, Santa Clara County, California",93,89,4
1000000US060855082023005,060855082023005,"Block 3005, Block Group 3, Census Tract 5082.02, Santa Clara County, California",31,30,1
1000000US060855082023006,060855082023006,"Block 3006, Block Group 3, Census Tract 5082.02, Santa Clara County, California",0,0,0
1000000US060855082023007,060855082023007,"Block 3007, Block Group 3, Census Tract 5082.02, Santa Clara County, California",0,0,0
1000000US060855082023008,060855082023008,"Block 3008, Block Group 3, Census Tract 5082.02, Santa Clara County, California",21,20,1
1000000US060855082023009,060855082023009,"Block 3009, Block Group 3, Census Tract 5082.02, Santa Clara County, California",7,7,0
1000000US060855082023010,060855082023010,"Block 3010, Block Group 3, Census Tract 5082.02, Santa Clara County, California",29,28,1
1000000US060855082023011,060855082023011,"Block 3011, Block Group 3, Census Tract 5082.02, Santa Clara County, California",8,8,0
1000000US060855082023012,060855082023012,"Block 3012, Block Group 3, Census Tract 5082.02, Santa Clara County, California",7,7,0
1000000US060855082023013,060855082023013,"Block 3013, Block Group 3, Census Tract 5082.02, Santa Clara County, California",36,36,0
1000000US060855082023014,060855082023014,"Block 3014, Block Group 3, Census Tract 5082.02, Santa Clara County, California",28,27,1
1000000US060855082023015,060855082023015,"Block 3015, Block Group 3, Census Tract 5082.02, Santa Clara County, California",11,11,0
1000000US060855082023016,060855082023016,"Block 3016, Block Group 3, Census Tract 5082.02, Santa Clara County, California",25,25,0
1000000US060855082023017,060855082023017,"Block 3017, Block Group 3, Census Tract 5082.02, Santa Clara County, California",4,4,0
1000000US060855082023018,060855082023018,"Block 3018, Block Group 3, Census Tract 5082.02, Santa Clara County, California",24,23,1
1000000US060855082023019,060855082023019,"Block 3019, Block Group 3, Census Tract 5082.02, Santa Clara County, California",25,24,1
1000000US060855082023020,060855082023020,"Block 3020, Block Group 3, Census Tract 5082.02, Santa Clara County, California",19,18,1
1000000US060855082023021,060855082023021,"Block 3021, Block Group 3, Census Tract 5082.02, Santa Clara County, California",22,21,1
1000000US060855082024000,060855082024000,"Block 4000, Block Group 4, Census Tract 5082.02, Santa Clara County, California",33,33,0
1000000US060855082024001,060855082024001,"Block 4001, Block Group 4, Census Tract 5082.02, Santa Clara County, California",28,28,0
1000000US060855082024002,060855082024002,"Block 4002, Block Group 4, Census Tract 5082.02, Santa Clara County, California",58,57,1
1000000US060855082024003,060855082024003,"Block 4003, Block Group 4, Census Tract 5082.02, Santa Clara County, California",45,44,1
1000000US060855082024004,060855082024004,"Block 4004, Block Group 4, Census Tract 5082.02, Santa Clara County, California",33,33,0
1000000US060855082024005,060855082024005,"Block 4005, Block Group 4, Census Tract 5082.02, Santa Clara County, California",17,17,0
1000000US060855082024006,060855082024006,"Block 4006, Block Group 4, Census Tract 5082.02, Santa Clara County, California",38,38,0
1000000US060855082024007,060855082024007,"Block 4007, Block Group 4, Census Tract 5082.02, Santa Clara County, California",17,17,0
1000000US060855082024008,060855082024008,"Block 4008, Block Group 4, Census Tract 5082.02, Santa Clara County, California",64,62,2
1000000US060855082024009,060855082024009,"Block 4009, Block Group 4, Census Tract 5082.02, Santa Clara County, California",177,174,3
1000000US060855082024010,060855082024010,"Block 4010, Block Group 4, Census Tract 5082.02, Santa Clara County, California",31,31,0
1000000US060855082024011,060855082024011,"Block 4011, Block Group 4, Census Tract 5082.02, Santa Clara County, California",0,0,0
1000000US060855082024012,060855082024012,"Block 4012, Block Group 4, Census Tract 5082.02, Santa Clara County, California",13,13,0
1000000US060855082024013,060855082024013,"Block 4013, Block Group 4, Census Tract 5082.02, Santa Clara County, California",24,24,0
1000000US060855082025000,060855082025000,"Block 5000, Block Group 5, Census Tract 5082.02, Santa Clara County, California",29,29,0
1000000US060855082025001,060855082025001,"Block 5001, Block Group 5, Census Tract 5082.02, Santa Clara County, California",85,83,2
1000000US060855082025002,060855082025002,"Block 5002, Block Group 5, Census Tract 5082.02, Santa Clara County, California",28,26,2
1000000US060855082025003,060855082025003,"Block 5003, Block Group 5, Census Tract 5082.02, Santa Clara County, California",25,24,1
1000000US060855082025004,060855082025004,"Block 5004, Block Group 5, Census Tract 5082.02, Santa Clara County, California",40,40,0
1000000US060855082025005,060855082025005,"Block 5005, Block Group 5, Census Tract 5082.02, Santa Clara County, California",2,2,0
1000000US060855082025006,060855082025006,"Block 5006, Block Group 5, Census Tract 5082.02, Santa Clara County, California",36,36,0
1000000US060855082025007,060855082025007,"Block 5007, Block Group 5, Census Tract 5082.02, Santa Clara County, California",32,30,2
1000000US060855082025008,060855082025008,"Block 5008, Block Group 5, Census Tract 5082.02, Santa Clara County, California",31,31,0
1000000US060855082025009,060855082025009,"Block 5009, Block Group 5, Census Tract 5082.02, Santa Clara County, California",33,33,0
1000000US060855082025010,060855082025010,"Block 5010, Block Group 5, Census Tract 5082.02, Santa Clara County, California",20,20,0
1000000US060855082025011,060855082025011,"Block 5011, Block Group 5, Census Tract 5082.02, Santa Clara County, California",31,31,0
1000000US060855082025012,060855082025012,"Block 5012, Block Group 5, Census Tract 5082.02, Santa Clara County, California",30,29,1
1000000US060855082025013,060855082025013,"Block 5013, Block Group 5, Census Tract 5082.02, Santa Clara County, California",44,43,1
1000000US060855082025014,060855082025014,"Block 5014, Block Group 5, Census Tract 5082.02, Santa Clara County, California",62,61,1
1000000US060855082025015,060855082025015,"Block 5015, Block Group 5, Census Tract 5082.02, Santa Clara County, California",0,0,0
1000000US060855082025016,060855082025016,"Block 5016, Block Group 5, Census Tract 5082.02, Santa Clara County, California",30,29,1
1000000US060855082025017,060855082025017,"Block 5017, Block Group 5, Census Tract 5082.02, Santa Clara County, California",30,30,0
1000000US060855082025018,060855082025018,"Block 5018, Block Group 5, Census Tract 5082.02, Santa Clara County, California",8,8,0
1000000US060855082031000,060855082031000,"Block 1000, Block Group 1, Census Tract 5082.03, Santa Clara County, California",41,41,0
1000000US060855082031001,060855082031001,"Block 1001, Block Group 1, Census Tract 5082.03, Santa Clara County, California",39,37,2
1000000US060855082031002,060855082031002,"Block 1002, Block Group 1, Census Tract 5082.03, Santa Clara County, California",24,24,0
1000000US060855082031003,060855082031003,"Block 1003, Block Group 1, Census Tract 5082.03, Santa Clara County, California",64,61,3
1000000US060855082031004,060855082031004,"Block 1004, Block Group 1, Census Tract 5082.03, Santa Clara County, California",36,34,2
1000000US060855082031005,060855082031005,"Block 1005, Block Group 1, Census Tract 5082.03, Santa Clara County, California",20,20,0
1000000US060855082031006,060855082031006,"Block 1006, Block Group 1, Census Tract 5082.03, Santa Clara County, California",15,15,0
1000000US060855082031007,060855082031007,"Block 1007, Block Group 1, Census Tract 5082.03, Santa Clara County, California",51,48,3
1000000US060855082031008,060855082031008,"Block 1008, Block Group 1, Census Tract 5082.03, Santa Clara County, California",28,28,0
1000000US060855082031009,060855082031009,"Block 1009, Block Group 1, Census Tract 5082.03, Santa Clara County, California",57,57,0
1000000US060855082031010,060855082031010,"Block 1010, Block Group 1, Census Tract 5082.03, Santa Clara County, California",53,52,1
1000000US060855082032000,060855082032000,"Block 2000, Block Group 2, Census Tract 5082.03, Santa Clara County, California",35,33,2
1000000US060855082032001,060855082032001,"Block 2001, Block Group 2, Census Tract 5082.03, Santa Clara County, California",24,23,1
1000000US060855082032002,060855082032002,"Block 2002, Block Group 2, Census Tract 5082.03, Santa Clara County, California",144,141,3
1000000US060855082032003,060855082032003,"Block 2003, Block Group 2, Census Tract 5082.03, Santa Clara County, California",0,0,0
1000000US060855082032004,060855082032004,"Block 2004, Block Group 2, Census Tract 5082.03, Santa Clara County, California",6,6,0
1000000US060855082032005,060855082032005,"Block 2005, Block Group 2, Census Tract 5082.03, Santa Clara County, California",0,0,0
1000000US060855082032006,060855082032006,"Block 2006, Block Group 2, Census Tract 5082.03, Santa Clara County, California",0,0,0
1000000US060855082032007,060855082032007,"Block 2007, Block Group 2, Census Tract 5082.03, Santa Clara County, California",41,40,1
1000000US060855082032008,060855082032008,"Block 2008, Block Group 2, Census Tract 5082.03, Santa Clara County, California",93,93,0
1000000US060855082032009,060855082032009,"Block 2009, Block Group 2, Census Tract 5082.03, Santa Clara County, California",0,0,0
1000000US060855082032010,060855082032010,"Block 2010, Block Group 2, Census Tract 5082.03, Santa Clara County, California",45,43,2
1000000US060855082032011,060855082032011,"Block 2011, Block Group 2, Census Tract 5082.03, Santa Clara County, California",40,40,0
1000000US060855082032012,060855082032012,"Block 2012, Block Group 2, Census Tract 5082.03, Santa Clara County, California",27,27,0
1000000US060855082032013,060855082032013,"Block 2013, Block Group 2, Census Tract 5082.03, Santa Clara County, California",23,23,0
1000000US060855082032014,060855082032014,"Block 2014, Block Group 2, Census Tract 5082.03, Santa Clara County, California",53,51,2
1000000US060855082033000,060855082033000,"Block 3000, Block Group 3, Census Tract 5082.03, Santa Clara County, California",87,86,1
1000000US060855082033001,060855082033001,"Block 3001, Block Group 3, Census Tract 5082.03, Santa Clara County, California",40,40,0
1000000US060855082033002,060855082033002,"Block 3002, Block Group 3, Census Tract 5082.03, Santa Clara County, California",23,23,0
1000000US060855082033003,060855082033003,"Block 3003, Block Group 3, Census Tract 5082.03, Santa Clara County, California",34,34,0
1000000US060855082033004,060855082033004,"Block 3004, Block Group 3, Census Tract 5082.03, Santa Clara County, California",0,0,0
1000000US060855082033005,060855082033005,"Block 3005, Block Group 3, Census Tract 5082.03, Santa Clara County, California",0,0,0
1000000US060855082033006,060855082033006,"Block 3006, Block Group 3, Census Tract 5082.03, Santa Clara County, California",106,101,5
1000000US060855082033007,060855082033007,"Block 3007, Block Group 3, Census Tract 5082.03, Santa Clara County, California",70,68,2
1000000US060855082033008,060855082033008,"Block 3008, Block Group 3, Census Tract 5082.03, Santa Clara County, California",37,34,3
1000000US060855082033009,060855082033009,"Block 3009, Block Group 3, Census Tract 5082.03, Santa Clara County, California",87,85,2
1000000US060855082033010,060855082033010,"Block 3010, Block Group 3, Census Tract 5082.03, Santa Clara County, California",65,64,1
1000000US060855082033011,060855082033011,"Block 3011, Block Group 3, Census Tract 5082.03, Santa Clara County, California",44,43,1
1000000US060855082033012,060855082033012,"Block 3012, Block Group 3, Census Tract 5082.03, Santa Clara County, California",9,9,0
1000000US060855082033013,060855082033013,"Block 3013, Block Group 3, Census Tract 5082.03, Santa Clara County, California",107,101,6
1000000US060855082033014,060855082033014,"Block 3014, Block Group 3, Census Tract 5082.03, Santa Clara County, California",39,38,1
1000000US060855082033015,060855082033015,"Block 3015, Block Group 3, Census Tract 5082.03, Santa Clara County, California",0,0,0
1000000US060855082033016,060855082033016,"Block 3016, Block Group 3, Census Tract 5082.03, Santa Clara County, California",0,0,0
1000000US060855082033017,060855082033017,"Block 3017, Block Group 3, Census Tract 5082.03, Santa Clara County, California",56,53,3
1000000US060855082033018,060855082033018,"Block 3018, Block Group 3, Census Tract 5082.03, Santa Clara County, California",84,76,8
1000000US060855082041000,060855082041000,"Block 1000, Block Group 1, Census Tract 5082.04, Santa Clara County, California",1,1,0
1000000US060855082041001,060855082041001,"Block 1001, Block Group 1, Census Tract 5082.04, Santa Clara County, California",455,437,18
1000000US060855082041002,060855082041002,"Block 1002, Block Group 1, Census Tract 5082.04, Santa Clara County, California",34,34,0
1000000US060855082041003,060855082041003,"Block 1003, Block Group 1, Census Tract 5082.04, Santa Clara County, California",0,0,0
1000000US060855082041004,060855082041004,"Block 1004, Block Group 1, Census Tract 5082.04, Santa Clara County, California",68,65,3
1000000US060855082041005,060855082041005,"Block 1005, Block Group 1, Census Tract 5082.04, Santa Clara County, California",32,32,0
1000000US060855082041006,060855082041006,"Block 1006, Block Group 1, Census Tract 5082.04, Santa Clara County, California",33,32,1
1000000US060855082041007,060855082041007,"Block 1007, Block Group 1, Census Tract 5082.04, Santa Clara County, California",56,54,2
1000000US060855082041008,060855082041008,"Block 1008, Block Group 1, Census Tract 5082.04, Santa Clara County, California",0,0,0
1000000US060855082041009,060855082041009,"Block 1009, Block Group 1, Census Tract 5082.04, Santa Clara County, California",0,0,0
1000000US060855082041010,060855082041010,"Block 1010, Block Group 1, Census Tract 5082.04, Santa Clara County, California",0,0,0
1000000US060855082042000,060855082042000,"Block 2000, Block Group 2, Census Tract 5082.04, Santa Clara County, California",0,0,0
1000000US060855082042001,060855082042001,"Block 2001, Block Group 2, Census Tract 5082.04, Santa Clara County, California",0,0,0
1000000US060855082042002,060855082042002,"Block 2002, Block Group 2, Census Tract 5082.04, Santa Clara County, California",86,85,1
1000000US060855082042003,060855082042003,"Block 2003, Block Group 2, Census Tract 5082.04, Santa Clara County, California",59,58,1
1000000US060855082042004,060855082042004,"Block 2004, Block Group 2, Census Tract 5082.04, Santa Clara County, California",36,36,0
1000000US060855082042005,060855082042005,"Block 2005, Block Group 2, Census Tract 5082.04, Santa Clara County, California",36,34,2
1000000US060855082042006,060855082042006,"Block 2006, Block Group 2, Census Tract 5082.04, Santa Clara County, California",20,19,1
1000000US060855082042007,060855082042007,"Block 2007, Block Group 2, Census Tract 5082.04, Santa Clara County, California",52,51,1
1000000US060855082042008,060855082042008,"Block 2008, Block Group 2, Census Tract 5082.04, Santa Clara County, California",34,32,2
1000000US060855082042009,060855082042009,"Block 2009, Block Group 2, Census Tract 5082.04, Santa Clara County, California",31,31,0
1000000US060855082043000,060855082043000,"Block 3000, Block Group 3, Census Tract 5082.04, Santa Clara County, California",43,43,0
1000000US060855082043001,060855082043001,"Block 3001, Block Group 3, Census Tract 5082.04, Santa Clara County, California",37,35,2
1000000US060855082043002,060855082043002,"Block 3002, Block Group 3, Census Tract 5082.04, Santa Clara County, California",40,40,0
1000000US060855082043003,060855082043003,"Block 3003, Block Group 3, Census Tract 5082.04, Santa Clara County, California",38,36,2
1000000US060855082043004,060855082043004,"Block 3004, Block Group 3, Census Tract 5082.04, Santa Clara County, California",16,16,0
1000000US060855082043005,060855082043005,"Block 3005, Block Group 3, Census Tract 5082.04, Santa Clara County, California",12,12,0
1000000US060855082043006,060855082043006,"Block 3006, Block Group 3, Census Tract 5082.04, Santa Clara County, California",30,30,0
1000000US060855082043007,060855082043007,"Block 3007, Block Group 3, Census Tract 5082.04, Santa Clara County, California",43,39,4
1000000US060855082043008,060855082043008,"Block 3008, Block Group 3, Census Tract 5082.04, Santa Clara County, California",52,49,3
1000000US060855082043009,060855082043009,"Block 3009, Block Group 3, Census Tract 5082.04, Santa Clara County, California",32,32,0
1000000US060855082043010,060855082043010,"Block 3010, Block Group 3, Census Tract 5082.04, Santa Clara County, California",32,32,0
1000000US060855082043011,060855082043011,"Block 3011, Block Group 3, Census Tract 5082.04, Santa Clara County, California",0,0,0
1000000US060855082043012,060855082043012,"Block 3012, Block Group 3, Census Tract 5082.04, Santa Clara County, California",34,34,0
1000000US060855082043013,060855082043013,"Block 3013, Block Group 3, Census Tract 5082.04, Santa Clara County, California",39,39,0
1000000US060855082043014,060855082043014,"Block 3014, Block Group 3, Census Tract 5082.04, Santa Clara County, California",16,16,0
1000000US060855083011000,060855083011000,"Block 1000, Block Group 1, Census Tract 5083.01, Santa Clara County, California",181,177,4
1000000US060855083011001,060855083011001,"Block 1001, Block Group 1, Census Tract 5083.01, Santa Clara County, California",0,0,0
1000000US060855083011002,060855083011002,"Block 1002, Block Group 1, Census Tract 5083.01, Santa Clara County, California",88,87,1
1000000US060855083011003,060855083011003,"Block 1003, Block Group 1, Census Tract 5083.01, Santa Clara County, California",18,18,0
1000000US060855083011004,060855083011004,"Block 1004, Block Group 1, Census Tract 5083.01, Santa Clara County, California",28,28,0
1000000US060855083011005,060855083011005,"Block 1005, Block Group 1, Census Tract 5083.01, Santa Clara County, California",10,10,0
1000000US060855083011006,060855083011006,"Block 1006, Block Group 1, Census Tract 5083.01, Santa Clara County, California",47,47,0
1000000US060855083011007,060855083011007,"Block 1007, Block Group 1, Census Tract 5083.01, Santa Clara County, California",170,162,8
1000000US060855083011008,060855083011008,"Block 1008, Block Group 1, Census Tract 5083.01, Santa Clara County, California",0,0,0
1000000US060855083011009,060855083011009,"Block 1009, Block Group 1, Census Tract 5083.01, Santa Clara County, California",0,0,0
1000000US060855083012000,060855083012000,"Block 2000, Block Group 2, Census Tract 5083.01, Santa Clara County, California",35,34,1
1000000US060855083012001,060855083012001,"Block 2001, Block Group 2, Census Tract 5083.01, Santa Clara County, California",8,8,0
1000000US060855083012002,060855083012002,"Block 2002, Block Group 2, Census Tract 5083.01, Santa Clara County, California",0,0,0
1000000US060855083012003,060855083012003,"Block 2003, Block Group 2, Census Tract 5083.01, Santa Clara County, California",44,43,1
1000000US060855083012004,060855083012004,"Block 2004, Block Group 2, Census Tract 5083.01, Santa Clara County, California",62,60,2
1000000US060855083012005,060855083012005,"Block 2005, Block Group 2, Census Tract 5083.01, Santa Clara County, California",0,0,0
1000000US060855083012006,060855083012006,"Block 2006, Block Group 2, Census Tract 5083.01, Santa Clara County, California",0,0,0
1000000US060855083012007,060855083012007,"Block 2007, Block Group 2, Census Tract 5083.01, Santa Clara County, California",0,0,0
1000000US060855083012008,060855083012008,"Block 2008, Block Group 2, Census Tract 5083.01, Santa Clara County, California",39,37,2
1000000US060855083012009,060855083012009,"Block 2009, Block Group 2, Census Tract 5083.01, Santa Clara County, California",24,24,0
1000000US060855083012010,060855083012010,"Block 2010, Block Group 2, Census Tract 5083.01, Santa Clara County, California",69,68,1
1000000US060855083012011,060855083012011,"Block 2011, Block Group 2, Census Tract 5083.01, Santa Clara County, California",28,25,3
1000000US060855083012012,060855083012012,"Block 2012, Block Group 2, Census Tract 5083.01, Santa Clara County, California",42,41,1
1000000US060855083012013,060855083012013,"Block 2013, Block Group 2, Census Tract 5083.01, Santa Clara County, California",19,19,0
1000000US060855083012014,060855083012014,"Block 2014, Block Group 2, Census Tract 5083.01, Santa Clara County, California",45,44,1
1000000US060855083013000,060855083013000,"Block 3000, Block Group 3, Census Tract 5083.01, Santa Clara County, California",21,21,0
1000000US060855083013001,060855083013001,"Block 3001, Block Group 3, Census Tract 5083.01, Santa Clara County, California",0,0,0
1000000US060855083013002,060855083013002,"Block 3002, Block Group 3, Census Tract 5083.01, Santa Clara County, California",42,41,1
1000000US060855083013003,060855083013003,"Block 3003, Block Group 3, Census Tract 5083.01, Santa Clara County, California",16,16,0
1000000US060855083013004,060855083013004,"Block 3004, Block Group 3, Census Tract 5083.01, Santa Clara County, California",0,0,0
1000000US060855083013005,060855083013005,"Block 3005, Block Group 3, Census Tract 5083.01, Santa Clara County, California",72,72,0
1000000US060855083013006,060855083013006,"Block 3006, Block Group 3, Census Tract 5083.01, Santa Clara County, California",32,32,0
1000000US060855083013007,060855083013007,"Block 3007, Block Group 3, Census Tract 5083.01, Santa Clara County, California",21,21,0
1000000US060855083013008,060855083013008,"Block 3008, Block Group 3, Census Tract 5083.01, Santa Clara County, California",20,19,1
1000000US060855083013009,060855083013009,"Block 3009, Block Group 3, Census Tract 5083.01, Santa Clara County, California",21,21,0
1000000US060855083013010,060855083013010,"Block 3010, Block Group 3, Census Tract 5083.01, Santa Clara County, California",37,37,0
1000000US060855083013011,060855083013011,"Block 3011, Block Group 3, Census Tract 5083.01, Santa Clara County, California",34,34,0
1000000US060855083013012,060855083013012,"Block 3012, Block Group 3, Census Tract 5083.01, Santa Clara County, California",46,45,1
1000000US060855083013013,060855083013013,"Block 3013, Block Group 3, Census Tract 5083.01, Santa Clara County, California",62,61,1
1000000US060855083013014,060855083013014,"Block 3014, Block Group 3, Census Tract 5083.01, Santa Clara County, California",24,23,1
1000000US060855083013015,060855083013015,"Block 3015, Block Group 3, Census Tract 5083.01, Santa Clara County, California",32,32,0
1000000US060855083013016,060855083013016,"Block 3016, Block Group 3, Census Tract 5083.01, Santa Clara County, California",62,60,2
1000000US060855083013017,060855083013017,"Block 3017, Block Group 3, Census Tract 5083.01, Santa Clara County, California",35,35,0
1000000US060855083013018,060855083013018,"Block 3018, Block Group 3, Census Tract 5083.01, Santa Clara County, California",33,32,1
1000000US060855083031000,060855083031000,"Block 1000, Block Group 1, Census Tract 5083.03, Santa Clara County, California",1,1,0
1000000US060855083031001,060855083031001,"Block 1001, Block Group 1, Census Tract 5083.03, Santa Clara County, California",60,59,1
1000000US060855083031002,060855083031002,"Block 1002, Block Group 1, Census Tract 5083.03, Santa Clara County, California",57,57,0
1000000US060855083031003,060855083031003,"Block 1003, Block Group 1, Census Tract 5083.03, Santa Clara County, California",28,27,1
1000000US060855083031004,060855083031004,"Block 1004, Block Group 1, Census Tract 5083.03, Santa Clara County, California",19,19,0
1000000US060855083031005,060855083031005,"Block 1005, Block Group 1, Census Tract 5083.03, Santa Clara County, California",0,0,0
1000000US060855083031006,060855083031006,"Block 1006, Block Group 1, Census Tract 5083.03, Santa Clara County, California",0,0,0
1000000US060855083031007,060855083031007,"Block 1007, Block Group 1, Census Tract 5083.03, Santa Clara County, California",39,39,0
1000000US060855083031008,060855083031008,"Block 1008, Block Group 1, Census Tract 5083.03, Santa Clara County, California",66,66,0
1000000US060855083031009,060855083031009,"Block 1009, Block Group 1, Census Tract 5083.03, Santa Clara County, California",0,0,0
1000000US060855083031010,060855083031010,"Block 1010, Block Group 1, Census Tract 5083.03, Santa Clara County, California",41,41,0
1000000US060855083031011,060855083031011,"Block 1011, Block Group 1, Census Tract 5083.03, Santa Clara County, California",27,27,0
1000000US060855083031012,060855083031012,"Block 1012, Block Group 1, Census Tract 5083.03, Santa Clara County, California",48,46,2
1000000US060855083031013,060855083031013,"Block 1013, Block Group 1, Census Tract 5083.03, Santa Clara County, California",38,36,2
1000000US060855083031014,060855083031014,"Block 1014, Block Group 1, Census Tract 5083.03, Santa Clara County, California",0,0,0
1000000US060855083031015,060855083031015,"Block 1015, Block Group 1, Census Tract 5083.03, Santa Clara County, California",42,42,0
1000000US060855083032000,060855083032000,"Block 2000, Block Group 2, Census Tract 5083.03, Santa Clara County, California",25,25,0
1000000US060855083032001,060855083032001,"Block 2001, Block Group 2, Census Tract 5083.03, Santa Clara County, California",35,35,0
1000000US060855083032002,060855083032002,"Block 2002, Block Group 2, Census Tract 5083.03, Santa Clara County, California",31,30,1
1000000US060855083032003,060855083032003,"Block 2003, Block Group 2, Census Tract 5083.03, Santa Clara County, California",42,42,0
1000000US060855083032004,060855083032004,"Block 2004, Block Group 2, Census Tract 5083.03, Santa Clara County, California",0,0,0
1000000US060855083032005,060855083032005,"Block 2005, Block Group 2, Census Tract 5083.03, Santa Clara County, California",0,0,0
1000000US060855083032006,060855083032006,"Block 2006, Block Group 2, Census Tract 5083.03, Santa Clara County, California",65,65,0
1000000US060855083032007,060855083032007,"Block 2007, Block Group 2, Census Tract 5083.03, Santa Clara County, California",25,25,0
1000000US060855083032008,060855083032008,"Block 2008, Block Group 2, Census Tract 5083.03, Santa Clara County, California",35,34,1
1000000US060855083032009,060855083032009,"Block 2009, Block Group 2, Census Tract 5083.03, Santa Clara County, California",27,26,1
1000000US060855083032010,060855083032010,"Block 2010, Block Group 2, Census Tract 5083.03, Santa Clara County, California",27,27,0
1000000US060855083032011,060855083032011,"Block 2011, Block Group 2, Census Tract 5083.03, Santa Clara County, California",100,99,1
1000000US060855083032012,060855083032012,"Block 2012, Block Group 2, Census Tract 5083.03, Santa Clara County, California",23,23,0
1000000US060855083032013,060855083032013,"Block 2013, Block Group 2, Census Tract 5083.03, Santa Clara County, California",26,26,0
1000000US060855083032014,060855083032014,"Block 2014, Block Group 2, Census Tract 5083.03, Santa Clara County, California",0,0,0
1000000US060855083032015,060855083032015,"Block 2015, Block Group 2, Census Tract 5083.03, Santa Clara County, California",0,0,0
1000000US060855083041000,060855083041000,"Block 1000, Block Group 1, Census Tract 5083.04, Santa Clara County, California",70,69,1
1000000US060855083041001,060855083041001,"Block 1001, Block Group 1, Census Tract 5083.04, Santa Clara County, California",12,12,0
1000000US060855083041002,060855083041002,"Block 1002, Block Group 1, Census Tract 5083.04, Santa Clara County, California",12,11,1
1000000US060855083041003,060855083041003,"Block 1003, Block Group 1, Census Tract 5083.04, Santa Clara County, California",12,12,0
1000000US060855083041004,060855083041004,"Block 1004, Block Group 1, Census Tract 5083.04, Santa Clara County, California",12,12,0
1000000US060855083041005,060855083041005,"Block 1005, Block Group 1, Census Tract 5083.04, Santa Clara County, California",47,44,3
1000000US060855083041006,060855083041006,"Block 1006, Block Group 1, Census Tract 5083.04, Santa Clara County, California",36,36,0
1000000US060855083041007,060855083041007,"Block 1007, Block Group 1, Census Tract 5083.04, Santa Clara County, California",32,31,1
1000000US060855083041008,060855083041008,"Block 1008, Block Group 1, Census Tract 5083.04, Santa Clara County, California",32,32,0
1000000US060855083041009,060855083041009,"Block 1009, Block Group 1, Census Tract 5083.04, Santa Clara County, California",47,46,1
1000000US060855083041010,060855083041010,"Block 1010, Block Group 1, Census Tract 5083.04, Santa Clara County, California",0,0,0
1000000US060855083041011,060855083041011,"Block 1011, Block Group 1, Census Tract 5083.04, Santa Clara County, California",0,0,0
1000000US060855083041012,060855083041012,"Block 1012, Block Group 1, Census Tract 5083.04, Santa Clara County, California",39,39,0
1000000US060855083041013,060855083041013,"Block 1013, Block Group 1, Census Tract 5083.04, Santa Clara County, California",15,15,0
1000000US060855083041014,060855083041014,"Block 1014, Block Group 1, Census Tract 5083.04, Santa Clara County, California",13,12,1
1000000US060855083041015,060855083041015,"Block 1015, Block Group 1, Census Tract 5083.04, Santa Clara County, California",10,9,1
1000000US060855083041016,060855083041016,"Block 1016, Block Group 1, Census Tract 5083.04, Santa Clara County, California",41,39,2
1000000US060855083041017,060855083041017,"Block 1017, Block Group 1, Census Tract 5083.04, Santa Clara County, California",74,73,1
1000000US060855083041018,060855083041018,"Block 1018, Block Group 1, Census Tract 5083.04, Santa Clara County, California",0,0,0
1000000US060855083041019,060855083041019,"Block 1019, Block Group 1, Census Tract 5083.04, Santa Clara County, California",12,12,0
1000000US060855083042000,060855083042000,"Block 2000, Block Group 2, Census Tract 5083.04, Santa Clara County, California",63,61,2
1000000US060855083042001,060855083042001,"Block 2001, Block Group 2, Census Tract 5083.04, Santa Clara County, California",38,38,0
1000000US060855083042002,060855083042002,"Block 2002, Block Group 2, Census Tract 5083.04, Santa Clara County, California",35,35,0
1000000US060855083042003,060855083042003,"Block 2003, Block Group 2, Census Tract 5083.04, Santa Clara County, California",64,64,0
1000000US060855083042004,060855083042004,"Block 2004, Block Group 2, Census Tract 5083.04, Santa Clara County, California",76,76,0
1000000US060855083042005,060855083042005,"Block 2005, Block Group 2, Census Tract 5083.04, Santa Clara County, California",13,13,0
1000000US060855083042006,060855083042006,"Block 2006, Block Group 2, Census Tract 5083.04, Santa Clara County, California",0,0,0
1000000US060855083042007,060855083042007,"Block 2007, Block Group 2, Census Tract 5083.04, Santa Clara County, California",3,3,0
1000000US060855083043000,060855083043000,"Block 3000, Block Group 3, Census Tract 5083.04, Santa Clara County, California",53,52,1
1000000US060855083043001,060855083043001,"Block 3001, Block Group 3, Census Tract 5083.04, Santa Clara County, California",14,13,1
1000000US060855083043002,060855083043002,"Block 3002, Block Group 3, Census Tract 5083.04, Santa Clara County, California",20,20,0
1000000US060855083043003,060855083043003,"Block 3003, Block Group 3, Census Tract 5083.04, Santa Clara County, California",220,211,9
1000000US060855083043004,060855083043004,"Block 3004, Block Group 3, Census Tract 5083.04, Santa Clara County, California",10,8,2
1000000US060855083044000,060855083044000,"Block 4000, Block Group 4, Census Tract 5083.04, Santa Clara County, California",705,668,37
1000000US060855083044001,060855083044001,"Block 4001, Block Group 4, Census Tract 5083.04, Santa Clara County, California",22,22,0
1000000US060855083045000,060855083045000,"Block 5000, Block Group 5, Census Tract 5083.04, Santa Clara County, California",251,241,10
1000000US060855083045001,060855083045001,"Block 5001, Block Group 5, Census Tract 5083.04, Santa Clara County, California",196,161,35
1000000US060855083045002,060855083045002,"Block 5002, Block Group 5, Census Tract 5083.04, Santa Clara County, California",272,259,13
1000000US060855083045003,060855083045003,"Block 5003, Block Group 5, Census Tract 5083.04, Santa Clara County, California",411,393,18
1000000US060855083045004,060855083045004,"Block 5004, Block Group 5, Census Tract 5083.04, Santa Clara County, California",0,0,0
1000000US060855083045005,060855083045005,"Block 5005, Block Group 5, Census Tract 5083.04, Santa Clara County, California",0,0,0
1000000US060855083045006,060855083045006,"Block 5006, Block Group 5, Census Tract 5083.04, Santa Clara County, California",49,49,0
1000000US060855083045007,060855083045007,"Block 5007, Block Group 5, Census Tract 5083.04, Santa Clara County, California",19,18,1
1000000US060855083045008,060855083045008,"Block 5008, Block Group 5, Census Tract 5083.04, Santa Clara County, California",38,38,0
1000000US060855084011000,060855084011000,"Block 1000, Block Group 1, Census Tract 5084.01, Santa Clara County, California",20,20,0
1000000US060855084011001,060855084011001,"Block 1001, Block Group 1, Census Tract 5084.01, Santa Clara County, California",29,29,0
1000000US060855084011002,060855084011002,"Block 1002, Block Group 1, Census Tract 5084.01, Santa Clara County, California",30,30,0
1000000US060855084011003,060855084011003,"Block 1003, Block Group 1, Census Tract 5084.01, Santa Clara County, California",30,30,0
1000000US060855084011004,060855084011004,"Block 1004, Block Group 1, Census Tract 5084.01, Santa Clara County, California",54,51,3
1000000US060855084011005,060855084011005,"Block 1005, Block Group 1, Census Tract 5084.01, Santa Clara County, California",47,45,2
1000000US060855084011006,060855084011006,"Block 1006, Block Group 1, Census Tract 5084.01, Santa Clara County, California",15,15,0
1000000US060855084011007,060855084011007,"Block 1007, Block Group 1, Census Tract 5084.01, Santa Clara County, California",17,17,0
1000000US060855084011008,060855084011008,"Block 1008, Block Group 1, Census Tract 5084.01, Santa Clara County, California",20,20,0
1000000US060855084012000,060855084012000,"Block 2000, Block Group 2, Census Tract 5084.01, Santa Clara County, California",64,61,3
1000000US060855084012001,060855084012001,"Block 2001, Block Group 2, Census Tract 5084.01, Santa Clara County, California",36,35,1
1000000US060855084012002,060855084012002,"Block 2002, Block Group 2, Census Tract 5084.01, Santa Clara County, California",20,19,1
1000000US060855084012003,060855084012003,"Block 2003, Block Group 2, Census Tract 5084.01, Santa Clara County, California",20,20,0
1000000US060855084012004,060855084012004,"Block 2004, Block Group 2, Census Tract 5084.01, Santa Clara County, California",40,40,0
1000000US060855084012005,060855084012005,"Block 2005, Block Group 2, Census Tract 5084.01, Santa Clara County, California",52,50,2
1000000US060855084012006,060855084012006,"Block 2006, Block Group 2, Census Tract 5084.01, Santa Clara County, California",86,84,2
1000000US060855084012007,060855084012007,"Block 2007, Block Group 2, Census Tract 5084.01, Santa Clara County, California",28,27,1
1000000US060855084012008,060855084012008,"Block 2008, Block Group 2, Census Tract 5084.01, Santa Clara County, California",15,15,0
1000000US060855084012009,060855084012009,"Block 2009, Block Group 2, Census Tract 5084.01, Santa Clara County, California",0,0,0
1000000US060855084012010,060855084012010,"Block 2010, Block Group 2, Census Tract 5084.01, Santa Clara County, California",26,25,1
1000000US060855084012011,060855084012011,"Block 2011, Block Group 2, Census Tract 5084.01, Santa Clara County, California",0,0,0
1000000US060855084012012,060855084012012,"Block 2012, Block Group 2, Census Tract 5084.01, Santa Clara County, California",0,0,0
1000000US060855084012013,060855084012013,"Block 2013, Block Group 2, Census Tract 5084.01, Santa Clara County, California",0,0,0
1000000US060855084013000,060855084013000,"Block 3000, Block Group 3, Census Tract 5084.01, Santa Clara County, California",187,173,14
1000000US060855084013001,060855084013001,"Block 3001, Block Group 3, Census Tract 5084.01, Santa Clara County, California",40,39,1
1000000US060855084013002,060855084013002,"Block 3002, Block Group 3, Census Tract 5084.01, Santa Clara County, California",24,24,0
1000000US060855084013003,060855084013003,"Block 3003, Block Group 3, Census Tract 5084.01, Santa Clara County, California",160,152,8
1000000US060855084013004,060855084013004,"Block 3004, Block Group 3, Census Tract 5084.01, Santa Clara County, California",19,18,1
1000000US060855084013005,060855084013005,"Block 3005, Block Group 3, Census Tract 5084.01, Santa Clara County, California",30,30,0
1000000US060855084013006,060855084013006,"Block 3006, Block Group 3, Census Tract 5084.01, Santa Clara County, California",48,48,0
1000000US060855084013007,060855084013007,"Block 3007, Block Group 3, Census Tract 5084.01, Santa Clara County, California",22,22,0
1000000US060855084013008,060855084013008,"Block 3008, Block Group 3, Census Tract 5084.01, Santa Clara County, California",18,18,0
1000000US060855084014000,060855084014000,"Block 4000, Block Group 4, Census Tract 5084.01, Santa Clara County, California",37,34,3
1000000US060855084014001,060855084014001,"Block 4001, Block Group 4, Census Tract 5084.01, Santa Clara County, California",37,36,1
1000000US060855084014002,060855084014002,"Block 4002, Block Group 4, Census Tract 5084.01, Santa Clara County, California",41,40,1
1000000US060855084014003,060855084014003,"Block 4003, Block Group 4, Census Tract 5084.01, Santa Clara County, California",51,50,1
1000000US060855084014004,060855084014004,"Block 4004, Block Group 4, Census Tract 5084.01, Santa Clara County, California",57,55,2
1000000US060855084014005,060855084014005,"Block 4005, Block Group 4, Census Tract 5084.01, Santa Clara County, California",20,19,1
1000000US060855084014006,060855084014006,"Block 4006, Block Group 4, Census Tract 5084.01, Santa Clara County, California",19,19,0
1000000US060855084014007,060855084014007,"Block 4007, Block Group 4, Census Tract 5084.01, Santa Clara County, California",6,6,0
1000000US060855084014008,060855084014008,"Block 4008, Block Group 4, Census Tract 5084.01, Santa Clara County, California",0,0,0
1000000US060855084014009,060855084014009,"Block 4009, Block Group 4, Census Tract 5084.01, Santa Clara County, California",0,0,0
1000000US060855084014010,060855084014010,"Block 4010, Block Group 4, Census Tract 5084.01, Santa Clara County, California",0,0,0
1000000US060855084014011,060855084014011,"Block 4011, Block Group 4, Census Tract 5084.01, Santa Clara County, California",0,0,0
1000000US060855084014012,060855084014012,"Block 4012, Block Group 4, Census Tract 5084.01, Santa Clara County, California",0,0,0
1000000US060855084014013,060855084014013,"Block 4013, Block Group 4, Census Tract 5084.01, Santa Clara County, California",0,0,0
1000000US060855084014014,060855084014014,"Block 4014, Block Group 4, Census Tract 5084.01, Santa Clara County, California",16,16,0
1000000US060855084014015,060855084014015,"Block 4015, Block Group 4, Census Tract 5084.01, Santa Clara County, California",23,23,0
1000000US060855084015000,060855084015000,"Block 5000, Block Group 5, Census Tract 5084.01, Santa Clara County, California",24,24,0
1000000US060855084015001,060855084015001,"Block 5001, Block Group 5, Census Tract 5084.01, Santa Clara County, California",38,38,0
1000000US060855084015002,060855084015002,"Block 5002, Block Group 5, Census Tract 5084.01, Santa Clara County, California",29,28,1
1000000US060855084015003,060855084015003,"Block 5003, Block Group 5, Census Tract 5084.01, Santa Clara County, California",61,60,1
1000000US060855084015004,060855084015004,"Block 5004, Block Group 5, Census Tract 5084.01, Santa Clara County, California",26,26,0
1000000US060855084015005,060855084015005,"Block 5005, Block Group 5, Census Tract 5084.01, Santa Clara County, California",26,26,0
1000000US060855084015006,060855084015006,"Block 5006, Block Group 5, Census Tract 5084.01, Santa Clara County, California",0,0,0
1000000US060855084015007,060855084015007,"Block 5007, Block Group 5, Census Tract 5084.01, Santa Clara County, California",0,0,0
1000000US060855084015008,060855084015008,"Block 5008, Block Group 5, Census Tract 5084.01, Santa Clara County, California",0,0,0
1000000US060855084015009,060855084015009,"Block 5009, Block Group 5, Census Tract 5084.01, Santa Clara County, California",0,0,0
1000000US060855084015010,060855084015010,"Block 5010, Block Group 5, Census Tract 5084.01, Santa Clara County, California",0,0,0
1000000US060855084015011,060855084015011,"Block 5011, Block Group 5, Census Tract 5084.01, Santa Clara County, California",0,0,0
1000000US060855084015012,060855084015012,"Block 5012, Block Group 5, Census Tract 5084.01, Santa Clara County, California",48,48,0
1000000US060855084015013,060855084015013,"Block 5013, Block Group 5, Census Tract 5084.01, Santa Clara County, California",23,23,0
1000000US060855084015014,060855084015014,"Block 5014, Block Group 5, Census Tract 5084.01, Santa Clara County, California",11,11,0
1000000US060855084015015,060855084015015,"Block 5015, Block Group 5, Census Tract 5084.01, Santa Clara County, California",12,12,0
1000000US060855084015016,060855084015016,"Block 5016, Block Group 5, Census Tract 5084.01, Santa Clara County, California",24,24,0
1000000US060855084015017,060855084015017,"Block 5017, Block Group 5, Census Tract 5084.01, Santa Clara County, California",36,35,1
1000000US060855084015018,060855084015018,"Block 5018, Block Group 5, Census Tract 5084.01, Santa Clara County, California",63,63,0
1000000US060855084015019,060855084015019,"Block 5019, Block Group 5, Census Tract 5084.01, Santa Clara County, California",18,17,1
1000000US060855084015020,060855084015020,"Block 5020, Block Group 5, Census Tract 5084.01, Santa Clara County, California",26,26,0
1000000US060855084016000,060855084016000,"Block 6000, Block Group 6, Census Tract 5084.01, Santa Clara County, California",14,14,0
1000000US060855084016001,060855084016001,"Block 6001, Block Group 6, Census Tract 5084.01, Santa Clara County, California",146,141,5
1000000US060855084016002,060855084016002,"Block 6002, Block Group 6, Census Tract 5084.01, Santa Clara County, California",0,0,0
1000000US060855084016003,060855084016003,"Block 6003, Block Group 6, Census Tract 5084.01, Santa Clara County, California",78,74,4
1000000US060855084016004,060855084016004,"Block 6004, Block Group 6, Census Tract 5084.01, Santa Clara County, California",0,0,0
1000000US060855084016005,060855084016005,"Block 6005, Block Group 6, Census Tract 5084.01, Santa Clara County, California",35,35,0
1000000US060855084016006,060855084016006,"Block 6006, Block Group 6, Census Tract 5084.01, Santa Clara County, California",108,97,11
1000000US060855084016007,060855084016007,"Block 6007, Block Group 6, Census Tract 5084.01, Santa Clara County, California",0,0,0
1000000US060855084016008,060855084016008,"Block 6008, Block Group 6, Census Tract 5084.01, Santa Clara County, California",24,24,0
1000000US060855084016009,060855084016009,"Block 6009, Block Group 6, Census Tract 5084.01, Santa Clara County, California",31,31,0
1000000US060855084016010,060855084016010,"Block 6010, Block Group 6, Census Tract 5084.01, Santa Clara County, California",23,23,0
1000000US060855084016011,060855084016011,"Block 6011, Block Group 6, Census Tract 5084.01, Santa Clara County, California",38,35,3
1000000US060855084016012,060855084016012,"Block 6012, Block Group 6, Census Tract 5084.01, Santa Clara County, California",37,36,1
1000000US060855084016013,060855084016013,"Block 6013, Block Group 6, Census Tract 5084.01, Santa Clara County, California",37,37,0
1000000US060855084016014,060855084016014,"Block 6014, Block Group 6, Census Tract 5084.01, Santa Clara County, California",24,23,1
1000000US060855084016015,060855084016015,"Block 6015, Block Group 6, Census Tract 5084.01, Santa Clara County, California",24,23,1
1000000US060855084016016,060855084016016,"Block 6016, Block Group 6, Census Tract 5084.01, Santa Clara County, California",24,23,1
1000000US060855084031000,060855084031000,"Block 1000, Block Group 1, Census Tract 5084.03, Santa Clara County, California",57,57,0
1000000US060855084031001,060855084031001,"Block 1001, Block Group 1, Census Tract 5084.03, Santa Clara County, California",50,48,2
1000000US060855084031002,060855084031002,"Block 1002, Block Group 1, Census Tract 5084.03, Santa Clara County, California",81,80,1
1000000US060855084031003,060855084031003,"Block 1003, Block Group 1, Census Tract 5084.03, Santa Clara County, California",16,16,0
1000000US060855084031004,060855084031004,"Block 1004, Block Group 1, Census Tract 5084.03, Santa Clara County, California",0,0,0
1000000US060855084031005,060855084031005,"Block 1005, Block Group 1, Census Tract 5084.03, Santa Clara County, California",0,0,0
1000000US060855084031006,060855084031006,"Block 1006, Block Group 1, Census Tract 5084.03, Santa Clara County, California",32,31,1
1000000US060855084031007,060855084031007,"Block 1007, Block Group 1, Census Tract 5084.03, Santa Clara County, California",0,0,0
1000000US060855084031008,060855084031008,"Block 1008, Block Group 1, Census Tract 5084.03, Santa Clara County, California",48,46,2
1000000US060855084032000,060855084032000,"Block 2000, Block Group 2, Census Tract 5084.03, Santa Clara County, California",132,129,3
1000000US060855084032001,060855084032001,"Block 2001, Block Group 2, Census Tract 5084.03, Santa Clara County, California",48,48,0
1000000US060855084032002,060855084032002,"Block 2002, Block Group 2, Census Tract 5084.03, Santa Clara County, California",54,54,0
1000000US060855084032003,060855084032003,"Block 2003, Block Group 2, Census Tract 5084.03, Santa Clara County, California",43,43,0
1000000US060855084032004,060855084032004,"Block 2004, Block Group 2, Census Tract 5084.03, Santa Clara County, California",0,0,0
1000000US060855084032005,060855084032005,"Block 2005, Block Group 2, Census Tract 5084.03, Santa Clara County, California",33,33,0
1000000US060855084032006,060855084032006,"Block 2006, Block Group 2, Census Tract 5084.03, Santa Clara County, California",63,63,0
1000000US060855084032007,060855084032007,"Block 2007, Block Group 2, Census Tract 5084.03, Santa Clara County, California",19,19,0
1000000US060855084032008,060855084032008,"Block 2008, Block Group 2, Census Tract 5084.03, Santa Clara County, California",13,13,0
1000000US060855084033000,060855084033000,"Block 3000, Block Group 3, Census Tract 5084.03, Santa Clara County, California",17,17,0
1000000US060855084033001,060855084033001,"Block 3001, Block Group 3, Census Tract 5084.03, Santa Clara County, California",162,158,4
1000000US060855084033002,060855084033002,"Block 3002, Block Group 3, Census Tract 5084.03, Santa Clara County, California",0,0,0
1000000US060855084033003,060855084033003,"Block 3003, Block Group 3, Census Tract 5084.03, Santa Clara County, California",22,22,0
1000000US060855084033004,060855084033004,"Block 3004, Block Group 3, Census Tract 5084.03, Santa Clara County, California",16,16,0
1000000US060855084033005,060855084033005,"Block 3005, Block Group 3, Census Tract 5084.03, Santa Clara County, California",8,8,0
1000000US060855084033006,060855084033006,"Block 3006, Block Group 3, Census Tract 5084.03, Santa Clara County, California",79,68,11
1000000US060855084033007,060855084033007,"Block 3007, Block Group 3, Census Tract 5084.03, Santa Clara County, California",0,0,0
1000000US060855084033008,060855084033008,"Block 3008, Block Group 3, Census Tract 5084.03, Santa Clara County, California",16,16,0
1000000US060855084033009,060855084033009,"Block 3009, Block Group 3, Census Tract 5084.03, Santa Clara County, California",1,1,0
1000000US060855084033010,060855084033010,"Block 3010, Block Group 3, Census Tract 5084.03, Santa Clara County, California",0,0,0
1000000US060855084033011,060855084033011,"Block 3011, Block Group 3, Census Tract 5084.03, Santa Clara County, California",0,0,0
1000000US060855084033012,060855084033012,"Block 3012, Block Group 3, Census Tract 5084.03, Santa Clara County, California",0,0,0
1000000US060855084033013,060855084033013,"Block 3013, Block Group 3, Census Tract 5084.03, Santa Clara County, California",0,0,0
1000000US060855084033014,060855084033014,"Block 3014, Block Group 3, Census Tract 5084.03, Santa Clara County, California",17,11,6
1000000US060855084033015,060855084033015,"Block 3015, Block Group 3, Census Tract 5084.03, Santa Clara County, California",20,9,11
1000000US060855084033016,060855084033016,"Block 3016, Block Group 3, Census Tract 5084.03, Santa Clara County, California",32,32,0
1000000US060855084041000,060855084041000,"Block 1000, Block Group 1, Census Tract 5084.04, Santa Clara County, California",301,284,17
1000000US060855084041001,060855084041001,"Block 1001, Block Group 1, Census Tract 5084.04, Santa Clara County, California",429,406,23
1000000US060855084041002,060855084041002,"Block 1002, Block Group 1, Census Tract 5084.04, Santa Clara County, California",0,0,0
1000000US060855084041003,060855084041003,"Block 1003, Block Group 1, Census Tract 5084.04, Santa Clara County, California",1,1,0
1000000US060855084041004,060855084041004,"Block 1004, Block Group 1, Census Tract 5084.04, Santa Clara County, California",13,13,0
1000000US060855084041005,060855084041005,"Block 1005, Block Group 1, Census Tract 5084.04, Santa Clara County, California",7,7,0
1000000US060855084041006,060855084041006,"Block 1006, Block Group 1, Census Tract 5084.04, Santa Clara County, California",3,3,0
1000000US060855084041007,060855084041007,"Block 1007, Block Group 1, Census Tract 5084.04, Santa Clara County, California",59,57,2
1000000US060855084041008,060855084041008,"Block 1008, Block Group 1, Census Tract 5084.04, Santa Clara County, California",44,44,0
1000000US060855084041009,060855084041009,"Block 1009, Block Group 1, Census Tract 5084.04, Santa Clara County, California",77,75,2
1000000US060855084041010,060855084041010,"Block 1010, Block Group 1, Census Tract 5084.04, Santa Clara County, California",69,67,2
1000000US060855084041011,060855084041011,"Block 1011, Block Group 1, Census Tract 5084.04, Santa Clara County, California",31,31,0
1000000US060855084041012,060855084041012,"Block 1012, Block Group 1, Census Tract 5084.04, Santa Clara County, California",97,93,4
1000000US060855084041013,060855084041013,"Block 1013, Block Group 1, Census Tract 5084.04, Santa Clara County, California",28,28,0
1000000US060855084041014,060855084041014,"Block 1014, Block Group 1, Census Tract 5084.04, Santa Clara County, California",9,9,0
1000000US060855084041015,060855084041015,"Block 1015, Block Group 1, Census Tract 5084.04, Santa Clara County, California",24,23,1
1000000US060855084041016,060855084041016,"Block 1016, Block Group 1, Census Tract 5084.04, Santa Clara County, California",6,6,0
1000000US060855084041017,060855084041017,"Block 1017, Block Group 1, Census Tract 5084.04, Santa Clara County, California",20,20,0
1000000US060855084041018,060855084041018,"Block 1018, Block Group 1, Census Tract 5084.04, Santa Clara County, California",33,33,0
1000000US060855084041019,060855084041019,"Block 1019, Block Group 1, Census Tract 5084.04, Santa Clara County, California",3,3,0
1000000US060855084041020,060855084041020,"Block 1020, Block Group 1, Census Tract 5084.04, Santa Clara County, California",7,7,0
1000000US060855084042000,060855084042000,"Block 2000, Block Group 2, Census Tract 5084.04, Santa Clara County, California",0,0,0
1000000US060855084042001,060855084042001,"Block 2001, Block Group 2, Census Tract 5084.04, Santa Clara County, California",116,113,3
1000000US060855084042002,060855084042002,"Block 2002, Block Group 2, Census Tract 5084.04, Santa Clara County, California",41,39,2
1000000US060855084042003,060855084042003,"Block 2003, Block Group 2, Census Tract 5084.04, Santa Clara County, California",0,0,0
1000000US060855084042004,060855084042004,"Block 2004, Block Group 2, Census Tract 5084.04, Santa Clara County, California",0,0,0
1000000US060855084042005,060855084042005,"Block 2005, Block Group 2, Census Tract 5084.04, Santa Clara County, California",0,0,0
1000000US060855084042006,060855084042006,"Block 2006, Block Group 2, Census Tract 5084.04, Santa Clara County, California",47,47,0
1000000US060855084042007,060855084042007,"Block 2007, Block Group 2, Census Tract 5084.04, Santa Clara County, California",171,166,5
1000000US060855084042008,060855084042008,"Block 2008, Block Group 2, Census Tract 5084.04, Santa Clara County, California",46,44,2
1000000US060855084042009,060855084042009,"Block 2009, Block Group 2, Census Tract 5084.04, Santa Clara County, California",22,22,0
1000000US060855084042010,060855084042010,"Block 2010, Block Group 2, Census Tract 5084.04, Santa Clara County, California",33,33,0
1000000US060855084042011,060855084042011,"Block 2011, Block Group 2, Census Tract 5084.04, Santa Clara County, California",45,45,0
1000000US060855084042012,060855084042012,"Block 2012, Block Group 2, Census Tract 5084.04, Santa Clara County, California",23,23,0
1000000US060855084042013,060855084042013,"Block 2013, Block Group 2, Census Tract 5084.04, Santa Clara County, California",45,44,1
1000000US060855084042014,060855084042014,"Block 2014, Block Group 2, Census Tract 5084.04, Santa Clara County, California",32,30,2
1000000US060855084042015,060855084042015,"Block 2015, Block Group 2, Census Tract 5084.04, Santa Clara County, California",0,0,0
1000000US060855084043000,060855084043000,"Block 3000, Block Group 3, Census Tract 5084.04, Santa Clara County, California",34,34,0
1000000US060855084043001,060855084043001,"Block 3001, Block Group 3, Census Tract 5084.04, Santa Clara County, California",36,35,1
1000000US060855084043002,060855084043002,"Block 3002, Block Group 3, Census Tract 5084.04, Santa Clara County, California",31,31,0
1000000US060855084043003,060855084043003,"Block 3003, Block Group 3, Census Tract 5084.04, Santa Clara County, California",54,50,4
1000000US060855084043004,060855084043004,"Block 3004, Block Group 3, Census Tract 5084.04, Santa Clara County, California",27,26,1
1000000US060855084043005,060855084043005,"Block 3005, Block Group 3, Census Tract 5084.04, Santa Clara County, California",0,0,0
1000000US060855084043006,060855084043006,"Block 3006, Block Group 3, Census Tract 5084.04, Santa Clara County, California",0,0,0
1000000US060855084043007,060855084043007,"Block 3007, Block Group 3, Census Tract 5084.04, Santa Clara County, California",0,0,0
1000000US060855084043008,060855084043008,"Block 3008, Block Group 3, Census Tract 5084.04, Santa Clara County, California",66,66,0
1000000US060855084043009,060855084043009,"Block 3009, Block Group 3, Census Tract 5084.04, Santa Clara County, California",20,20,0
1000000US060855084043010,060855084043010,"Block 3010, Block Group 3, Census Tract 5084.04, Santa Clara County, California",30,27,3
1000000US060855084043011,060855084043011,"Block 3011, Block Group 3, Census Tract 5084.04, Santa Clara County, California",0,0,0
1000000US060855084043012,060855084043012,"Block 3012, Block Group 3, Census Tract 5084.04, Santa Clara County, California",0,0,0
1000000US060855084043013,060855084043013,"Block 3013, Block Group 3, Census Tract 5084.04, Santa Clara County, California",103,100,3
1000000US060855084043014,060855084043014,"Block 3014, Block Group 3, Census Tract 5084.04, Santa Clara County, California",39,38,1
1000000US060855084043015,060855084043015,"Block 3015, Block Group 3, Census Tract 5084.04, Santa Clara County, California",29,29,0
1000000US060855084043016,060855084043016,"Block 3016, Block Group 3, Census Tract 5084.04, Santa Clara County, California",19,19,0
1000000US060855084043017,060855084043017,"Block 3017, Block Group 3, Census Tract 5084.04, Santa Clara County, California",0,0,0
1000000US060855085031000,060855085031000,"Block 1000, Block Group 1, Census Tract 5085.03, Santa Clara County, California",0,0,0
1000000US060855085031001,060855085031001,"Block 1001, Block Group 1, Census Tract 5085.03, Santa Clara County, California",0,0,0
1000000US060855085031002,060855085031002,"Block 1002, Block Group 1, Census Tract 5085.03, Santa Clara County, California",0,0,0
1000000US060855085031003,060855085031003,"Block 1003, Block Group 1, Census Tract 5085.03, Santa Clara County, California",48,47,1
1000000US060855085031004,060855085031004,"Block 1004, Block Group 1, Census Tract 5085.03, Santa Clara County, California",0,0,0
1000000US060855085031005,060855085031005,"Block 1005, Block Group 1, Census Tract 5085.03, Santa Clara County, California",611,514,97
1000000US060855085031006,060855085031006,"Block 1006, Block Group 1, Census Tract 5085.03, Santa Clara County, California",21,19,2
1000000US060855085031007,060855085031007,"Block 1007, Block Group 1, Census Tract 5085.03, Santa Clara County, California",0,0,0
1000000US060855085031008,060855085031008,"Block 1008, Block Group 1, Census Tract 5085.03, Santa Clara County, California",35,32,3
1000000US060855085031009,060855085031009,"Block 1009, Block Group 1, Census Tract 5085.03, Santa Clara County, California",33,32,1
1000000US060855085031010,060855085031010,"Block 1010, Block Group 1, Census Tract 5085.03, Santa Clara County, California",66,61,5
1000000US060855085031011,060855085031011,"Block 1011, Block Group 1, Census Tract 5085.03, Santa Clara County, California",0,0,0
1000000US060855085032000,060855085032000,"Block 2000, Block Group 2, Census Tract 5085.03, Santa Clara County, California",0,0,0
1000000US060855085032001,060855085032001,"Block 2001, Block Group 2, Census Tract 5085.03, Santa Clara County, California",10,10,0
1000000US060855085032002,060855085032002,"Block 2002, Block Group 2, Census Tract 5085.03, Santa Clara County, California",54,51,3
1000000US060855085032003,060855085032003,"Block 2003, Block Group 2, Census Tract 5085.03, Santa Clara County, California",20,20,0
1000000US060855085032004,060855085032004,"Block 2004, Block Group 2, Census Tract 5085.03, Santa Clara County, California",38,38,0
1000000US060855085032005,060855085032005,"Block 2005, Block Group 2, Census Tract 5085.03, Santa Clara County, California",348,338,10
1000000US060855085032006,060855085032006,"Block 2006, Block Group 2, Census Tract 5085.03, Santa Clara County, California",0,0,0
1000000US060855085032007,060855085032007,"Block 2007, Block Group 2, Census Tract 5085.03, Santa Clara County, California",38,37,1
1000000US060855085032008,060855085032008,"Block 2008, Block Group 2, Census Tract 5085.03, Santa Clara County, California",51,50,1
1000000US060855085032009,060855085032009,"Block 2009, Block Group 2, Census Tract 5085.03, Santa Clara County, California",3,3,0
1000000US060855085032010,060855085032010,"Block 2010, Block Group 2, Census Tract 5085.03, Santa Clara County, California",0,0,0
1000000US060855085032011,060855085032011,"Block 2011, Block Group 2, Census Tract 5085.03, Santa Clara County, California",0,0,0
1000000US060855085032012,060855085032012,"Block 2012, Block Group 2, Census Tract 5085.03, Santa Clara County, California",0,0,0
1000000US060855085032013,060855085032013,"Block 2013, Block Group 2, Census Tract 5085.03, Santa Clara County, California",0,0,0
1000000US060855085032014,060855085032014,"Block 2014, Block Group 2, Census Tract 5085.03, Santa Clara County, California",0,0,0
1000000US060855085032015,060855085032015,"Block 2015, Block Group 2, Census Tract 5085.03, Santa Clara County, California",0,0,0
1000000US060855085032016,060855085032016,"Block 2016, Block Group 2, Census Tract 5085.03, Santa Clara County, California",0,0,0
1000000US060855085032017,060855085032017,"Block 2017, Block Group 2, Census Tract 5085.03, Santa Clara County, California",0,0,0
1000000US060855085032018,060855085032018,"Block 2018, Block Group 2, Census Tract 5085.03, Santa Clara County, California",0,0,0
1000000US060855085032019,060855085032019,"Block 2019, Block Group 2, Census Tract 5085.03, Santa Clara County, California",0,0,0
1000000US060855085032020,060855085032020,"Block 2020, Block Group 2, Census Tract 5085.03, Santa Clara County, California",0,0,0
1000000US060855085032021,060855085032021,"Block 2021, Block Group 2, Census Tract 5085.03, Santa Clara County, California",0,0,0
1000000US060855085032022,060855085032022,"Block 2022, Block Group 2, Census Tract 5085.03, Santa Clara County, California",0,0,0
1000000US060855085032023,060855085032023,"Block 2023, Block Group 2, Census Tract 5085.03, Santa Clara County, California",34,34,0
1000000US060855085032024,060855085032024,"Block 2024, Block Group 2, Census Tract 5085.03, Santa Clara County, California",12,12,0
1000000US060855085033000,060855085033000,"Block 3000, Block Group 3, Census Tract 5085.03, Santa Clara County, California",0,0,0
1000000US060855085033001,060855085033001,"Block 3001, Block Group 3, Census Tract 5085.03, Santa Clara County, California",188,185,3
1000000US060855085033002,060855085033002,"Block 3002, Block Group 3, Census Tract 5085.03, Santa Clara County, California",297,281,16
1000000US060855085033003,060855085033003,"Block 3003, Block Group 3, Census Tract 5085.03, Santa Clara County, California",81,68,13
1000000US060855085033004,060855085033004,"Block 3004, Block Group 3, Census Tract 5085.03, Santa Clara County, California",0,0,0
1000000US060855085033005,060855085033005,"Block 3005, Block Group 3, Census Tract 5085.03, Santa Clara County, California",0,0,0
1000000US060855085033006,060855085033006,"Block 3006, Block Group 3, Census Tract 5085.03, Santa Clara County, California",55,54,1
1000000US060855085033007,060855085033007,"Block 3007, Block Group 3, Census Tract 5085.03, Santa Clara County, California",122,121,1
1000000US060855085033008,060855085033008,"Block 3008, Block Group 3, Census Tract 5085.03, Santa Clara County, California",26,26,0
1000000US060855085033009,060855085033009,"Block 3009, Block Group 3, Census Tract 5085.03, Santa Clara County, California",12,12,0
1000000US060855085033010,060855085033010,"Block 3010, Block Group 3, Census Tract 5085.03, Santa Clara County, California",56,55,1
1000000US060855085033011,060855085033011,"Block 3011, Block Group 3, Census Tract 5085.03, Santa Clara County, California",0,0,0
1000000US060855085033012,060855085033012,"Block 3012, Block Group 3, Census Tract 5085.03, Santa Clara County, California",0,0,0
1000000US060855085033013,060855085033013,"Block 3013, Block Group 3, Census Tract 5085.03, Santa Clara County, California",0,0,0
1000000US060855085033014,060855085033014,"Block 3014, Block Group 3, Census Tract 5085.03, Santa Clara County, California",0,0,0
1000000US060855085033015,060855085033015,"Block 3015, Block Group 3, Census Tract 5085.03, Santa Clara County, California",61,60,1
1000000US060855085033016,060855085033016,"Block 3016, Block Group 3, Census Tract 5085.03, Santa Clara County, California",0,0,0
1000000US060855085033017,060855085033017,"Block 3017, Block Group 3, Census Tract 5085.03, Santa Clara County, California",146,142,4
1000000US060855085033018,060855085033018,"Block 3018, Block Group 3, Census Tract 5085.03, Santa Clara County, California",0,0,0
1000000US060855085033019,060855085033019,"Block 3019, Block Group 3, Census Tract 5085.03, Santa Clara County, California",0,0,0
1000000US060855085033020,060855085033020,"Block 3020, Block Group 3, Census Tract 5085.03, Santa Clara County, California",0,0,0
1000000US060855085033021,060855085033021,"Block 3021, Block Group 3, Census Tract 5085.03, Santa Clara County, California",55,54,1
1000000US060855085033022,060855085033022,"Block 3022, Block Group 3, Census Tract 5085.03, Santa Clara County, California",1,1,0
1000000US060855085033023,060855085033023,"Block 3023, Block Group 3, Census Tract 5085.03, Santa Clara County, California",55,54,1
1000000US060855085033024,060855085033024,"Block 3024, Block Group 3, Census Tract 5085.03, Santa Clara County, California",166,159,7
1000000US060855085033025,060855085033025,"Block 3025, Block Group 3, Census Tract 5085.03, Santa Clara County, California",11,10,1
1000000US060855085033026,060855085033026,"Block 3026, Block Group 3, Census Tract 5085.03, Santa Clara County, California",0,0,0
1000000US060855085033027,060855085033027,"Block 3027, Block Group 3, Census Tract 5085.03, Santa Clara County, California",0,0,0
1000000US060855085033028,060855085033028,"Block 3028, Block Group 3, Census Tract 5085.03, Santa Clara County, California",0,0,0
1000000US060855085033029,060855085033029,"Block 3029, Block Group 3, Census Tract 5085.03, Santa Clara County, California",0,0,0
1000000US060855085033030,060855085033030,"Block 3030, Block Group 3, Census Tract 5085.03, Santa Clara County, California",0,0,0
1000000US060855085033031,060855085033031,"Block 3031, Block Group 3, Census Tract 5085.03, Santa Clara County, California",0,0,0
1000000US060855085033032,060855085033032,"Block 3032, Block Group 3, Census Tract 5085.03, Santa Clara County, California",0,0,0
1000000US060855085033033,060855085033033,"Block 3033, Block Group 3, Census Tract 5085.03, Santa Clara County, California",18,18,0
1000000US060855085033034,060855085033034,"Block 3034, Block Group 3, Census Tract 5085.03, Santa Clara County, California",0,0,0
1000000US060855085033035,060855085033035,"Block 3035, Block Group 3, Census Tract 5085.03, Santa Clara County, California",41,41,0
1000000US060855085033036,060855085033036,"Block 3036, Block Group 3, Census Tract 5085.03, Santa Clara County, California",0,0,0
1000000US060855085033037,060855085033037,"Block 3037, Block Group 3, Census Tract 5085.03, Santa Clara County, California",0,0,0
1000000US060855085033038,060855085033038,"Block 3038, Block Group 3, Census Tract 5085.03, Santa Clara County, California",0,0,0
1000000US060855085033039,060855085033039,"Block 3039, Block Group 3, Census Tract 5085.03, Santa Clara County, California",0,0,0
1000000US060855085033040,060855085033040,"Block 3040, Block Group 3, Census Tract 5085.03, Santa Clara County, California",0,0,0
1000000US060855085033041,060855085033041,"Block 3041, Block Group 3, Census Tract 5085.03, Santa Clara County, California",0,0,0
1000000US060855085033042,060855085033042,"Block 3042, Block Group 3, Census Tract 5085.03, Santa Clara County, California",0,0,0
1000000US060855085033043,060855085033043,"Block 3043, Block Group 3, Census Tract 5085.03, Santa Clara County, California",21,18,3
1000000US060855085033044,060855085033044,"Block 3044, Block Group 3, Census Tract 5085.03, Santa Clara County, California",0,0,0
1000000US060855085033045,060855085033045,"Block 3045, Block Group 3, Census Tract 5085.03, Santa Clara County, California",13,13,0
1000000US060855085033046,060855085033046,"Block 3046, Block Group 3, Census Tract 5085.03, Santa Clara County, California",0,0,0
1000000US060855085033047,060855085033047,"Block 3047, Block Group 3, Census Tract 5085.03, Santa Clara County, California",0,0,0
1000000US060855085033048,060855085033048,"Block 3048, Block Group 3, Census Tract 5085.03, Santa Clara County, California",88,84,4
1000000US060855085041000,060855085041000,"Block 1000, Block Group 1, Census Tract 5085.04, Santa Clara County, California",311,292,19
1000000US060855085041001,060855085041001,"Block 1001, Block Group 1, Census Tract 5085.04, Santa Clara County, California",150,147,3
1000000US060855085041002,060855085041002,"Block 1002, Block Group 1, Census Tract 5085.04, Santa Clara County, California",0,0,0
1000000US060855085041003,060855085041003,"Block 1003, Block Group 1, Census Tract 5085.04, Santa Clara County, California",0,0,0
1000000US060855085041004,060855085041004,"Block 1004, Block Group 1, Census Tract 5085.04, Santa Clara County, California",0,0,0
1000000US060855085041005,060855085041005,"Block 1005, Block Group 1, Census Tract 5085.04, Santa Clara County, California",0,0,0
1000000US060855085041006,060855085041006,"Block 1006, Block Group 1, Census Tract 5085.04, Santa Clara County, California",0,0,0
1000000US060855085041007,060855085041007,"Block 1007, Block Group 1, Census Tract 5085.04, Santa Clara County, California",0,0,0
1000000US060855085041008,060855085041008,"Block 1008, Block Group 1, Census Tract 5085.04, Santa Clara County, California",0,0,0
1000000US060855085041009,060855085041009,"Block 1009, Block Group 1, Census Tract 5085.04, Santa Clara County, California",0,0,0
1000000US060855085041010,060855085041010,"Block 1010, Block Group 1, Census Tract 5085.04, Santa Clara County, California",0,0,0
1000000US060855085041011,060855085041011,"Block 1011, Block Group 1, Census Tract 5085.04, Santa Clara County, California",0,0,0
1000000US060855085041012,060855085041012,"Block 1012, Block Group 1, Census Tract 5085.04, Santa Clara County, California",0,0,0
1000000US060855085041013,060855085041013,"Block 1013, Block Group 1, Census Tract 5085.04, Santa Clara County, California",0,0,0
1000000US060855085041014,060855085041014,"Block 1014, Block Group 1, Census Tract 5085.04, Santa Clara County, California",208,206,2
1000000US060855085041015,060855085041015,"Block 1015, Block Group 1, Census Tract 5085.04, Santa Clara County, California",1,1,0
1000000US060855085041016,060855085041016,"Block 1016, Block Group 1, Census Tract 5085.04, Santa Clara County, California",0,0,0
1000000US060855085041017,060855085041017,"Block 1017, Block Group 1, Census Tract 5085.04, Santa Clara County, California",0,0,0
1000000US060855085041018,060855085041018,"Block 1018, Block Group 1, Census Tract 5085.04, Santa Clara County, California",0,0,0
1000000US060855085041019,060855085041019,"Block 1019, Block Group 1, Census Tract 5085.04, Santa Clara County, California",462,448,14
1000000US060855085042000,060855085042000,"Block 2000, Block Group 2, Census Tract 5085.04, Santa Clara County, California",0,0,0
1000000US060855085042001,060855085042001,"Block 2001, Block Group 2, Census Tract 5085.04, Santa Clara County, California",0,0,0
1000000US060855085042002,060855085042002,"Block 2002, Block Group 2, Census Tract 5085.04, Santa Clara County, California",0,0,0
1000000US060855085042003,060855085042003,"Block 2003, Block Group 2, Census Tract 5085.04, Santa Clara County, California",96,93,3
1000000US060855085042004,060855085042004,"Block 2004, Block Group 2, Census Tract 5085.04, Santa Clara County, California",268,258,10
1000000US060855085042005,060855085042005,"Block 2005, Block Group 2, Census Tract 5085.04, Santa Clara County, California",185,178,7
1000000US060855085042006,060855085042006,"Block 2006, Block Group 2, Census Tract 5085.04, Santa Clara County, California",110,106,4
1000000US060855085042007,060855085042007,"Block 2007, Block Group 2, Census Tract 5085.04, Santa Clara County, California",144,128,16
1000000US060855085042008,060855085042008,"Block 2008, Block Group 2, Census Tract 5085.04, Santa Clara County, California",36,34,2
1000000US060855085043000,060855085043000,"Block 3000, Block Group 3, Census Tract 5085.04, Santa Clara County, California",0,0,0
1000000US060855085043001,060855085043001,"Block 3001, Block Group 3, Census Tract 5085.04, Santa Clara County, California",133,129,4
1000000US060855085043002,060855085043002,"Block 3002, Block Group 3, Census Tract 5085.04, Santa Clara County, California",55,54,1
1000000US060855085043003,060855085043003,"Block 3003, Block Group 3, Census Tract 5085.04, Santa Clara County, California",19,19,0
1000000US060855085043004,060855085043004,"Block 3004, Block Group 3, Census Tract 5085.04, Santa Clara County, California",50,49,1
1000000US060855085043005,060855085043005,"Block 3005, Block Group 3, Census Tract 5085.04, Santa Clara County, California",120,113,7
1000000US060855085043006,060855085043006,"Block 3006, Block Group 3, Census Tract 5085.04, Santa Clara County, California",23,23,0
1000000US060855085043007,060855085043007,"Block 3007, Block Group 3, Census Tract 5085.04, Santa Clara County, California",0,0,0
1000000US060855085044000,060855085044000,"Block 4000, Block Group 4, Census Tract 5085.04, Santa Clara County, California",17,17,0
1000000US060855085044001,060855085044001,"Block 4001, Block Group 4, Census Tract 5085.04, Santa Clara County, California",20,19,1
1000000US060855085044002,060855085044002,"Block 4002, Block Group 4, Census Tract 5085.04, Santa Clara County, California",57,56,1
1000000US060855085044003,060855085044003,"Block 4003, Block Group 4, Census Tract 5085.04, Santa Clara County, California",36,35,1
1000000US060855085044004,060855085044004,"Block 4004, Block Group 4, Census Tract 5085.04, Santa Clara County, California",196,189,7
1000000US060855085044005,060855085044005,"Block 4005, Block Group 4, Census Tract 5085.04, Santa Clara County, California",57,55,2
1000000US060855085044006,060855085044006,"Block 4006, Block Group 4, Census Tract 5085.04, Santa Clara County, California",0,0,0
1000000US060855085044007,060855085044007,"Block 4007, Block Group 4, Census Tract 5085.04, Santa Clara County, California",1,1,0
1000000US060855085044008,060855085044008,"Block 4008, Block Group 4, Census Tract 5085.04, Santa Clara County, California",40,40,0
1000000US060855085044009,060855085044009,"Block 4009, Block Group 4, Census Tract 5085.04, Santa Clara County, California",32,32,0
1000000US060855085044010,060855085044010,"Block 4010, Block Group 4, Census Tract 5085.04, Santa Clara County, California",0,0,0
1000000US060855085044011,060855085044011,"Block 4011, Block Group 4, Census Tract 5085.04, Santa Clara County, California",47,44,3
1000000US060855085044012,060855085044012,"Block 4012, Block Group 4, Census Tract 5085.04, Santa Clara County, California",309,300,9
1000000US060855085044013,060855085044013,"Block 4013, Block Group 4, Census Tract 5085.04, Santa Clara County, California",6,6,0
1000000US060855085044014,060855085044014,"Block 4014, Block Group 4, Census Tract 5085.04, Santa Clara County, California",132,62,70
1000000US060855085044015,060855085044015,"Block 4015, Block Group 4, Census Tract 5085.04, Santa Clara County, California",0,0,0
1000000US060855085051000,060855085051000,"Block 1000, Block Group 1, Census Tract 5085.05, Santa Clara County, California",67,67,0
1000000US060855085051001,060855085051001,"Block 1001, Block Group 1, Census Tract 5085.05, Santa Clara County, California",89,88,1
1000000US060855085051002,060855085051002,"Block 1002, Block Group 1, Census Tract 5085.05, Santa Clara County, California",27,27,0
1000000US060855085051003,060855085051003,"Block 1003, Block Group 1, Census Tract 5085.05, Santa Clara County, California",57,56,1
1000000US060855085051004,060855085051004,"Block 1004, Block Group 1, Census Tract 5085.05, Santa Clara County, California",46,46,0
1000000US060855085051005,060855085051005,"Block 1005, Block Group 1, Census Tract 5085.05, Santa Clara County, California",29,27,2
1000000US060855085051006,060855085051006,"Block 1006, Block Group 1, Census Tract 5085.05, Santa Clara County, California",32,32,0
1000000US060855085051007,060855085051007,"Block 1007, Block Group 1, Census Tract 5085.05, Santa Clara County, California",27,26,1
1000000US060855085051008,060855085051008,"Block 1008, Block Group 1, Census Tract 5085.05, Santa Clara County, California",58,57,1
1000000US060855085052000,060855085052000,"Block 2000, Block Group 2, Census Tract 5085.05, Santa Clara County, California",33,32,1
1000000US060855085052001,060855085052001,"Block 2001, Block Group 2, Census Tract 5085.05, Santa Clara County, California",0,0,0
1000000US060855085052002,060855085052002,"Block 2002, Block Group 2, Census Tract 5085.05, Santa Clara County, California",0,0,0
1000000US060855085052003,060855085052003,"Block 2003, Block Group 2, Census Tract 5085.05, Santa Clara County, California",27,27,0
1000000US060855085052004,060855085052004,"Block 2004, Block Group 2, Census Tract 5085.05, Santa Clara County, California",44,43,1
1000000US060855085052005,060855085052005,"Block 2005, Block Group 2, Census Tract 5085.05, Santa Clara County, California",35,35,0
1000000US060855085052006,060855085052006,"Block 2006, Block Group 2, Census Tract 5085.05, Santa Clara County, California",34,34,0
1000000US060855085052007,060855085052007,"Block 2007, Block Group 2, Census Tract 5085.05, Santa Clara County, California",22,21,1
1000000US060855085052008,060855085052008,"Block 2008, Block Group 2, Census Tract 5085.05, Santa Clara County, California",312,262,50
1000000US060855085052009,060855085052009,"Block 2009, Block Group 2, Census Tract 5085.05, Santa Clara County, California",12,12,0
1000000US060855085052010,060855085052010,"Block 2010, Block Group 2, Census Tract 5085.05, Santa Clara County, California",1,1,0
1000000US060855085052011,060855085052011,"Block 2011, Block Group 2, Census Tract 5085.05, Santa Clara County, California",50,47,3
1000000US060855085053000,060855085053000,"Block 3000, Block Group 3, Census Tract 5085.05, Santa Clara County, California",275,259,16
1000000US060855085053001,060855085053001,"Block 3001, Block Group 3, Census Tract 5085.05, Santa Clara County, California",38,35,3
1000000US060855085053002,060855085053002,"Block 3002, Block Group 3, Census Tract 5085.05, Santa Clara County, California",95,93,2
1000000US060855085053003,060855085053003,"Block 3003, Block Group 3, Census Tract 5085.05, Santa Clara County, California",69,67,2
1000000US060855085053004,060855085053004,"Block 3004, Block Group 3, Census Tract 5085.05, Santa Clara County, California",414,384,30
1000000US060855085053005,060855085053005,"Block 3005, Block Group 3, Census Tract 5085.05, Santa Clara County, California",4,4,0
1000000US060855085053006,060855085053006,"Block 3006, Block Group 3, Census Tract 5085.05, Santa Clara County, California",1,1,0
1000000US060855085053007,060855085053007,"Block 3007, Block Group 3, Census Tract 5085.05, Santa Clara County, California",44,44,0
1000000US060855085053008,060855085053008,"Block 3008, Block Group 3, Census Tract 5085.05, Santa Clara County, California",82,79,3
1000000US060855085053009,060855085053009,"Block 3009, Block Group 3, Census Tract 5085.05, Santa Clara County, California",0,0,0
1000000US060855085053010,060855085053010,"Block 3010, Block Group 3, Census Tract 5085.05, Santa Clara County, California",0,0,0
1000000US060855085053011,060855085053011,"Block 3011, Block Group 3, Census Tract 5085.05, Santa Clara County, California",0,0,0
1000000US060855085071000,060855085071000,"Block 1000, Block Group 1, Census Tract 5085.07, Santa Clara County, California",112,108,4
1000000US060855085071001,060855085071001,"Block 1001, Block Group 1, Census Tract 5085.07, Santa Clara County, California",199,198,1
1000000US060855085071002,060855085071002,"Block 1002, Block Group 1, Census Tract 5085.07, Santa Clara County, California",146,142,4
1000000US060855085071003,060855085071003,"Block 1003, Block Group 1, Census Tract 5085.07, Santa Clara County, California",111,108,3
1000000US060855085071004,060855085071004,"Block 1004, Block Group 1, Census Tract 5085.07, Santa Clara County, California",0,0,0
1000000US060855085071005,060855085071005,"Block 1005, Block Group 1, Census Tract 5085.07, Santa Clara County, California",0,0,0
1000000US060855085071006,060855085071006,"Block 1006, Block Group 1, Census Tract 5085.07, Santa Clara County, California",118,112,6
1000000US060855085071007,060855085071007,"Block 1007, Block Group 1, Census Tract 5085.07, Santa Clara County, California",12,12,0
1000000US060855085071008,060855085071008,"Block 1008, Block Group 1, Census Tract 5085.07, Santa Clara County, California",6,6,0
1000000US060855085071009,060855085071009,"Block 1009, Block Group 1, Census Tract 5085.07, Santa Clara County, California",0,0,0
1000000US060855085071010,060855085071010,"Block 1010, Block Group 1, Census Tract 5085.07, Santa Clara County, California",1,1,0
1000000US060855085071011,060855085071011,"Block 1011, Block Group 1, Census Tract 5085.07, Santa Clara County, California",0,0,0
1000000US060855085072000,060855085072000,"Block 2000, Block Group 2, Census Tract 5085.07, Santa Clara County, California",0,0,0
1000000US060855085072001,060855085072001,"Block 2001, Block Group 2, Census Tract 5085.07, Santa Clara County, California",0,0,0
1000000US060855085072002,060855085072002,"Block 2002, Block Group 2, Census Tract 5085.07, Santa Clara County, California",1,1,0
1000000US060855085072003,060855085072003,"Block 2003, Block Group 2, Census Tract 5085.07, Santa Clara County, California",158,148,10
1000000US060855085072004,060855085072004,"Block 2004, Block Group 2, Census Tract 5085.07, Santa Clara County, California",0,0,0
1000000US060855085072005,060855085072005,"Block 2005, Block Group 2, Census Tract 5085.07, Santa Clara County, California",76,73,3
1000000US060855085072006,060855085072006,"Block 2006, Block Group 2, Census Tract 5085.07, Santa Clara County, California",343,334,9
1000000US060855085072007,060855085072007,"Block 2007, Block Group 2, Census Tract 5085.07, Santa Clara County, California",0,0,0
1000000US060855085072008,060855085072008,"Block 2008, Block Group 2, Census Tract 5085.07, Santa Clara County, California",0,0,0
1000000US060855085072009,060855085072009,"Block 2009, Block Group 2, Census Tract 5085.07, Santa Clara County, California",132,109,23
1000000US060855085081000,060855085081000,"Block 1000, Block Group 1, Census Tract 5085.08, Santa Clara County, California",0,0,0
1000000US060855085081001,060855085081001,"Block 1001, Block Group 1, Census Tract 5085.08, Santa Clara County, California",46,44,2
1000000US060855085081002,060855085081002,"Block 1002, Block Group 1, Census Tract 5085.08, Santa Clara County, California",40,40,0
1000000US060855085081003,060855085081003,"Block 1003, Block Group 1, Census Tract 5085.08, Santa Clara County, California",55,54,1
1000000US060855085081004,060855085081004,"Block 1004, Block Group 1, Census Tract 5085.08, Santa Clara County, California",42,42,0
1000000US060855085081005,060855085081005,"Block 1005, Block Group 1, Census Tract 5085.08, Santa Clara County, California",51,50,1
1000000US060855085081006,060855085081006,"Block 1006, Block Group 1, Census Tract 5085.08, Santa Clara County, California",45,44,1
1000000US060855085082000,060855085082000,"Block 2000, Block Group 2, Census Tract 5085.08, Santa Clara County, California",133,128,5
1000000US060855085082001,060855085082001,"Block 2001, Block Group 2, Census Tract 5085.08, Santa Clara County, California",22,20,2
1000000US060855085082002,060855085082002,"Block 2002, Block Group 2, Census Tract 5085.08, Santa Clara County, California",22,22,0
1000000US060855085082003,060855085082003,"Block 2003, Block Group 2, Census Tract 5085.08, Santa Clara County, California",0,0,0
1000000US060855085082004,060855085082004,"Block 2004, Block Group 2, Census Tract 5085.08, Santa Clara County, California",141,141,0
1000000US060855085082005,060855085082005,"Block 2005, Block Group 2, Census Tract 5085.08, Santa Clara County, California",81,81,0
1000000US060855085082006,060855085082006,"Block 2006, Block Group 2, Census Tract 5085.08, Santa Clara County, California",49,48,1
1000000US060855085083000,060855085083000,"Block 3000, Block Group 3, Census Tract 5085.08, Santa Clara County, California",677,621,56
1000000US060855085083001,060855085083001,"Block 3001, Block Group 3, Census Tract 5085.08, Santa Clara County, California",21,19,2
1000000US060855085083002,060855085083002,"Block 3002, Block Group 3, Census Tract 5085.08, Santa Clara County, California",15,10,5
1000000US060855085083003,060855085083003,"Block 3003, Block Group 3, Census Tract 5085.08, Santa Clara County, California",12,10,2
1000000US060855085083004,060855085083004,"Block 3004, Block Group 3, Census Tract 5085.08, Santa Clara County, California",11,9,2
1000000US060855085083005,060855085083005,"Block 3005, Block Group 3, Census Tract 5085.08, Santa Clara County, California",27,22,5
1000000US060855085083006,060855085083006,"Block 3006, Block Group 3, Census Tract 5085.08, Santa Clara County, California",13,12,1
1000000US060855085083007,060855085083007,"Block 3007, Block Group 3, Census Tract 5085.08, Santa Clara County, California",16,14,2
1000000US060855085083008,060855085083008,"Block 3008, Block Group 3, Census Tract 5085.08, Santa Clara County, California",30,22,8
1000000US060855085083009,060855085083009,"Block 3009, Block Group 3, Census Tract 5085.08, Santa Clara County, California",57,56,1
1000000US060855085083010,060855085083010,"Block 3010, Block Group 3, Census Tract 5085.08, Santa Clara County, California",11,11,0
1000000US060855085083011,060855085083011,"Block 3011, Block Group 3, Census Tract 5085.08, Santa Clara County, California",16,15,1
1000000US060855085083012,060855085083012,"Block 3012, Block Group 3, Census Tract 5085.08, Santa Clara County, California",15,13,2
1000000US060855085084000,060855085084000,"Block 4000, Block Group 4, Census Tract 5085.08, Santa Clara County, California",0,0,0
1000000US060855085084001,060855085084001,"Block 4001, Block Group 4, Census Tract 5085.08, Santa Clara County, California",0,0,0
1000000US060855085084002,060855085084002,"Block 4002, Block Group 4, Census Tract 5085.08, Santa Clara County, California",7,7,0
1000000US060855085084003,060855085084003,"Block 4003, Block Group 4, Census Tract 5085.08, Santa Clara County, California",49,46,3
1000000US060855085084004,060855085084004,"Block 4004, Block Group 4, Census Tract 5085.08, Santa Clara County, California",98,97,1
1000000US060855085084005,060855085084005,"Block 4005, Block Group 4, Census Tract 5085.08, Santa Clara County, California",27,26,1
1000000US060855085084006,060855085084006,"Block 4006, Block Group 4, Census Tract 5085.08, Santa Clara County, California",12,11,1
1000000US060855085084007,060855085084007,"Block 4007, Block Group 4, Census Tract 5085.08, Santa Clara County, California",18,14,4
1000000US060855085084008,060855085084008,"Block 4008, Block Group 4, Census Tract 5085.08, Santa Clara County, California",73,63,10
1000000US060855085084009,060855085084009,"Block 4009, Block Group 4, Census Tract 5085.08, Santa Clara County, California",65,60,5
1000000US060855086011000,060855086011000,"Block 1000, Block Group 1, Census Tract 5086.01, Santa Clara County, California",9,9,0
1000000US060855086011001,060855086011001,"Block 1001, Block Group 1, Census Tract 5086.01, Santa Clara County, California",49,46,3
1000000US060855086011002,060855086011002,"Block 1002, Block Group 1, Census Tract 5086.01, Santa Clara County, California",38,33,5
1000000US060855086011003,060855086011003,"Block 1003, Block Group 1, Census Tract 5086.01, Santa Clara County, California",37,31,6
1000000US060855086011004,060855086011004,"Block 1004, Block Group 1, Census Tract 5086.01, Santa Clara County, California",30,29,1
1000000US060855086011005,060855086011005,"Block 1005, Block Group 1, Census Tract 5086.01, Santa Clara County, California",35,35,0
1000000US060855086011006,060855086011006,"Block 1006, Block Group 1, Census Tract 5086.01, Santa Clara County, California",42,41,1
1000000US060855086011007,060855086011007,"Block 1007, Block Group 1, Census Tract 5086.01, Santa Clara County, California",12,11,1
1000000US060855086011008,060855086011008,"Block 1008, Block Group 1, Census Tract 5086.01, Santa Clara County, California",2,2,0
1000000US060855086011009,060855086011009,"Block 1009, Block Group 1, Census Tract 5086.01, Santa Clara County, California",26,26,0
1000000US060855086011010,060855086011010,"Block 1010, Block Group 1, Census Tract 5086.01, Santa Clara County, California",0,0,0
1000000US060855086011011,060855086011011,"Block 1011, Block Group 1, Census Tract 5086.01, Santa Clara County, California",0,0,0
1000000US060855086011012,060855086011012,"Block 1012, Block Group 1, Census Tract 5086.01, Santa Clara County, California",0,0,0
1000000US060855086011013,060855086011013,"Block 1013, Block Group 1, Census Tract 5086.01, Santa Clara County, California",0,0,0
1000000US060855086011014,060855086011014,"Block 1014, Block Group 1, Census Tract 5086.01, Santa Clara County, California",0,0,0
1000000US060855086011015,060855086011015,"Block 1015, Block Group 1, Census Tract 5086.01, Santa Clara County, California",0,0,0
1000000US060855086011016,060855086011016,"Block 1016, Block Group 1, Census Tract 5086.01, Santa Clara County, California",0,0,0
1000000US060855086011017,060855086011017,"Block 1017, Block Group 1, Census Tract 5086.01, Santa Clara County, California",0,0,0
1000000US060855086012000,060855086012000,"Block 2000, Block Group 2, Census Tract 5086.01, Santa Clara County, California",0,0,0
1000000US060855086012001,060855086012001,"Block 2001, Block Group 2, Census Tract 5086.01, Santa Clara County, California",49,47,2
1000000US060855086012002,060855086012002,"Block 2002, Block Group 2, Census Tract 5086.01, Santa Clara County, California",43,43,0
1000000US060855086012003,060855086012003,"Block 2003, Block Group 2, Census Tract 5086.01, Santa Clara County, California",25,24,1
1000000US060855086012004,060855086012004,"Block 2004, Block Group 2, Census Tract 5086.01, Santa Clara County, California",18,18,0
1000000US060855086012005,060855086012005,"Block 2005, Block Group 2, Census Tract 5086.01, Santa Clara County, California",37,37,0
1000000US060855086012006,060855086012006,"Block 2006, Block Group 2, Census Tract 5086.01, Santa Clara County, California",24,24,0
1000000US060855086012007,060855086012007,"Block 2007, Block Group 2, Census Tract 5086.01, Santa Clara County, California",41,41,0
1000000US060855086012008,060855086012008,"Block 2008, Block Group 2, Census Tract 5086.01, Santa Clara County, California",56,54,2
1000000US060855086012009,060855086012009,"Block 2009, Block Group 2, Census Tract 5086.01, Santa Clara County, California",14,14,0
1000000US060855086012010,060855086012010,"Block 2010, Block Group 2, Census Tract 5086.01, Santa Clara County, California",14,14,0
1000000US060855086012011,060855086012011,"Block 2011, Block Group 2, Census Tract 5086.01, Santa Clara County, California",27,27,0
1000000US060855086012012,060855086012012,"Block 2012, Block Group 2, Census Tract 5086.01, Santa Clara County, California",27,25,2
1000000US060855086012013,060855086012013,"Block 2013, Block Group 2, Census Tract 5086.01, Santa Clara County, California",26,26,0
1000000US060855086012014,060855086012014,"Block 2014, Block Group 2, Census Tract 5086.01, Santa Clara County, California",26,24,2
1000000US060855086012015,060855086012015,"Block 2015, Block Group 2, Census Tract 5086.01, Santa Clara County, California",26,23,3
1000000US060855086012016,060855086012016,"Block 2016, Block Group 2, Census Tract 5086.01, Santa Clara County, California",26,26,0
1000000US060855086012017,060855086012017,"Block 2017, Block Group 2, Census Tract 5086.01, Santa Clara County, California",25,22,3
1000000US060855086012018,060855086012018,"Block 2018, Block Group 2, Census Tract 5086.01, Santa Clara County, California",29,29,0
1000000US060855086012019,060855086012019,"Block 2019, Block Group 2, Census Tract 5086.01, Santa Clara County, California",0,0,0
1000000US060855086012020,060855086012020,"Block 2020, Block Group 2, Census Tract 5086.01, Santa Clara County, California",0,0,0
1000000US060855086012021,060855086012021,"Block 2021, Block Group 2, Census Tract 5086.01, Santa Clara County, California",37,37,0
1000000US060855086012022,060855086012022,"Block 2022, Block Group 2, Census Tract 5086.01, Santa Clara County, California",25,25,0
1000000US060855086012023,060855086012023,"Block 2023, Block Group 2, Census Tract 5086.01, Santa Clara County, California",0,0,0
1000000US060855086013000,060855086013000,"Block 3000, Block Group 3, Census Tract 5086.01, Santa Clara County, California",0,0,0
1000000US060855086013001,060855086013001,"Block 3001, Block Group 3, Census Tract 5086.01, Santa Clara County, California",0,0,0
1000000US060855086013002,060855086013002,"Block 3002, Block Group 3, Census Tract 5086.01, Santa Clara County, California",26,24,2
1000000US060855086013003,060855086013003,"Block 3003, Block Group 3, Census Tract 5086.01, Santa Clara County, California",0,0,0
1000000US060855086013004,060855086013004,"Block 3004, Block Group 3, Census Tract 5086.01, Santa Clara County, California",45,43,2
1000000US060855086013005,060855086013005,"Block 3005, Block Group 3, Census Tract 5086.01, Santa Clara County, California",51,50,1
1000000US060855086013006,060855086013006,"Block 3006, Block Group 3, Census Tract 5086.01, Santa Clara County, California",54,50,4
1000000US060855086013007,060855086013007,"Block 3007, Block Group 3, Census Tract 5086.01, Santa Clara County, California",47,47,0
1000000US060855086013008,060855086013008,"Block 3008, Block Group 3, Census Tract 5086.01, Santa Clara County, California",26,25,1
1000000US060855086013009,060855086013009,"Block 3009, Block Group 3, Census Tract 5086.01, Santa Clara County, California",40,40,0
1000000US060855086013010,060855086013010,"Block 3010, Block Group 3, Census Tract 5086.01, Santa Clara County, California",32,32,0
1000000US060855086013011,060855086013011,"Block 3011, Block Group 3, Census Tract 5086.01, Santa Clara County, California",36,35,1
1000000US060855086013012,060855086013012,"Block 3012, Block Group 3, Census Tract 5086.01, Santa Clara County, California",56,54,2
1000000US060855086013013,060855086013013,"Block 3013, Block Group 3, Census Tract 5086.01, Santa Clara County, California",61,55,6
1000000US060855086013014,060855086013014,"Block 3014, Block Group 3, Census Tract 5086.01, Santa Clara County, California",66,63,3
1000000US060855086021000,060855086021000,"Block 1000, Block Group 1, Census Tract 5086.02, Santa Clara County, California",124,116,8
1000000US060855086021001,060855086021001,"Block 1001, Block Group 1, Census Tract 5086.02, Santa Clara County, California",4,3,1
1000000US060855086021002,060855086021002,"Block 1002, Block Group 1, Census Tract 5086.02, Santa Clara County, California",0,0,0
1000000US060855086021003,060855086021003,"Block 1003, Block Group 1, Census Tract 5086.02, Santa Clara County, California",0,0,0
1000000US060855086021004,060855086021004,"Block 1004, Block Group 1, Census Tract 5086.02, Santa Clara County, California",0,0,0
1000000US060855086021005,060855086021005,"Block 1005, Block Group 1, Census Tract 5086.02, Santa Clara County, California",0,0,0
1000000US060855086021006,060855086021006,"Block 1006, Block Group 1, Census Tract 5086.02, Santa Clara County, California",0,0,0
1000000US060855086021007,060855086021007,"Block 1007, Block Group 1, Census Tract 5086.02, Santa Clara County, California",0,0,0
1000000US060855086021008,060855086021008,"Block 1008, Block Group 1, Census Tract 5086.02, Santa Clara County, California",0,0,0
1000000US060855086021009,060855086021009,"Block 1009, Block Group 1, Census Tract 5086.02, Santa Clara County, California",20,19,1
1000000US060855086021010,060855086021010,"Block 1010, Block Group 1, Census Tract 5086.02, Santa Clara County, California",0,0,0
1000000US060855086021011,060855086021011,"Block 1011, Block Group 1, Census Tract 5086.02, Santa Clara County, California",0,0,0
1000000US060855086021012,060855086021012,"Block 1012, Block Group 1, Census Tract 5086.02, Santa Clara County, California",0,0,0
1000000US060855086021013,060855086021013,"Block 1013, Block Group 1, Census Tract 5086.02, Santa Clara County, California",0,0,0
1000000US060855086021014,060855086021014,"Block 1014, Block Group 1, Census Tract 5086.02, Santa Clara County, California",0,0,0
1000000US060855086021015,060855086021015,"Block 1015, Block Group 1, Census Tract 5086.02, Santa Clara County, California",0,0,0
1000000US060855086021016,060855086021016,"Block 1016, Block Group 1, Census Tract 5086.02, Santa Clara County, California",2,2,0
1000000US060855086021017,060855086021017,"Block 1017, Block Group 1, Census Tract 5086.02, Santa Clara County, California",0,0,0
1000000US060855086021018,060855086021018,"Block 1018, Block Group 1, Census Tract 5086.02, Santa Clara County, California",2,2,0
1000000US060855086021019,060855086021019,"Block 1019, Block Group 1, Census Tract 5086.02, Santa Clara County, California",17,6,11
1000000US060855086021020,060855086021020,"Block 1020, Block Group 1, Census Tract 5086.02, Santa Clara County, California",0,0,0
1000000US060855086021021,060855086021021,"Block 1021, Block Group 1, Census Tract 5086.02, Santa Clara County, California",0,0,0
1000000US060855086021022,060855086021022,"Block 1022, Block Group 1, Census Tract 5086.02, Santa Clara County, California",184,173,11
1000000US060855086021023,060855086021023,"Block 1023, Block Group 1, Census Tract 5086.02, Santa Clara County, California",70,67,3
1000000US060855086021024,060855086021024,"Block 1024, Block Group 1, Census Tract 5086.02, Santa Clara County, California",69,67,2
1000000US060855086021025,060855086021025,"Block 1025, Block Group 1, Census Tract 5086.02, Santa Clara County, California",101,101,0
1000000US060855086021026,060855086021026,"Block 1026, Block Group 1, Census Tract 5086.02, Santa Clara County, California",0,0,0
1000000US060855086021027,060855086021027,"Block 1027, Block Group 1, Census Tract 5086.02, Santa Clara County, California",0,0,0
1000000US060855086021028,060855086021028,"Block 1028, Block Group 1, Census Tract 5086.02, Santa Clara County, California",0,0,0
1000000US060855086021029,060855086021029,"Block 1029, Block Group 1, Census Tract 5086.02, Santa Clara County, California",0,0,0
1000000US060855086021030,060855086021030,"Block 1030, Block Group 1, Census Tract 5086.02, Santa Clara County, California",0,0,0
1000000US060855086021031,060855086021031,"Block 1031, Block Group 1, Census Tract 5086.02, Santa Clara County, California",0,0,0
1000000US060855086021032,060855086021032,"Block 1032, Block Group 1, Census Tract 5086.02, Santa Clara County, California",0,0,0
1000000US060855086021033,060855086021033,"Block 1033, Block Group 1, Census Tract 5086.02, Santa Clara County, California",0,0,0
1000000US060855086021034,060855086021034,"Block 1034, Block Group 1, Census Tract 5086.02, Santa Clara County, California",57,55,2
1000000US060855086021035,060855086021035,"Block 1035, Block Group 1, Census Tract 5086.02, Santa Clara County, California",41,38,3
1000000US060855086021036,060855086021036,"Block 1036, Block Group 1, Census Tract 5086.02, Santa Clara County, California",38,37,1
1000000US060855086021037,060855086021037,"Block 1037, Block Group 1, Census Tract 5086.02, Santa Clara County, California",276,259,17
1000000US060855086021038,060855086021038,"Block 1038, Block Group 1, Census Tract 5086.02, Santa Clara County, California",0,0,0
1000000US060855086021039,060855086021039,"Block 1039, Block Group 1, Census Tract 5086.02, Santa Clara County, California",13,12,1
1000000US060855086021040,060855086021040,"Block 1040, Block Group 1, Census Tract 5086.02, Santa Clara County, California",0,0,0
1000000US060855086021041,060855086021041,"Block 1041, Block Group 1, Census Tract 5086.02, Santa Clara County, California",0,0,0
1000000US060855086021042,060855086021042,"Block 1042, Block Group 1, Census Tract 5086.02, Santa Clara County, California",21,21,0
1000000US060855086021043,060855086021043,"Block 1043, Block Group 1, Census Tract 5086.02, Santa Clara County, California",20,20,0
1000000US060855086021044,060855086021044,"Block 1044, Block Group 1, Census Tract 5086.02, Santa Clara County, California",26,26,0
1000000US060855086021045,060855086021045,"Block 1045, Block Group 1, Census Tract 5086.02, Santa Clara County, California",0,0,0
1000000US060855086022000,060855086022000,"Block 2000, Block Group 2, Census Tract 5086.02, Santa Clara County, California",0,0,0
1000000US060855086022001,060855086022001,"Block 2001, Block Group 2, Census Tract 5086.02, Santa Clara County, California",70,68,2
1000000US060855086022002,060855086022002,"Block 2002, Block Group 2, Census Tract 5086.02, Santa Clara County, California",20,18,2
1000000US060855086022003,060855086022003,"Block 2003, Block Group 2, Census Tract 5086.02, Santa Clara County, California",30,29,1
1000000US060855086022004,060855086022004,"Block 2004, Block Group 2, Census Tract 5086.02, Santa Clara County, California",56,52,4
1000000US060855086022005,060855086022005,"Block 2005, Block Group 2, Census Tract 5086.02, Santa Clara County, California",33,32,1
1000000US060855086022006,060855086022006,"Block 2006, Block Group 2, Census Tract 5086.02, Santa Clara County, California",46,40,6
1000000US060855086022007,060855086022007,"Block 2007, Block Group 2, Census Tract 5086.02, Santa Clara County, California",3,3,0
1000000US060855086022008,060855086022008,"Block 2008, Block Group 2, Census Tract 5086.02, Santa Clara County, California",29,29,0
1000000US060855086022009,060855086022009,"Block 2009, Block Group 2, Census Tract 5086.02, Santa Clara County, California",28,27,1
1000000US060855086022010,060855086022010,"Block 2010, Block Group 2, Census Tract 5086.02, Santa Clara County, California",40,40,0
1000000US060855086022011,060855086022011,"Block 2011, Block Group 2, Census Tract 5086.02, Santa Clara County, California",20,20,0
1000000US060855086022012,060855086022012,"Block 2012, Block Group 2, Census Tract 5086.02, Santa Clara County, California",33,32,1
1000000US060855086022013,060855086022013,"Block 2013, Block Group 2, Census Tract 5086.02, Santa Clara County, California",0,0,0
1000000US060855086022014,060855086022014,"Block 2014, Block Group 2, Census Tract 5086.02, Santa Clara County, California",0,0,0
1000000US060855086022015,060855086022015,"Block 2015, Block Group 2, Census Tract 5086.02, Santa Clara County, California",23,21,2
1000000US060855086022016,060855086022016,"Block 2016, Block Group 2, Census Tract 5086.02, Santa Clara County, California",16,16,0
1000000US060855086022017,060855086022017,"Block 2017, Block Group 2, Census Tract 5086.02, Santa Clara County, California",20,19,1
1000000US060855086022018,060855086022018,"Block 2018, Block Group 2, Census Tract 5086.02, Santa Clara County, California",0,0,0
1000000US060855086023000,060855086023000,"Block 3000, Block Group 3, Census Tract 5086.02, Santa Clara County, California",30,27,3
1000000US060855086023001,060855086023001,"Block 3001, Block Group 3, Census Tract 5086.02, Santa Clara County, California",35,33,2
1000000US060855086023002,060855086023002,"Block 3002, Block Group 3, Census Tract 5086.02, Santa Clara County, California",0,0,0
1000000US060855086023003,060855086023003,"Block 3003, Block Group 3, Census Tract 5086.02, Santa Clara County, California",0,0,0
1000000US060855086023004,060855086023004,"Block 3004, Block Group 3, Census Tract 5086.02, Santa Clara County, California",0,0,0
1000000US060855086023005,060855086023005,"Block 3005, Block Group 3, Census Tract 5086.02, Santa Clara County, California",0,0,0
1000000US060855086023006,060855086023006,"Block 3006, Block Group 3, Census Tract 5086.02, Santa Clara County, California",0,0,0
1000000US060855086023007,060855086023007,"Block 3007, Block Group 3, Census Tract 5086.02, Santa Clara County, California",5,5,0
1000000US060855086023008,060855086023008,"Block 3008, Block Group 3, Census Tract 5086.02, Santa Clara County, California",53,52,1
1000000US060855086023009,060855086023009,"Block 3009, Block Group 3, Census Tract 5086.02, Santa Clara County, California",32,32,0
1000000US060855086023010,060855086023010,"Block 3010, Block Group 3, Census Tract 5086.02, Santa Clara County, California",100,94,6
1000000US060855086023011,060855086023011,"Block 3011, Block Group 3, Census Tract 5086.02, Santa Clara County, California",0,0,0
1000000US060855086023012,060855086023012,"Block 3012, Block Group 3, Census Tract 5086.02, Santa Clara County, California",0,0,0
1000000US060855086023013,060855086023013,"Block 3013, Block Group 3, Census Tract 5086.02, Santa Clara County, California",0,0,0
1000000US060855086023014,060855086023014,"Block 3014, Block Group 3, Census Tract 5086.02, Santa Clara County, California",27,27,0
1000000US060855086023015,060855086023015,"Block 3015, Block Group 3, Census Tract 5086.02, Santa Clara County, California",16,16,0
1000000US060855086023016,060855086023016,"Block 3016, Block Group 3, Census Tract 5086.02, Santa Clara County, California",0,0,0
1000000US060855087031000,060855087031000,"Block 1000, Block Group 1, Census Tract 5087.03, Santa Clara County, California",17,17,0
1000000US060855087031001,060855087031001,"Block 1001, Block Group 1, Census Tract 5087.03, Santa Clara County, California",38,38,0
1000000US060855087031002,060855087031002,"Block 1002, Block Group 1, Census Tract 5087.03, Santa Clara County, California",16,14,2
1000000US060855087031003,060855087031003,"Block 1003, Block Group 1, Census Tract 5087.03, Santa Clara County, California",190,186,4
1000000US060855087031004,060855087031004,"Block 1004, Block Group 1, Census Tract 5087.03, Santa Clara County, California",0,0,0
1000000US060855087031005,060855087031005,"Block 1005, Block Group 1, Census Tract 5087.03, Santa Clara County, California",0,0,0
1000000US060855087031006,060855087031006,"Block 1006, Block Group 1, Census Tract 5087.03, Santa Clara County, California",60,55,5
1000000US060855087031007,060855087031007,"Block 1007, Block Group 1, Census Tract 5087.03, Santa Clara County, California",53,52,1
1000000US060855087031008,060855087031008,"Block 1008, Block Group 1, Census Tract 5087.03, Santa Clara County, California",86,81,5
1000000US060855087032000,060855087032000,"Block 2000, Block Group 2, Census Tract 5087.03, Santa Clara County, California",0,0,0
1000000US060855087032001,060855087032001,"Block 2001, Block Group 2, Census Tract 5087.03, Santa Clara County, California",308,295,13
1000000US060855087032002,060855087032002,"Block 2002, Block Group 2, Census Tract 5087.03, Santa Clara County, California",0,0,0
1000000US060855087032003,060855087032003,"Block 2003, Block Group 2, Census Tract 5087.03, Santa Clara County, California",330,296,34
1000000US060855087032004,060855087032004,"Block 2004, Block Group 2, Census Tract 5087.03, Santa Clara County, California",0,0,0
1000000US060855087032005,060855087032005,"Block 2005, Block Group 2, Census Tract 5087.03, Santa Clara County, California",0,0,0
1000000US060855087032006,060855087032006,"Block 2006, Block Group 2, Census Tract 5087.03, Santa Clara County, California",0,0,0
1000000US060855087032007,060855087032007,"Block 2007, Block Group 2, Census Tract 5087.03, Santa Clara County, California",88,79,9
1000000US060855087032008,060855087032008,"Block 2008, Block Group 2, Census Tract 5087.03, Santa Clara County, California",0,0,0
1000000US060855087032009,060855087032009,"Block 2009, Block Group 2, Census Tract 5087.03, Santa Clara County, California",0,0,0
1000000US060855087033000,060855087033000,"Block 3000, Block Group 3, Census Tract 5087.03, Santa Clara County, California",52,52,0
1000000US060855087033001,060855087033001,"Block 3001, Block Group 3, Census Tract 5087.03, Santa Clara County, California",24,22,2
1000000US060855087033002,060855087033002,"Block 3002, Block Group 3, Census Tract 5087.03, Santa Clara County, California",37,31,6
1000000US060855087033003,060855087033003,"Block 3003, Block Group 3, Census Tract 5087.03, Santa Clara County, California",35,34,1
1000000US060855087033004,060855087033004,"Block 3004, Block Group 3, Census Tract 5087.03, Santa Clara County, California",10,10,0
1000000US060855087033005,060855087033005,"Block 3005, Block Group 3, Census Tract 5087.03, Santa Clara County, California",18,18,0
1000000US060855087033006,060855087033006,"Block 3006, Block Group 3, Census Tract 5087.03, Santa Clara County, California",9,9,0
1000000US060855087033007,060855087033007,"Block 3007, Block Group 3, Census Tract 5087.03, Santa Clara County, California",59,58,1
1000000US060855087033008,060855087033008,"Block 3008, Block Group 3, Census Tract 5087.03, Santa Clara County, California",36,36,0
1000000US060855087033009,060855087033009,"Block 3009, Block Group 3, Census Tract 5087.03, Santa Clara County, California",26,26,0
1000000US060855087033010,060855087033010,"Block 3010, Block Group 3, Census Tract 5087.03, Santa Clara County, California",51,49,2
1000000US060855087033011,060855087033011,"Block 3011, Block Group 3, Census Tract 5087.03, Santa Clara County, California",21,20,1
1000000US060855087033012,060855087033012,"Block 3012, Block Group 3, Census Tract 5087.03, Santa Clara County, California",31,30,1
1000000US060855087034000,060855087034000,"Block 4000, Block Group 4, Census Tract 5087.03, Santa Clara County, California",0,0,0
1000000US060855087034001,060855087034001,"Block 4001, Block Group 4, Census Tract 5087.03, Santa Clara County, California",0,0,0
1000000US060855087034002,060855087034002,"Block 4002, Block Group 4, Census Tract 5087.03, Santa Clara County, California",42,34,8
1000000US060855087034003,060855087034003,"Block 4003, Block Group 4, Census Tract 5087.03, Santa Clara County, California",10,0,10
1000000US060855087034004,060855087034004,"Block 4004, Block Group 4, Census Tract 5087.03, Santa Clara County, California",12,1,11
1000000US060855087034005,060855087034005,"Block 4005, Block Group 4, Census Tract 5087.03, Santa Clara County, California",12,12,0
1000000US060855087034006,060855087034006,"Block 4006, Block Group 4, Census Tract 5087.03, Santa Clara County, California",16,16,0
1000000US060855087034007,060855087034007,"Block 4007, Block Group 4, Census Tract 5087.03, Santa Clara County, California",10,10,0
1000000US060855087034008,060855087034008,"Block 4008, Block Group 4, Census Tract 5087.03, Santa Clara County, California",10,10,0
1000000US060855087034009,060855087034009,"Block 4009, Block Group 4, Census Tract 5087.03, Santa Clara County, California",99,98,1
1000000US060855087034010,060855087034010,"Block 4010, Block Group 4, Census Tract 5087.03, Santa Clara County, California",0,0,0
1000000US060855087034011,060855087034011,"Block 4011, Block Group 4, Census Tract 5087.03, Santa Clara County, California",95,92,3
1000000US060855087034012,060855087034012,"Block 4012, Block Group 4, Census Tract 5087.03, Santa Clara County, California",56,54,2
1000000US060855087034013,060855087034013,"Block 4013, Block Group 4, Census Tract 5087.03, Santa Clara County, California",48,46,2
1000000US060855087034014,060855087034014,"Block 4014, Block Group 4, Census Tract 5087.03, Santa Clara County, California",0,0,0
1000000US060855087034015,060855087034015,"Block 4015, Block Group 4, Census Tract 5087.03, Santa Clara County, California",80,75,5
1000000US060855087035000,060855087035000,"Block 5000, Block Group 5, Census Tract 5087.03, Santa Clara County, California",0,0,0
1000000US060855087035001,060855087035001,"Block 5001, Block Group 5, Census Tract 5087.03, Santa Clara County, California",0,0,0
1000000US060855087035002,060855087035002,"Block 5002, Block Group 5, Census Tract 5087.03, Santa Clara County, California",1,1,0
1000000US060855087035003,060855087035003,"Block 5003, Block Group 5, Census Tract 5087.03, Santa Clara County, California",0,0,0
1000000US060855087035004,060855087035004,"Block 5004, Block Group 5, Census Tract 5087.03, Santa Clara County, California",283,269,14
1000000US060855087035005,060855087035005,"Block 5005, Block Group 5, Census Tract 5087.03, Santa Clara County, California",0,0,0
1000000US060855087035006,060855087035006,"Block 5006, Block Group 5, Census Tract 5087.03, Santa Clara County, California",275,267,8
1000000US060855087035007,060855087035007,"Block 5007, Block Group 5, Census Tract 5087.03, Santa Clara County, California",36,34,2
1000000US060855087035008,060855087035008,"Block 5008, Block Group 5, Census Tract 5087.03, Santa Clara County, California",54,53,1
1000000US060855087035009,060855087035009,"Block 5009, Block Group 5, Census Tract 5087.03, Santa Clara County, California",28,27,1
1000000US060855087035010,060855087035010,"Block 5010, Block Group 5, Census Tract 5087.03, Santa Clara County, California",55,47,8
1000000US060855087035011,060855087035011,"Block 5011, Block Group 5, Census Tract 5087.03, Santa Clara County, California",28,27,1
1000000US060855087035012,060855087035012,"Block 5012, Block Group 5, Census Tract 5087.03, Santa Clara County, California",107,102,5
1000000US060855087035013,060855087035013,"Block 5013, Block Group 5, Census Tract 5087.03, Santa Clara County, California",0,0,0
1000000US060855087035014,060855087035014,"Block 5014, Block Group 5, Census Tract 5087.03, Santa Clara County, California",0,0,0
1000000US060855087035015,060855087035015,"Block 5015, Block Group 5, Census Tract 5087.03, Santa Clara County, California",215,210,5
1000000US060855087035016,060855087035016,"Block 5016, Block Group 5, Census Tract 5087.03, Santa Clara County, California",0,0,0
1000000US060855087035017,060855087035017,"Block 5017, Block Group 5, Census Tract 5087.03, Santa Clara County, California",0,0,0
1000000US060855087035018,060855087035018,"Block 5018, Block Group 5, Census Tract 5087.03, Santa Clara County, California",0,0,0
1000000US060855087041000,060855087041000,"Block 1000, Block Group 1, Census Tract 5087.04, Santa Clara County, California",31,31,0
1000000US060855087041001,060855087041001,"Block 1001, Block Group 1, Census Tract 5087.04, Santa Clara County, California",245,239,6
1000000US060855087041002,060855087041002,"Block 1002, Block Group 1, Census Tract 5087.04, Santa Clara County, California",0,0,0
1000000US060855087041003,060855087041003,"Block 1003, Block Group 1, Census Tract 5087.04, Santa Clara County, California",111,105,6
1000000US060855087041004,060855087041004,"Block 1004, Block Group 1, Census Tract 5087.04, Santa Clara County, California",113,103,10
1000000US060855087041005,060855087041005,"Block 1005, Block Group 1, Census Tract 5087.04, Santa Clara County, California",0,0,0
1000000US060855087041006,060855087041006,"Block 1006, Block Group 1, Census Tract 5087.04, Santa Clara County, California",0,0,0
1000000US060855087041007,060855087041007,"Block 1007, Block Group 1, Census Tract 5087.04, Santa Clara County, California",0,0,0
1000000US060855087041008,060855087041008,"Block 1008, Block Group 1, Census Tract 5087.04, Santa Clara County, California",98,89,9
1000000US060855087041009,060855087041009,"Block 1009, Block Group 1, Census Tract 5087.04, Santa Clara County, California",0,0,0
1000000US060855087041010,060855087041010,"Block 1010, Block Group 1, Census Tract 5087.04, Santa Clara County, California",31,31,0
1000000US060855087041011,060855087041011,"Block 1011, Block Group 1, Census Tract 5087.04, Santa Clara County, California",69,63,6
1000000US060855087041012,060855087041012,"Block 1012, Block Group 1, Census Tract 5087.04, Santa Clara County, California",28,23,5
1000000US060855087041013,060855087041013,"Block 1013, Block Group 1, Census Tract 5087.04, Santa Clara County, California",16,16,0
1000000US060855087041014,060855087041014,"Block 1014, Block Group 1, Census Tract 5087.04, Santa Clara County, California",26,25,1
1000000US060855087041015,060855087041015,"Block 1015, Block Group 1, Census Tract 5087.04, Santa Clara County, California",38,36,2
1000000US060855087041016,060855087041016,"Block 1016, Block Group 1, Census Tract 5087.04, Santa Clara County, California",0,0,0
1000000US060855087042000,060855087042000,"Block 2000, Block Group 2, Census Tract 5087.04, Santa Clara County, California",0,0,0
1000000US060855087042001,060855087042001,"Block 2001, Block Group 2, Census Tract 5087.04, Santa Clara County, California",0,0,0
1000000US060855087042002,060855087042002,"Block 2002, Block Group 2, Census Tract 5087.04, Santa Clara County, California",14,0,14
1000000US060855087042003,060855087042003,"Block 2003, Block Group 2, Census Tract 5087.04, Santa Clara County, California",0,0,0
1000000US060855087042004,060855087042004,"Block 2004, Block Group 2, Census Tract 5087.04, Santa Clara County, California",0,0,0
1000000US060855087042005,060855087042005,"Block 2005, Block Group 2, Census Tract 5087.04, Santa Clara County, California",0,0,0
1000000US060855087042006,060855087042006,"Block 2006, Block Group 2, Census Tract 5087.04, Santa Clara County, California",0,0,0
1000000US060855087042007,060855087042007,"Block 2007, Block Group 2, Census Tract 5087.04, Santa Clara County, California",0,0,0
1000000US060855087042008,060855087042008,"Block 2008, Block Group 2, Census Tract 5087.04, Santa Clara County, California",49,47,2
1000000US060855087042009,060855087042009,"Block 2009, Block Group 2, Census Tract 5087.04, Santa Clara County, California",0,0,0
1000000US060855087042010,060855087042010,"Block 2010, Block Group 2, Census Tract 5087.04, Santa Clara County, California",0,0,0
1000000US060855087042011,060855087042011,"Block 2011, Block Group 2, Census Tract 5087.04, Santa Clara County, California",0,0,0
1000000US060855087042012,060855087042012,"Block 2012, Block Group 2, Census Tract 5087.04, Santa Clara County, California",23,22,1
1000000US060855087042013,060855087042013,"Block 2013, Block Group 2, Census Tract 5087.04, Santa Clara County, California",0,0,0
1000000US060855087042014,060855087042014,"Block 2014, Block Group 2, Census Tract 5087.04, Santa Clara County, California",0,0,0
1000000US060855087042015,060855087042015,"Block 2015, Block Group 2, Census Tract 5087.04, Santa Clara County, California",0,0,0
1000000US060855087042016,060855087042016,"Block 2016, Block Group 2, Census Tract 5087.04, Santa Clara County, California",0,0,0
1000000US060855087042017,060855087042017,"Block 2017, Block Group 2, Census Tract 5087.04, Santa Clara County, California",0,0,0
1000000US060855087042018,060855087042018,"Block 2018, Block Group 2, Census Tract 5087.04, Santa Clara County, California",0,0,0
1000000US060855087042019,060855087042019,"Block 2019, Block Group 2, Census Tract 5087.04, Santa Clara County, California",0,0,0
1000000US060855087042020,060855087042020,"Block 2020, Block Group 2, Census Tract 5087.04, Santa Clara County, California",0,0,0
1000000US060855087042021,060855087042021,"Block 2021, Block Group 2, Census Tract 5087.04, Santa Clara County, California",13,13,0
1000000US060855087042022,060855087042022,"Block 2022, Block Group 2, Census Tract 5087.04, Santa Clara County, California",0,0,0
1000000US060855087042023,060855087042023,"Block 2023, Block Group 2, Census Tract 5087.04, Santa Clara County, California",0,0,0
1000000US060855087042024,060855087042024,"Block 2024, Block Group 2, Census Tract 5087.04, Santa Clara County, California",0,0,0
1000000US060855087042025,060855087042025,"Block 2025, Block Group 2, Census Tract 5087.04, Santa Clara County, California",0,0,0
1000000US060855087042026,060855087042026,"Block 2026, Block Group 2, Census Tract 5087.04, Santa Clara County, California",0,0,0
1000000US060855087042027,060855087042027,"Block 2027, Block Group 2, Census Tract 5087.04, Santa Clara County, California",3,3,0
1000000US060855087042028,060855087042028,"Block 2028, Block Group 2, Census Tract 5087.04, Santa Clara County, California",0,0,0
1000000US060855087042029,060855087042029,"Block 2029, Block Group 2, Census Tract 5087.04, Santa Clara County, California",14,12,2
1000000US060855087042030,060855087042030,"Block 2030, Block Group 2, Census Tract 5087.04, Santa Clara County, California",0,0,0
1000000US060855087042031,060855087042031,"Block 2031, Block Group 2, Census Tract 5087.04, Santa Clara County, California",0,0,0
1000000US060855087042032,060855087042032,"Block 2032, Block Group 2, Census Tract 5087.04, Santa Clara County, California",38,33,5
1000000US060855087042033,060855087042033,"Block 2033, Block Group 2, Census Tract 5087.04, Santa Clara County, California",0,0,0
1000000US060855087042034,060855087042034,"Block 2034, Block Group 2, Census Tract 5087.04, Santa Clara County, California",0,0,0
1000000US060855087042035,060855087042035,"Block 2035, Block Group 2, Census Tract 5087.04, Santa Clara County, California",189,188,1
1000000US060855087042036,060855087042036,"Block 2036, Block Group 2, Census Tract 5087.04, Santa Clara County, California",0,0,0
1000000US060855087042037,060855087042037,"Block 2037, Block Group 2, Census Tract 5087.04, Santa Clara County, California",40,39,1
1000000US060855087042038,060855087042038,"Block 2038, Block Group 2, Census Tract 5087.04, Santa Clara County, California",34,33,1
1000000US060855087042039,060855087042039,"Block 2039, Block Group 2, Census Tract 5087.04, Santa Clara County, California",0,0,0
1000000US060855087042040,060855087042040,"Block 2040, Block Group 2, Census Tract 5087.04, Santa Clara County, California",7,6,1
1000000US060855087042041,060855087042041,"Block 2041, Block Group 2, Census Tract 5087.04, Santa Clara County, California",7,7,0
1000000US060855087042042,060855087042042,"Block 2042, Block Group 2, Census Tract 5087.04, Santa Clara County, California",0,0,0
1000000US060855087042043,060855087042043,"Block 2043, Block Group 2, Census Tract 5087.04, Santa Clara County, California",0,0,0
1000000US060855087042044,060855087042044,"Block 2044, Block Group 2, Census Tract 5087.04, Santa Clara County, California",0,0,0
1000000US060855087042045,060855087042045,"Block 2045, Block Group 2, Census Tract 5087.04, Santa Clara County, California",0,0,0
1000000US060855087042046,060855087042046,"Block 2046, Block Group 2, Census Tract 5087.04, Santa Clara County, California",0,0,0
1000000US060855087042047,060855087042047,"Block 2047, Block Group 2, Census Tract 5087.04, Santa Clara County, California",0,0,0
1000000US060855087042048,060855087042048,"Block 2048, Block Group 2, Census Tract 5087.04, Santa Clara County, California",0,0,0
1000000US060855087042049,060855087042049,"Block 2049, Block Group 2, Census Tract 5087.04, Santa Clara County, California",0,0,0
1000000US060855087042050,060855087042050,"Block 2050, Block Group 2, Census Tract 5087.04, Santa Clara County, California",0,0,0
1000000US060855087042051,060855087042051,"Block 2051, Block Group 2, Census Tract 5087.04, Santa Clara County, California",0,0,0
1000000US060855087042052,060855087042052,"Block 2052, Block Group 2, Census Tract 5087.04, Santa Clara County, California",0,0,0
1000000US060855087042053,060855087042053,"Block 2053, Block Group 2, Census Tract 5087.04, Santa Clara County, California",0,0,0
1000000US060855087042054,060855087042054,"Block 2054, Block Group 2, Census Tract 5087.04, Santa Clara County, California",0,0,0
1000000US060855087042055,060855087042055,"Block 2055, Block Group 2, Census Tract 5087.04, Santa Clara County, California",0,0,0
1000000US060855087042056,060855087042056,"Block 2056, Block Group 2, Census Tract 5087.04, Santa Clara County, California",0,0,0
1000000US060855087042057,060855087042057,"Block 2057, Block Group 2, Census Tract 5087.04, Santa Clara County, California",0,0,0
1000000US060855087042058,060855087042058,"Block 2058, Block Group 2, Census Tract 5087.04, Santa Clara County, California",0,0,0
1000000US060855087042059,060855087042059,"Block 2059, Block Group 2, Census Tract 5087.04, Santa Clara County, California",0,0,0
1000000US060855087042060,060855087042060,"Block 2060, Block Group 2, Census Tract 5087.04, Santa Clara County, California",0,0,0
1000000US060855087042061,060855087042061,"Block 2061, Block Group 2, Census Tract 5087.04, Santa Clara County, California",0,0,0
1000000US060855087042062,060855087042062,"Block 2062, Block Group 2, Census Tract 5087.04, Santa Clara County, California",0,0,0
1000000US060855087042063,060855087042063,"Block 2063, Block Group 2, Census Tract 5087.04, Santa Clara County, California",0,0,0
1000000US060855087042064,060855087042064,"Block 2064, Block Group 2, Census Tract 5087.04, Santa Clara County, California",0,0,0
1000000US060855087042065,060855087042065,"Block 2065, Block Group 2, Census Tract 5087.04, Santa Clara County, California",0,0,0
1000000US060855087042066,060855087042066,"Block 2066, Block Group 2, Census Tract 5087.04, Santa Clara County, California",0,0,0
1000000US060855087042067,060855087042067,"Block 2067, Block Group 2, Census Tract 5087.04, Santa Clara County, California",0,0,0
1000000US060855087042068,060855087042068,"Block 2068, Block Group 2, Census Tract 5087.04, Santa Clara County, California",0,0,0
1000000US060855087042069,060855087042069,"Block 2069, Block Group 2, Census Tract 5087.04, Santa Clara County, California",0,0,0
1000000US060855087042070,060855087042070,"Block 2070, Block Group 2, Census Tract 5087.04, Santa Clara County, California",0,0,0
1000000US060855087042071,060855087042071,"Block 2071, Block Group 2, Census Tract 5087.04, Santa Clara County, California",0,0,0
1000000US060855087042072,060855087042072,"Block 2072, Block Group 2, Census Tract 5087.04, Santa Clara County, California",0,0,0
1000000US060855087042073,060855087042073,"Block 2073, Block Group 2, Census Tract 5087.04, Santa Clara County, California",0,0,0
1000000US060855087042074,060855087042074,"Block 2074, Block Group 2, Census Tract 5087.04, Santa Clara County, California",0,0,0
1000000US060855087042075,060855087042075,"Block 2075, Block Group 2, Census Tract 5087.04, Santa Clara County, California",0,0,0
1000000US060855087042076,060855087042076,"Block 2076, Block Group 2, Census Tract 5087.04, Santa Clara County, California",0,0,0
1000000US060855087042077,060855087042077,"Block 2077, Block Group 2, Census Tract 5087.04, Santa Clara County, California",0,0,0
1000000US060855087042078,060855087042078,"Block 2078, Block Group 2, Census Tract 5087.04, Santa Clara County, California",0,0,0
1000000US060855087042079,060855087042079,"Block 2079, Block Group 2, Census Tract 5087.04, Santa Clara County, California",0,0,0
1000000US060855087042080,060855087042080,"Block 2080, Block Group 2, Census Tract 5087.04, Santa Clara County, California",0,0,0
1000000US060855087042081,060855087042081,"Block 2081, Block Group 2, Census Tract 5087.04, Santa Clara County, California",0,0,0
1000000US060855087042082,060855087042082,"Block 2082, Block Group 2, Census Tract 5087.04, Santa Clara County, California",0,0,0
1000000US060855087042083,060855087042083,"Block 2083, Block Group 2, Census Tract 5087.04, Santa Clara County, California",0,0,0
1000000US060855087042084,060855087042084,"Block 2084, Block Group 2, Census Tract 5087.04, Santa Clara County, California",0,0,0
1000000US060855087042085,060855087042085,"Block 2085, Block Group 2, Census Tract 5087.04, Santa Clara County, California",0,0,0
1000000US060855087042086,060855087042086,"Block 2086, Block Group 2, Census Tract 5087.04, Santa Clara County, California",0,0,0
1000000US060855087042087,060855087042087,"Block 2087, Block Group 2, Census Tract 5087.04, Santa Clara County, California",0,0,0
1000000US060855087042088,060855087042088,"Block 2088, Block Group 2, Census Tract 5087.04, Santa Clara County, California",85,83,2
1000000US060855087042089,060855087042089,"Block 2089, Block Group 2, Census Tract 5087.04, Santa Clara County, California",0,0,0
1000000US060855087042090,060855087042090,"Block 2090, Block Group 2, Census Tract 5087.04, Santa Clara County, California",0,0,0
1000000US060855087042091,060855087042091,"Block 2091, Block Group 2, Census Tract 5087.04, Santa Clara County, California",0,0,0
1000000US060855087042092,060855087042092,"Block 2092, Block Group 2, Census Tract 5087.04, Santa Clara County, California",0,0,0
1000000US060855087042093,060855087042093,"Block 2093, Block Group 2, Census Tract 5087.04, Santa Clara County, California",0,0,0
1000000US060855087042094,060855087042094,"Block 2094, Block Group 2, Census Tract 5087.04, Santa Clara County, California",0,0,0
1000000US060855087042095,060855087042095,"Block 2095, Block Group 2, Census Tract 5087.04, Santa Clara County, California",44,42,2
1000000US060855087042096,060855087042096,"Block 2096, Block Group 2, Census Tract 5087.04, Santa Clara County, California",0,0,0
1000000US060855087042097,060855087042097,"Block 2097, Block Group 2, Census Tract 5087.04, Santa Clara County, California",25,25,0
1000000US060855087042098,060855087042098,"Block 2098, Block Group 2, Census Tract 5087.04, Santa Clara County, California",0,0,0
1000000US060855087042099,060855087042099,"Block 2099, Block Group 2, Census Tract 5087.04, Santa Clara County, California",74,68,6
1000000US060855087042100,060855087042100,"Block 2100, Block Group 2, Census Tract 5087.04, Santa Clara County, California",35,31,4
1000000US060855087042101,060855087042101,"Block 2101, Block Group 2, Census Tract 5087.04, Santa Clara County, California",0,0,0
1000000US060855087042102,060855087042102,"Block 2102, Block Group 2, Census Tract 5087.04, Santa Clara County, California",0,0,0
1000000US060855087042103,060855087042103,"Block 2103, Block Group 2, Census Tract 5087.04, Santa Clara County, California",0,0,0
1000000US060855087042104,060855087042104,"Block 2104, Block Group 2, Census Tract 5087.04, Santa Clara County, California",0,0,0
1000000US060855087042105,060855087042105,"Block 2105, Block Group 2, Census Tract 5087.04, Santa Clara County, California",0,0,0
1000000US060855087042106,060855087042106,"Block 2106, Block Group 2, Census Tract 5087.04, Santa Clara County, California",33,32,1
1000000US060855087042107,060855087042107,"Block 2107, Block Group 2, Census Tract 5087.04, Santa Clara County, California",9,7,2
1000000US060855087042108,060855087042108,"Block 2108, Block Group 2, Census Tract 5087.04, Santa Clara County, California",0,0,0
1000000US060855087042109,060855087042109,"Block 2109, Block Group 2, Census Tract 5087.04, Santa Clara County, California",0,0,0
1000000US060855087042110,060855087042110,"Block 2110, Block Group 2, Census Tract 5087.04, Santa Clara County, California",11,11,0
1000000US060855087042111,060855087042111,"Block 2111, Block Group 2, Census Tract 5087.04, Santa Clara County, California",31,31,0
1000000US060855087042112,060855087042112,"Block 2112, Block Group 2, Census Tract 5087.04, Santa Clara County, California",32,32,0
1000000US060855087042113,060855087042113,"Block 2113, Block Group 2, Census Tract 5087.04, Santa Clara County, California",0,0,0
1000000US060855087042114,060855087042114,"Block 2114, Block Group 2, Census Tract 5087.04, Santa Clara County, California",0,0,0
1000000US060855087042115,060855087042115,"Block 2115, Block Group 2, Census Tract 5087.04, Santa Clara County, California",0,0,0
1000000US060855087042116,060855087042116,"Block 2116, Block Group 2, Census Tract 5087.04, Santa Clara County, California",0,0,0
1000000US060855087042117,060855087042117,"Block 2117, Block Group 2, Census Tract 5087.04, Santa Clara County, California",25,24,1
1000000US060855087042118,060855087042118,"Block 2118, Block Group 2, Census Tract 5087.04, Santa Clara County, California",0,0,0
1000000US060855087042119,060855087042119,"Block 2119, Block Group 2, Census Tract 5087.04, Santa Clara County, California",0,0,0
1000000US060855087042120,060855087042120,"Block 2120, Block Group 2, Census Tract 5087.04, Santa Clara County, California",0,0,0
1000000US060855087042121,060855087042121,"Block 2121, Block Group 2, Census Tract 5087.04, Santa Clara County, California",0,0,0
1000000US060855087042122,060855087042122,"Block 2122, Block Group 2, Census Tract 5087.04, Santa Clara County, California",0,0,0
1000000US060855087042123,060855087042123,"Block 2123, Block Group 2, Census Tract 5087.04, Santa Clara County, California",0,0,0
1000000US060855087042124,060855087042124,"Block 2124, Block Group 2, Census Tract 5087.04, Santa Clara County, California",0,0,0
1000000US060855087042125,060855087042125,"Block 2125, Block Group 2, Census Tract 5087.04, Santa Clara County, California",0,0,0
1000000US060855087042126,060855087042126,"Block 2126, Block Group 2, Census Tract 5087.04, Santa Clara County, California",0,0,0
1000000US060855087042127,060855087042127,"Block 2127, Block Group 2, Census Tract 5087.04, Santa Clara County, California",12,10,2
1000000US060855087042128,060855087042128,"Block 2128, Block Group 2, Census Tract 5087.04, Santa Clara County, California",0,0,0
1000000US060855087042129,060855087042129,"Block 2129, Block Group 2, Census Tract 5087.04, Santa Clara County, California",0,0,0
1000000US060855087042130,060855087042130,"Block 2130, Block Group 2, Census Tract 5087.04, Santa Clara County, California",0,0,0
1000000US060855087042131,060855087042131,"Block 2131, Block Group 2, Census Tract 5087.04, Santa Clara County, California",0,0,0
1000000US060855087042132,060855087042132,"Block 2132, Block Group 2, Census Tract 5087.04, Santa Clara County, California",0,0,0
1000000US060855087042133,060855087042133,"Block 2133, Block Group 2, Census Tract 5087.04, Santa Clara County, California",0,0,0
1000000US060855087042134,060855087042134,"Block 2134, Block Group 2, Census Tract 5087.04, Santa Clara County, California",0,0,0
1000000US060855087042135,060855087042135,"Block 2135, Block Group 2, Census Tract 5087.04, Santa Clara County, California",0,0,0
1000000US060855087042136,060855087042136,"Block 2136, Block Group 2, Census Tract 5087.04, Santa Clara County, California",0,0,0
1000000US060855087042137,060855087042137,"Block 2137, Block Group 2, Census Tract 5087.04, Santa Clara County, California",0,0,0
1000000US060855087042138,060855087042138,"Block 2138, Block Group 2, Census Tract 5087.04, Santa Clara County, California",0,0,0
1000000US060855087042139,060855087042139,"Block 2139, Block Group 2, Census Tract 5087.04, Santa Clara County, California",0,0,0
1000000US060855087042140,060855087042140,"Block 2140, Block Group 2, Census Tract 5087.04, Santa Clara County, California",0,0,0
1000000US060855087042141,060855087042141,"Block 2141, Block Group 2, Census Tract 5087.04, Santa Clara County, California",0,0,0
1000000US060855087042142,060855087042142,"Block 2142, Block Group 2, Census Tract 5087.04, Santa Clara County, California",0,0,0
1000000US060855087042143,060855087042143,"Block 2143, Block Group 2, Census Tract 5087.04, Santa Clara County, California",0,0,0
1000000US060855087042144,060855087042144,"Block 2144, Block Group 2, Census Tract 5087.04, Santa Clara County, California",0,0,0
1000000US060855087042145,060855087042145,"Block 2145, Block Group 2, Census Tract 5087.04, Santa Clara County, California",0,0,0
1000000US060855087043000,060855087043000,"Block 3000, Block Group 3, Census Tract 5087.04, Santa Clara County, California",0,0,0
1000000US060855087043001,060855087043001,"Block 3001, Block Group 3, Census Tract 5087.04, Santa Clara County, California",288,274,14
1000000US060855087043002,060855087043002,"Block 3002, Block Group 3, Census Tract 5087.04, Santa Clara County, California",0,0,0
1000000US060855087043003,060855087043003,"Block 3003, Block Group 3, Census Tract 5087.04, Santa Clara County, California",0,0,0
1000000US060855087043004,060855087043004,"Block 3004, Block Group 3, Census Tract 5087.04, Santa Clara County, California",0,0,0
1000000US060855087043005,060855087043005,"Block 3005, Block Group 3, Census Tract 5087.04, Santa Clara County, California",2,2,0
1000000US060855087043006,060855087043006,"Block 3006, Block Group 3, Census Tract 5087.04, Santa Clara County, California",0,0,0
1000000US060855087043007,060855087043007,"Block 3007, Block Group 3, Census Tract 5087.04, Santa Clara County, California",0,0,0
1000000US060855087043008,060855087043008,"Block 3008, Block Group 3, Census Tract 5087.04, Santa Clara County, California",0,0,0
1000000US060855087043009,060855087043009,"Block 3009, Block Group 3, Census Tract 5087.04, Santa Clara County, California",0,0,0
1000000US060855087043010,060855087043010,"Block 3010, Block Group 3, Census Tract 5087.04, Santa Clara County, California",0,0,0
1000000US060855087043011,060855087043011,"Block 3011, Block Group 3, Census Tract 5087.04, Santa Clara County, California",0,0,0
1000000US060855087043012,060855087043012,"Block 3012, Block Group 3, Census Tract 5087.04, Santa Clara County, California",217,203,14
1000000US060855087043013,060855087043013,"Block 3013, Block Group 3, Census Tract 5087.04, Santa Clara County, California",0,0,0
1000000US060855087043014,060855087043014,"Block 3014, Block Group 3, Census Tract 5087.04, Santa Clara County, California",0,0,0
1000000US060855087043015,060855087043015,"Block 3015, Block Group 3, Census Tract 5087.04, Santa Clara County, California",0,0,0
1000000US060855087043016,060855087043016,"Block 3016, Block Group 3, Census Tract 5087.04, Santa Clara County, California",0,0,0
1000000US060855087043017,060855087043017,"Block 3017, Block Group 3, Census Tract 5087.04, Santa Clara County, California",0,0,0
1000000US060855087043018,060855087043018,"Block 3018, Block Group 3, Census Tract 5087.04, Santa Clara County, California",0,0,0
1000000US060855087043019,060855087043019,"Block 3019, Block Group 3, Census Tract 5087.04, Santa Clara County, California",202,181,21
1000000US060855087043020,060855087043020,"Block 3020, Block Group 3, Census Tract 5087.04, Santa Clara County, California",0,0,0
1000000US060855087043021,060855087043021,"Block 3021, Block Group 3, Census Tract 5087.04, Santa Clara County, California",0,0,0
1000000US060855087043022,060855087043022,"Block 3022, Block Group 3, Census Tract 5087.04, Santa Clara County, California",0,0,0
1000000US060855087043023,060855087043023,"Block 3023, Block Group 3, Census Tract 5087.04, Santa Clara County, California",0,0,0
1000000US060855087043024,060855087043024,"Block 3024, Block Group 3, Census Tract 5087.04, Santa Clara County, California",0,0,0
1000000US060855087043025,060855087043025,"Block 3025, Block Group 3, Census Tract 5087.04, Santa Clara County, California",0,0,0
1000000US060855087043026,060855087043026,"Block 3026, Block Group 3, Census Tract 5087.04, Santa Clara County, California",0,0,0
1000000US060855087043027,060855087043027,"Block 3027, Block Group 3, Census Tract 5087.04, Santa Clara County, California",0,0,0
1000000US060855087043028,060855087043028,"Block 3028, Block Group 3, Census Tract 5087.04, Santa Clara County, California",0,0,0
1000000US060855087043029,060855087043029,"Block 3029, Block Group 3, Census Tract 5087.04, Santa Clara County, California",0,0,0
1000000US060855087043030,060855087043030,"Block 3030, Block Group 3, Census Tract 5087.04, Santa Clara County, California",0,0,0
1000000US060855087043031,060855087043031,"Block 3031, Block Group 3, Census Tract 5087.04, Santa Clara County, California",0,0,0
1000000US060855087043032,060855087043032,"Block 3032, Block Group 3, Census Tract 5087.04, Santa Clara County, California",0,0,0
1000000US060855087043033,060855087043033,"Block 3033, Block Group 3, Census Tract 5087.04, Santa Clara County, California",0,0,0
1000000US060855087043034,060855087043034,"Block 3034, Block Group 3, Census Tract 5087.04, Santa Clara County, California",0,0,0
1000000US060855087043035,060855087043035,"Block 3035, Block Group 3, Census Tract 5087.04, Santa Clara County, California",0,0,0
1000000US060855087043036,060855087043036,"Block 3036, Block Group 3, Census Tract 5087.04, Santa Clara County, California",0,0,0
1000000US060855087043037,060855087043037,"Block 3037, Block Group 3, Census Tract 5087.04, Santa Clara County, California",0,0,0
1000000US060855087043038,060855087043038,"Block 3038, Block Group 3, Census Tract 5087.04, Santa Clara County, California",0,0,0
1000000US060855087043039,060855087043039,"Block 3039, Block Group 3, Census Tract 5087.04, Santa Clara County, California",0,0,0
1000000US060855087043040,060855087043040,"Block 3040, Block Group 3, Census Tract 5087.04, Santa Clara County, California",0,0,0
1000000US060855087043041,060855087043041,"Block 3041, Block Group 3, Census Tract 5087.04, Santa Clara County, California",0,0,0
1000000US060855087043042,060855087043042,"Block 3042, Block Group 3, Census Tract 5087.04, Santa Clara County, California",0,0,0
1000000US060855087043043,060855087043043,"Block 3043, Block Group 3, Census Tract 5087.04, Santa Clara County, California",0,0,0
1000000US060855087043044,060855087043044,"Block 3044, Block Group 3, Census Tract 5087.04, Santa Clara County, California",0,0,0
1000000US060855087043045,060855087043045,"Block 3045, Block Group 3, Census Tract 5087.04, Santa Clara County, California",0,0,0
1000000US060855087043046,060855087043046,"Block 3046, Block Group 3, Census Tract 5087.04, Santa Clara County, California",0,0,0
1000000US060855087043047,060855087043047,"Block 3047, Block Group 3, Census Tract 5087.04, Santa Clara County, California",1,1,0
1000000US060855087043048,060855087043048,"Block 3048, Block Group 3, Census Tract 5087.04, Santa Clara County, California",0,0,0
1000000US060855087043049,060855087043049,"Block 3049, Block Group 3, Census Tract 5087.04, Santa Clara County, California",0,0,0
1000000US060855087043050,060855087043050,"Block 3050, Block Group 3, Census Tract 5087.04, Santa Clara County, California",0,0,0
1000000US060855087043051,060855087043051,"Block 3051, Block Group 3, Census Tract 5087.04, Santa Clara County, California",0,0,0
1000000US060855087043052,060855087043052,"Block 3052, Block Group 3, Census Tract 5087.04, Santa Clara County, California",0,0,0
1000000US060855087043053,060855087043053,"Block 3053, Block Group 3, Census Tract 5087.04, Santa Clara County, California",0,0,0
1000000US060855087043054,060855087043054,"Block 3054, Block Group 3, Census Tract 5087.04, Santa Clara County, California",0,0,0
1000000US060855087043055,060855087043055,"Block 3055, Block Group 3, Census Tract 5087.04, Santa Clara County, California",0,0,0
1000000US060855087043056,060855087043056,"Block 3056, Block Group 3, Census Tract 5087.04, Santa Clara County, California",0,0,0
1000000US060855087043057,060855087043057,"Block 3057, Block Group 3, Census Tract 5087.04, Santa Clara County, California",0,0,0
1000000US060855087043058,060855087043058,"Block 3058, Block Group 3, Census Tract 5087.04, Santa Clara County, California",0,0,0
1000000US060855088001000,060855088001000,"Block 1000, Block Group 1, Census Tract 5088, Santa Clara County, California",0,0,0
1000000US060855088001001,060855088001001,"Block 1001, Block Group 1, Census Tract 5088, Santa Clara County, California",0,0,0
1000000US060855088001002,060855088001002,"Block 1002, Block Group 1, Census Tract 5088, Santa Clara County, California",0,0,0
1000000US060855088001003,060855088001003,"Block 1003, Block Group 1, Census Tract 5088, Santa Clara County, California",56,51,5
1000000US060855088001004,060855088001004,"Block 1004, Block Group 1, Census Tract 5088, Santa Clara County, California",0,0,0
1000000US060855088001005,060855088001005,"Block 1005, Block Group 1, Census Tract 5088, Santa Clara County, California",0,0,0
1000000US060855088001006,060855088001006,"Block 1006, Block Group 1, Census Tract 5088, Santa Clara County, California",0,0,0
1000000US060855088001007,060855088001007,"Block 1007, Block Group 1, Census Tract 5088, Santa Clara County, California",0,0,0
1000000US060855088001008,060855088001008,"Block 1008, Block Group 1, Census Tract 5088, Santa Clara County, California",0,0,0
1000000US060855088001009,060855088001009,"Block 1009, Block Group 1, Census Tract 5088, Santa Clara County, California",0,0,0
1000000US060855088001010,060855088001010,"Block 1010, Block Group 1, Census Tract 5088, Santa Clara County, California",62,59,3
1000000US060855088001011,060855088001011,"Block 1011, Block Group 1, Census Tract 5088, Santa Clara County, California",57,54,3
1000000US060855088001012,060855088001012,"Block 1012, Block Group 1, Census Tract 5088, Santa Clara County, California",0,0,0
1000000US060855088001013,060855088001013,"Block 1013, Block Group 1, Census Tract 5088, Santa Clara County, California",157,152,5
1000000US060855088001014,060855088001014,"Block 1014, Block Group 1, Census Tract 5088, Santa Clara County, California",48,46,2
1000000US060855088001015,060855088001015,"Block 1015, Block Group 1, Census Tract 5088, Santa Clara County, California",388,362,26
1000000US060855088001016,060855088001016,"Block 1016, Block Group 1, Census Tract 5088, Santa Clara County, California",0,0,0
1000000US060855088001017,060855088001017,"Block 1017, Block Group 1, Census Tract 5088, Santa Clara County, California",47,44,3
1000000US060855088001018,060855088001018,"Block 1018, Block Group 1, Census Tract 5088, Santa Clara County, California",0,0,0
1000000US060855088001019,060855088001019,"Block 1019, Block Group 1, Census Tract 5088, Santa Clara County, California",27,27,0
1000000US060855088001020,060855088001020,"Block 1020, Block Group 1, Census Tract 5088, Santa Clara County, California",64,63,1
1000000US060855088001021,060855088001021,"Block 1021, Block Group 1, Census Tract 5088, Santa Clara County, California",0,0,0
1000000US060855088001022,060855088001022,"Block 1022, Block Group 1, Census Tract 5088, Santa Clara County, California",0,0,0
1000000US060855088001023,060855088001023,"Block 1023, Block Group 1, Census Tract 5088, Santa Clara County, California",26,24,2
1000000US060855088002000,060855088002000,"Block 2000, Block Group 2, Census Tract 5088, Santa Clara County, California",0,0,0
1000000US060855088002001,060855088002001,"Block 2001, Block Group 2, Census Tract 5088, Santa Clara County, California",0,0,0
1000000US060855088002002,060855088002002,"Block 2002, Block Group 2, Census Tract 5088, Santa Clara County, California",0,0,0
1000000US060855088002003,060855088002003,"Block 2003, Block Group 2, Census Tract 5088, Santa Clara County, California",149,138,11
1000000US060855088002004,060855088002004,"Block 2004, Block Group 2, Census Tract 5088, Santa Clara County, California",151,147,4
1000000US060855088002005,060855088002005,"Block 2005, Block Group 2, Census Tract 5088, Santa Clara County, California",41,39,2
1000000US060855088002006,060855088002006,"Block 2006, Block Group 2, Census Tract 5088, Santa Clara County, California",34,31,3
1000000US060855088002007,060855088002007,"Block 2007, Block Group 2, Census Tract 5088, Santa Clara County, California",33,33,0
1000000US060855088002008,060855088002008,"Block 2008, Block Group 2, Census Tract 5088, Santa Clara County, California",20,18,2
1000000US060855088002009,060855088002009,"Block 2009, Block Group 2, Census Tract 5088, Santa Clara County, California",20,18,2
1000000US060855088002010,060855088002010,"Block 2010, Block Group 2, Census Tract 5088, Santa Clara County, California",19,19,0
1000000US060855088002011,060855088002011,"Block 2011, Block Group 2, Census Tract 5088, Santa Clara County, California",0,0,0
1000000US060855088002012,060855088002012,"Block 2012, Block Group 2, Census Tract 5088, Santa Clara County, California",0,0,0
1000000US060855088002013,060855088002013,"Block 2013, Block Group 2, Census Tract 5088, Santa Clara County, California",0,0,0
1000000US060855088002014,060855088002014,"Block 2014, Block Group 2, Census Tract 5088, Santa Clara County, California",36,33,3
1000000US060855088002015,060855088002015,"Block 2015, Block Group 2, Census Tract 5088, Santa Clara County, California",38,37,1
1000000US060855088002016,060855088002016,"Block 2016, Block Group 2, Census Tract 5088, Santa Clara County, California",0,0,0
1000000US060855088002017,060855088002017,"Block 2017, Block Group 2, Census Tract 5088, Santa Clara County, California",0,0,0
1000000US060855088002018,060855088002018,"Block 2018, Block Group 2, Census Tract 5088, Santa Clara County, California",0,0,0
1000000US060855088002019,060855088002019,"Block 2019, Block Group 2, Census Tract 5088, Santa Clara County, California",0,0,0
1000000US060855088002020,060855088002020,"Block 2020, Block Group 2, Census Tract 5088, Santa Clara County, California",0,0,0
1000000US060855088002021,060855088002021,"Block 2021, Block Group 2, Census Tract 5088, Santa Clara County, California",0,0,0
1000000US060855089001000,060855089001000,"Block 1000, Block Group 1, Census Tract 5089, Santa Clara County, California",0,0,0
1000000US060855089001001,060855089001001,"Block 1001, Block Group 1, Census Tract 5089, Santa Clara County, California",0,0,0
1000000US060855089001002,060855089001002,"Block 1002, Block Group 1, Census Tract 5089, Santa Clara County, California",0,0,0
1000000US060855089001003,060855089001003,"Block 1003, Block Group 1, Census Tract 5089, Santa Clara County, California",215,205,10
1000000US060855089001004,060855089001004,"Block 1004, Block Group 1, Census Tract 5089, Santa Clara County, California",210,205,5
1000000US060855089001005,060855089001005,"Block 1005, Block Group 1, Census Tract 5089, Santa Clara County, California",30,27,3
1000000US060855089001006,060855089001006,"Block 1006, Block Group 1, Census Tract 5089, Santa Clara County, California",40,39,1
1000000US060855089001007,060855089001007,"Block 1007, Block Group 1, Census Tract 5089, Santa Clara County, California",98,93,5
1000000US060855089001008,060855089001008,"Block 1008, Block Group 1, Census Tract 5089, Santa Clara County, California",64,56,8
1000000US060855089001009,060855089001009,"Block 1009, Block Group 1, Census Tract 5089, Santa Clara County, California",16,15,1
1000000US060855089001010,060855089001010,"Block 1010, Block Group 1, Census Tract 5089, Santa Clara County, California",81,80,1
1000000US060855089001011,060855089001011,"Block 1011, Block Group 1, Census Tract 5089, Santa Clara County, California",0,0,0
1000000US060855089001012,060855089001012,"Block 1012, Block Group 1, Census Tract 5089, Santa Clara County, California",16,15,1
1000000US060855089001013,060855089001013,"Block 1013, Block Group 1, Census Tract 5089, Santa Clara County, California",113,103,10
1000000US060855089001014,060855089001014,"Block 1014, Block Group 1, Census Tract 5089, Santa Clara County, California",210,196,14
1000000US060855089002000,060855089002000,"Block 2000, Block Group 2, Census Tract 5089, Santa Clara County, California",0,0,0
1000000US060855089002001,060855089002001,"Block 2001, Block Group 2, Census Tract 5089, Santa Clara County, California",58,56,2
1000000US060855089002002,060855089002002,"Block 2002, Block Group 2, Census Tract 5089, Santa Clara County, California",34,34,0
1000000US060855089002003,060855089002003,"Block 2003, Block Group 2, Census Tract 5089, Santa Clara County, California",31,31,0
1000000US060855089002004,060855089002004,"Block 2004, Block Group 2, Census Tract 5089, Santa Clara County, California",18,18,0
1000000US060855089002005,060855089002005,"Block 2005, Block Group 2, Census Tract 5089, Santa Clara County, California",21,21,0
1000000US060855089002006,060855089002006,"Block 2006, Block Group 2, Census Tract 5089, Santa Clara County, California",23,21,2
1000000US060855089002007,060855089002007,"Block 2007, Block Group 2, Census Tract 5089, Santa Clara County, California",64,63,1
1000000US060855089002008,060855089002008,"Block 2008, Block Group 2, Census Tract 5089, Santa Clara County, California",18,18,0
1000000US060855089002009,060855089002009,"Block 2009, Block Group 2, Census Tract 5089, Santa Clara County, California",18,18,0
1000000US060855089002010,060855089002010,"Block 2010, Block Group 2, Census Tract 5089, Santa Clara County, California",18,17,1
1000000US060855089002011,060855089002011,"Block 2011, Block Group 2, Census Tract 5089, Santa Clara County, California",56,55,1
1000000US060855089002012,060855089002012,"Block 2012, Block Group 2, Census Tract 5089, Santa Clara County, California",14,13,1
1000000US060855089003000,060855089003000,"Block 3000, Block Group 3, Census Tract 5089, Santa Clara County, California",0,0,0
1000000US060855089003001,060855089003001,"Block 3001, Block Group 3, Census Tract 5089, Santa Clara County, California",23,22,1
1000000US060855089003002,060855089003002,"Block 3002, Block Group 3, Census Tract 5089, Santa Clara County, California",26,26,0
1000000US060855089003003,060855089003003,"Block 3003, Block Group 3, Census Tract 5089, Santa Clara County, California",24,23,1
1000000US060855089003004,060855089003004,"Block 3004, Block Group 3, Census Tract 5089, Santa Clara County, California",51,50,1
1000000US060855089003005,060855089003005,"Block 3005, Block Group 3, Census Tract 5089, Santa Clara County, California",24,21,3
1000000US060855089003006,060855089003006,"Block 3006, Block Group 3, Census Tract 5089, Santa Clara County, California",24,24,0
1000000US060855089003007,060855089003007,"Block 3007, Block Group 3, Census Tract 5089, Santa Clara County, California",26,26,0
1000000US060855089003008,060855089003008,"Block 3008, Block Group 3, Census Tract 5089, Santa Clara County, California",24,23,1
1000000US060855089003009,060855089003009,"Block 3009, Block Group 3, Census Tract 5089, Santa Clara County, California",23,23,0
1000000US060855089003010,060855089003010,"Block 3010, Block Group 3, Census Tract 5089, Santa Clara County, California",22,22,0
1000000US060855089003011,060855089003011,"Block 3011, Block Group 3, Census Tract 5089, Santa Clara County, California",0,0,0
1000000US060855090001000,060855090001000,"Block 1000, Block Group 1, Census Tract 5090, Santa Clara County, California",0,0,0
1000000US060855090001001,060855090001001,"Block 1001, Block Group 1, Census Tract 5090, Santa Clara County, California",60,48,12
1000000US060855090001002,060855090001002,"Block 1002, Block Group 1, Census Tract 5090, Santa Clara County, California",411,395,16
1000000US060855090001003,060855090001003,"Block 1003, Block Group 1, Census Tract 5090, Santa Clara County, California",0,0,0
1000000US060855090001004,060855090001004,"Block 1004, Block Group 1, Census Tract 5090, Santa Clara County, California",0,0,0
1000000US060855090001005,060855090001005,"Block 1005, Block Group 1, Census Tract 5090, Santa Clara County, California",27,25,2
1000000US060855090001006,060855090001006,"Block 1006, Block Group 1, Census Tract 5090, Santa Clara County, California",24,20,4
1000000US060855090001007,060855090001007,"Block 1007, Block Group 1, Census Tract 5090, Santa Clara County, California",24,23,1
1000000US060855090001008,060855090001008,"Block 1008, Block Group 1, Census Tract 5090, Santa Clara County, California",32,32,0
1000000US060855090001009,060855090001009,"Block 1009, Block Group 1, Census Tract 5090, Santa Clara County, California",0,0,0
1000000US060855090001010,060855090001010,"Block 1010, Block Group 1, Census Tract 5090, Santa Clara County, California",31,31,0
1000000US060855090001011,060855090001011,"Block 1011, Block Group 1, Census Tract 5090, Santa Clara County, California",24,21,3
1000000US060855090001012,060855090001012,"Block 1012, Block Group 1, Census Tract 5090, Santa Clara County, California",24,21,3
1000000US060855090001013,060855090001013,"Block 1013, Block Group 1, Census Tract 5090, Santa Clara County, California",0,0,0
1000000US060855090001014,060855090001014,"Block 1014, Block Group 1, Census Tract 5090, Santa Clara County, California",16,16,0
1000000US060855090002000,060855090002000,"Block 2000, Block Group 2, Census Tract 5090, Santa Clara County, California",0,0,0
1000000US060855090002001,060855090002001,"Block 2001, Block Group 2, Census Tract 5090, Santa Clara County, California",67,64,3
1000000US060855090002002,060855090002002,"Block 2002, Block Group 2, Census Tract 5090, Santa Clara County, California",226,223,3
1000000US060855090002003,060855090002003,"Block 2003, Block Group 2, Census Tract 5090, Santa Clara County, California",0,0,0
1000000US060855090002004,060855090002004,"Block 2004, Block Group 2, Census Tract 5090, Santa Clara County, California",22,21,1
1000000US060855090002005,060855090002005,"Block 2005, Block Group 2, Census Tract 5090, Santa Clara County, California",0,0,0
1000000US060855090002006,060855090002006,"Block 2006, Block Group 2, Census Tract 5090, Santa Clara County, California",40,38,2
1000000US060855090002007,060855090002007,"Block 2007, Block Group 2, Census Tract 5090, Santa Clara County, California",19,19,0
1000000US060855090002008,060855090002008,"Block 2008, Block Group 2, Census Tract 5090, Santa Clara County, California",63,63,0
1000000US060855090002009,060855090002009,"Block 2009, Block Group 2, Census Tract 5090, Santa Clara County, California",43,42,1
1000000US060855090002010,060855090002010,"Block 2010, Block Group 2, Census Tract 5090, Santa Clara County, California",19,19,0
1000000US060855090003000,060855090003000,"Block 3000, Block Group 3, Census Tract 5090, Santa Clara County, California",0,0,0
1000000US060855090003001,060855090003001,"Block 3001, Block Group 3, Census Tract 5090, Santa Clara County, California",0,0,0
1000000US060855090003002,060855090003002,"Block 3002, Block Group 3, Census Tract 5090, Santa Clara County, California",0,0,0
1000000US060855090003003,060855090003003,"Block 3003, Block Group 3, Census Tract 5090, Santa Clara County, California",0,0,0
1000000US060855090003004,060855090003004,"Block 3004, Block Group 3, Census Tract 5090, Santa Clara County, California",80,79,1
1000000US060855090003005,060855090003005,"Block 3005, Block Group 3, Census Tract 5090, Santa Clara County, California",58,56,2
1000000US060855090003006,060855090003006,"Block 3006, Block Group 3, Census Tract 5090, Santa Clara County, California",12,12,0
1000000US060855090003007,060855090003007,"Block 3007, Block Group 3, Census Tract 5090, Santa Clara County, California",72,67,5
1000000US060855090003008,060855090003008,"Block 3008, Block Group 3, Census Tract 5090, Santa Clara County, California",7,5,2
1000000US060855090003009,060855090003009,"Block 3009, Block Group 3, Census Tract 5090, Santa Clara County, California",10,10,0
1000000US060855090003010,060855090003010,"Block 3010, Block Group 3, Census Tract 5090, Santa Clara County, California",79,74,5
1000000US060855090003011,060855090003011,"Block 3011, Block Group 3, Census Tract 5090, Santa Clara County, California",16,13,3
1000000US060855090003012,060855090003012,"Block 3012, Block Group 3, Census Tract 5090, Santa Clara County, California",19,16,3
1000000US060855090003013,060855090003013,"Block 3013, Block Group 3, Census Tract 5090, Santa Clara County, California",104,101,3
1000000US060855090003014,060855090003014,"Block 3014, Block Group 3, Census Tract 5090, Santa Clara County, California",220,213,7
1000000US060855090003015,060855090003015,"Block 3015, Block Group 3, Census Tract 5090, Santa Clara County, California",13,13,0
1000000US060855090003016,060855090003016,"Block 3016, Block Group 3, Census Tract 5090, Santa Clara County, California",28,26,2
1000000US060855090003017,060855090003017,"Block 3017, Block Group 3, Census Tract 5090, Santa Clara County, California",21,21,0
1000000US060855090003018,060855090003018,"Block 3018, Block Group 3, Census Tract 5090, Santa Clara County, California",26,24,2
1000000US060855090003019,060855090003019,"Block 3019, Block Group 3, Census Tract 5090, Santa Clara County, California",26,26,0
1000000US060855090003020,060855090003020,"Block 3020, Block Group 3, Census Tract 5090, Santa Clara County, California",67,63,4
1000000US060855090003021,060855090003021,"Block 3021, Block Group 3, Census Tract 5090, Santa Clara County, California",0,0,0
1000000US060855090003022,060855090003022,"Block 3022, Block Group 3, Census Tract 5090, Santa Clara County, California",0,0,0
1000000US060855090003023,060855090003023,"Block 3023, Block Group 3, Census Tract 5090, Santa Clara County, California",8,8,0
1000000US060855090003024,060855090003024,"Block 3024, Block Group 3, Census Tract 5090, Santa Clara County, California",15,14,1
1000000US060855090004000,060855090004000,"Block 4000, Block Group 4, Census Tract 5090, Santa Clara County, California",0,0,0
1000000US060855090004001,060855090004001,"Block 4001, Block Group 4, Census Tract 5090, Santa Clara County, California",25,24,1
1000000US060855090004002,060855090004002,"Block 4002, Block Group 4, Census Tract 5090, Santa Clara County, California",28,27,1
1000000US060855090004003,060855090004003,"Block 4003, Block Group 4, Census Tract 5090, Santa Clara County, California",27,26,1
1000000US060855090004004,060855090004004,"Block 4004, Block Group 4, Census Tract 5090, Santa Clara County, California",26,26,0
1000000US060855090004005,060855090004005,"Block 4005, Block Group 4, Census Tract 5090, Santa Clara County, California",28,27,1
1000000US060855090004006,060855090004006,"Block 4006, Block Group 4, Census Tract 5090, Santa Clara County, California",24,23,1
1000000US060855090004007,060855090004007,"Block 4007, Block Group 4, Census Tract 5090, Santa Clara County, California",28,28,0
1000000US060855090004008,060855090004008,"Block 4008, Block Group 4, Census Tract 5090, Santa Clara County, California",29,27,2
1000000US060855090004009,060855090004009,"Block 4009, Block Group 4, Census Tract 5090, Santa Clara County, California",26,26,0
1000000US060855090004010,060855090004010,"Block 4010, Block Group 4, Census Tract 5090, Santa Clara County, California",24,24,0
1000000US060855090004011,060855090004011,"Block 4011, Block Group 4, Census Tract 5090, Santa Clara County, California",23,20,3
1000000US060855090004012,060855090004012,"Block 4012, Block Group 4, Census Tract 5090, Santa Clara County, California",25,25,0
1000000US060855090004013,060855090004013,"Block 4013, Block Group 4, Census Tract 5090, Santa Clara County, California",27,25,2
1000000US060855090004014,060855090004014,"Block 4014, Block Group 4, Census Tract 5090, Santa Clara County, California",73,71,2
1000000US060855090004015,060855090004015,"Block 4015, Block Group 4, Census Tract 5090, Santa Clara County, California",37,37,0
1000000US060855090004016,060855090004016,"Block 4016, Block Group 4, Census Tract 5090, Santa Clara County, California",50,49,1
1000000US060855090004017,060855090004017,"Block 4017, Block Group 4, Census Tract 5090, Santa Clara County, California",12,12,0
1000000US060855091021000,060855091021000,"Block 1000, Block Group 1, Census Tract 5091.02, Santa Clara County, California",0,0,0
1000000US060855091021001,060855091021001,"Block 1001, Block Group 1, Census Tract 5091.02, Santa Clara County, California",0,0,0
1000000US060855091021002,060855091021002,"Block 1002, Block Group 1, Census Tract 5091.02, Santa Clara County, California",0,0,0
1000000US060855091021003,060855091021003,"Block 1003, Block Group 1, Census Tract 5091.02, Santa Clara County, California",0,0,0
1000000US060855091021004,060855091021004,"Block 1004, Block Group 1, Census Tract 5091.02, Santa Clara County, California",0,0,0
1000000US060855091021005,060855091021005,"Block 1005, Block Group 1, Census Tract 5091.02, Santa Clara County, California",0,0,0
1000000US060855091021006,060855091021006,"Block 1006, Block Group 1, Census Tract 5091.02, Santa Clara County, California",0,0,0
1000000US060855091021007,060855091021007,"Block 1007, Block Group 1, Census Tract 5091.02, Santa Clara County, California",0,0,0
1000000US060855091021008,060855091021008,"Block 1008, Block Group 1, Census Tract 5091.02, Santa Clara County, California",0,0,0
1000000US060855091021009,060855091021009,"Block 1009, Block Group 1, Census Tract 5091.02, Santa Clara County, California",0,0,0
1000000US060855091021010,060855091021010,"Block 1010, Block Group 1, Census Tract 5091.02, Santa Clara County, California",4,4,0
1000000US060855091021011,060855091021011,"Block 1011, Block Group 1, Census Tract 5091.02, Santa Clara County, California",0,0,0
1000000US060855091021012,060855091021012,"Block 1012, Block Group 1, Census Tract 5091.02, Santa Clara County, California",0,0,0
1000000US060855091021013,060855091021013,"Block 1013, Block Group 1, Census Tract 5091.02, Santa Clara County, California",0,0,0
1000000US060855091021014,060855091021014,"Block 1014, Block Group 1, Census Tract 5091.02, Santa Clara County, California",0,0,0
1000000US060855091021015,060855091021015,"Block 1015, Block Group 1, Census Tract 5091.02, Santa Clara County, California",0,0,0
1000000US060855091021016,060855091021016,"Block 1016, Block Group 1, Census Tract 5091.02, Santa Clara County, California",0,0,0
1000000US060855091021017,060855091021017,"Block 1017, Block Group 1, Census Tract 5091.02, Santa Clara County, California",0,0,0
1000000US060855091021018,060855091021018,"Block 1018, Block Group 1, Census Tract 5091.02, Santa Clara County, California",0,0,0
1000000US060855091021019,060855091021019,"Block 1019, Block Group 1, Census Tract 5091.02, Santa Clara County, California",0,0,0
1000000US060855091021020,060855091021020,"Block 1020, Block Group 1, Census Tract 5091.02, Santa Clara County, California",0,0,0
1000000US060855091021021,060855091021021,"Block 1021, Block Group 1, Census Tract 5091.02, Santa Clara County, California",0,0,0
1000000US060855091021022,060855091021022,"Block 1022, Block Group 1, Census Tract 5091.02, Santa Clara County, California",0,0,0
1000000US060855091021023,060855091021023,"Block 1023, Block Group 1, Census Tract 5091.02, Santa Clara County, California",0,0,0
1000000US060855091021024,060855091021024,"Block 1024, Block Group 1, Census Tract 5091.02, Santa Clara County, California",0,0,0
1000000US060855091021025,060855091021025,"Block 1025, Block Group 1, Census Tract 5091.02, Santa Clara County, California",0,0,0
1000000US060855091021026,060855091021026,"Block 1026, Block Group 1, Census Tract 5091.02, Santa Clara County, California",164,160,4
1000000US060855091021027,060855091021027,"Block 1027, Block Group 1, Census Tract 5091.02, Santa Clara County, California",63,61,2
1000000US060855091021028,060855091021028,"Block 1028, Block Group 1, Census Tract 5091.02, Santa Clara County, California",86,82,4
1000000US060855091021029,060855091021029,"Block 1029, Block Group 1, Census Tract 5091.02, Santa Clara County, California",0,0,0
1000000US060855091021030,060855091021030,"Block 1030, Block Group 1, Census Tract 5091.02, Santa Clara County, California",0,0,0
1000000US060855091021031,060855091021031,"Block 1031, Block Group 1, Census Tract 5091.02, Santa Clara County, California",16,16,0
1000000US060855091021032,060855091021032,"Block 1032, Block Group 1, Census Tract 5091.02, Santa Clara County, California",106,102,4
1000000US060855091021033,060855091021033,"Block 1033, Block Group 1, Census Tract 5091.02, Santa Clara County, California",0,0,0
1000000US060855091021034,060855091021034,"Block 1034, Block Group 1, Census Tract 5091.02, Santa Clara County, California",237,225,12
1000000US060855091021035,060855091021035,"Block 1035, Block Group 1, Census Tract 5091.02, Santa Clara County, California",0,0,0
1000000US060855091021036,060855091021036,"Block 1036, Block Group 1, Census Tract 5091.02, Santa Clara County, California",193,181,12
1000000US060855091021037,060855091021037,"Block 1037, Block Group 1, Census Tract 5091.02, Santa Clara County, California",1,1,0
1000000US060855091021038,060855091021038,"Block 1038, Block Group 1, Census Tract 5091.02, Santa Clara County, California",0,0,0
1000000US060855091021039,060855091021039,"Block 1039, Block Group 1, Census Tract 5091.02, Santa Clara County, California",0,0,0
1000000US060855091021040,060855091021040,"Block 1040, Block Group 1, Census Tract 5091.02, Santa Clara County, California",0,0,0
1000000US060855091021041,060855091021041,"Block 1041, Block Group 1, Census Tract 5091.02, Santa Clara County, California",0,0,0
1000000US060855091021042,060855091021042,"Block 1042, Block Group 1, Census Tract 5091.02, Santa Clara County, California",0,0,0
1000000US060855091021043,060855091021043,"Block 1043, Block Group 1, Census Tract 5091.02, Santa Clara County, California",0,0,0
1000000US060855091021044,060855091021044,"Block 1044, Block Group 1, Census Tract 5091.02, Santa Clara County, California",22,22,0
1000000US060855091021045,060855091021045,"Block 1045, Block Group 1, Census Tract 5091.02, Santa Clara County, California",0,0,0
1000000US060855091021046,060855091021046,"Block 1046, Block Group 1, Census Tract 5091.02, Santa Clara County, California",4,3,1
1000000US060855091021047,060855091021047,"Block 1047, Block Group 1, Census Tract 5091.02, Santa Clara County, California",44,44,0
1000000US060855091021048,060855091021048,"Block 1048, Block Group 1, Census Tract 5091.02, Santa Clara County, California",0,0,0
1000000US060855091022000,060855091022000,"Block 2000, Block Group 2, Census Tract 5091.02, Santa Clara County, California",0,0,0
1000000US060855091022001,060855091022001,"Block 2001, Block Group 2, Census Tract 5091.02, Santa Clara County, California",56,54,2
1000000US060855091022002,060855091022002,"Block 2002, Block Group 2, Census Tract 5091.02, Santa Clara County, California",88,81,7
1000000US060855091022003,060855091022003,"Block 2003, Block Group 2, Census Tract 5091.02, Santa Clara County, California",520,486,34
1000000US060855091022004,060855091022004,"Block 2004, Block Group 2, Census Tract 5091.02, Santa Clara County, California",0,0,0
1000000US060855091022005,060855091022005,"Block 2005, Block Group 2, Census Tract 5091.02, Santa Clara County, California",128,122,6
1000000US060855091022006,060855091022006,"Block 2006, Block Group 2, Census Tract 5091.02, Santa Clara County, California",13,11,2
1000000US060855091022007,060855091022007,"Block 2007, Block Group 2, Census Tract 5091.02, Santa Clara County, California",100,99,1
1000000US060855091022008,060855091022008,"Block 2008, Block Group 2, Census Tract 5091.02, Santa Clara County, California",0,0,0
1000000US060855091022009,060855091022009,"Block 2009, Block Group 2, Census Tract 5091.02, Santa Clara County, California",0,0,0
1000000US060855091022010,060855091022010,"Block 2010, Block Group 2, Census Tract 5091.02, Santa Clara County, California",0,0,0
1000000US060855091022011,060855091022011,"Block 2011, Block Group 2, Census Tract 5091.02, Santa Clara County, California",0,0,0
1000000US060855091022012,060855091022012,"Block 2012, Block Group 2, Census Tract 5091.02, Santa Clara County, California",0,0,0
1000000US060855091022013,060855091022013,"Block 2013, Block Group 2, Census Tract 5091.02, Santa Clara County, California",1,1,0
1000000US060855091022014,060855091022014,"Block 2014, Block Group 2, Census Tract 5091.02, Santa Clara County, California",257,244,13
1000000US060855091022015,060855091022015,"Block 2015, Block Group 2, Census Tract 5091.02, Santa Clara County, California",0,0,0
1000000US060855091022016,060855091022016,"Block 2016, Block Group 2, Census Tract 5091.02, Santa Clara County, California",27,27,0
1000000US060855091022017,060855091022017,"Block 2017, Block Group 2, Census Tract 5091.02, Santa Clara County, California",12,11,1
1000000US060855091022018,060855091022018,"Block 2018, Block Group 2, Census Tract 5091.02, Santa Clara County, California",36,33,3
1000000US060855091022019,060855091022019,"Block 2019, Block Group 2, Census Tract 5091.02, Santa Clara County, California",8,7,1
1000000US060855091022020,060855091022020,"Block 2020, Block Group 2, Census Tract 5091.02, Santa Clara County, California",0,0,0
1000000US060855091022021,060855091022021,"Block 2021, Block Group 2, Census Tract 5091.02, Santa Clara County, California",64,59,5
1000000US060855091022022,060855091022022,"Block 2022, Block Group 2, Census Tract 5091.02, Santa Clara County, California",0,0,0
1000000US060855091022023,060855091022023,"Block 2023, Block Group 2, Census Tract 5091.02, Santa Clara County, California",0,0,0
1000000US060855091022024,060855091022024,"Block 2024, Block Group 2, Census Tract 5091.02, Santa Clara County, California",107,99,8
1000000US060855091051000,060855091051000,"Block 1000, Block Group 1, Census Tract 5091.05, Santa Clara County, California",0,0,0
1000000US060855091051001,060855091051001,"Block 1001, Block Group 1, Census Tract 5091.05, Santa Clara County, California",0,0,0
1000000US060855091051002,060855091051002,"Block 1002, Block Group 1, Census Tract 5091.05, Santa Clara County, California",0,0,0
1000000US060855091051003,060855091051003,"Block 1003, Block Group 1, Census Tract 5091.05, Santa Clara County, California",0,0,0
1000000US060855091051004,060855091051004,"Block 1004, Block Group 1, Census Tract 5091.05, Santa Clara County, California",0,0,0
1000000US060855091051005,060855091051005,"Block 1005, Block Group 1, Census Tract 5091.05, Santa Clara County, California",0,0,0
1000000US060855091051006,060855091051006,"Block 1006, Block Group 1, Census Tract 5091.05, Santa Clara County, California",0,0,0
1000000US060855091051007,060855091051007,"Block 1007, Block Group 1, Census Tract 5091.05, Santa Clara County, California",37,8,29
1000000US060855091051008,060855091051008,"Block 1008, Block Group 1, Census Tract 5091.05, Santa Clara County, California",16,9,7
1000000US060855091051009,060855091051009,"Block 1009, Block Group 1, Census Tract 5091.05, Santa Clara County, California",0,0,0
1000000US060855091051010,060855091051010,"Block 1010, Block Group 1, Census Tract 5091.05, Santa Clara County, California",0,0,0
1000000US060855091051011,060855091051011,"Block 1011, Block Group 1, Census Tract 5091.05, Santa Clara County, California",0,0,0
1000000US060855091051012,060855091051012,"Block 1012, Block Group 1, Census Tract 5091.05, Santa Clara County, California",0,0,0
1000000US060855091051013,060855091051013,"Block 1013, Block Group 1, Census Tract 5091.05, Santa Clara County, California",113,96,17
1000000US060855091051014,060855091051014,"Block 1014, Block Group 1, Census Tract 5091.05, Santa Clara County, California",24,23,1
1000000US060855091051015,060855091051015,"Block 1015, Block Group 1, Census Tract 5091.05, Santa Clara County, California",0,0,0
1000000US060855091051016,060855091051016,"Block 1016, Block Group 1, Census Tract 5091.05, Santa Clara County, California",0,0,0
1000000US060855091051017,060855091051017,"Block 1017, Block Group 1, Census Tract 5091.05, Santa Clara County, California",14,12,2
1000000US060855091051018,060855091051018,"Block 1018, Block Group 1, Census Tract 5091.05, Santa Clara County, California",28,28,0
1000000US060855091051019,060855091051019,"Block 1019, Block Group 1, Census Tract 5091.05, Santa Clara County, California",6,5,1
1000000US060855091051020,060855091051020,"Block 1020, Block Group 1, Census Tract 5091.05, Santa Clara County, California",0,0,0
1000000US060855091051021,060855091051021,"Block 1021, Block Group 1, Census Tract 5091.05, Santa Clara County, California",22,21,1
1000000US060855091051022,060855091051022,"Block 1022, Block Group 1, Census Tract 5091.05, Santa Clara County, California",50,46,4
1000000US060855091051023,060855091051023,"Block 1023, Block Group 1, Census Tract 5091.05, Santa Clara County, California",5,0,5
1000000US060855091051024,060855091051024,"Block 1024, Block Group 1, Census Tract 5091.05, Santa Clara County, California",13,13,0
1000000US060855091051025,060855091051025,"Block 1025, Block Group 1, Census Tract 5091.05, Santa Clara County, California",43,42,1
1000000US060855091051026,060855091051026,"Block 1026, Block Group 1, Census Tract 5091.05, Santa Clara County, California",11,0,11
1000000US060855091051027,060855091051027,"Block 1027, Block Group 1, Census Tract 5091.05, Santa Clara County, California",0,0,0
1000000US060855091051028,060855091051028,"Block 1028, Block Group 1, Census Tract 5091.05, Santa Clara County, California",139,135,4
1000000US060855091051029,060855091051029,"Block 1029, Block Group 1, Census Tract 5091.05, Santa Clara County, California",248,234,14
1000000US060855091051030,060855091051030,"Block 1030, Block Group 1, Census Tract 5091.05, Santa Clara County, California",0,0,0
1000000US060855091051031,060855091051031,"Block 1031, Block Group 1, Census Tract 5091.05, Santa Clara County, California",42,42,0
1000000US060855091051032,060855091051032,"Block 1032, Block Group 1, Census Tract 5091.05, Santa Clara County, California",0,0,0
1000000US060855091051033,060855091051033,"Block 1033, Block Group 1, Census Tract 5091.05, Santa Clara County, California",36,36,0
1000000US060855091051034,060855091051034,"Block 1034, Block Group 1, Census Tract 5091.05, Santa Clara County, California",0,0,0
1000000US060855091051035,060855091051035,"Block 1035, Block Group 1, Census Tract 5091.05, Santa Clara County, California",49,45,4
1000000US060855091051036,060855091051036,"Block 1036, Block Group 1, Census Tract 5091.05, Santa Clara County, California",0,0,0
1000000US060855091051037,060855091051037,"Block 1037, Block Group 1, Census Tract 5091.05, Santa Clara County, California",8,8,0
1000000US060855091051038,060855091051038,"Block 1038, Block Group 1, Census Tract 5091.05, Santa Clara County, California",42,40,2
1000000US060855091051039,060855091051039,"Block 1039, Block Group 1, Census Tract 5091.05, Santa Clara County, California",1,1,0
1000000US060855091051040,060855091051040,"Block 1040, Block Group 1, Census Tract 5091.05, Santa Clara County, California",0,0,0
1000000US060855091051041,060855091051041,"Block 1041, Block Group 1, Census Tract 5091.05, Santa Clara County, California",14,12,2
1000000US060855091052000,060855091052000,"Block 2000, Block Group 2, Census Tract 5091.05, Santa Clara County, California",1,1,0
1000000US060855091052001,060855091052001,"Block 2001, Block Group 2, Census Tract 5091.05, Santa Clara County, California",0,0,0
1000000US060855091052002,060855091052002,"Block 2002, Block Group 2, Census Tract 5091.05, Santa Clara County, California",13,12,1
1000000US060855091052003,060855091052003,"Block 2003, Block Group 2, Census Tract 5091.05, Santa Clara County, California",0,0,0
1000000US060855091052004,060855091052004,"Block 2004, Block Group 2, Census Tract 5091.05, Santa Clara County, California",262,249,13
1000000US060855091052005,060855091052005,"Block 2005, Block Group 2, Census Tract 5091.05, Santa Clara County, California",132,130,2
1000000US060855091052006,060855091052006,"Block 2006, Block Group 2, Census Tract 5091.05, Santa Clara County, California",0,0,0
1000000US060855091052007,060855091052007,"Block 2007, Block Group 2, Census Tract 5091.05, Santa Clara County, California",0,0,0
1000000US060855091052008,060855091052008,"Block 2008, Block Group 2, Census Tract 5091.05, Santa Clara County, California",0,0,0
1000000US060855091052009,060855091052009,"Block 2009, Block Group 2, Census Tract 5091.05, Santa Clara County, California",66,63,3
1000000US060855091052010,060855091052010,"Block 2010, Block Group 2, Census Tract 5091.05, Santa Clara County, California",0,0,0
1000000US060855091052011,060855091052011,"Block 2011, Block Group 2, Census Tract 5091.05, Santa Clara County, California",144,139,5
1000000US060855091052012,060855091052012,"Block 2012, Block Group 2, Census Tract 5091.05, Santa Clara County, California",40,39,1
1000000US060855091052013,060855091052013,"Block 2013, Block Group 2, Census Tract 5091.05, Santa Clara County, California",1,1,0
1000000US060855091052014,060855091052014,"Block 2014, Block Group 2, Census Tract 5091.05, Santa Clara County, California",10,10,0
1000000US060855091052015,060855091052015,"Block 2015, Block Group 2, Census Tract 5091.05, Santa Clara County, California",0,0,0
1000000US060855091052016,060855091052016,"Block 2016, Block Group 2, Census Tract 5091.05, Santa Clara County, California",24,24,0
1000000US060855091052017,060855091052017,"Block 2017, Block Group 2, Census Tract 5091.05, Santa Clara County, California",72,70,2
1000000US060855091052018,060855091052018,"Block 2018, Block Group 2, Census Tract 5091.05, Santa Clara County, California",17,15,2
1000000US060855091052019,060855091052019,"Block 2019, Block Group 2, Census Tract 5091.05, Santa Clara County, California",14,14,0
1000000US060855091053000,060855091053000,"Block 3000, Block Group 3, Census Tract 5091.05, Santa Clara County, California",90,80,10
1000000US060855091053001,060855091053001,"Block 3001, Block Group 3, Census Tract 5091.05, Santa Clara County, California",178,150,28
1000000US060855091053002,060855091053002,"Block 3002, Block Group 3, Census Tract 5091.05, Santa Clara County, California",0,0,0
1000000US060855091053003,060855091053003,"Block 3003, Block Group 3, Census Tract 5091.05, Santa Clara County, California",0,0,0
1000000US060855091053004,060855091053004,"Block 3004, Block Group 3, Census Tract 5091.05, Santa Clara County, California",0,0,0
1000000US060855091053005,060855091053005,"Block 3005, Block Group 3, Census Tract 5091.05, Santa Clara County, California",0,0,0
1000000US060855091053006,060855091053006,"Block 3006, Block Group 3, Census Tract 5091.05, Santa Clara County, California",46,42,4
1000000US060855091053007,060855091053007,"Block 3007, Block Group 3, Census Tract 5091.05, Santa Clara County, California",42,41,1
1000000US060855091053008,060855091053008,"Block 3008, Block Group 3, Census Tract 5091.05, Santa Clara County, California",0,0,0
1000000US060855091053009,060855091053009,"Block 3009, Block Group 3, Census Tract 5091.05, Santa Clara County, California",52,51,1
1000000US060855091053010,060855091053010,"Block 3010, Block Group 3, Census Tract 5091.05, Santa Clara County, California",33,32,1
1000000US060855091053011,060855091053011,"Block 3011, Block Group 3, Census Tract 5091.05, Santa Clara County, California",98,96,2
1000000US060855091053012,060855091053012,"Block 3012, Block Group 3, Census Tract 5091.05, Santa Clara County, California",14,14,0
1000000US060855091053013,060855091053013,"Block 3013, Block Group 3, Census Tract 5091.05, Santa Clara County, California",6,5,1
1000000US060855091053014,060855091053014,"Block 3014, Block Group 3, Census Tract 5091.05, Santa Clara County, California",132,127,5
1000000US060855091053015,060855091053015,"Block 3015, Block Group 3, Census Tract 5091.05, Santa Clara County, California",0,0,0
1000000US060855091054000,060855091054000,"Block 4000, Block Group 4, Census Tract 5091.05, Santa Clara County, California",225,218,7
1000000US060855091054001,060855091054001,"Block 4001, Block Group 4, Census Tract 5091.05, Santa Clara County, California",0,0,0
1000000US060855091054002,060855091054002,"Block 4002, Block Group 4, Census Tract 5091.05, Santa Clara County, California",0,0,0
1000000US060855091054003,060855091054003,"Block 4003, Block Group 4, Census Tract 5091.05, Santa Clara County, California",0,0,0
1000000US060855091054004,060855091054004,"Block 4004, Block Group 4, Census Tract 5091.05, Santa Clara County, California",543,521,22
1000000US060855091061000,060855091061000,"Block 1000, Block Group 1, Census Tract 5091.06, Santa Clara County, California",0,0,0
1000000US060855091061001,060855091061001,"Block 1001, Block Group 1, Census Tract 5091.06, Santa Clara County, California",0,0,0
1000000US060855091061002,060855091061002,"Block 1002, Block Group 1, Census Tract 5091.06, Santa Clara County, California",333,322,11
1000000US060855091061003,060855091061003,"Block 1003, Block Group 1, Census Tract 5091.06, Santa Clara County, California",84,82,2
1000000US060855091061004,060855091061004,"Block 1004, Block Group 1, Census Tract 5091.06, Santa Clara County, California",82,80,2
1000000US060855091061005,060855091061005,"Block 1005, Block Group 1, Census Tract 5091.06, Santa Clara County, California",10,10,0
1000000US060855091061006,060855091061006,"Block 1006, Block Group 1, Census Tract 5091.06, Santa Clara County, California",35,35,0
1000000US060855091061007,060855091061007,"Block 1007, Block Group 1, Census Tract 5091.06, Santa Clara County, California",72,70,2
1000000US060855091062000,060855091062000,"Block 2000, Block Group 2, Census Tract 5091.06, Santa Clara County, California",11,11,0
1000000US060855091062001,060855091062001,"Block 2001, Block Group 2, Census Tract 5091.06, Santa Clara County, California",50,48,2
1000000US060855091062002,060855091062002,"Block 2002, Block Group 2, Census Tract 5091.06, Santa Clara County, California",80,76,4
1000000US060855091062003,060855091062003,"Block 2003, Block Group 2, Census Tract 5091.06, Santa Clara County, California",11,11,0
1000000US060855091062004,060855091062004,"Block 2004, Block Group 2, Census Tract 5091.06, Santa Clara County, California",12,12,0
1000000US060855091062005,060855091062005,"Block 2005, Block Group 2, Census Tract 5091.06, Santa Clara County, California",13,13,0
1000000US060855091062006,060855091062006,"Block 2006, Block Group 2, Census Tract 5091.06, Santa Clara County, California",74,69,5
1000000US060855091062007,060855091062007,"Block 2007, Block Group 2, Census Tract 5091.06, Santa Clara County, California",30,30,0
1000000US060855091062008,060855091062008,"Block 2008, Block Group 2, Census Tract 5091.06, Santa Clara County, California",55,52,3
1000000US060855091062009,060855091062009,"Block 2009, Block Group 2, Census Tract 5091.06, Santa Clara County, California",32,31,1
1000000US060855091062010,060855091062010,"Block 2010, Block Group 2, Census Tract 5091.06, Santa Clara County, California",45,44,1
1000000US060855091062011,060855091062011,"Block 2011, Block Group 2, Census Tract 5091.06, Santa Clara County, California",10,10,0
1000000US060855091063000,060855091063000,"Block 3000, Block Group 3, Census Tract 5091.06, Santa Clara County, California",99,99,0
1000000US060855091063001,060855091063001,"Block 3001, Block Group 3, Census Tract 5091.06, Santa Clara County, California",331,305,26
1000000US060855091063002,060855091063002,"Block 3002, Block Group 3, Census Tract 5091.06, Santa Clara County, California",32,32,0
1000000US060855091063003,060855091063003,"Block 3003, Block Group 3, Census Tract 5091.06, Santa Clara County, California",99,95,4
1000000US060855091063004,060855091063004,"Block 3004, Block Group 3, Census Tract 5091.06, Santa Clara County, California",24,23,1
1000000US060855091063005,060855091063005,"Block 3005, Block Group 3, Census Tract 5091.06, Santa Clara County, California",76,74,2
1000000US060855091063006,060855091063006,"Block 3006, Block Group 3, Census Tract 5091.06, Santa Clara County, California",106,100,6
1000000US060855091063007,060855091063007,"Block 3007, Block Group 3, Census Tract 5091.06, Santa Clara County, California",0,0,0
1000000US060855091063008,060855091063008,"Block 3008, Block Group 3, Census Tract 5091.06, Santa Clara County, California",0,0,0
1000000US060855091063009,060855091063009,"Block 3009, Block Group 3, Census Tract 5091.06, Santa Clara County, California",0,0,0
1000000US060855091071000,060855091071000,"Block 1000, Block Group 1, Census Tract 5091.07, Santa Clara County, California",175,161,14
1000000US060855091071001,060855091071001,"Block 1001, Block Group 1, Census Tract 5091.07, Santa Clara County, California",200,179,21
1000000US060855091071002,060855091071002,"Block 1002, Block Group 1, Census Tract 5091.07, Santa Clara County, California",60,58,2
1000000US060855091071003,060855091071003,"Block 1003, Block Group 1, Census Tract 5091.07, Santa Clara County, California",197,182,15
1000000US060855091071004,060855091071004,"Block 1004, Block Group 1, Census Tract 5091.07, Santa Clara County, California",118,112,6
1000000US060855091071005,060855091071005,"Block 1005, Block Group 1, Census Tract 5091.07, Santa Clara County, California",14,14,0
1000000US060855091072000,060855091072000,"Block 2000, Block Group 2, Census Tract 5091.07, Santa Clara County, California",314,300,14
1000000US060855091072001,060855091072001,"Block 2001, Block Group 2, Census Tract 5091.07, Santa Clara County, California",14,11,3
1000000US060855091072002,060855091072002,"Block 2002, Block Group 2, Census Tract 5091.07, Santa Clara County, California",44,41,3
1000000US060855091072003,060855091072003,"Block 2003, Block Group 2, Census Tract 5091.07, Santa Clara County, California",204,196,8
1000000US060855091072004,060855091072004,"Block 2004, Block Group 2, Census Tract 5091.07, Santa Clara County, California",110,104,6
1000000US060855091072005,060855091072005,"Block 2005, Block Group 2, Census Tract 5091.07, Santa Clara County, California",45,42,3
1000000US060855091072006,060855091072006,"Block 2006, Block Group 2, Census Tract 5091.07, Santa Clara County, California",279,260,19
1000000US060855091072007,060855091072007,"Block 2007, Block Group 2, Census Tract 5091.07, Santa Clara County, California",46,46,0
1000000US060855091072008,060855091072008,"Block 2008, Block Group 2, Census Tract 5091.07, Santa Clara County, California",46,45,1
1000000US060855091072009,060855091072009,"Block 2009, Block Group 2, Census Tract 5091.07, Santa Clara County, California",0,0,0
1000000US060855091072010,060855091072010,"Block 2010, Block Group 2, Census Tract 5091.07, Santa Clara County, California",0,0,0
1000000US060855091072011,060855091072011,"Block 2011, Block Group 2, Census Tract 5091.07, Santa Clara County, California",0,0,0
1000000US060855091072012,060855091072012,"Block 2012, Block Group 2, Census Tract 5091.07, Santa Clara County, California",22,21,1
1000000US060855091072013,060855091072013,"Block 2013, Block Group 2, Census Tract 5091.07, Santa Clara County, California",141,130,11
1000000US060855091072014,060855091072014,"Block 2014, Block Group 2, Census Tract 5091.07, Santa Clara County, California",0,0,0
1000000US060855091081000,060855091081000,"Block 1000, Block Group 1, Census Tract 5091.08, Santa Clara County, California",0,0,0
1000000US060855091081001,060855091081001,"Block 1001, Block Group 1, Census Tract 5091.08, Santa Clara County, California",52,48,4
1000000US060855091081002,060855091081002,"Block 1002, Block Group 1, Census Tract 5091.08, Santa Clara County, California",27,27,0
1000000US060855091081003,060855091081003,"Block 1003, Block Group 1, Census Tract 5091.08, Santa Clara County, California",0,0,0
1000000US060855091081004,060855091081004,"Block 1004, Block Group 1, Census Tract 5091.08, Santa Clara County, California",0,0,0
1000000US060855091081005,060855091081005,"Block 1005, Block Group 1, Census Tract 5091.08, Santa Clara County, California",0,0,0
1000000US060855091081006,060855091081006,"Block 1006, Block Group 1, Census Tract 5091.08, Santa Clara County, California",0,0,0
1000000US060855091081007,060855091081007,"Block 1007, Block Group 1, Census Tract 5091.08, Santa Clara County, California",0,0,0
1000000US060855091081008,060855091081008,"Block 1008, Block Group 1, Census Tract 5091.08, Santa Clara County, California",50,48,2
1000000US060855091081009,060855091081009,"Block 1009, Block Group 1, Census Tract 5091.08, Santa Clara County, California",11,9,2
1000000US060855091081010,060855091081010,"Block 1010, Block Group 1, Census Tract 5091.08, Santa Clara County, California",189,186,3
1000000US060855091081011,060855091081011,"Block 1011, Block Group 1, Census Tract 5091.08, Santa Clara County, California",35,34,1
1000000US060855091081012,060855091081012,"Block 1012, Block Group 1, Census Tract 5091.08, Santa Clara County, California",87,87,0
1000000US060855091081013,060855091081013,"Block 1013, Block Group 1, Census Tract 5091.08, Santa Clara County, California",50,48,2
1000000US060855091082000,060855091082000,"Block 2000, Block Group 2, Census Tract 5091.08, Santa Clara County, California",0,0,0
1000000US060855091082001,060855091082001,"Block 2001, Block Group 2, Census Tract 5091.08, Santa Clara County, California",0,0,0
1000000US060855091082002,060855091082002,"Block 2002, Block Group 2, Census Tract 5091.08, Santa Clara County, California",139,132,7
1000000US060855091082003,060855091082003,"Block 2003, Block Group 2, Census Tract 5091.08, Santa Clara County, California",0,0,0
1000000US060855091082004,060855091082004,"Block 2004, Block Group 2, Census Tract 5091.08, Santa Clara County, California",0,0,0
1000000US060855091082005,060855091082005,"Block 2005, Block Group 2, Census Tract 5091.08, Santa Clara County, California",0,0,0
1000000US060855091082006,060855091082006,"Block 2006, Block Group 2, Census Tract 5091.08, Santa Clara County, California",0,0,0
1000000US060855091082007,060855091082007,"Block 2007, Block Group 2, Census Tract 5091.08, Santa Clara County, California",55,55,0
1000000US060855091082008,060855091082008,"Block 2008, Block Group 2, Census Tract 5091.08, Santa Clara County, California",34,30,4
1000000US060855091082009,060855091082009,"Block 2009, Block Group 2, Census Tract 5091.08, Santa Clara County, California",17,16,1
1000000US060855091082010,060855091082010,"Block 2010, Block Group 2, Census Tract 5091.08, Santa Clara County, California",67,64,3
1000000US060855091082011,060855091082011,"Block 2011, Block Group 2, Census Tract 5091.08, Santa Clara County, California",114,106,8
1000000US060855091082012,060855091082012,"Block 2012, Block Group 2, Census Tract 5091.08, Santa Clara County, California",42,41,1
1000000US060855091082013,060855091082013,"Block 2013, Block Group 2, Census Tract 5091.08, Santa Clara County, California",0,0,0
1000000US060855091083000,060855091083000,"Block 3000, Block Group 3, Census Tract 5091.08, Santa Clara County, California",0,0,0
1000000US060855091083001,060855091083001,"Block 3001, Block Group 3, Census Tract 5091.08, Santa Clara County, California",116,110,6
1000000US060855091083002,060855091083002,"Block 3002, Block Group 3, Census Tract 5091.08, Santa Clara County, California",4,4,0
1000000US060855091083003,060855091083003,"Block 3003, Block Group 3, Census Tract 5091.08, Santa Clara County, California",41,39,2
1000000US060855091083004,060855091083004,"Block 3004, Block Group 3, Census Tract 5091.08, Santa Clara County, California",0,0,0
1000000US060855091083005,060855091083005,"Block 3005, Block Group 3, Census Tract 5091.08, Santa Clara County, California",45,42,3
1000000US060855091083006,060855091083006,"Block 3006, Block Group 3, Census Tract 5091.08, Santa Clara County, California",105,103,2
1000000US060855091083007,060855091083007,"Block 3007, Block Group 3, Census Tract 5091.08, Santa Clara County, California",71,8,63
1000000US060855091083008,060855091083008,"Block 3008, Block Group 3, Census Tract 5091.08, Santa Clara County, California",69,67,2
1000000US060855091083009,060855091083009,"Block 3009, Block Group 3, Census Tract 5091.08, Santa Clara County, California",10,10,0
1000000US060855091084000,060855091084000,"Block 4000, Block Group 4, Census Tract 5091.08, Santa Clara County, California",0,0,0
1000000US060855091084001,060855091084001,"Block 4001, Block Group 4, Census Tract 5091.08, Santa Clara County, California",0,0,0
1000000US060855091084002,060855091084002,"Block 4002, Block Group 4, Census Tract 5091.08, Santa Clara County, California",0,0,0
1000000US060855091084003,060855091084003,"Block 4003, Block Group 4, Census Tract 5091.08, Santa Clara County, California",0,0,0
1000000US060855091084004,060855091084004,"Block 4004, Block Group 4, Census Tract 5091.08, Santa Clara County, California",0,0,0
1000000US060855091084005,060855091084005,"Block 4005, Block Group 4, Census Tract 5091.08, Santa Clara County, California",0,0,0
1000000US060855091084006,060855091084006,"Block 4006, Block Group 4, Census Tract 5091.08, Santa Clara County, California",0,0,0
1000000US060855091084007,060855091084007,"Block 4007, Block Group 4, Census Tract 5091.08, Santa Clara County, California",0,0,0
1000000US060855091084008,060855091084008,"Block 4008, Block Group 4, Census Tract 5091.08, Santa Clara County, California",0,0,0
1000000US060855091084009,060855091084009,"Block 4009, Block Group 4, Census Tract 5091.08, Santa Clara County, California",0,0,0
1000000US060855091084010,060855091084010,"Block 4010, Block Group 4, Census Tract 5091.08, Santa Clara County, California",0,0,0
1000000US060855091084011,060855091084011,"Block 4011, Block Group 4, Census Tract 5091.08, Santa Clara County, California",0,0,0
1000000US060855091084012,060855091084012,"Block 4012, Block Group 4, Census Tract 5091.08, Santa Clara County, California",0,0,0
1000000US060855091084013,060855091084013,"Block 4013, Block Group 4, Census Tract 5091.08, Santa Clara County, California",0,0,0
1000000US060855091084014,060855091084014,"Block 4014, Block Group 4, Census Tract 5091.08, Santa Clara County, California",0,0,0
1000000US060855091084015,060855091084015,"Block 4015, Block Group 4, Census Tract 5091.08, Santa Clara County, California",0,0,0
1000000US060855091084016,060855091084016,"Block 4016, Block Group 4, Census Tract 5091.08, Santa Clara County, California",0,0,0
1000000US060855091084017,060855091084017,"Block 4017, Block Group 4, Census Tract 5091.08, Santa Clara County, California",0,0,0
1000000US060855091084018,060855091084018,"Block 4018, Block Group 4, Census Tract 5091.08, Santa Clara County, California",0,0,0
1000000US060855091084019,060855091084019,"Block 4019, Block Group 4, Census Tract 5091.08, Santa Clara County, California",0,0,0
1000000US060855091084020,060855091084020,"Block 4020, Block Group 4, Census Tract 5091.08, Santa Clara County, California",0,0,0
1000000US060855091084021,060855091084021,"Block 4021, Block Group 4, Census Tract 5091.08, Santa Clara County, California",0,0,0
1000000US060855091084022,060855091084022,"Block 4022, Block Group 4, Census Tract 5091.08, Santa Clara County, California",0,0,0
1000000US060855091084023,060855091084023,"Block 4023, Block Group 4, Census Tract 5091.08, Santa Clara County, California",0,0,0
1000000US060855091084024,060855091084024,"Block 4024, Block Group 4, Census Tract 5091.08, Santa Clara County, California",0,0,0
1000000US060855091084025,060855091084025,"Block 4025, Block Group 4, Census Tract 5091.08, Santa Clara County, California",0,0,0
1000000US060855091084026,060855091084026,"Block 4026, Block Group 4, Census Tract 5091.08, Santa Clara County, California",0,0,0
1000000US060855091084027,060855091084027,"Block 4027, Block Group 4, Census Tract 5091.08, Santa Clara County, California",0,0,0
1000000US060855091084028,060855091084028,"Block 4028, Block Group 4, Census Tract 5091.08, Santa Clara County, California",0,0,0
1000000US060855091084029,060855091084029,"Block 4029, Block Group 4, Census Tract 5091.08, Santa Clara County, California",0,0,0
1000000US060855091084030,060855091084030,"Block 4030, Block Group 4, Census Tract 5091.08, Santa Clara County, California",0,0,0
1000000US060855091084031,060855091084031,"Block 4031, Block Group 4, Census Tract 5091.08, Santa Clara County, California",0,0,0
1000000US060855091084032,060855091084032,"Block 4032, Block Group 4, Census Tract 5091.08, Santa Clara County, California",0,0,0
1000000US060855091084033,060855091084033,"Block 4033, Block Group 4, Census Tract 5091.08, Santa Clara County, California",65,63,2
1000000US060855091084034,060855091084034,"Block 4034, Block Group 4, Census Tract 5091.08, Santa Clara County, California",173,168,5
1000000US060855091084035,060855091084035,"Block 4035, Block Group 4, Census Tract 5091.08, Santa Clara County, California",129,128,1
1000000US060855091084036,060855091084036,"Block 4036, Block Group 4, Census Tract 5091.08, Santa Clara County, California",44,44,0
1000000US060855091084037,060855091084037,"Block 4037, Block Group 4, Census Tract 5091.08, Santa Clara County, California",1,1,0
1000000US060855091084038,060855091084038,"Block 4038, Block Group 4, Census Tract 5091.08, Santa Clara County, California",0,0,0
1000000US060855091084039,060855091084039,"Block 4039, Block Group 4, Census Tract 5091.08, Santa Clara County, California",0,0,0
1000000US060855091084040,060855091084040,"Block 4040, Block Group 4, Census Tract 5091.08, Santa Clara County, California",0,0,0
1000000US060855091084041,060855091084041,"Block 4041, Block Group 4, Census Tract 5091.08, Santa Clara County, California",0,0,0
1000000US060855091084042,060855091084042,"Block 4042, Block Group 4, Census Tract 5091.08, Santa Clara County, California",67,64,3
1000000US060855091084043,060855091084043,"Block 4043, Block Group 4, Census Tract 5091.08, Santa Clara County, California",16,15,1
1000000US060855091084044,060855091084044,"Block 4044, Block Group 4, Census Tract 5091.08, Santa Clara County, California",58,55,3
1000000US060855091084045,060855091084045,"Block 4045, Block Group 4, Census Tract 5091.08, Santa Clara County, California",0,0,0
1000000US060855091084046,060855091084046,"Block 4046, Block Group 4, Census Tract 5091.08, Santa Clara County, California",0,0,0
1000000US060855091084047,060855091084047,"Block 4047, Block Group 4, Census Tract 5091.08, Santa Clara County, California",0,0,0
1000000US060855091084048,060855091084048,"Block 4048, Block Group 4, Census Tract 5091.08, Santa Clara County, California",0,0,0
1000000US060855091084049,060855091084049,"Block 4049, Block Group 4, Census Tract 5091.08, Santa Clara County, California",0,0,0
1000000US060855091084050,060855091084050,"Block 4050, Block Group 4, Census Tract 5091.08, Santa Clara County, California",0,0,0
1000000US060855091084051,060855091084051,"Block 4051, Block Group 4, Census Tract 5091.08, Santa Clara County, California",0,0,0
1000000US060855091084052,060855091084052,"Block 4052, Block Group 4, Census Tract 5091.08, Santa Clara County, California",0,0,0
1000000US060855091084053,060855091084053,"Block 4053, Block Group 4, Census Tract 5091.08, Santa Clara County, California",0,0,0
1000000US060855091084054,060855091084054,"Block 4054, Block Group 4, Census Tract 5091.08, Santa Clara County, California",0,0,0
1000000US060855091084055,060855091084055,"Block 4055, Block Group 4, Census Tract 5091.08, Santa Clara County, California",0,0,0
1000000US060855091084056,060855091084056,"Block 4056, Block Group 4, Census Tract 5091.08, Santa Clara County, California",0,0,0
1000000US060855091084057,060855091084057,"Block 4057, Block Group 4, Census Tract 5091.08, Santa Clara County, California",0,0,0
1000000US060855091084058,060855091084058,"Block 4058, Block Group 4, Census Tract 5091.08, Santa Clara County, California",0,0,0
1000000US060855091084059,060855091084059,"Block 4059, Block Group 4, Census Tract 5091.08, Santa Clara County, California",0,0,0
1000000US060855091091000,060855091091000,"Block 1000, Block Group 1, Census Tract 5091.09, Santa Clara County, California",0,0,0
1000000US060855091091001,060855091091001,"Block 1001, Block Group 1, Census Tract 5091.09, Santa Clara County, California",0,0,0
1000000US060855091091002,060855091091002,"Block 1002, Block Group 1, Census Tract 5091.09, Santa Clara County, California",192,180,12
1000000US060855091091003,060855091091003,"Block 1003, Block Group 1, Census Tract 5091.09, Santa Clara County, California",0,0,0
1000000US060855091091004,060855091091004,"Block 1004, Block Group 1, Census Tract 5091.09, Santa Clara County, California",0,0,0
1000000US060855091091005,060855091091005,"Block 1005, Block Group 1, Census Tract 5091.09, Santa Clara County, California",144,134,10
1000000US060855091091006,060855091091006,"Block 1006, Block Group 1, Census Tract 5091.09, Santa Clara County, California",84,78,6
1000000US060855091091007,060855091091007,"Block 1007, Block Group 1, Census Tract 5091.09, Santa Clara County, California",0,0,0
1000000US060855091091008,060855091091008,"Block 1008, Block Group 1, Census Tract 5091.09, Santa Clara County, California",0,0,0
1000000US060855091091009,060855091091009,"Block 1009, Block Group 1, Census Tract 5091.09, Santa Clara County, California",63,59,4
1000000US060855091091010,060855091091010,"Block 1010, Block Group 1, Census Tract 5091.09, Santa Clara County, California",126,120,6
1000000US060855091091011,060855091091011,"Block 1011, Block Group 1, Census Tract 5091.09, Santa Clara County, California",6,6,0
1000000US060855091091012,060855091091012,"Block 1012, Block Group 1, Census Tract 5091.09, Santa Clara County, California",88,86,2
1000000US060855091091013,060855091091013,"Block 1013, Block Group 1, Census Tract 5091.09, Santa Clara County, California",49,49,0
1000000US060855091091014,060855091091014,"Block 1014, Block Group 1, Census Tract 5091.09, Santa Clara County, California",27,25,2
1000000US060855091091015,060855091091015,"Block 1015, Block Group 1, Census Tract 5091.09, Santa Clara County, California",65,62,3
1000000US060855091091016,060855091091016,"Block 1016, Block Group 1, Census Tract 5091.09, Santa Clara County, California",171,166,5
1000000US060855091091017,060855091091017,"Block 1017, Block Group 1, Census Tract 5091.09, Santa Clara County, California",57,57,0
1000000US060855091091018,060855091091018,"Block 1018, Block Group 1, Census Tract 5091.09, Santa Clara County, California",1,1,0
1000000US060855091091019,060855091091019,"Block 1019, Block Group 1, Census Tract 5091.09, Santa Clara County, California",12,12,0
1000000US060855091091020,060855091091020,"Block 1020, Block Group 1, Census Tract 5091.09, Santa Clara County, California",1,1,0
1000000US060855091091021,060855091091021,"Block 1021, Block Group 1, Census Tract 5091.09, Santa Clara County, California",0,0,0
1000000US060855091091022,060855091091022,"Block 1022, Block Group 1, Census Tract 5091.09, Santa Clara County, California",0,0,0
1000000US060855091091023,060855091091023,"Block 1023, Block Group 1, Census Tract 5091.09, Santa Clara County, California",0,0,0
1000000US060855091091024,060855091091024,"Block 1024, Block Group 1, Census Tract 5091.09, Santa Clara County, California",0,0,0
1000000US060855091091025,060855091091025,"Block 1025, Block Group 1, Census Tract 5091.09, Santa Clara County, California",0,0,0
1000000US060855091091026,060855091091026,"Block 1026, Block Group 1, Census Tract 5091.09, Santa Clara County, California",0,0,0
1000000US060855091091027,060855091091027,"Block 1027, Block Group 1, Census Tract 5091.09, Santa Clara County, California",0,0,0
1000000US060855091091028,060855091091028,"Block 1028, Block Group 1, Census Tract 5091.09, Santa Clara County, California",0,0,0
1000000US060855091091029,060855091091029,"Block 1029, Block Group 1, Census Tract 5091.09, Santa Clara County, California",213,211,2
1000000US060855091091030,060855091091030,"Block 1030, Block Group 1, Census Tract 5091.09, Santa Clara County, California",0,0,0
1000000US060855091091031,060855091091031,"Block 1031, Block Group 1, Census Tract 5091.09, Santa Clara County, California",0,0,0
1000000US060855091091032,060855091091032,"Block 1032, Block Group 1, Census Tract 5091.09, Santa Clara County, California",0,0,0
1000000US060855091091033,060855091091033,"Block 1033, Block Group 1, Census Tract 5091.09, Santa Clara County, California",0,0,0
1000000US060855091091034,060855091091034,"Block 1034, Block Group 1, Census Tract 5091.09, Santa Clara County, California",0,0,0
1000000US060855091091035,060855091091035,"Block 1035, Block Group 1, Census Tract 5091.09, Santa Clara County, California",0,0,0
1000000US060855091091036,060855091091036,"Block 1036, Block Group 1, Census Tract 5091.09, Santa Clara County, California",0,0,0
1000000US060855091091037,060855091091037,"Block 1037, Block Group 1, Census Tract 5091.09, Santa Clara County, California",1,1,0
1000000US060855091091038,060855091091038,"Block 1038, Block Group 1, Census Tract 5091.09, Santa Clara County, California",0,0,0
1000000US060855091091039,060855091091039,"Block 1039, Block Group 1, Census Tract 5091.09, Santa Clara County, California",0,0,0
1000000US060855091091040,060855091091040,"Block 1040, Block Group 1, Census Tract 5091.09, Santa Clara County, California",0,0,0
1000000US060855091091041,060855091091041,"Block 1041, Block Group 1, Census Tract 5091.09, Santa Clara County, California",0,0,0
1000000US060855091091042,060855091091042,"Block 1042, Block Group 1, Census Tract 5091.09, Santa Clara County, California",0,0,0
1000000US060855091092000,060855091092000,"Block 2000, Block Group 2, Census Tract 5091.09, Santa Clara County, California",0,0,0
1000000US060855091092001,060855091092001,"Block 2001, Block Group 2, Census Tract 5091.09, Santa Clara County, California",215,208,7
1000000US060855091092002,060855091092002,"Block 2002, Block Group 2, Census Tract 5091.09, Santa Clara County, California",19,18,1
1000000US060855091092003,060855091092003,"Block 2003, Block Group 2, Census Tract 5091.09, Santa Clara County, California",48,47,1
1000000US060855091092004,060855091092004,"Block 2004, Block Group 2, Census Tract 5091.09, Santa Clara County, California",58,56,2
1000000US060855091092005,060855091092005,"Block 2005, Block Group 2, Census Tract 5091.09, Santa Clara County, California",0,0,0
1000000US060855091092006,060855091092006,"Block 2006, Block Group 2, Census Tract 5091.09, Santa Clara County, California",23,23,0
1000000US060855091092007,060855091092007,"Block 2007, Block Group 2, Census Tract 5091.09, Santa Clara County, California",27,27,0
1000000US060855091092008,060855091092008,"Block 2008, Block Group 2, Census Tract 5091.09, Santa Clara County, California",0,0,0
1000000US060855091092009,060855091092009,"Block 2009, Block Group 2, Census Tract 5091.09, Santa Clara County, California",0,0,0
1000000US060855091092010,060855091092010,"Block 2010, Block Group 2, Census Tract 5091.09, Santa Clara County, California",0,0,0
1000000US060855091092011,060855091092011,"Block 2011, Block Group 2, Census Tract 5091.09, Santa Clara County, California",0,0,0
1000000US060855091092012,060855091092012,"Block 2012, Block Group 2, Census Tract 5091.09, Santa Clara County, California",20,20,0
1000000US060855091092013,060855091092013,"Block 2013, Block Group 2, Census Tract 5091.09, Santa Clara County, California",9,9,0
1000000US060855091092014,060855091092014,"Block 2014, Block Group 2, Census Tract 5091.09, Santa Clara County, California",0,0,0
1000000US060855091092015,060855091092015,"Block 2015, Block Group 2, Census Tract 5091.09, Santa Clara County, California",107,104,3
1000000US060855091092016,060855091092016,"Block 2016, Block Group 2, Census Tract 5091.09, Santa Clara County, California",20,20,0
1000000US060855091092017,060855091092017,"Block 2017, Block Group 2, Census Tract 5091.09, Santa Clara County, California",5,5,0
1000000US060855091092018,060855091092018,"Block 2018, Block Group 2, Census Tract 5091.09, Santa Clara County, California",56,52,4
1000000US060855091092019,060855091092019,"Block 2019, Block Group 2, Census Tract 5091.09, Santa Clara County, California",16,16,0
1000000US060855091092020,060855091092020,"Block 2020, Block Group 2, Census Tract 5091.09, Santa Clara County, California",20,20,0
1000000US060855091092021,060855091092021,"Block 2021, Block Group 2, Census Tract 5091.09, Santa Clara County, California",17,16,1
1000000US060855091092022,060855091092022,"Block 2022, Block Group 2, Census Tract 5091.09, Santa Clara County, California",5,5,0
1000000US060855091092023,060855091092023,"Block 2023, Block Group 2, Census Tract 5091.09, Santa Clara County, California",0,0,0
1000000US060855091092024,060855091092024,"Block 2024, Block Group 2, Census Tract 5091.09, Santa Clara County, California",0,0,0
1000000US060855091092025,060855091092025,"Block 2025, Block Group 2, Census Tract 5091.09, Santa Clara County, California",0,0,0
1000000US060855091092026,060855091092026,"Block 2026, Block Group 2, Census Tract 5091.09, Santa Clara County, California",0,0,0
1000000US060855091092027,060855091092027,"Block 2027, Block Group 2, Census Tract 5091.09, Santa Clara County, California",0,0,0
1000000US060855091092028,060855091092028,"Block 2028, Block Group 2, Census Tract 5091.09, Santa Clara County, California",0,0,0
1000000US060855091092029,060855091092029,"Block 2029, Block Group 2, Census Tract 5091.09, Santa Clara County, California",0,0,0
1000000US060855091092030,060855091092030,"Block 2030, Block Group 2, Census Tract 5091.09, Santa Clara County, California",0,0,0
1000000US060855091092031,060855091092031,"Block 2031, Block Group 2, Census Tract 5091.09, Santa Clara County, California",0,0,0
1000000US060855091092032,060855091092032,"Block 2032, Block Group 2, Census Tract 5091.09, Santa Clara County, California",0,0,0
1000000US060855091092033,060855091092033,"Block 2033, Block Group 2, Census Tract 5091.09, Santa Clara County, California",0,0,0
1000000US060855091092034,060855091092034,"Block 2034, Block Group 2, Census Tract 5091.09, Santa Clara County, California",0,0,0
1000000US060855091092035,060855091092035,"Block 2035, Block Group 2, Census Tract 5091.09, Santa Clara County, California",0,0,0
1000000US060855091092036,060855091092036,"Block 2036, Block Group 2, Census Tract 5091.09, Santa Clara County, California",0,0,0
1000000US060855091092037,060855091092037,"Block 2037, Block Group 2, Census Tract 5091.09, Santa Clara County, California",0,0,0
1000000US060855091092038,060855091092038,"Block 2038, Block Group 2, Census Tract 5091.09, Santa Clara County, California",0,0,0
1000000US060855091092039,060855091092039,"Block 2039, Block Group 2, Census Tract 5091.09, Santa Clara County, California",0,0,0
1000000US060855091092040,060855091092040,"Block 2040, Block Group 2, Census Tract 5091.09, Santa Clara County, California",0,0,0
1000000US060855091092041,060855091092041,"Block 2041, Block Group 2, Census Tract 5091.09, Santa Clara County, California",0,0,0
1000000US060855091092042,060855091092042,"Block 2042, Block Group 2, Census Tract 5091.09, Santa Clara County, California",0,0,0
1000000US060855091092043,060855091092043,"Block 2043, Block Group 2, Census Tract 5091.09, Santa Clara County, California",0,0,0
1000000US060855091092044,060855091092044,"Block 2044, Block Group 2, Census Tract 5091.09, Santa Clara County, California",0,0,0
1000000US060855091092045,060855091092045,"Block 2045, Block Group 2, Census Tract 5091.09, Santa Clara County, California",0,0,0
1000000US060855092011000,060855092011000,"Block 1000, Block Group 1, Census Tract 5092.01, Santa Clara County, California",0,0,0
1000000US060855092011001,060855092011001,"Block 1001, Block Group 1, Census Tract 5092.01, Santa Clara County, California",65,62,3
1000000US060855092011002,060855092011002,"Block 1002, Block Group 1, Census Tract 5092.01, Santa Clara County, California",47,45,2
1000000US060855092011003,060855092011003,"Block 1003, Block Group 1, Census Tract 5092.01, Santa Clara County, California",168,159,9
1000000US060855092011004,060855092011004,"Block 1004, Block Group 1, Census Tract 5092.01, Santa Clara County, California",11,10,1
1000000US060855092011005,060855092011005,"Block 1005, Block Group 1, Census Tract 5092.01, Santa Clara County, California",0,0,0
1000000US060855092011006,060855092011006,"Block 1006, Block Group 1, Census Tract 5092.01, Santa Clara County, California",17,17,0
1000000US060855092011007,060855092011007,"Block 1007, Block Group 1, Census Tract 5092.01, Santa Clara County, California",0,0,0
1000000US060855092011008,060855092011008,"Block 1008, Block Group 1, Census Tract 5092.01, Santa Clara County, California",8,7,1
1000000US060855092011009,060855092011009,"Block 1009, Block Group 1, Census Tract 5092.01, Santa Clara County, California",14,14,0
1000000US060855092011010,060855092011010,"Block 1010, Block Group 1, Census Tract 5092.01, Santa Clara County, California",21,19,2
1000000US060855092011011,060855092011011,"Block 1011, Block Group 1, Census Tract 5092.01, Santa Clara County, California",0,0,0
1000000US060855092011012,060855092011012,"Block 1012, Block Group 1, Census Tract 5092.01, Santa Clara County, California",3,3,0
1000000US060855092011013,060855092011013,"Block 1013, Block Group 1, Census Tract 5092.01, Santa Clara County, California",10,10,0
1000000US060855092011014,060855092011014,"Block 1014, Block Group 1, Census Tract 5092.01, Santa Clara County, California",18,16,2
1000000US060855092011015,060855092011015,"Block 1015, Block Group 1, Census Tract 5092.01, Santa Clara County, California",0,0,0
1000000US060855092011016,060855092011016,"Block 1016, Block Group 1, Census Tract 5092.01, Santa Clara County, California",0,0,0
1000000US060855092011017,060855092011017,"Block 1017, Block Group 1, Census Tract 5092.01, Santa Clara County, California",0,0,0
1000000US060855092011018,060855092011018,"Block 1018, Block Group 1, Census Tract 5092.01, Santa Clara County, California",0,0,0
1000000US060855092011019,060855092011019,"Block 1019, Block Group 1, Census Tract 5092.01, Santa Clara County, California",0,0,0
1000000US060855092011020,060855092011020,"Block 1020, Block Group 1, Census Tract 5092.01, Santa Clara County, California",0,0,0
1000000US060855092011021,060855092011021,"Block 1021, Block Group 1, Census Tract 5092.01, Santa Clara County, California",0,0,0
1000000US060855092011022,060855092011022,"Block 1022, Block Group 1, Census Tract 5092.01, Santa Clara County, California",0,0,0
1000000US060855092011023,060855092011023,"Block 1023, Block Group 1, Census Tract 5092.01, Santa Clara County, California",105,100,5
1000000US060855092012000,060855092012000,"Block 2000, Block Group 2, Census Tract 5092.01, Santa Clara County, California",0,0,0
1000000US060855092012001,060855092012001,"Block 2001, Block Group 2, Census Tract 5092.01, Santa Clara County, California",280,265,15
1000000US060855092012002,060855092012002,"Block 2002, Block Group 2, Census Tract 5092.01, Santa Clara County, California",144,138,6
1000000US060855092012003,060855092012003,"Block 2003, Block Group 2, Census Tract 5092.01, Santa Clara County, California",18,18,0
1000000US060855092012004,060855092012004,"Block 2004, Block Group 2, Census Tract 5092.01, Santa Clara County, California",14,13,1
1000000US060855092012005,060855092012005,"Block 2005, Block Group 2, Census Tract 5092.01, Santa Clara County, California",38,37,1
1000000US060855092012006,060855092012006,"Block 2006, Block Group 2, Census Tract 5092.01, Santa Clara County, California",56,55,1
1000000US060855092012007,060855092012007,"Block 2007, Block Group 2, Census Tract 5092.01, Santa Clara County, California",0,0,0
1000000US060855092012008,060855092012008,"Block 2008, Block Group 2, Census Tract 5092.01, Santa Clara County, California",3,3,0
1000000US060855092012009,060855092012009,"Block 2009, Block Group 2, Census Tract 5092.01, Santa Clara County, California",23,23,0
1000000US060855092012010,060855092012010,"Block 2010, Block Group 2, Census Tract 5092.01, Santa Clara County, California",10,10,0
1000000US060855092012011,060855092012011,"Block 2011, Block Group 2, Census Tract 5092.01, Santa Clara County, California",0,0,0
1000000US060855092012012,060855092012012,"Block 2012, Block Group 2, Census Tract 5092.01, Santa Clara County, California",0,0,0
1000000US060855092012013,060855092012013,"Block 2013, Block Group 2, Census Tract 5092.01, Santa Clara County, California",95,94,1
1000000US060855092012014,060855092012014,"Block 2014, Block Group 2, Census Tract 5092.01, Santa Clara County, California",0,0,0
1000000US060855092012015,060855092012015,"Block 2015, Block Group 2, Census Tract 5092.01, Santa Clara County, California",0,0,0
1000000US060855092012016,060855092012016,"Block 2016, Block Group 2, Census Tract 5092.01, Santa Clara County, California",0,0,0
1000000US060855092013000,060855092013000,"Block 3000, Block Group 3, Census Tract 5092.01, Santa Clara County, California",492,279,213
1000000US060855092013001,060855092013001,"Block 3001, Block Group 3, Census Tract 5092.01, Santa Clara County, California",187,179,8
1000000US060855092013002,060855092013002,"Block 3002, Block Group 3, Census Tract 5092.01, Santa Clara County, California",0,0,0
1000000US060855092013003,060855092013003,"Block 3003, Block Group 3, Census Tract 5092.01, Santa Clara County, California",0,0,0
1000000US060855092013004,060855092013004,"Block 3004, Block Group 3, Census Tract 5092.01, Santa Clara County, California",0,0,0
1000000US060855092013005,060855092013005,"Block 3005, Block Group 3, Census Tract 5092.01, Santa Clara County, California",114,108,6
1000000US060855092014000,060855092014000,"Block 4000, Block Group 4, Census Tract 5092.01, Santa Clara County, California",78,75,3
1000000US060855092014001,060855092014001,"Block 4001, Block Group 4, Census Tract 5092.01, Santa Clara County, California",0,0,0
1000000US060855092014002,060855092014002,"Block 4002, Block Group 4, Census Tract 5092.01, Santa Clara County, California",0,0,0
1000000US060855092014003,060855092014003,"Block 4003, Block Group 4, Census Tract 5092.01, Santa Clara County, California",26,26,0
1000000US060855092014004,060855092014004,"Block 4004, Block Group 4, Census Tract 5092.01, Santa Clara County, California",42,41,1
1000000US060855092014005,060855092014005,"Block 4005, Block Group 4, Census Tract 5092.01, Santa Clara County, California",20,20,0
1000000US060855092014006,060855092014006,"Block 4006, Block Group 4, Census Tract 5092.01, Santa Clara County, California",27,26,1
1000000US060855092014007,060855092014007,"Block 4007, Block Group 4, Census Tract 5092.01, Santa Clara County, California",18,14,4
1000000US060855092014008,060855092014008,"Block 4008, Block Group 4, Census Tract 5092.01, Santa Clara County, California",0,0,0
1000000US060855092014009,060855092014009,"Block 4009, Block Group 4, Census Tract 5092.01, Santa Clara County, California",0,0,0
1000000US060855092014010,060855092014010,"Block 4010, Block Group 4, Census Tract 5092.01, Santa Clara County, California",0,0,0
1000000US060855092014011,060855092014011,"Block 4011, Block Group 4, Census Tract 5092.01, Santa Clara County, California",0,0,0
1000000US060855092014012,060855092014012,"Block 4012, Block Group 4, Census Tract 5092.01, Santa Clara County, California",66,65,1
1000000US060855092014013,060855092014013,"Block 4013, Block Group 4, Census Tract 5092.01, Santa Clara County, California",0,0,0
1000000US060855092014014,060855092014014,"Block 4014, Block Group 4, Census Tract 5092.01, Santa Clara County, California",78,77,1
1000000US060855092014015,060855092014015,"Block 4015, Block Group 4, Census Tract 5092.01, Santa Clara County, California",0,0,0
1000000US060855092014016,060855092014016,"Block 4016, Block Group 4, Census Tract 5092.01, Santa Clara County, California",0,0,0
1000000US060855092014017,060855092014017,"Block 4017, Block Group 4, Census Tract 5092.01, Santa Clara County, California",0,0,0
1000000US060855092014018,060855092014018,"Block 4018, Block Group 4, Census Tract 5092.01, Santa Clara County, California",50,49,1
1000000US060855092014019,060855092014019,"Block 4019, Block Group 4, Census Tract 5092.01, Santa Clara County, California",0,0,0
1000000US060855092014020,060855092014020,"Block 4020, Block Group 4, Census Tract 5092.01, Santa Clara County, California",94,91,3
1000000US060855092014021,060855092014021,"Block 4021, Block Group 4, Census Tract 5092.01, Santa Clara County, California",24,23,1
1000000US060855092014022,060855092014022,"Block 4022, Block Group 4, Census Tract 5092.01, Santa Clara County, California",74,72,2
1000000US060855092014023,060855092014023,"Block 4023, Block Group 4, Census Tract 5092.01, Santa Clara County, California",0,0,0
1000000US060855092014024,060855092014024,"Block 4024, Block Group 4, Census Tract 5092.01, Santa Clara County, California",0,0,0
1000000US060855092014025,060855092014025,"Block 4025, Block Group 4, Census Tract 5092.01, Santa Clara County, California",0,0,0
1000000US060855092014026,060855092014026,"Block 4026, Block Group 4, Census Tract 5092.01, Santa Clara County, California",0,0,0
1000000US060855092014027,060855092014027,"Block 4027, Block Group 4, Census Tract 5092.01, Santa Clara County, California",0,0,0
1000000US060855092014028,060855092014028,"Block 4028, Block Group 4, Census Tract 5092.01, Santa Clara County, California",0,0,0
1000000US060855092021000,060855092021000,"Block 1000, Block Group 1, Census Tract 5092.02, Santa Clara County, California",1,1,0
1000000US060855092021001,060855092021001,"Block 1001, Block Group 1, Census Tract 5092.02, Santa Clara County, California",58,47,11
1000000US060855092021002,060855092021002,"Block 1002, Block Group 1, Census Tract 5092.02, Santa Clara County, California",112,107,5
1000000US060855092021003,060855092021003,"Block 1003, Block Group 1, Census Tract 5092.02, Santa Clara County, California",262,259,3
1000000US060855092021004,060855092021004,"Block 1004, Block Group 1, Census Tract 5092.02, Santa Clara County, California",0,0,0
1000000US060855092021005,060855092021005,"Block 1005, Block Group 1, Census Tract 5092.02, Santa Clara County, California",0,0,0
1000000US060855092021006,060855092021006,"Block 1006, Block Group 1, Census Tract 5092.02, Santa Clara County, California",24,24,0
1000000US060855092021007,060855092021007,"Block 1007, Block Group 1, Census Tract 5092.02, Santa Clara County, California",119,113,6
1000000US060855092021008,060855092021008,"Block 1008, Block Group 1, Census Tract 5092.02, Santa Clara County, California",20,20,0
1000000US060855092021009,060855092021009,"Block 1009, Block Group 1, Census Tract 5092.02, Santa Clara County, California",194,175,19
1000000US060855092021010,060855092021010,"Block 1010, Block Group 1, Census Tract 5092.02, Santa Clara County, California",41,39,2
1000000US060855092021011,060855092021011,"Block 1011, Block Group 1, Census Tract 5092.02, Santa Clara County, California",0,0,0
1000000US060855092021012,060855092021012,"Block 1012, Block Group 1, Census Tract 5092.02, Santa Clara County, California",11,10,1
1000000US060855092021013,060855092021013,"Block 1013, Block Group 1, Census Tract 5092.02, Santa Clara County, California",0,0,0
1000000US060855092021014,060855092021014,"Block 1014, Block Group 1, Census Tract 5092.02, Santa Clara County, California",0,0,0
1000000US060855092021015,060855092021015,"Block 1015, Block Group 1, Census Tract 5092.02, Santa Clara County, California",0,0,0
1000000US060855092021016,060855092021016,"Block 1016, Block Group 1, Census Tract 5092.02, Santa Clara County, California",0,0,0
1000000US060855092021017,060855092021017,"Block 1017, Block Group 1, Census Tract 5092.02, Santa Clara County, California",14,13,1
1000000US060855092022000,060855092022000,"Block 2000, Block Group 2, Census Tract 5092.02, Santa Clara County, California",64,64,0
1000000US060855092022001,060855092022001,"Block 2001, Block Group 2, Census Tract 5092.02, Santa Clara County, California",27,27,0
1000000US060855092022002,060855092022002,"Block 2002, Block Group 2, Census Tract 5092.02, Santa Clara County, California",27,26,1
1000000US060855092022003,060855092022003,"Block 2003, Block Group 2, Census Tract 5092.02, Santa Clara County, California",23,23,0
1000000US060855092022004,060855092022004,"Block 2004, Block Group 2, Census Tract 5092.02, Santa Clara County, California",43,43,0
1000000US060855092022005,060855092022005,"Block 2005, Block Group 2, Census Tract 5092.02, Santa Clara County, California",14,14,0
1000000US060855092022006,060855092022006,"Block 2006, Block Group 2, Census Tract 5092.02, Santa Clara County, California",111,104,7
1000000US060855092022007,060855092022007,"Block 2007, Block Group 2, Census Tract 5092.02, Santa Clara County, California",11,10,1
1000000US060855092022008,060855092022008,"Block 2008, Block Group 2, Census Tract 5092.02, Santa Clara County, California",6,5,1
1000000US060855092023000,060855092023000,"Block 3000, Block Group 3, Census Tract 5092.02, Santa Clara County, California",0,0,0
1000000US060855092023001,060855092023001,"Block 3001, Block Group 3, Census Tract 5092.02, Santa Clara County, California",0,0,0
1000000US060855092023002,060855092023002,"Block 3002, Block Group 3, Census Tract 5092.02, Santa Clara County, California",0,0,0
1000000US060855092023003,060855092023003,"Block 3003, Block Group 3, Census Tract 5092.02, Santa Clara County, California",8,8,0
1000000US060855092023004,060855092023004,"Block 3004, Block Group 3, Census Tract 5092.02, Santa Clara County, California",20,19,1
1000000US060855092023005,060855092023005,"Block 3005, Block Group 3, Census Tract 5092.02, Santa Clara County, California",66,64,2
1000000US060855092023006,060855092023006,"Block 3006, Block Group 3, Census Tract 5092.02, Santa Clara County, California",0,0,0
1000000US060855092023007,060855092023007,"Block 3007, Block Group 3, Census Tract 5092.02, Santa Clara County, California",33,33,0
1000000US060855092023008,060855092023008,"Block 3008, Block Group 3, Census Tract 5092.02, Santa Clara County, California",0,0,0
1000000US060855092023009,060855092023009,"Block 3009, Block Group 3, Census Tract 5092.02, Santa Clara County, California",20,17,3
1000000US060855092023010,060855092023010,"Block 3010, Block Group 3, Census Tract 5092.02, Santa Clara County, California",0,0,0
1000000US060855092023011,060855092023011,"Block 3011, Block Group 3, Census Tract 5092.02, Santa Clara County, California",0,0,0
1000000US060855092023012,060855092023012,"Block 3012, Block Group 3, Census Tract 5092.02, Santa Clara County, California",0,0,0
1000000US060855092023013,060855092023013,"Block 3013, Block Group 3, Census Tract 5092.02, Santa Clara County, California",0,0,0
1000000US060855092023014,060855092023014,"Block 3014, Block Group 3, Census Tract 5092.02, Santa Clara County, California",120,113,7
1000000US060855092023015,060855092023015,"Block 3015, Block Group 3, Census Tract 5092.02, Santa Clara County, California",180,169,11
1000000US060855092023016,060855092023016,"Block 3016, Block Group 3, Census Tract 5092.02, Santa Clara County, California",0,0,0
1000000US060855092023017,060855092023017,"Block 3017, Block Group 3, Census Tract 5092.02, Santa Clara County, California",0,0,0
1000000US060855092023018,060855092023018,"Block 3018, Block Group 3, Census Tract 5092.02, Santa Clara County, California",0,0,0
1000000US060855092024000,060855092024000,"Block 4000, Block Group 4, Census Tract 5092.02, Santa Clara County, California",19,18,1
1000000US060855092024001,060855092024001,"Block 4001, Block Group 4, Census Tract 5092.02, Santa Clara County, California",5,5,0
1000000US060855092024002,060855092024002,"Block 4002, Block Group 4, Census Tract 5092.02, Santa Clara County, California",14,14,0
1000000US060855092024003,060855092024003,"Block 4003, Block Group 4, Census Tract 5092.02, Santa Clara County, California",21,20,1
1000000US060855092024004,060855092024004,"Block 4004, Block Group 4, Census Tract 5092.02, Santa Clara County, California",21,20,1
1000000US060855092024005,060855092024005,"Block 4005, Block Group 4, Census Tract 5092.02, Santa Clara County, California",23,23,0
1000000US060855092024006,060855092024006,"Block 4006, Block Group 4, Census Tract 5092.02, Santa Clara County, California",23,21,2
1000000US060855092024007,060855092024007,"Block 4007, Block Group 4, Census Tract 5092.02, Santa Clara County, California",14,14,0
1000000US060855092024008,060855092024008,"Block 4008, Block Group 4, Census Tract 5092.02, Santa Clara County, California",24,22,2
1000000US060855092024009,060855092024009,"Block 4009, Block Group 4, Census Tract 5092.02, Santa Clara County, California",25,25,0
1000000US060855092024010,060855092024010,"Block 4010, Block Group 4, Census Tract 5092.02, Santa Clara County, California",24,22,2
1000000US060855092024011,060855092024011,"Block 4011, Block Group 4, Census Tract 5092.02, Santa Clara County, California",11,10,1
1000000US060855092024012,060855092024012,"Block 4012, Block Group 4, Census Tract 5092.02, Santa Clara County, California",26,24,2
1000000US060855092024013,060855092024013,"Block 4013, Block Group 4, Census Tract 5092.02, Santa Clara County, California",27,27,0
1000000US060855093021000,060855093021000,"Block 1000, Block Group 1, Census Tract 5093.02, Santa Clara County, California",35,34,1
1000000US060855093021001,060855093021001,"Block 1001, Block Group 1, Census Tract 5093.02, Santa Clara County, California",0,0,0
1000000US060855093021002,060855093021002,"Block 1002, Block Group 1, Census Tract 5093.02, Santa Clara County, California",51,50,1
1000000US060855093021003,060855093021003,"Block 1003, Block Group 1, Census Tract 5093.02, Santa Clara County, California",39,39,0
1000000US060855093021004,060855093021004,"Block 1004, Block Group 1, Census Tract 5093.02, Santa Clara County, California",0,0,0
1000000US060855093021005,060855093021005,"Block 1005, Block Group 1, Census Tract 5093.02, Santa Clara County, California",60,58,2
1000000US060855093021006,060855093021006,"Block 1006, Block Group 1, Census Tract 5093.02, Santa Clara County, California",24,23,1
1000000US060855093021007,060855093021007,"Block 1007, Block Group 1, Census Tract 5093.02, Santa Clara County, California",12,11,1
1000000US060855093021008,060855093021008,"Block 1008, Block Group 1, Census Tract 5093.02, Santa Clara County, California",49,48,1
1000000US060855093021009,060855093021009,"Block 1009, Block Group 1, Census Tract 5093.02, Santa Clara County, California",21,21,0
1000000US060855093021010,060855093021010,"Block 1010, Block Group 1, Census Tract 5093.02, Santa Clara County, California",7,7,0
1000000US060855093021011,060855093021011,"Block 1011, Block Group 1, Census Tract 5093.02, Santa Clara County, California",16,16,0
1000000US060855093021012,060855093021012,"Block 1012, Block Group 1, Census Tract 5093.02, Santa Clara County, California",140,138,2
1000000US060855093021013,060855093021013,"Block 1013, Block Group 1, Census Tract 5093.02, Santa Clara County, California",15,15,0
1000000US060855093021014,060855093021014,"Block 1014, Block Group 1, Census Tract 5093.02, Santa Clara County, California",28,28,0
1000000US060855093021015,060855093021015,"Block 1015, Block Group 1, Census Tract 5093.02, Santa Clara County, California",0,0,0
1000000US060855093021016,060855093021016,"Block 1016, Block Group 1, Census Tract 5093.02, Santa Clara County, California",0,0,0
1000000US060855093021017,060855093021017,"Block 1017, Block Group 1, Census Tract 5093.02, Santa Clara County, California",0,0,0
1000000US060855093021018,060855093021018,"Block 1018, Block Group 1, Census Tract 5093.02, Santa Clara County, California",67,65,2
1000000US060855093021019,060855093021019,"Block 1019, Block Group 1, Census Tract 5093.02, Santa Clara County, California",24,23,1
1000000US060855093021020,060855093021020,"Block 1020, Block Group 1, Census Tract 5093.02, Santa Clara County, California",0,0,0
1000000US060855093021021,060855093021021,"Block 1021, Block Group 1, Census Tract 5093.02, Santa Clara County, California",0,0,0
1000000US060855093021022,060855093021022,"Block 1022, Block Group 1, Census Tract 5093.02, Santa Clara County, California",0,0,0
1000000US060855093021023,060855093021023,"Block 1023, Block Group 1, Census Tract 5093.02, Santa Clara County, California",47,46,1
1000000US060855093021024,060855093021024,"Block 1024, Block Group 1, Census Tract 5093.02, Santa Clara County, California",86,82,4
1000000US060855093021025,060855093021025,"Block 1025, Block Group 1, Census Tract 5093.02, Santa Clara County, California",0,0,0
1000000US060855093021026,060855093021026,"Block 1026, Block Group 1, Census Tract 5093.02, Santa Clara County, California",0,0,0
1000000US060855093021027,060855093021027,"Block 1027, Block Group 1, Census Tract 5093.02, Santa Clara County, California",84,80,4
1000000US060855093021028,060855093021028,"Block 1028, Block Group 1, Census Tract 5093.02, Santa Clara County, California",0,0,0
1000000US060855093021029,060855093021029,"Block 1029, Block Group 1, Census Tract 5093.02, Santa Clara County, California",0,0,0
1000000US060855093021030,060855093021030,"Block 1030, Block Group 1, Census Tract 5093.02, Santa Clara County, California",0,0,0
1000000US060855093021031,060855093021031,"Block 1031, Block Group 1, Census Tract 5093.02, Santa Clara County, California",26,25,1
1000000US060855093021032,060855093021032,"Block 1032, Block Group 1, Census Tract 5093.02, Santa Clara County, California",125,119,6
1000000US060855093021033,060855093021033,"Block 1033, Block Group 1, Census Tract 5093.02, Santa Clara County, California",0,0,0
1000000US060855093021034,060855093021034,"Block 1034, Block Group 1, Census Tract 5093.02, Santa Clara County, California",134,130,4
1000000US060855093021035,060855093021035,"Block 1035, Block Group 1, Census Tract 5093.02, Santa Clara County, California",35,33,2
1000000US060855093021036,060855093021036,"Block 1036, Block Group 1, Census Tract 5093.02, Santa Clara County, California",45,45,0
1000000US060855093021037,060855093021037,"Block 1037, Block Group 1, Census Tract 5093.02, Santa Clara County, California",19,17,2
1000000US060855093021038,060855093021038,"Block 1038, Block Group 1, Census Tract 5093.02, Santa Clara County, California",21,21,0
1000000US060855093021039,060855093021039,"Block 1039, Block Group 1, Census Tract 5093.02, Santa Clara County, California",9,9,0
1000000US060855093021040,060855093021040,"Block 1040, Block Group 1, Census Tract 5093.02, Santa Clara County, California",31,29,2
1000000US060855093021041,060855093021041,"Block 1041, Block Group 1, Census Tract 5093.02, Santa Clara County, California",0,0,0
1000000US060855093031000,060855093031000,"Block 1000, Block Group 1, Census Tract 5093.03, Santa Clara County, California",89,84,5
1000000US060855093031001,060855093031001,"Block 1001, Block Group 1, Census Tract 5093.03, Santa Clara County, California",388,371,17
1000000US060855093032000,060855093032000,"Block 2000, Block Group 2, Census Tract 5093.03, Santa Clara County, California",23,23,0
1000000US060855093032001,060855093032001,"Block 2001, Block Group 2, Census Tract 5093.03, Santa Clara County, California",42,41,1
1000000US060855093032002,060855093032002,"Block 2002, Block Group 2, Census Tract 5093.03, Santa Clara County, California",17,17,0
1000000US060855093032003,060855093032003,"Block 2003, Block Group 2, Census Tract 5093.03, Santa Clara County, California",32,30,2
1000000US060855093032004,060855093032004,"Block 2004, Block Group 2, Census Tract 5093.03, Santa Clara County, California",70,63,7
1000000US060855093032005,060855093032005,"Block 2005, Block Group 2, Census Tract 5093.03, Santa Clara County, California",108,100,8
1000000US060855093032006,060855093032006,"Block 2006, Block Group 2, Census Tract 5093.03, Santa Clara County, California",16,16,0
1000000US060855093032007,060855093032007,"Block 2007, Block Group 2, Census Tract 5093.03, Santa Clara County, California",134,130,4
1000000US060855093032008,060855093032008,"Block 2008, Block Group 2, Census Tract 5093.03, Santa Clara County, California",0,0,0
1000000US060855093032009,060855093032009,"Block 2009, Block Group 2, Census Tract 5093.03, Santa Clara County, California",0,0,0
1000000US060855093033000,060855093033000,"Block 3000, Block Group 3, Census Tract 5093.03, Santa Clara County, California",312,305,7
1000000US060855093033001,060855093033001,"Block 3001, Block Group 3, Census Tract 5093.03, Santa Clara County, California",133,117,16
1000000US060855093034000,060855093034000,"Block 4000, Block Group 4, Census Tract 5093.03, Santa Clara County, California",556,536,20
1000000US060855093034001,060855093034001,"Block 4001, Block Group 4, Census Tract 5093.03, Santa Clara County, California",0,0,0
1000000US060855093034002,060855093034002,"Block 4002, Block Group 4, Census Tract 5093.03, Santa Clara County, California",0,0,0
1000000US060855093034003,060855093034003,"Block 4003, Block Group 4, Census Tract 5093.03, Santa Clara County, California",0,0,0
1000000US060855093041000,060855093041000,"Block 1000, Block Group 1, Census Tract 5093.04, Santa Clara County, California",0,0,0
1000000US060855093041001,060855093041001,"Block 1001, Block Group 1, Census Tract 5093.04, Santa Clara County, California",0,0,0
1000000US060855093041002,060855093041002,"Block 1002, Block Group 1, Census Tract 5093.04, Santa Clara County, California",0,0,0
1000000US060855093041003,060855093041003,"Block 1003, Block Group 1, Census Tract 5093.04, Santa Clara County, California",0,0,0
1000000US060855093041004,060855093041004,"Block 1004, Block Group 1, Census Tract 5093.04, Santa Clara County, California",0,0,0
1000000US060855093041005,060855093041005,"Block 1005, Block Group 1, Census Tract 5093.04, Santa Clara County, California",0,0,0
1000000US060855093041006,060855093041006,"Block 1006, Block Group 1, Census Tract 5093.04, Santa Clara County, California",0,0,0
1000000US060855093041007,060855093041007,"Block 1007, Block Group 1, Census Tract 5093.04, Santa Clara County, California",0,0,0
1000000US060855093041008,060855093041008,"Block 1008, Block Group 1, Census Tract 5093.04, Santa Clara County, California",0,0,0
1000000US060855093041009,060855093041009,"Block 1009, Block Group 1, Census Tract 5093.04, Santa Clara County, California",0,0,0
1000000US060855093041010,060855093041010,"Block 1010, Block Group 1, Census Tract 5093.04, Santa Clara County, California",1,1,0
1000000US060855093041011,060855093041011,"Block 1011, Block Group 1, Census Tract 5093.04, Santa Clara County, California",0,0,0
1000000US060855093041012,060855093041012,"Block 1012, Block Group 1, Census Tract 5093.04, Santa Clara County, California",0,0,0
1000000US060855093041013,060855093041013,"Block 1013, Block Group 1, Census Tract 5093.04, Santa Clara County, California",1,1,0
1000000US060855093041014,060855093041014,"Block 1014, Block Group 1, Census Tract 5093.04, Santa Clara County, California",0,0,0
1000000US060855093041015,060855093041015,"Block 1015, Block Group 1, Census Tract 5093.04, Santa Clara County, California",0,0,0
1000000US060855093041016,060855093041016,"Block 1016, Block Group 1, Census Tract 5093.04, Santa Clara County, California",0,0,0
1000000US060855093041017,060855093041017,"Block 1017, Block Group 1, Census Tract 5093.04, Santa Clara County, California",0,0,0
1000000US060855093041018,060855093041018,"Block 1018, Block Group 1, Census Tract 5093.04, Santa Clara County, California",0,0,0
1000000US060855093041019,060855093041019,"Block 1019, Block Group 1, Census Tract 5093.04, Santa Clara County, California",0,0,0
1000000US060855093041020,060855093041020,"Block 1020, Block Group 1, Census Tract 5093.04, Santa Clara County, California",0,0,0
1000000US060855093041021,060855093041021,"Block 1021, Block Group 1, Census Tract 5093.04, Santa Clara County, California",60,46,14
1000000US060855093041022,060855093041022,"Block 1022, Block Group 1, Census Tract 5093.04, Santa Clara County, California",49,46,3
1000000US060855093041023,060855093041023,"Block 1023, Block Group 1, Census Tract 5093.04, Santa Clara County, California",27,26,1
1000000US060855093041024,060855093041024,"Block 1024, Block Group 1, Census Tract 5093.04, Santa Clara County, California",0,0,0
1000000US060855093041025,060855093041025,"Block 1025, Block Group 1, Census Tract 5093.04, Santa Clara County, California",10,10,0
1000000US060855093041026,060855093041026,"Block 1026, Block Group 1, Census Tract 5093.04, Santa Clara County, California",8,8,0
1000000US060855093041027,060855093041027,"Block 1027, Block Group 1, Census Tract 5093.04, Santa Clara County, California",9,9,0
1000000US060855093041028,060855093041028,"Block 1028, Block Group 1, Census Tract 5093.04, Santa Clara County, California",41,38,3
1000000US060855093041029,060855093041029,"Block 1029, Block Group 1, Census Tract 5093.04, Santa Clara County, California",1,1,0
1000000US060855093041030,060855093041030,"Block 1030, Block Group 1, Census Tract 5093.04, Santa Clara County, California",0,0,0
1000000US060855093041031,060855093041031,"Block 1031, Block Group 1, Census Tract 5093.04, Santa Clara County, California",0,0,0
1000000US060855093041032,060855093041032,"Block 1032, Block Group 1, Census Tract 5093.04, Santa Clara County, California",90,83,7
1000000US060855093041033,060855093041033,"Block 1033, Block Group 1, Census Tract 5093.04, Santa Clara County, California",0,0,0
1000000US060855093041034,060855093041034,"Block 1034, Block Group 1, Census Tract 5093.04, Santa Clara County, California",7,7,0
1000000US060855093041035,060855093041035,"Block 1035, Block Group 1, Census Tract 5093.04, Santa Clara County, California",3,3,0
1000000US060855093041036,060855093041036,"Block 1036, Block Group 1, Census Tract 5093.04, Santa Clara County, California",0,0,0
1000000US060855093041037,060855093041037,"Block 1037, Block Group 1, Census Tract 5093.04, Santa Clara County, California",153,151,2
1000000US060855093041038,060855093041038,"Block 1038, Block Group 1, Census Tract 5093.04, Santa Clara County, California",25,23,2
1000000US060855093042000,060855093042000,"Block 2000, Block Group 2, Census Tract 5093.04, Santa Clara County, California",58,56,2
1000000US060855093042001,060855093042001,"Block 2001, Block Group 2, Census Tract 5093.04, Santa Clara County, California",103,99,4
1000000US060855093042002,060855093042002,"Block 2002, Block Group 2, Census Tract 5093.04, Santa Clara County, California",201,183,18
1000000US060855093042003,060855093042003,"Block 2003, Block Group 2, Census Tract 5093.04, Santa Clara County, California",62,59,3
1000000US060855093042004,060855093042004,"Block 2004, Block Group 2, Census Tract 5093.04, Santa Clara County, California",0,0,0
1000000US060855093042005,060855093042005,"Block 2005, Block Group 2, Census Tract 5093.04, Santa Clara County, California",0,0,0
1000000US060855093042006,060855093042006,"Block 2006, Block Group 2, Census Tract 5093.04, Santa Clara County, California",0,0,0
1000000US060855093042007,060855093042007,"Block 2007, Block Group 2, Census Tract 5093.04, Santa Clara County, California",0,0,0
1000000US060855093042008,060855093042008,"Block 2008, Block Group 2, Census Tract 5093.04, Santa Clara County, California",17,15,2
1000000US060855093042009,060855093042009,"Block 2009, Block Group 2, Census Tract 5093.04, Santa Clara County, California",42,41,1
1000000US060855093042010,060855093042010,"Block 2010, Block Group 2, Census Tract 5093.04, Santa Clara County, California",24,0,24
1000000US060855093042011,060855093042011,"Block 2011, Block Group 2, Census Tract 5093.04, Santa Clara County, California",27,27,0
1000000US060855093042012,060855093042012,"Block 2012, Block Group 2, Census Tract 5093.04, Santa Clara County, California",0,0,0
1000000US060855093042013,060855093042013,"Block 2013, Block Group 2, Census Tract 5093.04, Santa Clara County, California",30,30,0
1000000US060855093042014,060855093042014,"Block 2014, Block Group 2, Census Tract 5093.04, Santa Clara County, California",148,138,10
1000000US060855093042015,060855093042015,"Block 2015, Block Group 2, Census Tract 5093.04, Santa Clara County, California",125,109,16
1000000US060855093042016,060855093042016,"Block 2016, Block Group 2, Census Tract 5093.04, Santa Clara County, California",4,4,0
1000000US060855093042017,060855093042017,"Block 2017, Block Group 2, Census Tract 5093.04, Santa Clara County, California",0,0,0
1000000US060855093042018,060855093042018,"Block 2018, Block Group 2, Census Tract 5093.04, Santa Clara County, California",0,0,0
1000000US060855094011000,060855094011000,"Block 1000, Block Group 1, Census Tract 5094.01, Santa Clara County, California",545,526,19
1000000US060855094011001,060855094011001,"Block 1001, Block Group 1, Census Tract 5094.01, Santa Clara County, California",0,0,0
1000000US060855094011002,060855094011002,"Block 1002, Block Group 1, Census Tract 5094.01, Santa Clara County, California",2,2,0
1000000US060855094011003,060855094011003,"Block 1003, Block Group 1, Census Tract 5094.01, Santa Clara County, California",35,34,1
1000000US060855094011004,060855094011004,"Block 1004, Block Group 1, Census Tract 5094.01, Santa Clara County, California",96,95,1
1000000US060855094011005,060855094011005,"Block 1005, Block Group 1, Census Tract 5094.01, Santa Clara County, California",86,79,7
1000000US060855094011006,060855094011006,"Block 1006, Block Group 1, Census Tract 5094.01, Santa Clara County, California",8,7,1
1000000US060855094011007,060855094011007,"Block 1007, Block Group 1, Census Tract 5094.01, Santa Clara County, California",45,36,9
1000000US060855094011008,060855094011008,"Block 1008, Block Group 1, Census Tract 5094.01, Santa Clara County, California",9,7,2
1000000US060855094011009,060855094011009,"Block 1009, Block Group 1, Census Tract 5094.01, Santa Clara County, California",4,4,0
1000000US060855094011010,060855094011010,"Block 1010, Block Group 1, Census Tract 5094.01, Santa Clara County, California",0,0,0
1000000US060855094011011,060855094011011,"Block 1011, Block Group 1, Census Tract 5094.01, Santa Clara County, California",0,0,0
1000000US060855094012000,060855094012000,"Block 2000, Block Group 2, Census Tract 5094.01, Santa Clara County, California",19,19,0
1000000US060855094012001,060855094012001,"Block 2001, Block Group 2, Census Tract 5094.01, Santa Clara County, California",2,2,0
1000000US060855094012002,060855094012002,"Block 2002, Block Group 2, Census Tract 5094.01, Santa Clara County, California",15,15,0
1000000US060855094012003,060855094012003,"Block 2003, Block Group 2, Census Tract 5094.01, Santa Clara County, California",16,15,1
1000000US060855094012004,060855094012004,"Block 2004, Block Group 2, Census Tract 5094.01, Santa Clara County, California",13,12,1
1000000US060855094012005,060855094012005,"Block 2005, Block Group 2, Census Tract 5094.01, Santa Clara County, California",43,42,1
1000000US060855094012006,060855094012006,"Block 2006, Block Group 2, Census Tract 5094.01, Santa Clara County, California",13,10,3
1000000US060855094012007,060855094012007,"Block 2007, Block Group 2, Census Tract 5094.01, Santa Clara County, California",0,0,0
1000000US060855094012008,060855094012008,"Block 2008, Block Group 2, Census Tract 5094.01, Santa Clara County, California",80,80,0
1000000US060855094012009,060855094012009,"Block 2009, Block Group 2, Census Tract 5094.01, Santa Clara County, California",95,88,7
1000000US060855094012010,060855094012010,"Block 2010, Block Group 2, Census Tract 5094.01, Santa Clara County, California",0,0,0
1000000US060855094012011,060855094012011,"Block 2011, Block Group 2, Census Tract 5094.01, Santa Clara County, California",0,0,0
1000000US060855094012012,060855094012012,"Block 2012, Block Group 2, Census Tract 5094.01, Santa Clara County, California",0,0,0
1000000US060855094013000,060855094013000,"Block 3000, Block Group 3, Census Tract 5094.01, Santa Clara County, California",98,92,6
1000000US060855094013001,060855094013001,"Block 3001, Block Group 3, Census Tract 5094.01, Santa Clara County, California",7,6,1
1000000US060855094013002,060855094013002,"Block 3002, Block Group 3, Census Tract 5094.01, Santa Clara County, California",215,196,19
1000000US060855094013003,060855094013003,"Block 3003, Block Group 3, Census Tract 5094.01, Santa Clara County, California",258,235,23
1000000US060855094013004,060855094013004,"Block 3004, Block Group 3, Census Tract 5094.01, Santa Clara County, California",0,0,0
1000000US060855094013005,060855094013005,"Block 3005, Block Group 3, Census Tract 5094.01, Santa Clara County, California",0,0,0
1000000US060855094013006,060855094013006,"Block 3006, Block Group 3, Census Tract 5094.01, Santa Clara County, California",0,0,0
1000000US060855094013007,060855094013007,"Block 3007, Block Group 3, Census Tract 5094.01, Santa Clara County, California",0,0,0
1000000US060855094013008,060855094013008,"Block 3008, Block Group 3, Census Tract 5094.01, Santa Clara County, California",0,0,0
1000000US060855094031000,060855094031000,"Block 1000, Block Group 1, Census Tract 5094.03, Santa Clara County, California",0,0,0
1000000US060855094031001,060855094031001,"Block 1001, Block Group 1, Census Tract 5094.03, Santa Clara County, California",753,687,66
1000000US060855094031002,060855094031002,"Block 1002, Block Group 1, Census Tract 5094.03, Santa Clara County, California",223,202,21
1000000US060855094031003,060855094031003,"Block 1003, Block Group 1, Census Tract 5094.03, Santa Clara County, California",0,0,0
1000000US060855094031004,060855094031004,"Block 1004, Block Group 1, Census Tract 5094.03, Santa Clara County, California",1,1,0
1000000US060855094032000,060855094032000,"Block 2000, Block Group 2, Census Tract 5094.03, Santa Clara County, California",1050,1012,38
1000000US060855094032001,060855094032001,"Block 2001, Block Group 2, Census Tract 5094.03, Santa Clara County, California",132,128,4
1000000US060855094032002,060855094032002,"Block 2002, Block Group 2, Census Tract 5094.03, Santa Clara County, California",0,0,0
1000000US060855094032003,060855094032003,"Block 2003, Block Group 2, Census Tract 5094.03, Santa Clara County, California",0,0,0
1000000US060855094032004,060855094032004,"Block 2004, Block Group 2, Census Tract 5094.03, Santa Clara County, California",0,0,0
1000000US060855094041000,060855094041000,"Block 1000, Block Group 1, Census Tract 5094.04, Santa Clara County, California",0,0,0
1000000US060855094041001,060855094041001,"Block 1001, Block Group 1, Census Tract 5094.04, Santa Clara County, California",0,0,0
1000000US060855094041002,060855094041002,"Block 1002, Block Group 1, Census Tract 5094.04, Santa Clara County, California",285,267,18
1000000US060855094041003,060855094041003,"Block 1003, Block Group 1, Census Tract 5094.04, Santa Clara County, California",11,11,0
1000000US060855094041004,060855094041004,"Block 1004, Block Group 1, Census Tract 5094.04, Santa Clara County, California",12,12,0
1000000US060855094041005,060855094041005,"Block 1005, Block Group 1, Census Tract 5094.04, Santa Clara County, California",15,15,0
1000000US060855094041006,060855094041006,"Block 1006, Block Group 1, Census Tract 5094.04, Santa Clara County, California",15,15,0
1000000US060855094041007,060855094041007,"Block 1007, Block Group 1, Census Tract 5094.04, Santa Clara County, California",298,287,11
1000000US060855094041008,060855094041008,"Block 1008, Block Group 1, Census Tract 5094.04, Santa Clara County, California",48,45,3
1000000US060855094041009,060855094041009,"Block 1009, Block Group 1, Census Tract 5094.04, Santa Clara County, California",16,16,0
1000000US060855094041010,060855094041010,"Block 1010, Block Group 1, Census Tract 5094.04, Santa Clara County, California",0,0,0
1000000US060855094041011,060855094041011,"Block 1011, Block Group 1, Census Tract 5094.04, Santa Clara County, California",0,0,0
1000000US060855094041012,060855094041012,"Block 1012, Block Group 1, Census Tract 5094.04, Santa Clara County, California",17,16,1
1000000US060855094042000,060855094042000,"Block 2000, Block Group 2, Census Tract 5094.04, Santa Clara County, California",3,3,0
1000000US060855094042001,060855094042001,"Block 2001, Block Group 2, Census Tract 5094.04, Santa Clara County, California",0,0,0
1000000US060855094042002,060855094042002,"Block 2002, Block Group 2, Census Tract 5094.04, Santa Clara County, California",325,313,12
1000000US060855094042003,060855094042003,"Block 2003, Block Group 2, Census Tract 5094.04, Santa Clara County, California",0,0,0
1000000US060855094042004,060855094042004,"Block 2004, Block Group 2, Census Tract 5094.04, Santa Clara County, California",28,26,2
1000000US060855094042005,060855094042005,"Block 2005, Block Group 2, Census Tract 5094.04, Santa Clara County, California",25,25,0
1000000US060855094042006,060855094042006,"Block 2006, Block Group 2, Census Tract 5094.04, Santa Clara County, California",35,31,4
1000000US060855094042007,060855094042007,"Block 2007, Block Group 2, Census Tract 5094.04, Santa Clara County, California",22,19,3
1000000US060855094043000,060855094043000,"Block 3000, Block Group 3, Census Tract 5094.04, Santa Clara County, California",373,365,8
1000000US060855094043001,060855094043001,"Block 3001, Block Group 3, Census Tract 5094.04, Santa Clara County, California",23,23,0
1000000US060855094043002,060855094043002,"Block 3002, Block Group 3, Census Tract 5094.04, Santa Clara County, California",161,152,9
1000000US060855094043003,060855094043003,"Block 3003, Block Group 3, Census Tract 5094.04, Santa Clara County, California",12,12,0
1000000US060855094043004,060855094043004,"Block 3004, Block Group 3, Census Tract 5094.04, Santa Clara County, California",0,0,0
1000000US060855094043005,060855094043005,"Block 3005, Block Group 3, Census Tract 5094.04, Santa Clara County, California",0,0,0
1000000US060855094043006,060855094043006,"Block 3006, Block Group 3, Census Tract 5094.04, Santa Clara County, California",35,31,4
1000000US060855094043007,060855094043007,"Block 3007, Block Group 3, Census Tract 5094.04, Santa Clara County, California",246,240,6
1000000US060855094043008,060855094043008,"Block 3008, Block Group 3, Census Tract 5094.04, Santa Clara County, California",0,0,0
1000000US060855094044000,060855094044000,"Block 4000, Block Group 4, Census Tract 5094.04, Santa Clara County, California",0,0,0
1000000US060855094044001,060855094044001,"Block 4001, Block Group 4, Census Tract 5094.04, Santa Clara County, California",0,0,0
1000000US060855094044002,060855094044002,"Block 4002, Block Group 4, Census Tract 5094.04, Santa Clara County, California",0,0,0
1000000US060855094044003,060855094044003,"Block 4003, Block Group 4, Census Tract 5094.04, Santa Clara County, California",0,0,0
1000000US060855094044004,060855094044004,"Block 4004, Block Group 4, Census Tract 5094.04, Santa Clara County, California",0,0,0
1000000US060855094044005,060855094044005,"Block 4005, Block Group 4, Census Tract 5094.04, Santa Clara County, California",0,0,0
1000000US060855094044006,060855094044006,"Block 4006, Block Group 4, Census Tract 5094.04, Santa Clara County, California",0,0,0
1000000US060855094044007,060855094044007,"Block 4007, Block Group 4, Census Tract 5094.04, Santa Clara County, California",0,0,0
1000000US060855094044008,060855094044008,"Block 4008, Block Group 4, Census Tract 5094.04, Santa Clara County, California",0,0,0
1000000US060855094044009,060855094044009,"Block 4009, Block Group 4, Census Tract 5094.04, Santa Clara County, California",0,0,0
1000000US060855094044010,060855094044010,"Block 4010, Block Group 4, Census Tract 5094.04, Santa Clara County, California",0,0,0
1000000US060855094044011,060855094044011,"Block 4011, Block Group 4, Census Tract 5094.04, Santa Clara County, California",0,0,0
1000000US060855094044012,060855094044012,"Block 4012, Block Group 4, Census Tract 5094.04, Santa Clara County, California",0,0,0
1000000US060855094044013,060855094044013,"Block 4013, Block Group 4, Census Tract 5094.04, Santa Clara County, California",2,2,0
1000000US060855094044014,060855094044014,"Block 4014, Block Group 4, Census Tract 5094.04, Santa Clara County, California",185,182,3
1000000US060855094044015,060855094044015,"Block 4015, Block Group 4, Census Tract 5094.04, Santa Clara County, California",75,70,5
1000000US060855094044016,060855094044016,"Block 4016, Block Group 4, Census Tract 5094.04, Santa Clara County, California",0,0,0
1000000US060855094044017,060855094044017,"Block 4017, Block Group 4, Census Tract 5094.04, Santa Clara County, California",0,0,0
1000000US060855094044018,060855094044018,"Block 4018, Block Group 4, Census Tract 5094.04, Santa Clara County, California",342,308,34
1000000US060855094044019,060855094044019,"Block 4019, Block Group 4, Census Tract 5094.04, Santa Clara County, California",1,1,0
1000000US060855094044020,060855094044020,"Block 4020, Block Group 4, Census Tract 5094.04, Santa Clara County, California",0,0,0
1000000US060855095001000,060855095001000,"Block 1000, Block Group 1, Census Tract 5095, Santa Clara County, California",352,342,10
1000000US060855095001001,060855095001001,"Block 1001, Block Group 1, Census Tract 5095, Santa Clara County, California",0,0,0
1000000US060855095001002,060855095001002,"Block 1002, Block Group 1, Census Tract 5095, Santa Clara County, California",20,19,1
1000000US060855095001003,060855095001003,"Block 1003, Block Group 1, Census Tract 5095, Santa Clara County, California",17,16,1
1000000US060855095001004,060855095001004,"Block 1004, Block Group 1, Census Tract 5095, Santa Clara County, California",164,156,8
1000000US060855095001005,060855095001005,"Block 1005, Block Group 1, Census Tract 5095, Santa Clara County, California",41,39,2
1000000US060855095001006,060855095001006,"Block 1006, Block Group 1, Census Tract 5095, Santa Clara County, California",153,149,4
1000000US060855095001007,060855095001007,"Block 1007, Block Group 1, Census Tract 5095, Santa Clara County, California",105,100,5
1000000US060855095001008,060855095001008,"Block 1008, Block Group 1, Census Tract 5095, Santa Clara County, California",0,0,0
1000000US060855095002000,060855095002000,"Block 2000, Block Group 2, Census Tract 5095, Santa Clara County, California",166,152,14
1000000US060855095002001,060855095002001,"Block 2001, Block Group 2, Census Tract 5095, Santa Clara County, California",62,61,1
1000000US060855095002002,060855095002002,"Block 2002, Block Group 2, Census Tract 5095, Santa Clara County, California",51,51,0
1000000US060855095002003,060855095002003,"Block 2003, Block Group 2, Census Tract 5095, Santa Clara County, California",79,74,5
1000000US060855095002004,060855095002004,"Block 2004, Block Group 2, Census Tract 5095, Santa Clara County, California",29,24,5
1000000US060855095002005,060855095002005,"Block 2005, Block Group 2, Census Tract 5095, Santa Clara County, California",0,0,0
1000000US060855095002006,060855095002006,"Block 2006, Block Group 2, Census Tract 5095, Santa Clara County, California",99,95,4
1000000US060855095002007,060855095002007,"Block 2007, Block Group 2, Census Tract 5095, Santa Clara County, California",45,42,3
1000000US060855095002008,060855095002008,"Block 2008, Block Group 2, Census Tract 5095, Santa Clara County, California",69,69,0
1000000US060855095002009,060855095002009,"Block 2009, Block Group 2, Census Tract 5095, Santa Clara County, California",1,1,0
1000000US060855095002010,060855095002010,"Block 2010, Block Group 2, Census Tract 5095, Santa Clara County, California",11,10,1
1000000US060855095002011,060855095002011,"Block 2011, Block Group 2, Census Tract 5095, Santa Clara County, California",0,0,0
1000000US060855095002012,060855095002012,"Block 2012, Block Group 2, Census Tract 5095, Santa Clara County, California",63,59,4
1000000US060855095002013,060855095002013,"Block 2013, Block Group 2, Census Tract 5095, Santa Clara County, California",78,75,3
1000000US060855095002014,060855095002014,"Block 2014, Block Group 2, Census Tract 5095, Santa Clara County, California",53,47,6
1000000US060855095002015,060855095002015,"Block 2015, Block Group 2, Census Tract 5095, Santa Clara County, California",3,2,1
1000000US060855095003000,060855095003000,"Block 3000, Block Group 3, Census Tract 5095, Santa Clara County, California",45,42,3
1000000US060855095003001,060855095003001,"Block 3001, Block Group 3, Census Tract 5095, Santa Clara County, California",4,4,0
1000000US060855095003002,060855095003002,"Block 3002, Block Group 3, Census Tract 5095, Santa Clara County, California",48,40,8
1000000US060855095003003,060855095003003,"Block 3003, Block Group 3, Census Tract 5095, Santa Clara County, California",47,46,1
1000000US060855095003004,060855095003004,"Block 3004, Block Group 3, Census Tract 5095, Santa Clara County, California",23,23,0
1000000US060855095003005,060855095003005,"Block 3005, Block Group 3, Census Tract 5095, Santa Clara County, California",24,23,1
1000000US060855095003006,060855095003006,"Block 3006, Block Group 3, Census Tract 5095, Santa Clara County, California",1,1,0
1000000US060855095003007,060855095003007,"Block 3007, Block Group 3, Census Tract 5095, Santa Clara County, California",0,0,0
1000000US060855095003008,060855095003008,"Block 3008, Block Group 3, Census Tract 5095, Santa Clara County, California",0,0,0
1000000US060855095003009,060855095003009,"Block 3009, Block Group 3, Census Tract 5095, Santa Clara County, California",1,1,0
1000000US060855095003010,060855095003010,"Block 3010, Block Group 3, Census Tract 5095, Santa Clara County, California",32,29,3
1000000US060855095003011,060855095003011,"Block 3011, Block Group 3, Census Tract 5095, Santa Clara County, California",41,36,5
1000000US060855095003012,060855095003012,"Block 3012, Block Group 3, Census Tract 5095, Santa Clara County, California",45,40,5
1000000US060855095003013,060855095003013,"Block 3013, Block Group 3, Census Tract 5095, Santa Clara County, California",74,68,6
1000000US060855095003014,060855095003014,"Block 3014, Block Group 3, Census Tract 5095, Santa Clara County, California",53,46,7
1000000US060855095003015,060855095003015,"Block 3015, Block Group 3, Census Tract 5095, Santa Clara County, California",23,20,3
1000000US060855095003016,060855095003016,"Block 3016, Block Group 3, Census Tract 5095, Santa Clara County, California",25,25,0
1000000US060855095003017,060855095003017,"Block 3017, Block Group 3, Census Tract 5095, Santa Clara County, California",25,23,2
1000000US060855095003018,060855095003018,"Block 3018, Block Group 3, Census Tract 5095, Santa Clara County, California",23,21,2
1000000US060855095003019,060855095003019,"Block 3019, Block Group 3, Census Tract 5095, Santa Clara County, California",22,21,1
1000000US060855095003020,060855095003020,"Block 3020, Block Group 3, Census Tract 5095, Santa Clara County, California",15,14,1
1000000US060855095003021,060855095003021,"Block 3021, Block Group 3, Census Tract 5095, Santa Clara County, California",24,23,1
1000000US060855095003022,060855095003022,"Block 3022, Block Group 3, Census Tract 5095, Santa Clara County, California",23,22,1
1000000US060855095003023,060855095003023,"Block 3023, Block Group 3, Census Tract 5095, Santa Clara County, California",48,45,3
1000000US060855095003024,060855095003024,"Block 3024, Block Group 3, Census Tract 5095, Santa Clara County, California",34,33,1
1000000US060855095003025,060855095003025,"Block 3025, Block Group 3, Census Tract 5095, Santa Clara County, California",18,18,0
1000000US060855095003026,060855095003026,"Block 3026, Block Group 3, Census Tract 5095, Santa Clara County, California",0,0,0
1000000US060855095003027,060855095003027,"Block 3027, Block Group 3, Census Tract 5095, Santa Clara County, California",0,0,0
1000000US060855096001000,060855096001000,"Block 1000, Block Group 1, Census Tract 5096, Santa Clara County, California",0,0,0
1000000US060855096001001,060855096001001,"Block 1001, Block Group 1, Census Tract 5096, Santa Clara County, California",0,0,0
1000000US060855096001002,060855096001002,"Block 1002, Block Group 1, Census Tract 5096, Santa Clara County, California",0,0,0
1000000US060855096001003,060855096001003,"Block 1003, Block Group 1, Census Tract 5096, Santa Clara County, California",0,0,0
1000000US060855096001004,060855096001004,"Block 1004, Block Group 1, Census Tract 5096, Santa Clara County, California",0,0,0
1000000US060855096001005,060855096001005,"Block 1005, Block Group 1, Census Tract 5096, Santa Clara County, California",0,0,0
1000000US060855096001006,060855096001006,"Block 1006, Block Group 1, Census Tract 5096, Santa Clara County, California",0,0,0
1000000US060855096001007,060855096001007,"Block 1007, Block Group 1, Census Tract 5096, Santa Clara County, California",0,0,0
1000000US060855096001008,060855096001008,"Block 1008, Block Group 1, Census Tract 5096, Santa Clara County, California",0,0,0
1000000US060855096001009,060855096001009,"Block 1009, Block Group 1, Census Tract 5096, Santa Clara County, California",10,10,0
1000000US060855096001010,060855096001010,"Block 1010, Block Group 1, Census Tract 5096, Santa Clara County, California",44,41,3
1000000US060855096001011,060855096001011,"Block 1011, Block Group 1, Census Tract 5096, Santa Clara County, California",5,5,0
1000000US060855096001012,060855096001012,"Block 1012, Block Group 1, Census Tract 5096, Santa Clara County, California",0,0,0
1000000US060855096001013,060855096001013,"Block 1013, Block Group 1, Census Tract 5096, Santa Clara County, California",0,0,0
1000000US060855096001014,060855096001014,"Block 1014, Block Group 1, Census Tract 5096, Santa Clara County, California",5,4,1
1000000US060855096001015,060855096001015,"Block 1015, Block Group 1, Census Tract 5096, Santa Clara County, California",1,0,1
1000000US060855096001016,060855096001016,"Block 1016, Block Group 1, Census Tract 5096, Santa Clara County, California",0,0,0
1000000US060855096001017,060855096001017,"Block 1017, Block Group 1, Census Tract 5096, Santa Clara County, California",37,30,7
1000000US060855096001018,060855096001018,"Block 1018, Block Group 1, Census Tract 5096, Santa Clara County, California",11,11,0
1000000US060855096001019,060855096001019,"Block 1019, Block Group 1, Census Tract 5096, Santa Clara County, California",0,0,0
1000000US060855096001020,060855096001020,"Block 1020, Block Group 1, Census Tract 5096, Santa Clara County, California",0,0,0
1000000US060855096001021,060855096001021,"Block 1021, Block Group 1, Census Tract 5096, Santa Clara County, California",0,0,0
1000000US060855096001022,060855096001022,"Block 1022, Block Group 1, Census Tract 5096, Santa Clara County, California",23,23,0
1000000US060855096001023,060855096001023,"Block 1023, Block Group 1, Census Tract 5096, Santa Clara County, California",44,38,6
1000000US060855096001024,060855096001024,"Block 1024, Block Group 1, Census Tract 5096, Santa Clara County, California",47,43,4
1000000US060855096001025,060855096001025,"Block 1025, Block Group 1, Census Tract 5096, Santa Clara County, California",27,26,1
1000000US060855096001026,060855096001026,"Block 1026, Block Group 1, Census Tract 5096, Santa Clara County, California",1,1,0
1000000US060855096001027,060855096001027,"Block 1027, Block Group 1, Census Tract 5096, Santa Clara County, California",0,0,0
1000000US060855096001028,060855096001028,"Block 1028, Block Group 1, Census Tract 5096, Santa Clara County, California",2,2,0
1000000US060855096001029,060855096001029,"Block 1029, Block Group 1, Census Tract 5096, Santa Clara County, California",0,0,0
1000000US060855096001030,060855096001030,"Block 1030, Block Group 1, Census Tract 5096, Santa Clara County, California",25,24,1
1000000US060855096001031,060855096001031,"Block 1031, Block Group 1, Census Tract 5096, Santa Clara County, California",1,1,0
1000000US060855096001032,060855096001032,"Block 1032, Block Group 1, Census Tract 5096, Santa Clara County, California",8,8,0
1000000US060855096001033,060855096001033,"Block 1033, Block Group 1, Census Tract 5096, Santa Clara County, California",4,4,0
1000000US060855096001034,060855096001034,"Block 1034, Block Group 1, Census Tract 5096, Santa Clara County, California",4,4,0
1000000US060855096001035,060855096001035,"Block 1035, Block Group 1, Census Tract 5096, Santa Clara County, California",9,9,0
1000000US060855096001036,060855096001036,"Block 1036, Block Group 1, Census Tract 5096, Santa Clara County, California",4,4,0
1000000US060855096001037,060855096001037,"Block 1037, Block Group 1, Census Tract 5096, Santa Clara County, California",4,3,1
1000000US060855096001038,060855096001038,"Block 1038, Block Group 1, Census Tract 5096, Santa Clara County, California",2,2,0
1000000US060855096001039,060855096001039,"Block 1039, Block Group 1, Census Tract 5096, Santa Clara County, California",0,0,0
1000000US060855096001040,060855096001040,"Block 1040, Block Group 1, Census Tract 5096, Santa Clara County, California",33,31,2
1000000US060855096001041,060855096001041,"Block 1041, Block Group 1, Census Tract 5096, Santa Clara County, California",6,6,0
1000000US060855096001042,060855096001042,"Block 1042, Block Group 1, Census Tract 5096, Santa Clara County, California",0,0,0
1000000US060855096001043,060855096001043,"Block 1043, Block Group 1, Census Tract 5096, Santa Clara County, California",0,0,0
1000000US060855096001044,060855096001044,"Block 1044, Block Group 1, Census Tract 5096, Santa Clara County, California",0,0,0
1000000US060855096001045,060855096001045,"Block 1045, Block Group 1, Census Tract 5096, Santa Clara County, California",0,0,0
1000000US060855096001046,060855096001046,"Block 1046, Block Group 1, Census Tract 5096, Santa Clara County, California",0,0,0
1000000US060855096001047,060855096001047,"Block 1047, Block Group 1, Census Tract 5096, Santa Clara County, California",0,0,0
1000000US060855096001048,060855096001048,"Block 1048, Block Group 1, Census Tract 5096, Santa Clara County, California",0,0,0
1000000US060855096001049,060855096001049,"Block 1049, Block Group 1, Census Tract 5096, Santa Clara County, California",17,15,2
1000000US060855096001050,060855096001050,"Block 1050, Block Group 1, Census Tract 5096, Santa Clara County, California",0,0,0
1000000US060855096001051,060855096001051,"Block 1051, Block Group 1, Census Tract 5096, Santa Clara County, California",18,17,1
1000000US060855096001052,060855096001052,"Block 1052, Block Group 1, Census Tract 5096, Santa Clara County, California",32,31,1
1000000US060855096001053,060855096001053,"Block 1053, Block Group 1, Census Tract 5096, Santa Clara County, California",43,41,2
1000000US060855096001054,060855096001054,"Block 1054, Block Group 1, Census Tract 5096, Santa Clara County, California",20,17,3
1000000US060855096001055,060855096001055,"Block 1055, Block Group 1, Census Tract 5096, Santa Clara County, California",0,0,0
1000000US060855096001056,060855096001056,"Block 1056, Block Group 1, Census Tract 5096, Santa Clara County, California",0,0,0
1000000US060855096001057,060855096001057,"Block 1057, Block Group 1, Census Tract 5096, Santa Clara County, California",0,0,0
1000000US060855096001058,060855096001058,"Block 1058, Block Group 1, Census Tract 5096, Santa Clara County, California",0,0,0
1000000US060855096001059,060855096001059,"Block 1059, Block Group 1, Census Tract 5096, Santa Clara County, California",0,0,0
1000000US060855096001060,060855096001060,"Block 1060, Block Group 1, Census Tract 5096, Santa Clara County, California",35,34,1
1000000US060855096001061,060855096001061,"Block 1061, Block Group 1, Census Tract 5096, Santa Clara County, California",22,20,2
1000000US060855096001062,060855096001062,"Block 1062, Block Group 1, Census Tract 5096, Santa Clara County, California",38,36,2
1000000US060855096001063,060855096001063,"Block 1063, Block Group 1, Census Tract 5096, Santa Clara County, California",34,29,5
1000000US060855096001064,060855096001064,"Block 1064, Block Group 1, Census Tract 5096, Santa Clara County, California",73,72,1
1000000US060855096001065,060855096001065,"Block 1065, Block Group 1, Census Tract 5096, Santa Clara County, California",80,69,11
1000000US060855096001066,060855096001066,"Block 1066, Block Group 1, Census Tract 5096, Santa Clara County, California",0,0,0
1000000US060855096001067,060855096001067,"Block 1067, Block Group 1, Census Tract 5096, Santa Clara County, California",0,0,0
1000000US060855096001068,060855096001068,"Block 1068, Block Group 1, Census Tract 5096, Santa Clara County, California",0,0,0
1000000US060855096001069,060855096001069,"Block 1069, Block Group 1, Census Tract 5096, Santa Clara County, California",42,39,3
1000000US060855096001070,060855096001070,"Block 1070, Block Group 1, Census Tract 5096, Santa Clara County, California",32,32,0
1000000US060855096001071,060855096001071,"Block 1071, Block Group 1, Census Tract 5096, Santa Clara County, California",0,0,0
1000000US060855096002000,060855096002000,"Block 2000, Block Group 2, Census Tract 5096, Santa Clara County, California",0,0,0
1000000US060855096002001,060855096002001,"Block 2001, Block Group 2, Census Tract 5096, Santa Clara County, California",173,173,0
1000000US060855096002002,060855096002002,"Block 2002, Block Group 2, Census Tract 5096, Santa Clara County, California",17,16,1
1000000US060855096002003,060855096002003,"Block 2003, Block Group 2, Census Tract 5096, Santa Clara County, California",154,131,23
1000000US060855096002004,060855096002004,"Block 2004, Block Group 2, Census Tract 5096, Santa Clara County, California",0,0,0
1000000US060855096002005,060855096002005,"Block 2005, Block Group 2, Census Tract 5096, Santa Clara County, California",21,20,1
1000000US060855096002006,060855096002006,"Block 2006, Block Group 2, Census Tract 5096, Santa Clara County, California",17,15,2
1000000US060855096002007,060855096002007,"Block 2007, Block Group 2, Census Tract 5096, Santa Clara County, California",11,10,1
1000000US060855096002008,060855096002008,"Block 2008, Block Group 2, Census Tract 5096, Santa Clara County, California",10,10,0
1000000US060855096002009,060855096002009,"Block 2009, Block Group 2, Census Tract 5096, Santa Clara County, California",15,15,0
1000000US060855096002010,060855096002010,"Block 2010, Block Group 2, Census Tract 5096, Santa Clara County, California",15,15,0
1000000US060855096002011,060855096002011,"Block 2011, Block Group 2, Census Tract 5096, Santa Clara County, California",6,6,0
1000000US060855096002012,060855096002012,"Block 2012, Block Group 2, Census Tract 5096, Santa Clara County, California",0,0,0
1000000US060855096002013,060855096002013,"Block 2013, Block Group 2, Census Tract 5096, Santa Clara County, California",0,0,0
1000000US060855096002014,060855096002014,"Block 2014, Block Group 2, Census Tract 5096, Santa Clara County, California",54,53,1
1000000US060855096002015,060855096002015,"Block 2015, Block Group 2, Census Tract 5096, Santa Clara County, California",0,0,0
1000000US060855096002016,060855096002016,"Block 2016, Block Group 2, Census Tract 5096, Santa Clara County, California",0,0,0
1000000US060855096002017,060855096002017,"Block 2017, Block Group 2, Census Tract 5096, Santa Clara County, California",0,0,0
1000000US060855096002018,060855096002018,"Block 2018, Block Group 2, Census Tract 5096, Santa Clara County, California",0,0,0
1000000US060855096002019,060855096002019,"Block 2019, Block Group 2, Census Tract 5096, Santa Clara County, California",0,0,0
1000000US060855096002020,060855096002020,"Block 2020, Block Group 2, Census Tract 5096, Santa Clara County, California",22,21,1
1000000US060855096002021,060855096002021,"Block 2021, Block Group 2, Census Tract 5096, Santa Clara County, California",0,0,0
1000000US060855096002022,060855096002022,"Block 2022, Block Group 2, Census Tract 5096, Santa Clara County, California",6,6,0
1000000US060855096002023,060855096002023,"Block 2023, Block Group 2, Census Tract 5096, Santa Clara County, California",10,10,0
1000000US060855097001000,060855097001000,"Block 1000, Block Group 1, Census Tract 5097, Santa Clara County, California",58,57,1
1000000US060855097001001,060855097001001,"Block 1001, Block Group 1, Census Tract 5097, Santa Clara County, California",10,10,0
1000000US060855097001002,060855097001002,"Block 1002, Block Group 1, Census Tract 5097, Santa Clara County, California",31,29,2
1000000US060855097001003,060855097001003,"Block 1003, Block Group 1, Census Tract 5097, Santa Clara County, California",28,27,1
1000000US060855097001004,060855097001004,"Block 1004, Block Group 1, Census Tract 5097, Santa Clara County, California",12,12,0
1000000US060855097001005,060855097001005,"Block 1005, Block Group 1, Census Tract 5097, Santa Clara County, California",38,36,2
1000000US060855097001006,060855097001006,"Block 1006, Block Group 1, Census Tract 5097, Santa Clara County, California",20,19,1
1000000US060855097001007,060855097001007,"Block 1007, Block Group 1, Census Tract 5097, Santa Clara County, California",36,34,2
1000000US060855097001008,060855097001008,"Block 1008, Block Group 1, Census Tract 5097, Santa Clara County, California",24,23,1
1000000US060855097001009,060855097001009,"Block 1009, Block Group 1, Census Tract 5097, Santa Clara County, California",127,119,8
1000000US060855097001010,060855097001010,"Block 1010, Block Group 1, Census Tract 5097, Santa Clara County, California",15,15,0
1000000US060855097001011,060855097001011,"Block 1011, Block Group 1, Census Tract 5097, Santa Clara County, California",13,13,0
1000000US060855097001012,060855097001012,"Block 1012, Block Group 1, Census Tract 5097, Santa Clara County, California",20,20,0
1000000US060855097001013,060855097001013,"Block 1013, Block Group 1, Census Tract 5097, Santa Clara County, California",28,25,3
1000000US060855097002000,060855097002000,"Block 2000, Block Group 2, Census Tract 5097, Santa Clara County, California",0,0,0
1000000US060855097002001,060855097002001,"Block 2001, Block Group 2, Census Tract 5097, Santa Clara County, California",0,0,0
1000000US060855097002002,060855097002002,"Block 2002, Block Group 2, Census Tract 5097, Santa Clara County, California",349,337,12
1000000US060855097002003,060855097002003,"Block 2003, Block Group 2, Census Tract 5097, Santa Clara County, California",90,89,1
1000000US060855097002004,060855097002004,"Block 2004, Block Group 2, Census Tract 5097, Santa Clara County, California",15,15,0
1000000US060855097002005,060855097002005,"Block 2005, Block Group 2, Census Tract 5097, Santa Clara County, California",6,6,0
1000000US060855097002006,060855097002006,"Block 2006, Block Group 2, Census Tract 5097, Santa Clara County, California",45,44,1
1000000US060855097002007,060855097002007,"Block 2007, Block Group 2, Census Tract 5097, Santa Clara County, California",0,0,0
1000000US060855097002008,060855097002008,"Block 2008, Block Group 2, Census Tract 5097, Santa Clara County, California",0,0,0
1000000US060855097002009,060855097002009,"Block 2009, Block Group 2, Census Tract 5097, Santa Clara County, California",0,0,0
1000000US060855097003000,060855097003000,"Block 3000, Block Group 3, Census Tract 5097, Santa Clara County, California",23,22,1
1000000US060855097003001,060855097003001,"Block 3001, Block Group 3, Census Tract 5097, Santa Clara County, California",52,52,0
1000000US060855097003002,060855097003002,"Block 3002, Block Group 3, Census Tract 5097, Santa Clara County, California",23,22,1
1000000US060855097003003,060855097003003,"Block 3003, Block Group 3, Census Tract 5097, Santa Clara County, California",65,61,4
1000000US060855097003004,060855097003004,"Block 3004, Block Group 3, Census Tract 5097, Santa Clara County, California",68,66,2
1000000US060855097003005,060855097003005,"Block 3005, Block Group 3, Census Tract 5097, Santa Clara County, California",105,102,3
1000000US060855097003006,060855097003006,"Block 3006, Block Group 3, Census Tract 5097, Santa Clara County, California",12,12,0
1000000US060855097003007,060855097003007,"Block 3007, Block Group 3, Census Tract 5097, Santa Clara County, California",62,59,3
1000000US060855097003008,060855097003008,"Block 3008, Block Group 3, Census Tract 5097, Santa Clara County, California",28,28,0
1000000US060855097003009,060855097003009,"Block 3009, Block Group 3, Census Tract 5097, Santa Clara County, California",16,16,0
1000000US060855097003010,060855097003010,"Block 3010, Block Group 3, Census Tract 5097, Santa Clara County, California",78,76,2
1000000US060855097003011,060855097003011,"Block 3011, Block Group 3, Census Tract 5097, Santa Clara County, California",0,0,0
1000000US060855097003012,060855097003012,"Block 3012, Block Group 3, Census Tract 5097, Santa Clara County, California",0,0,0
1000000US060855097003013,060855097003013,"Block 3013, Block Group 3, Census Tract 5097, Santa Clara County, California",0,0,0
1000000US060855097003014,060855097003014,"Block 3014, Block Group 3, Census Tract 5097, Santa Clara County, California",0,0,0
1000000US060855097003015,060855097003015,"Block 3015, Block Group 3, Census Tract 5097, Santa Clara County, California",0,0,0
1000000US060855097003016,060855097003016,"Block 3016, Block Group 3, Census Tract 5097, Santa Clara County, California",0,0,0
1000000US060855097003017,060855097003017,"Block 3017, Block Group 3, Census Tract 5097, Santa Clara County, California",0,0,0
1000000US060855097003018,060855097003018,"Block 3018, Block Group 3, Census Tract 5097, Santa Clara County, California",0,0,0
1000000US060855097003019,060855097003019,"Block 3019, Block Group 3, Census Tract 5097, Santa Clara County, California",5,5,0
1000000US060855097003020,060855097003020,"Block 3020, Block Group 3, Census Tract 5097, Santa Clara County, California",0,0,0
1000000US060855097003021,060855097003021,"Block 3021, Block Group 3, Census Tract 5097, Santa Clara County, California",2,2,0
1000000US060855097003022,060855097003022,"Block 3022, Block Group 3, Census Tract 5097, Santa Clara County, California",0,0,0
1000000US060855098011000,060855098011000,"Block 1000, Block Group 1, Census Tract 5098.01, Santa Clara County, California",52,52,0
1000000US060855098011001,060855098011001,"Block 1001, Block Group 1, Census Tract 5098.01, Santa Clara County, California",32,29,3
1000000US060855098011002,060855098011002,"Block 1002, Block Group 1, Census Tract 5098.01, Santa Clara County, California",73,70,3
1000000US060855098011003,060855098011003,"Block 1003, Block Group 1, Census Tract 5098.01, Santa Clara County, California",0,0,0
1000000US060855098011004,060855098011004,"Block 1004, Block Group 1, Census Tract 5098.01, Santa Clara County, California",84,79,5
1000000US060855098011005,060855098011005,"Block 1005, Block Group 1, Census Tract 5098.01, Santa Clara County, California",0,0,0
1000000US060855098011006,060855098011006,"Block 1006, Block Group 1, Census Tract 5098.01, Santa Clara County, California",0,0,0
1000000US060855098011007,060855098011007,"Block 1007, Block Group 1, Census Tract 5098.01, Santa Clara County, California",129,122,7
1000000US060855098011008,060855098011008,"Block 1008, Block Group 1, Census Tract 5098.01, Santa Clara County, California",0,0,0
1000000US060855098011009,060855098011009,"Block 1009, Block Group 1, Census Tract 5098.01, Santa Clara County, California",47,46,1
1000000US060855098011010,060855098011010,"Block 1010, Block Group 1, Census Tract 5098.01, Santa Clara County, California",101,98,3
1000000US060855098011011,060855098011011,"Block 1011, Block Group 1, Census Tract 5098.01, Santa Clara County, California",50,46,4
1000000US060855098011012,060855098011012,"Block 1012, Block Group 1, Census Tract 5098.01, Santa Clara County, California",96,93,3
1000000US060855098011013,060855098011013,"Block 1013, Block Group 1, Census Tract 5098.01, Santa Clara County, California",26,24,2
1000000US060855098011014,060855098011014,"Block 1014, Block Group 1, Census Tract 5098.01, Santa Clara County, California",0,0,0
1000000US060855098011015,060855098011015,"Block 1015, Block Group 1, Census Tract 5098.01, Santa Clara County, California",0,0,0
1000000US060855098011016,060855098011016,"Block 1016, Block Group 1, Census Tract 5098.01, Santa Clara County, California",0,0,0
1000000US060855098011017,060855098011017,"Block 1017, Block Group 1, Census Tract 5098.01, Santa Clara County, California",86,80,6
1000000US060855098011018,060855098011018,"Block 1018, Block Group 1, Census Tract 5098.01, Santa Clara County, California",37,35,2
1000000US060855098011019,060855098011019,"Block 1019, Block Group 1, Census Tract 5098.01, Santa Clara County, California",1,1,0
1000000US060855098011020,060855098011020,"Block 1020, Block Group 1, Census Tract 5098.01, Santa Clara County, California",0,0,0
1000000US060855098012000,060855098012000,"Block 2000, Block Group 2, Census Tract 5098.01, Santa Clara County, California",116,115,1
1000000US060855098012001,060855098012001,"Block 2001, Block Group 2, Census Tract 5098.01, Santa Clara County, California",29,29,0
1000000US060855098012002,060855098012002,"Block 2002, Block Group 2, Census Tract 5098.01, Santa Clara County, California",29,26,3
1000000US060855098012003,060855098012003,"Block 2003, Block Group 2, Census Tract 5098.01, Santa Clara County, California",28,24,4
1000000US060855098012004,060855098012004,"Block 2004, Block Group 2, Census Tract 5098.01, Santa Clara County, California",22,21,1
1000000US060855098012005,060855098012005,"Block 2005, Block Group 2, Census Tract 5098.01, Santa Clara County, California",18,18,0
1000000US060855098012006,060855098012006,"Block 2006, Block Group 2, Census Tract 5098.01, Santa Clara County, California",10,10,0
1000000US060855098012007,060855098012007,"Block 2007, Block Group 2, Census Tract 5098.01, Santa Clara County, California",10,10,0
1000000US060855098012008,060855098012008,"Block 2008, Block Group 2, Census Tract 5098.01, Santa Clara County, California",16,16,0
1000000US060855098012009,060855098012009,"Block 2009, Block Group 2, Census Tract 5098.01, Santa Clara County, California",24,24,0
1000000US060855098012010,060855098012010,"Block 2010, Block Group 2, Census Tract 5098.01, Santa Clara County, California",24,23,1
1000000US060855098012011,060855098012011,"Block 2011, Block Group 2, Census Tract 5098.01, Santa Clara County, California",31,29,2
1000000US060855098012012,060855098012012,"Block 2012, Block Group 2, Census Tract 5098.01, Santa Clara County, California",17,17,0
1000000US060855098012013,060855098012013,"Block 2013, Block Group 2, Census Tract 5098.01, Santa Clara County, California",12,12,0
1000000US060855098013000,060855098013000,"Block 3000, Block Group 3, Census Tract 5098.01, Santa Clara County, California",72,48,24
1000000US060855098013001,060855098013001,"Block 3001, Block Group 3, Census Tract 5098.01, Santa Clara County, California",13,13,0
1000000US060855098013002,060855098013002,"Block 3002, Block Group 3, Census Tract 5098.01, Santa Clara County, California",35,35,0
1000000US060855098013003,060855098013003,"Block 3003, Block Group 3, Census Tract 5098.01, Santa Clara County, California",40,38,2
1000000US060855098013004,060855098013004,"Block 3004, Block Group 3, Census Tract 5098.01, Santa Clara County, California",53,50,3
1000000US060855098013005,060855098013005,"Block 3005, Block Group 3, Census Tract 5098.01, Santa Clara County, California",0,0,0
1000000US060855098013006,060855098013006,"Block 3006, Block Group 3, Census Tract 5098.01, Santa Clara County, California",0,0,0
1000000US060855098013007,060855098013007,"Block 3007, Block Group 3, Census Tract 5098.01, Santa Clara County, California",20,20,0
1000000US060855098013008,060855098013008,"Block 3008, Block Group 3, Census Tract 5098.01, Santa Clara County, California",70,65,5
1000000US060855098013009,060855098013009,"Block 3009, Block Group 3, Census Tract 5098.01, Santa Clara County, California",0,0,0
1000000US060855098013010,060855098013010,"Block 3010, Block Group 3, Census Tract 5098.01, Santa Clara County, California",24,24,0
1000000US060855098013011,060855098013011,"Block 3011, Block Group 3, Census Tract 5098.01, Santa Clara County, California",24,24,0
1000000US060855098013012,060855098013012,"Block 3012, Block Group 3, Census Tract 5098.01, Santa Clara County, California",39,38,1
1000000US060855098013013,060855098013013,"Block 3013, Block Group 3, Census Tract 5098.01, Santa Clara County, California",22,21,1
1000000US060855098013014,060855098013014,"Block 3014, Block Group 3, Census Tract 5098.01, Santa Clara County, California",46,46,0
1000000US060855098013015,060855098013015,"Block 3015, Block Group 3, Census Tract 5098.01, Santa Clara County, California",45,43,2
1000000US060855098013016,060855098013016,"Block 3016, Block Group 3, Census Tract 5098.01, Santa Clara County, California",39,37,2
1000000US060855098013017,060855098013017,"Block 3017, Block Group 3, Census Tract 5098.01, Santa Clara County, California",2,2,0
1000000US060855098013018,060855098013018,"Block 3018, Block Group 3, Census Tract 5098.01, Santa Clara County, California",1,1,0
1000000US060855098014000,060855098014000,"Block 4000, Block Group 4, Census Tract 5098.01, Santa Clara County, California",46,34,12
1000000US060855098014001,060855098014001,"Block 4001, Block Group 4, Census Tract 5098.01, Santa Clara County, California",17,15,2
1000000US060855098014002,060855098014002,"Block 4002, Block Group 4, Census Tract 5098.01, Santa Clara County, California",6,6,0
1000000US060855098014003,060855098014003,"Block 4003, Block Group 4, Census Tract 5098.01, Santa Clara County, California",7,6,1
1000000US060855098014004,060855098014004,"Block 4004, Block Group 4, Census Tract 5098.01, Santa Clara County, California",74,73,1
1000000US060855098014005,060855098014005,"Block 4005, Block Group 4, Census Tract 5098.01, Santa Clara County, California",40,40,0
1000000US060855098014006,060855098014006,"Block 4006, Block Group 4, Census Tract 5098.01, Santa Clara County, California",32,32,0
1000000US060855098014007,060855098014007,"Block 4007, Block Group 4, Census Tract 5098.01, Santa Clara County, California",34,34,0
1000000US060855098014008,060855098014008,"Block 4008, Block Group 4, Census Tract 5098.01, Santa Clara County, California",34,34,0
1000000US060855098014009,060855098014009,"Block 4009, Block Group 4, Census Tract 5098.01, Santa Clara County, California",34,33,1
1000000US060855098014010,060855098014010,"Block 4010, Block Group 4, Census Tract 5098.01, Santa Clara County, California",16,15,1
1000000US060855098014011,060855098014011,"Block 4011, Block Group 4, Census Tract 5098.01, Santa Clara County, California",31,31,0
1000000US060855098014012,060855098014012,"Block 4012, Block Group 4, Census Tract 5098.01, Santa Clara County, California",7,7,0
1000000US060855098014013,060855098014013,"Block 4013, Block Group 4, Census Tract 5098.01, Santa Clara County, California",26,26,0
1000000US060855098014014,060855098014014,"Block 4014, Block Group 4, Census Tract 5098.01, Santa Clara County, California",26,23,3
1000000US060855098014015,060855098014015,"Block 4015, Block Group 4, Census Tract 5098.01, Santa Clara County, California",36,36,0
1000000US060855098014016,060855098014016,"Block 4016, Block Group 4, Census Tract 5098.01, Santa Clara County, California",38,38,0
1000000US060855098014017,060855098014017,"Block 4017, Block Group 4, Census Tract 5098.01, Santa Clara County, California",0,0,0
1000000US060855098014018,060855098014018,"Block 4018, Block Group 4, Census Tract 5098.01, Santa Clara County, California",0,0,0
1000000US060855098014019,060855098014019,"Block 4019, Block Group 4, Census Tract 5098.01, Santa Clara County, California",0,0,0
1000000US060855098014020,060855098014020,"Block 4020, Block Group 4, Census Tract 5098.01, Santa Clara County, California",0,0,0
1000000US060855098014021,060855098014021,"Block 4021, Block Group 4, Census Tract 5098.01, Santa Clara County, California",0,0,0
1000000US060855098014022,060855098014022,"Block 4022, Block Group 4, Census Tract 5098.01, Santa Clara County, California",0,0,0
1000000US060855098014023,060855098014023,"Block 4023, Block Group 4, Census Tract 5098.01, Santa Clara County, California",37,37,0
1000000US060855098014024,060855098014024,"Block 4024, Block Group 4, Census Tract 5098.01, Santa Clara County, California",9,8,1
1000000US060855098014025,060855098014025,"Block 4025, Block Group 4, Census Tract 5098.01, Santa Clara County, California",8,8,0
1000000US060855098021000,060855098021000,"Block 1000, Block Group 1, Census Tract 5098.02, Santa Clara County, California",0,0,0
1000000US060855098021001,060855098021001,"Block 1001, Block Group 1, Census Tract 5098.02, Santa Clara County, California",26,25,1
1000000US060855098021002,060855098021002,"Block 1002, Block Group 1, Census Tract 5098.02, Santa Clara County, California",0,0,0
1000000US060855098021003,060855098021003,"Block 1003, Block Group 1, Census Tract 5098.02, Santa Clara County, California",39,38,1
1000000US060855098021004,060855098021004,"Block 1004, Block Group 1, Census Tract 5098.02, Santa Clara County, California",162,154,8
1000000US060855098021005,060855098021005,"Block 1005, Block Group 1, Census Tract 5098.02, Santa Clara County, California",0,0,0
1000000US060855098021006,060855098021006,"Block 1006, Block Group 1, Census Tract 5098.02, Santa Clara County, California",0,0,0
1000000US060855098021007,060855098021007,"Block 1007, Block Group 1, Census Tract 5098.02, Santa Clara County, California",0,0,0
1000000US060855098021008,060855098021008,"Block 1008, Block Group 1, Census Tract 5098.02, Santa Clara County, California",194,173,21
1000000US060855098021009,060855098021009,"Block 1009, Block Group 1, Census Tract 5098.02, Santa Clara County, California",54,52,2
1000000US060855098021010,060855098021010,"Block 1010, Block Group 1, Census Tract 5098.02, Santa Clara County, California",111,107,4
1000000US060855098021011,060855098021011,"Block 1011, Block Group 1, Census Tract 5098.02, Santa Clara County, California",62,60,2
1000000US060855098022000,060855098022000,"Block 2000, Block Group 2, Census Tract 5098.02, Santa Clara County, California",20,19,1
1000000US060855098022001,060855098022001,"Block 2001, Block Group 2, Census Tract 5098.02, Santa Clara County, California",20,19,1
1000000US060855098022002,060855098022002,"Block 2002, Block Group 2, Census Tract 5098.02, Santa Clara County, California",20,19,1
1000000US060855098022003,060855098022003,"Block 2003, Block Group 2, Census Tract 5098.02, Santa Clara County, California",21,21,0
1000000US060855098022004,060855098022004,"Block 2004, Block Group 2, Census Tract 5098.02, Santa Clara County, California",20,20,0
1000000US060855098022005,060855098022005,"Block 2005, Block Group 2, Census Tract 5098.02, Santa Clara County, California",20,20,0
1000000US060855098022006,060855098022006,"Block 2006, Block Group 2, Census Tract 5098.02, Santa Clara County, California",20,19,1
1000000US060855098022007,060855098022007,"Block 2007, Block Group 2, Census Tract 5098.02, Santa Clara County, California",29,29,0
1000000US060855098022008,060855098022008,"Block 2008, Block Group 2, Census Tract 5098.02, Santa Clara County, California",0,0,0
1000000US060855098022009,060855098022009,"Block 2009, Block Group 2, Census Tract 5098.02, Santa Clara County, California",20,19,1
1000000US060855098022010,060855098022010,"Block 2010, Block Group 2, Census Tract 5098.02, Santa Clara County, California",30,30,0
1000000US060855098022011,060855098022011,"Block 2011, Block Group 2, Census Tract 5098.02, Santa Clara County, California",32,31,1
1000000US060855098022012,060855098022012,"Block 2012, Block Group 2, Census Tract 5098.02, Santa Clara County, California",27,26,1
1000000US060855098022013,060855098022013,"Block 2013, Block Group 2, Census Tract 5098.02, Santa Clara County, California",39,39,0
1000000US060855098022014,060855098022014,"Block 2014, Block Group 2, Census Tract 5098.02, Santa Clara County, California",38,36,2
1000000US060855098022015,060855098022015,"Block 2015, Block Group 2, Census Tract 5098.02, Santa Clara County, California",38,37,1
1000000US060855098022016,060855098022016,"Block 2016, Block Group 2, Census Tract 5098.02, Santa Clara County, California",33,31,2
1000000US060855098022017,060855098022017,"Block 2017, Block Group 2, Census Tract 5098.02, Santa Clara County, California",0,0,0
1000000US060855098022018,060855098022018,"Block 2018, Block Group 2, Census Tract 5098.02, Santa Clara County, California",10,10,0
1000000US060855098022019,060855098022019,"Block 2019, Block Group 2, Census Tract 5098.02, Santa Clara County, California",14,14,0
1000000US060855098022020,060855098022020,"Block 2020, Block Group 2, Census Tract 5098.02, Santa Clara County, California",26,25,1
1000000US060855098022021,060855098022021,"Block 2021, Block Group 2, Census Tract 5098.02, Santa Clara County, California",19,19,0
1000000US060855098022022,060855098022022,"Block 2022, Block Group 2, Census Tract 5098.02, Santa Clara County, California",0,0,0
1000000US060855098022023,060855098022023,"Block 2023, Block Group 2, Census Tract 5098.02, Santa Clara County, California",0,0,0
1000000US060855099011000,060855099011000,"Block 1000, Block Group 1, Census Tract 5099.01, Santa Clara County, California",2,2,0
1000000US060855099011001,060855099011001,"Block 1001, Block Group 1, Census Tract 5099.01, Santa Clara County, California",17,17,0
1000000US060855099011002,060855099011002,"Block 1002, Block Group 1, Census Tract 5099.01, Santa Clara County, California",56,54,2
1000000US060855099011003,060855099011003,"Block 1003, Block Group 1, Census Tract 5099.01, Santa Clara County, California",18,17,1
1000000US060855099011004,060855099011004,"Block 1004, Block Group 1, Census Tract 5099.01, Santa Clara County, California",0,0,0
1000000US060855099011005,060855099011005,"Block 1005, Block Group 1, Census Tract 5099.01, Santa Clara County, California",19,17,2
1000000US060855099011006,060855099011006,"Block 1006, Block Group 1, Census Tract 5099.01, Santa Clara County, California",71,71,0
1000000US060855099011007,060855099011007,"Block 1007, Block Group 1, Census Tract 5099.01, Santa Clara County, California",12,12,0
1000000US060855099011008,060855099011008,"Block 1008, Block Group 1, Census Tract 5099.01, Santa Clara County, California",41,40,1
1000000US060855099011009,060855099011009,"Block 1009, Block Group 1, Census Tract 5099.01, Santa Clara County, California",60,57,3
1000000US060855099011010,060855099011010,"Block 1010, Block Group 1, Census Tract 5099.01, Santa Clara County, California",50,48,2
1000000US060855099011011,060855099011011,"Block 1011, Block Group 1, Census Tract 5099.01, Santa Clara County, California",0,0,0
1000000US060855099011012,060855099011012,"Block 1012, Block Group 1, Census Tract 5099.01, Santa Clara County, California",0,0,0
1000000US060855099011013,060855099011013,"Block 1013, Block Group 1, Census Tract 5099.01, Santa Clara County, California",0,0,0
1000000US060855099011014,060855099011014,"Block 1014, Block Group 1, Census Tract 5099.01, Santa Clara County, California",7,7,0
1000000US060855099011015,060855099011015,"Block 1015, Block Group 1, Census Tract 5099.01, Santa Clara County, California",15,15,0
1000000US060855099011016,060855099011016,"Block 1016, Block Group 1, Census Tract 5099.01, Santa Clara County, California",1,1,0
1000000US060855099011017,060855099011017,"Block 1017, Block Group 1, Census Tract 5099.01, Santa Clara County, California",20,20,0
1000000US060855099011018,060855099011018,"Block 1018, Block Group 1, Census Tract 5099.01, Santa Clara County, California",6,6,0
1000000US060855099011019,060855099011019,"Block 1019, Block Group 1, Census Tract 5099.01, Santa Clara County, California",0,0,0
1000000US060855099011020,060855099011020,"Block 1020, Block Group 1, Census Tract 5099.01, Santa Clara County, California",0,0,0
1000000US060855099011021,060855099011021,"Block 1021, Block Group 1, Census Tract 5099.01, Santa Clara County, California",4,4,0
1000000US060855099011022,060855099011022,"Block 1022, Block Group 1, Census Tract 5099.01, Santa Clara County, California",8,7,1
1000000US060855099011023,060855099011023,"Block 1023, Block Group 1, Census Tract 5099.01, Santa Clara County, California",17,17,0
1000000US060855099012000,060855099012000,"Block 2000, Block Group 2, Census Tract 5099.01, Santa Clara County, California",0,0,0
1000000US060855099012001,060855099012001,"Block 2001, Block Group 2, Census Tract 5099.01, Santa Clara County, California",68,67,1
1000000US060855099012002,060855099012002,"Block 2002, Block Group 2, Census Tract 5099.01, Santa Clara County, California",16,16,0
1000000US060855099012003,060855099012003,"Block 2003, Block Group 2, Census Tract 5099.01, Santa Clara County, California",24,24,0
1000000US060855099012004,060855099012004,"Block 2004, Block Group 2, Census Tract 5099.01, Santa Clara County, California",56,53,3
1000000US060855099012005,060855099012005,"Block 2005, Block Group 2, Census Tract 5099.01, Santa Clara County, California",28,27,1
1000000US060855099012006,060855099012006,"Block 2006, Block Group 2, Census Tract 5099.01, Santa Clara County, California",28,28,0
1000000US060855099012007,060855099012007,"Block 2007, Block Group 2, Census Tract 5099.01, Santa Clara County, California",26,26,0
1000000US060855099012008,060855099012008,"Block 2008, Block Group 2, Census Tract 5099.01, Santa Clara County, California",36,36,0
1000000US060855099012009,060855099012009,"Block 2009, Block Group 2, Census Tract 5099.01, Santa Clara County, California",58,57,1
1000000US060855099021000,060855099021000,"Block 1000, Block Group 1, Census Tract 5099.02, Santa Clara County, California",101,96,5
1000000US060855099021001,060855099021001,"Block 1001, Block Group 1, Census Tract 5099.02, Santa Clara County, California",1,1,0
1000000US060855099021002,060855099021002,"Block 1002, Block Group 1, Census Tract 5099.02, Santa Clara County, California",71,70,1
1000000US060855099021003,060855099021003,"Block 1003, Block Group 1, Census Tract 5099.02, Santa Clara County, California",0,0,0
1000000US060855099021004,060855099021004,"Block 1004, Block Group 1, Census Tract 5099.02, Santa Clara County, California",1,1,0
1000000US060855099021005,060855099021005,"Block 1005, Block Group 1, Census Tract 5099.02, Santa Clara County, California",0,0,0
1000000US060855099021006,060855099021006,"Block 1006, Block Group 1, Census Tract 5099.02, Santa Clara County, California",0,0,0
1000000US060855099021007,060855099021007,"Block 1007, Block Group 1, Census Tract 5099.02, Santa Clara County, California",0,0,0
1000000US060855099021008,060855099021008,"Block 1008, Block Group 1, Census Tract 5099.02, Santa Clara County, California",547,539,8
1000000US060855099021009,060855099021009,"Block 1009, Block Group 1, Census Tract 5099.02, Santa Clara County, California",14,13,1
1000000US060855099021010,060855099021010,"Block 1010, Block Group 1, Census Tract 5099.02, Santa Clara County, California",0,0,0
1000000US060855099021011,060855099021011,"Block 1011, Block Group 1, Census Tract 5099.02, Santa Clara County, California",24,23,1
1000000US060855099021012,060855099021012,"Block 1012, Block Group 1, Census Tract 5099.02, Santa Clara County, California",26,26,0
1000000US060855099021013,060855099021013,"Block 1013, Block Group 1, Census Tract 5099.02, Santa Clara County, California",10,9,1
1000000US060855099021014,060855099021014,"Block 1014, Block Group 1, Census Tract 5099.02, Santa Clara County, California",31,28,3
1000000US060855099021015,060855099021015,"Block 1015, Block Group 1, Census Tract 5099.02, Santa Clara County, California",8,8,0
1000000US060855099021016,060855099021016,"Block 1016, Block Group 1, Census Tract 5099.02, Santa Clara County, California",37,31,6
1000000US060855099021017,060855099021017,"Block 1017, Block Group 1, Census Tract 5099.02, Santa Clara County, California",26,20,6
1000000US060855099021018,060855099021018,"Block 1018, Block Group 1, Census Tract 5099.02, Santa Clara County, California",21,21,0
1000000US060855099021019,060855099021019,"Block 1019, Block Group 1, Census Tract 5099.02, Santa Clara County, California",0,0,0
1000000US060855099021020,060855099021020,"Block 1020, Block Group 1, Census Tract 5099.02, Santa Clara County, California",44,43,1
1000000US060855099021021,060855099021021,"Block 1021, Block Group 1, Census Tract 5099.02, Santa Clara County, California",24,23,1
1000000US060855099021022,060855099021022,"Block 1022, Block Group 1, Census Tract 5099.02, Santa Clara County, California",0,0,0
1000000US060855099021023,060855099021023,"Block 1023, Block Group 1, Census Tract 5099.02, Santa Clara County, California",16,13,3
1000000US060855099021024,060855099021024,"Block 1024, Block Group 1, Census Tract 5099.02, Santa Clara County, California",0,0,0
1000000US060855099021025,060855099021025,"Block 1025, Block Group 1, Census Tract 5099.02, Santa Clara County, California",26,26,0
1000000US060855099021026,060855099021026,"Block 1026, Block Group 1, Census Tract 5099.02, Santa Clara County, California",1,1,0
1000000US060855099021027,060855099021027,"Block 1027, Block Group 1, Census Tract 5099.02, Santa Clara County, California",0,0,0
1000000US060855099021028,060855099021028,"Block 1028, Block Group 1, Census Tract 5099.02, Santa Clara County, California",0,0,0
1000000US060855099021029,060855099021029,"Block 1029, Block Group 1, Census Tract 5099.02, Santa Clara County, California",0,0,0
1000000US060855099021030,060855099021030,"Block 1030, Block Group 1, Census Tract 5099.02, Santa Clara County, California",0,0,0
1000000US060855099022000,060855099022000,"Block 2000, Block Group 2, Census Tract 5099.02, Santa Clara County, California",25,25,0
1000000US060855099022001,060855099022001,"Block 2001, Block Group 2, Census Tract 5099.02, Santa Clara County, California",64,62,2
1000000US060855099022002,060855099022002,"Block 2002, Block Group 2, Census Tract 5099.02, Santa Clara County, California",39,39,0
1000000US060855099022003,060855099022003,"Block 2003, Block Group 2, Census Tract 5099.02, Santa Clara County, California",0,0,0
1000000US060855099022004,060855099022004,"Block 2004, Block Group 2, Census Tract 5099.02, Santa Clara County, California",0,0,0
1000000US060855099022005,060855099022005,"Block 2005, Block Group 2, Census Tract 5099.02, Santa Clara County, California",67,66,1
1000000US060855099022006,060855099022006,"Block 2006, Block Group 2, Census Tract 5099.02, Santa Clara County, California",4,4,0
1000000US060855099022007,060855099022007,"Block 2007, Block Group 2, Census Tract 5099.02, Santa Clara County, California",33,33,0
1000000US060855099022008,060855099022008,"Block 2008, Block Group 2, Census Tract 5099.02, Santa Clara County, California",0,0,0
1000000US060855099022009,060855099022009,"Block 2009, Block Group 2, Census Tract 5099.02, Santa Clara County, California",21,21,0
1000000US060855099022010,060855099022010,"Block 2010, Block Group 2, Census Tract 5099.02, Santa Clara County, California",17,17,0
1000000US060855099022011,060855099022011,"Block 2011, Block Group 2, Census Tract 5099.02, Santa Clara County, California",11,11,0
1000000US060855099022012,060855099022012,"Block 2012, Block Group 2, Census Tract 5099.02, Santa Clara County, California",39,39,0
1000000US060855099022013,060855099022013,"Block 2013, Block Group 2, Census Tract 5099.02, Santa Clara County, California",31,31,0
1000000US060855099022014,060855099022014,"Block 2014, Block Group 2, Census Tract 5099.02, Santa Clara County, California",16,16,0
1000000US060855099022015,060855099022015,"Block 2015, Block Group 2, Census Tract 5099.02, Santa Clara County, California",48,43,5
1000000US060855099023000,060855099023000,"Block 3000, Block Group 3, Census Tract 5099.02, Santa Clara County, California",21,20,1
1000000US060855099023001,060855099023001,"Block 3001, Block Group 3, Census Tract 5099.02, Santa Clara County, California",73,73,0
1000000US060855099023002,060855099023002,"Block 3002, Block Group 3, Census Tract 5099.02, Santa Clara County, California",14,14,0
1000000US060855099023003,060855099023003,"Block 3003, Block Group 3, Census Tract 5099.02, Santa Clara County, California",12,11,1
1000000US060855099023004,060855099023004,"Block 3004, Block Group 3, Census Tract 5099.02, Santa Clara County, California",55,53,2
1000000US060855099023005,060855099023005,"Block 3005, Block Group 3, Census Tract 5099.02, Santa Clara County, California",7,6,1
1000000US060855099023006,060855099023006,"Block 3006, Block Group 3, Census Tract 5099.02, Santa Clara County, California",6,6,0
1000000US060855099023007,060855099023007,"Block 3007, Block Group 3, Census Tract 5099.02, Santa Clara County, California",19,18,1
1000000US060855099023008,060855099023008,"Block 3008, Block Group 3, Census Tract 5099.02, Santa Clara County, California",60,57,3
1000000US060855099023009,060855099023009,"Block 3009, Block Group 3, Census Tract 5099.02, Santa Clara County, California",0,0,0
1000000US060855099023010,060855099023010,"Block 3010, Block Group 3, Census Tract 5099.02, Santa Clara County, California",0,0,0
1000000US060855099023011,060855099023011,"Block 3011, Block Group 3, Census Tract 5099.02, Santa Clara County, California",0,0,0
1000000US060855099023012,060855099023012,"Block 3012, Block Group 3, Census Tract 5099.02, Santa Clara County, California",0,0,0
1000000US060855099023013,060855099023013,"Block 3013, Block Group 3, Census Tract 5099.02, Santa Clara County, California",45,44,1
1000000US060855099023014,060855099023014,"Block 3014, Block Group 3, Census Tract 5099.02, Santa Clara County, California",86,80,6
1000000US060855099023015,060855099023015,"Block 3015, Block Group 3, Census Tract 5099.02, Santa Clara County, California",30,30,0
1000000US060855099023016,060855099023016,"Block 3016, Block Group 3, Census Tract 5099.02, Santa Clara County, California",20,19,1
1000000US060855099023017,060855099023017,"Block 3017, Block Group 3, Census Tract 5099.02, Santa Clara County, California",16,16,0
1000000US060855100011000,060855100011000,"Block 1000, Block Group 1, Census Tract 5100.01, Santa Clara County, California",16,16,0
1000000US060855100011001,060855100011001,"Block 1001, Block Group 1, Census Tract 5100.01, Santa Clara County, California",0,0,0
1000000US060855100011002,060855100011002,"Block 1002, Block Group 1, Census Tract 5100.01, Santa Clara County, California",0,0,0
1000000US060855100011003,060855100011003,"Block 1003, Block Group 1, Census Tract 5100.01, Santa Clara County, California",57,56,1
1000000US060855100011004,060855100011004,"Block 1004, Block Group 1, Census Tract 5100.01, Santa Clara County, California",102,101,1
1000000US060855100011005,060855100011005,"Block 1005, Block Group 1, Census Tract 5100.01, Santa Clara County, California",32,32,0
1000000US060855100011006,060855100011006,"Block 1006, Block Group 1, Census Tract 5100.01, Santa Clara County, California",32,32,0
1000000US060855100011007,060855100011007,"Block 1007, Block Group 1, Census Tract 5100.01, Santa Clara County, California",38,35,3
1000000US060855100011008,060855100011008,"Block 1008, Block Group 1, Census Tract 5100.01, Santa Clara County, California",0,0,0
1000000US060855100011009,060855100011009,"Block 1009, Block Group 1, Census Tract 5100.01, Santa Clara County, California",0,0,0
1000000US060855100011010,060855100011010,"Block 1010, Block Group 1, Census Tract 5100.01, Santa Clara County, California",0,0,0
1000000US060855100012000,060855100012000,"Block 2000, Block Group 2, Census Tract 5100.01, Santa Clara County, California",146,145,1
1000000US060855100012001,060855100012001,"Block 2001, Block Group 2, Census Tract 5100.01, Santa Clara County, California",15,15,0
1000000US060855100012002,060855100012002,"Block 2002, Block Group 2, Census Tract 5100.01, Santa Clara County, California",17,16,1
1000000US060855100012003,060855100012003,"Block 2003, Block Group 2, Census Tract 5100.01, Santa Clara County, California",17,17,0
1000000US060855100012004,060855100012004,"Block 2004, Block Group 2, Census Tract 5100.01, Santa Clara County, California",12,12,0
1000000US060855100012005,060855100012005,"Block 2005, Block Group 2, Census Tract 5100.01, Santa Clara County, California",8,8,0
1000000US060855100012006,060855100012006,"Block 2006, Block Group 2, Census Tract 5100.01, Santa Clara County, California",10,10,0
1000000US060855100012007,060855100012007,"Block 2007, Block Group 2, Census Tract 5100.01, Santa Clara County, California",0,0,0
1000000US060855100012008,060855100012008,"Block 2008, Block Group 2, Census Tract 5100.01, Santa Clara County, California",62,62,0
1000000US060855100012009,060855100012009,"Block 2009, Block Group 2, Census Tract 5100.01, Santa Clara County, California",13,12,1
1000000US060855100012010,060855100012010,"Block 2010, Block Group 2, Census Tract 5100.01, Santa Clara County, California",61,61,0
1000000US060855100012011,060855100012011,"Block 2011, Block Group 2, Census Tract 5100.01, Santa Clara County, California",60,57,3
1000000US060855100012012,060855100012012,"Block 2012, Block Group 2, Census Tract 5100.01, Santa Clara County, California",25,25,0
1000000US060855100012013,060855100012013,"Block 2013, Block Group 2, Census Tract 5100.01, Santa Clara County, California",18,18,0
1000000US060855100012014,060855100012014,"Block 2014, Block Group 2, Census Tract 5100.01, Santa Clara County, California",42,40,2
1000000US060855100012015,060855100012015,"Block 2015, Block Group 2, Census Tract 5100.01, Santa Clara County, California",46,45,1
1000000US060855100012016,060855100012016,"Block 2016, Block Group 2, Census Tract 5100.01, Santa Clara County, California",0,0,0
1000000US060855100012017,060855100012017,"Block 2017, Block Group 2, Census Tract 5100.01, Santa Clara County, California",0,0,0
1000000US060855100012018,060855100012018,"Block 2018, Block Group 2, Census Tract 5100.01, Santa Clara County, California",36,35,1
1000000US060855100012019,060855100012019,"Block 2019, Block Group 2, Census Tract 5100.01, Santa Clara County, California",0,0,0
1000000US060855100012020,060855100012020,"Block 2020, Block Group 2, Census Tract 5100.01, Santa Clara County, California",0,0,0
1000000US060855100012021,060855100012021,"Block 2021, Block Group 2, Census Tract 5100.01, Santa Clara County, California",0,0,0
1000000US060855100013000,060855100013000,"Block 3000, Block Group 3, Census Tract 5100.01, Santa Clara County, California",50,49,1
1000000US060855100013001,060855100013001,"Block 3001, Block Group 3, Census Tract 5100.01, Santa Clara County, California",168,166,2
1000000US060855100013002,060855100013002,"Block 3002, Block Group 3, Census Tract 5100.01, Santa Clara County, California",19,19,0
1000000US060855100013003,060855100013003,"Block 3003, Block Group 3, Census Tract 5100.01, Santa Clara County, California",24,24,0
1000000US060855100013004,060855100013004,"Block 3004, Block Group 3, Census Tract 5100.01, Santa Clara County, California",25,24,1
1000000US060855100013005,060855100013005,"Block 3005, Block Group 3, Census Tract 5100.01, Santa Clara County, California",58,56,2
1000000US060855100013006,060855100013006,"Block 3006, Block Group 3, Census Tract 5100.01, Santa Clara County, California",10,10,0
1000000US060855100013007,060855100013007,"Block 3007, Block Group 3, Census Tract 5100.01, Santa Clara County, California",10,9,1
1000000US060855100013008,060855100013008,"Block 3008, Block Group 3, Census Tract 5100.01, Santa Clara County, California",0,0,0
1000000US060855100013009,060855100013009,"Block 3009, Block Group 3, Census Tract 5100.01, Santa Clara County, California",0,0,0
1000000US060855100013010,060855100013010,"Block 3010, Block Group 3, Census Tract 5100.01, Santa Clara County, California",0,0,0
1000000US060855100013011,060855100013011,"Block 3011, Block Group 3, Census Tract 5100.01, Santa Clara County, California",37,37,0
1000000US060855100014000,060855100014000,"Block 4000, Block Group 4, Census Tract 5100.01, Santa Clara County, California",62,57,5
1000000US060855100014001,060855100014001,"Block 4001, Block Group 4, Census Tract 5100.01, Santa Clara County, California",11,11,0
1000000US060855100014002,060855100014002,"Block 4002, Block Group 4, Census Tract 5100.01, Santa Clara County, California",40,39,1
1000000US060855100014003,060855100014003,"Block 4003, Block Group 4, Census Tract 5100.01, Santa Clara County, California",0,0,0
1000000US060855100014004,060855100014004,"Block 4004, Block Group 4, Census Tract 5100.01, Santa Clara County, California",7,7,0
1000000US060855100014005,060855100014005,"Block 4005, Block Group 4, Census Tract 5100.01, Santa Clara County, California",115,108,7
1000000US060855100014006,060855100014006,"Block 4006, Block Group 4, Census Tract 5100.01, Santa Clara County, California",7,7,0
1000000US060855100014007,060855100014007,"Block 4007, Block Group 4, Census Tract 5100.01, Santa Clara County, California",28,27,1
1000000US060855100014008,060855100014008,"Block 4008, Block Group 4, Census Tract 5100.01, Santa Clara County, California",0,0,0
1000000US060855100014009,060855100014009,"Block 4009, Block Group 4, Census Tract 5100.01, Santa Clara County, California",5,5,0
1000000US060855100014010,060855100014010,"Block 4010, Block Group 4, Census Tract 5100.01, Santa Clara County, California",0,0,0
1000000US060855100014011,060855100014011,"Block 4011, Block Group 4, Census Tract 5100.01, Santa Clara County, California",0,0,0
1000000US060855100015000,060855100015000,"Block 5000, Block Group 5, Census Tract 5100.01, Santa Clara County, California",9,9,0
1000000US060855100015001,060855100015001,"Block 5001, Block Group 5, Census Tract 5100.01, Santa Clara County, California",15,15,0
1000000US060855100015002,060855100015002,"Block 5002, Block Group 5, Census Tract 5100.01, Santa Clara County, California",18,17,1
1000000US060855100015003,060855100015003,"Block 5003, Block Group 5, Census Tract 5100.01, Santa Clara County, California",15,14,1
1000000US060855100015004,060855100015004,"Block 5004, Block Group 5, Census Tract 5100.01, Santa Clara County, California",15,15,0
1000000US060855100015005,060855100015005,"Block 5005, Block Group 5, Census Tract 5100.01, Santa Clara County, California",22,21,1
1000000US060855100015006,060855100015006,"Block 5006, Block Group 5, Census Tract 5100.01, Santa Clara County, California",48,46,2
1000000US060855100015007,060855100015007,"Block 5007, Block Group 5, Census Tract 5100.01, Santa Clara County, California",16,16,0
1000000US060855100015008,060855100015008,"Block 5008, Block Group 5, Census Tract 5100.01, Santa Clara County, California",72,70,2
1000000US060855100015009,060855100015009,"Block 5009, Block Group 5, Census Tract 5100.01, Santa Clara County, California",32,31,1
1000000US060855100015010,060855100015010,"Block 5010, Block Group 5, Census Tract 5100.01, Santa Clara County, California",60,58,2
1000000US060855100015011,060855100015011,"Block 5011, Block Group 5, Census Tract 5100.01, Santa Clara County, California",10,8,2
1000000US060855100015012,060855100015012,"Block 5012, Block Group 5, Census Tract 5100.01, Santa Clara County, California",0,0,0
1000000US060855100016000,060855100016000,"Block 6000, Block Group 6, Census Tract 5100.01, Santa Clara County, California",106,104,2
1000000US060855100016001,060855100016001,"Block 6001, Block Group 6, Census Tract 5100.01, Santa Clara County, California",17,16,1
1000000US060855100016002,060855100016002,"Block 6002, Block Group 6, Census Tract 5100.01, Santa Clara County, California",7,7,0
1000000US060855100016003,060855100016003,"Block 6003, Block Group 6, Census Tract 5100.01, Santa Clara County, California",29,28,1
1000000US060855100016004,060855100016004,"Block 6004, Block Group 6, Census Tract 5100.01, Santa Clara County, California",12,12,0
1000000US060855100016005,060855100016005,"Block 6005, Block Group 6, Census Tract 5100.01, Santa Clara County, California",0,0,0
1000000US060855100016006,060855100016006,"Block 6006, Block Group 6, Census Tract 5100.01, Santa Clara County, California",1,1,0
1000000US060855100016007,060855100016007,"Block 6007, Block Group 6, Census Tract 5100.01, Santa Clara County, California",14,13,1
1000000US060855100016008,060855100016008,"Block 6008, Block Group 6, Census Tract 5100.01, Santa Clara County, California",77,77,0
1000000US060855100021000,060855100021000,"Block 1000, Block Group 1, Census Tract 5100.02, Santa Clara County, California",163,158,5
1000000US060855100021001,060855100021001,"Block 1001, Block Group 1, Census Tract 5100.02, Santa Clara County, California",0,0,0
1000000US060855100021002,060855100021002,"Block 1002, Block Group 1, Census Tract 5100.02, Santa Clara County, California",12,12,0
1000000US060855100021003,060855100021003,"Block 1003, Block Group 1, Census Tract 5100.02, Santa Clara County, California",55,53,2
1000000US060855100021004,060855100021004,"Block 1004, Block Group 1, Census Tract 5100.02, Santa Clara County, California",17,17,0
1000000US060855100021005,060855100021005,"Block 1005, Block Group 1, Census Tract 5100.02, Santa Clara County, California",20,19,1
1000000US060855100021006,060855100021006,"Block 1006, Block Group 1, Census Tract 5100.02, Santa Clara County, California",22,21,1
1000000US060855100021007,060855100021007,"Block 1007, Block Group 1, Census Tract 5100.02, Santa Clara County, California",26,25,1
1000000US060855100021008,060855100021008,"Block 1008, Block Group 1, Census Tract 5100.02, Santa Clara County, California",26,26,0
1000000US060855100021009,060855100021009,"Block 1009, Block Group 1, Census Tract 5100.02, Santa Clara County, California",46,44,2
1000000US060855100021010,060855100021010,"Block 1010, Block Group 1, Census Tract 5100.02, Santa Clara County, California",76,71,5
1000000US060855100021011,060855100021011,"Block 1011, Block Group 1, Census Tract 5100.02, Santa Clara County, California",28,26,2
1000000US060855100021012,060855100021012,"Block 1012, Block Group 1, Census Tract 5100.02, Santa Clara County, California",25,25,0
1000000US060855100022000,060855100022000,"Block 2000, Block Group 2, Census Tract 5100.02, Santa Clara County, California",17,17,0
1000000US060855100022001,060855100022001,"Block 2001, Block Group 2, Census Tract 5100.02, Santa Clara County, California",61,58,3
1000000US060855100022002,060855100022002,"Block 2002, Block Group 2, Census Tract 5100.02, Santa Clara County, California",14,14,0
1000000US060855100022003,060855100022003,"Block 2003, Block Group 2, Census Tract 5100.02, Santa Clara County, California",19,18,1
1000000US060855100022004,060855100022004,"Block 2004, Block Group 2, Census Tract 5100.02, Santa Clara County, California",60,59,1
1000000US060855100022005,060855100022005,"Block 2005, Block Group 2, Census Tract 5100.02, Santa Clara County, California",16,15,1
1000000US060855100022006,060855100022006,"Block 2006, Block Group 2, Census Tract 5100.02, Santa Clara County, California",12,12,0
1000000US060855100022007,060855100022007,"Block 2007, Block Group 2, Census Tract 5100.02, Santa Clara County, California",0,0,0
1000000US060855100022008,060855100022008,"Block 2008, Block Group 2, Census Tract 5100.02, Santa Clara County, California",0,0,0
1000000US060855100022009,060855100022009,"Block 2009, Block Group 2, Census Tract 5100.02, Santa Clara County, California",0,0,0
1000000US060855100022010,060855100022010,"Block 2010, Block Group 2, Census Tract 5100.02, Santa Clara County, California",64,61,3
1000000US060855100022011,060855100022011,"Block 2011, Block Group 2, Census Tract 5100.02, Santa Clara County, California",12,12,0
1000000US060855100022012,060855100022012,"Block 2012, Block Group 2, Census Tract 5100.02, Santa Clara County, California",27,26,1
1000000US060855100022013,060855100022013,"Block 2013, Block Group 2, Census Tract 5100.02, Santa Clara County, California",28,27,1
1000000US060855100022014,060855100022014,"Block 2014, Block Group 2, Census Tract 5100.02, Santa Clara County, California",31,31,0
1000000US060855100022015,060855100022015,"Block 2015, Block Group 2, Census Tract 5100.02, Santa Clara County, California",30,30,0
1000000US060855100023000,060855100023000,"Block 3000, Block Group 3, Census Tract 5100.02, Santa Clara County, California",26,26,0
1000000US060855100023001,060855100023001,"Block 3001, Block Group 3, Census Tract 5100.02, Santa Clara County, California",32,31,1
1000000US060855100023002,060855100023002,"Block 3002, Block Group 3, Census Tract 5100.02, Santa Clara County, California",15,15,0
1000000US060855100023003,060855100023003,"Block 3003, Block Group 3, Census Tract 5100.02, Santa Clara County, California",32,31,1
1000000US060855100023004,060855100023004,"Block 3004, Block Group 3, Census Tract 5100.02, Santa Clara County, California",33,29,4
1000000US060855100023005,060855100023005,"Block 3005, Block Group 3, Census Tract 5100.02, Santa Clara County, California",41,39,2
1000000US060855100023006,060855100023006,"Block 3006, Block Group 3, Census Tract 5100.02, Santa Clara County, California",44,42,2
1000000US060855100023007,060855100023007,"Block 3007, Block Group 3, Census Tract 5100.02, Santa Clara County, California",24,21,3
1000000US060855100023008,060855100023008,"Block 3008, Block Group 3, Census Tract 5100.02, Santa Clara County, California",19,18,1
1000000US060855100023009,060855100023009,"Block 3009, Block Group 3, Census Tract 5100.02, Santa Clara County, California",17,17,0
1000000US060855100023010,060855100023010,"Block 3010, Block Group 3, Census Tract 5100.02, Santa Clara County, California",18,17,1
1000000US060855100023011,060855100023011,"Block 3011, Block Group 3, Census Tract 5100.02, Santa Clara County, California",22,22,0
1000000US060855100023012,060855100023012,"Block 3012, Block Group 3, Census Tract 5100.02, Santa Clara County, California",42,40,2
1000000US060855100023013,060855100023013,"Block 3013, Block Group 3, Census Tract 5100.02, Santa Clara County, California",33,30,3
1000000US060855100023014,060855100023014,"Block 3014, Block Group 3, Census Tract 5100.02, Santa Clara County, California",9,9,0
1000000US060855101001000,060855101001000,"Block 1000, Block Group 1, Census Tract 5101, Santa Clara County, California",135,133,2
1000000US060855101001001,060855101001001,"Block 1001, Block Group 1, Census Tract 5101, Santa Clara County, California",25,24,1
1000000US060855101001002,060855101001002,"Block 1002, Block Group 1, Census Tract 5101, Santa Clara County, California",47,47,0
1000000US060855101001003,060855101001003,"Block 1003, Block Group 1, Census Tract 5101, Santa Clara County, California",30,30,0
1000000US060855101001004,060855101001004,"Block 1004, Block Group 1, Census Tract 5101, Santa Clara County, California",116,108,8
1000000US060855101001005,060855101001005,"Block 1005, Block Group 1, Census Tract 5101, Santa Clara County, California",5,5,0
1000000US060855101001006,060855101001006,"Block 1006, Block Group 1, Census Tract 5101, Santa Clara County, California",27,27,0
1000000US060855101001007,060855101001007,"Block 1007, Block Group 1, Census Tract 5101, Santa Clara County, California",16,14,2
1000000US060855101001008,060855101001008,"Block 1008, Block Group 1, Census Tract 5101, Santa Clara County, California",18,18,0
1000000US060855101001009,060855101001009,"Block 1009, Block Group 1, Census Tract 5101, Santa Clara County, California",10,10,0
1000000US060855101001010,060855101001010,"Block 1010, Block Group 1, Census Tract 5101, Santa Clara County, California",17,17,0
1000000US060855101001011,060855101001011,"Block 1011, Block Group 1, Census Tract 5101, Santa Clara County, California",0,0,0
1000000US060855101001012,060855101001012,"Block 1012, Block Group 1, Census Tract 5101, Santa Clara County, California",9,9,0
1000000US060855101001013,060855101001013,"Block 1013, Block Group 1, Census Tract 5101, Santa Clara County, California",16,16,0
1000000US060855101001014,060855101001014,"Block 1014, Block Group 1, Census Tract 5101, Santa Clara County, California",26,24,2
1000000US060855101001015,060855101001015,"Block 1015, Block Group 1, Census Tract 5101, Santa Clara County, California",15,15,0
1000000US060855101001016,060855101001016,"Block 1016, Block Group 1, Census Tract 5101, Santa Clara County, California",14,13,1
1000000US060855101001017,060855101001017,"Block 1017, Block Group 1, Census Tract 5101, Santa Clara County, California",9,9,0
1000000US060855101001018,060855101001018,"Block 1018, Block Group 1, Census Tract 5101, Santa Clara County, California",22,20,2
1000000US060855101002000,060855101002000,"Block 2000, Block Group 2, Census Tract 5101, Santa Clara County, California",18,18,0
1000000US060855101002001,060855101002001,"Block 2001, Block Group 2, Census Tract 5101, Santa Clara County, California",7,7,0
1000000US060855101002002,060855101002002,"Block 2002, Block Group 2, Census Tract 5101, Santa Clara County, California",14,14,0
1000000US060855101002003,060855101002003,"Block 2003, Block Group 2, Census Tract 5101, Santa Clara County, California",14,14,0
1000000US060855101002004,060855101002004,"Block 2004, Block Group 2, Census Tract 5101, Santa Clara County, California",110,108,2
1000000US060855101002005,060855101002005,"Block 2005, Block Group 2, Census Tract 5101, Santa Clara County, California",22,22,0
1000000US060855101002006,060855101002006,"Block 2006, Block Group 2, Census Tract 5101, Santa Clara County, California",9,9,0
1000000US060855101002007,060855101002007,"Block 2007, Block Group 2, Census Tract 5101, Santa Clara County, California",25,25,0
1000000US060855101003000,060855101003000,"Block 3000, Block Group 3, Census Tract 5101, Santa Clara County, California",26,26,0
1000000US060855101003001,060855101003001,"Block 3001, Block Group 3, Census Tract 5101, Santa Clara County, California",43,41,2
1000000US060855101003002,060855101003002,"Block 3002, Block Group 3, Census Tract 5101, Santa Clara County, California",197,191,6
1000000US060855101003003,060855101003003,"Block 3003, Block Group 3, Census Tract 5101, Santa Clara County, California",20,19,1
1000000US060855101003004,060855101003004,"Block 3004, Block Group 3, Census Tract 5101, Santa Clara County, California",25,24,1
1000000US060855101003005,060855101003005,"Block 3005, Block Group 3, Census Tract 5101, Santa Clara County, California",0,0,0
1000000US060855101003006,060855101003006,"Block 3006, Block Group 3, Census Tract 5101, Santa Clara County, California",14,13,1
1000000US060855101003007,060855101003007,"Block 3007, Block Group 3, Census Tract 5101, Santa Clara County, California",7,7,0
1000000US060855101003008,060855101003008,"Block 3008, Block Group 3, Census Tract 5101, Santa Clara County, California",1,1,0
1000000US060855102001000,060855102001000,"Block 1000, Block Group 1, Census Tract 5102, Santa Clara County, California",2,2,0
1000000US060855102001001,060855102001001,"Block 1001, Block Group 1, Census Tract 5102, Santa Clara County, California",31,30,1
1000000US060855102001002,060855102001002,"Block 1002, Block Group 1, Census Tract 5102, Santa Clara County, California",83,80,3
1000000US060855102001003,060855102001003,"Block 1003, Block Group 1, Census Tract 5102, Santa Clara County, California",0,0,0
1000000US060855102001004,060855102001004,"Block 1004, Block Group 1, Census Tract 5102, Santa Clara County, California",0,0,0
1000000US060855102001005,060855102001005,"Block 1005, Block Group 1, Census Tract 5102, Santa Clara County, California",21,20,1
1000000US060855102001006,060855102001006,"Block 1006, Block Group 1, Census Tract 5102, Santa Clara County, California",7,7,0
1000000US060855102001007,060855102001007,"Block 1007, Block Group 1, Census Tract 5102, Santa Clara County, California",32,30,2
1000000US060855102001008,060855102001008,"Block 1008, Block Group 1, Census Tract 5102, Santa Clara County, California",50,48,2
1000000US060855102001009,060855102001009,"Block 1009, Block Group 1, Census Tract 5102, Santa Clara County, California",91,89,2
1000000US060855102001010,060855102001010,"Block 1010, Block Group 1, Census Tract 5102, Santa Clara County, California",20,18,2
1000000US060855102001011,060855102001011,"Block 1011, Block Group 1, Census Tract 5102, Santa Clara County, California",13,13,0
1000000US060855102001012,060855102001012,"Block 1012, Block Group 1, Census Tract 5102, Santa Clara County, California",12,12,0
1000000US060855102001013,060855102001013,"Block 1013, Block Group 1, Census Tract 5102, Santa Clara County, California",35,34,1
1000000US060855102001014,060855102001014,"Block 1014, Block Group 1, Census Tract 5102, Santa Clara County, California",15,12,3
1000000US060855102001015,060855102001015,"Block 1015, Block Group 1, Census Tract 5102, Santa Clara County, California",14,14,0
1000000US060855102001016,060855102001016,"Block 1016, Block Group 1, Census Tract 5102, Santa Clara County, California",13,13,0
1000000US060855102001017,060855102001017,"Block 1017, Block Group 1, Census Tract 5102, Santa Clara County, California",47,44,3
1000000US060855102001018,060855102001018,"Block 1018, Block Group 1, Census Tract 5102, Santa Clara County, California",82,80,2
1000000US060855102001019,060855102001019,"Block 1019, Block Group 1, Census Tract 5102, Santa Clara County, California",7,7,0
1000000US060855102001020,060855102001020,"Block 1020, Block Group 1, Census Tract 5102, Santa Clara County, California",23,22,1
1000000US060855102001021,060855102001021,"Block 1021, Block Group 1, Census Tract 5102, Santa Clara County, California",8,8,0
1000000US060855102001022,060855102001022,"Block 1022, Block Group 1, Census Tract 5102, Santa Clara County, California",12,12,0
1000000US060855102002000,060855102002000,"Block 2000, Block Group 2, Census Tract 5102, Santa Clara County, California",2,2,0
1000000US060855102002001,060855102002001,"Block 2001, Block Group 2, Census Tract 5102, Santa Clara County, California",37,30,7
1000000US060855102002002,060855102002002,"Block 2002, Block Group 2, Census Tract 5102, Santa Clara County, California",52,50,2
1000000US060855102002003,060855102002003,"Block 2003, Block Group 2, Census Tract 5102, Santa Clara County, California",14,13,1
1000000US060855102002004,060855102002004,"Block 2004, Block Group 2, Census Tract 5102, Santa Clara County, California",8,8,0
1000000US060855102002005,060855102002005,"Block 2005, Block Group 2, Census Tract 5102, Santa Clara County, California",25,24,1
1000000US060855102002006,060855102002006,"Block 2006, Block Group 2, Census Tract 5102, Santa Clara County, California",19,18,1
1000000US060855102002007,060855102002007,"Block 2007, Block Group 2, Census Tract 5102, Santa Clara County, California",42,41,1
1000000US060855102002008,060855102002008,"Block 2008, Block Group 2, Census Tract 5102, Santa Clara County, California",23,22,1
1000000US060855102002009,060855102002009,"Block 2009, Block Group 2, Census Tract 5102, Santa Clara County, California",100,96,4
1000000US060855102002010,060855102002010,"Block 2010, Block Group 2, Census Tract 5102, Santa Clara County, California",22,22,0
1000000US060855102002011,060855102002011,"Block 2011, Block Group 2, Census Tract 5102, Santa Clara County, California",23,23,0
1000000US060855102002012,060855102002012,"Block 2012, Block Group 2, Census Tract 5102, Santa Clara County, California",0,0,0
1000000US060855102002013,060855102002013,"Block 2013, Block Group 2, Census Tract 5102, Santa Clara County, California",0,0,0
1000000US060855102002014,060855102002014,"Block 2014, Block Group 2, Census Tract 5102, Santa Clara County, California",0,0,0
1000000US060855102003000,060855102003000,"Block 3000, Block Group 3, Census Tract 5102, Santa Clara County, California",30,29,1
1000000US060855102003001,060855102003001,"Block 3001, Block Group 3, Census Tract 5102, Santa Clara County, California",38,38,0
1000000US060855102003002,060855102003002,"Block 3002, Block Group 3, Census Tract 5102, Santa Clara County, California",50,49,1
1000000US060855102003003,060855102003003,"Block 3003, Block Group 3, Census Tract 5102, Santa Clara County, California",42,41,1
1000000US060855102003004,060855102003004,"Block 3004, Block Group 3, Census Tract 5102, Santa Clara County, California",13,13,0
1000000US060855102003005,060855102003005,"Block 3005, Block Group 3, Census Tract 5102, Santa Clara County, California",0,0,0
1000000US060855102003006,060855102003006,"Block 3006, Block Group 3, Census Tract 5102, Santa Clara County, California",14,12,2
1000000US060855102003007,060855102003007,"Block 3007, Block Group 3, Census Tract 5102, Santa Clara County, California",3,3,0
1000000US060855102003008,060855102003008,"Block 3008, Block Group 3, Census Tract 5102, Santa Clara County, California",20,18,2
1000000US060855102003009,060855102003009,"Block 3009, Block Group 3, Census Tract 5102, Santa Clara County, California",26,25,1
1000000US060855102003010,060855102003010,"Block 3010, Block Group 3, Census Tract 5102, Santa Clara County, California",19,19,0
1000000US060855102003011,060855102003011,"Block 3011, Block Group 3, Census Tract 5102, Santa Clara County, California",19,16,3
1000000US060855102003012,060855102003012,"Block 3012, Block Group 3, Census Tract 5102, Santa Clara County, California",0,0,0
1000000US060855102003013,060855102003013,"Block 3013, Block Group 3, Census Tract 5102, Santa Clara County, California",0,0,0
1000000US060855102003014,060855102003014,"Block 3014, Block Group 3, Census Tract 5102, Santa Clara County, California",13,12,1
1000000US060855102003015,060855102003015,"Block 3015, Block Group 3, Census Tract 5102, Santa Clara County, California",36,35,1
1000000US060855102003016,060855102003016,"Block 3016, Block Group 3, Census Tract 5102, Santa Clara County, California",0,0,0
1000000US060855102003017,060855102003017,"Block 3017, Block Group 3, Census Tract 5102, Santa Clara County, California",41,41,0
1000000US060855102003018,060855102003018,"Block 3018, Block Group 3, Census Tract 5102, Santa Clara County, California",8,8,0
1000000US060855102003019,060855102003019,"Block 3019, Block Group 3, Census Tract 5102, Santa Clara County, California",0,0,0
1000000US060855102003020,060855102003020,"Block 3020, Block Group 3, Census Tract 5102, Santa Clara County, California",11,11,0
1000000US060855102003021,060855102003021,"Block 3021, Block Group 3, Census Tract 5102, Santa Clara County, California",120,113,7
1000000US060855102003022,060855102003022,"Block 3022, Block Group 3, Census Tract 5102, Santa Clara County, California",27,25,2
1000000US060855102003023,060855102003023,"Block 3023, Block Group 3, Census Tract 5102, Santa Clara County, California",23,23,0
1000000US060855102003024,060855102003024,"Block 3024, Block Group 3, Census Tract 5102, Santa Clara County, California",21,21,0
1000000US060855102003025,060855102003025,"Block 3025, Block Group 3, Census Tract 5102, Santa Clara County, California",0,0,0
1000000US060855102003026,060855102003026,"Block 3026, Block Group 3, Census Tract 5102, Santa Clara County, California",0,0,0
1000000US060855102003027,060855102003027,"Block 3027, Block Group 3, Census Tract 5102, Santa Clara County, California",0,0,0
1000000US060855102003028,060855102003028,"Block 3028, Block Group 3, Census Tract 5102, Santa Clara County, California",0,0,0
1000000US060855102003029,060855102003029,"Block 3029, Block Group 3, Census Tract 5102, Santa Clara County, California",0,0,0
1000000US060855103001000,060855103001000,"Block 1000, Block Group 1, Census Tract 5103, Santa Clara County, California",27,26,1
1000000US060855103001001,060855103001001,"Block 1001, Block Group 1, Census Tract 5103, Santa Clara County, California",66,62,4
1000000US060855103001002,060855103001002,"Block 1002, Block Group 1, Census Tract 5103, Santa Clara County, California",42,41,1
1000000US060855103001003,060855103001003,"Block 1003, Block Group 1, Census Tract 5103, Santa Clara County, California",28,27,1
1000000US060855103001004,060855103001004,"Block 1004, Block Group 1, Census Tract 5103, Santa Clara County, California",37,37,0
1000000US060855103001005,060855103001005,"Block 1005, Block Group 1, Census Tract 5103, Santa Clara County, California",26,24,2
1000000US060855103001006,060855103001006,"Block 1006, Block Group 1, Census Tract 5103, Santa Clara County, California",63,61,2
1000000US060855103001007,060855103001007,"Block 1007, Block Group 1, Census Tract 5103, Santa Clara County, California",15,15,0
1000000US060855103001008,060855103001008,"Block 1008, Block Group 1, Census Tract 5103, Santa Clara County, California",20,19,1
1000000US060855103001009,060855103001009,"Block 1009, Block Group 1, Census Tract 5103, Santa Clara County, California",30,30,0
1000000US060855103001010,060855103001010,"Block 1010, Block Group 1, Census Tract 5103, Santa Clara County, California",0,0,0
1000000US060855103001011,060855103001011,"Block 1011, Block Group 1, Census Tract 5103, Santa Clara County, California",20,20,0
1000000US060855103001012,060855103001012,"Block 1012, Block Group 1, Census Tract 5103, Santa Clara County, California",27,24,3
1000000US060855103001013,060855103001013,"Block 1013, Block Group 1, Census Tract 5103, Santa Clara County, California",19,18,1
1000000US060855103001014,060855103001014,"Block 1014, Block Group 1, Census Tract 5103, Santa Clara County, California",13,12,1
1000000US060855103001015,060855103001015,"Block 1015, Block Group 1, Census Tract 5103, Santa Clara County, California",13,13,0
1000000US060855103001016,060855103001016,"Block 1016, Block Group 1, Census Tract 5103, Santa Clara County, California",33,31,2
1000000US060855103001017,060855103001017,"Block 1017, Block Group 1, Census Tract 5103, Santa Clara County, California",12,11,1
1000000US060855103001018,060855103001018,"Block 1018, Block Group 1, Census Tract 5103, Santa Clara County, California",66,64,2
1000000US060855103002000,060855103002000,"Block 2000, Block Group 2, Census Tract 5103, Santa Clara County, California",91,85,6
1000000US060855103002001,060855103002001,"Block 2001, Block Group 2, Census Tract 5103, Santa Clara County, California",39,36,3
1000000US060855103002002,060855103002002,"Block 2002, Block Group 2, Census Tract 5103, Santa Clara County, California",21,18,3
1000000US060855103002003,060855103002003,"Block 2003, Block Group 2, Census Tract 5103, Santa Clara County, California",41,36,5
1000000US060855103002004,060855103002004,"Block 2004, Block Group 2, Census Tract 5103, Santa Clara County, California",0,0,0
1000000US060855103002005,060855103002005,"Block 2005, Block Group 2, Census Tract 5103, Santa Clara County, California",0,0,0
1000000US060855103002006,060855103002006,"Block 2006, Block Group 2, Census Tract 5103, Santa Clara County, California",0,0,0
1000000US060855103002007,060855103002007,"Block 2007, Block Group 2, Census Tract 5103, Santa Clara County, California",0,0,0
1000000US060855103002008,060855103002008,"Block 2008, Block Group 2, Census Tract 5103, Santa Clara County, California",0,0,0
1000000US060855103002009,060855103002009,"Block 2009, Block Group 2, Census Tract 5103, Santa Clara County, California",0,0,0
1000000US060855103002010,060855103002010,"Block 2010, Block Group 2, Census Tract 5103, Santa Clara County, California",0,0,0
1000000US060855103002011,060855103002011,"Block 2011, Block Group 2, Census Tract 5103, Santa Clara County, California",0,0,0
1000000US060855103002012,060855103002012,"Block 2012, Block Group 2, Census Tract 5103, Santa Clara County, California",0,0,0
1000000US060855103002013,060855103002013,"Block 2013, Block Group 2, Census Tract 5103, Santa Clara County, California",0,0,0
1000000US060855103002014,060855103002014,"Block 2014, Block Group 2, Census Tract 5103, Santa Clara County, California",0,0,0
1000000US060855103002015,060855103002015,"Block 2015, Block Group 2, Census Tract 5103, Santa Clara County, California",44,43,1
1000000US060855103002016,060855103002016,"Block 2016, Block Group 2, Census Tract 5103, Santa Clara County, California",7,7,0
1000000US060855103002017,060855103002017,"Block 2017, Block Group 2, Census Tract 5103, Santa Clara County, California",0,0,0
1000000US060855103002018,060855103002018,"Block 2018, Block Group 2, Census Tract 5103, Santa Clara County, California",85,79,6
1000000US060855103002019,060855103002019,"Block 2019, Block Group 2, Census Tract 5103, Santa Clara County, California",62,53,9
1000000US060855103002020,060855103002020,"Block 2020, Block Group 2, Census Tract 5103, Santa Clara County, California",0,0,0
1000000US060855103002021,060855103002021,"Block 2021, Block Group 2, Census Tract 5103, Santa Clara County, California",0,0,0
1000000US060855103002022,060855103002022,"Block 2022, Block Group 2, Census Tract 5103, Santa Clara County, California",0,0,0
1000000US060855103002023,060855103002023,"Block 2023, Block Group 2, Census Tract 5103, Santa Clara County, California",0,0,0
1000000US060855103002024,060855103002024,"Block 2024, Block Group 2, Census Tract 5103, Santa Clara County, California",0,0,0
1000000US060855103002025,060855103002025,"Block 2025, Block Group 2, Census Tract 5103, Santa Clara County, California",0,0,0
1000000US060855103002026,060855103002026,"Block 2026, Block Group 2, Census Tract 5103, Santa Clara County, California",0,0,0
1000000US060855103002027,060855103002027,"Block 2027, Block Group 2, Census Tract 5103, Santa Clara County, California",0,0,0
1000000US060855103002028,060855103002028,"Block 2028, Block Group 2, Census Tract 5103, Santa Clara County, California",0,0,0
1000000US060855103002029,060855103002029,"Block 2029, Block Group 2, Census Tract 5103, Santa Clara County, California",0,0,0
1000000US060855103002030,060855103002030,"Block 2030, Block Group 2, Census Tract 5103, Santa Clara County, California",0,0,0
1000000US060855103002031,060855103002031,"Block 2031, Block Group 2, Census Tract 5103, Santa Clara County, California",0,0,0
1000000US060855103002032,060855103002032,"Block 2032, Block Group 2, Census Tract 5103, Santa Clara County, California",0,0,0
1000000US060855103002033,060855103002033,"Block 2033, Block Group 2, Census Tract 5103, Santa Clara County, California",0,0,0
1000000US060855103002034,060855103002034,"Block 2034, Block Group 2, Census Tract 5103, Santa Clara County, California",0,0,0
1000000US060855103002035,060855103002035,"Block 2035, Block Group 2, Census Tract 5103, Santa Clara County, California",0,0,0
1000000US060855103002036,060855103002036,"Block 2036, Block Group 2, Census Tract 5103, Santa Clara County, California",0,0,0
1000000US060855103002037,060855103002037,"Block 2037, Block Group 2, Census Tract 5103, Santa Clara County, California",0,0,0
1000000US060855103002038,060855103002038,"Block 2038, Block Group 2, Census Tract 5103, Santa Clara County, California",0,0,0
1000000US060855103002039,060855103002039,"Block 2039, Block Group 2, Census Tract 5103, Santa Clara County, California",0,0,0
1000000US060855103002040,060855103002040,"Block 2040, Block Group 2, Census Tract 5103, Santa Clara County, California",0,0,0
1000000US060855103002041,060855103002041,"Block 2041, Block Group 2, Census Tract 5103, Santa Clara County, California",0,0,0
1000000US060855103002042,060855103002042,"Block 2042, Block Group 2, Census Tract 5103, Santa Clara County, California",0,0,0
1000000US060855103002043,060855103002043,"Block 2043, Block Group 2, Census Tract 5103, Santa Clara County, California",0,0,0
1000000US060855103002044,060855103002044,"Block 2044, Block Group 2, Census Tract 5103, Santa Clara County, California",0,0,0
1000000US060855103002045,060855103002045,"Block 2045, Block Group 2, Census Tract 5103, Santa Clara County, California",0,0,0
1000000US060855103002046,060855103002046,"Block 2046, Block Group 2, Census Tract 5103, Santa Clara County, California",0,0,0
1000000US060855103002047,060855103002047,"Block 2047, Block Group 2, Census Tract 5103, Santa Clara County, California",0,0,0
1000000US060855103002048,060855103002048,"Block 2048, Block Group 2, Census Tract 5103, Santa Clara County, California",0,0,0
1000000US060855103002049,060855103002049,"Block 2049, Block Group 2, Census Tract 5103, Santa Clara County, California",33,30,3
1000000US060855103002050,060855103002050,"Block 2050, Block Group 2, Census Tract 5103, Santa Clara County, California",29,24,5
1000000US060855103002051,060855103002051,"Block 2051, Block Group 2, Census Tract 5103, Santa Clara County, California",33,31,2
1000000US060855103002052,060855103002052,"Block 2052, Block Group 2, Census Tract 5103, Santa Clara County, California",33,30,3
1000000US060855103002053,060855103002053,"Block 2053, Block Group 2, Census Tract 5103, Santa Clara County, California",32,32,0
1000000US060855103002054,060855103002054,"Block 2054, Block Group 2, Census Tract 5103, Santa Clara County, California",54,50,4
1000000US060855103002055,060855103002055,"Block 2055, Block Group 2, Census Tract 5103, Santa Clara County, California",60,57,3
1000000US060855103002056,060855103002056,"Block 2056, Block Group 2, Census Tract 5103, Santa Clara County, California",63,57,6
1000000US060855103002057,060855103002057,"Block 2057, Block Group 2, Census Tract 5103, Santa Clara County, California",27,22,5
1000000US060855103002058,060855103002058,"Block 2058, Block Group 2, Census Tract 5103, Santa Clara County, California",0,0,0
1000000US060855103002059,060855103002059,"Block 2059, Block Group 2, Census Tract 5103, Santa Clara County, California",0,0,0
1000000US060855103002060,060855103002060,"Block 2060, Block Group 2, Census Tract 5103, Santa Clara County, California",43,40,3
1000000US060855103003000,060855103003000,"Block 3000, Block Group 3, Census Tract 5103, Santa Clara County, California",0,0,0
1000000US060855103003001,060855103003001,"Block 3001, Block Group 3, Census Tract 5103, Santa Clara County, California",27,27,0
1000000US060855103003002,060855103003002,"Block 3002, Block Group 3, Census Tract 5103, Santa Clara County, California",0,0,0
1000000US060855103003003,060855103003003,"Block 3003, Block Group 3, Census Tract 5103, Santa Clara County, California",16,13,3
1000000US060855103003004,060855103003004,"Block 3004, Block Group 3, Census Tract 5103, Santa Clara County, California",0,0,0
1000000US060855103003005,060855103003005,"Block 3005, Block Group 3, Census Tract 5103, Santa Clara County, California",0,0,0
1000000US060855103003006,060855103003006,"Block 3006, Block Group 3, Census Tract 5103, Santa Clara County, California",23,23,0
1000000US060855103003007,060855103003007,"Block 3007, Block Group 3, Census Tract 5103, Santa Clara County, California",32,29,3
1000000US060855103003008,060855103003008,"Block 3008, Block Group 3, Census Tract 5103, Santa Clara County, California",0,0,0
1000000US060855103003009,060855103003009,"Block 3009, Block Group 3, Census Tract 5103, Santa Clara County, California",8,7,1
1000000US060855103003010,060855103003010,"Block 3010, Block Group 3, Census Tract 5103, Santa Clara County, California",17,16,1
1000000US060855103003011,060855103003011,"Block 3011, Block Group 3, Census Tract 5103, Santa Clara County, California",23,21,2
1000000US060855103003012,060855103003012,"Block 3012, Block Group 3, Census Tract 5103, Santa Clara County, California",28,26,2
1000000US060855103003013,060855103003013,"Block 3013, Block Group 3, Census Tract 5103, Santa Clara County, California",25,25,0
1000000US060855103003014,060855103003014,"Block 3014, Block Group 3, Census Tract 5103, Santa Clara County, California",20,18,2
1000000US060855103003015,060855103003015,"Block 3015, Block Group 3, Census Tract 5103, Santa Clara County, California",18,16,2
1000000US060855103003016,060855103003016,"Block 3016, Block Group 3, Census Tract 5103, Santa Clara County, California",66,64,2
1000000US060855103003017,060855103003017,"Block 3017, Block Group 3, Census Tract 5103, Santa Clara County, California",1,1,0
1000000US060855103003018,060855103003018,"Block 3018, Block Group 3, Census Tract 5103, Santa Clara County, California",20,20,0
1000000US060855103003019,060855103003019,"Block 3019, Block Group 3, Census Tract 5103, Santa Clara County, California",21,20,1
1000000US060855103003020,060855103003020,"Block 3020, Block Group 3, Census Tract 5103, Santa Clara County, California",14,9,5
1000000US060855103003021,060855103003021,"Block 3021, Block Group 3, Census Tract 5103, Santa Clara County, California",52,48,4
1000000US060855104001000,060855104001000,"Block 1000, Block Group 1, Census Tract 5104, Santa Clara County, California",0,0,0
1000000US060855104001001,060855104001001,"Block 1001, Block Group 1, Census Tract 5104, Santa Clara County, California",0,0,0
1000000US060855104001002,060855104001002,"Block 1002, Block Group 1, Census Tract 5104, Santa Clara County, California",54,53,1
1000000US060855104001003,060855104001003,"Block 1003, Block Group 1, Census Tract 5104, Santa Clara County, California",0,0,0
1000000US060855104001004,060855104001004,"Block 1004, Block Group 1, Census Tract 5104, Santa Clara County, California",55,54,1
1000000US060855104001005,060855104001005,"Block 1005, Block Group 1, Census Tract 5104, Santa Clara County, California",4,2,2
1000000US060855104001006,060855104001006,"Block 1006, Block Group 1, Census Tract 5104, Santa Clara County, California",21,18,3
1000000US060855104001007,060855104001007,"Block 1007, Block Group 1, Census Tract 5104, Santa Clara County, California",1,1,0
1000000US060855104001008,060855104001008,"Block 1008, Block Group 1, Census Tract 5104, Santa Clara County, California",15,15,0
1000000US060855104001009,060855104001009,"Block 1009, Block Group 1, Census Tract 5104, Santa Clara County, California",2,1,1
1000000US060855104001010,060855104001010,"Block 1010, Block Group 1, Census Tract 5104, Santa Clara County, California",12,12,0
1000000US060855104001011,060855104001011,"Block 1011, Block Group 1, Census Tract 5104, Santa Clara County, California",43,42,1
1000000US060855104001012,060855104001012,"Block 1012, Block Group 1, Census Tract 5104, Santa Clara County, California",23,23,0
1000000US060855104001013,060855104001013,"Block 1013, Block Group 1, Census Tract 5104, Santa Clara County, California",35,35,0
1000000US060855104001014,060855104001014,"Block 1014, Block Group 1, Census Tract 5104, Santa Clara County, California",0,0,0
1000000US060855104001015,060855104001015,"Block 1015, Block Group 1, Census Tract 5104, Santa Clara County, California",0,0,0
1000000US060855104001016,060855104001016,"Block 1016, Block Group 1, Census Tract 5104, Santa Clara County, California",87,81,6
1000000US060855104001017,060855104001017,"Block 1017, Block Group 1, Census Tract 5104, Santa Clara County, California",2,2,0
1000000US060855104001018,060855104001018,"Block 1018, Block Group 1, Census Tract 5104, Santa Clara County, California",11,11,0
1000000US060855104001019,060855104001019,"Block 1019, Block Group 1, Census Tract 5104, Santa Clara County, California",50,47,3
1000000US060855104001020,060855104001020,"Block 1020, Block Group 1, Census Tract 5104, Santa Clara County, California",8,8,0
1000000US060855104001021,060855104001021,"Block 1021, Block Group 1, Census Tract 5104, Santa Clara County, California",24,24,0
1000000US060855104001022,060855104001022,"Block 1022, Block Group 1, Census Tract 5104, Santa Clara County, California",26,25,1
1000000US060855104001023,060855104001023,"Block 1023, Block Group 1, Census Tract 5104, Santa Clara County, California",50,50,0
1000000US060855104001024,060855104001024,"Block 1024, Block Group 1, Census Tract 5104, Santa Clara County, California",51,49,2
1000000US060855104001025,060855104001025,"Block 1025, Block Group 1, Census Tract 5104, Santa Clara County, California",0,0,0
1000000US060855104001026,060855104001026,"Block 1026, Block Group 1, Census Tract 5104, Santa Clara County, California",18,18,0
1000000US060855104002000,060855104002000,"Block 2000, Block Group 2, Census Tract 5104, Santa Clara County, California",16,16,0
1000000US060855104002001,060855104002001,"Block 2001, Block Group 2, Census Tract 5104, Santa Clara County, California",16,16,0
1000000US060855104002002,060855104002002,"Block 2002, Block Group 2, Census Tract 5104, Santa Clara County, California",25,24,1
1000000US060855104002003,060855104002003,"Block 2003, Block Group 2, Census Tract 5104, Santa Clara County, California",30,30,0
1000000US060855104002004,060855104002004,"Block 2004, Block Group 2, Census Tract 5104, Santa Clara County, California",33,29,4
1000000US060855104002005,060855104002005,"Block 2005, Block Group 2, Census Tract 5104, Santa Clara County, California",40,38,2
1000000US060855104002006,060855104002006,"Block 2006, Block Group 2, Census Tract 5104, Santa Clara County, California",27,26,1
1000000US060855104002007,060855104002007,"Block 2007, Block Group 2, Census Tract 5104, Santa Clara County, California",47,47,0
1000000US060855104002008,060855104002008,"Block 2008, Block Group 2, Census Tract 5104, Santa Clara County, California",18,17,1
1000000US060855104002009,060855104002009,"Block 2009, Block Group 2, Census Tract 5104, Santa Clara County, California",2,2,0
1000000US060855104003000,060855104003000,"Block 3000, Block Group 3, Census Tract 5104, Santa Clara County, California",53,50,3
1000000US060855104003001,060855104003001,"Block 3001, Block Group 3, Census Tract 5104, Santa Clara County, California",23,22,1
1000000US060855104003002,060855104003002,"Block 3002, Block Group 3, Census Tract 5104, Santa Clara County, California",24,24,0
1000000US060855104003003,060855104003003,"Block 3003, Block Group 3, Census Tract 5104, Santa Clara County, California",24,24,0
1000000US060855104003004,060855104003004,"Block 3004, Block Group 3, Census Tract 5104, Santa Clara County, California",27,26,1
1000000US060855104003005,060855104003005,"Block 3005, Block Group 3, Census Tract 5104, Santa Clara County, California",20,18,2
1000000US060855104003006,060855104003006,"Block 3006, Block Group 3, Census Tract 5104, Santa Clara County, California",8,8,0
1000000US060855104003007,060855104003007,"Block 3007, Block Group 3, Census Tract 5104, Santa Clara County, California",27,26,1
1000000US060855104003008,060855104003008,"Block 3008, Block Group 3, Census Tract 5104, Santa Clara County, California",37,36,1
1000000US060855104003009,060855104003009,"Block 3009, Block Group 3, Census Tract 5104, Santa Clara County, California",0,0,0
1000000US060855104003010,060855104003010,"Block 3010, Block Group 3, Census Tract 5104, Santa Clara County, California",39,38,1
1000000US060855104003011,060855104003011,"Block 3011, Block Group 3, Census Tract 5104, Santa Clara County, California",22,21,1
1000000US060855104003012,060855104003012,"Block 3012, Block Group 3, Census Tract 5104, Santa Clara County, California",23,23,0
1000000US060855104003013,060855104003013,"Block 3013, Block Group 3, Census Tract 5104, Santa Clara County, California",28,26,2
1000000US060855105001000,060855105001000,"Block 1000, Block Group 1, Census Tract 5105, Santa Clara County, California",0,0,0
1000000US060855105001001,060855105001001,"Block 1001, Block Group 1, Census Tract 5105, Santa Clara County, California",0,0,0
1000000US060855105001002,060855105001002,"Block 1002, Block Group 1, Census Tract 5105, Santa Clara County, California",204,191,13
1000000US060855105001003,060855105001003,"Block 1003, Block Group 1, Census Tract 5105, Santa Clara County, California",0,0,0
1000000US060855105001004,060855105001004,"Block 1004, Block Group 1, Census Tract 5105, Santa Clara County, California",0,0,0
1000000US060855105001005,060855105001005,"Block 1005, Block Group 1, Census Tract 5105, Santa Clara County, California",0,0,0
1000000US060855105001006,060855105001006,"Block 1006, Block Group 1, Census Tract 5105, Santa Clara County, California",76,67,9
1000000US060855105001007,060855105001007,"Block 1007, Block Group 1, Census Tract 5105, Santa Clara County, California",60,53,7
1000000US060855105001008,060855105001008,"Block 1008, Block Group 1, Census Tract 5105, Santa Clara County, California",18,16,2
1000000US060855105001009,060855105001009,"Block 1009, Block Group 1, Census Tract 5105, Santa Clara County, California",17,16,1
1000000US060855105001010,060855105001010,"Block 1010, Block Group 1, Census Tract 5105, Santa Clara County, California",18,18,0
1000000US060855105001011,060855105001011,"Block 1011, Block Group 1, Census Tract 5105, Santa Clara County, California",0,0,0
1000000US060855105001012,060855105001012,"Block 1012, Block Group 1, Census Tract 5105, Santa Clara County, California",0,0,0
1000000US060855105001013,060855105001013,"Block 1013, Block Group 1, Census Tract 5105, Santa Clara County, California",15,15,0
1000000US060855105001014,060855105001014,"Block 1014, Block Group 1, Census Tract 5105, Santa Clara County, California",19,19,0
1000000US060855105001015,060855105001015,"Block 1015, Block Group 1, Census Tract 5105, Santa Clara County, California",23,23,0
1000000US060855105001016,060855105001016,"Block 1016, Block Group 1, Census Tract 5105, Santa Clara County, California",0,0,0
1000000US060855105002000,060855105002000,"Block 2000, Block Group 2, Census Tract 5105, Santa Clara County, California",118,113,5
1000000US060855105002001,060855105002001,"Block 2001, Block Group 2, Census Tract 5105, Santa Clara County, California",28,27,1
1000000US060855105002002,060855105002002,"Block 2002, Block Group 2, Census Tract 5105, Santa Clara County, California",14,14,0
1000000US060855105002003,060855105002003,"Block 2003, Block Group 2, Census Tract 5105, Santa Clara County, California",4,4,0
1000000US060855105002004,060855105002004,"Block 2004, Block Group 2, Census Tract 5105, Santa Clara County, California",7,7,0
1000000US060855105002005,060855105002005,"Block 2005, Block Group 2, Census Tract 5105, Santa Clara County, California",149,137,12
1000000US060855105002006,060855105002006,"Block 2006, Block Group 2, Census Tract 5105, Santa Clara County, California",0,0,0
1000000US060855105002007,060855105002007,"Block 2007, Block Group 2, Census Tract 5105, Santa Clara County, California",24,23,1
1000000US060855105002008,060855105002008,"Block 2008, Block Group 2, Census Tract 5105, Santa Clara County, California",12,12,0
1000000US060855105002009,060855105002009,"Block 2009, Block Group 2, Census Tract 5105, Santa Clara County, California",159,150,9
1000000US060855105002010,060855105002010,"Block 2010, Block Group 2, Census Tract 5105, Santa Clara County, California",22,22,0
1000000US060855105002011,060855105002011,"Block 2011, Block Group 2, Census Tract 5105, Santa Clara County, California",12,12,0
1000000US060855105002012,060855105002012,"Block 2012, Block Group 2, Census Tract 5105, Santa Clara County, California",67,67,0
1000000US060855105002013,060855105002013,"Block 2013, Block Group 2, Census Tract 5105, Santa Clara County, California",4,3,1
1000000US060855105002014,060855105002014,"Block 2014, Block Group 2, Census Tract 5105, Santa Clara County, California",29,27,2
1000000US060855105002015,060855105002015,"Block 2015, Block Group 2, Census Tract 5105, Santa Clara County, California",20,19,1
1000000US060855105002016,060855105002016,"Block 2016, Block Group 2, Census Tract 5105, Santa Clara County, California",19,19,0
1000000US060855105002017,060855105002017,"Block 2017, Block Group 2, Census Tract 5105, Santa Clara County, California",27,27,0
1000000US060855105003000,060855105003000,"Block 3000, Block Group 3, Census Tract 5105, Santa Clara County, California",0,0,0
1000000US060855105003001,060855105003001,"Block 3001, Block Group 3, Census Tract 5105, Santa Clara County, California",72,67,5
1000000US060855105003002,060855105003002,"Block 3002, Block Group 3, Census Tract 5105, Santa Clara County, California",9,9,0
1000000US060855105003003,060855105003003,"Block 3003, Block Group 3, Census Tract 5105, Santa Clara County, California",58,52,6
1000000US060855105003004,060855105003004,"Block 3004, Block Group 3, Census Tract 5105, Santa Clara County, California",30,29,1
1000000US060855105003005,060855105003005,"Block 3005, Block Group 3, Census Tract 5105, Santa Clara County, California",47,46,1
1000000US060855105003006,060855105003006,"Block 3006, Block Group 3, Census Tract 5105, Santa Clara County, California",48,46,2
1000000US060855105003007,060855105003007,"Block 3007, Block Group 3, Census Tract 5105, Santa Clara County, California",12,12,0
1000000US060855105003008,060855105003008,"Block 3008, Block Group 3, Census Tract 5105, Santa Clara County, California",24,24,0
1000000US060855105003009,060855105003009,"Block 3009, Block Group 3, Census Tract 5105, Santa Clara County, California",9,9,0
1000000US060855105003010,060855105003010,"Block 3010, Block Group 3, Census Tract 5105, Santa Clara County, California",0,0,0
1000000US060855105003011,060855105003011,"Block 3011, Block Group 3, Census Tract 5105, Santa Clara County, California",0,0,0
1000000US060855105003012,060855105003012,"Block 3012, Block Group 3, Census Tract 5105, Santa Clara County, California",0,0,0
1000000US060855105003013,060855105003013,"Block 3013, Block Group 3, Census Tract 5105, Santa Clara County, California",0,0,0
1000000US060855105003014,060855105003014,"Block 3014, Block Group 3, Census Tract 5105, Santa Clara County, California",0,0,0
1000000US060855105003015,060855105003015,"Block 3015, Block Group 3, Census Tract 5105, Santa Clara County, California",30,29,1
1000000US060855105003016,060855105003016,"Block 3016, Block Group 3, Census Tract 5105, Santa Clara County, California",158,155,3
1000000US060855105003017,060855105003017,"Block 3017, Block Group 3, Census Tract 5105, Santa Clara County, California",20,19,1
1000000US060855105003018,060855105003018,"Block 3018, Block Group 3, Census Tract 5105, Santa Clara County, California",19,19,0
1000000US060855105003019,060855105003019,"Block 3019, Block Group 3, Census Tract 5105, Santa Clara County, California",11,11,0
1000000US060855105003020,060855105003020,"Block 3020, Block Group 3, Census Tract 5105, Santa Clara County, California",12,11,1
1000000US060855105003021,060855105003021,"Block 3021, Block Group 3, Census Tract 5105, Santa Clara County, California",63,63,0
1000000US060855105003022,060855105003022,"Block 3022, Block Group 3, Census Tract 5105, Santa Clara County, California",18,18,0
1000000US060855105003023,060855105003023,"Block 3023, Block Group 3, Census Tract 5105, Santa Clara County, California",0,0,0
1000000US060855105003024,060855105003024,"Block 3024, Block Group 3, Census Tract 5105, Santa Clara County, California",26,25,1
1000000US060855105003025,060855105003025,"Block 3025, Block Group 3, Census Tract 5105, Santa Clara County, California",26,24,2
1000000US060855105003026,060855105003026,"Block 3026, Block Group 3, Census Tract 5105, Santa Clara County, California",71,67,4
1000000US060855105003027,060855105003027,"Block 3027, Block Group 3, Census Tract 5105, Santa Clara County, California",0,0,0
1000000US060855105003028,060855105003028,"Block 3028, Block Group 3, Census Tract 5105, Santa Clara County, California",0,0,0
1000000US060855105003029,060855105003029,"Block 3029, Block Group 3, Census Tract 5105, Santa Clara County, California",0,0,0
1000000US060855105003030,060855105003030,"Block 3030, Block Group 3, Census Tract 5105, Santa Clara County, California",0,0,0
1000000US060855105003031,060855105003031,"Block 3031, Block Group 3, Census Tract 5105, Santa Clara County, California",40,38,2
1000000US060855105003032,060855105003032,"Block 3032, Block Group 3, Census Tract 5105, Santa Clara County, California",0,0,0
1000000US060855105003033,060855105003033,"Block 3033, Block Group 3, Census Tract 5105, Santa Clara County, California",0,0,0
1000000US060855105003034,060855105003034,"Block 3034, Block Group 3, Census Tract 5105, Santa Clara County, California",7,6,1
1000000US060855105003035,060855105003035,"Block 3035, Block Group 3, Census Tract 5105, Santa Clara County, California",0,0,0
1000000US060855105003036,060855105003036,"Block 3036, Block Group 3, Census Tract 5105, Santa Clara County, California",0,0,0
1000000US060855106001000,060855106001000,"Block 1000, Block Group 1, Census Tract 5106, Santa Clara County, California",138,125,13
1000000US060855106001001,060855106001001,"Block 1001, Block Group 1, Census Tract 5106, Santa Clara County, California",19,18,1
1000000US060855106001002,060855106001002,"Block 1002, Block Group 1, Census Tract 5106, Santa Clara County, California",18,18,0
1000000US060855106001003,060855106001003,"Block 1003, Block Group 1, Census Tract 5106, Santa Clara County, California",39,39,0
1000000US060855106001004,060855106001004,"Block 1004, Block Group 1, Census Tract 5106, Santa Clara County, California",36,36,0
1000000US060855106001005,060855106001005,"Block 1005, Block Group 1, Census Tract 5106, Santa Clara County, California",38,37,1
1000000US060855106001006,060855106001006,"Block 1006, Block Group 1, Census Tract 5106, Santa Clara County, California",20,20,0
1000000US060855106002000,060855106002000,"Block 2000, Block Group 2, Census Tract 5106, Santa Clara County, California",18,15,3
1000000US060855106002001,060855106002001,"Block 2001, Block Group 2, Census Tract 5106, Santa Clara County, California",35,34,1
1000000US060855106002002,060855106002002,"Block 2002, Block Group 2, Census Tract 5106, Santa Clara County, California",15,15,0
1000000US060855106002003,060855106002003,"Block 2003, Block Group 2, Census Tract 5106, Santa Clara County, California",179,168,11
1000000US060855106002004,060855106002004,"Block 2004, Block Group 2, Census Tract 5106, Santa Clara County, California",49,49,0
1000000US060855106002005,060855106002005,"Block 2005, Block Group 2, Census Tract 5106, Santa Clara County, California",45,43,2
1000000US060855106002006,060855106002006,"Block 2006, Block Group 2, Census Tract 5106, Santa Clara County, California",12,12,0
1000000US060855106002007,060855106002007,"Block 2007, Block Group 2, Census Tract 5106, Santa Clara County, California",32,31,1
1000000US060855106002008,060855106002008,"Block 2008, Block Group 2, Census Tract 5106, Santa Clara County, California",9,9,0
1000000US060855106002009,060855106002009,"Block 2009, Block Group 2, Census Tract 5106, Santa Clara County, California",28,27,1
1000000US060855106002010,060855106002010,"Block 2010, Block Group 2, Census Tract 5106, Santa Clara County, California",55,54,1
1000000US060855106002011,060855106002011,"Block 2011, Block Group 2, Census Tract 5106, Santa Clara County, California",45,44,1
1000000US060855106002012,060855106002012,"Block 2012, Block Group 2, Census Tract 5106, Santa Clara County, California",110,110,0
1000000US060855106002013,060855106002013,"Block 2013, Block Group 2, Census Tract 5106, Santa Clara County, California",69,67,2
1000000US060855106002014,060855106002014,"Block 2014, Block Group 2, Census Tract 5106, Santa Clara County, California",10,10,0
1000000US060855106002015,060855106002015,"Block 2015, Block Group 2, Census Tract 5106, Santa Clara County, California",24,24,0
1000000US060855106002016,060855106002016,"Block 2016, Block Group 2, Census Tract 5106, Santa Clara County, California",16,16,0
1000000US060855106002017,060855106002017,"Block 2017, Block Group 2, Census Tract 5106, Santa Clara County, California",16,16,0
1000000US060855106002018,060855106002018,"Block 2018, Block Group 2, Census Tract 5106, Santa Clara County, California",25,25,0
1000000US060855106002019,060855106002019,"Block 2019, Block Group 2, Census Tract 5106, Santa Clara County, California",27,27,0
1000000US060855106002020,060855106002020,"Block 2020, Block Group 2, Census Tract 5106, Santa Clara County, California",27,25,2
1000000US060855106003000,060855106003000,"Block 3000, Block Group 3, Census Tract 5106, Santa Clara County, California",31,29,2
1000000US060855106003001,060855106003001,"Block 3001, Block Group 3, Census Tract 5106, Santa Clara County, California",133,127,6
1000000US060855106003002,060855106003002,"Block 3002, Block Group 3, Census Tract 5106, Santa Clara County, California",17,17,0
1000000US060855106003003,060855106003003,"Block 3003, Block Group 3, Census Tract 5106, Santa Clara County, California",27,27,0
1000000US060855106003004,060855106003004,"Block 3004, Block Group 3, Census Tract 5106, Santa Clara County, California",166,163,3
1000000US060855106003005,060855106003005,"Block 3005, Block Group 3, Census Tract 5106, Santa Clara County, California",20,20,0
1000000US060855106003006,060855106003006,"Block 3006, Block Group 3, Census Tract 5106, Santa Clara County, California",230,224,6
1000000US060855106003007,060855106003007,"Block 3007, Block Group 3, Census Tract 5106, Santa Clara County, California",20,20,0
1000000US060855106003008,060855106003008,"Block 3008, Block Group 3, Census Tract 5106, Santa Clara County, California",0,0,0
1000000US060855106003009,060855106003009,"Block 3009, Block Group 3, Census Tract 5106, Santa Clara County, California",31,31,0
1000000US060855106003010,060855106003010,"Block 3010, Block Group 3, Census Tract 5106, Santa Clara County, California",46,44,2
1000000US060855106003011,060855106003011,"Block 3011, Block Group 3, Census Tract 5106, Santa Clara County, California",10,9,1
1000000US060855106003012,060855106003012,"Block 3012, Block Group 3, Census Tract 5106, Santa Clara County, California",70,67,3
1000000US060855106003013,060855106003013,"Block 3013, Block Group 3, Census Tract 5106, Santa Clara County, California",0,0,0
1000000US060855106004000,060855106004000,"Block 4000, Block Group 4, Census Tract 5106, Santa Clara County, California",0,0,0
1000000US060855106004001,060855106004001,"Block 4001, Block Group 4, Census Tract 5106, Santa Clara County, California",0,0,0
1000000US060855106004002,060855106004002,"Block 4002, Block Group 4, Census Tract 5106, Santa Clara County, California",270,260,10
1000000US060855106004003,060855106004003,"Block 4003, Block Group 4, Census Tract 5106, Santa Clara County, California",19,19,0
1000000US060855106004004,060855106004004,"Block 4004, Block Group 4, Census Tract 5106, Santa Clara County, California",56,50,6
1000000US060855106004005,060855106004005,"Block 4005, Block Group 4, Census Tract 5106, Santa Clara County, California",0,0,0
1000000US060855106004006,060855106004006,"Block 4006, Block Group 4, Census Tract 5106, Santa Clara County, California",30,29,1
1000000US060855106004007,060855106004007,"Block 4007, Block Group 4, Census Tract 5106, Santa Clara County, California",19,19,0
1000000US060855106004008,060855106004008,"Block 4008, Block Group 4, Census Tract 5106, Santa Clara County, California",17,17,0
1000000US060855106004009,060855106004009,"Block 4009, Block Group 4, Census Tract 5106, Santa Clara County, California",101,90,11
1000000US060855107001000,060855107001000,"Block 1000, Block Group 1, Census Tract 5107, Santa Clara County, California",0,0,0
1000000US060855107001001,060855107001001,"Block 1001, Block Group 1, Census Tract 5107, Santa Clara County, California",0,0,0
1000000US060855107001002,060855107001002,"Block 1002, Block Group 1, Census Tract 5107, Santa Clara County, California",0,0,0
1000000US060855107001003,060855107001003,"Block 1003, Block Group 1, Census Tract 5107, Santa Clara County, California",0,0,0
1000000US060855107001004,060855107001004,"Block 1004, Block Group 1, Census Tract 5107, Santa Clara County, California",0,0,0
1000000US060855107001005,060855107001005,"Block 1005, Block Group 1, Census Tract 5107, Santa Clara County, California",21,21,0
1000000US060855107001006,060855107001006,"Block 1006, Block Group 1, Census Tract 5107, Santa Clara County, California",0,0,0
1000000US060855107001007,060855107001007,"Block 1007, Block Group 1, Census Tract 5107, Santa Clara County, California",1,1,0
1000000US060855107001008,060855107001008,"Block 1008, Block Group 1, Census Tract 5107, Santa Clara County, California",0,0,0
1000000US060855107001009,060855107001009,"Block 1009, Block Group 1, Census Tract 5107, Santa Clara County, California",18,18,0
1000000US060855107001010,060855107001010,"Block 1010, Block Group 1, Census Tract 5107, Santa Clara County, California",17,16,1
1000000US060855107001011,060855107001011,"Block 1011, Block Group 1, Census Tract 5107, Santa Clara County, California",31,28,3
1000000US060855107001012,060855107001012,"Block 1012, Block Group 1, Census Tract 5107, Santa Clara County, California",0,0,0
1000000US060855107001013,060855107001013,"Block 1013, Block Group 1, Census Tract 5107, Santa Clara County, California",14,14,0
1000000US060855107001014,060855107001014,"Block 1014, Block Group 1, Census Tract 5107, Santa Clara County, California",18,18,0
1000000US060855107001015,060855107001015,"Block 1015, Block Group 1, Census Tract 5107, Santa Clara County, California",0,0,0
1000000US060855107001016,060855107001016,"Block 1016, Block Group 1, Census Tract 5107, Santa Clara County, California",0,0,0
1000000US060855107001017,060855107001017,"Block 1017, Block Group 1, Census Tract 5107, Santa Clara County, California",0,0,0
1000000US060855107001018,060855107001018,"Block 1018, Block Group 1, Census Tract 5107, Santa Clara County, California",1,1,0
1000000US060855107001019,060855107001019,"Block 1019, Block Group 1, Census Tract 5107, Santa Clara County, California",3,1,2
1000000US060855107001020,060855107001020,"Block 1020, Block Group 1, Census Tract 5107, Santa Clara County, California",21,20,1
1000000US060855107001021,060855107001021,"Block 1021, Block Group 1, Census Tract 5107, Santa Clara County, California",19,18,1
1000000US060855107001022,060855107001022,"Block 1022, Block Group 1, Census Tract 5107, Santa Clara County, California",21,21,0
1000000US060855107001023,060855107001023,"Block 1023, Block Group 1, Census Tract 5107, Santa Clara County, California",38,37,1
1000000US060855107001024,060855107001024,"Block 1024, Block Group 1, Census Tract 5107, Santa Clara County, California",33,30,3
1000000US060855107001025,060855107001025,"Block 1025, Block Group 1, Census Tract 5107, Santa Clara County, California",33,30,3
1000000US060855107001026,060855107001026,"Block 1026, Block Group 1, Census Tract 5107, Santa Clara County, California",2,2,0
1000000US060855107001027,060855107001027,"Block 1027, Block Group 1, Census Tract 5107, Santa Clara County, California",0,0,0
1000000US060855107001028,060855107001028,"Block 1028, Block Group 1, Census Tract 5107, Santa Clara County, California",3,3,0
1000000US060855107001029,060855107001029,"Block 1029, Block Group 1, Census Tract 5107, Santa Clara County, California",3,3,0
1000000US060855107001030,060855107001030,"Block 1030, Block Group 1, Census Tract 5107, Santa Clara County, California",1,1,0
1000000US060855107002000,060855107002000,"Block 2000, Block Group 2, Census Tract 5107, Santa Clara County, California",102,95,7
1000000US060855107002001,060855107002001,"Block 2001, Block Group 2, Census Tract 5107, Santa Clara County, California",15,15,0
1000000US060855107002002,060855107002002,"Block 2002, Block Group 2, Census Tract 5107, Santa Clara County, California",56,52,4
1000000US060855107002003,060855107002003,"Block 2003, Block Group 2, Census Tract 5107, Santa Clara County, California",309,281,28
1000000US060855107002004,060855107002004,"Block 2004, Block Group 2, Census Tract 5107, Santa Clara County, California",186,171,15
1000000US060855107002005,060855107002005,"Block 2005, Block Group 2, Census Tract 5107, Santa Clara County, California",4,4,0
1000000US060855107002006,060855107002006,"Block 2006, Block Group 2, Census Tract 5107, Santa Clara County, California",0,0,0
1000000US060855107002007,060855107002007,"Block 2007, Block Group 2, Census Tract 5107, Santa Clara County, California",25,24,1
1000000US060855107002008,060855107002008,"Block 2008, Block Group 2, Census Tract 5107, Santa Clara County, California",143,138,5
1000000US060855107002009,060855107002009,"Block 2009, Block Group 2, Census Tract 5107, Santa Clara County, California",56,54,2
1000000US060855107002010,060855107002010,"Block 2010, Block Group 2, Census Tract 5107, Santa Clara County, California",27,25,2
1000000US060855107003000,060855107003000,"Block 3000, Block Group 3, Census Tract 5107, Santa Clara County, California",28,27,1
1000000US060855107003001,060855107003001,"Block 3001, Block Group 3, Census Tract 5107, Santa Clara County, California",53,49,4
1000000US060855107003002,060855107003002,"Block 3002, Block Group 3, Census Tract 5107, Santa Clara County, California",86,82,4
1000000US060855107003003,060855107003003,"Block 3003, Block Group 3, Census Tract 5107, Santa Clara County, California",10,7,3
1000000US060855107003004,060855107003004,"Block 3004, Block Group 3, Census Tract 5107, Santa Clara County, California",1,1,0
1000000US060855107003005,060855107003005,"Block 3005, Block Group 3, Census Tract 5107, Santa Clara County, California",0,0,0
1000000US060855107003006,060855107003006,"Block 3006, Block Group 3, Census Tract 5107, Santa Clara County, California",0,0,0
1000000US060855107003007,060855107003007,"Block 3007, Block Group 3, Census Tract 5107, Santa Clara County, California",0,0,0
1000000US060855107003008,060855107003008,"Block 3008, Block Group 3, Census Tract 5107, Santa Clara County, California",172,164,8
1000000US060855107003009,060855107003009,"Block 3009, Block Group 3, Census Tract 5107, Santa Clara County, California",32,29,3
1000000US060855107003010,060855107003010,"Block 3010, Block Group 3, Census Tract 5107, Santa Clara County, California",25,23,2
1000000US060855107003011,060855107003011,"Block 3011, Block Group 3, Census Tract 5107, Santa Clara County, California",40,38,2
1000000US060855107003012,060855107003012,"Block 3012, Block Group 3, Census Tract 5107, Santa Clara County, California",186,167,19
1000000US060855107003013,060855107003013,"Block 3013, Block Group 3, Census Tract 5107, Santa Clara County, California",1,1,0
1000000US060855107003014,060855107003014,"Block 3014, Block Group 3, Census Tract 5107, Santa Clara County, California",36,36,0
1000000US060855107003015,060855107003015,"Block 3015, Block Group 3, Census Tract 5107, Santa Clara County, California",0,0,0
1000000US060855107003016,060855107003016,"Block 3016, Block Group 3, Census Tract 5107, Santa Clara County, California",0,0,0
1000000US060855107003017,060855107003017,"Block 3017, Block Group 3, Census Tract 5107, Santa Clara County, California",0,0,0
1000000US060855107003018,060855107003018,"Block 3018, Block Group 3, Census Tract 5107, Santa Clara County, California",94,92,2
1000000US060855107003019,060855107003019,"Block 3019, Block Group 3, Census Tract 5107, Santa Clara County, California",5,5,0
1000000US060855107003020,060855107003020,"Block 3020, Block Group 3, Census Tract 5107, Santa Clara County, California",7,7,0
1000000US060855107003021,060855107003021,"Block 3021, Block Group 3, Census Tract 5107, Santa Clara County, California",2,2,0
1000000US060855107003022,060855107003022,"Block 3022, Block Group 3, Census Tract 5107, Santa Clara County, California",36,34,2
1000000US060855107003023,060855107003023,"Block 3023, Block Group 3, Census Tract 5107, Santa Clara County, California",1,1,0
1000000US060855107003024,060855107003024,"Block 3024, Block Group 3, Census Tract 5107, Santa Clara County, California",28,28,0
1000000US060855107003025,060855107003025,"Block 3025, Block Group 3, Census Tract 5107, Santa Clara County, California",34,31,3
1000000US060855107003026,060855107003026,"Block 3026, Block Group 3, Census Tract 5107, Santa Clara County, California",0,0,0
1000000US060855108011000,060855108011000,"Block 1000, Block Group 1, Census Tract 5108.01, Santa Clara County, California",0,0,0
1000000US060855108011001,060855108011001,"Block 1001, Block Group 1, Census Tract 5108.01, Santa Clara County, California",0,0,0
1000000US060855108011002,060855108011002,"Block 1002, Block Group 1, Census Tract 5108.01, Santa Clara County, California",50,50,0
1000000US060855108011003,060855108011003,"Block 1003, Block Group 1, Census Tract 5108.01, Santa Clara County, California",49,48,1
1000000US060855108011004,060855108011004,"Block 1004, Block Group 1, Census Tract 5108.01, Santa Clara County, California",23,23,0
1000000US060855108011005,060855108011005,"Block 1005, Block Group 1, Census Tract 5108.01, Santa Clara County, California",96,94,2
1000000US060855108011006,060855108011006,"Block 1006, Block Group 1, Census Tract 5108.01, Santa Clara County, California",19,19,0
1000000US060855108011007,060855108011007,"Block 1007, Block Group 1, Census Tract 5108.01, Santa Clara County, California",16,16,0
1000000US060855108011008,060855108011008,"Block 1008, Block Group 1, Census Tract 5108.01, Santa Clara County, California",56,54,2
1000000US060855108011009,060855108011009,"Block 1009, Block Group 1, Census Tract 5108.01, Santa Clara County, California",20,20,0
1000000US060855108011010,060855108011010,"Block 1010, Block Group 1, Census Tract 5108.01, Santa Clara County, California",33,32,1
1000000US060855108011011,060855108011011,"Block 1011, Block Group 1, Census Tract 5108.01, Santa Clara County, California",17,16,1
1000000US060855108011012,060855108011012,"Block 1012, Block Group 1, Census Tract 5108.01, Santa Clara County, California",38,37,1
1000000US060855108011013,060855108011013,"Block 1013, Block Group 1, Census Tract 5108.01, Santa Clara County, California",81,80,1
1000000US060855108011014,060855108011014,"Block 1014, Block Group 1, Census Tract 5108.01, Santa Clara County, California",25,24,1
1000000US060855108011015,060855108011015,"Block 1015, Block Group 1, Census Tract 5108.01, Santa Clara County, California",14,14,0
1000000US060855108011016,060855108011016,"Block 1016, Block Group 1, Census Tract 5108.01, Santa Clara County, California",15,13,2
1000000US060855108012000,060855108012000,"Block 2000, Block Group 2, Census Tract 5108.01, Santa Clara County, California",92,90,2
1000000US060855108012001,060855108012001,"Block 2001, Block Group 2, Census Tract 5108.01, Santa Clara County, California",25,25,0
1000000US060855108012002,060855108012002,"Block 2002, Block Group 2, Census Tract 5108.01, Santa Clara County, California",33,33,0
1000000US060855108012003,060855108012003,"Block 2003, Block Group 2, Census Tract 5108.01, Santa Clara County, California",14,14,0
1000000US060855108012004,060855108012004,"Block 2004, Block Group 2, Census Tract 5108.01, Santa Clara County, California",75,74,1
1000000US060855108012005,060855108012005,"Block 2005, Block Group 2, Census Tract 5108.01, Santa Clara County, California",5,5,0
1000000US060855108012006,060855108012006,"Block 2006, Block Group 2, Census Tract 5108.01, Santa Clara County, California",30,30,0
1000000US060855108012007,060855108012007,"Block 2007, Block Group 2, Census Tract 5108.01, Santa Clara County, California",10,10,0
1000000US060855108012008,060855108012008,"Block 2008, Block Group 2, Census Tract 5108.01, Santa Clara County, California",42,42,0
1000000US060855108012009,060855108012009,"Block 2009, Block Group 2, Census Tract 5108.01, Santa Clara County, California",20,20,0
1000000US060855108012010,060855108012010,"Block 2010, Block Group 2, Census Tract 5108.01, Santa Clara County, California",18,18,0
1000000US060855108012011,060855108012011,"Block 2011, Block Group 2, Census Tract 5108.01, Santa Clara County, California",22,22,0
1000000US060855108012012,060855108012012,"Block 2012, Block Group 2, Census Tract 5108.01, Santa Clara County, California",68,66,2
1000000US060855108012013,060855108012013,"Block 2013, Block Group 2, Census Tract 5108.01, Santa Clara County, California",35,34,1
1000000US060855108012014,060855108012014,"Block 2014, Block Group 2, Census Tract 5108.01, Santa Clara County, California",28,26,2
1000000US060855108012015,060855108012015,"Block 2015, Block Group 2, Census Tract 5108.01, Santa Clara County, California",54,52,2
1000000US060855108012016,060855108012016,"Block 2016, Block Group 2, Census Tract 5108.01, Santa Clara County, California",22,21,1
1000000US060855108012017,060855108012017,"Block 2017, Block Group 2, Census Tract 5108.01, Santa Clara County, California",45,45,0
1000000US060855108012018,060855108012018,"Block 2018, Block Group 2, Census Tract 5108.01, Santa Clara County, California",22,22,0
1000000US060855108012019,060855108012019,"Block 2019, Block Group 2, Census Tract 5108.01, Santa Clara County, California",25,25,0
1000000US060855108012020,060855108012020,"Block 2020, Block Group 2, Census Tract 5108.01, Santa Clara County, California",37,36,1
1000000US060855108013000,060855108013000,"Block 3000, Block Group 3, Census Tract 5108.01, Santa Clara County, California",327,101,226
1000000US060855108013001,060855108013001,"Block 3001, Block Group 3, Census Tract 5108.01, Santa Clara County, California",0,0,0
1000000US060855108013002,060855108013002,"Block 3002, Block Group 3, Census Tract 5108.01, Santa Clara County, California",0,0,0
1000000US060855108013003,060855108013003,"Block 3003, Block Group 3, Census Tract 5108.01, Santa Clara County, California",0,0,0
1000000US060855108013004,060855108013004,"Block 3004, Block Group 3, Census Tract 5108.01, Santa Clara County, California",0,0,0
1000000US060855108013005,060855108013005,"Block 3005, Block Group 3, Census Tract 5108.01, Santa Clara County, California",55,48,7
1000000US060855108013006,060855108013006,"Block 3006, Block Group 3, Census Tract 5108.01, Santa Clara County, California",11,10,1
1000000US060855108013007,060855108013007,"Block 3007, Block Group 3, Census Tract 5108.01, Santa Clara County, California",0,0,0
1000000US060855108013008,060855108013008,"Block 3008, Block Group 3, Census Tract 5108.01, Santa Clara County, California",0,0,0
1000000US060855108013009,060855108013009,"Block 3009, Block Group 3, Census Tract 5108.01, Santa Clara County, California",294,280,14
1000000US060855108013010,060855108013010,"Block 3010, Block Group 3, Census Tract 5108.01, Santa Clara County, California",0,0,0
1000000US060855108013011,060855108013011,"Block 3011, Block Group 3, Census Tract 5108.01, Santa Clara County, California",0,0,0
1000000US060855108013012,060855108013012,"Block 3012, Block Group 3, Census Tract 5108.01, Santa Clara County, California",26,26,0
1000000US060855108013013,060855108013013,"Block 3013, Block Group 3, Census Tract 5108.01, Santa Clara County, California",55,55,0
1000000US060855108013014,060855108013014,"Block 3014, Block Group 3, Census Tract 5108.01, Santa Clara County, California",52,50,2
1000000US060855108013015,060855108013015,"Block 3015, Block Group 3, Census Tract 5108.01, Santa Clara County, California",72,72,0
1000000US060855108013016,060855108013016,"Block 3016, Block Group 3, Census Tract 5108.01, Santa Clara County, California",29,28,1
1000000US060855108013017,060855108013017,"Block 3017, Block Group 3, Census Tract 5108.01, Santa Clara County, California",28,28,0
1000000US060855108013018,060855108013018,"Block 3018, Block Group 3, Census Tract 5108.01, Santa Clara County, California",0,0,0
1000000US060855108013019,060855108013019,"Block 3019, Block Group 3, Census Tract 5108.01, Santa Clara County, California",0,0,0
1000000US060855108013020,060855108013020,"Block 3020, Block Group 3, Census Tract 5108.01, Santa Clara County, California",0,0,0
1000000US060855108013021,060855108013021,"Block 3021, Block Group 3, Census Tract 5108.01, Santa Clara County, California",0,0,0
1000000US060855108013022,060855108013022,"Block 3022, Block Group 3, Census Tract 5108.01, Santa Clara County, California",0,0,0
1000000US060855108013023,060855108013023,"Block 3023, Block Group 3, Census Tract 5108.01, Santa Clara County, California",0,0,0
1000000US060855108013024,060855108013024,"Block 3024, Block Group 3, Census Tract 5108.01, Santa Clara County, California",0,0,0
1000000US060855108013025,060855108013025,"Block 3025, Block Group 3, Census Tract 5108.01, Santa Clara County, California",0,0,0
1000000US060855108021000,060855108021000,"Block 1000, Block Group 1, Census Tract 5108.02, Santa Clara County, California",89,86,3
1000000US060855108021001,060855108021001,"Block 1001, Block Group 1, Census Tract 5108.02, Santa Clara County, California",40,39,1
1000000US060855108021002,060855108021002,"Block 1002, Block Group 1, Census Tract 5108.02, Santa Clara County, California",0,0,0
1000000US060855108021003,060855108021003,"Block 1003, Block Group 1, Census Tract 5108.02, Santa Clara County, California",34,34,0
1000000US060855108021004,060855108021004,"Block 1004, Block Group 1, Census Tract 5108.02, Santa Clara County, California",10,9,1
1000000US060855108021005,060855108021005,"Block 1005, Block Group 1, Census Tract 5108.02, Santa Clara County, California",55,53,2
1000000US060855108021006,060855108021006,"Block 1006, Block Group 1, Census Tract 5108.02, Santa Clara County, California",17,17,0
1000000US060855108021007,060855108021007,"Block 1007, Block Group 1, Census Tract 5108.02, Santa Clara County, California",19,19,0
1000000US060855108021008,060855108021008,"Block 1008, Block Group 1, Census Tract 5108.02, Santa Clara County, California",0,0,0
1000000US060855108021009,060855108021009,"Block 1009, Block Group 1, Census Tract 5108.02, Santa Clara County, California",57,55,2
1000000US060855108022000,060855108022000,"Block 2000, Block Group 2, Census Tract 5108.02, Santa Clara County, California",88,88,0
1000000US060855108022001,060855108022001,"Block 2001, Block Group 2, Census Tract 5108.02, Santa Clara County, California",0,0,0
1000000US060855108022002,060855108022002,"Block 2002, Block Group 2, Census Tract 5108.02, Santa Clara County, California",28,27,1
1000000US060855108022003,060855108022003,"Block 2003, Block Group 2, Census Tract 5108.02, Santa Clara County, California",41,40,1
1000000US060855108022004,060855108022004,"Block 2004, Block Group 2, Census Tract 5108.02, Santa Clara County, California",31,31,0
1000000US060855108022005,060855108022005,"Block 2005, Block Group 2, Census Tract 5108.02, Santa Clara County, California",0,0,0
1000000US060855108022006,060855108022006,"Block 2006, Block Group 2, Census Tract 5108.02, Santa Clara County, California",0,0,0
1000000US060855108022007,060855108022007,"Block 2007, Block Group 2, Census Tract 5108.02, Santa Clara County, California",0,0,0
1000000US060855108022008,060855108022008,"Block 2008, Block Group 2, Census Tract 5108.02, Santa Clara County, California",0,0,0
1000000US060855108022009,060855108022009,"Block 2009, Block Group 2, Census Tract 5108.02, Santa Clara County, California",17,16,1
1000000US060855108022010,060855108022010,"Block 2010, Block Group 2, Census Tract 5108.02, Santa Clara County, California",36,35,1
1000000US060855108022011,060855108022011,"Block 2011, Block Group 2, Census Tract 5108.02, Santa Clara County, California",80,77,3
1000000US060855108022012,060855108022012,"Block 2012, Block Group 2, Census Tract 5108.02, Santa Clara County, California",29,29,0
1000000US060855108022013,060855108022013,"Block 2013, Block Group 2, Census Tract 5108.02, Santa Clara County, California",0,0,0
1000000US060855108022014,060855108022014,"Block 2014, Block Group 2, Census Tract 5108.02, Santa Clara County, California",0,0,0
1000000US060855108022015,060855108022015,"Block 2015, Block Group 2, Census Tract 5108.02, Santa Clara County, California",0,0,0
1000000US060855108022016,060855108022016,"Block 2016, Block Group 2, Census Tract 5108.02, Santa Clara County, California",0,0,0
1000000US060855108022017,060855108022017,"Block 2017, Block Group 2, Census Tract 5108.02, Santa Clara County, California",0,0,0
1000000US060855108022018,060855108022018,"Block 2018, Block Group 2, Census Tract 5108.02, Santa Clara County, California",0,0,0
1000000US060855108022019,060855108022019,"Block 2019, Block Group 2, Census Tract 5108.02, Santa Clara County, California",0,0,0
1000000US060855108022020,060855108022020,"Block 2020, Block Group 2, Census Tract 5108.02, Santa Clara County, California",37,36,1
1000000US060855108022021,060855108022021,"Block 2021, Block Group 2, Census Tract 5108.02, Santa Clara County, California",18,17,1
1000000US060855108031000,060855108031000,"Block 1000, Block Group 1, Census Tract 5108.03, Santa Clara County, California",20,20,0
1000000US060855108031001,060855108031001,"Block 1001, Block Group 1, Census Tract 5108.03, Santa Clara County, California",49,49,0
1000000US060855108031002,060855108031002,"Block 1002, Block Group 1, Census Tract 5108.03, Santa Clara County, California",48,48,0
1000000US060855108031003,060855108031003,"Block 1003, Block Group 1, Census Tract 5108.03, Santa Clara County, California",76,73,3
1000000US060855108031004,060855108031004,"Block 1004, Block Group 1, Census Tract 5108.03, Santa Clara County, California",53,52,1
1000000US060855108031005,060855108031005,"Block 1005, Block Group 1, Census Tract 5108.03, Santa Clara County, California",43,42,1
1000000US060855108031006,060855108031006,"Block 1006, Block Group 1, Census Tract 5108.03, Santa Clara County, California",44,42,2
1000000US060855108031007,060855108031007,"Block 1007, Block Group 1, Census Tract 5108.03, Santa Clara County, California",0,0,0
1000000US060855108031008,060855108031008,"Block 1008, Block Group 1, Census Tract 5108.03, Santa Clara County, California",120,120,0
1000000US060855108031009,060855108031009,"Block 1009, Block Group 1, Census Tract 5108.03, Santa Clara County, California",0,0,0
1000000US060855108031010,060855108031010,"Block 1010, Block Group 1, Census Tract 5108.03, Santa Clara County, California",0,0,0
1000000US060855108031011,060855108031011,"Block 1011, Block Group 1, Census Tract 5108.03, Santa Clara County, California",0,0,0
1000000US060855108031012,060855108031012,"Block 1012, Block Group 1, Census Tract 5108.03, Santa Clara County, California",39,37,2
1000000US060855108031013,060855108031013,"Block 1013, Block Group 1, Census Tract 5108.03, Santa Clara County, California",31,31,0
1000000US060855108032000,060855108032000,"Block 2000, Block Group 2, Census Tract 5108.03, Santa Clara County, California",45,43,2
1000000US060855108032001,060855108032001,"Block 2001, Block Group 2, Census Tract 5108.03, Santa Clara County, California",3,2,1
1000000US060855108032002,060855108032002,"Block 2002, Block Group 2, Census Tract 5108.03, Santa Clara County, California",37,36,1
1000000US060855108032003,060855108032003,"Block 2003, Block Group 2, Census Tract 5108.03, Santa Clara County, California",45,44,1
1000000US060855108032004,060855108032004,"Block 2004, Block Group 2, Census Tract 5108.03, Santa Clara County, California",230,215,15
1000000US060855108032005,060855108032005,"Block 2005, Block Group 2, Census Tract 5108.03, Santa Clara County, California",45,45,0
1000000US060855108032006,060855108032006,"Block 2006, Block Group 2, Census Tract 5108.03, Santa Clara County, California",39,39,0
1000000US060855108032007,060855108032007,"Block 2007, Block Group 2, Census Tract 5108.03, Santa Clara County, California",33,32,1
1000000US060855108032008,060855108032008,"Block 2008, Block Group 2, Census Tract 5108.03, Santa Clara County, California",0,0,0
1000000US060855108032009,060855108032009,"Block 2009, Block Group 2, Census Tract 5108.03, Santa Clara County, California",0,0,0
1000000US060855108032010,060855108032010,"Block 2010, Block Group 2, Census Tract 5108.03, Santa Clara County, California",0,0,0
1000000US060855108032011,060855108032011,"Block 2011, Block Group 2, Census Tract 5108.03, Santa Clara County, California",0,0,0
1000000US060855108032012,060855108032012,"Block 2012, Block Group 2, Census Tract 5108.03, Santa Clara County, California",0,0,0
1000000US060855108032013,060855108032013,"Block 2013, Block Group 2, Census Tract 5108.03, Santa Clara County, California",0,0,0
1000000US060855108032014,060855108032014,"Block 2014, Block Group 2, Census Tract 5108.03, Santa Clara County, California",16,16,0
1000000US060855108032015,060855108032015,"Block 2015, Block Group 2, Census Tract 5108.03, Santa Clara County, California",23,22,1
1000000US060855108032016,060855108032016,"Block 2016, Block Group 2, Census Tract 5108.03, Santa Clara County, California",20,19,1
1000000US060855108032017,060855108032017,"Block 2017, Block Group 2, Census Tract 5108.03, Santa Clara County, California",4,4,0
1000000US060855109001000,060855109001000,"Block 1000, Block Group 1, Census Tract 5109, Santa Clara County, California",0,0,0
1000000US060855109001001,060855109001001,"Block 1001, Block Group 1, Census Tract 5109, Santa Clara County, California",0,0,0
1000000US060855109001002,060855109001002,"Block 1002, Block Group 1, Census Tract 5109, Santa Clara County, California",47,46,1
1000000US060855109001003,060855109001003,"Block 1003, Block Group 1, Census Tract 5109, Santa Clara County, California",26,26,0
1000000US060855109001004,060855109001004,"Block 1004, Block Group 1, Census Tract 5109, Santa Clara County, California",31,30,1
1000000US060855109001005,060855109001005,"Block 1005, Block Group 1, Census Tract 5109, Santa Clara County, California",54,53,1
1000000US060855109001006,060855109001006,"Block 1006, Block Group 1, Census Tract 5109, Santa Clara County, California",0,0,0
1000000US060855109001007,060855109001007,"Block 1007, Block Group 1, Census Tract 5109, Santa Clara County, California",22,22,0
1000000US060855109001008,060855109001008,"Block 1008, Block Group 1, Census Tract 5109, Santa Clara County, California",11,10,1
1000000US060855109001009,060855109001009,"Block 1009, Block Group 1, Census Tract 5109, Santa Clara County, California",23,22,1
1000000US060855109001010,060855109001010,"Block 1010, Block Group 1, Census Tract 5109, Santa Clara County, California",23,22,1
1000000US060855109001011,060855109001011,"Block 1011, Block Group 1, Census Tract 5109, Santa Clara County, California",23,23,0
1000000US060855109001012,060855109001012,"Block 1012, Block Group 1, Census Tract 5109, Santa Clara County, California",0,0,0
1000000US060855109001013,060855109001013,"Block 1013, Block Group 1, Census Tract 5109, Santa Clara County, California",0,0,0
1000000US060855109001014,060855109001014,"Block 1014, Block Group 1, Census Tract 5109, Santa Clara County, California",24,24,0
1000000US060855109001015,060855109001015,"Block 1015, Block Group 1, Census Tract 5109, Santa Clara County, California",22,22,0
1000000US060855109001016,060855109001016,"Block 1016, Block Group 1, Census Tract 5109, Santa Clara County, California",0,0,0
1000000US060855109001017,060855109001017,"Block 1017, Block Group 1, Census Tract 5109, Santa Clara County, California",47,43,4
1000000US060855109001018,060855109001018,"Block 1018, Block Group 1, Census Tract 5109, Santa Clara County, California",31,31,0
1000000US060855109001019,060855109001019,"Block 1019, Block Group 1, Census Tract 5109, Santa Clara County, California",30,29,1
1000000US060855109001020,060855109001020,"Block 1020, Block Group 1, Census Tract 5109, Santa Clara County, California",0,0,0
1000000US060855109001021,060855109001021,"Block 1021, Block Group 1, Census Tract 5109, Santa Clara County, California",0,0,0
1000000US060855109001022,060855109001022,"Block 1022, Block Group 1, Census Tract 5109, Santa Clara County, California",51,49,2
1000000US060855109001023,060855109001023,"Block 1023, Block Group 1, Census Tract 5109, Santa Clara County, California",23,23,0
1000000US060855109001024,060855109001024,"Block 1024, Block Group 1, Census Tract 5109, Santa Clara County, California",12,11,1
1000000US060855109001025,060855109001025,"Block 1025, Block Group 1, Census Tract 5109, Santa Clara County, California",35,35,0
1000000US060855109001026,060855109001026,"Block 1026, Block Group 1, Census Tract 5109, Santa Clara County, California",26,25,1
1000000US060855109001027,060855109001027,"Block 1027, Block Group 1, Census Tract 5109, Santa Clara County, California",27,26,1
1000000US060855109001028,060855109001028,"Block 1028, Block Group 1, Census Tract 5109, Santa Clara County, California",75,71,4
1000000US060855109002000,060855109002000,"Block 2000, Block Group 2, Census Tract 5109, Santa Clara County, California",160,157,3
1000000US060855109002001,060855109002001,"Block 2001, Block Group 2, Census Tract 5109, Santa Clara County, California",120,114,6
1000000US060855109002002,060855109002002,"Block 2002, Block Group 2, Census Tract 5109, Santa Clara County, California",57,54,3
1000000US060855109002003,060855109002003,"Block 2003, Block Group 2, Census Tract 5109, Santa Clara County, California",0,0,0
1000000US060855109002004,060855109002004,"Block 2004, Block Group 2, Census Tract 5109, Santa Clara County, California",54,54,0
1000000US060855109002005,060855109002005,"Block 2005, Block Group 2, Census Tract 5109, Santa Clara County, California",48,48,0
1000000US060855109002006,060855109002006,"Block 2006, Block Group 2, Census Tract 5109, Santa Clara County, California",22,21,1
1000000US060855109002007,060855109002007,"Block 2007, Block Group 2, Census Tract 5109, Santa Clara County, California",22,22,0
1000000US060855109002008,060855109002008,"Block 2008, Block Group 2, Census Tract 5109, Santa Clara County, California",22,21,1
1000000US060855109002009,060855109002009,"Block 2009, Block Group 2, Census Tract 5109, Santa Clara County, California",23,23,0
1000000US060855109002010,060855109002010,"Block 2010, Block Group 2, Census Tract 5109, Santa Clara County, California",46,43,3
1000000US060855109002011,060855109002011,"Block 2011, Block Group 2, Census Tract 5109, Santa Clara County, California",35,30,5
1000000US060855109002012,060855109002012,"Block 2012, Block Group 2, Census Tract 5109, Santa Clara County, California",14,12,2
1000000US060855109002013,060855109002013,"Block 2013, Block Group 2, Census Tract 5109, Santa Clara County, California",0,0,0
1000000US060855109002014,060855109002014,"Block 2014, Block Group 2, Census Tract 5109, Santa Clara County, California",8,8,0
1000000US060855109002015,060855109002015,"Block 2015, Block Group 2, Census Tract 5109, Santa Clara County, California",6,6,0
1000000US060855109002016,060855109002016,"Block 2016, Block Group 2, Census Tract 5109, Santa Clara County, California",7,7,0
1000000US060855109002017,060855109002017,"Block 2017, Block Group 2, Census Tract 5109, Santa Clara County, California",16,16,0
1000000US060855109002018,060855109002018,"Block 2018, Block Group 2, Census Tract 5109, Santa Clara County, California",69,67,2
1000000US060855109002019,060855109002019,"Block 2019, Block Group 2, Census Tract 5109, Santa Clara County, California",0,0,0
1000000US060855109002020,060855109002020,"Block 2020, Block Group 2, Census Tract 5109, Santa Clara County, California",28,27,1
1000000US060855109002021,060855109002021,"Block 2021, Block Group 2, Census Tract 5109, Santa Clara County, California",28,28,0
1000000US060855109002022,060855109002022,"Block 2022, Block Group 2, Census Tract 5109, Santa Clara County, California",55,51,4
1000000US060855109003000,060855109003000,"Block 3000, Block Group 3, Census Tract 5109, Santa Clara County, California",62,59,3
1000000US060855109003001,060855109003001,"Block 3001, Block Group 3, Census Tract 5109, Santa Clara County, California",53,51,2
1000000US060855109003002,060855109003002,"Block 3002, Block Group 3, Census Tract 5109, Santa Clara County, California",20,20,0
1000000US060855109003003,060855109003003,"Block 3003, Block Group 3, Census Tract 5109, Santa Clara County, California",17,17,0
1000000US060855109003004,060855109003004,"Block 3004, Block Group 3, Census Tract 5109, Santa Clara County, California",47,46,1
1000000US060855109003005,060855109003005,"Block 3005, Block Group 3, Census Tract 5109, Santa Clara County, California",34,32,2
1000000US060855109003006,060855109003006,"Block 3006, Block Group 3, Census Tract 5109, Santa Clara County, California",16,14,2
1000000US060855109003007,060855109003007,"Block 3007, Block Group 3, Census Tract 5109, Santa Clara County, California",16,16,0
1000000US060855109003008,060855109003008,"Block 3008, Block Group 3, Census Tract 5109, Santa Clara County, California",5,5,0
1000000US060855109003009,060855109003009,"Block 3009, Block Group 3, Census Tract 5109, Santa Clara County, California",20,20,0
1000000US060855109003010,060855109003010,"Block 3010, Block Group 3, Census Tract 5109, Santa Clara County, California",16,16,0
1000000US060855109003011,060855109003011,"Block 3011, Block Group 3, Census Tract 5109, Santa Clara County, California",24,24,0
1000000US060855109003012,060855109003012,"Block 3012, Block Group 3, Census Tract 5109, Santa Clara County, California",15,15,0
1000000US060855109003013,060855109003013,"Block 3013, Block Group 3, Census Tract 5109, Santa Clara County, California",24,24,0
1000000US060855109003014,060855109003014,"Block 3014, Block Group 3, Census Tract 5109, Santa Clara County, California",24,24,0
1000000US060855109003015,060855109003015,"Block 3015, Block Group 3, Census Tract 5109, Santa Clara County, California",46,45,1
1000000US060855109003016,060855109003016,"Block 3016, Block Group 3, Census Tract 5109, Santa Clara County, California",88,84,4
1000000US060855109003017,060855109003017,"Block 3017, Block Group 3, Census Tract 5109, Santa Clara County, California",0,0,0
1000000US060855109003018,060855109003018,"Block 3018, Block Group 3, Census Tract 5109, Santa Clara County, California",0,0,0
1000000US060855109003019,060855109003019,"Block 3019, Block Group 3, Census Tract 5109, Santa Clara County, California",14,14,0
1000000US060855109003020,060855109003020,"Block 3020, Block Group 3, Census Tract 5109, Santa Clara County, California",17,17,0
1000000US060855109003021,060855109003021,"Block 3021, Block Group 3, Census Tract 5109, Santa Clara County, California",15,15,0
1000000US060855109003022,060855109003022,"Block 3022, Block Group 3, Census Tract 5109, Santa Clara County, California",25,22,3
1000000US060855110001000,060855110001000,"Block 1000, Block Group 1, Census Tract 5110, Santa Clara County, California",0,0,0
1000000US060855110001001,060855110001001,"Block 1001, Block Group 1, Census Tract 5110, Santa Clara County, California",0,0,0
1000000US060855110001002,060855110001002,"Block 1002, Block Group 1, Census Tract 5110, Santa Clara County, California",0,0,0
1000000US060855110001003,060855110001003,"Block 1003, Block Group 1, Census Tract 5110, Santa Clara County, California",342,330,12
1000000US060855110001004,060855110001004,"Block 1004, Block Group 1, Census Tract 5110, Santa Clara County, California",92,88,4
1000000US060855110001005,060855110001005,"Block 1005, Block Group 1, Census Tract 5110, Santa Clara County, California",10,9,1
1000000US060855110001006,060855110001006,"Block 1006, Block Group 1, Census Tract 5110, Santa Clara County, California",26,26,0
1000000US060855110001007,060855110001007,"Block 1007, Block Group 1, Census Tract 5110, Santa Clara County, California",0,0,0
1000000US060855110001008,060855110001008,"Block 1008, Block Group 1, Census Tract 5110, Santa Clara County, California",9,9,0
1000000US060855110001009,060855110001009,"Block 1009, Block Group 1, Census Tract 5110, Santa Clara County, California",69,67,2
1000000US060855110001010,060855110001010,"Block 1010, Block Group 1, Census Tract 5110, Santa Clara County, California",19,17,2
1000000US060855110001011,060855110001011,"Block 1011, Block Group 1, Census Tract 5110, Santa Clara County, California",19,19,0
1000000US060855110001012,060855110001012,"Block 1012, Block Group 1, Census Tract 5110, Santa Clara County, California",48,47,1
1000000US060855110002000,060855110002000,"Block 2000, Block Group 2, Census Tract 5110, Santa Clara County, California",0,0,0
1000000US060855110002001,060855110002001,"Block 2001, Block Group 2, Census Tract 5110, Santa Clara County, California",12,11,1
1000000US060855110002002,060855110002002,"Block 2002, Block Group 2, Census Tract 5110, Santa Clara County, California",48,47,1
1000000US060855110002003,060855110002003,"Block 2003, Block Group 2, Census Tract 5110, Santa Clara County, California",25,25,0
1000000US060855110002004,060855110002004,"Block 2004, Block Group 2, Census Tract 5110, Santa Clara County, California",14,13,1
1000000US060855110002005,060855110002005,"Block 2005, Block Group 2, Census Tract 5110, Santa Clara County, California",37,37,0
1000000US060855110002006,060855110002006,"Block 2006, Block Group 2, Census Tract 5110, Santa Clara County, California",82,81,1
1000000US060855110002007,060855110002007,"Block 2007, Block Group 2, Census Tract 5110, Santa Clara County, California",16,16,0
1000000US060855110002008,060855110002008,"Block 2008, Block Group 2, Census Tract 5110, Santa Clara County, California",16,16,0
1000000US060855110002009,060855110002009,"Block 2009, Block Group 2, Census Tract 5110, Santa Clara County, California",45,43,2
1000000US060855110002010,060855110002010,"Block 2010, Block Group 2, Census Tract 5110, Santa Clara County, California",19,18,1
1000000US060855110002011,060855110002011,"Block 2011, Block Group 2, Census Tract 5110, Santa Clara County, California",0,0,0
1000000US060855110002012,060855110002012,"Block 2012, Block Group 2, Census Tract 5110, Santa Clara County, California",0,0,0
1000000US060855110002013,060855110002013,"Block 2013, Block Group 2, Census Tract 5110, Santa Clara County, California",144,138,6
1000000US060855110002014,060855110002014,"Block 2014, Block Group 2, Census Tract 5110, Santa Clara County, California",33,32,1
1000000US060855110003000,060855110003000,"Block 3000, Block Group 3, Census Tract 5110, Santa Clara County, California",69,66,3
1000000US060855110003001,060855110003001,"Block 3001, Block Group 3, Census Tract 5110, Santa Clara County, California",6,6,0
1000000US060855110003002,060855110003002,"Block 3002, Block Group 3, Census Tract 5110, Santa Clara County, California",5,5,0
1000000US060855110003003,060855110003003,"Block 3003, Block Group 3, Census Tract 5110, Santa Clara County, California",104,103,1
1000000US060855110003004,060855110003004,"Block 3004, Block Group 3, Census Tract 5110, Santa Clara County, California",12,12,0
1000000US060855110003005,060855110003005,"Block 3005, Block Group 3, Census Tract 5110, Santa Clara County, California",79,77,2
1000000US060855110004000,060855110004000,"Block 4000, Block Group 4, Census Tract 5110, Santa Clara County, California",0,0,0
1000000US060855110004001,060855110004001,"Block 4001, Block Group 4, Census Tract 5110, Santa Clara County, California",67,65,2
1000000US060855110004002,060855110004002,"Block 4002, Block Group 4, Census Tract 5110, Santa Clara County, California",14,10,4
1000000US060855110004003,060855110004003,"Block 4003, Block Group 4, Census Tract 5110, Santa Clara County, California",0,0,0
1000000US060855110004004,060855110004004,"Block 4004, Block Group 4, Census Tract 5110, Santa Clara County, California",14,10,4
1000000US060855110004005,060855110004005,"Block 4005, Block Group 4, Census Tract 5110, Santa Clara County, California",0,0,0
1000000US060855110004006,060855110004006,"Block 4006, Block Group 4, Census Tract 5110, Santa Clara County, California",0,0,0
1000000US060855110004007,060855110004007,"Block 4007, Block Group 4, Census Tract 5110, Santa Clara County, California",0,0,0
1000000US060855110004008,060855110004008,"Block 4008, Block Group 4, Census Tract 5110, Santa Clara County, California",0,0,0
1000000US060855110004009,060855110004009,"Block 4009, Block Group 4, Census Tract 5110, Santa Clara County, California",7,7,0
1000000US060855110004010,060855110004010,"Block 4010, Block Group 4, Census Tract 5110, Santa Clara County, California",31,30,1
1000000US060855110004011,060855110004011,"Block 4011, Block Group 4, Census Tract 5110, Santa Clara County, California",78,77,1
1000000US060855110004012,060855110004012,"Block 4012, Block Group 4, Census Tract 5110, Santa Clara County, California",29,29,0
1000000US060855110004013,060855110004013,"Block 4013, Block Group 4, Census Tract 5110, Santa Clara County, California",11,11,0
1000000US060855110004014,060855110004014,"Block 4014, Block Group 4, Census Tract 5110, Santa Clara County, California",29,28,1
1000000US060855110004015,060855110004015,"Block 4015, Block Group 4, Census Tract 5110, Santa Clara County, California",66,62,4
1000000US060855110004016,060855110004016,"Block 4016, Block Group 4, Census Tract 5110, Santa Clara County, California",31,31,0
1000000US060855110004017,060855110004017,"Block 4017, Block Group 4, Census Tract 5110, Santa Clara County, California",48,45,3
1000000US060855110005000,060855110005000,"Block 5000, Block Group 5, Census Tract 5110, Santa Clara County, California",64,61,3
1000000US060855110005001,060855110005001,"Block 5001, Block Group 5, Census Tract 5110, Santa Clara County, California",17,17,0
1000000US060855110005002,060855110005002,"Block 5002, Block Group 5, Census Tract 5110, Santa Clara County, California",13,12,1
1000000US060855110005003,060855110005003,"Block 5003, Block Group 5, Census Tract 5110, Santa Clara County, California",26,25,1
1000000US060855110005004,060855110005004,"Block 5004, Block Group 5, Census Tract 5110, Santa Clara County, California",0,0,0
1000000US060855110005005,060855110005005,"Block 5005, Block Group 5, Census Tract 5110, Santa Clara County, California",63,56,7
1000000US060855110005006,060855110005006,"Block 5006, Block Group 5, Census Tract 5110, Santa Clara County, California",12,11,1
1000000US060855110005007,060855110005007,"Block 5007, Block Group 5, Census Tract 5110, Santa Clara County, California",68,68,0
1000000US060855110005008,060855110005008,"Block 5008, Block Group 5, Census Tract 5110, Santa Clara County, California",0,0,0
1000000US060855110005009,060855110005009,"Block 5009, Block Group 5, Census Tract 5110, Santa Clara County, California",18,18,0
1000000US060855110005010,060855110005010,"Block 5010, Block Group 5, Census Tract 5110, Santa Clara County, California",73,72,1
1000000US060855110005011,060855110005011,"Block 5011, Block Group 5, Census Tract 5110, Santa Clara County, California",25,23,2
1000000US060855110005012,060855110005012,"Block 5012, Block Group 5, Census Tract 5110, Santa Clara County, California",285,271,14
1000000US060855111001000,060855111001000,"Block 1000, Block Group 1, Census Tract 5111, Santa Clara County, California",0,0,0
1000000US060855111001001,060855111001001,"Block 1001, Block Group 1, Census Tract 5111, Santa Clara County, California",57,54,3
1000000US060855111001002,060855111001002,"Block 1002, Block Group 1, Census Tract 5111, Santa Clara County, California",17,16,1
1000000US060855111001003,060855111001003,"Block 1003, Block Group 1, Census Tract 5111, Santa Clara County, California",34,29,5
1000000US060855111001004,060855111001004,"Block 1004, Block Group 1, Census Tract 5111, Santa Clara County, California",29,28,1
1000000US060855111001005,060855111001005,"Block 1005, Block Group 1, Census Tract 5111, Santa Clara County, California",54,54,0
1000000US060855111001006,060855111001006,"Block 1006, Block Group 1, Census Tract 5111, Santa Clara County, California",25,25,0
1000000US060855111001007,060855111001007,"Block 1007, Block Group 1, Census Tract 5111, Santa Clara County, California",0,0,0
1000000US060855111001008,060855111001008,"Block 1008, Block Group 1, Census Tract 5111, Santa Clara County, California",0,0,0
1000000US060855111001009,060855111001009,"Block 1009, Block Group 1, Census Tract 5111, Santa Clara County, California",19,19,0
1000000US060855111001010,060855111001010,"Block 1010, Block Group 1, Census Tract 5111, Santa Clara County, California",68,66,2
1000000US060855111001011,060855111001011,"Block 1011, Block Group 1, Census Tract 5111, Santa Clara County, California",35,34,1
1000000US060855111001012,060855111001012,"Block 1012, Block Group 1, Census Tract 5111, Santa Clara County, California",13,13,0
1000000US060855111001013,060855111001013,"Block 1013, Block Group 1, Census Tract 5111, Santa Clara County, California",15,15,0
1000000US060855111001014,060855111001014,"Block 1014, Block Group 1, Census Tract 5111, Santa Clara County, California",88,86,2
1000000US060855111001015,060855111001015,"Block 1015, Block Group 1, Census Tract 5111, Santa Clara County, California",12,12,0
1000000US060855111001016,060855111001016,"Block 1016, Block Group 1, Census Tract 5111, Santa Clara County, California",16,16,0
1000000US060855111001017,060855111001017,"Block 1017, Block Group 1, Census Tract 5111, Santa Clara County, California",18,16,2
1000000US060855111001018,060855111001018,"Block 1018, Block Group 1, Census Tract 5111, Santa Clara County, California",25,23,2
1000000US060855111001019,060855111001019,"Block 1019, Block Group 1, Census Tract 5111, Santa Clara County, California",25,24,1
1000000US060855111002000,060855111002000,"Block 2000, Block Group 2, Census Tract 5111, Santa Clara County, California",1,1,0
1000000US060855111002001,060855111002001,"Block 2001, Block Group 2, Census Tract 5111, Santa Clara County, California",14,14,0
1000000US060855111002002,060855111002002,"Block 2002, Block Group 2, Census Tract 5111, Santa Clara County, California",50,48,2
1000000US060855111002003,060855111002003,"Block 2003, Block Group 2, Census Tract 5111, Santa Clara County, California",13,12,1
1000000US060855111002004,060855111002004,"Block 2004, Block Group 2, Census Tract 5111, Santa Clara County, California",82,80,2
1000000US060855111002005,060855111002005,"Block 2005, Block Group 2, Census Tract 5111, Santa Clara County, California",93,92,1
1000000US060855111002006,060855111002006,"Block 2006, Block Group 2, Census Tract 5111, Santa Clara County, California",58,57,1
1000000US060855111002007,060855111002007,"Block 2007, Block Group 2, Census Tract 5111, Santa Clara County, California",43,41,2
1000000US060855111002008,060855111002008,"Block 2008, Block Group 2, Census Tract 5111, Santa Clara County, California",19,19,0
1000000US060855111002009,060855111002009,"Block 2009, Block Group 2, Census Tract 5111, Santa Clara County, California",0,0,0
1000000US060855111002010,060855111002010,"Block 2010, Block Group 2, Census Tract 5111, Santa Clara County, California",40,39,1
1000000US060855111002011,060855111002011,"Block 2011, Block Group 2, Census Tract 5111, Santa Clara County, California",14,13,1
1000000US060855111002012,060855111002012,"Block 2012, Block Group 2, Census Tract 5111, Santa Clara County, California",15,15,0
1000000US060855111002013,060855111002013,"Block 2013, Block Group 2, Census Tract 5111, Santa Clara County, California",0,0,0
1000000US060855111002014,060855111002014,"Block 2014, Block Group 2, Census Tract 5111, Santa Clara County, California",61,58,3
1000000US060855111002015,060855111002015,"Block 2015, Block Group 2, Census Tract 5111, Santa Clara County, California",13,13,0
1000000US060855111003000,060855111003000,"Block 3000, Block Group 3, Census Tract 5111, Santa Clara County, California",41,38,3
1000000US060855111003001,060855111003001,"Block 3001, Block Group 3, Census Tract 5111, Santa Clara County, California",0,0,0
1000000US060855111003002,060855111003002,"Block 3002, Block Group 3, Census Tract 5111, Santa Clara County, California",0,0,0
1000000US060855111003003,060855111003003,"Block 3003, Block Group 3, Census Tract 5111, Santa Clara County, California",0,0,0
1000000US060855111003004,060855111003004,"Block 3004, Block Group 3, Census Tract 5111, Santa Clara County, California",0,0,0
1000000US060855111003005,060855111003005,"Block 3005, Block Group 3, Census Tract 5111, Santa Clara County, California",0,0,0
1000000US060855111003006,060855111003006,"Block 3006, Block Group 3, Census Tract 5111, Santa Clara County, California",40,38,2
1000000US060855111003007,060855111003007,"Block 3007, Block Group 3, Census Tract 5111, Santa Clara County, California",89,89,0
1000000US060855111003008,060855111003008,"Block 3008, Block Group 3, Census Tract 5111, Santa Clara County, California",0,0,0
1000000US060855111003009,060855111003009,"Block 3009, Block Group 3, Census Tract 5111, Santa Clara County, California",39,37,2
1000000US060855111003010,060855111003010,"Block 3010, Block Group 3, Census Tract 5111, Santa Clara County, California",88,84,4
1000000US060855111003011,060855111003011,"Block 3011, Block Group 3, Census Tract 5111, Santa Clara County, California",13,13,0
1000000US060855111003012,060855111003012,"Block 3012, Block Group 3, Census Tract 5111, Santa Clara County, California",70,69,1
1000000US060855111003013,060855111003013,"Block 3013, Block Group 3, Census Tract 5111, Santa Clara County, California",0,0,0
1000000US060855111003014,060855111003014,"Block 3014, Block Group 3, Census Tract 5111, Santa Clara County, California",43,43,0
1000000US060855111003015,060855111003015,"Block 3015, Block Group 3, Census Tract 5111, Santa Clara County, California",40,40,0
1000000US060855111004000,060855111004000,"Block 4000, Block Group 4, Census Tract 5111, Santa Clara County, California",0,0,0
1000000US060855111004001,060855111004001,"Block 4001, Block Group 4, Census Tract 5111, Santa Clara County, California",10,9,1
1000000US060855111004002,060855111004002,"Block 4002, Block Group 4, Census Tract 5111, Santa Clara County, California",62,60,2
1000000US060855111004003,060855111004003,"Block 4003, Block Group 4, Census Tract 5111, Santa Clara County, California",10,10,0
1000000US060855111004004,060855111004004,"Block 4004, Block Group 4, Census Tract 5111, Santa Clara County, California",5,4,1
1000000US060855111004005,060855111004005,"Block 4005, Block Group 4, Census Tract 5111, Santa Clara County, California",0,0,0
1000000US060855111004006,060855111004006,"Block 4006, Block Group 4, Census Tract 5111, Santa Clara County, California",19,19,0
1000000US060855111004007,060855111004007,"Block 4007, Block Group 4, Census Tract 5111, Santa Clara County, California",33,30,3
1000000US060855111004008,060855111004008,"Block 4008, Block Group 4, Census Tract 5111, Santa Clara County, California",57,56,1
1000000US060855111004009,060855111004009,"Block 4009, Block Group 4, Census Tract 5111, Santa Clara County, California",35,35,0
1000000US060855111004010,060855111004010,"Block 4010, Block Group 4, Census Tract 5111, Santa Clara County, California",15,14,1
1000000US060855111004011,060855111004011,"Block 4011, Block Group 4, Census Tract 5111, Santa Clara County, California",0,0,0
1000000US060855111004012,060855111004012,"Block 4012, Block Group 4, Census Tract 5111, Santa Clara County, California",0,0,0
1000000US060855111004013,060855111004013,"Block 4013, Block Group 4, Census Tract 5111, Santa Clara County, California",19,19,0
1000000US060855111004014,060855111004014,"Block 4014, Block Group 4, Census Tract 5111, Santa Clara County, California",25,23,2
1000000US060855111004015,060855111004015,"Block 4015, Block Group 4, Census Tract 5111, Santa Clara County, California",30,25,5
1000000US060855111004016,060855111004016,"Block 4016, Block Group 4, Census Tract 5111, Santa Clara County, California",26,26,0
1000000US060855111004017,060855111004017,"Block 4017, Block Group 4, Census Tract 5111, Santa Clara County, California",0,0,0
1000000US060855111004018,060855111004018,"Block 4018, Block Group 4, Census Tract 5111, Santa Clara County, California",0,0,0
1000000US060855111004019,060855111004019,"Block 4019, Block Group 4, Census Tract 5111, Santa Clara County, California",0,0,0
1000000US060855111004020,060855111004020,"Block 4020, Block Group 4, Census Tract 5111, Santa Clara County, California",21,21,0
1000000US060855111004021,060855111004021,"Block 4021, Block Group 4, Census Tract 5111, Santa Clara County, California",13,13,0
1000000US060855111004022,060855111004022,"Block 4022, Block Group 4, Census Tract 5111, Santa Clara County, California",12,12,0
1000000US060855111004023,060855111004023,"Block 4023, Block Group 4, Census Tract 5111, Santa Clara County, California",0,0,0
1000000US060855111004024,060855111004024,"Block 4024, Block Group 4, Census Tract 5111, Santa Clara County, California",10,10,0
1000000US060855111004025,060855111004025,"Block 4025, Block Group 4, Census Tract 5111, Santa Clara County, California",31,27,4
1000000US060855112001000,060855112001000,"Block 1000, Block Group 1, Census Tract 5112, Santa Clara County, California",27,25,2
1000000US060855112001001,060855112001001,"Block 1001, Block Group 1, Census Tract 5112, Santa Clara County, California",19,19,0
1000000US060855112001002,060855112001002,"Block 1002, Block Group 1, Census Tract 5112, Santa Clara County, California",13,12,1
1000000US060855112001003,060855112001003,"Block 1003, Block Group 1, Census Tract 5112, Santa Clara County, California",8,7,1
1000000US060855112001004,060855112001004,"Block 1004, Block Group 1, Census Tract 5112, Santa Clara County, California",9,9,0
1000000US060855112001005,060855112001005,"Block 1005, Block Group 1, Census Tract 5112, Santa Clara County, California",10,9,1
1000000US060855112001006,060855112001006,"Block 1006, Block Group 1, Census Tract 5112, Santa Clara County, California",19,17,2
1000000US060855112001007,060855112001007,"Block 1007, Block Group 1, Census Tract 5112, Santa Clara County, California",0,0,0
1000000US060855112001008,060855112001008,"Block 1008, Block Group 1, Census Tract 5112, Santa Clara County, California",15,15,0
1000000US060855112001009,060855112001009,"Block 1009, Block Group 1, Census Tract 5112, Santa Clara County, California",12,12,0
1000000US060855112001010,060855112001010,"Block 1010, Block Group 1, Census Tract 5112, Santa Clara County, California",19,18,1
1000000US060855112001011,060855112001011,"Block 1011, Block Group 1, Census Tract 5112, Santa Clara County, California",33,28,5
1000000US060855112001012,060855112001012,"Block 1012, Block Group 1, Census Tract 5112, Santa Clara County, California",20,18,2
1000000US060855112001013,060855112001013,"Block 1013, Block Group 1, Census Tract 5112, Santa Clara County, California",22,22,0
1000000US060855112001014,060855112001014,"Block 1014, Block Group 1, Census Tract 5112, Santa Clara County, California",20,20,0
1000000US060855112001015,060855112001015,"Block 1015, Block Group 1, Census Tract 5112, Santa Clara County, California",18,17,1
1000000US060855112001016,060855112001016,"Block 1016, Block Group 1, Census Tract 5112, Santa Clara County, California",27,26,1
1000000US060855112001017,060855112001017,"Block 1017, Block Group 1, Census Tract 5112, Santa Clara County, California",0,0,0
1000000US060855112001018,060855112001018,"Block 1018, Block Group 1, Census Tract 5112, Santa Clara County, California",14,12,2
1000000US060855112001019,060855112001019,"Block 1019, Block Group 1, Census Tract 5112, Santa Clara County, California",57,52,5
1000000US060855112001020,060855112001020,"Block 1020, Block Group 1, Census Tract 5112, Santa Clara County, California",19,18,1
1000000US060855112001021,060855112001021,"Block 1021, Block Group 1, Census Tract 5112, Santa Clara County, California",12,10,2
1000000US060855112001022,060855112001022,"Block 1022, Block Group 1, Census Tract 5112, Santa Clara County, California",45,42,3
1000000US060855112001023,060855112001023,"Block 1023, Block Group 1, Census Tract 5112, Santa Clara County, California",28,27,1
1000000US060855112001024,060855112001024,"Block 1024, Block Group 1, Census Tract 5112, Santa Clara County, California",15,15,0
1000000US060855112001025,060855112001025,"Block 1025, Block Group 1, Census Tract 5112, Santa Clara County, California",14,14,0
1000000US060855112001026,060855112001026,"Block 1026, Block Group 1, Census Tract 5112, Santa Clara County, California",22,21,1
1000000US060855112001027,060855112001027,"Block 1027, Block Group 1, Census Tract 5112, Santa Clara County, California",29,26,3
1000000US060855112001028,060855112001028,"Block 1028, Block Group 1, Census Tract 5112, Santa Clara County, California",15,14,1
1000000US060855112001029,060855112001029,"Block 1029, Block Group 1, Census Tract 5112, Santa Clara County, California",14,13,1
1000000US060855112001030,060855112001030,"Block 1030, Block Group 1, Census Tract 5112, Santa Clara County, California",15,12,3
1000000US060855112001031,060855112001031,"Block 1031, Block Group 1, Census Tract 5112, Santa Clara County, California",5,5,0
1000000US060855112002000,060855112002000,"Block 2000, Block Group 2, Census Tract 5112, Santa Clara County, California",49,49,0
1000000US060855112002001,060855112002001,"Block 2001, Block Group 2, Census Tract 5112, Santa Clara County, California",28,26,2
1000000US060855112002002,060855112002002,"Block 2002, Block Group 2, Census Tract 5112, Santa Clara County, California",70,67,3
1000000US060855112002003,060855112002003,"Block 2003, Block Group 2, Census Tract 5112, Santa Clara County, California",18,16,2
1000000US060855112002004,060855112002004,"Block 2004, Block Group 2, Census Tract 5112, Santa Clara County, California",47,45,2
1000000US060855112002005,060855112002005,"Block 2005, Block Group 2, Census Tract 5112, Santa Clara County, California",0,0,0
1000000US060855112002006,060855112002006,"Block 2006, Block Group 2, Census Tract 5112, Santa Clara County, California",27,25,2
1000000US060855112002007,060855112002007,"Block 2007, Block Group 2, Census Tract 5112, Santa Clara County, California",27,27,0
1000000US060855112002008,060855112002008,"Block 2008, Block Group 2, Census Tract 5112, Santa Clara County, California",34,33,1
1000000US060855112002009,060855112002009,"Block 2009, Block Group 2, Census Tract 5112, Santa Clara County, California",6,6,0
1000000US060855112002010,060855112002010,"Block 2010, Block Group 2, Census Tract 5112, Santa Clara County, California",14,13,1
1000000US060855112002011,060855112002011,"Block 2011, Block Group 2, Census Tract 5112, Santa Clara County, California",11,11,0
1000000US060855112002012,060855112002012,"Block 2012, Block Group 2, Census Tract 5112, Santa Clara County, California",12,12,0
1000000US060855112002013,060855112002013,"Block 2013, Block Group 2, Census Tract 5112, Santa Clara County, California",12,12,0
1000000US060855112002014,060855112002014,"Block 2014, Block Group 2, Census Tract 5112, Santa Clara County, California",31,31,0
1000000US060855112002015,060855112002015,"Block 2015, Block Group 2, Census Tract 5112, Santa Clara County, California",23,21,2
1000000US060855112002016,060855112002016,"Block 2016, Block Group 2, Census Tract 5112, Santa Clara County, California",16,16,0
1000000US060855112002017,060855112002017,"Block 2017, Block Group 2, Census Tract 5112, Santa Clara County, California",28,28,0
1000000US060855112002018,060855112002018,"Block 2018, Block Group 2, Census Tract 5112, Santa Clara County, California",15,15,0
1000000US060855112002019,060855112002019,"Block 2019, Block Group 2, Census Tract 5112, Santa Clara County, California",27,25,2
1000000US060855112002020,060855112002020,"Block 2020, Block Group 2, Census Tract 5112, Santa Clara County, California",17,17,0
1000000US060855112002021,060855112002021,"Block 2021, Block Group 2, Census Tract 5112, Santa Clara County, California",46,44,2
1000000US060855112003000,060855112003000,"Block 3000, Block Group 3, Census Tract 5112, Santa Clara County, California",68,68,0
1000000US060855112003001,060855112003001,"Block 3001, Block Group 3, Census Tract 5112, Santa Clara County, California",56,55,1
1000000US060855112003002,060855112003002,"Block 3002, Block Group 3, Census Tract 5112, Santa Clara County, California",68,64,4
1000000US060855112003003,060855112003003,"Block 3003, Block Group 3, Census Tract 5112, Santa Clara County, California",10,10,0
1000000US060855112003004,060855112003004,"Block 3004, Block Group 3, Census Tract 5112, Santa Clara County, California",40,39,1
1000000US060855112003005,060855112003005,"Block 3005, Block Group 3, Census Tract 5112, Santa Clara County, California",27,24,3
1000000US060855112003006,060855112003006,"Block 3006, Block Group 3, Census Tract 5112, Santa Clara County, California",7,7,0
1000000US060855112003007,060855112003007,"Block 3007, Block Group 3, Census Tract 5112, Santa Clara County, California",27,26,1
1000000US060855112003008,060855112003008,"Block 3008, Block Group 3, Census Tract 5112, Santa Clara County, California",15,14,1
1000000US060855112003009,060855112003009,"Block 3009, Block Group 3, Census Tract 5112, Santa Clara County, California",25,24,1
1000000US060855112004000,060855112004000,"Block 4000, Block Group 4, Census Tract 5112, Santa Clara County, California",30,29,1
1000000US060855112004001,060855112004001,"Block 4001, Block Group 4, Census Tract 5112, Santa Clara County, California",27,27,0
1000000US060855112004002,060855112004002,"Block 4002, Block Group 4, Census Tract 5112, Santa Clara County, California",15,15,0
1000000US060855112004003,060855112004003,"Block 4003, Block Group 4, Census Tract 5112, Santa Clara County, California",26,25,1
1000000US060855112004004,060855112004004,"Block 4004, Block Group 4, Census Tract 5112, Santa Clara County, California",0,0,0
1000000US060855112004005,060855112004005,"Block 4005, Block Group 4, Census Tract 5112, Santa Clara County, California",15,15,0
1000000US060855112004006,060855112004006,"Block 4006, Block Group 4, Census Tract 5112, Santa Clara County, California",15,13,2
1000000US060855112004007,060855112004007,"Block 4007, Block Group 4, Census Tract 5112, Santa Clara County, California",35,34,1
1000000US060855112004008,060855112004008,"Block 4008, Block Group 4, Census Tract 5112, Santa Clara County, California",14,11,3
1000000US060855112004009,060855112004009,"Block 4009, Block Group 4, Census Tract 5112, Santa Clara County, California",30,29,1
1000000US060855112004010,060855112004010,"Block 4010, Block Group 4, Census Tract 5112, Santa Clara County, California",16,16,0
1000000US060855112004011,060855112004011,"Block 4011, Block Group 4, Census Tract 5112, Santa Clara County, California",8,6,2
1000000US060855112004012,060855112004012,"Block 4012, Block Group 4, Census Tract 5112, Santa Clara County, California",16,16,0
1000000US060855112004013,060855112004013,"Block 4013, Block Group 4, Census Tract 5112, Santa Clara County, California",17,15,2
1000000US060855112004014,060855112004014,"Block 4014, Block Group 4, Census Tract 5112, Santa Clara County, California",9,8,1
1000000US060855112004015,060855112004015,"Block 4015, Block Group 4, Census Tract 5112, Santa Clara County, California",12,11,1
1000000US060855112004016,060855112004016,"Block 4016, Block Group 4, Census Tract 5112, Santa Clara County, California",11,10,1
1000000US060855112004017,060855112004017,"Block 4017, Block Group 4, Census Tract 5112, Santa Clara County, California",8,8,0
1000000US060855112004018,060855112004018,"Block 4018, Block Group 4, Census Tract 5112, Santa Clara County, California",4,4,0
1000000US060855112004019,060855112004019,"Block 4019, Block Group 4, Census Tract 5112, Santa Clara County, California",8,8,0
1000000US060855112004020,060855112004020,"Block 4020, Block Group 4, Census Tract 5112, Santa Clara County, California",2,2,0
1000000US060855112004021,060855112004021,"Block 4021, Block Group 4, Census Tract 5112, Santa Clara County, California",7,7,0
1000000US060855112004022,060855112004022,"Block 4022, Block Group 4, Census Tract 5112, Santa Clara County, California",19,19,0
1000000US060855112004023,060855112004023,"Block 4023, Block Group 4, Census Tract 5112, Santa Clara County, California",13,11,2
1000000US060855112004024,060855112004024,"Block 4024, Block Group 4, Census Tract 5112, Santa Clara County, California",0,0,0
1000000US060855112004025,060855112004025,"Block 4025, Block Group 4, Census Tract 5112, Santa Clara County, California",7,7,0
1000000US060855112004026,060855112004026,"Block 4026, Block Group 4, Census Tract 5112, Santa Clara County, California",6,6,0
1000000US060855113011000,060855113011000,"Block 1000, Block Group 1, Census Tract 5113.01, Santa Clara County, California",62,52,10
1000000US060855113011001,060855113011001,"Block 1001, Block Group 1, Census Tract 5113.01, Santa Clara County, California",63,61,2
1000000US060855113011002,060855113011002,"Block 1002, Block Group 1, Census Tract 5113.01, Santa Clara County, California",67,66,1
1000000US060855113011003,060855113011003,"Block 1003, Block Group 1, Census Tract 5113.01, Santa Clara County, California",79,77,2
1000000US060855113011004,060855113011004,"Block 1004, Block Group 1, Census Tract 5113.01, Santa Clara County, California",2,1,1
1000000US060855113011005,060855113011005,"Block 1005, Block Group 1, Census Tract 5113.01, Santa Clara County, California",231,197,34
1000000US060855113011006,060855113011006,"Block 1006, Block Group 1, Census Tract 5113.01, Santa Clara County, California",91,90,1
1000000US060855113011007,060855113011007,"Block 1007, Block Group 1, Census Tract 5113.01, Santa Clara County, California",55,52,3
1000000US060855113011008,060855113011008,"Block 1008, Block Group 1, Census Tract 5113.01, Santa Clara County, California",112,102,10
1000000US060855113011009,060855113011009,"Block 1009, Block Group 1, Census Tract 5113.01, Santa Clara County, California",22,22,0
1000000US060855113011010,060855113011010,"Block 1010, Block Group 1, Census Tract 5113.01, Santa Clara County, California",0,0,0
1000000US060855113011011,060855113011011,"Block 1011, Block Group 1, Census Tract 5113.01, Santa Clara County, California",32,29,3
1000000US060855113011012,060855113011012,"Block 1012, Block Group 1, Census Tract 5113.01, Santa Clara County, California",8,7,1
1000000US060855113011013,060855113011013,"Block 1013, Block Group 1, Census Tract 5113.01, Santa Clara County, California",53,53,0
1000000US060855113011014,060855113011014,"Block 1014, Block Group 1, Census Tract 5113.01, Santa Clara County, California",56,40,16
1000000US060855113011015,060855113011015,"Block 1015, Block Group 1, Census Tract 5113.01, Santa Clara County, California",30,28,2
1000000US060855113011016,060855113011016,"Block 1016, Block Group 1, Census Tract 5113.01, Santa Clara County, California",41,40,1
1000000US060855113011017,060855113011017,"Block 1017, Block Group 1, Census Tract 5113.01, Santa Clara County, California",54,52,2
1000000US060855113011018,060855113011018,"Block 1018, Block Group 1, Census Tract 5113.01, Santa Clara County, California",25,23,2
1000000US060855113011019,060855113011019,"Block 1019, Block Group 1, Census Tract 5113.01, Santa Clara County, California",35,32,3
1000000US060855113011020,060855113011020,"Block 1020, Block Group 1, Census Tract 5113.01, Santa Clara County, California",61,59,2
1000000US060855113011021,060855113011021,"Block 1021, Block Group 1, Census Tract 5113.01, Santa Clara County, California",19,15,4
1000000US060855113011022,060855113011022,"Block 1022, Block Group 1, Census Tract 5113.01, Santa Clara County, California",6,5,1
1000000US060855113011023,060855113011023,"Block 1023, Block Group 1, Census Tract 5113.01, Santa Clara County, California",0,0,0
1000000US060855113011024,060855113011024,"Block 1024, Block Group 1, Census Tract 5113.01, Santa Clara County, California",0,0,0
1000000US060855113011025,060855113011025,"Block 1025, Block Group 1, Census Tract 5113.01, Santa Clara County, California",0,0,0
1000000US060855113011026,060855113011026,"Block 1026, Block Group 1, Census Tract 5113.01, Santa Clara County, California",0,0,0
1000000US060855113011027,060855113011027,"Block 1027, Block Group 1, Census Tract 5113.01, Santa Clara County, California",0,0,0
1000000US060855113011028,060855113011028,"Block 1028, Block Group 1, Census Tract 5113.01, Santa Clara County, California",0,0,0
1000000US060855113011029,060855113011029,"Block 1029, Block Group 1, Census Tract 5113.01, Santa Clara County, California",105,105,0
1000000US060855113011030,060855113011030,"Block 1030, Block Group 1, Census Tract 5113.01, Santa Clara County, California",0,0,0
1000000US060855113011031,060855113011031,"Block 1031, Block Group 1, Census Tract 5113.01, Santa Clara County, California",4,4,0
1000000US060855113011032,060855113011032,"Block 1032, Block Group 1, Census Tract 5113.01, Santa Clara County, California",0,0,0
1000000US060855113011033,060855113011033,"Block 1033, Block Group 1, Census Tract 5113.01, Santa Clara County, California",0,0,0
1000000US060855113011034,060855113011034,"Block 1034, Block Group 1, Census Tract 5113.01, Santa Clara County, California",60,56,4
1000000US060855113012000,060855113012000,"Block 2000, Block Group 2, Census Tract 5113.01, Santa Clara County, California",0,0,0
1000000US060855113012001,060855113012001,"Block 2001, Block Group 2, Census Tract 5113.01, Santa Clara County, California",18,16,2
1000000US060855113012002,060855113012002,"Block 2002, Block Group 2, Census Tract 5113.01, Santa Clara County, California",15,13,2
1000000US060855113012003,060855113012003,"Block 2003, Block Group 2, Census Tract 5113.01, Santa Clara County, California",20,18,2
1000000US060855113012004,060855113012004,"Block 2004, Block Group 2, Census Tract 5113.01, Santa Clara County, California",19,14,5
1000000US060855113012005,060855113012005,"Block 2005, Block Group 2, Census Tract 5113.01, Santa Clara County, California",15,14,1
1000000US060855113012006,060855113012006,"Block 2006, Block Group 2, Census Tract 5113.01, Santa Clara County, California",16,16,0
1000000US060855113012007,060855113012007,"Block 2007, Block Group 2, Census Tract 5113.01, Santa Clara County, California",28,27,1
1000000US060855113012008,060855113012008,"Block 2008, Block Group 2, Census Tract 5113.01, Santa Clara County, California",16,15,1
1000000US060855113012009,060855113012009,"Block 2009, Block Group 2, Census Tract 5113.01, Santa Clara County, California",10,10,0
1000000US060855113012010,060855113012010,"Block 2010, Block Group 2, Census Tract 5113.01, Santa Clara County, California",14,12,2
1000000US060855113012011,060855113012011,"Block 2011, Block Group 2, Census Tract 5113.01, Santa Clara County, California",12,12,0
1000000US060855113012012,060855113012012,"Block 2012, Block Group 2, Census Tract 5113.01, Santa Clara County, California",25,22,3
1000000US060855113012013,060855113012013,"Block 2013, Block Group 2, Census Tract 5113.01, Santa Clara County, California",39,36,3
1000000US060855113012014,060855113012014,"Block 2014, Block Group 2, Census Tract 5113.01, Santa Clara County, California",23,18,5
1000000US060855113012015,060855113012015,"Block 2015, Block Group 2, Census Tract 5113.01, Santa Clara County, California",9,9,0
1000000US060855113012016,060855113012016,"Block 2016, Block Group 2, Census Tract 5113.01, Santa Clara County, California",14,11,3
1000000US060855113012017,060855113012017,"Block 2017, Block Group 2, Census Tract 5113.01, Santa Clara County, California",20,18,2
1000000US060855113012018,060855113012018,"Block 2018, Block Group 2, Census Tract 5113.01, Santa Clara County, California",15,12,3
1000000US060855113012019,060855113012019,"Block 2019, Block Group 2, Census Tract 5113.01, Santa Clara County, California",10,9,1
1000000US060855113012020,060855113012020,"Block 2020, Block Group 2, Census Tract 5113.01, Santa Clara County, California",32,26,6
1000000US060855113012021,060855113012021,"Block 2021, Block Group 2, Census Tract 5113.01, Santa Clara County, California",30,29,1
1000000US060855113012022,060855113012022,"Block 2022, Block Group 2, Census Tract 5113.01, Santa Clara County, California",10,10,0
1000000US060855113012023,060855113012023,"Block 2023, Block Group 2, Census Tract 5113.01, Santa Clara County, California",7,6,1
1000000US060855113012024,060855113012024,"Block 2024, Block Group 2, Census Tract 5113.01, Santa Clara County, California",6,6,0
1000000US060855113012025,060855113012025,"Block 2025, Block Group 2, Census Tract 5113.01, Santa Clara County, California",7,6,1
1000000US060855113012026,060855113012026,"Block 2026, Block Group 2, Census Tract 5113.01, Santa Clara County, California",10,9,1
1000000US060855113012027,060855113012027,"Block 2027, Block Group 2, Census Tract 5113.01, Santa Clara County, California",8,8,0
1000000US060855113012028,060855113012028,"Block 2028, Block Group 2, Census Tract 5113.01, Santa Clara County, California",9,8,1
1000000US060855113012029,060855113012029,"Block 2029, Block Group 2, Census Tract 5113.01, Santa Clara County, California",10,9,1
1000000US060855113012030,060855113012030,"Block 2030, Block Group 2, Census Tract 5113.01, Santa Clara County, California",9,8,1
1000000US060855113012031,060855113012031,"Block 2031, Block Group 2, Census Tract 5113.01, Santa Clara County, California",7,6,1
1000000US060855113012032,060855113012032,"Block 2032, Block Group 2, Census Tract 5113.01, Santa Clara County, California",8,6,2
1000000US060855113012033,060855113012033,"Block 2033, Block Group 2, Census Tract 5113.01, Santa Clara County, California",14,12,2
1000000US060855113012034,060855113012034,"Block 2034, Block Group 2, Census Tract 5113.01, Santa Clara County, California",13,12,1
1000000US060855113012035,060855113012035,"Block 2035, Block Group 2, Census Tract 5113.01, Santa Clara County, California",10,10,0
1000000US060855113012036,060855113012036,"Block 2036, Block Group 2, Census Tract 5113.01, Santa Clara County, California",10,10,0
1000000US060855113012037,060855113012037,"Block 2037, Block Group 2, Census Tract 5113.01, Santa Clara County, California",11,10,1
1000000US060855113012038,060855113012038,"Block 2038, Block Group 2, Census Tract 5113.01, Santa Clara County, California",3,3,0
1000000US060855113012039,060855113012039,"Block 2039, Block Group 2, Census Tract 5113.01, Santa Clara County, California",0,0,0
1000000US060855113012040,060855113012040,"Block 2040, Block Group 2, Census Tract 5113.01, Santa Clara County, California",0,0,0
1000000US060855113021000,060855113021000,"Block 1000, Block Group 1, Census Tract 5113.02, Santa Clara County, California",17,16,1
1000000US060855113021001,060855113021001,"Block 1001, Block Group 1, Census Tract 5113.02, Santa Clara County, California",355,341,14
1000000US060855113021002,060855113021002,"Block 1002, Block Group 1, Census Tract 5113.02, Santa Clara County, California",30,27,3
1000000US060855113021003,060855113021003,"Block 1003, Block Group 1, Census Tract 5113.02, Santa Clara County, California",28,28,0
1000000US060855113021004,060855113021004,"Block 1004, Block Group 1, Census Tract 5113.02, Santa Clara County, California",32,30,2
1000000US060855113021005,060855113021005,"Block 1005, Block Group 1, Census Tract 5113.02, Santa Clara County, California",46,44,2
1000000US060855113021006,060855113021006,"Block 1006, Block Group 1, Census Tract 5113.02, Santa Clara County, California",51,46,5
1000000US060855113021007,060855113021007,"Block 1007, Block Group 1, Census Tract 5113.02, Santa Clara County, California",30,29,1
1000000US060855113021008,060855113021008,"Block 1008, Block Group 1, Census Tract 5113.02, Santa Clara County, California",0,0,0
1000000US060855113021009,060855113021009,"Block 1009, Block Group 1, Census Tract 5113.02, Santa Clara County, California",85,81,4
1000000US060855113021010,060855113021010,"Block 1010, Block Group 1, Census Tract 5113.02, Santa Clara County, California",43,41,2
1000000US060855113021011,060855113021011,"Block 1011, Block Group 1, Census Tract 5113.02, Santa Clara County, California",0,0,0
1000000US060855113021012,060855113021012,"Block 1012, Block Group 1, Census Tract 5113.02, Santa Clara County, California",0,0,0
1000000US060855113021013,060855113021013,"Block 1013, Block Group 1, Census Tract 5113.02, Santa Clara County, California",7,6,1
1000000US060855113021014,060855113021014,"Block 1014, Block Group 1, Census Tract 5113.02, Santa Clara County, California",0,0,0
1000000US060855113021015,060855113021015,"Block 1015, Block Group 1, Census Tract 5113.02, Santa Clara County, California",8,7,1
1000000US060855113021016,060855113021016,"Block 1016, Block Group 1, Census Tract 5113.02, Santa Clara County, California",0,0,0
1000000US060855113021017,060855113021017,"Block 1017, Block Group 1, Census Tract 5113.02, Santa Clara County, California",26,26,0
1000000US060855113021018,060855113021018,"Block 1018, Block Group 1, Census Tract 5113.02, Santa Clara County, California",21,21,0
1000000US060855113021019,060855113021019,"Block 1019, Block Group 1, Census Tract 5113.02, Santa Clara County, California",22,20,2
1000000US060855113021020,060855113021020,"Block 1020, Block Group 1, Census Tract 5113.02, Santa Clara County, California",0,0,0
1000000US060855113021021,060855113021021,"Block 1021, Block Group 1, Census Tract 5113.02, Santa Clara County, California",0,0,0
1000000US060855113021022,060855113021022,"Block 1022, Block Group 1, Census Tract 5113.02, Santa Clara County, California",0,0,0
1000000US060855113021023,060855113021023,"Block 1023, Block Group 1, Census Tract 5113.02, Santa Clara County, California",44,43,1
1000000US060855113021024,060855113021024,"Block 1024, Block Group 1, Census Tract 5113.02, Santa Clara County, California",4,4,0
1000000US060855113021025,060855113021025,"Block 1025, Block Group 1, Census Tract 5113.02, Santa Clara County, California",0,0,0
1000000US060855113021026,060855113021026,"Block 1026, Block Group 1, Census Tract 5113.02, Santa Clara County, California",0,0,0
1000000US060855113022000,060855113022000,"Block 2000, Block Group 2, Census Tract 5113.02, Santa Clara County, California",36,28,8
1000000US060855113022001,060855113022001,"Block 2001, Block Group 2, Census Tract 5113.02, Santa Clara County, California",71,66,5
1000000US060855113022002,060855113022002,"Block 2002, Block Group 2, Census Tract 5113.02, Santa Clara County, California",5,5,0
1000000US060855113022003,060855113022003,"Block 2003, Block Group 2, Census Tract 5113.02, Santa Clara County, California",29,26,3
1000000US060855113022004,060855113022004,"Block 2004, Block Group 2, Census Tract 5113.02, Santa Clara County, California",28,28,0
1000000US060855113022005,060855113022005,"Block 2005, Block Group 2, Census Tract 5113.02, Santa Clara County, California",113,107,6
1000000US060855113022006,060855113022006,"Block 2006, Block Group 2, Census Tract 5113.02, Santa Clara County, California",0,0,0
1000000US060855113022007,060855113022007,"Block 2007, Block Group 2, Census Tract 5113.02, Santa Clara County, California",73,61,12
1000000US060855113022008,060855113022008,"Block 2008, Block Group 2, Census Tract 5113.02, Santa Clara County, California",0,0,0
1000000US060855113022009,060855113022009,"Block 2009, Block Group 2, Census Tract 5113.02, Santa Clara County, California",62,54,8
1000000US060855113022010,060855113022010,"Block 2010, Block Group 2, Census Tract 5113.02, Santa Clara County, California",33,32,1
1000000US060855113022011,060855113022011,"Block 2011, Block Group 2, Census Tract 5113.02, Santa Clara County, California",44,38,6
1000000US060855113022012,060855113022012,"Block 2012, Block Group 2, Census Tract 5113.02, Santa Clara County, California",0,0,0
1000000US060855113022013,060855113022013,"Block 2013, Block Group 2, Census Tract 5113.02, Santa Clara County, California",0,0,0
1000000US060855113022014,060855113022014,"Block 2014, Block Group 2, Census Tract 5113.02, Santa Clara County, California",0,0,0
1000000US060855113022015,060855113022015,"Block 2015, Block Group 2, Census Tract 5113.02, Santa Clara County, California",0,0,0
1000000US060855113022016,060855113022016,"Block 2016, Block Group 2, Census Tract 5113.02, Santa Clara County, California",34,30,4
1000000US060855113022017,060855113022017,"Block 2017, Block Group 2, Census Tract 5113.02, Santa Clara County, California",0,0,0
1000000US060855113022018,060855113022018,"Block 2018, Block Group 2, Census Tract 5113.02, Santa Clara County, California",0,0,0
1000000US060855113022019,060855113022019,"Block 2019, Block Group 2, Census Tract 5113.02, Santa Clara County, California",0,0,0
1000000US060855113023000,060855113023000,"Block 3000, Block Group 3, Census Tract 5113.02, Santa Clara County, California",22,21,1
1000000US060855113023001,060855113023001,"Block 3001, Block Group 3, Census Tract 5113.02, Santa Clara County, California",0,0,0
1000000US060855113023002,060855113023002,"Block 3002, Block Group 3, Census Tract 5113.02, Santa Clara County, California",0,0,0
1000000US060855113023003,060855113023003,"Block 3003, Block Group 3, Census Tract 5113.02, Santa Clara County, California",2,1,1
1000000US060855113023004,060855113023004,"Block 3004, Block Group 3, Census Tract 5113.02, Santa Clara County, California",18,17,1
1000000US060855113023005,060855113023005,"Block 3005, Block Group 3, Census Tract 5113.02, Santa Clara County, California",13,12,1
1000000US060855113023006,060855113023006,"Block 3006, Block Group 3, Census Tract 5113.02, Santa Clara County, California",16,14,2
1000000US060855113023007,060855113023007,"Block 3007, Block Group 3, Census Tract 5113.02, Santa Clara County, California",0,0,0
1000000US060855113023008,060855113023008,"Block 3008, Block Group 3, Census Tract 5113.02, Santa Clara County, California",26,26,0
1000000US060855113023009,060855113023009,"Block 3009, Block Group 3, Census Tract 5113.02, Santa Clara County, California",10,9,1
1000000US060855113023010,060855113023010,"Block 3010, Block Group 3, Census Tract 5113.02, Santa Clara County, California",21,20,1
1000000US060855113023011,060855113023011,"Block 3011, Block Group 3, Census Tract 5113.02, Santa Clara County, California",24,22,2
1000000US060855113023012,060855113023012,"Block 3012, Block Group 3, Census Tract 5113.02, Santa Clara County, California",157,126,31
1000000US060855113023013,060855113023013,"Block 3013, Block Group 3, Census Tract 5113.02, Santa Clara County, California",18,16,2
1000000US060855113023014,060855113023014,"Block 3014, Block Group 3, Census Tract 5113.02, Santa Clara County, California",24,23,1
1000000US060855113023015,060855113023015,"Block 3015, Block Group 3, Census Tract 5113.02, Santa Clara County, California",43,43,0
1000000US060855113023016,060855113023016,"Block 3016, Block Group 3, Census Tract 5113.02, Santa Clara County, California",0,0,0
1000000US060855113023017,060855113023017,"Block 3017, Block Group 3, Census Tract 5113.02, Santa Clara County, California",0,0,0
1000000US060855113023018,060855113023018,"Block 3018, Block Group 3, Census Tract 5113.02, Santa Clara County, California",93,88,5
1000000US060855113023019,060855113023019,"Block 3019, Block Group 3, Census Tract 5113.02, Santa Clara County, California",34,33,1
1000000US060855113023020,060855113023020,"Block 3020, Block Group 3, Census Tract 5113.02, Santa Clara County, California",27,26,1
1000000US060855113023021,060855113023021,"Block 3021, Block Group 3, Census Tract 5113.02, Santa Clara County, California",0,0,0
1000000US060855113023022,060855113023022,"Block 3022, Block Group 3, Census Tract 5113.02, Santa Clara County, California",189,179,10
1000000US060855113023023,060855113023023,"Block 3023, Block Group 3, Census Tract 5113.02, Santa Clara County, California",39,36,3
1000000US060855113023024,060855113023024,"Block 3024, Block Group 3, Census Tract 5113.02, Santa Clara County, California",22,21,1
1000000US060855113023025,060855113023025,"Block 3025, Block Group 3, Census Tract 5113.02, Santa Clara County, California",43,39,4
1000000US060855113023026,060855113023026,"Block 3026, Block Group 3, Census Tract 5113.02, Santa Clara County, California",54,52,2
1000000US060855113023027,060855113023027,"Block 3027, Block Group 3, Census Tract 5113.02, Santa Clara County, California",156,138,18
1000000US060855113023028,060855113023028,"Block 3028, Block Group 3, Census Tract 5113.02, Santa Clara County, California",0,0,0
1000000US060855113023029,060855113023029,"Block 3029, Block Group 3, Census Tract 5113.02, Santa Clara County, California",48,46,2
1000000US060855113023030,060855113023030,"Block 3030, Block Group 3, Census Tract 5113.02, Santa Clara County, California",33,31,2
1000000US060855113023031,060855113023031,"Block 3031, Block Group 3, Census Tract 5113.02, Santa Clara County, California",0,0,0
1000000US060855114001000,060855114001000,"Block 1000, Block Group 1, Census Tract 5114, Santa Clara County, California",0,0,0
1000000US060855114001001,060855114001001,"Block 1001, Block Group 1, Census Tract 5114, Santa Clara County, California",6,6,0
1000000US060855114001002,060855114001002,"Block 1002, Block Group 1, Census Tract 5114, Santa Clara County, California",14,14,0
1000000US060855114001003,060855114001003,"Block 1003, Block Group 1, Census Tract 5114, Santa Clara County, California",0,0,0
1000000US060855114001004,060855114001004,"Block 1004, Block Group 1, Census Tract 5114, Santa Clara County, California",3,3,0
1000000US060855114001005,060855114001005,"Block 1005, Block Group 1, Census Tract 5114, Santa Clara County, California",0,0,0
1000000US060855114001006,060855114001006,"Block 1006, Block Group 1, Census Tract 5114, Santa Clara County, California",0,0,0
1000000US060855114001007,060855114001007,"Block 1007, Block Group 1, Census Tract 5114, Santa Clara County, California",0,0,0
1000000US060855114001008,060855114001008,"Block 1008, Block Group 1, Census Tract 5114, Santa Clara County, California",17,17,0
1000000US060855114001009,060855114001009,"Block 1009, Block Group 1, Census Tract 5114, Santa Clara County, California",10,8,2
1000000US060855114001010,060855114001010,"Block 1010, Block Group 1, Census Tract 5114, Santa Clara County, California",15,13,2
1000000US060855114001011,060855114001011,"Block 1011, Block Group 1, Census Tract 5114, Santa Clara County, California",23,22,1
1000000US060855114001012,060855114001012,"Block 1012, Block Group 1, Census Tract 5114, Santa Clara County, California",3,3,0
1000000US060855114001013,060855114001013,"Block 1013, Block Group 1, Census Tract 5114, Santa Clara County, California",0,0,0
1000000US060855114001014,060855114001014,"Block 1014, Block Group 1, Census Tract 5114, Santa Clara County, California",1,1,0
1000000US060855114001015,060855114001015,"Block 1015, Block Group 1, Census Tract 5114, Santa Clara County, California",0,0,0
1000000US060855114001016,060855114001016,"Block 1016, Block Group 1, Census Tract 5114, Santa Clara County, California",0,0,0
1000000US060855114001017,060855114001017,"Block 1017, Block Group 1, Census Tract 5114, Santa Clara County, California",43,37,6
1000000US060855114001018,060855114001018,"Block 1018, Block Group 1, Census Tract 5114, Santa Clara County, California",38,34,4
1000000US060855114001019,060855114001019,"Block 1019, Block Group 1, Census Tract 5114, Santa Clara County, California",39,38,1
1000000US060855114001020,060855114001020,"Block 1020, Block Group 1, Census Tract 5114, Santa Clara County, California",24,22,2
1000000US060855114001021,060855114001021,"Block 1021, Block Group 1, Census Tract 5114, Santa Clara County, California",16,13,3
1000000US060855114001022,060855114001022,"Block 1022, Block Group 1, Census Tract 5114, Santa Clara County, California",35,32,3
1000000US060855114001023,060855114001023,"Block 1023, Block Group 1, Census Tract 5114, Santa Clara County, California",0,0,0
1000000US060855114001024,060855114001024,"Block 1024, Block Group 1, Census Tract 5114, Santa Clara County, California",0,0,0
1000000US060855114002000,060855114002000,"Block 2000, Block Group 2, Census Tract 5114, Santa Clara County, California",14,14,0
1000000US060855114002001,060855114002001,"Block 2001, Block Group 2, Census Tract 5114, Santa Clara County, California",23,22,1
1000000US060855114002002,060855114002002,"Block 2002, Block Group 2, Census Tract 5114, Santa Clara County, California",23,21,2
1000000US060855114002003,060855114002003,"Block 2003, Block Group 2, Census Tract 5114, Santa Clara County, California",29,28,1
1000000US060855114002004,060855114002004,"Block 2004, Block Group 2, Census Tract 5114, Santa Clara County, California",26,24,2
1000000US060855114002005,060855114002005,"Block 2005, Block Group 2, Census Tract 5114, Santa Clara County, California",15,13,2
1000000US060855114002006,060855114002006,"Block 2006, Block Group 2, Census Tract 5114, Santa Clara County, California",13,10,3
1000000US060855114002007,060855114002007,"Block 2007, Block Group 2, Census Tract 5114, Santa Clara County, California",27,25,2
1000000US060855114002008,060855114002008,"Block 2008, Block Group 2, Census Tract 5114, Santa Clara County, California",18,18,0
1000000US060855114002009,060855114002009,"Block 2009, Block Group 2, Census Tract 5114, Santa Clara County, California",20,18,2
1000000US060855114002010,060855114002010,"Block 2010, Block Group 2, Census Tract 5114, Santa Clara County, California",16,16,0
1000000US060855114002011,060855114002011,"Block 2011, Block Group 2, Census Tract 5114, Santa Clara County, California",15,14,1
1000000US060855114002012,060855114002012,"Block 2012, Block Group 2, Census Tract 5114, Santa Clara County, California",12,11,1
1000000US060855114002013,060855114002013,"Block 2013, Block Group 2, Census Tract 5114, Santa Clara County, California",45,41,4
1000000US060855114002014,060855114002014,"Block 2014, Block Group 2, Census Tract 5114, Santa Clara County, California",29,27,2
1000000US060855114002015,060855114002015,"Block 2015, Block Group 2, Census Tract 5114, Santa Clara County, California",19,19,0
1000000US060855114002016,060855114002016,"Block 2016, Block Group 2, Census Tract 5114, Santa Clara County, California",39,37,2
1000000US060855114002017,060855114002017,"Block 2017, Block Group 2, Census Tract 5114, Santa Clara County, California",0,0,0
1000000US060855114002018,060855114002018,"Block 2018, Block Group 2, Census Tract 5114, Santa Clara County, California",51,47,4
1000000US060855114003000,060855114003000,"Block 3000, Block Group 3, Census Tract 5114, Santa Clara County, California",24,24,0
1000000US060855114003001,060855114003001,"Block 3001, Block Group 3, Census Tract 5114, Santa Clara County, California",21,20,1
1000000US060855114003002,060855114003002,"Block 3002, Block Group 3, Census Tract 5114, Santa Clara County, California",23,22,1
1000000US060855114003003,060855114003003,"Block 3003, Block Group 3, Census Tract 5114, Santa Clara County, California",22,21,1
1000000US060855114003004,060855114003004,"Block 3004, Block Group 3, Census Tract 5114, Santa Clara County, California",20,19,1
1000000US060855114003005,060855114003005,"Block 3005, Block Group 3, Census Tract 5114, Santa Clara County, California",29,25,4
1000000US060855114003006,060855114003006,"Block 3006, Block Group 3, Census Tract 5114, Santa Clara County, California",30,29,1
1000000US060855114003007,060855114003007,"Block 3007, Block Group 3, Census Tract 5114, Santa Clara County, California",26,26,0
1000000US060855114003008,060855114003008,"Block 3008, Block Group 3, Census Tract 5114, Santa Clara County, California",46,45,1
1000000US060855114003009,060855114003009,"Block 3009, Block Group 3, Census Tract 5114, Santa Clara County, California",0,0,0
1000000US060855114003010,060855114003010,"Block 3010, Block Group 3, Census Tract 5114, Santa Clara County, California",50,47,3
1000000US060855114004000,060855114004000,"Block 4000, Block Group 4, Census Tract 5114, Santa Clara County, California",16,16,0
1000000US060855114004001,060855114004001,"Block 4001, Block Group 4, Census Tract 5114, Santa Clara County, California",13,13,0
1000000US060855114004002,060855114004002,"Block 4002, Block Group 4, Census Tract 5114, Santa Clara County, California",26,26,0
1000000US060855114004003,060855114004003,"Block 4003, Block Group 4, Census Tract 5114, Santa Clara County, California",22,21,1
1000000US060855114004004,060855114004004,"Block 4004, Block Group 4, Census Tract 5114, Santa Clara County, California",28,27,1
1000000US060855114004005,060855114004005,"Block 4005, Block Group 4, Census Tract 5114, Santa Clara County, California",32,30,2
1000000US060855114004006,060855114004006,"Block 4006, Block Group 4, Census Tract 5114, Santa Clara County, California",11,10,1
1000000US060855114004007,060855114004007,"Block 4007, Block Group 4, Census Tract 5114, Santa Clara County, California",0,0,0
1000000US060855114004008,060855114004008,"Block 4008, Block Group 4, Census Tract 5114, Santa Clara County, California",15,15,0
1000000US060855114004009,060855114004009,"Block 4009, Block Group 4, Census Tract 5114, Santa Clara County, California",11,11,0
1000000US060855114004010,060855114004010,"Block 4010, Block Group 4, Census Tract 5114, Santa Clara County, California",14,14,0
1000000US060855114004011,060855114004011,"Block 4011, Block Group 4, Census Tract 5114, Santa Clara County, California",13,11,2
1000000US060855114004012,060855114004012,"Block 4012, Block Group 4, Census Tract 5114, Santa Clara County, California",19,19,0
1000000US060855114004013,060855114004013,"Block 4013, Block Group 4, Census Tract 5114, Santa Clara County, California",21,21,0
1000000US060855114004014,060855114004014,"Block 4014, Block Group 4, Census Tract 5114, Santa Clara County, California",0,0,0
1000000US060855114004015,060855114004015,"Block 4015, Block Group 4, Census Tract 5114, Santa Clara County, California",0,0,0
1000000US060855114004016,060855114004016,"Block 4016, Block Group 4, Census Tract 5114, Santa Clara County, California",21,21,0
1000000US060855114004017,060855114004017,"Block 4017, Block Group 4, Census Tract 5114, Santa Clara County, California",22,22,0
1000000US060855114004018,060855114004018,"Block 4018, Block Group 4, Census Tract 5114, Santa Clara County, California",24,24,0
1000000US060855114004019,060855114004019,"Block 4019, Block Group 4, Census Tract 5114, Santa Clara County, California",6,6,0
1000000US060855114004020,060855114004020,"Block 4020, Block Group 4, Census Tract 5114, Santa Clara County, California",23,22,1
1000000US060855114004021,060855114004021,"Block 4021, Block Group 4, Census Tract 5114, Santa Clara County, California",16,15,1
1000000US060855114004022,060855114004022,"Block 4022, Block Group 4, Census Tract 5114, Santa Clara County, California",10,9,1
1000000US060855114004023,060855114004023,"Block 4023, Block Group 4, Census Tract 5114, Santa Clara County, California",6,6,0
1000000US060855114004024,060855114004024,"Block 4024, Block Group 4, Census Tract 5114, Santa Clara County, California",9,8,1
1000000US060855114004025,060855114004025,"Block 4025, Block Group 4, Census Tract 5114, Santa Clara County, California",15,15,0
1000000US060855114004026,060855114004026,"Block 4026, Block Group 4, Census Tract 5114, Santa Clara County, California",20,17,3
1000000US060855114004027,060855114004027,"Block 4027, Block Group 4, Census Tract 5114, Santa Clara County, California",6,6,0
1000000US060855114004028,060855114004028,"Block 4028, Block Group 4, Census Tract 5114, Santa Clara County, California",20,18,2
1000000US060855114004029,060855114004029,"Block 4029, Block Group 4, Census Tract 5114, Santa Clara County, California",0,0,0
1000000US060855114004030,060855114004030,"Block 4030, Block Group 4, Census Tract 5114, Santa Clara County, California",0,0,0
1000000US060855114004031,060855114004031,"Block 4031, Block Group 4, Census Tract 5114, Santa Clara County, California",5,5,0
1000000US060855114004032,060855114004032,"Block 4032, Block Group 4, Census Tract 5114, Santa Clara County, California",0,0,0
1000000US060855114004033,060855114004033,"Block 4033, Block Group 4, Census Tract 5114, Santa Clara County, California",0,0,0
1000000US060855115001000,060855115001000,"Block 1000, Block Group 1, Census Tract 5115, Santa Clara County, California",0,0,0
1000000US060855115001001,060855115001001,"Block 1001, Block Group 1, Census Tract 5115, Santa Clara County, California",10,10,0
1000000US060855115001002,060855115001002,"Block 1002, Block Group 1, Census Tract 5115, Santa Clara County, California",0,0,0
1000000US060855115001003,060855115001003,"Block 1003, Block Group 1, Census Tract 5115, Santa Clara County, California",0,0,0
1000000US060855115001004,060855115001004,"Block 1004, Block Group 1, Census Tract 5115, Santa Clara County, California",0,0,0
1000000US060855115001005,060855115001005,"Block 1005, Block Group 1, Census Tract 5115, Santa Clara County, California",0,0,0
1000000US060855115001006,060855115001006,"Block 1006, Block Group 1, Census Tract 5115, Santa Clara County, California",0,0,0
1000000US060855115001007,060855115001007,"Block 1007, Block Group 1, Census Tract 5115, Santa Clara County, California",0,0,0
1000000US060855115001008,060855115001008,"Block 1008, Block Group 1, Census Tract 5115, Santa Clara County, California",0,0,0
1000000US060855115001009,060855115001009,"Block 1009, Block Group 1, Census Tract 5115, Santa Clara County, California",0,0,0
1000000US060855115001010,060855115001010,"Block 1010, Block Group 1, Census Tract 5115, Santa Clara County, California",41,39,2
1000000US060855115001011,060855115001011,"Block 1011, Block Group 1, Census Tract 5115, Santa Clara County, California",11,10,1
1000000US060855115001012,060855115001012,"Block 1012, Block Group 1, Census Tract 5115, Santa Clara County, California",12,11,1
1000000US060855115001013,060855115001013,"Block 1013, Block Group 1, Census Tract 5115, Santa Clara County, California",8,8,0
1000000US060855115001014,060855115001014,"Block 1014, Block Group 1, Census Tract 5115, Santa Clara County, California",30,29,1
1000000US060855115001015,060855115001015,"Block 1015, Block Group 1, Census Tract 5115, Santa Clara County, California",53,50,3
1000000US060855115001016,060855115001016,"Block 1016, Block Group 1, Census Tract 5115, Santa Clara County, California",13,13,0
1000000US060855115001017,060855115001017,"Block 1017, Block Group 1, Census Tract 5115, Santa Clara County, California",18,17,1
1000000US060855115001018,060855115001018,"Block 1018, Block Group 1, Census Tract 5115, Santa Clara County, California",51,49,2
1000000US060855115001019,060855115001019,"Block 1019, Block Group 1, Census Tract 5115, Santa Clara County, California",0,0,0
1000000US060855115001020,060855115001020,"Block 1020, Block Group 1, Census Tract 5115, Santa Clara County, California",14,14,0
1000000US060855115001021,060855115001021,"Block 1021, Block Group 1, Census Tract 5115, Santa Clara County, California",15,15,0
1000000US060855115001022,060855115001022,"Block 1022, Block Group 1, Census Tract 5115, Santa Clara County, California",13,12,1
1000000US060855115001023,060855115001023,"Block 1023, Block Group 1, Census Tract 5115, Santa Clara County, California",0,0,0
1000000US060855115001024,060855115001024,"Block 1024, Block Group 1, Census Tract 5115, Santa Clara County, California",16,15,1
1000000US060855115001025,060855115001025,"Block 1025, Block Group 1, Census Tract 5115, Santa Clara County, California",11,10,1
1000000US060855115001026,060855115001026,"Block 1026, Block Group 1, Census Tract 5115, Santa Clara County, California",21,19,2
1000000US060855115001027,060855115001027,"Block 1027, Block Group 1, Census Tract 5115, Santa Clara County, California",11,11,0
1000000US060855115001028,060855115001028,"Block 1028, Block Group 1, Census Tract 5115, Santa Clara County, California",14,13,1
1000000US060855115001029,060855115001029,"Block 1029, Block Group 1, Census Tract 5115, Santa Clara County, California",21,21,0
1000000US060855115002000,060855115002000,"Block 2000, Block Group 2, Census Tract 5115, Santa Clara County, California",0,0,0
1000000US060855115002001,060855115002001,"Block 2001, Block Group 2, Census Tract 5115, Santa Clara County, California",0,0,0
1000000US060855115002002,060855115002002,"Block 2002, Block Group 2, Census Tract 5115, Santa Clara County, California",29,29,0
1000000US060855115002003,060855115002003,"Block 2003, Block Group 2, Census Tract 5115, Santa Clara County, California",0,0,0
1000000US060855115002004,060855115002004,"Block 2004, Block Group 2, Census Tract 5115, Santa Clara County, California",31,30,1
1000000US060855115002005,060855115002005,"Block 2005, Block Group 2, Census Tract 5115, Santa Clara County, California",40,40,0
1000000US060855115002006,060855115002006,"Block 2006, Block Group 2, Census Tract 5115, Santa Clara County, California",19,18,1
1000000US060855115002007,060855115002007,"Block 2007, Block Group 2, Census Tract 5115, Santa Clara County, California",19,18,1
1000000US060855115002008,060855115002008,"Block 2008, Block Group 2, Census Tract 5115, Santa Clara County, California",58,54,4
1000000US060855115002009,060855115002009,"Block 2009, Block Group 2, Census Tract 5115, Santa Clara County, California",0,0,0
1000000US060855115002010,060855115002010,"Block 2010, Block Group 2, Census Tract 5115, Santa Clara County, California",0,0,0
1000000US060855115002011,060855115002011,"Block 2011, Block Group 2, Census Tract 5115, Santa Clara County, California",0,0,0
1000000US060855115002012,060855115002012,"Block 2012, Block Group 2, Census Tract 5115, Santa Clara County, California",10,8,2
1000000US060855115002013,060855115002013,"Block 2013, Block Group 2, Census Tract 5115, Santa Clara County, California",0,0,0
1000000US060855115002014,060855115002014,"Block 2014, Block Group 2, Census Tract 5115, Santa Clara County, California",133,128,5
1000000US060855115002015,060855115002015,"Block 2015, Block Group 2, Census Tract 5115, Santa Clara County, California",0,0,0
1000000US060855115002016,060855115002016,"Block 2016, Block Group 2, Census Tract 5115, Santa Clara County, California",26,24,2
1000000US060855115002017,060855115002017,"Block 2017, Block Group 2, Census Tract 5115, Santa Clara County, California",0,0,0
1000000US060855115002018,060855115002018,"Block 2018, Block Group 2, Census Tract 5115, Santa Clara County, California",0,0,0
1000000US060855115002019,060855115002019,"Block 2019, Block Group 2, Census Tract 5115, Santa Clara County, California",0,0,0
1000000US060855115002020,060855115002020,"Block 2020, Block Group 2, Census Tract 5115, Santa Clara County, California",0,0,0
1000000US060855115002021,060855115002021,"Block 2021, Block Group 2, Census Tract 5115, Santa Clara County, California",0,0,0
1000000US060855115002022,060855115002022,"Block 2022, Block Group 2, Census Tract 5115, Santa Clara County, California",0,0,0
1000000US060855115002023,060855115002023,"Block 2023, Block Group 2, Census Tract 5115, Santa Clara County, California",36,34,2
1000000US060855115002024,060855115002024,"Block 2024, Block Group 2, Census Tract 5115, Santa Clara County, California",44,42,2
1000000US060855115002025,060855115002025,"Block 2025, Block Group 2, Census Tract 5115, Santa Clara County, California",32,28,4
1000000US060855115002026,060855115002026,"Block 2026, Block Group 2, Census Tract 5115, Santa Clara County, California",0,0,0
1000000US060855115002027,060855115002027,"Block 2027, Block Group 2, Census Tract 5115, Santa Clara County, California",0,0,0
1000000US060855115002028,060855115002028,"Block 2028, Block Group 2, Census Tract 5115, Santa Clara County, California",0,0,0
1000000US060855115002029,060855115002029,"Block 2029, Block Group 2, Census Tract 5115, Santa Clara County, California",0,0,0
1000000US060855115002030,060855115002030,"Block 2030, Block Group 2, Census Tract 5115, Santa Clara County, California",0,0,0
1000000US060855115002031,060855115002031,"Block 2031, Block Group 2, Census Tract 5115, Santa Clara County, California",40,38,2
1000000US060855115002032,060855115002032,"Block 2032, Block Group 2, Census Tract 5115, Santa Clara County, California",0,0,0
1000000US060855115002033,060855115002033,"Block 2033, Block Group 2, Census Tract 5115, Santa Clara County, California",1,1,0
1000000US060855115002034,060855115002034,"Block 2034, Block Group 2, Census Tract 5115, Santa Clara County, California",63,61,2
1000000US060855115002035,060855115002035,"Block 2035, Block Group 2, Census Tract 5115, Santa Clara County, California",90,90,0
1000000US060855115002036,060855115002036,"Block 2036, Block Group 2, Census Tract 5115, Santa Clara County, California",59,57,2
1000000US060855115002037,060855115002037,"Block 2037, Block Group 2, Census Tract 5115, Santa Clara County, California",192,169,23
1000000US060855115002038,060855115002038,"Block 2038, Block Group 2, Census Tract 5115, Santa Clara County, California",54,51,3
1000000US060855115002039,060855115002039,"Block 2039, Block Group 2, Census Tract 5115, Santa Clara County, California",5,4,1
1000000US060855115002040,060855115002040,"Block 2040, Block Group 2, Census Tract 5115, Santa Clara County, California",8,8,0
1000000US060855115002041,060855115002041,"Block 2041, Block Group 2, Census Tract 5115, Santa Clara County, California",0,0,0
1000000US060855115002042,060855115002042,"Block 2042, Block Group 2, Census Tract 5115, Santa Clara County, California",0,0,0
1000000US060855115003000,060855115003000,"Block 3000, Block Group 3, Census Tract 5115, Santa Clara County, California",0,0,0
1000000US060855115003001,060855115003001,"Block 3001, Block Group 3, Census Tract 5115, Santa Clara County, California",36,33,3
1000000US060855115003002,060855115003002,"Block 3002, Block Group 3, Census Tract 5115, Santa Clara County, California",0,0,0
1000000US060855115003003,060855115003003,"Block 3003, Block Group 3, Census Tract 5115, Santa Clara County, California",57,53,4
1000000US060855115003004,060855115003004,"Block 3004, Block Group 3, Census Tract 5115, Santa Clara County, California",19,17,2
1000000US060855115003005,060855115003005,"Block 3005, Block Group 3, Census Tract 5115, Santa Clara County, California",16,15,1
1000000US060855115003006,060855115003006,"Block 3006, Block Group 3, Census Tract 5115, Santa Clara County, California",82,79,3
1000000US060855115003007,060855115003007,"Block 3007, Block Group 3, Census Tract 5115, Santa Clara County, California",55,48,7
1000000US060855115003008,060855115003008,"Block 3008, Block Group 3, Census Tract 5115, Santa Clara County, California",56,51,5
1000000US060855115003009,060855115003009,"Block 3009, Block Group 3, Census Tract 5115, Santa Clara County, California",3,3,0
1000000US060855115003010,060855115003010,"Block 3010, Block Group 3, Census Tract 5115, Santa Clara County, California",39,37,2
1000000US060855115003011,060855115003011,"Block 3011, Block Group 3, Census Tract 5115, Santa Clara County, California",27,25,2
1000000US060855115003012,060855115003012,"Block 3012, Block Group 3, Census Tract 5115, Santa Clara County, California",40,40,0
1000000US060855115003013,060855115003013,"Block 3013, Block Group 3, Census Tract 5115, Santa Clara County, California",39,37,2
1000000US060855115003014,060855115003014,"Block 3014, Block Group 3, Census Tract 5115, Santa Clara County, California",45,44,1
1000000US060855115003015,060855115003015,"Block 3015, Block Group 3, Census Tract 5115, Santa Clara County, California",30,29,1
1000000US060855115003016,060855115003016,"Block 3016, Block Group 3, Census Tract 5115, Santa Clara County, California",32,31,1
1000000US060855115003017,060855115003017,"Block 3017, Block Group 3, Census Tract 5115, Santa Clara County, California",35,32,3
1000000US060855115003018,060855115003018,"Block 3018, Block Group 3, Census Tract 5115, Santa Clara County, California",40,38,2
1000000US060855115003019,060855115003019,"Block 3019, Block Group 3, Census Tract 5115, Santa Clara County, California",57,51,6
1000000US060855115003020,060855115003020,"Block 3020, Block Group 3, Census Tract 5115, Santa Clara County, California",34,33,1
1000000US060855115003021,060855115003021,"Block 3021, Block Group 3, Census Tract 5115, Santa Clara County, California",24,21,3
1000000US060855115003022,060855115003022,"Block 3022, Block Group 3, Census Tract 5115, Santa Clara County, California",25,23,2
1000000US060855115003023,060855115003023,"Block 3023, Block Group 3, Census Tract 5115, Santa Clara County, California",22,21,1
1000000US060855115003024,060855115003024,"Block 3024, Block Group 3, Census Tract 5115, Santa Clara County, California",28,27,1
1000000US060855115003025,060855115003025,"Block 3025, Block Group 3, Census Tract 5115, Santa Clara County, California",33,28,5
1000000US060855115003026,060855115003026,"Block 3026, Block Group 3, Census Tract 5115, Santa Clara County, California",27,26,1
1000000US060855115004000,060855115004000,"Block 4000, Block Group 4, Census Tract 5115, Santa Clara County, California",0,0,0
1000000US060855115004001,060855115004001,"Block 4001, Block Group 4, Census Tract 5115, Santa Clara County, California",86,85,1
1000000US060855115004002,060855115004002,"Block 4002, Block Group 4, Census Tract 5115, Santa Clara County, California",54,54,0
1000000US060855115004003,060855115004003,"Block 4003, Block Group 4, Census Tract 5115, Santa Clara County, California",77,75,2
1000000US060855115004004,060855115004004,"Block 4004, Block Group 4, Census Tract 5115, Santa Clara County, California",11,11,0
1000000US060855115004005,060855115004005,"Block 4005, Block Group 4, Census Tract 5115, Santa Clara County, California",18,18,0
1000000US060855115004006,060855115004006,"Block 4006, Block Group 4, Census Tract 5115, Santa Clara County, California",85,85,0
1000000US060855115004007,060855115004007,"Block 4007, Block Group 4, Census Tract 5115, Santa Clara County, California",9,9,0
1000000US060855115004008,060855115004008,"Block 4008, Block Group 4, Census Tract 5115, Santa Clara County, California",11,11,0
1000000US060855115004009,060855115004009,"Block 4009, Block Group 4, Census Tract 5115, Santa Clara County, California",9,9,0
1000000US060855115005000,060855115005000,"Block 5000, Block Group 5, Census Tract 5115, Santa Clara County, California",32,31,1
1000000US060855115005001,060855115005001,"Block 5001, Block Group 5, Census Tract 5115, Santa Clara County, California",0,0,0
1000000US060855115005002,060855115005002,"Block 5002, Block Group 5, Census Tract 5115, Santa Clara County, California",0,0,0
1000000US060855115005003,060855115005003,"Block 5003, Block Group 5, Census Tract 5115, Santa Clara County, California",0,0,0
1000000US060855115005004,060855115005004,"Block 5004, Block Group 5, Census Tract 5115, Santa Clara County, California",0,0,0
1000000US060855115005005,060855115005005,"Block 5005, Block Group 5, Census Tract 5115, Santa Clara County, California",5,3,2
1000000US060855115005006,060855115005006,"Block 5006, Block Group 5, Census Tract 5115, Santa Clara County, California",0,0,0
1000000US060855115005007,060855115005007,"Block 5007, Block Group 5, Census Tract 5115, Santa Clara County, California",5,5,0
1000000US060855115005008,060855115005008,"Block 5008, Block Group 5, Census Tract 5115, Santa Clara County, California",38,25,13
1000000US060855115005009,060855115005009,"Block 5009, Block Group 5, Census Tract 5115, Santa Clara County, California",0,0,0
1000000US060855115005010,060855115005010,"Block 5010, Block Group 5, Census Tract 5115, Santa Clara County, California",9,8,1
1000000US060855115005011,060855115005011,"Block 5011, Block Group 5, Census Tract 5115, Santa Clara County, California",9,9,0
1000000US060855115005012,060855115005012,"Block 5012, Block Group 5, Census Tract 5115, Santa Clara County, California",13,12,1
1000000US060855115005013,060855115005013,"Block 5013, Block Group 5, Census Tract 5115, Santa Clara County, California",8,7,1
1000000US060855115005014,060855115005014,"Block 5014, Block Group 5, Census Tract 5115, Santa Clara County, California",14,11,3
1000000US060855115005015,060855115005015,"Block 5015, Block Group 5, Census Tract 5115, Santa Clara County, California",30,25,5
1000000US060855115005016,060855115005016,"Block 5016, Block Group 5, Census Tract 5115, Santa Clara County, California",0,0,0
1000000US060855115005017,060855115005017,"Block 5017, Block Group 5, Census Tract 5115, Santa Clara County, California",0,0,0
1000000US060855115005018,060855115005018,"Block 5018, Block Group 5, Census Tract 5115, Santa Clara County, California",0,0,0
1000000US060855115005019,060855115005019,"Block 5019, Block Group 5, Census Tract 5115, Santa Clara County, California",6,6,0
1000000US060855115005020,060855115005020,"Block 5020, Block Group 5, Census Tract 5115, Santa Clara County, California",35,35,0
1000000US060855115005021,060855115005021,"Block 5021, Block Group 5, Census Tract 5115, Santa Clara County, California",56,55,1
1000000US060855115005022,060855115005022,"Block 5022, Block Group 5, Census Tract 5115, Santa Clara County, California",0,0,0
1000000US060855115005023,060855115005023,"Block 5023, Block Group 5, Census Tract 5115, Santa Clara County, California",17,16,1
1000000US060855115005024,060855115005024,"Block 5024, Block Group 5, Census Tract 5115, Santa Clara County, California",46,45,1
1000000US060855115005025,060855115005025,"Block 5025, Block Group 5, Census Tract 5115, Santa Clara County, California",20,20,0
1000000US060855115005026,060855115005026,"Block 5026, Block Group 5, Census Tract 5115, Santa Clara County, California",6,2,4
1000000US060855115005027,060855115005027,"Block 5027, Block Group 5, Census Tract 5115, Santa Clara County, California",0,0,0
1000000US060855115005028,060855115005028,"Block 5028, Block Group 5, Census Tract 5115, Santa Clara County, California",41,40,1
1000000US060855115005029,060855115005029,"Block 5029, Block Group 5, Census Tract 5115, Santa Clara County, California",6,6,0
1000000US060855115005030,060855115005030,"Block 5030, Block Group 5, Census Tract 5115, Santa Clara County, California",20,14,6
1000000US060855115005031,060855115005031,"Block 5031, Block Group 5, Census Tract 5115, Santa Clara County, California",0,0,0
1000000US060855115005032,060855115005032,"Block 5032, Block Group 5, Census Tract 5115, Santa Clara County, California",0,0,0
1000000US060855115005033,060855115005033,"Block 5033, Block Group 5, Census Tract 5115, Santa Clara County, California",15,15,0
1000000US060855115005034,060855115005034,"Block 5034, Block Group 5, Census Tract 5115, Santa Clara County, California",7,7,0
1000000US060855115005035,060855115005035,"Block 5035, Block Group 5, Census Tract 5115, Santa Clara County, California",5,5,0
1000000US060855115005036,060855115005036,"Block 5036, Block Group 5, Census Tract 5115, Santa Clara County, California",4,4,0
1000000US060855115005037,060855115005037,"Block 5037, Block Group 5, Census Tract 5115, Santa Clara County, California",11,8,3
1000000US060855115005038,060855115005038,"Block 5038, Block Group 5, Census Tract 5115, Santa Clara County, California",0,0,0
1000000US060855115005039,060855115005039,"Block 5039, Block Group 5, Census Tract 5115, Santa Clara County, California",5,5,0
1000000US060855115005040,060855115005040,"Block 5040, Block Group 5, Census Tract 5115, Santa Clara County, California",43,43,0
1000000US060855115005041,060855115005041,"Block 5041, Block Group 5, Census Tract 5115, Santa Clara County, California",19,19,0
1000000US060855115005042,060855115005042,"Block 5042, Block Group 5, Census Tract 5115, Santa Clara County, California",0,0,0
1000000US060855115005043,060855115005043,"Block 5043, Block Group 5, Census Tract 5115, Santa Clara County, California",21,21,0
1000000US060855116081000,060855116081000,"Block 1000, Block Group 1, Census Tract 5116.08, Santa Clara County, California",0,0,0
1000000US060855116081001,060855116081001,"Block 1001, Block Group 1, Census Tract 5116.08, Santa Clara County, California",0,0,0
1000000US060855116081002,060855116081002,"Block 1002, Block Group 1, Census Tract 5116.08, Santa Clara County, California",0,0,0
1000000US060855116081003,060855116081003,"Block 1003, Block Group 1, Census Tract 5116.08, Santa Clara County, California",0,0,0
1000000US060855116081004,060855116081004,"Block 1004, Block Group 1, Census Tract 5116.08, Santa Clara County, California",0,0,0
1000000US060855116081005,060855116081005,"Block 1005, Block Group 1, Census Tract 5116.08, Santa Clara County, California",0,0,0
1000000US060855116081006,060855116081006,"Block 1006, Block Group 1, Census Tract 5116.08, Santa Clara County, California",0,0,0
1000000US060855116081007,060855116081007,"Block 1007, Block Group 1, Census Tract 5116.08, Santa Clara County, California",0,0,0
1000000US060855116081008,060855116081008,"Block 1008, Block Group 1, Census Tract 5116.08, Santa Clara County, California",0,0,0
1000000US060855116081009,060855116081009,"Block 1009, Block Group 1, Census Tract 5116.08, Santa Clara County, California",0,0,0
1000000US060855116081010,060855116081010,"Block 1010, Block Group 1, Census Tract 5116.08, Santa Clara County, California",0,0,0
1000000US060855116081011,060855116081011,"Block 1011, Block Group 1, Census Tract 5116.08, Santa Clara County, California",0,0,0
1000000US060855116081012,060855116081012,"Block 1012, Block Group 1, Census Tract 5116.08, Santa Clara County, California",0,0,0
1000000US060855116081013,060855116081013,"Block 1013, Block Group 1, Census Tract 5116.08, Santa Clara County, California",0,0,0
1000000US060855116081014,060855116081014,"Block 1014, Block Group 1, Census Tract 5116.08, Santa Clara County, California",0,0,0
1000000US060855116081015,060855116081015,"Block 1015, Block Group 1, Census Tract 5116.08, Santa Clara County, California",0,0,0
1000000US060855116081016,060855116081016,"Block 1016, Block Group 1, Census Tract 5116.08, Santa Clara County, California",0,0,0
1000000US060855116081017,060855116081017,"Block 1017, Block Group 1, Census Tract 5116.08, Santa Clara County, California",0,0,0
1000000US060855116081018,060855116081018,"Block 1018, Block Group 1, Census Tract 5116.08, Santa Clara County, California",0,0,0
1000000US060855116081019,060855116081019,"Block 1019, Block Group 1, Census Tract 5116.08, Santa Clara County, California",0,0,0
1000000US060855116081020,060855116081020,"Block 1020, Block Group 1, Census Tract 5116.08, Santa Clara County, California",0,0,0
1000000US060855116081021,060855116081021,"Block 1021, Block Group 1, Census Tract 5116.08, Santa Clara County, California",0,0,0
1000000US060855116081022,060855116081022,"Block 1022, Block Group 1, Census Tract 5116.08, Santa Clara County, California",0,0,0
1000000US060855116081023,060855116081023,"Block 1023, Block Group 1, Census Tract 5116.08, Santa Clara County, California",0,0,0
1000000US060855116081024,060855116081024,"Block 1024, Block Group 1, Census Tract 5116.08, Santa Clara County, California",0,0,0
1000000US060855116081025,060855116081025,"Block 1025, Block Group 1, Census Tract 5116.08, Santa Clara County, California",0,0,0
1000000US060855116081026,060855116081026,"Block 1026, Block Group 1, Census Tract 5116.08, Santa Clara County, California",0,0,0
1000000US060855116081027,060855116081027,"Block 1027, Block Group 1, Census Tract 5116.08, Santa Clara County, California",0,0,0
1000000US060855116081028,060855116081028,"Block 1028, Block Group 1, Census Tract 5116.08, Santa Clara County, California",0,0,0
1000000US060855116081029,060855116081029,"Block 1029, Block Group 1, Census Tract 5116.08, Santa Clara County, California",0,0,0
1000000US060855116081030,060855116081030,"Block 1030, Block Group 1, Census Tract 5116.08, Santa Clara County, California",0,0,0
1000000US060855116081031,060855116081031,"Block 1031, Block Group 1, Census Tract 5116.08, Santa Clara County, California",0,0,0
1000000US060855116081032,060855116081032,"Block 1032, Block Group 1, Census Tract 5116.08, Santa Clara County, California",0,0,0
1000000US060855116081033,060855116081033,"Block 1033, Block Group 1, Census Tract 5116.08, Santa Clara County, California",0,0,0
1000000US060855116081034,060855116081034,"Block 1034, Block Group 1, Census Tract 5116.08, Santa Clara County, California",0,0,0
1000000US060855116081035,060855116081035,"Block 1035, Block Group 1, Census Tract 5116.08, Santa Clara County, California",0,0,0
1000000US060855116081036,060855116081036,"Block 1036, Block Group 1, Census Tract 5116.08, Santa Clara County, California",0,0,0
1000000US060855116081037,060855116081037,"Block 1037, Block Group 1, Census Tract 5116.08, Santa Clara County, California",0,0,0
1000000US060855116081038,060855116081038,"Block 1038, Block Group 1, Census Tract 5116.08, Santa Clara County, California",16,13,3
1000000US060855116081039,060855116081039,"Block 1039, Block Group 1, Census Tract 5116.08, Santa Clara County, California",0,0,0
1000000US060855116081040,060855116081040,"Block 1040, Block Group 1, Census Tract 5116.08, Santa Clara County, California",0,0,0
1000000US060855116081041,060855116081041,"Block 1041, Block Group 1, Census Tract 5116.08, Santa Clara County, California",1,1,0
1000000US060855116081042,060855116081042,"Block 1042, Block Group 1, Census Tract 5116.08, Santa Clara County, California",0,0,0
1000000US060855116081043,060855116081043,"Block 1043, Block Group 1, Census Tract 5116.08, Santa Clara County, California",0,0,0
1000000US060855116081044,060855116081044,"Block 1044, Block Group 1, Census Tract 5116.08, Santa Clara County, California",0,0,0
1000000US060855116081045,060855116081045,"Block 1045, Block Group 1, Census Tract 5116.08, Santa Clara County, California",0,0,0
1000000US060855116081046,060855116081046,"Block 1046, Block Group 1, Census Tract 5116.08, Santa Clara County, California",0,0,0
1000000US060855116081047,060855116081047,"Block 1047, Block Group 1, Census Tract 5116.08, Santa Clara County, California",0,0,0
1000000US060855116081048,060855116081048,"Block 1048, Block Group 1, Census Tract 5116.08, Santa Clara County, California",0,0,0
1000000US060855116081049,060855116081049,"Block 1049, Block Group 1, Census Tract 5116.08, Santa Clara County, California",0,0,0
1000000US060855116081050,060855116081050,"Block 1050, Block Group 1, Census Tract 5116.08, Santa Clara County, California",0,0,0
1000000US060855116081051,060855116081051,"Block 1051, Block Group 1, Census Tract 5116.08, Santa Clara County, California",0,0,0
1000000US060855116081052,060855116081052,"Block 1052, Block Group 1, Census Tract 5116.08, Santa Clara County, California",0,0,0
1000000US060855116081053,060855116081053,"Block 1053, Block Group 1, Census Tract 5116.08, Santa Clara County, California",0,0,0
1000000US060855116081054,060855116081054,"Block 1054, Block Group 1, Census Tract 5116.08, Santa Clara County, California",0,0,0
1000000US060855116081055,060855116081055,"Block 1055, Block Group 1, Census Tract 5116.08, Santa Clara County, California",0,0,0
1000000US060855116081056,060855116081056,"Block 1056, Block Group 1, Census Tract 5116.08, Santa Clara County, California",0,0,0
1000000US060855116081057,060855116081057,"Block 1057, Block Group 1, Census Tract 5116.08, Santa Clara County, California",0,0,0
1000000US060855116081058,060855116081058,"Block 1058, Block Group 1, Census Tract 5116.08, Santa Clara County, California",0,0,0
1000000US060855116081059,060855116081059,"Block 1059, Block Group 1, Census Tract 5116.08, Santa Clara County, California",0,0,0
1000000US060855116081060,060855116081060,"Block 1060, Block Group 1, Census Tract 5116.08, Santa Clara County, California",0,0,0
1000000US060855116081061,060855116081061,"Block 1061, Block Group 1, Census Tract 5116.08, Santa Clara County, California",0,0,0
1000000US060855116081062,060855116081062,"Block 1062, Block Group 1, Census Tract 5116.08, Santa Clara County, California",0,0,0
1000000US060855116081063,060855116081063,"Block 1063, Block Group 1, Census Tract 5116.08, Santa Clara County, California",0,0,0
1000000US060855116082000,060855116082000,"Block 2000, Block Group 2, Census Tract 5116.08, Santa Clara County, California",0,0,0
1000000US060855116082001,060855116082001,"Block 2001, Block Group 2, Census Tract 5116.08, Santa Clara County, California",2,2,0
1000000US060855116082002,060855116082002,"Block 2002, Block Group 2, Census Tract 5116.08, Santa Clara County, California",0,0,0
1000000US060855116082003,060855116082003,"Block 2003, Block Group 2, Census Tract 5116.08, Santa Clara County, California",91,91,0
1000000US060855116082004,060855116082004,"Block 2004, Block Group 2, Census Tract 5116.08, Santa Clara County, California",1,1,0
1000000US060855116082005,060855116082005,"Block 2005, Block Group 2, Census Tract 5116.08, Santa Clara County, California",0,0,0
1000000US060855116082006,060855116082006,"Block 2006, Block Group 2, Census Tract 5116.08, Santa Clara County, California",0,0,0
1000000US060855116082007,060855116082007,"Block 2007, Block Group 2, Census Tract 5116.08, Santa Clara County, California",0,0,0
1000000US060855116082008,060855116082008,"Block 2008, Block Group 2, Census Tract 5116.08, Santa Clara County, California",0,0,0
1000000US060855116091000,060855116091000,"Block 1000, Block Group 1, Census Tract 5116.09, Santa Clara County, California",0,0,0
1000000US060855116091001,060855116091001,"Block 1001, Block Group 1, Census Tract 5116.09, Santa Clara County, California",0,0,0
1000000US060855116091002,060855116091002,"Block 1002, Block Group 1, Census Tract 5116.09, Santa Clara County, California",0,0,0
1000000US060855116091003,060855116091003,"Block 1003, Block Group 1, Census Tract 5116.09, Santa Clara County, California",0,0,0
1000000US060855116091004,060855116091004,"Block 1004, Block Group 1, Census Tract 5116.09, Santa Clara County, California",0,0,0
1000000US060855116091005,060855116091005,"Block 1005, Block Group 1, Census Tract 5116.09, Santa Clara County, California",0,0,0
1000000US060855116091006,060855116091006,"Block 1006, Block Group 1, Census Tract 5116.09, Santa Clara County, California",0,0,0
1000000US060855116091007,060855116091007,"Block 1007, Block Group 1, Census Tract 5116.09, Santa Clara County, California",0,0,0
1000000US060855116091008,060855116091008,"Block 1008, Block Group 1, Census Tract 5116.09, Santa Clara County, California",0,0,0
1000000US060855116091009,060855116091009,"Block 1009, Block Group 1, Census Tract 5116.09, Santa Clara County, California",0,0,0
1000000US060855116091010,060855116091010,"Block 1010, Block Group 1, Census Tract 5116.09, Santa Clara County, California",0,0,0
1000000US060855116091011,060855116091011,"Block 1011, Block Group 1, Census Tract 5116.09, Santa Clara County, California",0,0,0
1000000US060855116091012,060855116091012,"Block 1012, Block Group 1, Census Tract 5116.09, Santa Clara County, California",0,0,0
1000000US060855116091013,060855116091013,"Block 1013, Block Group 1, Census Tract 5116.09, Santa Clara County, California",0,0,0
1000000US060855116091014,060855116091014,"Block 1014, Block Group 1, Census Tract 5116.09, Santa Clara County, California",0,0,0
1000000US060855116091015,060855116091015,"Block 1015, Block Group 1, Census Tract 5116.09, Santa Clara County, California",0,0,0
1000000US060855116091016,060855116091016,"Block 1016, Block Group 1, Census Tract 5116.09, Santa Clara County, California",0,0,0
1000000US060855116091017,060855116091017,"Block 1017, Block Group 1, Census Tract 5116.09, Santa Clara County, California",483,449,34
1000000US060855116091018,060855116091018,"Block 1018, Block Group 1, Census Tract 5116.09, Santa Clara County, California",0,0,0
1000000US060855116091019,060855116091019,"Block 1019, Block Group 1, Census Tract 5116.09, Santa Clara County, California",0,0,0
1000000US060855116091020,060855116091020,"Block 1020, Block Group 1, Census Tract 5116.09, Santa Clara County, California",0,0,0
1000000US060855116091021,060855116091021,"Block 1021, Block Group 1, Census Tract 5116.09, Santa Clara County, California",1022,859,163
1000000US060855116091022,060855116091022,"Block 1022, Block Group 1, Census Tract 5116.09, Santa Clara County, California",80,71,9
1000000US060855116091023,060855116091023,"Block 1023, Block Group 1, Census Tract 5116.09, Santa Clara County, California",100,88,12
1000000US060855116091024,060855116091024,"Block 1024, Block Group 1, Census Tract 5116.09, Santa Clara County, California",80,73,7
1000000US060855116091025,060855116091025,"Block 1025, Block Group 1, Census Tract 5116.09, Santa Clara County, California",0,0,0
1000000US060855116091026,060855116091026,"Block 1026, Block Group 1, Census Tract 5116.09, Santa Clara County, California",0,0,0
1000000US060855116091027,060855116091027,"Block 1027, Block Group 1, Census Tract 5116.09, Santa Clara County, California",108,94,14
1000000US060855116091028,060855116091028,"Block 1028, Block Group 1, Census Tract 5116.09, Santa Clara County, California",0,0,0
1000000US060855116091029,060855116091029,"Block 1029, Block Group 1, Census Tract 5116.09, Santa Clara County, California",80,75,5
1000000US060855116091030,060855116091030,"Block 1030, Block Group 1, Census Tract 5116.09, Santa Clara County, California",0,0,0
1000000US060855116091031,060855116091031,"Block 1031, Block Group 1, Census Tract 5116.09, Santa Clara County, California",0,0,0
1000000US060855116091032,060855116091032,"Block 1032, Block Group 1, Census Tract 5116.09, Santa Clara County, California",0,0,0
1000000US060855116091033,060855116091033,"Block 1033, Block Group 1, Census Tract 5116.09, Santa Clara County, California",24,21,3
1000000US060855116091034,060855116091034,"Block 1034, Block Group 1, Census Tract 5116.09, Santa Clara County, California",0,0,0
1000000US060855116091035,060855116091035,"Block 1035, Block Group 1, Census Tract 5116.09, Santa Clara County, California",0,0,0
1000000US060855116091036,060855116091036,"Block 1036, Block Group 1, Census Tract 5116.09, Santa Clara County, California",0,0,0
1000000US060855116091037,060855116091037,"Block 1037, Block Group 1, Census Tract 5116.09, Santa Clara County, California",0,0,0
1000000US060855116091038,060855116091038,"Block 1038, Block Group 1, Census Tract 5116.09, Santa Clara County, California",0,0,0
1000000US060855116091039,060855116091039,"Block 1039, Block Group 1, Census Tract 5116.09, Santa Clara County, California",0,0,0
1000000US060855116091040,060855116091040,"Block 1040, Block Group 1, Census Tract 5116.09, Santa Clara County, California",0,0,0
1000000US060855116091041,060855116091041,"Block 1041, Block Group 1, Census Tract 5116.09, Santa Clara County, California",0,0,0
1000000US060855116091042,060855116091042,"Block 1042, Block Group 1, Census Tract 5116.09, Santa Clara County, California",0,0,0
1000000US060855116091043,060855116091043,"Block 1043, Block Group 1, Census Tract 5116.09, Santa Clara County, California",0,0,0
1000000US060855116091044,060855116091044,"Block 1044, Block Group 1, Census Tract 5116.09, Santa Clara County, California",0,0,0
1000000US060855116091045,060855116091045,"Block 1045, Block Group 1, Census Tract 5116.09, Santa Clara County, California",0,0,0
1000000US060855116091046,060855116091046,"Block 1046, Block Group 1, Census Tract 5116.09, Santa Clara County, California",0,0,0
1000000US060855116091047,060855116091047,"Block 1047, Block Group 1, Census Tract 5116.09, Santa Clara County, California",0,0,0
1000000US060855116091048,060855116091048,"Block 1048, Block Group 1, Census Tract 5116.09, Santa Clara County, California",0,0,0
1000000US060855116091049,060855116091049,"Block 1049, Block Group 1, Census Tract 5116.09, Santa Clara County, California",0,0,0
1000000US060855116091050,060855116091050,"Block 1050, Block Group 1, Census Tract 5116.09, Santa Clara County, California",0,0,0
1000000US060855116091051,060855116091051,"Block 1051, Block Group 1, Census Tract 5116.09, Santa Clara County, California",25,25,0
1000000US060855116091052,060855116091052,"Block 1052, Block Group 1, Census Tract 5116.09, Santa Clara County, California",4,2,2
1000000US060855116091053,060855116091053,"Block 1053, Block Group 1, Census Tract 5116.09, Santa Clara County, California",0,0,0
1000000US060855116091054,060855116091054,"Block 1054, Block Group 1, Census Tract 5116.09, Santa Clara County, California",0,0,0
1000000US060855116091055,060855116091055,"Block 1055, Block Group 1, Census Tract 5116.09, Santa Clara County, California",0,0,0
1000000US060855116091056,060855116091056,"Block 1056, Block Group 1, Census Tract 5116.09, Santa Clara County, California",0,0,0
1000000US060855116091057,060855116091057,"Block 1057, Block Group 1, Census Tract 5116.09, Santa Clara County, California",0,0,0
1000000US060855116091058,060855116091058,"Block 1058, Block Group 1, Census Tract 5116.09, Santa Clara County, California",0,0,0
1000000US060855117011000,060855117011000,"Block 1000, Block Group 1, Census Tract 5117.01, Santa Clara County, California",4,4,0
1000000US060855117011001,060855117011001,"Block 1001, Block Group 1, Census Tract 5117.01, Santa Clara County, California",0,0,0
1000000US060855117011002,060855117011002,"Block 1002, Block Group 1, Census Tract 5117.01, Santa Clara County, California",0,0,0
1000000US060855117011003,060855117011003,"Block 1003, Block Group 1, Census Tract 5117.01, Santa Clara County, California",0,0,0
1000000US060855117011004,060855117011004,"Block 1004, Block Group 1, Census Tract 5117.01, Santa Clara County, California",0,0,0
1000000US060855117011005,060855117011005,"Block 1005, Block Group 1, Census Tract 5117.01, Santa Clara County, California",0,0,0
1000000US060855117011006,060855117011006,"Block 1006, Block Group 1, Census Tract 5117.01, Santa Clara County, California",18,17,1
1000000US060855117011007,060855117011007,"Block 1007, Block Group 1, Census Tract 5117.01, Santa Clara County, California",6,6,0
1000000US060855117011008,060855117011008,"Block 1008, Block Group 1, Census Tract 5117.01, Santa Clara County, California",33,33,0
1000000US060855117011009,060855117011009,"Block 1009, Block Group 1, Census Tract 5117.01, Santa Clara County, California",0,0,0
1000000US060855117011010,060855117011010,"Block 1010, Block Group 1, Census Tract 5117.01, Santa Clara County, California",16,15,1
1000000US060855117011011,060855117011011,"Block 1011, Block Group 1, Census Tract 5117.01, Santa Clara County, California",13,13,0
1000000US060855117011012,060855117011012,"Block 1012, Block Group 1, Census Tract 5117.01, Santa Clara County, California",79,72,7
1000000US060855117011013,060855117011013,"Block 1013, Block Group 1, Census Tract 5117.01, Santa Clara County, California",5,4,1
1000000US060855117011014,060855117011014,"Block 1014, Block Group 1, Census Tract 5117.01, Santa Clara County, California",1,0,1
1000000US060855117011015,060855117011015,"Block 1015, Block Group 1, Census Tract 5117.01, Santa Clara County, California",7,6,1
1000000US060855117011016,060855117011016,"Block 1016, Block Group 1, Census Tract 5117.01, Santa Clara County, California",9,9,0
1000000US060855117011017,060855117011017,"Block 1017, Block Group 1, Census Tract 5117.01, Santa Clara County, California",59,56,3
1000000US060855117011018,060855117011018,"Block 1018, Block Group 1, Census Tract 5117.01, Santa Clara County, California",14,14,0
1000000US060855117011019,060855117011019,"Block 1019, Block Group 1, Census Tract 5117.01, Santa Clara County, California",0,0,0
1000000US060855117011020,060855117011020,"Block 1020, Block Group 1, Census Tract 5117.01, Santa Clara County, California",0,0,0
1000000US060855117011021,060855117011021,"Block 1021, Block Group 1, Census Tract 5117.01, Santa Clara County, California",54,54,0
1000000US060855117011022,060855117011022,"Block 1022, Block Group 1, Census Tract 5117.01, Santa Clara County, California",20,19,1
1000000US060855117011023,060855117011023,"Block 1023, Block Group 1, Census Tract 5117.01, Santa Clara County, California",5,5,0
1000000US060855117011024,060855117011024,"Block 1024, Block Group 1, Census Tract 5117.01, Santa Clara County, California",6,6,0
1000000US060855117011025,060855117011025,"Block 1025, Block Group 1, Census Tract 5117.01, Santa Clara County, California",9,9,0
1000000US060855117011026,060855117011026,"Block 1026, Block Group 1, Census Tract 5117.01, Santa Clara County, California",1,0,1
1000000US060855117011027,060855117011027,"Block 1027, Block Group 1, Census Tract 5117.01, Santa Clara County, California",43,41,2
1000000US060855117011028,060855117011028,"Block 1028, Block Group 1, Census Tract 5117.01, Santa Clara County, California",11,11,0
1000000US060855117011029,060855117011029,"Block 1029, Block Group 1, Census Tract 5117.01, Santa Clara County, California",0,0,0
1000000US060855117011030,060855117011030,"Block 1030, Block Group 1, Census Tract 5117.01, Santa Clara County, California",28,22,6
1000000US060855117011031,060855117011031,"Block 1031, Block Group 1, Census Tract 5117.01, Santa Clara County, California",3,3,0
1000000US060855117011032,060855117011032,"Block 1032, Block Group 1, Census Tract 5117.01, Santa Clara County, California",0,0,0
1000000US060855117011033,060855117011033,"Block 1033, Block Group 1, Census Tract 5117.01, Santa Clara County, California",0,0,0
1000000US060855117011034,060855117011034,"Block 1034, Block Group 1, Census Tract 5117.01, Santa Clara County, California",6,6,0
1000000US060855117012000,060855117012000,"Block 2000, Block Group 2, Census Tract 5117.01, Santa Clara County, California",7,6,1
1000000US060855117012001,060855117012001,"Block 2001, Block Group 2, Census Tract 5117.01, Santa Clara County, California",53,50,3
1000000US060855117012002,060855117012002,"Block 2002, Block Group 2, Census Tract 5117.01, Santa Clara County, California",141,129,12
1000000US060855117012003,060855117012003,"Block 2003, Block Group 2, Census Tract 5117.01, Santa Clara County, California",0,0,0
1000000US060855117012004,060855117012004,"Block 2004, Block Group 2, Census Tract 5117.01, Santa Clara County, California",0,0,0
1000000US060855117012005,060855117012005,"Block 2005, Block Group 2, Census Tract 5117.01, Santa Clara County, California",2,1,1
1000000US060855117012006,060855117012006,"Block 2006, Block Group 2, Census Tract 5117.01, Santa Clara County, California",2,2,0
1000000US060855117012007,060855117012007,"Block 2007, Block Group 2, Census Tract 5117.01, Santa Clara County, California",1,1,0
1000000US060855117012008,060855117012008,"Block 2008, Block Group 2, Census Tract 5117.01, Santa Clara County, California",0,0,0
1000000US060855117012009,060855117012009,"Block 2009, Block Group 2, Census Tract 5117.01, Santa Clara County, California",4,3,1
1000000US060855117012010,060855117012010,"Block 2010, Block Group 2, Census Tract 5117.01, Santa Clara County, California",24,22,2
1000000US060855117012011,060855117012011,"Block 2011, Block Group 2, Census Tract 5117.01, Santa Clara County, California",1,1,0
1000000US060855117012012,060855117012012,"Block 2012, Block Group 2, Census Tract 5117.01, Santa Clara County, California",0,0,0
1000000US060855117012013,060855117012013,"Block 2013, Block Group 2, Census Tract 5117.01, Santa Clara County, California",23,20,3
1000000US060855117012014,060855117012014,"Block 2014, Block Group 2, Census Tract 5117.01, Santa Clara County, California",1,1,0
1000000US060855117012015,060855117012015,"Block 2015, Block Group 2, Census Tract 5117.01, Santa Clara County, California",22,21,1
1000000US060855117012016,060855117012016,"Block 2016, Block Group 2, Census Tract 5117.01, Santa Clara County, California",7,7,0
1000000US060855117012017,060855117012017,"Block 2017, Block Group 2, Census Tract 5117.01, Santa Clara County, California",0,0,0
1000000US060855117012018,060855117012018,"Block 2018, Block Group 2, Census Tract 5117.01, Santa Clara County, California",10,9,1
1000000US060855117012019,060855117012019,"Block 2019, Block Group 2, Census Tract 5117.01, Santa Clara County, California",0,0,0
1000000US060855117012020,060855117012020,"Block 2020, Block Group 2, Census Tract 5117.01, Santa Clara County, California",111,103,8
1000000US060855117012021,060855117012021,"Block 2021, Block Group 2, Census Tract 5117.01, Santa Clara County, California",12,11,1
1000000US060855117012022,060855117012022,"Block 2022, Block Group 2, Census Tract 5117.01, Santa Clara County, California",12,11,1
1000000US060855117012023,060855117012023,"Block 2023, Block Group 2, Census Tract 5117.01, Santa Clara County, California",0,0,0
1000000US060855117012024,060855117012024,"Block 2024, Block Group 2, Census Tract 5117.01, Santa Clara County, California",5,4,1
1000000US060855117012025,060855117012025,"Block 2025, Block Group 2, Census Tract 5117.01, Santa Clara County, California",20,18,2
1000000US060855117012026,060855117012026,"Block 2026, Block Group 2, Census Tract 5117.01, Santa Clara County, California",2,1,1
1000000US060855117012027,060855117012027,"Block 2027, Block Group 2, Census Tract 5117.01, Santa Clara County, California",27,24,3
1000000US060855117012028,060855117012028,"Block 2028, Block Group 2, Census Tract 5117.01, Santa Clara County, California",12,12,0
1000000US060855117012029,060855117012029,"Block 2029, Block Group 2, Census Tract 5117.01, Santa Clara County, California",0,0,0
1000000US060855117012030,060855117012030,"Block 2030, Block Group 2, Census Tract 5117.01, Santa Clara County, California",0,0,0
1000000US060855117012031,060855117012031,"Block 2031, Block Group 2, Census Tract 5117.01, Santa Clara County, California",0,0,0
1000000US060855117012032,060855117012032,"Block 2032, Block Group 2, Census Tract 5117.01, Santa Clara County, California",0,0,0
1000000US060855117012033,060855117012033,"Block 2033, Block Group 2, Census Tract 5117.01, Santa Clara County, California",0,0,0
1000000US060855117012034,060855117012034,"Block 2034, Block Group 2, Census Tract 5117.01, Santa Clara County, California",0,0,0
1000000US060855117012035,060855117012035,"Block 2035, Block Group 2, Census Tract 5117.01, Santa Clara County, California",90,87,3
1000000US060855117012036,060855117012036,"Block 2036, Block Group 2, Census Tract 5117.01, Santa Clara County, California",3,3,0
1000000US060855117012037,060855117012037,"Block 2037, Block Group 2, Census Tract 5117.01, Santa Clara County, California",14,12,2
1000000US060855117012038,060855117012038,"Block 2038, Block Group 2, Census Tract 5117.01, Santa Clara County, California",7,7,0
1000000US060855117012039,060855117012039,"Block 2039, Block Group 2, Census Tract 5117.01, Santa Clara County, California",56,51,5
1000000US060855117012040,060855117012040,"Block 2040, Block Group 2, Census Tract 5117.01, Santa Clara County, California",13,12,1
1000000US060855117012041,060855117012041,"Block 2041, Block Group 2, Census Tract 5117.01, Santa Clara County, California",9,8,1
1000000US060855117012042,060855117012042,"Block 2042, Block Group 2, Census Tract 5117.01, Santa Clara County, California",0,0,0
1000000US060855117012043,060855117012043,"Block 2043, Block Group 2, Census Tract 5117.01, Santa Clara County, California",20,19,1
1000000US060855117013000,060855117013000,"Block 3000, Block Group 3, Census Tract 5117.01, Santa Clara County, California",46,45,1
1000000US060855117013001,060855117013001,"Block 3001, Block Group 3, Census Tract 5117.01, Santa Clara County, California",2,2,0
1000000US060855117013002,060855117013002,"Block 3002, Block Group 3, Census Tract 5117.01, Santa Clara County, California",1,1,0
1000000US060855117013003,060855117013003,"Block 3003, Block Group 3, Census Tract 5117.01, Santa Clara County, California",1,1,0
1000000US060855117013004,060855117013004,"Block 3004, Block Group 3, Census Tract 5117.01, Santa Clara County, California",90,84,6
1000000US060855117013005,060855117013005,"Block 3005, Block Group 3, Census Tract 5117.01, Santa Clara County, California",45,42,3
1000000US060855117013006,060855117013006,"Block 3006, Block Group 3, Census Tract 5117.01, Santa Clara County, California",9,9,0
1000000US060855117013007,060855117013007,"Block 3007, Block Group 3, Census Tract 5117.01, Santa Clara County, California",12,11,1
1000000US060855117013008,060855117013008,"Block 3008, Block Group 3, Census Tract 5117.01, Santa Clara County, California",0,0,0
1000000US060855117013009,060855117013009,"Block 3009, Block Group 3, Census Tract 5117.01, Santa Clara County, California",2,2,0
1000000US060855117013010,060855117013010,"Block 3010, Block Group 3, Census Tract 5117.01, Santa Clara County, California",0,0,0
1000000US060855117013011,060855117013011,"Block 3011, Block Group 3, Census Tract 5117.01, Santa Clara County, California",13,13,0
1000000US060855117013012,060855117013012,"Block 3012, Block Group 3, Census Tract 5117.01, Santa Clara County, California",43,42,1
1000000US060855117013013,060855117013013,"Block 3013, Block Group 3, Census Tract 5117.01, Santa Clara County, California",6,6,0
1000000US060855117013014,060855117013014,"Block 3014, Block Group 3, Census Tract 5117.01, Santa Clara County, California",72,71,1
1000000US060855117013015,060855117013015,"Block 3015, Block Group 3, Census Tract 5117.01, Santa Clara County, California",1,0,1
1000000US060855117013016,060855117013016,"Block 3016, Block Group 3, Census Tract 5117.01, Santa Clara County, California",4,4,0
1000000US060855117013017,060855117013017,"Block 3017, Block Group 3, Census Tract 5117.01, Santa Clara County, California",1,1,0
1000000US060855117013018,060855117013018,"Block 3018, Block Group 3, Census Tract 5117.01, Santa Clara County, California",6,5,1
1000000US060855117013019,060855117013019,"Block 3019, Block Group 3, Census Tract 5117.01, Santa Clara County, California",1,1,0
1000000US060855117013020,060855117013020,"Block 3020, Block Group 3, Census Tract 5117.01, Santa Clara County, California",0,0,0
1000000US060855117013021,060855117013021,"Block 3021, Block Group 3, Census Tract 5117.01, Santa Clara County, California",0,0,0
1000000US060855117013022,060855117013022,"Block 3022, Block Group 3, Census Tract 5117.01, Santa Clara County, California",0,0,0
1000000US060855117013023,060855117013023,"Block 3023, Block Group 3, Census Tract 5117.01, Santa Clara County, California",0,0,0
1000000US060855117013024,060855117013024,"Block 3024, Block Group 3, Census Tract 5117.01, Santa Clara County, California",6,6,0
1000000US060855117013025,060855117013025,"Block 3025, Block Group 3, Census Tract 5117.01, Santa Clara County, California",0,0,0
1000000US060855117021000,060855117021000,"Block 1000, Block Group 1, Census Tract 5117.02, Santa Clara County, California",70,67,3
1000000US060855117021001,060855117021001,"Block 1001, Block Group 1, Census Tract 5117.02, Santa Clara County, California",13,13,0
1000000US060855117021002,060855117021002,"Block 1002, Block Group 1, Census Tract 5117.02, Santa Clara County, California",11,11,0
1000000US060855117021003,060855117021003,"Block 1003, Block Group 1, Census Tract 5117.02, Santa Clara County, California",111,106,5
1000000US060855117021004,060855117021004,"Block 1004, Block Group 1, Census Tract 5117.02, Santa Clara County, California",0,0,0
1000000US060855117021005,060855117021005,"Block 1005, Block Group 1, Census Tract 5117.02, Santa Clara County, California",36,34,2
1000000US060855117021006,060855117021006,"Block 1006, Block Group 1, Census Tract 5117.02, Santa Clara County, California",0,0,0
1000000US060855117021007,060855117021007,"Block 1007, Block Group 1, Census Tract 5117.02, Santa Clara County, California",57,56,1
1000000US060855117021008,060855117021008,"Block 1008, Block Group 1, Census Tract 5117.02, Santa Clara County, California",0,0,0
1000000US060855117021009,060855117021009,"Block 1009, Block Group 1, Census Tract 5117.02, Santa Clara County, California",2,1,1
1000000US060855117021010,060855117021010,"Block 1010, Block Group 1, Census Tract 5117.02, Santa Clara County, California",17,16,1
1000000US060855117021011,060855117021011,"Block 1011, Block Group 1, Census Tract 5117.02, Santa Clara County, California",7,6,1
1000000US060855117021012,060855117021012,"Block 1012, Block Group 1, Census Tract 5117.02, Santa Clara County, California",0,0,0
1000000US060855117021013,060855117021013,"Block 1013, Block Group 1, Census Tract 5117.02, Santa Clara County, California",0,0,0
1000000US060855117021014,060855117021014,"Block 1014, Block Group 1, Census Tract 5117.02, Santa Clara County, California",121,116,5
1000000US060855117021015,060855117021015,"Block 1015, Block Group 1, Census Tract 5117.02, Santa Clara County, California",0,0,0
1000000US060855117021016,060855117021016,"Block 1016, Block Group 1, Census Tract 5117.02, Santa Clara County, California",6,6,0
1000000US060855117021017,060855117021017,"Block 1017, Block Group 1, Census Tract 5117.02, Santa Clara County, California",13,12,1
1000000US060855117021018,060855117021018,"Block 1018, Block Group 1, Census Tract 5117.02, Santa Clara County, California",44,40,4
1000000US060855117021019,060855117021019,"Block 1019, Block Group 1, Census Tract 5117.02, Santa Clara County, California",5,5,0
1000000US060855117021020,060855117021020,"Block 1020, Block Group 1, Census Tract 5117.02, Santa Clara County, California",28,26,2
1000000US060855117021021,060855117021021,"Block 1021, Block Group 1, Census Tract 5117.02, Santa Clara County, California",26,24,2
1000000US060855117021022,060855117021022,"Block 1022, Block Group 1, Census Tract 5117.02, Santa Clara County, California",64,62,2
1000000US060855117021023,060855117021023,"Block 1023, Block Group 1, Census Tract 5117.02, Santa Clara County, California",58,57,1
1000000US060855117021024,060855117021024,"Block 1024, Block Group 1, Census Tract 5117.02, Santa Clara County, California",9,8,1
1000000US060855117022000,060855117022000,"Block 2000, Block Group 2, Census Tract 5117.02, Santa Clara County, California",0,0,0
1000000US060855117022001,060855117022001,"Block 2001, Block Group 2, Census Tract 5117.02, Santa Clara County, California",0,0,0
1000000US060855117022002,060855117022002,"Block 2002, Block Group 2, Census Tract 5117.02, Santa Clara County, California",84,82,2
1000000US060855117022003,060855117022003,"Block 2003, Block Group 2, Census Tract 5117.02, Santa Clara County, California",19,19,0
1000000US060855117022004,060855117022004,"Block 2004, Block Group 2, Census Tract 5117.02, Santa Clara County, California",21,18,3
1000000US060855117022005,060855117022005,"Block 2005, Block Group 2, Census Tract 5117.02, Santa Clara County, California",19,18,1
1000000US060855117022006,060855117022006,"Block 2006, Block Group 2, Census Tract 5117.02, Santa Clara County, California",27,27,0
1000000US060855117022007,060855117022007,"Block 2007, Block Group 2, Census Tract 5117.02, Santa Clara County, California",11,11,0
1000000US060855117022008,060855117022008,"Block 2008, Block Group 2, Census Tract 5117.02, Santa Clara County, California",36,36,0
1000000US060855117022009,060855117022009,"Block 2009, Block Group 2, Census Tract 5117.02, Santa Clara County, California",48,48,0
1000000US060855117022010,060855117022010,"Block 2010, Block Group 2, Census Tract 5117.02, Santa Clara County, California",0,0,0
1000000US060855117022011,060855117022011,"Block 2011, Block Group 2, Census Tract 5117.02, Santa Clara County, California",18,18,0
1000000US060855117041000,060855117041000,"Block 1000, Block Group 1, Census Tract 5117.04, Santa Clara County, California",0,0,0
1000000US060855117041001,060855117041001,"Block 1001, Block Group 1, Census Tract 5117.04, Santa Clara County, California",0,0,0
1000000US060855117041002,060855117041002,"Block 1002, Block Group 1, Census Tract 5117.04, Santa Clara County, California",0,0,0
1000000US060855117041003,060855117041003,"Block 1003, Block Group 1, Census Tract 5117.04, Santa Clara County, California",0,0,0
1000000US060855117041004,060855117041004,"Block 1004, Block Group 1, Census Tract 5117.04, Santa Clara County, California",286,270,16
1000000US060855117041005,060855117041005,"Block 1005, Block Group 1, Census Tract 5117.04, Santa Clara County, California",28,26,2
1000000US060855117041006,060855117041006,"Block 1006, Block Group 1, Census Tract 5117.04, Santa Clara County, California",0,0,0
1000000US060855117041007,060855117041007,"Block 1007, Block Group 1, Census Tract 5117.04, Santa Clara County, California",5,5,0
1000000US060855117041008,060855117041008,"Block 1008, Block Group 1, Census Tract 5117.04, Santa Clara County, California",0,0,0
1000000US060855117041009,060855117041009,"Block 1009, Block Group 1, Census Tract 5117.04, Santa Clara County, California",0,0,0
1000000US060855117041010,060855117041010,"Block 1010, Block Group 1, Census Tract 5117.04, Santa Clara County, California",0,0,0
1000000US060855117041011,060855117041011,"Block 1011, Block Group 1, Census Tract 5117.04, Santa Clara County, California",0,0,0
1000000US060855117041012,060855117041012,"Block 1012, Block Group 1, Census Tract 5117.04, Santa Clara County, California",2,2,0
1000000US060855117041013,060855117041013,"Block 1013, Block Group 1, Census Tract 5117.04, Santa Clara County, California",28,24,4
1000000US060855117041014,060855117041014,"Block 1014, Block Group 1, Census Tract 5117.04, Santa Clara County, California",10,9,1
1000000US060855117041015,060855117041015,"Block 1015, Block Group 1, Census Tract 5117.04, Santa Clara County, California",46,42,4
1000000US060855117041016,060855117041016,"Block 1016, Block Group 1, Census Tract 5117.04, Santa Clara County, California",2,2,0
1000000US060855117041017,060855117041017,"Block 1017, Block Group 1, Census Tract 5117.04, Santa Clara County, California",5,5,0
1000000US060855117041018,060855117041018,"Block 1018, Block Group 1, Census Tract 5117.04, Santa Clara County, California",0,0,0
1000000US060855117041019,060855117041019,"Block 1019, Block Group 1, Census Tract 5117.04, Santa Clara County, California",4,4,0
1000000US060855117041020,060855117041020,"Block 1020, Block Group 1, Census Tract 5117.04, Santa Clara County, California",48,43,5
1000000US060855117041021,060855117041021,"Block 1021, Block Group 1, Census Tract 5117.04, Santa Clara County, California",0,0,0
1000000US060855117041022,060855117041022,"Block 1022, Block Group 1, Census Tract 5117.04, Santa Clara County, California",60,57,3
1000000US060855117041023,060855117041023,"Block 1023, Block Group 1, Census Tract 5117.04, Santa Clara County, California",9,7,2
1000000US060855117041024,060855117041024,"Block 1024, Block Group 1, Census Tract 5117.04, Santa Clara County, California",0,0,0
1000000US060855117041025,060855117041025,"Block 1025, Block Group 1, Census Tract 5117.04, Santa Clara County, California",27,25,2
1000000US060855117041026,060855117041026,"Block 1026, Block Group 1, Census Tract 5117.04, Santa Clara County, California",10,10,0
1000000US060855117041027,060855117041027,"Block 1027, Block Group 1, Census Tract 5117.04, Santa Clara County, California",4,4,0
1000000US060855117041028,060855117041028,"Block 1028, Block Group 1, Census Tract 5117.04, Santa Clara County, California",3,3,0
1000000US060855117041029,060855117041029,"Block 1029, Block Group 1, Census Tract 5117.04, Santa Clara County, California",103,99,4
1000000US060855117041030,060855117041030,"Block 1030, Block Group 1, Census Tract 5117.04, Santa Clara County, California",16,16,0
1000000US060855117041031,060855117041031,"Block 1031, Block Group 1, Census Tract 5117.04, Santa Clara County, California",18,16,2
1000000US060855117041032,060855117041032,"Block 1032, Block Group 1, Census Tract 5117.04, Santa Clara County, California",4,4,0
1000000US060855117041033,060855117041033,"Block 1033, Block Group 1, Census Tract 5117.04, Santa Clara County, California",42,42,0
1000000US060855117041034,060855117041034,"Block 1034, Block Group 1, Census Tract 5117.04, Santa Clara County, California",7,7,0
1000000US060855117041035,060855117041035,"Block 1035, Block Group 1, Census Tract 5117.04, Santa Clara County, California",0,0,0
1000000US060855117041036,060855117041036,"Block 1036, Block Group 1, Census Tract 5117.04, Santa Clara County, California",0,0,0
1000000US060855117041037,060855117041037,"Block 1037, Block Group 1, Census Tract 5117.04, Santa Clara County, California",0,0,0
1000000US060855117041038,060855117041038,"Block 1038, Block Group 1, Census Tract 5117.04, Santa Clara County, California",0,0,0
1000000US060855117041039,060855117041039,"Block 1039, Block Group 1, Census Tract 5117.04, Santa Clara County, California",0,0,0
1000000US060855117041040,060855117041040,"Block 1040, Block Group 1, Census Tract 5117.04, Santa Clara County, California",6,6,0
1000000US060855117042000,060855117042000,"Block 2000, Block Group 2, Census Tract 5117.04, Santa Clara County, California",0,0,0
1000000US060855117042001,060855117042001,"Block 2001, Block Group 2, Census Tract 5117.04, Santa Clara County, California",0,0,0
1000000US060855117042002,060855117042002,"Block 2002, Block Group 2, Census Tract 5117.04, Santa Clara County, California",43,43,0
1000000US060855117042003,060855117042003,"Block 2003, Block Group 2, Census Tract 5117.04, Santa Clara County, California",5,5,0
1000000US060855117042004,060855117042004,"Block 2004, Block Group 2, Census Tract 5117.04, Santa Clara County, California",0,0,0
1000000US060855117042005,060855117042005,"Block 2005, Block Group 2, Census Tract 5117.04, Santa Clara County, California",0,0,0
1000000US060855117042006,060855117042006,"Block 2006, Block Group 2, Census Tract 5117.04, Santa Clara County, California",0,0,0
1000000US060855117042007,060855117042007,"Block 2007, Block Group 2, Census Tract 5117.04, Santa Clara County, California",33,32,1
1000000US060855117042008,060855117042008,"Block 2008, Block Group 2, Census Tract 5117.04, Santa Clara County, California",5,5,0
1000000US060855117042009,060855117042009,"Block 2009, Block Group 2, Census Tract 5117.04, Santa Clara County, California",8,7,1
1000000US060855117042010,060855117042010,"Block 2010, Block Group 2, Census Tract 5117.04, Santa Clara County, California",22,20,2
1000000US060855117042011,060855117042011,"Block 2011, Block Group 2, Census Tract 5117.04, Santa Clara County, California",1,1,0
1000000US060855117042012,060855117042012,"Block 2012, Block Group 2, Census Tract 5117.04, Santa Clara County, California",6,5,1
1000000US060855117042013,060855117042013,"Block 2013, Block Group 2, Census Tract 5117.04, Santa Clara County, California",1,1,0
1000000US060855117042014,060855117042014,"Block 2014, Block Group 2, Census Tract 5117.04, Santa Clara County, California",35,35,0
1000000US060855117042015,060855117042015,"Block 2015, Block Group 2, Census Tract 5117.04, Santa Clara County, California",1,1,0
1000000US060855117042016,060855117042016,"Block 2016, Block Group 2, Census Tract 5117.04, Santa Clara County, California",2,2,0
1000000US060855117042017,060855117042017,"Block 2017, Block Group 2, Census Tract 5117.04, Santa Clara County, California",0,0,0
1000000US060855117042018,060855117042018,"Block 2018, Block Group 2, Census Tract 5117.04, Santa Clara County, California",2,2,0
1000000US060855117042019,060855117042019,"Block 2019, Block Group 2, Census Tract 5117.04, Santa Clara County, California",30,29,1
1000000US060855117042020,060855117042020,"Block 2020, Block Group 2, Census Tract 5117.04, Santa Clara County, California",12,10,2
1000000US060855117042021,060855117042021,"Block 2021, Block Group 2, Census Tract 5117.04, Santa Clara County, California",10,9,1
1000000US060855117042022,060855117042022,"Block 2022, Block Group 2, Census Tract 5117.04, Santa Clara County, California",14,14,0
1000000US060855117042023,060855117042023,"Block 2023, Block Group 2, Census Tract 5117.04, Santa Clara County, California",14,14,0
1000000US060855117042024,060855117042024,"Block 2024, Block Group 2, Census Tract 5117.04, Santa Clara County, California",1,1,0
1000000US060855117043000,060855117043000,"Block 3000, Block Group 3, Census Tract 5117.04, Santa Clara County, California",0,0,0
1000000US060855117043001,060855117043001,"Block 3001, Block Group 3, Census Tract 5117.04, Santa Clara County, California",31,28,3
1000000US060855117043002,060855117043002,"Block 3002, Block Group 3, Census Tract 5117.04, Santa Clara County, California",7,6,1
1000000US060855117043003,060855117043003,"Block 3003, Block Group 3, Census Tract 5117.04, Santa Clara County, California",8,7,1
1000000US060855117043004,060855117043004,"Block 3004, Block Group 3, Census Tract 5117.04, Santa Clara County, California",20,19,1
1000000US060855117043005,060855117043005,"Block 3005, Block Group 3, Census Tract 5117.04, Santa Clara County, California",43,40,3
1000000US060855117043006,060855117043006,"Block 3006, Block Group 3, Census Tract 5117.04, Santa Clara County, California",0,0,0
1000000US060855117043007,060855117043007,"Block 3007, Block Group 3, Census Tract 5117.04, Santa Clara County, California",2,1,1
1000000US060855117043008,060855117043008,"Block 3008, Block Group 3, Census Tract 5117.04, Santa Clara County, California",18,18,0
1000000US060855117043009,060855117043009,"Block 3009, Block Group 3, Census Tract 5117.04, Santa Clara County, California",42,42,0
1000000US060855117043010,060855117043010,"Block 3010, Block Group 3, Census Tract 5117.04, Santa Clara County, California",1,0,1
1000000US060855117043011,060855117043011,"Block 3011, Block Group 3, Census Tract 5117.04, Santa Clara County, California",71,66,5
1000000US060855117043012,060855117043012,"Block 3012, Block Group 3, Census Tract 5117.04, Santa Clara County, California",31,30,1
1000000US060855117043013,060855117043013,"Block 3013, Block Group 3, Census Tract 5117.04, Santa Clara County, California",3,3,0
1000000US060855117043014,060855117043014,"Block 3014, Block Group 3, Census Tract 5117.04, Santa Clara County, California",3,3,0
1000000US060855117043015,060855117043015,"Block 3015, Block Group 3, Census Tract 5117.04, Santa Clara County, California",17,15,2
1000000US060855117043016,060855117043016,"Block 3016, Block Group 3, Census Tract 5117.04, Santa Clara County, California",9,9,0
1000000US060855117043017,060855117043017,"Block 3017, Block Group 3, Census Tract 5117.04, Santa Clara County, California",10,9,1
1000000US060855117043018,060855117043018,"Block 3018, Block Group 3, Census Tract 5117.04, Santa Clara County, California",0,0,0
1000000US060855117043019,060855117043019,"Block 3019, Block Group 3, Census Tract 5117.04, Santa Clara County, California",2,2,0
1000000US060855117043020,060855117043020,"Block 3020, Block Group 3, Census Tract 5117.04, Santa Clara County, California",37,36,1
1000000US060855117043021,060855117043021,"Block 3021, Block Group 3, Census Tract 5117.04, Santa Clara County, California",0,0,0
1000000US060855117043022,060855117043022,"Block 3022, Block Group 3, Census Tract 5117.04, Santa Clara County, California",32,31,1
1000000US060855117043023,060855117043023,"Block 3023, Block Group 3, Census Tract 5117.04, Santa Clara County, California",12,11,1
1000000US060855117043024,060855117043024,"Block 3024, Block Group 3, Census Tract 5117.04, Santa Clara County, California",77,75,2
1000000US060855117043025,060855117043025,"Block 3025, Block Group 3, Census Tract 5117.04, Santa Clara County, California",72,69,3
1000000US060855117043026,060855117043026,"Block 3026, Block Group 3, Census Tract 5117.04, Santa Clara County, California",3,2,1
1000000US060855117043027,060855117043027,"Block 3027, Block Group 3, Census Tract 5117.04, Santa Clara County, California",8,7,1
1000000US060855117043028,060855117043028,"Block 3028, Block Group 3, Census Tract 5117.04, Santa Clara County, California",24,22,2
1000000US060855117043029,060855117043029,"Block 3029, Block Group 3, Census Tract 5117.04, Santa Clara County, California",31,30,1
1000000US060855117043030,060855117043030,"Block 3030, Block Group 3, Census Tract 5117.04, Santa Clara County, California",8,8,0
1000000US060855117043031,060855117043031,"Block 3031, Block Group 3, Census Tract 5117.04, Santa Clara County, California",0,0,0
1000000US060855117043032,060855117043032,"Block 3032, Block Group 3, Census Tract 5117.04, Santa Clara County, California",1,1,0
1000000US060855117043033,060855117043033,"Block 3033, Block Group 3, Census Tract 5117.04, Santa Clara County, California",8,8,0
1000000US060855117043034,060855117043034,"Block 3034, Block Group 3, Census Tract 5117.04, Santa Clara County, California",5,4,1
1000000US060855117043035,060855117043035,"Block 3035, Block Group 3, Census Tract 5117.04, Santa Clara County, California",2,2,0
1000000US060855117043036,060855117043036,"Block 3036, Block Group 3, Census Tract 5117.04, Santa Clara County, California",13,12,1
1000000US060855117043037,060855117043037,"Block 3037, Block Group 3, Census Tract 5117.04, Santa Clara County, California",13,11,2
1000000US060855117043038,060855117043038,"Block 3038, Block Group 3, Census Tract 5117.04, Santa Clara County, California",2,2,0
1000000US060855117043039,060855117043039,"Block 3039, Block Group 3, Census Tract 5117.04, Santa Clara County, California",23,23,0
1000000US060855117043040,060855117043040,"Block 3040, Block Group 3, Census Tract 5117.04, Santa Clara County, California",0,0,0
1000000US060855117051000,060855117051000,"Block 1000, Block Group 1, Census Tract 5117.05, Santa Clara County, California",0,0,0
1000000US060855117051001,060855117051001,"Block 1001, Block Group 1, Census Tract 5117.05, Santa Clara County, California",0,0,0
1000000US060855117051002,060855117051002,"Block 1002, Block Group 1, Census Tract 5117.05, Santa Clara County, California",0,0,0
1000000US060855117051003,060855117051003,"Block 1003, Block Group 1, Census Tract 5117.05, Santa Clara County, California",0,0,0
1000000US060855117051004,060855117051004,"Block 1004, Block Group 1, Census Tract 5117.05, Santa Clara County, California",0,0,0
1000000US060855117051005,060855117051005,"Block 1005, Block Group 1, Census Tract 5117.05, Santa Clara County, California",0,0,0
1000000US060855117051006,060855117051006,"Block 1006, Block Group 1, Census Tract 5117.05, Santa Clara County, California",0,0,0
1000000US060855117051007,060855117051007,"Block 1007, Block Group 1, Census Tract 5117.05, Santa Clara County, California",1,1,0
1000000US060855117051008,060855117051008,"Block 1008, Block Group 1, Census Tract 5117.05, Santa Clara County, California",12,11,1
1000000US060855117051009,060855117051009,"Block 1009, Block Group 1, Census Tract 5117.05, Santa Clara County, California",0,0,0
1000000US060855117051010,060855117051010,"Block 1010, Block Group 1, Census Tract 5117.05, Santa Clara County, California",0,0,0
1000000US060855117051011,060855117051011,"Block 1011, Block Group 1, Census Tract 5117.05, Santa Clara County, California",0,0,0
1000000US060855117051012,060855117051012,"Block 1012, Block Group 1, Census Tract 5117.05, Santa Clara County, California",0,0,0
1000000US060855117051013,060855117051013,"Block 1013, Block Group 1, Census Tract 5117.05, Santa Clara County, California",80,75,5
1000000US060855117051014,060855117051014,"Block 1014, Block Group 1, Census Tract 5117.05, Santa Clara County, California",0,0,0
1000000US060855117051015,060855117051015,"Block 1015, Block Group 1, Census Tract 5117.05, Santa Clara County, California",0,0,0
1000000US060855117051016,060855117051016,"Block 1016, Block Group 1, Census Tract 5117.05, Santa Clara County, California",51,51,0
1000000US060855117051017,060855117051017,"Block 1017, Block Group 1, Census Tract 5117.05, Santa Clara County, California",0,0,0
1000000US060855117051018,060855117051018,"Block 1018, Block Group 1, Census Tract 5117.05, Santa Clara County, California",0,0,0
1000000US060855117051019,060855117051019,"Block 1019, Block Group 1, Census Tract 5117.05, Santa Clara County, California",0,0,0
1000000US060855117051020,060855117051020,"Block 1020, Block Group 1, Census Tract 5117.05, Santa Clara County, California",0,0,0
1000000US060855117051021,060855117051021,"Block 1021, Block Group 1, Census Tract 5117.05, Santa Clara County, California",1,1,0
1000000US060855117051022,060855117051022,"Block 1022, Block Group 1, Census Tract 5117.05, Santa Clara County, California",0,0,0
1000000US060855117051023,060855117051023,"Block 1023, Block Group 1, Census Tract 5117.05, Santa Clara County, California",11,11,0
1000000US060855117051024,060855117051024,"Block 1024, Block Group 1, Census Tract 5117.05, Santa Clara County, California",2,2,0
1000000US060855117051025,060855117051025,"Block 1025, Block Group 1, Census Tract 5117.05, Santa Clara County, California",0,0,0
1000000US060855117051026,060855117051026,"Block 1026, Block Group 1, Census Tract 5117.05, Santa Clara County, California",0,0,0
1000000US060855117051027,060855117051027,"Block 1027, Block Group 1, Census Tract 5117.05, Santa Clara County, California",0,0,0
1000000US060855117051028,060855117051028,"Block 1028, Block Group 1, Census Tract 5117.05, Santa Clara County, California",82,77,5
1000000US060855117051029,060855117051029,"Block 1029, Block Group 1, Census Tract 5117.05, Santa Clara County, California",7,7,0
1000000US060855117051030,060855117051030,"Block 1030, Block Group 1, Census Tract 5117.05, Santa Clara County, California",7,7,0
1000000US060855117051031,060855117051031,"Block 1031, Block Group 1, Census Tract 5117.05, Santa Clara County, California",31,30,1
1000000US060855117051032,060855117051032,"Block 1032, Block Group 1, Census Tract 5117.05, Santa Clara County, California",0,0,0
1000000US060855117051033,060855117051033,"Block 1033, Block Group 1, Census Tract 5117.05, Santa Clara County, California",0,0,0
1000000US060855117051034,060855117051034,"Block 1034, Block Group 1, Census Tract 5117.05, Santa Clara County, California",0,0,0
1000000US060855117051035,060855117051035,"Block 1035, Block Group 1, Census Tract 5117.05, Santa Clara County, California",0,0,0
1000000US060855117051036,060855117051036,"Block 1036, Block Group 1, Census Tract 5117.05, Santa Clara County, California",0,0,0
1000000US060855117051037,060855117051037,"Block 1037, Block Group 1, Census Tract 5117.05, Santa Clara County, California",0,0,0
1000000US060855117051038,060855117051038,"Block 1038, Block Group 1, Census Tract 5117.05, Santa Clara County, California",0,0,0
1000000US060855117051039,060855117051039,"Block 1039, Block Group 1, Census Tract 5117.05, Santa Clara County, California",0,0,0
1000000US060855117051040,060855117051040,"Block 1040, Block Group 1, Census Tract 5117.05, Santa Clara County, California",0,0,0
1000000US060855117051041,060855117051041,"Block 1041, Block Group 1, Census Tract 5117.05, Santa Clara County, California",0,0,0
1000000US060855117051042,060855117051042,"Block 1042, Block Group 1, Census Tract 5117.05, Santa Clara County, California",0,0,0
1000000US060855117051043,060855117051043,"Block 1043, Block Group 1, Census Tract 5117.05, Santa Clara County, California",0,0,0
1000000US060855117051044,060855117051044,"Block 1044, Block Group 1, Census Tract 5117.05, Santa Clara County, California",0,0,0
1000000US060855117051045,060855117051045,"Block 1045, Block Group 1, Census Tract 5117.05, Santa Clara County, California",0,0,0
1000000US060855117051046,060855117051046,"Block 1046, Block Group 1, Census Tract 5117.05, Santa Clara County, California",1,1,0
1000000US060855117051047,060855117051047,"Block 1047, Block Group 1, Census Tract 5117.05, Santa Clara County, California",0,0,0
1000000US060855117051048,060855117051048,"Block 1048, Block Group 1, Census Tract 5117.05, Santa Clara County, California",0,0,0
1000000US060855117051049,060855117051049,"Block 1049, Block Group 1, Census Tract 5117.05, Santa Clara County, California",0,0,0
1000000US060855117051050,060855117051050,"Block 1050, Block Group 1, Census Tract 5117.05, Santa Clara County, California",0,0,0
1000000US060855117051051,060855117051051,"Block 1051, Block Group 1, Census Tract 5117.05, Santa Clara County, California",0,0,0
1000000US060855117051052,060855117051052,"Block 1052, Block Group 1, Census Tract 5117.05, Santa Clara County, California",0,0,0
1000000US060855117051053,060855117051053,"Block 1053, Block Group 1, Census Tract 5117.05, Santa Clara County, California",0,0,0
1000000US060855117051054,060855117051054,"Block 1054, Block Group 1, Census Tract 5117.05, Santa Clara County, California",0,0,0
1000000US060855117051055,060855117051055,"Block 1055, Block Group 1, Census Tract 5117.05, Santa Clara County, California",0,0,0
1000000US060855117051056,060855117051056,"Block 1056, Block Group 1, Census Tract 5117.05, Santa Clara County, California",0,0,0
1000000US060855117051057,060855117051057,"Block 1057, Block Group 1, Census Tract 5117.05, Santa Clara County, California",0,0,0
1000000US060855117051058,060855117051058,"Block 1058, Block Group 1, Census Tract 5117.05, Santa Clara County, California",0,0,0
1000000US060855117051059,060855117051059,"Block 1059, Block Group 1, Census Tract 5117.05, Santa Clara County, California",0,0,0
1000000US060855117051060,060855117051060,"Block 1060, Block Group 1, Census Tract 5117.05, Santa Clara County, California",0,0,0
1000000US060855117051061,060855117051061,"Block 1061, Block Group 1, Census Tract 5117.05, Santa Clara County, California",0,0,0
1000000US060855117051062,060855117051062,"Block 1062, Block Group 1, Census Tract 5117.05, Santa Clara County, California",0,0,0
1000000US060855117051063,060855117051063,"Block 1063, Block Group 1, Census Tract 5117.05, Santa Clara County, California",0,0,0
1000000US060855117051064,060855117051064,"Block 1064, Block Group 1, Census Tract 5117.05, Santa Clara County, California",0,0,0
1000000US060855117051065,060855117051065,"Block 1065, Block Group 1, Census Tract 5117.05, Santa Clara County, California",0,0,0
1000000US060855117051066,060855117051066,"Block 1066, Block Group 1, Census Tract 5117.05, Santa Clara County, California",0,0,0
1000000US060855117051067,060855117051067,"Block 1067, Block Group 1, Census Tract 5117.05, Santa Clara County, California",0,0,0
1000000US060855117051068,060855117051068,"Block 1068, Block Group 1, Census Tract 5117.05, Santa Clara County, California",0,0,0
1000000US060855117051069,060855117051069,"Block 1069, Block Group 1, Census Tract 5117.05, Santa Clara County, California",0,0,0
1000000US060855117051070,060855117051070,"Block 1070, Block Group 1, Census Tract 5117.05, Santa Clara County, California",15,15,0
1000000US060855117051071,060855117051071,"Block 1071, Block Group 1, Census Tract 5117.05, Santa Clara County, California",5,4,1
1000000US060855117051072,060855117051072,"Block 1072, Block Group 1, Census Tract 5117.05, Santa Clara County, California",0,0,0
1000000US060855117051073,060855117051073,"Block 1073, Block Group 1, Census Tract 5117.05, Santa Clara County, California",0,0,0
1000000US060855117051074,060855117051074,"Block 1074, Block Group 1, Census Tract 5117.05, Santa Clara County, California",0,0,0
1000000US060855117051075,060855117051075,"Block 1075, Block Group 1, Census Tract 5117.05, Santa Clara County, California",1,1,0
1000000US060855117051076,060855117051076,"Block 1076, Block Group 1, Census Tract 5117.05, Santa Clara County, California",0,0,0
1000000US060855117051077,060855117051077,"Block 1077, Block Group 1, Census Tract 5117.05, Santa Clara County, California",0,0,0
1000000US060855117051078,060855117051078,"Block 1078, Block Group 1, Census Tract 5117.05, Santa Clara County, California",0,0,0
1000000US060855117051079,060855117051079,"Block 1079, Block Group 1, Census Tract 5117.05, Santa Clara County, California",0,0,0
1000000US060855117051080,060855117051080,"Block 1080, Block Group 1, Census Tract 5117.05, Santa Clara County, California",0,0,0
1000000US060855117051081,060855117051081,"Block 1081, Block Group 1, Census Tract 5117.05, Santa Clara County, California",0,0,0
1000000US060855117051082,060855117051082,"Block 1082, Block Group 1, Census Tract 5117.05, Santa Clara County, California",0,0,0
1000000US060855117051083,060855117051083,"Block 1083, Block Group 1, Census Tract 5117.05, Santa Clara County, California",0,0,0
1000000US060855117051084,060855117051084,"Block 1084, Block Group 1, Census Tract 5117.05, Santa Clara County, California",0,0,0
1000000US060855117051085,060855117051085,"Block 1085, Block Group 1, Census Tract 5117.05, Santa Clara County, California",0,0,0
1000000US060855117051086,060855117051086,"Block 1086, Block Group 1, Census Tract 5117.05, Santa Clara County, California",0,0,0
1000000US060855117051087,060855117051087,"Block 1087, Block Group 1, Census Tract 5117.05, Santa Clara County, California",0,0,0
1000000US060855117051088,060855117051088,"Block 1088, Block Group 1, Census Tract 5117.05, Santa Clara County, California",0,0,0
1000000US060855117051089,060855117051089,"Block 1089, Block Group 1, Census Tract 5117.05, Santa Clara County, California",0,0,0
1000000US060855117051090,060855117051090,"Block 1090, Block Group 1, Census Tract 5117.05, Santa Clara County, California",0,0,0
1000000US060855117051091,060855117051091,"Block 1091, Block Group 1, Census Tract 5117.05, Santa Clara County, California",0,0,0
1000000US060855117051092,060855117051092,"Block 1092, Block Group 1, Census Tract 5117.05, Santa Clara County, California",6,5,1
1000000US060855117051093,060855117051093,"Block 1093, Block Group 1, Census Tract 5117.05, Santa Clara County, California",3,2,1
1000000US060855117051094,060855117051094,"Block 1094, Block Group 1, Census Tract 5117.05, Santa Clara County, California",39,37,2
1000000US060855117051095,060855117051095,"Block 1095, Block Group 1, Census Tract 5117.05, Santa Clara County, California",0,0,0
1000000US060855117051096,060855117051096,"Block 1096, Block Group 1, Census Tract 5117.05, Santa Clara County, California",1,1,0
1000000US060855117051097,060855117051097,"Block 1097, Block Group 1, Census Tract 5117.05, Santa Clara County, California",0,0,0
1000000US060855117051098,060855117051098,"Block 1098, Block Group 1, Census Tract 5117.05, Santa Clara County, California",0,0,0
1000000US060855117051099,060855117051099,"Block 1099, Block Group 1, Census Tract 5117.05, Santa Clara County, California",0,0,0
1000000US060855117051100,060855117051100,"Block 1100, Block Group 1, Census Tract 5117.05, Santa Clara County, California",0,0,0
1000000US060855117051101,060855117051101,"Block 1101, Block Group 1, Census Tract 5117.05, Santa Clara County, California",0,0,0
1000000US060855117051102,060855117051102,"Block 1102, Block Group 1, Census Tract 5117.05, Santa Clara County, California",0,0,0
1000000US060855117051103,060855117051103,"Block 1103, Block Group 1, Census Tract 5117.05, Santa Clara County, California",0,0,0
1000000US060855117051104,060855117051104,"Block 1104, Block Group 1, Census Tract 5117.05, Santa Clara County, California",0,0,0
1000000US060855117051105,060855117051105,"Block 1105, Block Group 1, Census Tract 5117.05, Santa Clara County, California",0,0,0
1000000US060855117051106,060855117051106,"Block 1106, Block Group 1, Census Tract 5117.05, Santa Clara County, California",0,0,0
1000000US060855117051107,060855117051107,"Block 1107, Block Group 1, Census Tract 5117.05, Santa Clara County, California",0,0,0
1000000US060855117051108,060855117051108,"Block 1108, Block Group 1, Census Tract 5117.05, Santa Clara County, California",0,0,0
1000000US060855117051109,060855117051109,"Block 1109, Block Group 1, Census Tract 5117.05, Santa Clara County, California",0,0,0
1000000US060855117051110,060855117051110,"Block 1110, Block Group 1, Census Tract 5117.05, Santa Clara County, California",0,0,0
1000000US060855117051111,060855117051111,"Block 1111, Block Group 1, Census Tract 5117.05, Santa Clara County, California",0,0,0
1000000US060855117051112,060855117051112,"Block 1112, Block Group 1, Census Tract 5117.05, Santa Clara County, California",0,0,0
1000000US060855117051113,060855117051113,"Block 1113, Block Group 1, Census Tract 5117.05, Santa Clara County, California",0,0,0
1000000US060855117051114,060855117051114,"Block 1114, Block Group 1, Census Tract 5117.05, Santa Clara County, California",0,0,0
1000000US060855117051115,060855117051115,"Block 1115, Block Group 1, Census Tract 5117.05, Santa Clara County, California",0,0,0
1000000US060855117051116,060855117051116,"Block 1116, Block Group 1, Census Tract 5117.05, Santa Clara County, California",0,0,0
1000000US060855117051117,060855117051117,"Block 1117, Block Group 1, Census Tract 5117.05, Santa Clara County, California",0,0,0
1000000US060855117051118,060855117051118,"Block 1118, Block Group 1, Census Tract 5117.05, Santa Clara County, California",0,0,0
1000000US060855117051119,060855117051119,"Block 1119, Block Group 1, Census Tract 5117.05, Santa Clara County, California",0,0,0
1000000US060855117051120,060855117051120,"Block 1120, Block Group 1, Census Tract 5117.05, Santa Clara County, California",0,0,0
1000000US060855117051121,060855117051121,"Block 1121, Block Group 1, Census Tract 5117.05, Santa Clara County, California",0,0,0
1000000US060855117051122,060855117051122,"Block 1122, Block Group 1, Census Tract 5117.05, Santa Clara County, California",0,0,0
1000000US060855117051123,060855117051123,"Block 1123, Block Group 1, Census Tract 5117.05, Santa Clara County, California",0,0,0
1000000US060855117051124,060855117051124,"Block 1124, Block Group 1, Census Tract 5117.05, Santa Clara County, California",0,0,0
1000000US060855117051125,060855117051125,"Block 1125, Block Group 1, Census Tract 5117.05, Santa Clara County, California",0,0,0
1000000US060855117051126,060855117051126,"Block 1126, Block Group 1, Census Tract 5117.05, Santa Clara County, California",0,0,0
1000000US060855117051127,060855117051127,"Block 1127, Block Group 1, Census Tract 5117.05, Santa Clara County, California",0,0,0
1000000US060855117051128,060855117051128,"Block 1128, Block Group 1, Census Tract 5117.05, Santa Clara County, California",0,0,0
1000000US060855117051129,060855117051129,"Block 1129, Block Group 1, Census Tract 5117.05, Santa Clara County, California",0,0,0
1000000US060855117051130,060855117051130,"Block 1130, Block Group 1, Census Tract 5117.05, Santa Clara County, California",0,0,0
1000000US060855117051131,060855117051131,"Block 1131, Block Group 1, Census Tract 5117.05, Santa Clara County, California",0,0,0
1000000US060855117051132,060855117051132,"Block 1132, Block Group 1, Census Tract 5117.05, Santa Clara County, California",0,0,0
1000000US060855117051133,060855117051133,"Block 1133, Block Group 1, Census Tract 5117.05, Santa Clara County, California",0,0,0
1000000US060855117051134,060855117051134,"Block 1134, Block Group 1, Census Tract 5117.05, Santa Clara County, California",0,0,0
1000000US060855117051135,060855117051135,"Block 1135, Block Group 1, Census Tract 5117.05, Santa Clara County, California",0,0,0
1000000US060855117051136,060855117051136,"Block 1136, Block Group 1, Census Tract 5117.05, Santa Clara County, California",0,0,0
1000000US060855117051137,060855117051137,"Block 1137, Block Group 1, Census Tract 5117.05, Santa Clara County, California",0,0,0
1000000US060855117051138,060855117051138,"Block 1138, Block Group 1, Census Tract 5117.05, Santa Clara County, California",0,0,0
1000000US060855117051139,060855117051139,"Block 1139, Block Group 1, Census Tract 5117.05, Santa Clara County, California",0,0,0
1000000US060855117051140,060855117051140,"Block 1140, Block Group 1, Census Tract 5117.05, Santa Clara County, California",0,0,0
1000000US060855117051141,060855117051141,"Block 1141, Block Group 1, Census Tract 5117.05, Santa Clara County, California",0,0,0
1000000US060855117051142,060855117051142,"Block 1142, Block Group 1, Census Tract 5117.05, Santa Clara County, California",0,0,0
1000000US060855117051143,060855117051143,"Block 1143, Block Group 1, Census Tract 5117.05, Santa Clara County, California",0,0,0
1000000US060855117051144,060855117051144,"Block 1144, Block Group 1, Census Tract 5117.05, Santa Clara County, California",0,0,0
1000000US060855117051145,060855117051145,"Block 1145, Block Group 1, Census Tract 5117.05, Santa Clara County, California",0,0,0
1000000US060855117051146,060855117051146,"Block 1146, Block Group 1, Census Tract 5117.05, Santa Clara County, California",0,0,0
1000000US060855117051147,060855117051147,"Block 1147, Block Group 1, Census Tract 5117.05, Santa Clara County, California",0,0,0
1000000US060855117051148,060855117051148,"Block 1148, Block Group 1, Census Tract 5117.05, Santa Clara County, California",0,0,0
1000000US060855117051149,060855117051149,"Block 1149, Block Group 1, Census Tract 5117.05, Santa Clara County, California",0,0,0
1000000US060855117051150,060855117051150,"Block 1150, Block Group 1, Census Tract 5117.05, Santa Clara County, California",0,0,0
1000000US060855117051151,060855117051151,"Block 1151, Block Group 1, Census Tract 5117.05, Santa Clara County, California",0,0,0
1000000US060855117051152,060855117051152,"Block 1152, Block Group 1, Census Tract 5117.05, Santa Clara County, California",0,0,0
1000000US060855117051153,060855117051153,"Block 1153, Block Group 1, Census Tract 5117.05, Santa Clara County, California",0,0,0
1000000US060855117051154,060855117051154,"Block 1154, Block Group 1, Census Tract 5117.05, Santa Clara County, California",0,0,0
1000000US060855117051155,060855117051155,"Block 1155, Block Group 1, Census Tract 5117.05, Santa Clara County, California",0,0,0
1000000US060855117051156,060855117051156,"Block 1156, Block Group 1, Census Tract 5117.05, Santa Clara County, California",0,0,0
1000000US060855117071000,060855117071000,"Block 1000, Block Group 1, Census Tract 5117.07, Santa Clara County, California",1,1,0
1000000US060855117071001,060855117071001,"Block 1001, Block Group 1, Census Tract 5117.07, Santa Clara County, California",0,0,0
1000000US060855117071002,060855117071002,"Block 1002, Block Group 1, Census Tract 5117.07, Santa Clara County, California",1,1,0
1000000US060855117071003,060855117071003,"Block 1003, Block Group 1, Census Tract 5117.07, Santa Clara County, California",0,0,0
1000000US060855117071004,060855117071004,"Block 1004, Block Group 1, Census Tract 5117.07, Santa Clara County, California",0,0,0
1000000US060855117071005,060855117071005,"Block 1005, Block Group 1, Census Tract 5117.07, Santa Clara County, California",2,2,0
1000000US060855117071006,060855117071006,"Block 1006, Block Group 1, Census Tract 5117.07, Santa Clara County, California",0,0,0
1000000US060855117071007,060855117071007,"Block 1007, Block Group 1, Census Tract 5117.07, Santa Clara County, California",0,0,0
1000000US060855117071008,060855117071008,"Block 1008, Block Group 1, Census Tract 5117.07, Santa Clara County, California",0,0,0
1000000US060855117071009,060855117071009,"Block 1009, Block Group 1, Census Tract 5117.07, Santa Clara County, California",0,0,0
1000000US060855117071010,060855117071010,"Block 1010, Block Group 1, Census Tract 5117.07, Santa Clara County, California",0,0,0
1000000US060855117071011,060855117071011,"Block 1011, Block Group 1, Census Tract 5117.07, Santa Clara County, California",0,0,0
1000000US060855117071012,060855117071012,"Block 1012, Block Group 1, Census Tract 5117.07, Santa Clara County, California",0,0,0
1000000US060855117071013,060855117071013,"Block 1013, Block Group 1, Census Tract 5117.07, Santa Clara County, California",0,0,0
1000000US060855117071014,060855117071014,"Block 1014, Block Group 1, Census Tract 5117.07, Santa Clara County, California",7,7,0
1000000US060855117071015,060855117071015,"Block 1015, Block Group 1, Census Tract 5117.07, Santa Clara County, California",34,27,7
1000000US060855117071016,060855117071016,"Block 1016, Block Group 1, Census Tract 5117.07, Santa Clara County, California",89,82,7
1000000US060855117071017,060855117071017,"Block 1017, Block Group 1, Census Tract 5117.07, Santa Clara County, California",4,4,0
1000000US060855117071018,060855117071018,"Block 1018, Block Group 1, Census Tract 5117.07, Santa Clara County, California",7,7,0
1000000US060855117071019,060855117071019,"Block 1019, Block Group 1, Census Tract 5117.07, Santa Clara County, California",0,0,0
1000000US060855117071020,060855117071020,"Block 1020, Block Group 1, Census Tract 5117.07, Santa Clara County, California",0,0,0
1000000US060855117071021,060855117071021,"Block 1021, Block Group 1, Census Tract 5117.07, Santa Clara County, California",2,2,0
1000000US060855117071022,060855117071022,"Block 1022, Block Group 1, Census Tract 5117.07, Santa Clara County, California",0,0,0
1000000US060855117071023,060855117071023,"Block 1023, Block Group 1, Census Tract 5117.07, Santa Clara County, California",1,1,0
1000000US060855117071024,060855117071024,"Block 1024, Block Group 1, Census Tract 5117.07, Santa Clara County, California",0,0,0
1000000US060855117071025,060855117071025,"Block 1025, Block Group 1, Census Tract 5117.07, Santa Clara County, California",0,0,0
1000000US060855117071026,060855117071026,"Block 1026, Block Group 1, Census Tract 5117.07, Santa Clara County, California",15,15,0
1000000US060855117071027,060855117071027,"Block 1027, Block Group 1, Census Tract 5117.07, Santa Clara County, California",3,3,0
1000000US060855117071028,060855117071028,"Block 1028, Block Group 1, Census Tract 5117.07, Santa Clara County, California",0,0,0
1000000US060855117071029,060855117071029,"Block 1029, Block Group 1, Census Tract 5117.07, Santa Clara County, California",1,1,0
1000000US060855117071030,060855117071030,"Block 1030, Block Group 1, Census Tract 5117.07, Santa Clara County, California",8,8,0
1000000US060855117071031,060855117071031,"Block 1031, Block Group 1, Census Tract 5117.07, Santa Clara County, California",16,15,1
1000000US060855117071032,060855117071032,"Block 1032, Block Group 1, Census Tract 5117.07, Santa Clara County, California",1,1,0
1000000US060855117071033,060855117071033,"Block 1033, Block Group 1, Census Tract 5117.07, Santa Clara County, California",14,14,0
1000000US060855117071034,060855117071034,"Block 1034, Block Group 1, Census Tract 5117.07, Santa Clara County, California",20,17,3
1000000US060855117071035,060855117071035,"Block 1035, Block Group 1, Census Tract 5117.07, Santa Clara County, California",0,0,0
1000000US060855117071036,060855117071036,"Block 1036, Block Group 1, Census Tract 5117.07, Santa Clara County, California",0,0,0
1000000US060855117071037,060855117071037,"Block 1037, Block Group 1, Census Tract 5117.07, Santa Clara County, California",0,0,0
1000000US060855117071038,060855117071038,"Block 1038, Block Group 1, Census Tract 5117.07, Santa Clara County, California",16,15,1
1000000US060855117071039,060855117071039,"Block 1039, Block Group 1, Census Tract 5117.07, Santa Clara County, California",1,1,0
1000000US060855117071040,060855117071040,"Block 1040, Block Group 1, Census Tract 5117.07, Santa Clara County, California",4,4,0
1000000US060855117071041,060855117071041,"Block 1041, Block Group 1, Census Tract 5117.07, Santa Clara County, California",0,0,0
1000000US060855117071042,060855117071042,"Block 1042, Block Group 1, Census Tract 5117.07, Santa Clara County, California",2,2,0
1000000US060855117071043,060855117071043,"Block 1043, Block Group 1, Census Tract 5117.07, Santa Clara County, California",0,0,0
1000000US060855117071044,060855117071044,"Block 1044, Block Group 1, Census Tract 5117.07, Santa Clara County, California",0,0,0
1000000US060855117071045,060855117071045,"Block 1045, Block Group 1, Census Tract 5117.07, Santa Clara County, California",2,1,1
1000000US060855117071046,060855117071046,"Block 1046, Block Group 1, Census Tract 5117.07, Santa Clara County, California",0,0,0
1000000US060855117071047,060855117071047,"Block 1047, Block Group 1, Census Tract 5117.07, Santa Clara County, California",0,0,0
1000000US060855117071048,060855117071048,"Block 1048, Block Group 1, Census Tract 5117.07, Santa Clara County, California",0,0,0
1000000US060855117071049,060855117071049,"Block 1049, Block Group 1, Census Tract 5117.07, Santa Clara County, California",0,0,0
1000000US060855117071050,060855117071050,"Block 1050, Block Group 1, Census Tract 5117.07, Santa Clara County, California",0,0,0
1000000US060855117071051,060855117071051,"Block 1051, Block Group 1, Census Tract 5117.07, Santa Clara County, California",1,1,0
1000000US060855117071052,060855117071052,"Block 1052, Block Group 1, Census Tract 5117.07, Santa Clara County, California",0,0,0
1000000US060855117071053,060855117071053,"Block 1053, Block Group 1, Census Tract 5117.07, Santa Clara County, California",4,2,2
1000000US060855117071054,060855117071054,"Block 1054, Block Group 1, Census Tract 5117.07, Santa Clara County, California",0,0,0
1000000US060855117071055,060855117071055,"Block 1055, Block Group 1, Census Tract 5117.07, Santa Clara County, California",16,15,1
1000000US060855117071056,060855117071056,"Block 1056, Block Group 1, Census Tract 5117.07, Santa Clara County, California",0,0,0
1000000US060855117071057,060855117071057,"Block 1057, Block Group 1, Census Tract 5117.07, Santa Clara County, California",0,0,0
1000000US060855117071058,060855117071058,"Block 1058, Block Group 1, Census Tract 5117.07, Santa Clara County, California",0,0,0
1000000US060855117071059,060855117071059,"Block 1059, Block Group 1, Census Tract 5117.07, Santa Clara County, California",0,0,0
1000000US060855117071060,060855117071060,"Block 1060, Block Group 1, Census Tract 5117.07, Santa Clara County, California",0,0,0
1000000US060855117071061,060855117071061,"Block 1061, Block Group 1, Census Tract 5117.07, Santa Clara County, California",0,0,0
1000000US060855117071062,060855117071062,"Block 1062, Block Group 1, Census Tract 5117.07, Santa Clara County, California",0,0,0
1000000US060855117071063,060855117071063,"Block 1063, Block Group 1, Census Tract 5117.07, Santa Clara County, California",0,0,0
1000000US060855117071064,060855117071064,"Block 1064, Block Group 1, Census Tract 5117.07, Santa Clara County, California",0,0,0
1000000US060855117071065,060855117071065,"Block 1065, Block Group 1, Census Tract 5117.07, Santa Clara County, California",0,0,0
1000000US060855117071066,060855117071066,"Block 1066, Block Group 1, Census Tract 5117.07, Santa Clara County, California",0,0,0
1000000US060855117071067,060855117071067,"Block 1067, Block Group 1, Census Tract 5117.07, Santa Clara County, California",0,0,0
1000000US060855117071068,060855117071068,"Block 1068, Block Group 1, Census Tract 5117.07, Santa Clara County, California",80,78,2
1000000US060855117071069,060855117071069,"Block 1069, Block Group 1, Census Tract 5117.07, Santa Clara County, California",0,0,0
1000000US060855117071070,060855117071070,"Block 1070, Block Group 1, Census Tract 5117.07, Santa Clara County, California",0,0,0
1000000US060855117071071,060855117071071,"Block 1071, Block Group 1, Census Tract 5117.07, Santa Clara County, California",0,0,0
1000000US060855117071072,060855117071072,"Block 1072, Block Group 1, Census Tract 5117.07, Santa Clara County, California",7,7,0
1000000US060855117071073,060855117071073,"Block 1073, Block Group 1, Census Tract 5117.07, Santa Clara County, California",0,0,0
1000000US060855117071074,060855117071074,"Block 1074, Block Group 1, Census Tract 5117.07, Santa Clara County, California",0,0,0
1000000US060855117071075,060855117071075,"Block 1075, Block Group 1, Census Tract 5117.07, Santa Clara County, California",13,13,0
1000000US060855117071076,060855117071076,"Block 1076, Block Group 1, Census Tract 5117.07, Santa Clara County, California",0,0,0
1000000US060855117071077,060855117071077,"Block 1077, Block Group 1, Census Tract 5117.07, Santa Clara County, California",0,0,0
1000000US060855117071078,060855117071078,"Block 1078, Block Group 1, Census Tract 5117.07, Santa Clara County, California",17,15,2
1000000US060855117071079,060855117071079,"Block 1079, Block Group 1, Census Tract 5117.07, Santa Clara County, California",299,273,26
1000000US060855117071080,060855117071080,"Block 1080, Block Group 1, Census Tract 5117.07, Santa Clara County, California",0,0,0
1000000US060855117071081,060855117071081,"Block 1081, Block Group 1, Census Tract 5117.07, Santa Clara County, California",0,0,0
1000000US060855117071082,060855117071082,"Block 1082, Block Group 1, Census Tract 5117.07, Santa Clara County, California",57,52,5
1000000US060855117071083,060855117071083,"Block 1083, Block Group 1, Census Tract 5117.07, Santa Clara County, California",0,0,0
1000000US060855117071084,060855117071084,"Block 1084, Block Group 1, Census Tract 5117.07, Santa Clara County, California",65,63,2
1000000US060855117071085,060855117071085,"Block 1085, Block Group 1, Census Tract 5117.07, Santa Clara County, California",9,9,0
1000000US060855117071086,060855117071086,"Block 1086, Block Group 1, Census Tract 5117.07, Santa Clara County, California",0,0,0
1000000US060855117071087,060855117071087,"Block 1087, Block Group 1, Census Tract 5117.07, Santa Clara County, California",0,0,0
1000000US060855117071088,060855117071088,"Block 1088, Block Group 1, Census Tract 5117.07, Santa Clara County, California",8,8,0
1000000US060855117071089,060855117071089,"Block 1089, Block Group 1, Census Tract 5117.07, Santa Clara County, California",61,60,1
1000000US060855117071090,060855117071090,"Block 1090, Block Group 1, Census Tract 5117.07, Santa Clara County, California",9,9,0
1000000US060855117071091,060855117071091,"Block 1091, Block Group 1, Census Tract 5117.07, Santa Clara County, California",15,14,1
1000000US060855117071092,060855117071092,"Block 1092, Block Group 1, Census Tract 5117.07, Santa Clara County, California",0,0,0
1000000US060855117071093,060855117071093,"Block 1093, Block Group 1, Census Tract 5117.07, Santa Clara County, California",0,0,0
1000000US060855117071094,060855117071094,"Block 1094, Block Group 1, Census Tract 5117.07, Santa Clara County, California",0,0,0
1000000US060855117071095,060855117071095,"Block 1095, Block Group 1, Census Tract 5117.07, Santa Clara County, California",1,1,0
1000000US060855117071096,060855117071096,"Block 1096, Block Group 1, Census Tract 5117.07, Santa Clara County, California",0,0,0
1000000US060855117071097,060855117071097,"Block 1097, Block Group 1, Census Tract 5117.07, Santa Clara County, California",33,33,0
1000000US060855117071098,060855117071098,"Block 1098, Block Group 1, Census Tract 5117.07, Santa Clara County, California",0,0,0
1000000US060855117071099,060855117071099,"Block 1099, Block Group 1, Census Tract 5117.07, Santa Clara County, California",0,0,0
1000000US060855117071100,060855117071100,"Block 1100, Block Group 1, Census Tract 5117.07, Santa Clara County, California",0,0,0
1000000US060855117071101,060855117071101,"Block 1101, Block Group 1, Census Tract 5117.07, Santa Clara County, California",0,0,0
1000000US060855117071102,060855117071102,"Block 1102, Block Group 1, Census Tract 5117.07, Santa Clara County, California",0,0,0
1000000US060855117071103,060855117071103,"Block 1103, Block Group 1, Census Tract 5117.07, Santa Clara County, California",48,47,1
1000000US060855117071104,060855117071104,"Block 1104, Block Group 1, Census Tract 5117.07, Santa Clara County, California",0,0,0
1000000US060855117071105,060855117071105,"Block 1105, Block Group 1, Census Tract 5117.07, Santa Clara County, California",1,1,0
1000000US060855117071106,060855117071106,"Block 1106, Block Group 1, Census Tract 5117.07, Santa Clara County, California",0,0,0
1000000US060855117071107,060855117071107,"Block 1107, Block Group 1, Census Tract 5117.07, Santa Clara County, California",0,0,0
1000000US060855117071108,060855117071108,"Block 1108, Block Group 1, Census Tract 5117.07, Santa Clara County, California",0,0,0
1000000US060855117071109,060855117071109,"Block 1109, Block Group 1, Census Tract 5117.07, Santa Clara County, California",0,0,0
1000000US060855117071110,060855117071110,"Block 1110, Block Group 1, Census Tract 5117.07, Santa Clara County, California",0,0,0
1000000US060855117071111,060855117071111,"Block 1111, Block Group 1, Census Tract 5117.07, Santa Clara County, California",0,0,0
1000000US060855117071112,060855117071112,"Block 1112, Block Group 1, Census Tract 5117.07, Santa Clara County, California",0,0,0
1000000US060855117071113,060855117071113,"Block 1113, Block Group 1, Census Tract 5117.07, Santa Clara County, California",0,0,0
1000000US060855117071114,060855117071114,"Block 1114, Block Group 1, Census Tract 5117.07, Santa Clara County, California",0,0,0
1000000US060855117071115,060855117071115,"Block 1115, Block Group 1, Census Tract 5117.07, Santa Clara County, California",0,0,0
1000000US060855117071116,060855117071116,"Block 1116, Block Group 1, Census Tract 5117.07, Santa Clara County, California",0,0,0
1000000US060855117071117,060855117071117,"Block 1117, Block Group 1, Census Tract 5117.07, Santa Clara County, California",0,0,0
1000000US060855117071118,060855117071118,"Block 1118, Block Group 1, Census Tract 5117.07, Santa Clara County, California",0,0,0
1000000US060855117071119,060855117071119,"Block 1119, Block Group 1, Census Tract 5117.07, Santa Clara County, California",0,0,0
1000000US060855117071120,060855117071120,"Block 1120, Block Group 1, Census Tract 5117.07, Santa Clara County, California",0,0,0
1000000US060855117071121,060855117071121,"Block 1121, Block Group 1, Census Tract 5117.07, Santa Clara County, California",0,0,0
1000000US060855117071122,060855117071122,"Block 1122, Block Group 1, Census Tract 5117.07, Santa Clara County, California",2,2,0
1000000US060855117071123,060855117071123,"Block 1123, Block Group 1, Census Tract 5117.07, Santa Clara County, California",11,11,0
1000000US060855117071124,060855117071124,"Block 1124, Block Group 1, Census Tract 5117.07, Santa Clara County, California",0,0,0
1000000US060855117071125,060855117071125,"Block 1125, Block Group 1, Census Tract 5117.07, Santa Clara County, California",0,0,0
1000000US060855117071126,060855117071126,"Block 1126, Block Group 1, Census Tract 5117.07, Santa Clara County, California",0,0,0
1000000US060855117071127,060855117071127,"Block 1127, Block Group 1, Census Tract 5117.07, Santa Clara County, California",0,0,0
1000000US060855117071128,060855117071128,"Block 1128, Block Group 1, Census Tract 5117.07, Santa Clara County, California",0,0,0
1000000US060855117071129,060855117071129,"Block 1129, Block Group 1, Census Tract 5117.07, Santa Clara County, California",0,0,0
1000000US060855117071130,060855117071130,"Block 1130, Block Group 1, Census Tract 5117.07, Santa Clara County, California",0,0,0
1000000US060855117071131,060855117071131,"Block 1131, Block Group 1, Census Tract 5117.07, Santa Clara County, California",6,6,0
1000000US060855117071132,060855117071132,"Block 1132, Block Group 1, Census Tract 5117.07, Santa Clara County, California",28,22,6
1000000US060855117071133,060855117071133,"Block 1133, Block Group 1, Census Tract 5117.07, Santa Clara County, California",2,2,0
1000000US060855117071134,060855117071134,"Block 1134, Block Group 1, Census Tract 5117.07, Santa Clara County, California",6,6,0
1000000US060855117071135,060855117071135,"Block 1135, Block Group 1, Census Tract 5117.07, Santa Clara County, California",0,0,0
1000000US060855117071136,060855117071136,"Block 1136, Block Group 1, Census Tract 5117.07, Santa Clara County, California",1,0,1
1000000US060855117071137,060855117071137,"Block 1137, Block Group 1, Census Tract 5117.07, Santa Clara County, California",16,10,6
1000000US060855117071138,060855117071138,"Block 1138, Block Group 1, Census Tract 5117.07, Santa Clara County, California",15,14,1
1000000US060855117071139,060855117071139,"Block 1139, Block Group 1, Census Tract 5117.07, Santa Clara County, California",7,5,2
1000000US060855117071140,060855117071140,"Block 1140, Block Group 1, Census Tract 5117.07, Santa Clara County, California",0,0,0
1000000US060855117071141,060855117071141,"Block 1141, Block Group 1, Census Tract 5117.07, Santa Clara County, California",0,0,0
1000000US060855117071142,060855117071142,"Block 1142, Block Group 1, Census Tract 5117.07, Santa Clara County, California",0,0,0
1000000US060855117071143,060855117071143,"Block 1143, Block Group 1, Census Tract 5117.07, Santa Clara County, California",0,0,0
1000000US060855117071144,060855117071144,"Block 1144, Block Group 1, Census Tract 5117.07, Santa Clara County, California",0,0,0
1000000US060855117071145,060855117071145,"Block 1145, Block Group 1, Census Tract 5117.07, Santa Clara County, California",2,2,0
1000000US060855117071146,060855117071146,"Block 1146, Block Group 1, Census Tract 5117.07, Santa Clara County, California",1,1,0
1000000US060855117071147,060855117071147,"Block 1147, Block Group 1, Census Tract 5117.07, Santa Clara County, California",0,0,0
1000000US060855117071148,060855117071148,"Block 1148, Block Group 1, Census Tract 5117.07, Santa Clara County, California",2,2,0
1000000US060855117071149,060855117071149,"Block 1149, Block Group 1, Census Tract 5117.07, Santa Clara County, California",0,0,0
1000000US060855117071150,060855117071150,"Block 1150, Block Group 1, Census Tract 5117.07, Santa Clara County, California",0,0,0
1000000US060855117071151,060855117071151,"Block 1151, Block Group 1, Census Tract 5117.07, Santa Clara County, California",1,0,1
1000000US060855117071152,060855117071152,"Block 1152, Block Group 1, Census Tract 5117.07, Santa Clara County, California",0,0,0
1000000US060855117071153,060855117071153,"Block 1153, Block Group 1, Census Tract 5117.07, Santa Clara County, California",7,7,0
1000000US060855117071154,060855117071154,"Block 1154, Block Group 1, Census Tract 5117.07, Santa Clara County, California",0,0,0
1000000US060855117071155,060855117071155,"Block 1155, Block Group 1, Census Tract 5117.07, Santa Clara County, California",0,0,0
1000000US060855117071156,060855117071156,"Block 1156, Block Group 1, Census Tract 5117.07, Santa Clara County, California",1,1,0
1000000US060855117071157,060855117071157,"Block 1157, Block Group 1, Census Tract 5117.07, Santa Clara County, California",65,60,5
1000000US060855117071158,060855117071158,"Block 1158, Block Group 1, Census Tract 5117.07, Santa Clara County, California",0,0,0
1000000US060855117071159,060855117071159,"Block 1159, Block Group 1, Census Tract 5117.07, Santa Clara County, California",0,0,0
1000000US060855117071160,060855117071160,"Block 1160, Block Group 1, Census Tract 5117.07, Santa Clara County, California",0,0,0
1000000US060855117071161,060855117071161,"Block 1161, Block Group 1, Census Tract 5117.07, Santa Clara County, California",3,3,0
1000000US060855117071162,060855117071162,"Block 1162, Block Group 1, Census Tract 5117.07, Santa Clara County, California",0,0,0
1000000US060855117071163,060855117071163,"Block 1163, Block Group 1, Census Tract 5117.07, Santa Clara County, California",0,0,0
1000000US060855117071164,060855117071164,"Block 1164, Block Group 1, Census Tract 5117.07, Santa Clara County, California",9,9,0
1000000US060855117071165,060855117071165,"Block 1165, Block Group 1, Census Tract 5117.07, Santa Clara County, California",0,0,0
1000000US060855117071166,060855117071166,"Block 1166, Block Group 1, Census Tract 5117.07, Santa Clara County, California",1,1,0
1000000US060855117071167,060855117071167,"Block 1167, Block Group 1, Census Tract 5117.07, Santa Clara County, California",10,9,1
1000000US060855117071168,060855117071168,"Block 1168, Block Group 1, Census Tract 5117.07, Santa Clara County, California",1,1,0
1000000US060855117071169,060855117071169,"Block 1169, Block Group 1, Census Tract 5117.07, Santa Clara County, California",34,29,5
1000000US060855117071170,060855117071170,"Block 1170, Block Group 1, Census Tract 5117.07, Santa Clara County, California",3,2,1
1000000US060855117071171,060855117071171,"Block 1171, Block Group 1, Census Tract 5117.07, Santa Clara County, California",15,10,5
1000000US060855117071172,060855117071172,"Block 1172, Block Group 1, Census Tract 5117.07, Santa Clara County, California",0,0,0
1000000US060855117071173,060855117071173,"Block 1173, Block Group 1, Census Tract 5117.07, Santa Clara County, California",4,4,0
1000000US060855117071174,060855117071174,"Block 1174, Block Group 1, Census Tract 5117.07, Santa Clara County, California",9,9,0
1000000US060855117071175,060855117071175,"Block 1175, Block Group 1, Census Tract 5117.07, Santa Clara County, California",18,15,3
1000000US060855117071176,060855117071176,"Block 1176, Block Group 1, Census Tract 5117.07, Santa Clara County, California",1,1,0
1000000US060855117071177,060855117071177,"Block 1177, Block Group 1, Census Tract 5117.07, Santa Clara County, California",3,3,0
1000000US060855117071178,060855117071178,"Block 1178, Block Group 1, Census Tract 5117.07, Santa Clara County, California",0,0,0
1000000US060855117071179,060855117071179,"Block 1179, Block Group 1, Census Tract 5117.07, Santa Clara County, California",0,0,0
1000000US060855117071180,060855117071180,"Block 1180, Block Group 1, Census Tract 5117.07, Santa Clara County, California",0,0,0
1000000US060855117071181,060855117071181,"Block 1181, Block Group 1, Census Tract 5117.07, Santa Clara County, California",2,2,0
1000000US060855117071182,060855117071182,"Block 1182, Block Group 1, Census Tract 5117.07, Santa Clara County, California",7,5,2
1000000US060855117071183,060855117071183,"Block 1183, Block Group 1, Census Tract 5117.07, Santa Clara County, California",0,0,0
1000000US060855117071184,060855117071184,"Block 1184, Block Group 1, Census Tract 5117.07, Santa Clara County, California",2,2,0
1000000US060855117071185,060855117071185,"Block 1185, Block Group 1, Census Tract 5117.07, Santa Clara County, California",17,16,1
1000000US060855117071186,060855117071186,"Block 1186, Block Group 1, Census Tract 5117.07, Santa Clara County, California",3,3,0
1000000US060855117071187,060855117071187,"Block 1187, Block Group 1, Census Tract 5117.07, Santa Clara County, California",0,0,0
1000000US060855117071188,060855117071188,"Block 1188, Block Group 1, Census Tract 5117.07, Santa Clara County, California",0,0,0
1000000US060855117071189,060855117071189,"Block 1189, Block Group 1, Census Tract 5117.07, Santa Clara County, California",0,0,0
1000000US060855117071190,060855117071190,"Block 1190, Block Group 1, Census Tract 5117.07, Santa Clara County, California",0,0,0
1000000US060855117071191,060855117071191,"Block 1191, Block Group 1, Census Tract 5117.07, Santa Clara County, California",0,0,0
1000000US060855117071192,060855117071192,"Block 1192, Block Group 1, Census Tract 5117.07, Santa Clara County, California",1,1,0
1000000US060855117071193,060855117071193,"Block 1193, Block Group 1, Census Tract 5117.07, Santa Clara County, California",3,3,0
1000000US060855117071194,060855117071194,"Block 1194, Block Group 1, Census Tract 5117.07, Santa Clara County, California",0,0,0
1000000US060855117071195,060855117071195,"Block 1195, Block Group 1, Census Tract 5117.07, Santa Clara County, California",0,0,0
1000000US060855117071196,060855117071196,"Block 1196, Block Group 1, Census Tract 5117.07, Santa Clara County, California",0,0,0
1000000US060855117071197,060855117071197,"Block 1197, Block Group 1, Census Tract 5117.07, Santa Clara County, California",0,0,0
1000000US060855117071198,060855117071198,"Block 1198, Block Group 1, Census Tract 5117.07, Santa Clara County, California",0,0,0
1000000US060855117071199,060855117071199,"Block 1199, Block Group 1, Census Tract 5117.07, Santa Clara County, California",0,0,0
1000000US060855117071200,060855117071200,"Block 1200, Block Group 1, Census Tract 5117.07, Santa Clara County, California",0,0,0
1000000US060855117071201,060855117071201,"Block 1201, Block Group 1, Census Tract 5117.07, Santa Clara County, California",0,0,0
1000000US060855117071202,060855117071202,"Block 1202, Block Group 1, Census Tract 5117.07, Santa Clara County, California",0,0,0
1000000US060855117071203,060855117071203,"Block 1203, Block Group 1, Census Tract 5117.07, Santa Clara County, California",0,0,0
1000000US060855117071204,060855117071204,"Block 1204, Block Group 1, Census Tract 5117.07, Santa Clara County, California",0,0,0
1000000US060855117071205,060855117071205,"Block 1205, Block Group 1, Census Tract 5117.07, Santa Clara County, California",0,0,0
1000000US060855117071206,060855117071206,"Block 1206, Block Group 1, Census Tract 5117.07, Santa Clara County, California",0,0,0
1000000US060855117071207,060855117071207,"Block 1207, Block Group 1, Census Tract 5117.07, Santa Clara County, California",0,0,0
1000000US060855117071208,060855117071208,"Block 1208, Block Group 1, Census Tract 5117.07, Santa Clara County, California",0,0,0
1000000US060855117071209,060855117071209,"Block 1209, Block Group 1, Census Tract 5117.07, Santa Clara County, California",0,0,0
1000000US060855117071210,060855117071210,"Block 1210, Block Group 1, Census Tract 5117.07, Santa Clara County, California",0,0,0
1000000US060855117071211,060855117071211,"Block 1211, Block Group 1, Census Tract 5117.07, Santa Clara County, California",0,0,0
1000000US060855118001000,060855118001000,"Block 1000, Block Group 1, Census Tract 5118, Santa Clara County, California",38,35,3
1000000US060855118001001,060855118001001,"Block 1001, Block Group 1, Census Tract 5118, Santa Clara County, California",0,0,0
1000000US060855118001002,060855118001002,"Block 1002, Block Group 1, Census Tract 5118, Santa Clara County, California",0,0,0
1000000US060855118001003,060855118001003,"Block 1003, Block Group 1, Census Tract 5118, Santa Clara County, California",0,0,0
1000000US060855118001004,060855118001004,"Block 1004, Block Group 1, Census Tract 5118, Santa Clara County, California",43,41,2
1000000US060855118001005,060855118001005,"Block 1005, Block Group 1, Census Tract 5118, Santa Clara County, California",0,0,0
1000000US060855118001006,060855118001006,"Block 1006, Block Group 1, Census Tract 5118, Santa Clara County, California",0,0,0
1000000US060855118001007,060855118001007,"Block 1007, Block Group 1, Census Tract 5118, Santa Clara County, California",2,2,0
1000000US060855118001008,060855118001008,"Block 1008, Block Group 1, Census Tract 5118, Santa Clara County, California",11,10,1
1000000US060855118001009,060855118001009,"Block 1009, Block Group 1, Census Tract 5118, Santa Clara County, California",17,15,2
1000000US060855118001010,060855118001010,"Block 1010, Block Group 1, Census Tract 5118, Santa Clara County, California",0,0,0
1000000US060855118001011,060855118001011,"Block 1011, Block Group 1, Census Tract 5118, Santa Clara County, California",70,57,13
1000000US060855118001012,060855118001012,"Block 1012, Block Group 1, Census Tract 5118, Santa Clara County, California",22,20,2
1000000US060855118001013,060855118001013,"Block 1013, Block Group 1, Census Tract 5118, Santa Clara County, California",78,73,5
1000000US060855118001014,060855118001014,"Block 1014, Block Group 1, Census Tract 5118, Santa Clara County, California",3,3,0
1000000US060855118001015,060855118001015,"Block 1015, Block Group 1, Census Tract 5118, Santa Clara County, California",7,5,2
1000000US060855118001016,060855118001016,"Block 1016, Block Group 1, Census Tract 5118, Santa Clara County, California",0,0,0
1000000US060855118001017,060855118001017,"Block 1017, Block Group 1, Census Tract 5118, Santa Clara County, California",0,0,0
1000000US060855118001018,060855118001018,"Block 1018, Block Group 1, Census Tract 5118, Santa Clara County, California",0,0,0
1000000US060855118001019,060855118001019,"Block 1019, Block Group 1, Census Tract 5118, Santa Clara County, California",28,25,3
1000000US060855118001020,060855118001020,"Block 1020, Block Group 1, Census Tract 5118, Santa Clara County, California",14,14,0
1000000US060855118001021,060855118001021,"Block 1021, Block Group 1, Census Tract 5118, Santa Clara County, California",1,1,0
1000000US060855118001022,060855118001022,"Block 1022, Block Group 1, Census Tract 5118, Santa Clara County, California",0,0,0
1000000US060855118001023,060855118001023,"Block 1023, Block Group 1, Census Tract 5118, Santa Clara County, California",9,7,2
1000000US060855118001024,060855118001024,"Block 1024, Block Group 1, Census Tract 5118, Santa Clara County, California",5,5,0
1000000US060855118001025,060855118001025,"Block 1025, Block Group 1, Census Tract 5118, Santa Clara County, California",1,0,1
1000000US060855118001026,060855118001026,"Block 1026, Block Group 1, Census Tract 5118, Santa Clara County, California",0,0,0
1000000US060855118001027,060855118001027,"Block 1027, Block Group 1, Census Tract 5118, Santa Clara County, California",1,1,0
1000000US060855118001028,060855118001028,"Block 1028, Block Group 1, Census Tract 5118, Santa Clara County, California",94,88,6
1000000US060855118001029,060855118001029,"Block 1029, Block Group 1, Census Tract 5118, Santa Clara County, California",0,0,0
1000000US060855118001030,060855118001030,"Block 1030, Block Group 1, Census Tract 5118, Santa Clara County, California",0,0,0
1000000US060855118001031,060855118001031,"Block 1031, Block Group 1, Census Tract 5118, Santa Clara County, California",0,0,0
1000000US060855118001032,060855118001032,"Block 1032, Block Group 1, Census Tract 5118, Santa Clara County, California",0,0,0
1000000US060855118001033,060855118001033,"Block 1033, Block Group 1, Census Tract 5118, Santa Clara County, California",6,6,0
1000000US060855118001034,060855118001034,"Block 1034, Block Group 1, Census Tract 5118, Santa Clara County, California",0,0,0
1000000US060855118001035,060855118001035,"Block 1035, Block Group 1, Census Tract 5118, Santa Clara County, California",0,0,0
1000000US060855118001036,060855118001036,"Block 1036, Block Group 1, Census Tract 5118, Santa Clara County, California",4,4,0
1000000US060855118001037,060855118001037,"Block 1037, Block Group 1, Census Tract 5118, Santa Clara County, California",0,0,0
1000000US060855118001038,060855118001038,"Block 1038, Block Group 1, Census Tract 5118, Santa Clara County, California",9,8,1
1000000US060855118001039,060855118001039,"Block 1039, Block Group 1, Census Tract 5118, Santa Clara County, California",15,14,1
1000000US060855118001040,060855118001040,"Block 1040, Block Group 1, Census Tract 5118, Santa Clara County, California",8,8,0
1000000US060855118001041,060855118001041,"Block 1041, Block Group 1, Census Tract 5118, Santa Clara County, California",18,18,0
1000000US060855118001042,060855118001042,"Block 1042, Block Group 1, Census Tract 5118, Santa Clara County, California",17,17,0
1000000US060855118001043,060855118001043,"Block 1043, Block Group 1, Census Tract 5118, Santa Clara County, California",5,4,1
1000000US060855118001044,060855118001044,"Block 1044, Block Group 1, Census Tract 5118, Santa Clara County, California",4,4,0
1000000US060855118001045,060855118001045,"Block 1045, Block Group 1, Census Tract 5118, Santa Clara County, California",42,38,4
1000000US060855118001046,060855118001046,"Block 1046, Block Group 1, Census Tract 5118, Santa Clara County, California",70,69,1
1000000US060855118001047,060855118001047,"Block 1047, Block Group 1, Census Tract 5118, Santa Clara County, California",14,13,1
1000000US060855118001048,060855118001048,"Block 1048, Block Group 1, Census Tract 5118, Santa Clara County, California",0,0,0
1000000US060855118001049,060855118001049,"Block 1049, Block Group 1, Census Tract 5118, Santa Clara County, California",1,1,0
1000000US060855118001050,060855118001050,"Block 1050, Block Group 1, Census Tract 5118, Santa Clara County, California",17,17,0
1000000US060855118001051,060855118001051,"Block 1051, Block Group 1, Census Tract 5118, Santa Clara County, California",10,10,0
1000000US060855118001052,060855118001052,"Block 1052, Block Group 1, Census Tract 5118, Santa Clara County, California",8,8,0
1000000US060855118001053,060855118001053,"Block 1053, Block Group 1, Census Tract 5118, Santa Clara County, California",0,0,0
1000000US060855118001054,060855118001054,"Block 1054, Block Group 1, Census Tract 5118, Santa Clara County, California",0,0,0
1000000US060855118001055,060855118001055,"Block 1055, Block Group 1, Census Tract 5118, Santa Clara County, California",6,6,0
1000000US060855118001056,060855118001056,"Block 1056, Block Group 1, Census Tract 5118, Santa Clara County, California",0,0,0
1000000US060855118001057,060855118001057,"Block 1057, Block Group 1, Census Tract 5118, Santa Clara County, California",0,0,0
1000000US060855118001058,060855118001058,"Block 1058, Block Group 1, Census Tract 5118, Santa Clara County, California",0,0,0
1000000US060855118001059,060855118001059,"Block 1059, Block Group 1, Census Tract 5118, Santa Clara County, California",0,0,0
1000000US060855118001060,060855118001060,"Block 1060, Block Group 1, Census Tract 5118, Santa Clara County, California",5,5,0
1000000US060855118001061,060855118001061,"Block 1061, Block Group 1, Census Tract 5118, Santa Clara County, California",0,0,0
1000000US060855118001062,060855118001062,"Block 1062, Block Group 1, Census Tract 5118, Santa Clara County, California",0,0,0
1000000US060855118001063,060855118001063,"Block 1063, Block Group 1, Census Tract 5118, Santa Clara County, California",0,0,0
1000000US060855118001064,060855118001064,"Block 1064, Block Group 1, Census Tract 5118, Santa Clara County, California",3,3,0
1000000US060855118001065,060855118001065,"Block 1065, Block Group 1, Census Tract 5118, Santa Clara County, California",9,8,1
1000000US060855118001066,060855118001066,"Block 1066, Block Group 1, Census Tract 5118, Santa Clara County, California",1,1,0
1000000US060855118001067,060855118001067,"Block 1067, Block Group 1, Census Tract 5118, Santa Clara County, California",16,16,0
1000000US060855118001068,060855118001068,"Block 1068, Block Group 1, Census Tract 5118, Santa Clara County, California",6,6,0
1000000US060855118001069,060855118001069,"Block 1069, Block Group 1, Census Tract 5118, Santa Clara County, California",7,7,0
1000000US060855118001070,060855118001070,"Block 1070, Block Group 1, Census Tract 5118, Santa Clara County, California",0,0,0
1000000US060855118001071,060855118001071,"Block 1071, Block Group 1, Census Tract 5118, Santa Clara County, California",0,0,0
1000000US060855118001072,060855118001072,"Block 1072, Block Group 1, Census Tract 5118, Santa Clara County, California",3,3,0
1000000US060855118001073,060855118001073,"Block 1073, Block Group 1, Census Tract 5118, Santa Clara County, California",0,0,0
1000000US060855118001074,060855118001074,"Block 1074, Block Group 1, Census Tract 5118, Santa Clara County, California",0,0,0
1000000US060855118001075,060855118001075,"Block 1075, Block Group 1, Census Tract 5118, Santa Clara County, California",10,10,0
1000000US060855118001076,060855118001076,"Block 1076, Block Group 1, Census Tract 5118, Santa Clara County, California",3,3,0
1000000US060855118001077,060855118001077,"Block 1077, Block Group 1, Census Tract 5118, Santa Clara County, California",0,0,0
1000000US060855118001078,060855118001078,"Block 1078, Block Group 1, Census Tract 5118, Santa Clara County, California",0,0,0
1000000US060855118001079,060855118001079,"Block 1079, Block Group 1, Census Tract 5118, Santa Clara County, California",0,0,0
1000000US060855118001080,060855118001080,"Block 1080, Block Group 1, Census Tract 5118, Santa Clara County, California",0,0,0
1000000US060855118002000,060855118002000,"Block 2000, Block Group 2, Census Tract 5118, Santa Clara County, California",0,0,0
1000000US060855118002001,060855118002001,"Block 2001, Block Group 2, Census Tract 5118, Santa Clara County, California",0,0,0
1000000US060855118002002,060855118002002,"Block 2002, Block Group 2, Census Tract 5118, Santa Clara County, California",26,25,1
1000000US060855118002003,060855118002003,"Block 2003, Block Group 2, Census Tract 5118, Santa Clara County, California",1,1,0
1000000US060855118002004,060855118002004,"Block 2004, Block Group 2, Census Tract 5118, Santa Clara County, California",0,0,0
1000000US060855118002005,060855118002005,"Block 2005, Block Group 2, Census Tract 5118, Santa Clara County, California",7,6,1
1000000US060855118002006,060855118002006,"Block 2006, Block Group 2, Census Tract 5118, Santa Clara County, California",27,23,4
1000000US060855118002007,060855118002007,"Block 2007, Block Group 2, Census Tract 5118, Santa Clara County, California",18,17,1
1000000US060855118002008,060855118002008,"Block 2008, Block Group 2, Census Tract 5118, Santa Clara County, California",1,1,0
1000000US060855118002009,060855118002009,"Block 2009, Block Group 2, Census Tract 5118, Santa Clara County, California",10,10,0
1000000US060855118002010,060855118002010,"Block 2010, Block Group 2, Census Tract 5118, Santa Clara County, California",22,21,1
1000000US060855118002011,060855118002011,"Block 2011, Block Group 2, Census Tract 5118, Santa Clara County, California",0,0,0
1000000US060855118002012,060855118002012,"Block 2012, Block Group 2, Census Tract 5118, Santa Clara County, California",1,0,1
1000000US060855118002013,060855118002013,"Block 2013, Block Group 2, Census Tract 5118, Santa Clara County, California",0,0,0
1000000US060855118002014,060855118002014,"Block 2014, Block Group 2, Census Tract 5118, Santa Clara County, California",44,43,1
1000000US060855118002015,060855118002015,"Block 2015, Block Group 2, Census Tract 5118, Santa Clara County, California",12,11,1
1000000US060855118002016,060855118002016,"Block 2016, Block Group 2, Census Tract 5118, Santa Clara County, California",22,19,3
1000000US060855118002017,060855118002017,"Block 2017, Block Group 2, Census Tract 5118, Santa Clara County, California",54,49,5
1000000US060855118002018,060855118002018,"Block 2018, Block Group 2, Census Tract 5118, Santa Clara County, California",9,9,0
1000000US060855118002019,060855118002019,"Block 2019, Block Group 2, Census Tract 5118, Santa Clara County, California",0,0,0
1000000US060855118002020,060855118002020,"Block 2020, Block Group 2, Census Tract 5118, Santa Clara County, California",15,15,0
1000000US060855118002021,060855118002021,"Block 2021, Block Group 2, Census Tract 5118, Santa Clara County, California",0,0,0
1000000US060855118002022,060855118002022,"Block 2022, Block Group 2, Census Tract 5118, Santa Clara County, California",9,9,0
1000000US060855118002023,060855118002023,"Block 2023, Block Group 2, Census Tract 5118, Santa Clara County, California",2,2,0
1000000US060855118002024,060855118002024,"Block 2024, Block Group 2, Census Tract 5118, Santa Clara County, California",8,8,0
1000000US060855118002025,060855118002025,"Block 2025, Block Group 2, Census Tract 5118, Santa Clara County, California",10,9,1
1000000US060855118002026,060855118002026,"Block 2026, Block Group 2, Census Tract 5118, Santa Clara County, California",10,10,0
1000000US060855118002027,060855118002027,"Block 2027, Block Group 2, Census Tract 5118, Santa Clara County, California",1,1,0
1000000US060855118002028,060855118002028,"Block 2028, Block Group 2, Census Tract 5118, Santa Clara County, California",25,25,0
1000000US060855118002029,060855118002029,"Block 2029, Block Group 2, Census Tract 5118, Santa Clara County, California",0,0,0
1000000US060855118002030,060855118002030,"Block 2030, Block Group 2, Census Tract 5118, Santa Clara County, California",33,33,0
1000000US060855118002031,060855118002031,"Block 2031, Block Group 2, Census Tract 5118, Santa Clara County, California",13,11,2
1000000US060855118002032,060855118002032,"Block 2032, Block Group 2, Census Tract 5118, Santa Clara County, California",6,6,0
1000000US060855118002033,060855118002033,"Block 2033, Block Group 2, Census Tract 5118, Santa Clara County, California",37,34,3
1000000US060855118002034,060855118002034,"Block 2034, Block Group 2, Census Tract 5118, Santa Clara County, California",0,0,0
1000000US060855118002035,060855118002035,"Block 2035, Block Group 2, Census Tract 5118, Santa Clara County, California",19,19,0
1000000US060855118002036,060855118002036,"Block 2036, Block Group 2, Census Tract 5118, Santa Clara County, California",34,33,1
1000000US060855118002037,060855118002037,"Block 2037, Block Group 2, Census Tract 5118, Santa Clara County, California",0,0,0
1000000US060855118002038,060855118002038,"Block 2038, Block Group 2, Census Tract 5118, Santa Clara County, California",0,0,0
1000000US060855118002039,060855118002039,"Block 2039, Block Group 2, Census Tract 5118, Santa Clara County, California",0,0,0
1000000US060855118003000,060855118003000,"Block 3000, Block Group 3, Census Tract 5118, Santa Clara County, California",7,6,1
1000000US060855118003001,060855118003001,"Block 3001, Block Group 3, Census Tract 5118, Santa Clara County, California",0,0,0
1000000US060855118003002,060855118003002,"Block 3002, Block Group 3, Census Tract 5118, Santa Clara County, California",3,3,0
1000000US060855118003003,060855118003003,"Block 3003, Block Group 3, Census Tract 5118, Santa Clara County, California",1,1,0
1000000US060855118003004,060855118003004,"Block 3004, Block Group 3, Census Tract 5118, Santa Clara County, California",1,0,1
1000000US060855118003005,060855118003005,"Block 3005, Block Group 3, Census Tract 5118, Santa Clara County, California",0,0,0
1000000US060855118003006,060855118003006,"Block 3006, Block Group 3, Census Tract 5118, Santa Clara County, California",0,0,0
1000000US060855118003007,060855118003007,"Block 3007, Block Group 3, Census Tract 5118, Santa Clara County, California",34,32,2
1000000US060855118003008,060855118003008,"Block 3008, Block Group 3, Census Tract 5118, Santa Clara County, California",0,0,0
1000000US060855118003009,060855118003009,"Block 3009, Block Group 3, Census Tract 5118, Santa Clara County, California",0,0,0
1000000US060855118003010,060855118003010,"Block 3010, Block Group 3, Census Tract 5118, Santa Clara County, California",0,0,0
1000000US060855118003011,060855118003011,"Block 3011, Block Group 3, Census Tract 5118, Santa Clara County, California",0,0,0
1000000US060855118003012,060855118003012,"Block 3012, Block Group 3, Census Tract 5118, Santa Clara County, California",0,0,0
1000000US060855118003013,060855118003013,"Block 3013, Block Group 3, Census Tract 5118, Santa Clara County, California",0,0,0
1000000US060855118003014,060855118003014,"Block 3014, Block Group 3, Census Tract 5118, Santa Clara County, California",0,0,0
1000000US060855118003015,060855118003015,"Block 3015, Block Group 3, Census Tract 5118, Santa Clara County, California",0,0,0
1000000US060855118003016,060855118003016,"Block 3016, Block Group 3, Census Tract 5118, Santa Clara County, California",0,0,0
1000000US060855118003017,060855118003017,"Block 3017, Block Group 3, Census Tract 5118, Santa Clara County, California",0,0,0
1000000US060855118003018,060855118003018,"Block 3018, Block Group 3, Census Tract 5118, Santa Clara County, California",0,0,0
1000000US060855118003019,060855118003019,"Block 3019, Block Group 3, Census Tract 5118, Santa Clara County, California",0,0,0
1000000US060855118003020,060855118003020,"Block 3020, Block Group 3, Census Tract 5118, Santa Clara County, California",0,0,0
1000000US060855118003021,060855118003021,"Block 3021, Block Group 3, Census Tract 5118, Santa Clara County, California",0,0,0
1000000US060855118003022,060855118003022,"Block 3022, Block Group 3, Census Tract 5118, Santa Clara County, California",0,0,0
1000000US060855118003023,060855118003023,"Block 3023, Block Group 3, Census Tract 5118, Santa Clara County, California",0,0,0
1000000US060855118003024,060855118003024,"Block 3024, Block Group 3, Census Tract 5118, Santa Clara County, California",4,4,0
1000000US060855118003025,060855118003025,"Block 3025, Block Group 3, Census Tract 5118, Santa Clara County, California",0,0,0
1000000US060855118003026,060855118003026,"Block 3026, Block Group 3, Census Tract 5118, Santa Clara County, California",1,1,0
1000000US060855118003027,060855118003027,"Block 3027, Block Group 3, Census Tract 5118, Santa Clara County, California",0,0,0
1000000US060855118003028,060855118003028,"Block 3028, Block Group 3, Census Tract 5118, Santa Clara County, California",0,0,0
1000000US060855118003029,060855118003029,"Block 3029, Block Group 3, Census Tract 5118, Santa Clara County, California",0,0,0
1000000US060855118003030,060855118003030,"Block 3030, Block Group 3, Census Tract 5118, Santa Clara County, California",0,0,0
1000000US060855118003031,060855118003031,"Block 3031, Block Group 3, Census Tract 5118, Santa Clara County, California",0,0,0
1000000US060855118003032,060855118003032,"Block 3032, Block Group 3, Census Tract 5118, Santa Clara County, California",62,61,1
1000000US060855118003033,060855118003033,"Block 3033, Block Group 3, Census Tract 5118, Santa Clara County, California",0,0,0
1000000US060855118003034,060855118003034,"Block 3034, Block Group 3, Census Tract 5118, Santa Clara County, California",68,65,3
1000000US060855118003035,060855118003035,"Block 3035, Block Group 3, Census Tract 5118, Santa Clara County, California",0,0,0
1000000US060855118003036,060855118003036,"Block 3036, Block Group 3, Census Tract 5118, Santa Clara County, California",0,0,0
1000000US060855118003037,060855118003037,"Block 3037, Block Group 3, Census Tract 5118, Santa Clara County, California",0,0,0
1000000US060855118003038,060855118003038,"Block 3038, Block Group 3, Census Tract 5118, Santa Clara County, California",0,0,0
1000000US060855118003039,060855118003039,"Block 3039, Block Group 3, Census Tract 5118, Santa Clara County, California",0,0,0
1000000US060855118003040,060855118003040,"Block 3040, Block Group 3, Census Tract 5118, Santa Clara County, California",26,26,0
1000000US060855118003041,060855118003041,"Block 3041, Block Group 3, Census Tract 5118, Santa Clara County, California",0,0,0
1000000US060855118003042,060855118003042,"Block 3042, Block Group 3, Census Tract 5118, Santa Clara County, California",0,0,0
1000000US060855118003043,060855118003043,"Block 3043, Block Group 3, Census Tract 5118, Santa Clara County, California",9,8,1
1000000US060855118003044,060855118003044,"Block 3044, Block Group 3, Census Tract 5118, Santa Clara County, California",0,0,0
1000000US060855118003045,060855118003045,"Block 3045, Block Group 3, Census Tract 5118, Santa Clara County, California",0,0,0
1000000US060855118003046,060855118003046,"Block 3046, Block Group 3, Census Tract 5118, Santa Clara County, California",0,0,0
1000000US060855118003047,060855118003047,"Block 3047, Block Group 3, Census Tract 5118, Santa Clara County, California",25,21,4
1000000US060855118003048,060855118003048,"Block 3048, Block Group 3, Census Tract 5118, Santa Clara County, California",0,0,0
1000000US060855118003049,060855118003049,"Block 3049, Block Group 3, Census Tract 5118, Santa Clara County, California",0,0,0
1000000US060855118003050,060855118003050,"Block 3050, Block Group 3, Census Tract 5118, Santa Clara County, California",1,1,0
1000000US060855118003051,060855118003051,"Block 3051, Block Group 3, Census Tract 5118, Santa Clara County, California",0,0,0
1000000US060855118003052,060855118003052,"Block 3052, Block Group 3, Census Tract 5118, Santa Clara County, California",0,0,0
1000000US060855118003053,060855118003053,"Block 3053, Block Group 3, Census Tract 5118, Santa Clara County, California",0,0,0
1000000US060855118003054,060855118003054,"Block 3054, Block Group 3, Census Tract 5118, Santa Clara County, California",1,1,0
1000000US060855118003055,060855118003055,"Block 3055, Block Group 3, Census Tract 5118, Santa Clara County, California",0,0,0
1000000US060855118003056,060855118003056,"Block 3056, Block Group 3, Census Tract 5118, Santa Clara County, California",18,15,3
1000000US060855118003057,060855118003057,"Block 3057, Block Group 3, Census Tract 5118, Santa Clara County, California",0,0,0
1000000US060855118003058,060855118003058,"Block 3058, Block Group 3, Census Tract 5118, Santa Clara County, California",0,0,0
1000000US060855118003059,060855118003059,"Block 3059, Block Group 3, Census Tract 5118, Santa Clara County, California",1,1,0
1000000US060855118003060,060855118003060,"Block 3060, Block Group 3, Census Tract 5118, Santa Clara County, California",0,0,0
1000000US060855118003061,060855118003061,"Block 3061, Block Group 3, Census Tract 5118, Santa Clara County, California",0,0,0
1000000US060855118003062,060855118003062,"Block 3062, Block Group 3, Census Tract 5118, Santa Clara County, California",0,0,0
1000000US060855118003063,060855118003063,"Block 3063, Block Group 3, Census Tract 5118, Santa Clara County, California",0,0,0
1000000US060855118003064,060855118003064,"Block 3064, Block Group 3, Census Tract 5118, Santa Clara County, California",48,44,4
1000000US060855118003065,060855118003065,"Block 3065, Block Group 3, Census Tract 5118, Santa Clara County, California",0,0,0
1000000US060855118003066,060855118003066,"Block 3066, Block Group 3, Census Tract 5118, Santa Clara County, California",1,1,0
1000000US060855118003067,060855118003067,"Block 3067, Block Group 3, Census Tract 5118, Santa Clara County, California",0,0,0
1000000US060855118003068,060855118003068,"Block 3068, Block Group 3, Census Tract 5118, Santa Clara County, California",0,0,0
1000000US060855118003069,060855118003069,"Block 3069, Block Group 3, Census Tract 5118, Santa Clara County, California",0,0,0
1000000US060855118003070,060855118003070,"Block 3070, Block Group 3, Census Tract 5118, Santa Clara County, California",0,0,0
1000000US060855118003071,060855118003071,"Block 3071, Block Group 3, Census Tract 5118, Santa Clara County, California",0,0,0
1000000US060855118003072,060855118003072,"Block 3072, Block Group 3, Census Tract 5118, Santa Clara County, California",98,89,9
1000000US060855118003073,060855118003073,"Block 3073, Block Group 3, Census Tract 5118, Santa Clara County, California",0,0,0
1000000US060855118003074,060855118003074,"Block 3074, Block Group 3, Census Tract 5118, Santa Clara County, California",0,0,0
1000000US060855118003075,060855118003075,"Block 3075, Block Group 3, Census Tract 5118, Santa Clara County, California",0,0,0
1000000US060855118003076,060855118003076,"Block 3076, Block Group 3, Census Tract 5118, Santa Clara County, California",0,0,0
1000000US060855118003077,060855118003077,"Block 3077, Block Group 3, Census Tract 5118, Santa Clara County, California",0,0,0
1000000US060855118003078,060855118003078,"Block 3078, Block Group 3, Census Tract 5118, Santa Clara County, California",0,0,0
1000000US060855118003079,060855118003079,"Block 3079, Block Group 3, Census Tract 5118, Santa Clara County, California",0,0,0
1000000US060855118003080,060855118003080,"Block 3080, Block Group 3, Census Tract 5118, Santa Clara County, California",43,43,0
1000000US060855118003081,060855118003081,"Block 3081, Block Group 3, Census Tract 5118, Santa Clara County, California",0,0,0
1000000US060855118003082,060855118003082,"Block 3082, Block Group 3, Census Tract 5118, Santa Clara County, California",10,10,0
1000000US060855118003083,060855118003083,"Block 3083, Block Group 3, Census Tract 5118, Santa Clara County, California",0,0,0
1000000US060855118003084,060855118003084,"Block 3084, Block Group 3, Census Tract 5118, Santa Clara County, California",0,0,0
1000000US060855118003085,060855118003085,"Block 3085, Block Group 3, Census Tract 5118, Santa Clara County, California",0,0,0
1000000US060855118003086,060855118003086,"Block 3086, Block Group 3, Census Tract 5118, Santa Clara County, California",0,0,0
1000000US060855118003087,060855118003087,"Block 3087, Block Group 3, Census Tract 5118, Santa Clara County, California",0,0,0
1000000US060855118003088,060855118003088,"Block 3088, Block Group 3, Census Tract 5118, Santa Clara County, California",0,0,0
1000000US060855118003089,060855118003089,"Block 3089, Block Group 3, Census Tract 5118, Santa Clara County, California",0,0,0
1000000US060855118003090,060855118003090,"Block 3090, Block Group 3, Census Tract 5118, Santa Clara County, California",0,0,0
1000000US060855118003091,060855118003091,"Block 3091, Block Group 3, Census Tract 5118, Santa Clara County, California",0,0,0
1000000US060855118003092,060855118003092,"Block 3092, Block Group 3, Census Tract 5118, Santa Clara County, California",0,0,0
1000000US060855118003093,060855118003093,"Block 3093, Block Group 3, Census Tract 5118, Santa Clara County, California",0,0,0
1000000US060855118003094,060855118003094,"Block 3094, Block Group 3, Census Tract 5118, Santa Clara County, California",0,0,0
1000000US060855118003095,060855118003095,"Block 3095, Block Group 3, Census Tract 5118, Santa Clara County, California",0,0,0
1000000US060855118003096,060855118003096,"Block 3096, Block Group 3, Census Tract 5118, Santa Clara County, California",20,16,4
1000000US060855118003097,060855118003097,"Block 3097, Block Group 3, Census Tract 5118, Santa Clara County, California",12,11,1
1000000US060855119051000,060855119051000,"Block 1000, Block Group 1, Census Tract 5119.05, Santa Clara County, California",38,36,2
1000000US060855119051001,060855119051001,"Block 1001, Block Group 1, Census Tract 5119.05, Santa Clara County, California",32,32,0
1000000US060855119051002,060855119051002,"Block 1002, Block Group 1, Census Tract 5119.05, Santa Clara County, California",33,32,1
1000000US060855119051003,060855119051003,"Block 1003, Block Group 1, Census Tract 5119.05, Santa Clara County, California",43,42,1
1000000US060855119051004,060855119051004,"Block 1004, Block Group 1, Census Tract 5119.05, Santa Clara County, California",26,25,1
1000000US060855119051005,060855119051005,"Block 1005, Block Group 1, Census Tract 5119.05, Santa Clara County, California",36,36,0
1000000US060855119051006,060855119051006,"Block 1006, Block Group 1, Census Tract 5119.05, Santa Clara County, California",71,69,2
1000000US060855119051007,060855119051007,"Block 1007, Block Group 1, Census Tract 5119.05, Santa Clara County, California",118,114,4
1000000US060855119051008,060855119051008,"Block 1008, Block Group 1, Census Tract 5119.05, Santa Clara County, California",40,40,0
1000000US060855119051009,060855119051009,"Block 1009, Block Group 1, Census Tract 5119.05, Santa Clara County, California",41,40,1
1000000US060855119051010,060855119051010,"Block 1010, Block Group 1, Census Tract 5119.05, Santa Clara County, California",17,17,0
1000000US060855119051011,060855119051011,"Block 1011, Block Group 1, Census Tract 5119.05, Santa Clara County, California",23,23,0
1000000US060855119051012,060855119051012,"Block 1012, Block Group 1, Census Tract 5119.05, Santa Clara County, California",58,55,3
1000000US060855119051013,060855119051013,"Block 1013, Block Group 1, Census Tract 5119.05, Santa Clara County, California",24,23,1
1000000US060855119051014,060855119051014,"Block 1014, Block Group 1, Census Tract 5119.05, Santa Clara County, California",25,25,0
1000000US060855119051015,060855119051015,"Block 1015, Block Group 1, Census Tract 5119.05, Santa Clara County, California",46,44,2
1000000US060855119051016,060855119051016,"Block 1016, Block Group 1, Census Tract 5119.05, Santa Clara County, California",5,5,0
1000000US060855119051017,060855119051017,"Block 1017, Block Group 1, Census Tract 5119.05, Santa Clara County, California",9,9,0
1000000US060855119051018,060855119051018,"Block 1018, Block Group 1, Census Tract 5119.05, Santa Clara County, California",40,38,2
1000000US060855119051019,060855119051019,"Block 1019, Block Group 1, Census Tract 5119.05, Santa Clara County, California",38,38,0
1000000US060855119051020,060855119051020,"Block 1020, Block Group 1, Census Tract 5119.05, Santa Clara County, California",17,17,0
1000000US060855119051021,060855119051021,"Block 1021, Block Group 1, Census Tract 5119.05, Santa Clara County, California",17,17,0
1000000US060855119051022,060855119051022,"Block 1022, Block Group 1, Census Tract 5119.05, Santa Clara County, California",46,46,0
1000000US060855119051023,060855119051023,"Block 1023, Block Group 1, Census Tract 5119.05, Santa Clara County, California",47,47,0
1000000US060855119051024,060855119051024,"Block 1024, Block Group 1, Census Tract 5119.05, Santa Clara County, California",4,4,0
1000000US060855119051025,060855119051025,"Block 1025, Block Group 1, Census Tract 5119.05, Santa Clara County, California",21,21,0
1000000US060855119051026,060855119051026,"Block 1026, Block Group 1, Census Tract 5119.05, Santa Clara County, California",24,24,0
1000000US060855119051027,060855119051027,"Block 1027, Block Group 1, Census Tract 5119.05, Santa Clara County, California",24,24,0
1000000US060855119051028,060855119051028,"Block 1028, Block Group 1, Census Tract 5119.05, Santa Clara County, California",28,27,1
1000000US060855119051029,060855119051029,"Block 1029, Block Group 1, Census Tract 5119.05, Santa Clara County, California",68,65,3
1000000US060855119051030,060855119051030,"Block 1030, Block Group 1, Census Tract 5119.05, Santa Clara County, California",10,10,0
1000000US060855119051031,060855119051031,"Block 1031, Block Group 1, Census Tract 5119.05, Santa Clara County, California",34,33,1
1000000US060855119071000,060855119071000,"Block 1000, Block Group 1, Census Tract 5119.07, Santa Clara County, California",37,37,0
1000000US060855119071001,060855119071001,"Block 1001, Block Group 1, Census Tract 5119.07, Santa Clara County, California",46,46,0
1000000US060855119071002,060855119071002,"Block 1002, Block Group 1, Census Tract 5119.07, Santa Clara County, California",26,24,2
1000000US060855119071003,060855119071003,"Block 1003, Block Group 1, Census Tract 5119.07, Santa Clara County, California",39,39,0
1000000US060855119071004,060855119071004,"Block 1004, Block Group 1, Census Tract 5119.07, Santa Clara County, California",38,36,2
1000000US060855119071005,060855119071005,"Block 1005, Block Group 1, Census Tract 5119.07, Santa Clara County, California",26,26,0
1000000US060855119071006,060855119071006,"Block 1006, Block Group 1, Census Tract 5119.07, Santa Clara County, California",65,63,2
1000000US060855119071007,060855119071007,"Block 1007, Block Group 1, Census Tract 5119.07, Santa Clara County, California",18,18,0
1000000US060855119071008,060855119071008,"Block 1008, Block Group 1, Census Tract 5119.07, Santa Clara County, California",48,47,1
1000000US060855119071009,060855119071009,"Block 1009, Block Group 1, Census Tract 5119.07, Santa Clara County, California",30,30,0
1000000US060855119071010,060855119071010,"Block 1010, Block Group 1, Census Tract 5119.07, Santa Clara County, California",38,37,1
1000000US060855119071011,060855119071011,"Block 1011, Block Group 1, Census Tract 5119.07, Santa Clara County, California",54,52,2
1000000US060855119071012,060855119071012,"Block 1012, Block Group 1, Census Tract 5119.07, Santa Clara County, California",39,36,3
1000000US060855119071013,060855119071013,"Block 1013, Block Group 1, Census Tract 5119.07, Santa Clara County, California",31,31,0
1000000US060855119072000,060855119072000,"Block 2000, Block Group 2, Census Tract 5119.07, Santa Clara County, California",65,64,1
1000000US060855119072001,060855119072001,"Block 2001, Block Group 2, Census Tract 5119.07, Santa Clara County, California",48,48,0
1000000US060855119072002,060855119072002,"Block 2002, Block Group 2, Census Tract 5119.07, Santa Clara County, California",15,15,0
1000000US060855119072003,060855119072003,"Block 2003, Block Group 2, Census Tract 5119.07, Santa Clara County, California",11,11,0
1000000US060855119072004,060855119072004,"Block 2004, Block Group 2, Census Tract 5119.07, Santa Clara County, California",0,0,0
1000000US060855119072005,060855119072005,"Block 2005, Block Group 2, Census Tract 5119.07, Santa Clara County, California",34,33,1
1000000US060855119072006,060855119072006,"Block 2006, Block Group 2, Census Tract 5119.07, Santa Clara County, California",39,37,2
1000000US060855119072007,060855119072007,"Block 2007, Block Group 2, Census Tract 5119.07, Santa Clara County, California",37,36,1
1000000US060855119072008,060855119072008,"Block 2008, Block Group 2, Census Tract 5119.07, Santa Clara County, California",15,14,1
1000000US060855119072009,060855119072009,"Block 2009, Block Group 2, Census Tract 5119.07, Santa Clara County, California",36,36,0
1000000US060855119072010,060855119072010,"Block 2010, Block Group 2, Census Tract 5119.07, Santa Clara County, California",33,33,0
1000000US060855119072011,060855119072011,"Block 2011, Block Group 2, Census Tract 5119.07, Santa Clara County, California",15,15,0
1000000US060855119072012,060855119072012,"Block 2012, Block Group 2, Census Tract 5119.07, Santa Clara County, California",55,55,0
1000000US060855119072013,060855119072013,"Block 2013, Block Group 2, Census Tract 5119.07, Santa Clara County, California",13,11,2
1000000US060855119072014,060855119072014,"Block 2014, Block Group 2, Census Tract 5119.07, Santa Clara County, California",24,23,1
1000000US060855119072015,060855119072015,"Block 2015, Block Group 2, Census Tract 5119.07, Santa Clara County, California",47,47,0
1000000US060855119072016,060855119072016,"Block 2016, Block Group 2, Census Tract 5119.07, Santa Clara County, California",38,38,0
1000000US060855119072017,060855119072017,"Block 2017, Block Group 2, Census Tract 5119.07, Santa Clara County, California",42,42,0
1000000US060855119072018,060855119072018,"Block 2018, Block Group 2, Census Tract 5119.07, Santa Clara County, California",62,62,0
1000000US060855119072019,060855119072019,"Block 2019, Block Group 2, Census Tract 5119.07, Santa Clara County, California",64,64,0
1000000US060855119072020,060855119072020,"Block 2020, Block Group 2, Census Tract 5119.07, Santa Clara County, California",39,39,0
1000000US060855119072021,060855119072021,"Block 2021, Block Group 2, Census Tract 5119.07, Santa Clara County, California",19,18,1
1000000US060855119072022,060855119072022,"Block 2022, Block Group 2, Census Tract 5119.07, Santa Clara County, California",17,17,0
1000000US060855119072023,060855119072023,"Block 2023, Block Group 2, Census Tract 5119.07, Santa Clara County, California",8,8,0
1000000US060855119072024,060855119072024,"Block 2024, Block Group 2, Census Tract 5119.07, Santa Clara County, California",0,0,0
1000000US060855119072025,060855119072025,"Block 2025, Block Group 2, Census Tract 5119.07, Santa Clara County, California",32,32,0
1000000US060855119091000,060855119091000,"Block 1000, Block Group 1, Census Tract 5119.09, Santa Clara County, California",74,74,0
1000000US060855119091001,060855119091001,"Block 1001, Block Group 1, Census Tract 5119.09, Santa Clara County, California",33,32,1
1000000US060855119091002,060855119091002,"Block 1002, Block Group 1, Census Tract 5119.09, Santa Clara County, California",21,21,0
1000000US060855119091003,060855119091003,"Block 1003, Block Group 1, Census Tract 5119.09, Santa Clara County, California",110,107,3
1000000US060855119091004,060855119091004,"Block 1004, Block Group 1, Census Tract 5119.09, Santa Clara County, California",18,18,0
1000000US060855119091005,060855119091005,"Block 1005, Block Group 1, Census Tract 5119.09, Santa Clara County, California",14,14,0
1000000US060855119091006,060855119091006,"Block 1006, Block Group 1, Census Tract 5119.09, Santa Clara County, California",159,157,2
1000000US060855119091007,060855119091007,"Block 1007, Block Group 1, Census Tract 5119.09, Santa Clara County, California",0,0,0
1000000US060855119091008,060855119091008,"Block 1008, Block Group 1, Census Tract 5119.09, Santa Clara County, California",0,0,0
1000000US060855119091009,060855119091009,"Block 1009, Block Group 1, Census Tract 5119.09, Santa Clara County, California",35,35,0
1000000US060855119091010,060855119091010,"Block 1010, Block Group 1, Census Tract 5119.09, Santa Clara County, California",0,0,0
1000000US060855119091011,060855119091011,"Block 1011, Block Group 1, Census Tract 5119.09, Santa Clara County, California",2,2,0
1000000US060855119091012,060855119091012,"Block 1012, Block Group 1, Census Tract 5119.09, Santa Clara County, California",49,48,1
1000000US060855119091013,060855119091013,"Block 1013, Block Group 1, Census Tract 5119.09, Santa Clara County, California",33,31,2
1000000US060855119091014,060855119091014,"Block 1014, Block Group 1, Census Tract 5119.09, Santa Clara County, California",0,0,0
1000000US060855119091015,060855119091015,"Block 1015, Block Group 1, Census Tract 5119.09, Santa Clara County, California",0,0,0
1000000US060855119091016,060855119091016,"Block 1016, Block Group 1, Census Tract 5119.09, Santa Clara County, California",18,17,1
1000000US060855119091017,060855119091017,"Block 1017, Block Group 1, Census Tract 5119.09, Santa Clara County, California",37,35,2
1000000US060855119091018,060855119091018,"Block 1018, Block Group 1, Census Tract 5119.09, Santa Clara County, California",135,131,4
1000000US060855119091019,060855119091019,"Block 1019, Block Group 1, Census Tract 5119.09, Santa Clara County, California",15,14,1
1000000US060855119091020,060855119091020,"Block 1020, Block Group 1, Census Tract 5119.09, Santa Clara County, California",0,0,0
1000000US060855119091021,060855119091021,"Block 1021, Block Group 1, Census Tract 5119.09, Santa Clara County, California",0,0,0
1000000US060855119091022,060855119091022,"Block 1022, Block Group 1, Census Tract 5119.09, Santa Clara County, California",49,49,0
1000000US060855119091023,060855119091023,"Block 1023, Block Group 1, Census Tract 5119.09, Santa Clara County, California",92,89,3
1000000US060855119091024,060855119091024,"Block 1024, Block Group 1, Census Tract 5119.09, Santa Clara County, California",10,9,1
1000000US060855119091025,060855119091025,"Block 1025, Block Group 1, Census Tract 5119.09, Santa Clara County, California",17,17,0
1000000US060855119091026,060855119091026,"Block 1026, Block Group 1, Census Tract 5119.09, Santa Clara County, California",0,0,0
1000000US060855119091027,060855119091027,"Block 1027, Block Group 1, Census Tract 5119.09, Santa Clara County, California",0,0,0
1000000US060855119092000,060855119092000,"Block 2000, Block Group 2, Census Tract 5119.09, Santa Clara County, California",8,8,0
1000000US060855119092001,060855119092001,"Block 2001, Block Group 2, Census Tract 5119.09, Santa Clara County, California",0,0,0
1000000US060855119092002,060855119092002,"Block 2002, Block Group 2, Census Tract 5119.09, Santa Clara County, California",0,0,0
1000000US060855119092003,060855119092003,"Block 2003, Block Group 2, Census Tract 5119.09, Santa Clara County, California",8,8,0
1000000US060855119092004,060855119092004,"Block 2004, Block Group 2, Census Tract 5119.09, Santa Clara County, California",53,53,0
1000000US060855119092005,060855119092005,"Block 2005, Block Group 2, Census Tract 5119.09, Santa Clara County, California",0,0,0
1000000US060855119092006,060855119092006,"Block 2006, Block Group 2, Census Tract 5119.09, Santa Clara County, California",24,24,0
1000000US060855119092007,060855119092007,"Block 2007, Block Group 2, Census Tract 5119.09, Santa Clara County, California",56,55,1
1000000US060855119092008,060855119092008,"Block 2008, Block Group 2, Census Tract 5119.09, Santa Clara County, California",74,74,0
1000000US060855119092009,060855119092009,"Block 2009, Block Group 2, Census Tract 5119.09, Santa Clara County, California",39,38,1
1000000US060855119092010,060855119092010,"Block 2010, Block Group 2, Census Tract 5119.09, Santa Clara County, California",20,19,1
1000000US060855119092011,060855119092011,"Block 2011, Block Group 2, Census Tract 5119.09, Santa Clara County, California",65,65,0
1000000US060855119092012,060855119092012,"Block 2012, Block Group 2, Census Tract 5119.09, Santa Clara County, California",142,139,3
1000000US060855119092013,060855119092013,"Block 2013, Block Group 2, Census Tract 5119.09, Santa Clara County, California",10,10,0
1000000US060855119092014,060855119092014,"Block 2014, Block Group 2, Census Tract 5119.09, Santa Clara County, California",5,5,0
1000000US060855119092015,060855119092015,"Block 2015, Block Group 2, Census Tract 5119.09, Santa Clara County, California",5,5,0
1000000US060855119092016,060855119092016,"Block 2016, Block Group 2, Census Tract 5119.09, Santa Clara County, California",13,13,0
1000000US060855119092017,060855119092017,"Block 2017, Block Group 2, Census Tract 5119.09, Santa Clara County, California",26,26,0
1000000US060855119092018,060855119092018,"Block 2018, Block Group 2, Census Tract 5119.09, Santa Clara County, California",134,131,3
1000000US060855119092019,060855119092019,"Block 2019, Block Group 2, Census Tract 5119.09, Santa Clara County, California",0,0,0
1000000US060855119092020,060855119092020,"Block 2020, Block Group 2, Census Tract 5119.09, Santa Clara County, California",1,1,0
1000000US060855119092021,060855119092021,"Block 2021, Block Group 2, Census Tract 5119.09, Santa Clara County, California",0,0,0
1000000US060855119092022,060855119092022,"Block 2022, Block Group 2, Census Tract 5119.09, Santa Clara County, California",10,10,0
1000000US060855119092023,060855119092023,"Block 2023, Block Group 2, Census Tract 5119.09, Santa Clara County, California",0,0,0
1000000US060855119092024,060855119092024,"Block 2024, Block Group 2, Census Tract 5119.09, Santa Clara County, California",0,0,0
1000000US060855119092025,060855119092025,"Block 2025, Block Group 2, Census Tract 5119.09, Santa Clara County, California",4,4,0
1000000US060855119092026,060855119092026,"Block 2026, Block Group 2, Census Tract 5119.09, Santa Clara County, California",0,0,0
1000000US060855119092027,060855119092027,"Block 2027, Block Group 2, Census Tract 5119.09, Santa Clara County, California",33,33,0
1000000US060855119092028,060855119092028,"Block 2028, Block Group 2, Census Tract 5119.09, Santa Clara County, California",0,0,0
1000000US060855119092029,060855119092029,"Block 2029, Block Group 2, Census Tract 5119.09, Santa Clara County, California",0,0,0
1000000US060855119092030,060855119092030,"Block 2030, Block Group 2, Census Tract 5119.09, Santa Clara County, California",0,0,0
1000000US060855119092031,060855119092031,"Block 2031, Block Group 2, Census Tract 5119.09, Santa Clara County, California",0,0,0
1000000US060855119092032,060855119092032,"Block 2032, Block Group 2, Census Tract 5119.09, Santa Clara County, California",5,5,0
1000000US060855119092033,060855119092033,"Block 2033, Block Group 2, Census Tract 5119.09, Santa Clara County, California",0,0,0
1000000US060855119092034,060855119092034,"Block 2034, Block Group 2, Census Tract 5119.09, Santa Clara County, California",0,0,0
1000000US060855119092035,060855119092035,"Block 2035, Block Group 2, Census Tract 5119.09, Santa Clara County, California",37,37,0
1000000US060855119092036,060855119092036,"Block 2036, Block Group 2, Census Tract 5119.09, Santa Clara County, California",4,4,0
1000000US060855119092037,060855119092037,"Block 2037, Block Group 2, Census Tract 5119.09, Santa Clara County, California",1,1,0
1000000US060855119093000,060855119093000,"Block 3000, Block Group 3, Census Tract 5119.09, Santa Clara County, California",0,0,0
1000000US060855119093001,060855119093001,"Block 3001, Block Group 3, Census Tract 5119.09, Santa Clara County, California",0,0,0
1000000US060855119093002,060855119093002,"Block 3002, Block Group 3, Census Tract 5119.09, Santa Clara County, California",48,48,0
1000000US060855119093003,060855119093003,"Block 3003, Block Group 3, Census Tract 5119.09, Santa Clara County, California",0,0,0
1000000US060855119093004,060855119093004,"Block 3004, Block Group 3, Census Tract 5119.09, Santa Clara County, California",59,58,1
1000000US060855119093005,060855119093005,"Block 3005, Block Group 3, Census Tract 5119.09, Santa Clara County, California",36,36,0
1000000US060855119093006,060855119093006,"Block 3006, Block Group 3, Census Tract 5119.09, Santa Clara County, California",65,65,0
1000000US060855119093007,060855119093007,"Block 3007, Block Group 3, Census Tract 5119.09, Santa Clara County, California",25,25,0
1000000US060855119093008,060855119093008,"Block 3008, Block Group 3, Census Tract 5119.09, Santa Clara County, California",154,153,1
1000000US060855119093009,060855119093009,"Block 3009, Block Group 3, Census Tract 5119.09, Santa Clara County, California",41,40,1
1000000US060855119093010,060855119093010,"Block 3010, Block Group 3, Census Tract 5119.09, Santa Clara County, California",7,7,0
1000000US060855119093011,060855119093011,"Block 3011, Block Group 3, Census Tract 5119.09, Santa Clara County, California",9,9,0
1000000US060855119093012,060855119093012,"Block 3012, Block Group 3, Census Tract 5119.09, Santa Clara County, California",15,15,0
1000000US060855119093013,060855119093013,"Block 3013, Block Group 3, Census Tract 5119.09, Santa Clara County, California",70,69,1
1000000US060855119093014,060855119093014,"Block 3014, Block Group 3, Census Tract 5119.09, Santa Clara County, California",22,21,1
1000000US060855119093015,060855119093015,"Block 3015, Block Group 3, Census Tract 5119.09, Santa Clara County, California",39,38,1
1000000US060855119093016,060855119093016,"Block 3016, Block Group 3, Census Tract 5119.09, Santa Clara County, California",68,68,0
1000000US060855119093017,060855119093017,"Block 3017, Block Group 3, Census Tract 5119.09, Santa Clara County, California",25,25,0
1000000US060855119093018,060855119093018,"Block 3018, Block Group 3, Census Tract 5119.09, Santa Clara County, California",51,49,2
1000000US060855119093019,060855119093019,"Block 3019, Block Group 3, Census Tract 5119.09, Santa Clara County, California",23,23,0
1000000US060855119093020,060855119093020,"Block 3020, Block Group 3, Census Tract 5119.09, Santa Clara County, California",99,98,1
1000000US060855119093021,060855119093021,"Block 3021, Block Group 3, Census Tract 5119.09, Santa Clara County, California",8,8,0
1000000US060855119093022,060855119093022,"Block 3022, Block Group 3, Census Tract 5119.09, Santa Clara County, California",2,2,0
1000000US060855119093023,060855119093023,"Block 3023, Block Group 3, Census Tract 5119.09, Santa Clara County, California",14,14,0
1000000US060855119093024,060855119093024,"Block 3024, Block Group 3, Census Tract 5119.09, Santa Clara County, California",0,0,0
1000000US060855119093025,060855119093025,"Block 3025, Block Group 3, Census Tract 5119.09, Santa Clara County, California",67,66,1
1000000US060855119101000,060855119101000,"Block 1000, Block Group 1, Census Tract 5119.10, Santa Clara County, California",27,27,0
1000000US060855119101001,060855119101001,"Block 1001, Block Group 1, Census Tract 5119.10, Santa Clara County, California",24,24,0
1000000US060855119101002,060855119101002,"Block 1002, Block Group 1, Census Tract 5119.10, Santa Clara County, California",22,21,1
1000000US060855119101003,060855119101003,"Block 1003, Block Group 1, Census Tract 5119.10, Santa Clara County, California",49,46,3
1000000US060855119101004,060855119101004,"Block 1004, Block Group 1, Census Tract 5119.10, Santa Clara County, California",16,16,0
1000000US060855119101005,060855119101005,"Block 1005, Block Group 1, Census Tract 5119.10, Santa Clara County, California",39,38,1
1000000US060855119101006,060855119101006,"Block 1006, Block Group 1, Census Tract 5119.10, Santa Clara County, California",73,73,0
1000000US060855119101007,060855119101007,"Block 1007, Block Group 1, Census Tract 5119.10, Santa Clara County, California",12,11,1
1000000US060855119101008,060855119101008,"Block 1008, Block Group 1, Census Tract 5119.10, Santa Clara County, California",37,37,0
1000000US060855119101009,060855119101009,"Block 1009, Block Group 1, Census Tract 5119.10, Santa Clara County, California",72,72,0
1000000US060855119102000,060855119102000,"Block 2000, Block Group 2, Census Tract 5119.10, Santa Clara County, California",5,5,0
1000000US060855119102001,060855119102001,"Block 2001, Block Group 2, Census Tract 5119.10, Santa Clara County, California",36,35,1
1000000US060855119102002,060855119102002,"Block 2002, Block Group 2, Census Tract 5119.10, Santa Clara County, California",16,16,0
1000000US060855119102003,060855119102003,"Block 2003, Block Group 2, Census Tract 5119.10, Santa Clara County, California",25,25,0
1000000US060855119102004,060855119102004,"Block 2004, Block Group 2, Census Tract 5119.10, Santa Clara County, California",28,28,0
1000000US060855119102005,060855119102005,"Block 2005, Block Group 2, Census Tract 5119.10, Santa Clara County, California",27,27,0
1000000US060855119102006,060855119102006,"Block 2006, Block Group 2, Census Tract 5119.10, Santa Clara County, California",40,40,0
1000000US060855119102007,060855119102007,"Block 2007, Block Group 2, Census Tract 5119.10, Santa Clara County, California",30,30,0
1000000US060855119102008,060855119102008,"Block 2008, Block Group 2, Census Tract 5119.10, Santa Clara County, California",25,25,0
1000000US060855119102009,060855119102009,"Block 2009, Block Group 2, Census Tract 5119.10, Santa Clara County, California",23,22,1
1000000US060855119103000,060855119103000,"Block 3000, Block Group 3, Census Tract 5119.10, Santa Clara County, California",173,171,2
1000000US060855119103001,060855119103001,"Block 3001, Block Group 3, Census Tract 5119.10, Santa Clara County, California",15,15,0
1000000US060855119103002,060855119103002,"Block 3002, Block Group 3, Census Tract 5119.10, Santa Clara County, California",13,13,0
1000000US060855119103003,060855119103003,"Block 3003, Block Group 3, Census Tract 5119.10, Santa Clara County, California",38,38,0
1000000US060855119103004,060855119103004,"Block 3004, Block Group 3, Census Tract 5119.10, Santa Clara County, California",34,34,0
1000000US060855119103005,060855119103005,"Block 3005, Block Group 3, Census Tract 5119.10, Santa Clara County, California",41,40,1
1000000US060855119103006,060855119103006,"Block 3006, Block Group 3, Census Tract 5119.10, Santa Clara County, California",16,16,0
1000000US060855119103007,060855119103007,"Block 3007, Block Group 3, Census Tract 5119.10, Santa Clara County, California",14,14,0
1000000US060855119103008,060855119103008,"Block 3008, Block Group 3, Census Tract 5119.10, Santa Clara County, California",19,19,0
1000000US060855119103009,060855119103009,"Block 3009, Block Group 3, Census Tract 5119.10, Santa Clara County, California",10,10,0
1000000US060855119103010,060855119103010,"Block 3010, Block Group 3, Census Tract 5119.10, Santa Clara County, California",38,37,1
1000000US060855119103011,060855119103011,"Block 3011, Block Group 3, Census Tract 5119.10, Santa Clara County, California",21,20,1
1000000US060855119111000,060855119111000,"Block 1000, Block Group 1, Census Tract 5119.11, Santa Clara County, California",9,8,1
1000000US060855119111001,060855119111001,"Block 1001, Block Group 1, Census Tract 5119.11, Santa Clara County, California",475,463,12
1000000US060855119111002,060855119111002,"Block 1002, Block Group 1, Census Tract 5119.11, Santa Clara County, California",176,172,4
1000000US060855119111003,060855119111003,"Block 1003, Block Group 1, Census Tract 5119.11, Santa Clara County, California",56,54,2
1000000US060855119111004,060855119111004,"Block 1004, Block Group 1, Census Tract 5119.11, Santa Clara County, California",0,0,0
1000000US060855119111005,060855119111005,"Block 1005, Block Group 1, Census Tract 5119.11, Santa Clara County, California",0,0,0
1000000US060855119111006,060855119111006,"Block 1006, Block Group 1, Census Tract 5119.11, Santa Clara County, California",2,2,0
1000000US060855119111007,060855119111007,"Block 1007, Block Group 1, Census Tract 5119.11, Santa Clara County, California",30,30,0
1000000US060855119111008,060855119111008,"Block 1008, Block Group 1, Census Tract 5119.11, Santa Clara County, California",0,0,0
1000000US060855119111009,060855119111009,"Block 1009, Block Group 1, Census Tract 5119.11, Santa Clara County, California",10,9,1
1000000US060855119111010,060855119111010,"Block 1010, Block Group 1, Census Tract 5119.11, Santa Clara County, California",31,30,1
1000000US060855119111011,060855119111011,"Block 1011, Block Group 1, Census Tract 5119.11, Santa Clara County, California",0,0,0
1000000US060855119111012,060855119111012,"Block 1012, Block Group 1, Census Tract 5119.11, Santa Clara County, California",0,0,0
1000000US060855119111013,060855119111013,"Block 1013, Block Group 1, Census Tract 5119.11, Santa Clara County, California",0,0,0
1000000US060855119111014,060855119111014,"Block 1014, Block Group 1, Census Tract 5119.11, Santa Clara County, California",7,7,0
1000000US060855119111015,060855119111015,"Block 1015, Block Group 1, Census Tract 5119.11, Santa Clara County, California",0,0,0
1000000US060855119111016,060855119111016,"Block 1016, Block Group 1, Census Tract 5119.11, Santa Clara County, California",25,25,0
1000000US060855119111017,060855119111017,"Block 1017, Block Group 1, Census Tract 5119.11, Santa Clara County, California",7,7,0
1000000US060855119111018,060855119111018,"Block 1018, Block Group 1, Census Tract 5119.11, Santa Clara County, California",0,0,0
1000000US060855119111019,060855119111019,"Block 1019, Block Group 1, Census Tract 5119.11, Santa Clara County, California",1,1,0
1000000US060855119111020,060855119111020,"Block 1020, Block Group 1, Census Tract 5119.11, Santa Clara County, California",24,24,0
1000000US060855119111021,060855119111021,"Block 1021, Block Group 1, Census Tract 5119.11, Santa Clara County, California",33,31,2
1000000US060855119111022,060855119111022,"Block 1022, Block Group 1, Census Tract 5119.11, Santa Clara County, California",7,6,1
1000000US060855119111023,060855119111023,"Block 1023, Block Group 1, Census Tract 5119.11, Santa Clara County, California",25,25,0
1000000US060855119112000,060855119112000,"Block 2000, Block Group 2, Census Tract 5119.11, Santa Clara County, California",1,0,1
1000000US060855119112001,060855119112001,"Block 2001, Block Group 2, Census Tract 5119.11, Santa Clara County, California",0,0,0
1000000US060855119112002,060855119112002,"Block 2002, Block Group 2, Census Tract 5119.11, Santa Clara County, California",0,0,0
1000000US060855119112003,060855119112003,"Block 2003, Block Group 2, Census Tract 5119.11, Santa Clara County, California",0,0,0
1000000US060855119112004,060855119112004,"Block 2004, Block Group 2, Census Tract 5119.11, Santa Clara County, California",0,0,0
1000000US060855119112005,060855119112005,"Block 2005, Block Group 2, Census Tract 5119.11, Santa Clara County, California",0,0,0
1000000US060855119112006,060855119112006,"Block 2006, Block Group 2, Census Tract 5119.11, Santa Clara County, California",0,0,0
1000000US060855119112007,060855119112007,"Block 2007, Block Group 2, Census Tract 5119.11, Santa Clara County, California",26,22,4
1000000US060855119112008,060855119112008,"Block 2008, Block Group 2, Census Tract 5119.11, Santa Clara County, California",0,0,0
1000000US060855119112009,060855119112009,"Block 2009, Block Group 2, Census Tract 5119.11, Santa Clara County, California",0,0,0
1000000US060855119112010,060855119112010,"Block 2010, Block Group 2, Census Tract 5119.11, Santa Clara County, California",8,8,0
1000000US060855119112011,060855119112011,"Block 2011, Block Group 2, Census Tract 5119.11, Santa Clara County, California",2,2,0
1000000US060855119112012,060855119112012,"Block 2012, Block Group 2, Census Tract 5119.11, Santa Clara County, California",6,6,0
1000000US060855119112013,060855119112013,"Block 2013, Block Group 2, Census Tract 5119.11, Santa Clara County, California",0,0,0
1000000US060855119112014,060855119112014,"Block 2014, Block Group 2, Census Tract 5119.11, Santa Clara County, California",28,28,0
1000000US060855119112015,060855119112015,"Block 2015, Block Group 2, Census Tract 5119.11, Santa Clara County, California",0,0,0
1000000US060855119112016,060855119112016,"Block 2016, Block Group 2, Census Tract 5119.11, Santa Clara County, California",0,0,0
1000000US060855119112017,060855119112017,"Block 2017, Block Group 2, Census Tract 5119.11, Santa Clara County, California",7,6,1
1000000US060855119112018,060855119112018,"Block 2018, Block Group 2, Census Tract 5119.11, Santa Clara County, California",0,0,0
1000000US060855119112019,060855119112019,"Block 2019, Block Group 2, Census Tract 5119.11, Santa Clara County, California",0,0,0
1000000US060855119112020,060855119112020,"Block 2020, Block Group 2, Census Tract 5119.11, Santa Clara County, California",38,37,1
1000000US060855119112021,060855119112021,"Block 2021, Block Group 2, Census Tract 5119.11, Santa Clara County, California",5,5,0
1000000US060855119112022,060855119112022,"Block 2022, Block Group 2, Census Tract 5119.11, Santa Clara County, California",12,12,0
1000000US060855119112023,060855119112023,"Block 2023, Block Group 2, Census Tract 5119.11, Santa Clara County, California",4,4,0
1000000US060855119112024,060855119112024,"Block 2024, Block Group 2, Census Tract 5119.11, Santa Clara County, California",3,3,0
1000000US060855119112025,060855119112025,"Block 2025, Block Group 2, Census Tract 5119.11, Santa Clara County, California",0,0,0
1000000US060855119112026,060855119112026,"Block 2026, Block Group 2, Census Tract 5119.11, Santa Clara County, California",8,7,1
1000000US060855119112027,060855119112027,"Block 2027, Block Group 2, Census Tract 5119.11, Santa Clara County, California",12,11,1
1000000US060855119112028,060855119112028,"Block 2028, Block Group 2, Census Tract 5119.11, Santa Clara County, California",0,0,0
1000000US060855119112029,060855119112029,"Block 2029, Block Group 2, Census Tract 5119.11, Santa Clara County, California",0,0,0
1000000US060855119112030,060855119112030,"Block 2030, Block Group 2, Census Tract 5119.11, Santa Clara County, California",1,1,0
1000000US060855119112031,060855119112031,"Block 2031, Block Group 2, Census Tract 5119.11, Santa Clara County, California",0,0,0
1000000US060855119112032,060855119112032,"Block 2032, Block Group 2, Census Tract 5119.11, Santa Clara County, California",0,0,0
1000000US060855119112033,060855119112033,"Block 2033, Block Group 2, Census Tract 5119.11, Santa Clara County, California",0,0,0
1000000US060855119112034,060855119112034,"Block 2034, Block Group 2, Census Tract 5119.11, Santa Clara County, California",11,8,3
1000000US060855119112035,060855119112035,"Block 2035, Block Group 2, Census Tract 5119.11, Santa Clara County, California",0,0,0
1000000US060855119112036,060855119112036,"Block 2036, Block Group 2, Census Tract 5119.11, Santa Clara County, California",0,0,0
1000000US060855119112037,060855119112037,"Block 2037, Block Group 2, Census Tract 5119.11, Santa Clara County, California",0,0,0
1000000US060855119112038,060855119112038,"Block 2038, Block Group 2, Census Tract 5119.11, Santa Clara County, California",0,0,0
1000000US060855119112039,060855119112039,"Block 2039, Block Group 2, Census Tract 5119.11, Santa Clara County, California",31,30,1
1000000US060855119112040,060855119112040,"Block 2040, Block Group 2, Census Tract 5119.11, Santa Clara County, California",0,0,0
1000000US060855119112041,060855119112041,"Block 2041, Block Group 2, Census Tract 5119.11, Santa Clara County, California",28,27,1
1000000US060855119112042,060855119112042,"Block 2042, Block Group 2, Census Tract 5119.11, Santa Clara County, California",36,33,3
1000000US060855119112043,060855119112043,"Block 2043, Block Group 2, Census Tract 5119.11, Santa Clara County, California",0,0,0
1000000US060855119112044,060855119112044,"Block 2044, Block Group 2, Census Tract 5119.11, Santa Clara County, California",0,0,0
1000000US060855119112045,060855119112045,"Block 2045, Block Group 2, Census Tract 5119.11, Santa Clara County, California",4,4,0
1000000US060855119112046,060855119112046,"Block 2046, Block Group 2, Census Tract 5119.11, Santa Clara County, California",0,0,0
1000000US060855119112047,060855119112047,"Block 2047, Block Group 2, Census Tract 5119.11, Santa Clara County, California",0,0,0
1000000US060855119112048,060855119112048,"Block 2048, Block Group 2, Census Tract 5119.11, Santa Clara County, California",0,0,0
1000000US060855119112049,060855119112049,"Block 2049, Block Group 2, Census Tract 5119.11, Santa Clara County, California",0,0,0
1000000US060855119112050,060855119112050,"Block 2050, Block Group 2, Census Tract 5119.11, Santa Clara County, California",0,0,0
1000000US060855119112051,060855119112051,"Block 2051, Block Group 2, Census Tract 5119.11, Santa Clara County, California",0,0,0
1000000US060855119112052,060855119112052,"Block 2052, Block Group 2, Census Tract 5119.11, Santa Clara County, California",0,0,0
1000000US060855119112053,060855119112053,"Block 2053, Block Group 2, Census Tract 5119.11, Santa Clara County, California",0,0,0
1000000US060855119112054,060855119112054,"Block 2054, Block Group 2, Census Tract 5119.11, Santa Clara County, California",0,0,0
1000000US060855119112055,060855119112055,"Block 2055, Block Group 2, Census Tract 5119.11, Santa Clara County, California",0,0,0
1000000US060855119112056,060855119112056,"Block 2056, Block Group 2, Census Tract 5119.11, Santa Clara County, California",0,0,0
1000000US060855119112057,060855119112057,"Block 2057, Block Group 2, Census Tract 5119.11, Santa Clara County, California",0,0,0
1000000US060855119112058,060855119112058,"Block 2058, Block Group 2, Census Tract 5119.11, Santa Clara County, California",0,0,0
1000000US060855119112059,060855119112059,"Block 2059, Block Group 2, Census Tract 5119.11, Santa Clara County, California",0,0,0
1000000US060855119112060,060855119112060,"Block 2060, Block Group 2, Census Tract 5119.11, Santa Clara County, California",0,0,0
1000000US060855119112061,060855119112061,"Block 2061, Block Group 2, Census Tract 5119.11, Santa Clara County, California",0,0,0
1000000US060855119112062,060855119112062,"Block 2062, Block Group 2, Census Tract 5119.11, Santa Clara County, California",0,0,0
1000000US060855119112063,060855119112063,"Block 2063, Block Group 2, Census Tract 5119.11, Santa Clara County, California",0,0,0
1000000US060855119112064,060855119112064,"Block 2064, Block Group 2, Census Tract 5119.11, Santa Clara County, California",27,26,1
1000000US060855119112065,060855119112065,"Block 2065, Block Group 2, Census Tract 5119.11, Santa Clara County, California",3,2,1
1000000US060855119112066,060855119112066,"Block 2066, Block Group 2, Census Tract 5119.11, Santa Clara County, California",2,2,0
1000000US060855119112067,060855119112067,"Block 2067, Block Group 2, Census Tract 5119.11, Santa Clara County, California",0,0,0
1000000US060855119112068,060855119112068,"Block 2068, Block Group 2, Census Tract 5119.11, Santa Clara County, California",1,1,0
1000000US060855119112069,060855119112069,"Block 2069, Block Group 2, Census Tract 5119.11, Santa Clara County, California",0,0,0
1000000US060855119112070,060855119112070,"Block 2070, Block Group 2, Census Tract 5119.11, Santa Clara County, California",0,0,0
1000000US060855119112071,060855119112071,"Block 2071, Block Group 2, Census Tract 5119.11, Santa Clara County, California",0,0,0
1000000US060855119112072,060855119112072,"Block 2072, Block Group 2, Census Tract 5119.11, Santa Clara County, California",0,0,0
1000000US060855119112073,060855119112073,"Block 2073, Block Group 2, Census Tract 5119.11, Santa Clara County, California",0,0,0
1000000US060855119112074,060855119112074,"Block 2074, Block Group 2, Census Tract 5119.11, Santa Clara County, California",0,0,0
1000000US060855119112075,060855119112075,"Block 2075, Block Group 2, Census Tract 5119.11, Santa Clara County, California",0,0,0
1000000US060855119112076,060855119112076,"Block 2076, Block Group 2, Census Tract 5119.11, Santa Clara County, California",10,9,1
1000000US060855119112077,060855119112077,"Block 2077, Block Group 2, Census Tract 5119.11, Santa Clara County, California",10,9,1
1000000US060855119112078,060855119112078,"Block 2078, Block Group 2, Census Tract 5119.11, Santa Clara County, California",0,0,0
1000000US060855119112079,060855119112079,"Block 2079, Block Group 2, Census Tract 5119.11, Santa Clara County, California",14,12,2
1000000US060855119112080,060855119112080,"Block 2080, Block Group 2, Census Tract 5119.11, Santa Clara County, California",0,0,0
1000000US060855119112081,060855119112081,"Block 2081, Block Group 2, Census Tract 5119.11, Santa Clara County, California",0,0,0
1000000US060855119112082,060855119112082,"Block 2082, Block Group 2, Census Tract 5119.11, Santa Clara County, California",0,0,0
1000000US060855119113000,060855119113000,"Block 3000, Block Group 3, Census Tract 5119.11, Santa Clara County, California",28,27,1
1000000US060855119113001,060855119113001,"Block 3001, Block Group 3, Census Tract 5119.11, Santa Clara County, California",0,0,0
1000000US060855119113002,060855119113002,"Block 3002, Block Group 3, Census Tract 5119.11, Santa Clara County, California",27,26,1
1000000US060855119113003,060855119113003,"Block 3003, Block Group 3, Census Tract 5119.11, Santa Clara County, California",5,5,0
1000000US060855119113004,060855119113004,"Block 3004, Block Group 3, Census Tract 5119.11, Santa Clara County, California",30,28,2
1000000US060855119113005,060855119113005,"Block 3005, Block Group 3, Census Tract 5119.11, Santa Clara County, California",0,0,0
1000000US060855119113006,060855119113006,"Block 3006, Block Group 3, Census Tract 5119.11, Santa Clara County, California",0,0,0
1000000US060855119113007,060855119113007,"Block 3007, Block Group 3, Census Tract 5119.11, Santa Clara County, California",0,0,0
1000000US060855119113008,060855119113008,"Block 3008, Block Group 3, Census Tract 5119.11, Santa Clara County, California",0,0,0
1000000US060855119113009,060855119113009,"Block 3009, Block Group 3, Census Tract 5119.11, Santa Clara County, California",6,6,0
1000000US060855119113010,060855119113010,"Block 3010, Block Group 3, Census Tract 5119.11, Santa Clara County, California",11,10,1
1000000US060855119113011,060855119113011,"Block 3011, Block Group 3, Census Tract 5119.11, Santa Clara County, California",104,101,3
1000000US060855119113012,060855119113012,"Block 3012, Block Group 3, Census Tract 5119.11, Santa Clara County, California",57,56,1
1000000US060855119113013,060855119113013,"Block 3013, Block Group 3, Census Tract 5119.11, Santa Clara County, California",5,5,0
1000000US060855119113014,060855119113014,"Block 3014, Block Group 3, Census Tract 5119.11, Santa Clara County, California",17,17,0
1000000US060855119113015,060855119113015,"Block 3015, Block Group 3, Census Tract 5119.11, Santa Clara County, California",20,20,0
1000000US060855119113016,060855119113016,"Block 3016, Block Group 3, Census Tract 5119.11, Santa Clara County, California",29,28,1
1000000US060855119113017,060855119113017,"Block 3017, Block Group 3, Census Tract 5119.11, Santa Clara County, California",13,13,0
1000000US060855119113018,060855119113018,"Block 3018, Block Group 3, Census Tract 5119.11, Santa Clara County, California",9,9,0
1000000US060855119113019,060855119113019,"Block 3019, Block Group 3, Census Tract 5119.11, Santa Clara County, California",0,0,0
1000000US060855119113020,060855119113020,"Block 3020, Block Group 3, Census Tract 5119.11, Santa Clara County, California",1,1,0
1000000US060855119113021,060855119113021,"Block 3021, Block Group 3, Census Tract 5119.11, Santa Clara County, California",0,0,0
1000000US060855119113022,060855119113022,"Block 3022, Block Group 3, Census Tract 5119.11, Santa Clara County, California",0,0,0
1000000US060855119113023,060855119113023,"Block 3023, Block Group 3, Census Tract 5119.11, Santa Clara County, California",0,0,0
1000000US060855119113024,060855119113024,"Block 3024, Block Group 3, Census Tract 5119.11, Santa Clara County, California",0,0,0
1000000US060855119113025,060855119113025,"Block 3025, Block Group 3, Census Tract 5119.11, Santa Clara County, California",75,74,1
1000000US060855119113026,060855119113026,"Block 3026, Block Group 3, Census Tract 5119.11, Santa Clara County, California",8,8,0
1000000US060855119113027,060855119113027,"Block 3027, Block Group 3, Census Tract 5119.11, Santa Clara County, California",12,12,0
1000000US060855119113028,060855119113028,"Block 3028, Block Group 3, Census Tract 5119.11, Santa Clara County, California",0,0,0
1000000US060855119113029,060855119113029,"Block 3029, Block Group 3, Census Tract 5119.11, Santa Clara County, California",0,0,0
1000000US060855119113030,060855119113030,"Block 3030, Block Group 3, Census Tract 5119.11, Santa Clara County, California",38,37,1
1000000US060855119113031,060855119113031,"Block 3031, Block Group 3, Census Tract 5119.11, Santa Clara County, California",15,15,0
1000000US060855119113032,060855119113032,"Block 3032, Block Group 3, Census Tract 5119.11, Santa Clara County, California",38,37,1
1000000US060855119113033,060855119113033,"Block 3033, Block Group 3, Census Tract 5119.11, Santa Clara County, California",12,12,0
1000000US060855119113034,060855119113034,"Block 3034, Block Group 3, Census Tract 5119.11, Santa Clara County, California",0,0,0
1000000US060855119113035,060855119113035,"Block 3035, Block Group 3, Census Tract 5119.11, Santa Clara County, California",10,10,0
1000000US060855119113036,060855119113036,"Block 3036, Block Group 3, Census Tract 5119.11, Santa Clara County, California",20,20,0
1000000US060855119113037,060855119113037,"Block 3037, Block Group 3, Census Tract 5119.11, Santa Clara County, California",0,0,0
1000000US060855119113038,060855119113038,"Block 3038, Block Group 3, Census Tract 5119.11, Santa Clara County, California",7,6,1
1000000US060855119113039,060855119113039,"Block 3039, Block Group 3, Census Tract 5119.11, Santa Clara County, California",0,0,0
1000000US060855119113040,060855119113040,"Block 3040, Block Group 3, Census Tract 5119.11, Santa Clara County, California",0,0,0
1000000US060855119113041,060855119113041,"Block 3041, Block Group 3, Census Tract 5119.11, Santa Clara County, California",0,0,0
1000000US060855119113042,060855119113042,"Block 3042, Block Group 3, Census Tract 5119.11, Santa Clara County, California",1,1,0
1000000US060855119113043,060855119113043,"Block 3043, Block Group 3, Census Tract 5119.11, Santa Clara County, California",0,0,0
1000000US060855119113044,060855119113044,"Block 3044, Block Group 3, Census Tract 5119.11, Santa Clara County, California",10,10,0
1000000US060855119113045,060855119113045,"Block 3045, Block Group 3, Census Tract 5119.11, Santa Clara County, California",0,0,0
1000000US060855119121000,060855119121000,"Block 1000, Block Group 1, Census Tract 5119.12, Santa Clara County, California",79,78,1
1000000US060855119121001,060855119121001,"Block 1001, Block Group 1, Census Tract 5119.12, Santa Clara County, California",51,51,0
1000000US060855119121002,060855119121002,"Block 1002, Block Group 1, Census Tract 5119.12, Santa Clara County, California",29,29,0
1000000US060855119121003,060855119121003,"Block 1003, Block Group 1, Census Tract 5119.12, Santa Clara County, California",30,30,0
1000000US060855119121004,060855119121004,"Block 1004, Block Group 1, Census Tract 5119.12, Santa Clara County, California",22,22,0
1000000US060855119121005,060855119121005,"Block 1005, Block Group 1, Census Tract 5119.12, Santa Clara County, California",34,34,0
1000000US060855119121006,060855119121006,"Block 1006, Block Group 1, Census Tract 5119.12, Santa Clara County, California",24,23,1
1000000US060855119121007,060855119121007,"Block 1007, Block Group 1, Census Tract 5119.12, Santa Clara County, California",48,46,2
1000000US060855119121008,060855119121008,"Block 1008, Block Group 1, Census Tract 5119.12, Santa Clara County, California",20,20,0
1000000US060855119121009,060855119121009,"Block 1009, Block Group 1, Census Tract 5119.12, Santa Clara County, California",12,12,0
1000000US060855119121010,060855119121010,"Block 1010, Block Group 1, Census Tract 5119.12, Santa Clara County, California",35,35,0
1000000US060855119121011,060855119121011,"Block 1011, Block Group 1, Census Tract 5119.12, Santa Clara County, California",42,42,0
1000000US060855119121012,060855119121012,"Block 1012, Block Group 1, Census Tract 5119.12, Santa Clara County, California",26,26,0
1000000US060855119121013,060855119121013,"Block 1013, Block Group 1, Census Tract 5119.12, Santa Clara County, California",36,35,1
1000000US060855119121014,060855119121014,"Block 1014, Block Group 1, Census Tract 5119.12, Santa Clara County, California",188,186,2
1000000US060855119121015,060855119121015,"Block 1015, Block Group 1, Census Tract 5119.12, Santa Clara County, California",23,22,1
1000000US060855119121016,060855119121016,"Block 1016, Block Group 1, Census Tract 5119.12, Santa Clara County, California",31,30,1
1000000US060855119122000,060855119122000,"Block 2000, Block Group 2, Census Tract 5119.12, Santa Clara County, California",53,53,0
1000000US060855119122001,060855119122001,"Block 2001, Block Group 2, Census Tract 5119.12, Santa Clara County, California",18,18,0
1000000US060855119122002,060855119122002,"Block 2002, Block Group 2, Census Tract 5119.12, Santa Clara County, California",12,12,0
1000000US060855119122003,060855119122003,"Block 2003, Block Group 2, Census Tract 5119.12, Santa Clara County, California",20,19,1
1000000US060855119122004,060855119122004,"Block 2004, Block Group 2, Census Tract 5119.12, Santa Clara County, California",35,35,0
1000000US060855119122005,060855119122005,"Block 2005, Block Group 2, Census Tract 5119.12, Santa Clara County, California",6,6,0
1000000US060855119122006,060855119122006,"Block 2006, Block Group 2, Census Tract 5119.12, Santa Clara County, California",20,20,0
1000000US060855119122007,060855119122007,"Block 2007, Block Group 2, Census Tract 5119.12, Santa Clara County, California",33,33,0
1000000US060855119122008,060855119122008,"Block 2008, Block Group 2, Census Tract 5119.12, Santa Clara County, California",57,57,0
1000000US060855119122009,060855119122009,"Block 2009, Block Group 2, Census Tract 5119.12, Santa Clara County, California",0,0,0
1000000US060855119122010,060855119122010,"Block 2010, Block Group 2, Census Tract 5119.12, Santa Clara County, California",68,66,2
1000000US060855119122011,060855119122011,"Block 2011, Block Group 2, Census Tract 5119.12, Santa Clara County, California",14,13,1
1000000US060855119122012,060855119122012,"Block 2012, Block Group 2, Census Tract 5119.12, Santa Clara County, California",12,12,0
1000000US060855119122013,060855119122013,"Block 2013, Block Group 2, Census Tract 5119.12, Santa Clara County, California",16,15,1
1000000US060855119122014,060855119122014,"Block 2014, Block Group 2, Census Tract 5119.12, Santa Clara County, California",53,53,0
1000000US060855119122015,060855119122015,"Block 2015, Block Group 2, Census Tract 5119.12, Santa Clara County, California",26,25,1
1000000US060855119122016,060855119122016,"Block 2016, Block Group 2, Census Tract 5119.12, Santa Clara County, California",74,70,4
1000000US060855119122017,060855119122017,"Block 2017, Block Group 2, Census Tract 5119.12, Santa Clara County, California",12,12,0
1000000US060855119122018,060855119122018,"Block 2018, Block Group 2, Census Tract 5119.12, Santa Clara County, California",16,16,0
1000000US060855119122019,060855119122019,"Block 2019, Block Group 2, Census Tract 5119.12, Santa Clara County, California",18,18,0
1000000US060855119122020,060855119122020,"Block 2020, Block Group 2, Census Tract 5119.12, Santa Clara County, California",12,10,2
1000000US060855119122021,060855119122021,"Block 2021, Block Group 2, Census Tract 5119.12, Santa Clara County, California",0,0,0
1000000US060855119122022,060855119122022,"Block 2022, Block Group 2, Census Tract 5119.12, Santa Clara County, California",37,37,0
1000000US060855119123000,060855119123000,"Block 3000, Block Group 3, Census Tract 5119.12, Santa Clara County, California",106,104,2
1000000US060855119123001,060855119123001,"Block 3001, Block Group 3, Census Tract 5119.12, Santa Clara County, California",14,14,0
1000000US060855119123002,060855119123002,"Block 3002, Block Group 3, Census Tract 5119.12, Santa Clara County, California",26,25,1
1000000US060855119123003,060855119123003,"Block 3003, Block Group 3, Census Tract 5119.12, Santa Clara County, California",60,60,0
1000000US060855119123004,060855119123004,"Block 3004, Block Group 3, Census Tract 5119.12, Santa Clara County, California",31,31,0
1000000US060855119123005,060855119123005,"Block 3005, Block Group 3, Census Tract 5119.12, Santa Clara County, California",20,20,0
1000000US060855119123006,060855119123006,"Block 3006, Block Group 3, Census Tract 5119.12, Santa Clara County, California",93,93,0
1000000US060855119123007,060855119123007,"Block 3007, Block Group 3, Census Tract 5119.12, Santa Clara County, California",36,35,1
1000000US060855119123008,060855119123008,"Block 3008, Block Group 3, Census Tract 5119.12, Santa Clara County, California",4,4,0
1000000US060855119123009,060855119123009,"Block 3009, Block Group 3, Census Tract 5119.12, Santa Clara County, California",0,0,0
1000000US060855119123010,060855119123010,"Block 3010, Block Group 3, Census Tract 5119.12, Santa Clara County, California",0,0,0
1000000US060855119123011,060855119123011,"Block 3011, Block Group 3, Census Tract 5119.12, Santa Clara County, California",9,9,0
1000000US060855119131000,060855119131000,"Block 1000, Block Group 1, Census Tract 5119.13, Santa Clara County, California",40,39,1
1000000US060855119131001,060855119131001,"Block 1001, Block Group 1, Census Tract 5119.13, Santa Clara County, California",39,39,0
1000000US060855119131002,060855119131002,"Block 1002, Block Group 1, Census Tract 5119.13, Santa Clara County, California",58,58,0
1000000US060855119131003,060855119131003,"Block 1003, Block Group 1, Census Tract 5119.13, Santa Clara County, California",25,24,1
1000000US060855119131004,060855119131004,"Block 1004, Block Group 1, Census Tract 5119.13, Santa Clara County, California",66,65,1
1000000US060855119131005,060855119131005,"Block 1005, Block Group 1, Census Tract 5119.13, Santa Clara County, California",36,35,1
1000000US060855119131006,060855119131006,"Block 1006, Block Group 1, Census Tract 5119.13, Santa Clara County, California",51,49,2
1000000US060855119131007,060855119131007,"Block 1007, Block Group 1, Census Tract 5119.13, Santa Clara County, California",58,58,0
1000000US060855119131008,060855119131008,"Block 1008, Block Group 1, Census Tract 5119.13, Santa Clara County, California",18,18,0
1000000US060855119131009,060855119131009,"Block 1009, Block Group 1, Census Tract 5119.13, Santa Clara County, California",34,34,0
1000000US060855119132000,060855119132000,"Block 2000, Block Group 2, Census Tract 5119.13, Santa Clara County, California",57,57,0
1000000US060855119132001,060855119132001,"Block 2001, Block Group 2, Census Tract 5119.13, Santa Clara County, California",0,0,0
1000000US060855119132002,060855119132002,"Block 2002, Block Group 2, Census Tract 5119.13, Santa Clara County, California",3,3,0
1000000US060855119132003,060855119132003,"Block 2003, Block Group 2, Census Tract 5119.13, Santa Clara County, California",42,42,0
1000000US060855119132004,060855119132004,"Block 2004, Block Group 2, Census Tract 5119.13, Santa Clara County, California",2,2,0
1000000US060855119132005,060855119132005,"Block 2005, Block Group 2, Census Tract 5119.13, Santa Clara County, California",5,5,0
1000000US060855119132006,060855119132006,"Block 2006, Block Group 2, Census Tract 5119.13, Santa Clara County, California",40,40,0
1000000US060855119132007,060855119132007,"Block 2007, Block Group 2, Census Tract 5119.13, Santa Clara County, California",64,63,1
1000000US060855119132008,060855119132008,"Block 2008, Block Group 2, Census Tract 5119.13, Santa Clara County, California",10,10,0
1000000US060855119132009,060855119132009,"Block 2009, Block Group 2, Census Tract 5119.13, Santa Clara County, California",9,9,0
1000000US060855119132010,060855119132010,"Block 2010, Block Group 2, Census Tract 5119.13, Santa Clara County, California",0,0,0
1000000US060855119132011,060855119132011,"Block 2011, Block Group 2, Census Tract 5119.13, Santa Clara County, California",8,8,0
1000000US060855119132012,060855119132012,"Block 2012, Block Group 2, Census Tract 5119.13, Santa Clara County, California",47,47,0
1000000US060855119132013,060855119132013,"Block 2013, Block Group 2, Census Tract 5119.13, Santa Clara County, California",53,49,4
1000000US060855119132014,060855119132014,"Block 2014, Block Group 2, Census Tract 5119.13, Santa Clara County, California",44,44,0
1000000US060855119132015,060855119132015,"Block 2015, Block Group 2, Census Tract 5119.13, Santa Clara County, California",15,15,0
1000000US060855119132016,060855119132016,"Block 2016, Block Group 2, Census Tract 5119.13, Santa Clara County, California",70,70,0
1000000US060855119132017,060855119132017,"Block 2017, Block Group 2, Census Tract 5119.13, Santa Clara County, California",25,25,0
1000000US060855119132018,060855119132018,"Block 2018, Block Group 2, Census Tract 5119.13, Santa Clara County, California",0,0,0
1000000US060855119133000,060855119133000,"Block 3000, Block Group 3, Census Tract 5119.13, Santa Clara County, California",50,49,1
1000000US060855119133001,060855119133001,"Block 3001, Block Group 3, Census Tract 5119.13, Santa Clara County, California",38,38,0
1000000US060855119133002,060855119133002,"Block 3002, Block Group 3, Census Tract 5119.13, Santa Clara County, California",11,11,0
1000000US060855119133003,060855119133003,"Block 3003, Block Group 3, Census Tract 5119.13, Santa Clara County, California",15,15,0
1000000US060855119133004,060855119133004,"Block 3004, Block Group 3, Census Tract 5119.13, Santa Clara County, California",31,31,0
1000000US060855119133005,060855119133005,"Block 3005, Block Group 3, Census Tract 5119.13, Santa Clara County, California",26,26,0
1000000US060855119133006,060855119133006,"Block 3006, Block Group 3, Census Tract 5119.13, Santa Clara County, California",47,46,1
1000000US060855119133007,060855119133007,"Block 3007, Block Group 3, Census Tract 5119.13, Santa Clara County, California",16,16,0
1000000US060855119133008,060855119133008,"Block 3008, Block Group 3, Census Tract 5119.13, Santa Clara County, California",16,16,0
1000000US060855119133009,060855119133009,"Block 3009, Block Group 3, Census Tract 5119.13, Santa Clara County, California",54,54,0
1000000US060855119133010,060855119133010,"Block 3010, Block Group 3, Census Tract 5119.13, Santa Clara County, California",30,30,0
1000000US060855119133011,060855119133011,"Block 3011, Block Group 3, Census Tract 5119.13, Santa Clara County, California",2,2,0
1000000US060855119133012,060855119133012,"Block 3012, Block Group 3, Census Tract 5119.13, Santa Clara County, California",18,18,0
1000000US060855119133013,060855119133013,"Block 3013, Block Group 3, Census Tract 5119.13, Santa Clara County, California",35,35,0
1000000US060855119133014,060855119133014,"Block 3014, Block Group 3, Census Tract 5119.13, Santa Clara County, California",25,25,0
1000000US060855119133015,060855119133015,"Block 3015, Block Group 3, Census Tract 5119.13, Santa Clara County, California",29,28,1
1000000US060855119133016,060855119133016,"Block 3016, Block Group 3, Census Tract 5119.13, Santa Clara County, California",35,33,2
1000000US060855119133017,060855119133017,"Block 3017, Block Group 3, Census Tract 5119.13, Santa Clara County, California",16,16,0
1000000US060855119133018,060855119133018,"Block 3018, Block Group 3, Census Tract 5119.13, Santa Clara County, California",30,30,0
1000000US060855119141000,060855119141000,"Block 1000, Block Group 1, Census Tract 5119.14, Santa Clara County, California",82,79,3
1000000US060855119141001,060855119141001,"Block 1001, Block Group 1, Census Tract 5119.14, Santa Clara County, California",0,0,0
1000000US060855119141002,060855119141002,"Block 1002, Block Group 1, Census Tract 5119.14, Santa Clara County, California",48,48,0
1000000US060855119141003,060855119141003,"Block 1003, Block Group 1, Census Tract 5119.14, Santa Clara County, California",60,60,0
1000000US060855119141004,060855119141004,"Block 1004, Block Group 1, Census Tract 5119.14, Santa Clara County, California",39,39,0
1000000US060855119141005,060855119141005,"Block 1005, Block Group 1, Census Tract 5119.14, Santa Clara County, California",20,20,0
1000000US060855119141006,060855119141006,"Block 1006, Block Group 1, Census Tract 5119.14, Santa Clara County, California",39,39,0
1000000US060855119141007,060855119141007,"Block 1007, Block Group 1, Census Tract 5119.14, Santa Clara County, California",33,31,2
1000000US060855119141008,060855119141008,"Block 1008, Block Group 1, Census Tract 5119.14, Santa Clara County, California",23,22,1
1000000US060855119141009,060855119141009,"Block 1009, Block Group 1, Census Tract 5119.14, Santa Clara County, California",31,30,1
1000000US060855119141010,060855119141010,"Block 1010, Block Group 1, Census Tract 5119.14, Santa Clara County, California",31,31,0
1000000US060855119141011,060855119141011,"Block 1011, Block Group 1, Census Tract 5119.14, Santa Clara County, California",38,34,4
1000000US060855119141012,060855119141012,"Block 1012, Block Group 1, Census Tract 5119.14, Santa Clara County, California",27,27,0
1000000US060855119142000,060855119142000,"Block 2000, Block Group 2, Census Tract 5119.14, Santa Clara County, California",52,51,1
1000000US060855119142001,060855119142001,"Block 2001, Block Group 2, Census Tract 5119.14, Santa Clara County, California",30,30,0
1000000US060855119142002,060855119142002,"Block 2002, Block Group 2, Census Tract 5119.14, Santa Clara County, California",48,48,0
1000000US060855119142003,060855119142003,"Block 2003, Block Group 2, Census Tract 5119.14, Santa Clara County, California",69,69,0
1000000US060855119142004,060855119142004,"Block 2004, Block Group 2, Census Tract 5119.14, Santa Clara County, California",40,40,0
1000000US060855119142005,060855119142005,"Block 2005, Block Group 2, Census Tract 5119.14, Santa Clara County, California",36,36,0
1000000US060855119142006,060855119142006,"Block 2006, Block Group 2, Census Tract 5119.14, Santa Clara County, California",24,23,1
1000000US060855119142007,060855119142007,"Block 2007, Block Group 2, Census Tract 5119.14, Santa Clara County, California",93,93,0
1000000US060855119142008,060855119142008,"Block 2008, Block Group 2, Census Tract 5119.14, Santa Clara County, California",54,54,0
1000000US060855119142009,060855119142009,"Block 2009, Block Group 2, Census Tract 5119.14, Santa Clara County, California",33,33,0
1000000US060855119142010,060855119142010,"Block 2010, Block Group 2, Census Tract 5119.14, Santa Clara County, California",16,16,0
1000000US060855119142011,060855119142011,"Block 2011, Block Group 2, Census Tract 5119.14, Santa Clara County, California",58,58,0
1000000US060855119142012,060855119142012,"Block 2012, Block Group 2, Census Tract 5119.14, Santa Clara County, California",27,27,0
1000000US060855119142013,060855119142013,"Block 2013, Block Group 2, Census Tract 5119.14, Santa Clara County, California",41,41,0
1000000US060855119142014,060855119142014,"Block 2014, Block Group 2, Census Tract 5119.14, Santa Clara County, California",34,33,1
1000000US060855119142015,060855119142015,"Block 2015, Block Group 2, Census Tract 5119.14, Santa Clara County, California",51,50,1
1000000US060855119142016,060855119142016,"Block 2016, Block Group 2, Census Tract 5119.14, Santa Clara County, California",66,65,1
1000000US060855119142017,060855119142017,"Block 2017, Block Group 2, Census Tract 5119.14, Santa Clara County, California",25,24,1
1000000US060855119142018,060855119142018,"Block 2018, Block Group 2, Census Tract 5119.14, Santa Clara County, California",28,28,0
1000000US060855119142019,060855119142019,"Block 2019, Block Group 2, Census Tract 5119.14, Santa Clara County, California",28,28,0
1000000US060855119142020,060855119142020,"Block 2020, Block Group 2, Census Tract 5119.14, Santa Clara County, California",18,18,0
1000000US060855119142021,060855119142021,"Block 2021, Block Group 2, Census Tract 5119.14, Santa Clara County, California",17,17,0
1000000US060855119142022,060855119142022,"Block 2022, Block Group 2, Census Tract 5119.14, Santa Clara County, California",34,34,0
1000000US060855119142023,060855119142023,"Block 2023, Block Group 2, Census Tract 5119.14, Santa Clara County, California",31,29,2
1000000US060855119143000,060855119143000,"Block 3000, Block Group 3, Census Tract 5119.14, Santa Clara County, California",54,53,1
1000000US060855119143001,060855119143001,"Block 3001, Block Group 3, Census Tract 5119.14, Santa Clara County, California",17,17,0
1000000US060855119143002,060855119143002,"Block 3002, Block Group 3, Census Tract 5119.14, Santa Clara County, California",20,20,0
1000000US060855119143003,060855119143003,"Block 3003, Block Group 3, Census Tract 5119.14, Santa Clara County, California",37,37,0
1000000US060855119143004,060855119143004,"Block 3004, Block Group 3, Census Tract 5119.14, Santa Clara County, California",34,34,0
1000000US060855119143005,060855119143005,"Block 3005, Block Group 3, Census Tract 5119.14, Santa Clara County, California",25,25,0
1000000US060855119143006,060855119143006,"Block 3006, Block Group 3, Census Tract 5119.14, Santa Clara County, California",19,19,0
1000000US060855119143007,060855119143007,"Block 3007, Block Group 3, Census Tract 5119.14, Santa Clara County, California",33,33,0
1000000US060855119143008,060855119143008,"Block 3008, Block Group 3, Census Tract 5119.14, Santa Clara County, California",32,29,3
1000000US060855119143009,060855119143009,"Block 3009, Block Group 3, Census Tract 5119.14, Santa Clara County, California",27,26,1
1000000US060855119143010,060855119143010,"Block 3010, Block Group 3, Census Tract 5119.14, Santa Clara County, California",15,13,2
1000000US060855119143011,060855119143011,"Block 3011, Block Group 3, Census Tract 5119.14, Santa Clara County, California",10,10,0
1000000US060855119143012,060855119143012,"Block 3012, Block Group 3, Census Tract 5119.14, Santa Clara County, California",46,44,2
1000000US060855119143013,060855119143013,"Block 3013, Block Group 3, Census Tract 5119.14, Santa Clara County, California",16,16,0
1000000US060855119143014,060855119143014,"Block 3014, Block Group 3, Census Tract 5119.14, Santa Clara County, California",52,52,0
1000000US060855119143015,060855119143015,"Block 3015, Block Group 3, Census Tract 5119.14, Santa Clara County, California",19,19,0
1000000US060855119143016,060855119143016,"Block 3016, Block Group 3, Census Tract 5119.14, Santa Clara County, California",27,27,0
1000000US060855119143017,060855119143017,"Block 3017, Block Group 3, Census Tract 5119.14, Santa Clara County, California",52,52,0
1000000US060855119143018,060855119143018,"Block 3018, Block Group 3, Census Tract 5119.14, Santa Clara County, California",23,23,0
1000000US060855119143019,060855119143019,"Block 3019, Block Group 3, Census Tract 5119.14, Santa Clara County, California",0,0,0
1000000US060855119143020,060855119143020,"Block 3020, Block Group 3, Census Tract 5119.14, Santa Clara County, California",0,0,0
1000000US060855119151000,060855119151000,"Block 1000, Block Group 1, Census Tract 5119.15, Santa Clara County, California",38,38,0
1000000US060855119151001,060855119151001,"Block 1001, Block Group 1, Census Tract 5119.15, Santa Clara County, California",38,38,0
1000000US060855119151002,060855119151002,"Block 1002, Block Group 1, Census Tract 5119.15, Santa Clara County, California",96,95,1
1000000US060855119151003,060855119151003,"Block 1003, Block Group 1, Census Tract 5119.15, Santa Clara County, California",0,0,0
1000000US060855119151004,060855119151004,"Block 1004, Block Group 1, Census Tract 5119.15, Santa Clara County, California",0,0,0
1000000US060855119151005,060855119151005,"Block 1005, Block Group 1, Census Tract 5119.15, Santa Clara County, California",34,33,1
1000000US060855119151006,060855119151006,"Block 1006, Block Group 1, Census Tract 5119.15, Santa Clara County, California",84,79,5
1000000US060855119151007,060855119151007,"Block 1007, Block Group 1, Census Tract 5119.15, Santa Clara County, California",14,14,0
1000000US060855119151008,060855119151008,"Block 1008, Block Group 1, Census Tract 5119.15, Santa Clara County, California",101,100,1
1000000US060855119151009,060855119151009,"Block 1009, Block Group 1, Census Tract 5119.15, Santa Clara County, California",19,19,0
1000000US060855119151010,060855119151010,"Block 1010, Block Group 1, Census Tract 5119.15, Santa Clara County, California",36,35,1
1000000US060855119151011,060855119151011,"Block 1011, Block Group 1, Census Tract 5119.15, Santa Clara County, California",16,16,0
1000000US060855119151012,060855119151012,"Block 1012, Block Group 1, Census Tract 5119.15, Santa Clara County, California",16,16,0
1000000US060855119152000,060855119152000,"Block 2000, Block Group 2, Census Tract 5119.15, Santa Clara County, California",0,0,0
1000000US060855119152001,060855119152001,"Block 2001, Block Group 2, Census Tract 5119.15, Santa Clara County, California",244,235,9
1000000US060855119152002,060855119152002,"Block 2002, Block Group 2, Census Tract 5119.15, Santa Clara County, California",168,158,10
1000000US060855119152003,060855119152003,"Block 2003, Block Group 2, Census Tract 5119.15, Santa Clara County, California",36,36,0
1000000US060855119152004,060855119152004,"Block 2004, Block Group 2, Census Tract 5119.15, Santa Clara County, California",72,71,1
1000000US060855119152005,060855119152005,"Block 2005, Block Group 2, Census Tract 5119.15, Santa Clara County, California",56,53,3
1000000US060855119152006,060855119152006,"Block 2006, Block Group 2, Census Tract 5119.15, Santa Clara County, California",141,128,13
1000000US060855119152007,060855119152007,"Block 2007, Block Group 2, Census Tract 5119.15, Santa Clara County, California",19,19,0
1000000US060855119152008,060855119152008,"Block 2008, Block Group 2, Census Tract 5119.15, Santa Clara County, California",21,21,0
1000000US060855119152009,060855119152009,"Block 2009, Block Group 2, Census Tract 5119.15, Santa Clara County, California",22,22,0
1000000US060855119161000,060855119161000,"Block 1000, Block Group 1, Census Tract 5119.16, Santa Clara County, California",22,22,0
1000000US060855119161001,060855119161001,"Block 1001, Block Group 1, Census Tract 5119.16, Santa Clara County, California",0,0,0
1000000US060855119161002,060855119161002,"Block 1002, Block Group 1, Census Tract 5119.16, Santa Clara County, California",24,23,1
1000000US060855119161003,060855119161003,"Block 1003, Block Group 1, Census Tract 5119.16, Santa Clara County, California",34,33,1
1000000US060855119161004,060855119161004,"Block 1004, Block Group 1, Census Tract 5119.16, Santa Clara County, California",40,38,2
1000000US060855119161005,060855119161005,"Block 1005, Block Group 1, Census Tract 5119.16, Santa Clara County, California",24,24,0
1000000US060855119161006,060855119161006,"Block 1006, Block Group 1, Census Tract 5119.16, Santa Clara County, California",44,44,0
1000000US060855119161007,060855119161007,"Block 1007, Block Group 1, Census Tract 5119.16, Santa Clara County, California",26,26,0
1000000US060855119161008,060855119161008,"Block 1008, Block Group 1, Census Tract 5119.16, Santa Clara County, California",44,42,2
1000000US060855119161009,060855119161009,"Block 1009, Block Group 1, Census Tract 5119.16, Santa Clara County, California",32,32,0
1000000US060855119161010,060855119161010,"Block 1010, Block Group 1, Census Tract 5119.16, Santa Clara County, California",98,96,2
1000000US060855119161011,060855119161011,"Block 1011, Block Group 1, Census Tract 5119.16, Santa Clara County, California",22,22,0
1000000US060855119161012,060855119161012,"Block 1012, Block Group 1, Census Tract 5119.16, Santa Clara County, California",41,41,0
1000000US060855119161013,060855119161013,"Block 1013, Block Group 1, Census Tract 5119.16, Santa Clara County, California",64,64,0
1000000US060855119161014,060855119161014,"Block 1014, Block Group 1, Census Tract 5119.16, Santa Clara County, California",103,77,26
1000000US060855119161015,060855119161015,"Block 1015, Block Group 1, Census Tract 5119.16, Santa Clara County, California",29,28,1
1000000US060855119161016,060855119161016,"Block 1016, Block Group 1, Census Tract 5119.16, Santa Clara County, California",89,85,4
1000000US060855119161017,060855119161017,"Block 1017, Block Group 1, Census Tract 5119.16, Santa Clara County, California",18,18,0
1000000US060855119162000,060855119162000,"Block 2000, Block Group 2, Census Tract 5119.16, Santa Clara County, California",28,27,1
1000000US060855119162001,060855119162001,"Block 2001, Block Group 2, Census Tract 5119.16, Santa Clara County, California",28,28,0
1000000US060855119162002,060855119162002,"Block 2002, Block Group 2, Census Tract 5119.16, Santa Clara County, California",267,266,1
1000000US060855119162003,060855119162003,"Block 2003, Block Group 2, Census Tract 5119.16, Santa Clara County, California",58,58,0
1000000US060855119162004,060855119162004,"Block 2004, Block Group 2, Census Tract 5119.16, Santa Clara County, California",52,51,1
1000000US060855119162005,060855119162005,"Block 2005, Block Group 2, Census Tract 5119.16, Santa Clara County, California",20,20,0
1000000US060855119162006,060855119162006,"Block 2006, Block Group 2, Census Tract 5119.16, Santa Clara County, California",22,21,1
1000000US060855119162007,060855119162007,"Block 2007, Block Group 2, Census Tract 5119.16, Santa Clara County, California",23,23,0
1000000US060855119162008,060855119162008,"Block 2008, Block Group 2, Census Tract 5119.16, Santa Clara County, California",31,31,0
1000000US060855119162009,060855119162009,"Block 2009, Block Group 2, Census Tract 5119.16, Santa Clara County, California",25,25,0
1000000US060855119162010,060855119162010,"Block 2010, Block Group 2, Census Tract 5119.16, Santa Clara County, California",31,31,0
1000000US060855119162011,060855119162011,"Block 2011, Block Group 2, Census Tract 5119.16, Santa Clara County, California",20,20,0
1000000US060855119162012,060855119162012,"Block 2012, Block Group 2, Census Tract 5119.16, Santa Clara County, California",11,11,0
1000000US060855119162013,060855119162013,"Block 2013, Block Group 2, Census Tract 5119.16, Santa Clara County, California",19,19,0
1000000US060855119162014,060855119162014,"Block 2014, Block Group 2, Census Tract 5119.16, Santa Clara County, California",35,35,0
1000000US060855119162015,060855119162015,"Block 2015, Block Group 2, Census Tract 5119.16, Santa Clara County, California",0,0,0
1000000US060855119162016,060855119162016,"Block 2016, Block Group 2, Census Tract 5119.16, Santa Clara County, California",0,0,0
1000000US060855119162017,060855119162017,"Block 2017, Block Group 2, Census Tract 5119.16, Santa Clara County, California",16,16,0
1000000US060855119162018,060855119162018,"Block 2018, Block Group 2, Census Tract 5119.16, Santa Clara County, California",4,4,0
1000000US060855119162019,060855119162019,"Block 2019, Block Group 2, Census Tract 5119.16, Santa Clara County, California",0,0,0
1000000US060855119162020,060855119162020,"Block 2020, Block Group 2, Census Tract 5119.16, Santa Clara County, California",53,53,0
1000000US060855119162021,060855119162021,"Block 2021, Block Group 2, Census Tract 5119.16, Santa Clara County, California",43,42,1
1000000US060855119162022,060855119162022,"Block 2022, Block Group 2, Census Tract 5119.16, Santa Clara County, California",45,45,0
1000000US060855119162023,060855119162023,"Block 2023, Block Group 2, Census Tract 5119.16, Santa Clara County, California",40,40,0
1000000US060855119162024,060855119162024,"Block 2024, Block Group 2, Census Tract 5119.16, Santa Clara County, California",30,30,0
1000000US060855119162025,060855119162025,"Block 2025, Block Group 2, Census Tract 5119.16, Santa Clara County, California",27,25,2
1000000US060855120011000,060855120011000,"Block 1000, Block Group 1, Census Tract 5120.01, Santa Clara County, California",32,32,0
1000000US060855120011001,060855120011001,"Block 1001, Block Group 1, Census Tract 5120.01, Santa Clara County, California",19,19,0
1000000US060855120011002,060855120011002,"Block 1002, Block Group 1, Census Tract 5120.01, Santa Clara County, California",0,0,0
1000000US060855120011003,060855120011003,"Block 1003, Block Group 1, Census Tract 5120.01, Santa Clara County, California",0,0,0
1000000US060855120011004,060855120011004,"Block 1004, Block Group 1, Census Tract 5120.01, Santa Clara County, California",0,0,0
1000000US060855120011005,060855120011005,"Block 1005, Block Group 1, Census Tract 5120.01, Santa Clara County, California",0,0,0
1000000US060855120011006,060855120011006,"Block 1006, Block Group 1, Census Tract 5120.01, Santa Clara County, California",0,0,0
1000000US060855120011007,060855120011007,"Block 1007, Block Group 1, Census Tract 5120.01, Santa Clara County, California",0,0,0
1000000US060855120011008,060855120011008,"Block 1008, Block Group 1, Census Tract 5120.01, Santa Clara County, California",0,0,0
1000000US060855120011009,060855120011009,"Block 1009, Block Group 1, Census Tract 5120.01, Santa Clara County, California",0,0,0
1000000US060855120011010,060855120011010,"Block 1010, Block Group 1, Census Tract 5120.01, Santa Clara County, California",0,0,0
1000000US060855120011011,060855120011011,"Block 1011, Block Group 1, Census Tract 5120.01, Santa Clara County, California",50,50,0
1000000US060855120011012,060855120011012,"Block 1012, Block Group 1, Census Tract 5120.01, Santa Clara County, California",0,0,0
1000000US060855120011013,060855120011013,"Block 1013, Block Group 1, Census Tract 5120.01, Santa Clara County, California",0,0,0
1000000US060855120011014,060855120011014,"Block 1014, Block Group 1, Census Tract 5120.01, Santa Clara County, California",40,37,3
1000000US060855120011015,060855120011015,"Block 1015, Block Group 1, Census Tract 5120.01, Santa Clara County, California",0,0,0
1000000US060855120011016,060855120011016,"Block 1016, Block Group 1, Census Tract 5120.01, Santa Clara County, California",0,0,0
1000000US060855120011017,060855120011017,"Block 1017, Block Group 1, Census Tract 5120.01, Santa Clara County, California",0,0,0
1000000US060855120011018,060855120011018,"Block 1018, Block Group 1, Census Tract 5120.01, Santa Clara County, California",0,0,0
1000000US060855120011019,060855120011019,"Block 1019, Block Group 1, Census Tract 5120.01, Santa Clara County, California",0,0,0
1000000US060855120011020,060855120011020,"Block 1020, Block Group 1, Census Tract 5120.01, Santa Clara County, California",0,0,0
1000000US060855120011021,060855120011021,"Block 1021, Block Group 1, Census Tract 5120.01, Santa Clara County, California",1,1,0
1000000US060855120011022,060855120011022,"Block 1022, Block Group 1, Census Tract 5120.01, Santa Clara County, California",9,9,0
1000000US060855120011023,060855120011023,"Block 1023, Block Group 1, Census Tract 5120.01, Santa Clara County, California",0,0,0
1000000US060855120011024,060855120011024,"Block 1024, Block Group 1, Census Tract 5120.01, Santa Clara County, California",0,0,0
1000000US060855120011025,060855120011025,"Block 1025, Block Group 1, Census Tract 5120.01, Santa Clara County, California",3,3,0
1000000US060855120011026,060855120011026,"Block 1026, Block Group 1, Census Tract 5120.01, Santa Clara County, California",109,106,3
1000000US060855120011027,060855120011027,"Block 1027, Block Group 1, Census Tract 5120.01, Santa Clara County, California",0,0,0
1000000US060855120011028,060855120011028,"Block 1028, Block Group 1, Census Tract 5120.01, Santa Clara County, California",1,1,0
1000000US060855120011029,060855120011029,"Block 1029, Block Group 1, Census Tract 5120.01, Santa Clara County, California",1,1,0
1000000US060855120011030,060855120011030,"Block 1030, Block Group 1, Census Tract 5120.01, Santa Clara County, California",22,22,0
1000000US060855120011031,060855120011031,"Block 1031, Block Group 1, Census Tract 5120.01, Santa Clara County, California",2,2,0
1000000US060855120011032,060855120011032,"Block 1032, Block Group 1, Census Tract 5120.01, Santa Clara County, California",14,14,0
1000000US060855120011033,060855120011033,"Block 1033, Block Group 1, Census Tract 5120.01, Santa Clara County, California",31,31,0
1000000US060855120011034,060855120011034,"Block 1034, Block Group 1, Census Tract 5120.01, Santa Clara County, California",1,1,0
1000000US060855120011035,060855120011035,"Block 1035, Block Group 1, Census Tract 5120.01, Santa Clara County, California",3,3,0
1000000US060855120011036,060855120011036,"Block 1036, Block Group 1, Census Tract 5120.01, Santa Clara County, California",4,4,0
1000000US060855120011037,060855120011037,"Block 1037, Block Group 1, Census Tract 5120.01, Santa Clara County, California",0,0,0
1000000US060855120011038,060855120011038,"Block 1038, Block Group 1, Census Tract 5120.01, Santa Clara County, California",1,0,1
1000000US060855120011039,060855120011039,"Block 1039, Block Group 1, Census Tract 5120.01, Santa Clara County, California",35,35,0
1000000US060855120011040,060855120011040,"Block 1040, Block Group 1, Census Tract 5120.01, Santa Clara County, California",62,62,0
1000000US060855120011041,060855120011041,"Block 1041, Block Group 1, Census Tract 5120.01, Santa Clara County, California",24,24,0
1000000US060855120011042,060855120011042,"Block 1042, Block Group 1, Census Tract 5120.01, Santa Clara County, California",42,42,0
1000000US060855120011043,060855120011043,"Block 1043, Block Group 1, Census Tract 5120.01, Santa Clara County, California",36,35,1
1000000US060855120011044,060855120011044,"Block 1044, Block Group 1, Census Tract 5120.01, Santa Clara County, California",0,0,0
1000000US060855120011045,060855120011045,"Block 1045, Block Group 1, Census Tract 5120.01, Santa Clara County, California",0,0,0
1000000US060855120011046,060855120011046,"Block 1046, Block Group 1, Census Tract 5120.01, Santa Clara County, California",0,0,0
1000000US060855120011047,060855120011047,"Block 1047, Block Group 1, Census Tract 5120.01, Santa Clara County, California",341,335,6
1000000US060855120011048,060855120011048,"Block 1048, Block Group 1, Census Tract 5120.01, Santa Clara County, California",8,8,0
1000000US060855120011049,060855120011049,"Block 1049, Block Group 1, Census Tract 5120.01, Santa Clara County, California",15,14,1
1000000US060855120011050,060855120011050,"Block 1050, Block Group 1, Census Tract 5120.01, Santa Clara County, California",69,68,1
1000000US060855120011051,060855120011051,"Block 1051, Block Group 1, Census Tract 5120.01, Santa Clara County, California",0,0,0
1000000US060855120011052,060855120011052,"Block 1052, Block Group 1, Census Tract 5120.01, Santa Clara County, California",48,45,3
1000000US060855120011053,060855120011053,"Block 1053, Block Group 1, Census Tract 5120.01, Santa Clara County, California",0,0,0
1000000US060855120011054,060855120011054,"Block 1054, Block Group 1, Census Tract 5120.01, Santa Clara County, California",1,1,0
1000000US060855120011055,060855120011055,"Block 1055, Block Group 1, Census Tract 5120.01, Santa Clara County, California",5,4,1
1000000US060855120011056,060855120011056,"Block 1056, Block Group 1, Census Tract 5120.01, Santa Clara County, California",0,0,0
1000000US060855120011057,060855120011057,"Block 1057, Block Group 1, Census Tract 5120.01, Santa Clara County, California",0,0,0
1000000US060855120011058,060855120011058,"Block 1058, Block Group 1, Census Tract 5120.01, Santa Clara County, California",0,0,0
1000000US060855120011059,060855120011059,"Block 1059, Block Group 1, Census Tract 5120.01, Santa Clara County, California",0,0,0
1000000US060855120011060,060855120011060,"Block 1060, Block Group 1, Census Tract 5120.01, Santa Clara County, California",20,20,0
1000000US060855120011061,060855120011061,"Block 1061, Block Group 1, Census Tract 5120.01, Santa Clara County, California",9,9,0
1000000US060855120012000,060855120012000,"Block 2000, Block Group 2, Census Tract 5120.01, Santa Clara County, California",64,63,1
1000000US060855120012001,060855120012001,"Block 2001, Block Group 2, Census Tract 5120.01, Santa Clara County, California",57,56,1
1000000US060855120012002,060855120012002,"Block 2002, Block Group 2, Census Tract 5120.01, Santa Clara County, California",21,21,0
1000000US060855120012003,060855120012003,"Block 2003, Block Group 2, Census Tract 5120.01, Santa Clara County, California",18,17,1
1000000US060855120012004,060855120012004,"Block 2004, Block Group 2, Census Tract 5120.01, Santa Clara County, California",85,83,2
1000000US060855120012005,060855120012005,"Block 2005, Block Group 2, Census Tract 5120.01, Santa Clara County, California",30,30,0
1000000US060855120012006,060855120012006,"Block 2006, Block Group 2, Census Tract 5120.01, Santa Clara County, California",39,37,2
1000000US060855120012007,060855120012007,"Block 2007, Block Group 2, Census Tract 5120.01, Santa Clara County, California",9,9,0
1000000US060855120012008,060855120012008,"Block 2008, Block Group 2, Census Tract 5120.01, Santa Clara County, California",21,21,0
1000000US060855120012009,060855120012009,"Block 2009, Block Group 2, Census Tract 5120.01, Santa Clara County, California",9,9,0
1000000US060855120012010,060855120012010,"Block 2010, Block Group 2, Census Tract 5120.01, Santa Clara County, California",15,15,0
1000000US060855120012011,060855120012011,"Block 2011, Block Group 2, Census Tract 5120.01, Santa Clara County, California",24,24,0
1000000US060855120013000,060855120013000,"Block 3000, Block Group 3, Census Tract 5120.01, Santa Clara County, California",15,15,0
1000000US060855120013001,060855120013001,"Block 3001, Block Group 3, Census Tract 5120.01, Santa Clara County, California",374,371,3
1000000US060855120013002,060855120013002,"Block 3002, Block Group 3, Census Tract 5120.01, Santa Clara County, California",49,48,1
1000000US060855120013003,060855120013003,"Block 3003, Block Group 3, Census Tract 5120.01, Santa Clara County, California",0,0,0
1000000US060855120013004,060855120013004,"Block 3004, Block Group 3, Census Tract 5120.01, Santa Clara County, California",76,73,3
1000000US060855120013005,060855120013005,"Block 3005, Block Group 3, Census Tract 5120.01, Santa Clara County, California",58,55,3
1000000US060855120013006,060855120013006,"Block 3006, Block Group 3, Census Tract 5120.01, Santa Clara County, California",0,0,0
1000000US060855120051000,060855120051000,"Block 1000, Block Group 1, Census Tract 5120.05, Santa Clara County, California",107,107,0
1000000US060855120051001,060855120051001,"Block 1001, Block Group 1, Census Tract 5120.05, Santa Clara County, California",49,48,1
1000000US060855120051002,060855120051002,"Block 1002, Block Group 1, Census Tract 5120.05, Santa Clara County, California",27,27,0
1000000US060855120051003,060855120051003,"Block 1003, Block Group 1, Census Tract 5120.05, Santa Clara County, California",88,86,2
1000000US060855120051004,060855120051004,"Block 1004, Block Group 1, Census Tract 5120.05, Santa Clara County, California",36,36,0
1000000US060855120051005,060855120051005,"Block 1005, Block Group 1, Census Tract 5120.05, Santa Clara County, California",47,47,0
1000000US060855120051006,060855120051006,"Block 1006, Block Group 1, Census Tract 5120.05, Santa Clara County, California",23,23,0
1000000US060855120051007,060855120051007,"Block 1007, Block Group 1, Census Tract 5120.05, Santa Clara County, California",43,43,0
1000000US060855120052000,060855120052000,"Block 2000, Block Group 2, Census Tract 5120.05, Santa Clara County, California",49,49,0
1000000US060855120052001,060855120052001,"Block 2001, Block Group 2, Census Tract 5120.05, Santa Clara County, California",50,50,0
1000000US060855120052002,060855120052002,"Block 2002, Block Group 2, Census Tract 5120.05, Santa Clara County, California",47,47,0
1000000US060855120052003,060855120052003,"Block 2003, Block Group 2, Census Tract 5120.05, Santa Clara County, California",29,29,0
1000000US060855120052004,060855120052004,"Block 2004, Block Group 2, Census Tract 5120.05, Santa Clara County, California",33,33,0
1000000US060855120052005,060855120052005,"Block 2005, Block Group 2, Census Tract 5120.05, Santa Clara County, California",36,35,1
1000000US060855120053000,060855120053000,"Block 3000, Block Group 3, Census Tract 5120.05, Santa Clara County, California",62,61,1
1000000US060855120053001,060855120053001,"Block 3001, Block Group 3, Census Tract 5120.05, Santa Clara County, California",41,41,0
1000000US060855120053002,060855120053002,"Block 3002, Block Group 3, Census Tract 5120.05, Santa Clara County, California",32,32,0
1000000US060855120053003,060855120053003,"Block 3003, Block Group 3, Census Tract 5120.05, Santa Clara County, California",45,44,1
1000000US060855120053004,060855120053004,"Block 3004, Block Group 3, Census Tract 5120.05, Santa Clara County, California",39,39,0
1000000US060855120053005,060855120053005,"Block 3005, Block Group 3, Census Tract 5120.05, Santa Clara County, California",58,56,2
1000000US060855120054000,060855120054000,"Block 4000, Block Group 4, Census Tract 5120.05, Santa Clara County, California",29,29,0
1000000US060855120054001,060855120054001,"Block 4001, Block Group 4, Census Tract 5120.05, Santa Clara County, California",31,31,0
1000000US060855120054002,060855120054002,"Block 4002, Block Group 4, Census Tract 5120.05, Santa Clara County, California",29,29,0
1000000US060855120054003,060855120054003,"Block 4003, Block Group 4, Census Tract 5120.05, Santa Clara County, California",38,37,1
1000000US060855120054004,060855120054004,"Block 4004, Block Group 4, Census Tract 5120.05, Santa Clara County, California",67,66,1
1000000US060855120054005,060855120054005,"Block 4005, Block Group 4, Census Tract 5120.05, Santa Clara County, California",52,51,1
1000000US060855120054006,060855120054006,"Block 4006, Block Group 4, Census Tract 5120.05, Santa Clara County, California",176,171,5
1000000US060855120054007,060855120054007,"Block 4007, Block Group 4, Census Tract 5120.05, Santa Clara County, California",21,20,1
1000000US060855120054008,060855120054008,"Block 4008, Block Group 4, Census Tract 5120.05, Santa Clara County, California",48,46,2
1000000US060855120054009,060855120054009,"Block 4009, Block Group 4, Census Tract 5120.05, Santa Clara County, California",21,21,0
1000000US060855120054010,060855120054010,"Block 4010, Block Group 4, Census Tract 5120.05, Santa Clara County, California",46,43,3
1000000US060855120055000,060855120055000,"Block 5000, Block Group 5, Census Tract 5120.05, Santa Clara County, California",51,47,4
1000000US060855120055001,060855120055001,"Block 5001, Block Group 5, Census Tract 5120.05, Santa Clara County, California",36,36,0
1000000US060855120055002,060855120055002,"Block 5002, Block Group 5, Census Tract 5120.05, Santa Clara County, California",40,39,1
1000000US060855120055003,060855120055003,"Block 5003, Block Group 5, Census Tract 5120.05, Santa Clara County, California",10,10,0
1000000US060855120055004,060855120055004,"Block 5004, Block Group 5, Census Tract 5120.05, Santa Clara County, California",8,7,1
1000000US060855120055005,060855120055005,"Block 5005, Block Group 5, Census Tract 5120.05, Santa Clara County, California",21,21,0
1000000US060855120055006,060855120055006,"Block 5006, Block Group 5, Census Tract 5120.05, Santa Clara County, California",48,48,0
1000000US060855120055007,060855120055007,"Block 5007, Block Group 5, Census Tract 5120.05, Santa Clara County, California",29,29,0
1000000US060855120055008,060855120055008,"Block 5008, Block Group 5, Census Tract 5120.05, Santa Clara County, California",88,84,4
1000000US060855120055009,060855120055009,"Block 5009, Block Group 5, Census Tract 5120.05, Santa Clara County, California",42,41,1
1000000US060855120055010,060855120055010,"Block 5010, Block Group 5, Census Tract 5120.05, Santa Clara County, California",0,0,0
1000000US060855120055011,060855120055011,"Block 5011, Block Group 5, Census Tract 5120.05, Santa Clara County, California",22,22,0
1000000US060855120055012,060855120055012,"Block 5012, Block Group 5, Census Tract 5120.05, Santa Clara County, California",50,50,0
1000000US060855120055013,060855120055013,"Block 5013, Block Group 5, Census Tract 5120.05, Santa Clara County, California",27,26,1
1000000US060855120055014,060855120055014,"Block 5014, Block Group 5, Census Tract 5120.05, Santa Clara County, California",5,5,0
1000000US060855120055015,060855120055015,"Block 5015, Block Group 5, Census Tract 5120.05, Santa Clara County, California",35,35,0
1000000US060855120055016,060855120055016,"Block 5016, Block Group 5, Census Tract 5120.05, Santa Clara County, California",22,21,1
1000000US060855120055017,060855120055017,"Block 5017, Block Group 5, Census Tract 5120.05, Santa Clara County, California",22,22,0
1000000US060855120055018,060855120055018,"Block 5018, Block Group 5, Census Tract 5120.05, Santa Clara County, California",39,39,0
1000000US060855120055019,060855120055019,"Block 5019, Block Group 5, Census Tract 5120.05, Santa Clara County, California",15,14,1
1000000US060855120055020,060855120055020,"Block 5020, Block Group 5, Census Tract 5120.05, Santa Clara County, California",48,48,0
1000000US060855120055021,060855120055021,"Block 5021, Block Group 5, Census Tract 5120.05, Santa Clara County, California",30,30,0
1000000US060855120171000,060855120171000,"Block 1000, Block Group 1, Census Tract 5120.17, Santa Clara County, California",61,59,2
1000000US060855120171001,060855120171001,"Block 1001, Block Group 1, Census Tract 5120.17, Santa Clara County, California",18,18,0
1000000US060855120171002,060855120171002,"Block 1002, Block Group 1, Census Tract 5120.17, Santa Clara County, California",10,10,0
1000000US060855120171003,060855120171003,"Block 1003, Block Group 1, Census Tract 5120.17, Santa Clara County, California",167,160,7
1000000US060855120171004,060855120171004,"Block 1004, Block Group 1, Census Tract 5120.17, Santa Clara County, California",72,69,3
1000000US060855120171005,060855120171005,"Block 1005, Block Group 1, Census Tract 5120.17, Santa Clara County, California",39,37,2
1000000US060855120171006,060855120171006,"Block 1006, Block Group 1, Census Tract 5120.17, Santa Clara County, California",42,41,1
1000000US060855120171007,060855120171007,"Block 1007, Block Group 1, Census Tract 5120.17, Santa Clara County, California",41,41,0
1000000US060855120171008,060855120171008,"Block 1008, Block Group 1, Census Tract 5120.17, Santa Clara County, California",14,14,0
1000000US060855120171009,060855120171009,"Block 1009, Block Group 1, Census Tract 5120.17, Santa Clara County, California",9,9,0
1000000US060855120171010,060855120171010,"Block 1010, Block Group 1, Census Tract 5120.17, Santa Clara County, California",11,10,1
1000000US060855120171011,060855120171011,"Block 1011, Block Group 1, Census Tract 5120.17, Santa Clara County, California",13,12,1
1000000US060855120171012,060855120171012,"Block 1012, Block Group 1, Census Tract 5120.17, Santa Clara County, California",247,238,9
1000000US060855120171013,060855120171013,"Block 1013, Block Group 1, Census Tract 5120.17, Santa Clara County, California",19,19,0
1000000US060855120171014,060855120171014,"Block 1014, Block Group 1, Census Tract 5120.17, Santa Clara County, California",18,18,0
1000000US060855120172000,060855120172000,"Block 2000, Block Group 2, Census Tract 5120.17, Santa Clara County, California",40,40,0
1000000US060855120172001,060855120172001,"Block 2001, Block Group 2, Census Tract 5120.17, Santa Clara County, California",22,21,1
1000000US060855120172002,060855120172002,"Block 2002, Block Group 2, Census Tract 5120.17, Santa Clara County, California",24,24,0
1000000US060855120172003,060855120172003,"Block 2003, Block Group 2, Census Tract 5120.17, Santa Clara County, California",47,47,0
1000000US060855120172004,060855120172004,"Block 2004, Block Group 2, Census Tract 5120.17, Santa Clara County, California",0,0,0
1000000US060855120172005,060855120172005,"Block 2005, Block Group 2, Census Tract 5120.17, Santa Clara County, California",0,0,0
1000000US060855120172006,060855120172006,"Block 2006, Block Group 2, Census Tract 5120.17, Santa Clara County, California",6,6,0
1000000US060855120172007,060855120172007,"Block 2007, Block Group 2, Census Tract 5120.17, Santa Clara County, California",0,0,0
1000000US060855120172008,060855120172008,"Block 2008, Block Group 2, Census Tract 5120.17, Santa Clara County, California",20,20,0
1000000US060855120172009,060855120172009,"Block 2009, Block Group 2, Census Tract 5120.17, Santa Clara County, California",17,16,1
1000000US060855120172010,060855120172010,"Block 2010, Block Group 2, Census Tract 5120.17, Santa Clara County, California",23,23,0
1000000US060855120172011,060855120172011,"Block 2011, Block Group 2, Census Tract 5120.17, Santa Clara County, California",22,22,0
1000000US060855120172012,060855120172012,"Block 2012, Block Group 2, Census Tract 5120.17, Santa Clara County, California",22,19,3
1000000US060855120172013,060855120172013,"Block 2013, Block Group 2, Census Tract 5120.17, Santa Clara County, California",23,22,1
1000000US060855120172014,060855120172014,"Block 2014, Block Group 2, Census Tract 5120.17, Santa Clara County, California",23,22,1
1000000US060855120172015,060855120172015,"Block 2015, Block Group 2, Census Tract 5120.17, Santa Clara County, California",21,21,0
1000000US060855120172016,060855120172016,"Block 2016, Block Group 2, Census Tract 5120.17, Santa Clara County, California",22,22,0
1000000US060855120172017,060855120172017,"Block 2017, Block Group 2, Census Tract 5120.17, Santa Clara County, California",52,51,1
1000000US060855120172018,060855120172018,"Block 2018, Block Group 2, Census Tract 5120.17, Santa Clara County, California",38,35,3
1000000US060855120172019,060855120172019,"Block 2019, Block Group 2, Census Tract 5120.17, Santa Clara County, California",23,22,1
1000000US060855120172020,060855120172020,"Block 2020, Block Group 2, Census Tract 5120.17, Santa Clara County, California",23,23,0
1000000US060855120172021,060855120172021,"Block 2021, Block Group 2, Census Tract 5120.17, Santa Clara County, California",21,21,0
1000000US060855120172022,060855120172022,"Block 2022, Block Group 2, Census Tract 5120.17, Santa Clara County, California",41,40,1
1000000US060855120172023,060855120172023,"Block 2023, Block Group 2, Census Tract 5120.17, Santa Clara County, California",27,25,2
1000000US060855120172024,060855120172024,"Block 2024, Block Group 2, Census Tract 5120.17, Santa Clara County, California",20,19,1
1000000US060855120173000,060855120173000,"Block 3000, Block Group 3, Census Tract 5120.17, Santa Clara County, California",169,163,6
1000000US060855120173001,060855120173001,"Block 3001, Block Group 3, Census Tract 5120.17, Santa Clara County, California",20,19,1
1000000US060855120173002,060855120173002,"Block 3002, Block Group 3, Census Tract 5120.17, Santa Clara County, California",63,61,2
1000000US060855120173003,060855120173003,"Block 3003, Block Group 3, Census Tract 5120.17, Santa Clara County, California",45,44,1
1000000US060855120173004,060855120173004,"Block 3004, Block Group 3, Census Tract 5120.17, Santa Clara County, California",35,31,4
1000000US060855120173005,060855120173005,"Block 3005, Block Group 3, Census Tract 5120.17, Santa Clara County, California",37,36,1
1000000US060855120173006,060855120173006,"Block 3006, Block Group 3, Census Tract 5120.17, Santa Clara County, California",27,26,1
1000000US060855120173007,060855120173007,"Block 3007, Block Group 3, Census Tract 5120.17, Santa Clara County, California",33,33,0
1000000US060855120173008,060855120173008,"Block 3008, Block Group 3, Census Tract 5120.17, Santa Clara County, California",202,197,5
1000000US060855120173009,060855120173009,"Block 3009, Block Group 3, Census Tract 5120.17, Santa Clara County, California",16,16,0
1000000US060855120173010,060855120173010,"Block 3010, Block Group 3, Census Tract 5120.17, Santa Clara County, California",21,21,0
1000000US060855120173011,060855120173011,"Block 3011, Block Group 3, Census Tract 5120.17, Santa Clara County, California",26,26,0
1000000US060855120173012,060855120173012,"Block 3012, Block Group 3, Census Tract 5120.17, Santa Clara County, California",39,37,2
1000000US060855120173013,060855120173013,"Block 3013, Block Group 3, Census Tract 5120.17, Santa Clara County, California",19,19,0
1000000US060855120173014,060855120173014,"Block 3014, Block Group 3, Census Tract 5120.17, Santa Clara County, California",30,29,1
1000000US060855120173015,060855120173015,"Block 3015, Block Group 3, Census Tract 5120.17, Santa Clara County, California",26,24,2
1000000US060855120191000,060855120191000,"Block 1000, Block Group 1, Census Tract 5120.19, Santa Clara County, California",77,74,3
1000000US060855120191001,060855120191001,"Block 1001, Block Group 1, Census Tract 5120.19, Santa Clara County, California",31,31,0
1000000US060855120191002,060855120191002,"Block 1002, Block Group 1, Census Tract 5120.19, Santa Clara County, California",71,70,1
1000000US060855120191003,060855120191003,"Block 1003, Block Group 1, Census Tract 5120.19, Santa Clara County, California",60,60,0
1000000US060855120191004,060855120191004,"Block 1004, Block Group 1, Census Tract 5120.19, Santa Clara County, California",9,9,0
1000000US060855120191005,060855120191005,"Block 1005, Block Group 1, Census Tract 5120.19, Santa Clara County, California",13,13,0
1000000US060855120191006,060855120191006,"Block 1006, Block Group 1, Census Tract 5120.19, Santa Clara County, California",10,10,0
1000000US060855120192000,060855120192000,"Block 2000, Block Group 2, Census Tract 5120.19, Santa Clara County, California",3,3,0
1000000US060855120192001,060855120192001,"Block 2001, Block Group 2, Census Tract 5120.19, Santa Clara County, California",166,157,9
1000000US060855120192002,060855120192002,"Block 2002, Block Group 2, Census Tract 5120.19, Santa Clara County, California",162,160,2
1000000US060855120192003,060855120192003,"Block 2003, Block Group 2, Census Tract 5120.19, Santa Clara County, California",24,24,0
1000000US060855120192004,060855120192004,"Block 2004, Block Group 2, Census Tract 5120.19, Santa Clara County, California",23,22,1
1000000US060855120192005,060855120192005,"Block 2005, Block Group 2, Census Tract 5120.19, Santa Clara County, California",26,26,0
1000000US060855120192006,060855120192006,"Block 2006, Block Group 2, Census Tract 5120.19, Santa Clara County, California",231,223,8
1000000US060855120192007,060855120192007,"Block 2007, Block Group 2, Census Tract 5120.19, Santa Clara County, California",64,63,1
1000000US060855120192008,060855120192008,"Block 2008, Block Group 2, Census Tract 5120.19, Santa Clara County, California",25,24,1
1000000US060855120192009,060855120192009,"Block 2009, Block Group 2, Census Tract 5120.19, Santa Clara County, California",46,46,0
1000000US060855120193000,060855120193000,"Block 3000, Block Group 3, Census Tract 5120.19, Santa Clara County, California",37,37,0
1000000US060855120193001,060855120193001,"Block 3001, Block Group 3, Census Tract 5120.19, Santa Clara County, California",37,36,1
1000000US060855120193002,060855120193002,"Block 3002, Block Group 3, Census Tract 5120.19, Santa Clara County, California",37,37,0
1000000US060855120193003,060855120193003,"Block 3003, Block Group 3, Census Tract 5120.19, Santa Clara County, California",221,213,8
1000000US060855120193004,060855120193004,"Block 3004, Block Group 3, Census Tract 5120.19, Santa Clara County, California",31,31,0
1000000US060855120193005,060855120193005,"Block 3005, Block Group 3, Census Tract 5120.19, Santa Clara County, California",26,24,2
1000000US060855120193006,060855120193006,"Block 3006, Block Group 3, Census Tract 5120.19, Santa Clara County, California",24,24,0
1000000US060855120193007,060855120193007,"Block 3007, Block Group 3, Census Tract 5120.19, Santa Clara County, California",26,26,0
1000000US060855120193008,060855120193008,"Block 3008, Block Group 3, Census Tract 5120.19, Santa Clara County, California",26,26,0
1000000US060855120193009,060855120193009,"Block 3009, Block Group 3, Census Tract 5120.19, Santa Clara County, California",46,46,0
1000000US060855120201000,060855120201000,"Block 1000, Block Group 1, Census Tract 5120.20, Santa Clara County, California",0,0,0
1000000US060855120201001,060855120201001,"Block 1001, Block Group 1, Census Tract 5120.20, Santa Clara County, California",109,107,2
1000000US060855120201002,060855120201002,"Block 1002, Block Group 1, Census Tract 5120.20, Santa Clara County, California",0,0,0
1000000US060855120201003,060855120201003,"Block 1003, Block Group 1, Census Tract 5120.20, Santa Clara County, California",48,47,1
1000000US060855120201004,060855120201004,"Block 1004, Block Group 1, Census Tract 5120.20, Santa Clara County, California",19,19,0
1000000US060855120201005,060855120201005,"Block 1005, Block Group 1, Census Tract 5120.20, Santa Clara County, California",42,42,0
1000000US060855120201006,060855120201006,"Block 1006, Block Group 1, Census Tract 5120.20, Santa Clara County, California",23,22,1
1000000US060855120202000,060855120202000,"Block 2000, Block Group 2, Census Tract 5120.20, Santa Clara County, California",44,44,0
1000000US060855120202001,060855120202001,"Block 2001, Block Group 2, Census Tract 5120.20, Santa Clara County, California",516,496,20
1000000US060855120202002,060855120202002,"Block 2002, Block Group 2, Census Tract 5120.20, Santa Clara County, California",32,32,0
1000000US060855120202003,060855120202003,"Block 2003, Block Group 2, Census Tract 5120.20, Santa Clara County, California",26,26,0
1000000US060855120202004,060855120202004,"Block 2004, Block Group 2, Census Tract 5120.20, Santa Clara County, California",32,31,1
1000000US060855120202005,060855120202005,"Block 2005, Block Group 2, Census Tract 5120.20, Santa Clara County, California",22,22,0
1000000US060855120202006,060855120202006,"Block 2006, Block Group 2, Census Tract 5120.20, Santa Clara County, California",4,4,0
1000000US060855120202007,060855120202007,"Block 2007, Block Group 2, Census Tract 5120.20, Santa Clara County, California",28,25,3
1000000US060855120202008,060855120202008,"Block 2008, Block Group 2, Census Tract 5120.20, Santa Clara County, California",2,2,0
1000000US060855120202009,060855120202009,"Block 2009, Block Group 2, Census Tract 5120.20, Santa Clara County, California",4,3,1
1000000US060855120203000,060855120203000,"Block 3000, Block Group 3, Census Tract 5120.20, Santa Clara County, California",0,0,0
1000000US060855120203001,060855120203001,"Block 3001, Block Group 3, Census Tract 5120.20, Santa Clara County, California",1113,1066,47
1000000US060855120203002,060855120203002,"Block 3002, Block Group 3, Census Tract 5120.20, Santa Clara County, California",0,0,0
1000000US060855120203003,060855120203003,"Block 3003, Block Group 3, Census Tract 5120.20, Santa Clara County, California",360,348,12
1000000US060855120203004,060855120203004,"Block 3004, Block Group 3, Census Tract 5120.20, Santa Clara County, California",0,0,0
1000000US060855120203005,060855120203005,"Block 3005, Block Group 3, Census Tract 5120.20, Santa Clara County, California",0,0,0
1000000US060855120203006,060855120203006,"Block 3006, Block Group 3, Census Tract 5120.20, Santa Clara County, California",222,213,9
1000000US060855120211000,060855120211000,"Block 1000, Block Group 1, Census Tract 5120.21, Santa Clara County, California",0,0,0
1000000US060855120211001,060855120211001,"Block 1001, Block Group 1, Census Tract 5120.21, Santa Clara County, California",16,16,0
1000000US060855120211002,060855120211002,"Block 1002, Block Group 1, Census Tract 5120.21, Santa Clara County, California",21,21,0
1000000US060855120211003,060855120211003,"Block 1003, Block Group 1, Census Tract 5120.21, Santa Clara County, California",49,49,0
1000000US060855120211004,060855120211004,"Block 1004, Block Group 1, Census Tract 5120.21, Santa Clara County, California",54,52,2
1000000US060855120211005,060855120211005,"Block 1005, Block Group 1, Census Tract 5120.21, Santa Clara County, California",32,32,0
1000000US060855120211006,060855120211006,"Block 1006, Block Group 1, Census Tract 5120.21, Santa Clara County, California",0,0,0
1000000US060855120211007,060855120211007,"Block 1007, Block Group 1, Census Tract 5120.21, Santa Clara County, California",16,16,0
1000000US060855120211008,060855120211008,"Block 1008, Block Group 1, Census Tract 5120.21, Santa Clara County, California",84,84,0
1000000US060855120211009,060855120211009,"Block 1009, Block Group 1, Census Tract 5120.21, Santa Clara County, California",64,64,0
1000000US060855120211010,060855120211010,"Block 1010, Block Group 1, Census Tract 5120.21, Santa Clara County, California",45,45,0
1000000US060855120211011,060855120211011,"Block 1011, Block Group 1, Census Tract 5120.21, Santa Clara County, California",49,49,0
1000000US060855120212000,060855120212000,"Block 2000, Block Group 2, Census Tract 5120.21, Santa Clara County, California",0,0,0
1000000US060855120212001,060855120212001,"Block 2001, Block Group 2, Census Tract 5120.21, Santa Clara County, California",0,0,0
1000000US060855120212002,060855120212002,"Block 2002, Block Group 2, Census Tract 5120.21, Santa Clara County, California",16,16,0
1000000US060855120212003,060855120212003,"Block 2003, Block Group 2, Census Tract 5120.21, Santa Clara County, California",28,28,0
1000000US060855120212004,060855120212004,"Block 2004, Block Group 2, Census Tract 5120.21, Santa Clara County, California",0,0,0
1000000US060855120212005,060855120212005,"Block 2005, Block Group 2, Census Tract 5120.21, Santa Clara County, California",85,80,5
1000000US060855120212006,060855120212006,"Block 2006, Block Group 2, Census Tract 5120.21, Santa Clara County, California",9,7,2
1000000US060855120212007,060855120212007,"Block 2007, Block Group 2, Census Tract 5120.21, Santa Clara County, California",10,10,0
1000000US060855120212008,060855120212008,"Block 2008, Block Group 2, Census Tract 5120.21, Santa Clara County, California",29,28,1
1000000US060855120212009,060855120212009,"Block 2009, Block Group 2, Census Tract 5120.21, Santa Clara County, California",21,21,0
1000000US060855120212010,060855120212010,"Block 2010, Block Group 2, Census Tract 5120.21, Santa Clara County, California",24,24,0
1000000US060855120212011,060855120212011,"Block 2011, Block Group 2, Census Tract 5120.21, Santa Clara County, California",39,38,1
1000000US060855120212012,060855120212012,"Block 2012, Block Group 2, Census Tract 5120.21, Santa Clara County, California",113,110,3
1000000US060855120212013,060855120212013,"Block 2013, Block Group 2, Census Tract 5120.21, Santa Clara County, California",0,0,0
1000000US060855120212014,060855120212014,"Block 2014, Block Group 2, Census Tract 5120.21, Santa Clara County, California",21,21,0
1000000US060855120212015,060855120212015,"Block 2015, Block Group 2, Census Tract 5120.21, Santa Clara County, California",24,24,0
1000000US060855120212016,060855120212016,"Block 2016, Block Group 2, Census Tract 5120.21, Santa Clara County, California",10,10,0
1000000US060855120212017,060855120212017,"Block 2017, Block Group 2, Census Tract 5120.21, Santa Clara County, California",11,11,0
1000000US060855120212018,060855120212018,"Block 2018, Block Group 2, Census Tract 5120.21, Santa Clara County, California",12,12,0
1000000US060855120212019,060855120212019,"Block 2019, Block Group 2, Census Tract 5120.21, Santa Clara County, California",12,12,0
1000000US060855120212020,060855120212020,"Block 2020, Block Group 2, Census Tract 5120.21, Santa Clara County, California",49,46,3
1000000US060855120212021,060855120212021,"Block 2021, Block Group 2, Census Tract 5120.21, Santa Clara County, California",20,20,0
1000000US060855120212022,060855120212022,"Block 2022, Block Group 2, Census Tract 5120.21, Santa Clara County, California",43,43,0
1000000US060855120212023,060855120212023,"Block 2023, Block Group 2, Census Tract 5120.21, Santa Clara County, California",20,19,1
1000000US060855120213000,060855120213000,"Block 3000, Block Group 3, Census Tract 5120.21, Santa Clara County, California",28,28,0
1000000US060855120213001,060855120213001,"Block 3001, Block Group 3, Census Tract 5120.21, Santa Clara County, California",30,30,0
1000000US060855120213002,060855120213002,"Block 3002, Block Group 3, Census Tract 5120.21, Santa Clara County, California",22,22,0
1000000US060855120213003,060855120213003,"Block 3003, Block Group 3, Census Tract 5120.21, Santa Clara County, California",23,22,1
1000000US060855120213004,060855120213004,"Block 3004, Block Group 3, Census Tract 5120.21, Santa Clara County, California",56,56,0
1000000US060855120213005,060855120213005,"Block 3005, Block Group 3, Census Tract 5120.21, Santa Clara County, California",32,32,0
1000000US060855120213006,060855120213006,"Block 3006, Block Group 3, Census Tract 5120.21, Santa Clara County, California",156,151,5
1000000US060855120213007,060855120213007,"Block 3007, Block Group 3, Census Tract 5120.21, Santa Clara County, California",23,22,1
1000000US060855120213008,060855120213008,"Block 3008, Block Group 3, Census Tract 5120.21, Santa Clara County, California",6,6,0
1000000US060855120213009,060855120213009,"Block 3009, Block Group 3, Census Tract 5120.21, Santa Clara County, California",31,31,0
1000000US060855120213010,060855120213010,"Block 3010, Block Group 3, Census Tract 5120.21, Santa Clara County, California",8,8,0
1000000US060855120214000,060855120214000,"Block 4000, Block Group 4, Census Tract 5120.21, Santa Clara County, California",0,0,0
1000000US060855120214001,060855120214001,"Block 4001, Block Group 4, Census Tract 5120.21, Santa Clara County, California",103,101,2
1000000US060855120214002,060855120214002,"Block 4002, Block Group 4, Census Tract 5120.21, Santa Clara County, California",31,29,2
1000000US060855120214003,060855120214003,"Block 4003, Block Group 4, Census Tract 5120.21, Santa Clara County, California",18,17,1
1000000US060855120214004,060855120214004,"Block 4004, Block Group 4, Census Tract 5120.21, Santa Clara County, California",26,26,0
1000000US060855120214005,060855120214005,"Block 4005, Block Group 4, Census Tract 5120.21, Santa Clara County, California",26,26,0
1000000US060855120214006,060855120214006,"Block 4006, Block Group 4, Census Tract 5120.21, Santa Clara County, California",19,18,1
1000000US060855120214007,060855120214007,"Block 4007, Block Group 4, Census Tract 5120.21, Santa Clara County, California",27,25,2
1000000US060855120214008,060855120214008,"Block 4008, Block Group 4, Census Tract 5120.21, Santa Clara County, California",20,19,1
1000000US060855120214009,060855120214009,"Block 4009, Block Group 4, Census Tract 5120.21, Santa Clara County, California",30,30,0
1000000US060855120214010,060855120214010,"Block 4010, Block Group 4, Census Tract 5120.21, Santa Clara County, California",42,42,0
1000000US060855120214011,060855120214011,"Block 4011, Block Group 4, Census Tract 5120.21, Santa Clara County, California",1,1,0
1000000US060855120214012,060855120214012,"Block 4012, Block Group 4, Census Tract 5120.21, Santa Clara County, California",11,11,0
1000000US060855120214013,060855120214013,"Block 4013, Block Group 4, Census Tract 5120.21, Santa Clara County, California",0,0,0
1000000US060855120214014,060855120214014,"Block 4014, Block Group 4, Census Tract 5120.21, Santa Clara County, California",24,24,0
1000000US060855120214015,060855120214015,"Block 4015, Block Group 4, Census Tract 5120.21, Santa Clara County, California",33,32,1
1000000US060855120214016,060855120214016,"Block 4016, Block Group 4, Census Tract 5120.21, Santa Clara County, California",60,60,0
1000000US060855120214017,060855120214017,"Block 4017, Block Group 4, Census Tract 5120.21, Santa Clara County, California",22,22,0
1000000US060855120214018,060855120214018,"Block 4018, Block Group 4, Census Tract 5120.21, Santa Clara County, California",12,11,1
1000000US060855120214019,060855120214019,"Block 4019, Block Group 4, Census Tract 5120.21, Santa Clara County, California",14,14,0
1000000US060855120214020,060855120214020,"Block 4020, Block Group 4, Census Tract 5120.21, Santa Clara County, California",24,24,0
1000000US060855120214021,060855120214021,"Block 4021, Block Group 4, Census Tract 5120.21, Santa Clara County, California",27,27,0
1000000US060855120214022,060855120214022,"Block 4022, Block Group 4, Census Tract 5120.21, Santa Clara County, California",0,0,0
1000000US060855120214023,060855120214023,"Block 4023, Block Group 4, Census Tract 5120.21, Santa Clara County, California",20,20,0
1000000US060855120221000,060855120221000,"Block 1000, Block Group 1, Census Tract 5120.22, Santa Clara County, California",0,0,0
1000000US060855120221001,060855120221001,"Block 1001, Block Group 1, Census Tract 5120.22, Santa Clara County, California",46,46,0
1000000US060855120221002,060855120221002,"Block 1002, Block Group 1, Census Tract 5120.22, Santa Clara County, California",38,38,0
1000000US060855120221003,060855120221003,"Block 1003, Block Group 1, Census Tract 5120.22, Santa Clara County, California",54,54,0
1000000US060855120221004,060855120221004,"Block 1004, Block Group 1, Census Tract 5120.22, Santa Clara County, California",20,20,0
1000000US060855120221005,060855120221005,"Block 1005, Block Group 1, Census Tract 5120.22, Santa Clara County, California",24,24,0
1000000US060855120221006,060855120221006,"Block 1006, Block Group 1, Census Tract 5120.22, Santa Clara County, California",28,28,0
1000000US060855120221007,060855120221007,"Block 1007, Block Group 1, Census Tract 5120.22, Santa Clara County, California",44,42,2
1000000US060855120221008,060855120221008,"Block 1008, Block Group 1, Census Tract 5120.22, Santa Clara County, California",0,0,0
1000000US060855120221009,060855120221009,"Block 1009, Block Group 1, Census Tract 5120.22, Santa Clara County, California",67,65,2
1000000US060855120221010,060855120221010,"Block 1010, Block Group 1, Census Tract 5120.22, Santa Clara County, California",24,22,2
1000000US060855120221011,060855120221011,"Block 1011, Block Group 1, Census Tract 5120.22, Santa Clara County, California",11,10,1
1000000US060855120222000,060855120222000,"Block 2000, Block Group 2, Census Tract 5120.22, Santa Clara County, California",0,0,0
1000000US060855120222001,060855120222001,"Block 2001, Block Group 2, Census Tract 5120.22, Santa Clara County, California",0,0,0
1000000US060855120222002,060855120222002,"Block 2002, Block Group 2, Census Tract 5120.22, Santa Clara County, California",0,0,0
1000000US060855120222003,060855120222003,"Block 2003, Block Group 2, Census Tract 5120.22, Santa Clara County, California",62,62,0
1000000US060855120222004,060855120222004,"Block 2004, Block Group 2, Census Tract 5120.22, Santa Clara County, California",21,21,0
1000000US060855120222005,060855120222005,"Block 2005, Block Group 2, Census Tract 5120.22, Santa Clara County, California",18,17,1
1000000US060855120222006,060855120222006,"Block 2006, Block Group 2, Census Tract 5120.22, Santa Clara County, California",18,18,0
1000000US060855120222007,060855120222007,"Block 2007, Block Group 2, Census Tract 5120.22, Santa Clara County, California",30,28,2
1000000US060855120222008,060855120222008,"Block 2008, Block Group 2, Census Tract 5120.22, Santa Clara County, California",24,24,0
1000000US060855120222009,060855120222009,"Block 2009, Block Group 2, Census Tract 5120.22, Santa Clara County, California",24,23,1
1000000US060855120222010,060855120222010,"Block 2010, Block Group 2, Census Tract 5120.22, Santa Clara County, California",6,6,0
1000000US060855120222011,060855120222011,"Block 2011, Block Group 2, Census Tract 5120.22, Santa Clara County, California",74,71,3
1000000US060855120222012,060855120222012,"Block 2012, Block Group 2, Census Tract 5120.22, Santa Clara County, California",12,12,0
1000000US060855120222013,060855120222013,"Block 2013, Block Group 2, Census Tract 5120.22, Santa Clara County, California",16,16,0
1000000US060855120222014,060855120222014,"Block 2014, Block Group 2, Census Tract 5120.22, Santa Clara County, California",27,26,1
1000000US060855120222015,060855120222015,"Block 2015, Block Group 2, Census Tract 5120.22, Santa Clara County, California",26,26,0
1000000US060855120222016,060855120222016,"Block 2016, Block Group 2, Census Tract 5120.22, Santa Clara County, California",16,14,2
1000000US060855120222017,060855120222017,"Block 2017, Block Group 2, Census Tract 5120.22, Santa Clara County, California",102,96,6
1000000US060855120222018,060855120222018,"Block 2018, Block Group 2, Census Tract 5120.22, Santa Clara County, California",12,12,0
1000000US060855120222019,060855120222019,"Block 2019, Block Group 2, Census Tract 5120.22, Santa Clara County, California",53,51,2
1000000US060855120222020,060855120222020,"Block 2020, Block Group 2, Census Tract 5120.22, Santa Clara County, California",0,0,0
1000000US060855120222021,060855120222021,"Block 2021, Block Group 2, Census Tract 5120.22, Santa Clara County, California",62,57,5
1000000US060855120222022,060855120222022,"Block 2022, Block Group 2, Census Tract 5120.22, Santa Clara County, California",30,27,3
1000000US060855120222023,060855120222023,"Block 2023, Block Group 2, Census Tract 5120.22, Santa Clara County, California",30,27,3
1000000US060855120222024,060855120222024,"Block 2024, Block Group 2, Census Tract 5120.22, Santa Clara County, California",12,12,0
1000000US060855120222025,060855120222025,"Block 2025, Block Group 2, Census Tract 5120.22, Santa Clara County, California",0,0,0
1000000US060855120222026,060855120222026,"Block 2026, Block Group 2, Census Tract 5120.22, Santa Clara County, California",18,18,0
1000000US060855120222027,060855120222027,"Block 2027, Block Group 2, Census Tract 5120.22, Santa Clara County, California",18,17,1
1000000US060855120222028,060855120222028,"Block 2028, Block Group 2, Census Tract 5120.22, Santa Clara County, California",12,12,0
1000000US060855120223000,060855120223000,"Block 3000, Block Group 3, Census Tract 5120.22, Santa Clara County, California",79,78,1
1000000US060855120223001,060855120223001,"Block 3001, Block Group 3, Census Tract 5120.22, Santa Clara County, California",21,21,0
1000000US060855120223002,060855120223002,"Block 3002, Block Group 3, Census Tract 5120.22, Santa Clara County, California",28,28,0
1000000US060855120223003,060855120223003,"Block 3003, Block Group 3, Census Tract 5120.22, Santa Clara County, California",112,112,0
1000000US060855120223004,060855120223004,"Block 3004, Block Group 3, Census Tract 5120.22, Santa Clara County, California",491,460,31
1000000US060855120231000,060855120231000,"Block 1000, Block Group 1, Census Tract 5120.23, Santa Clara County, California",55,53,2
1000000US060855120231001,060855120231001,"Block 1001, Block Group 1, Census Tract 5120.23, Santa Clara County, California",14,13,1
1000000US060855120231002,060855120231002,"Block 1002, Block Group 1, Census Tract 5120.23, Santa Clara County, California",20,19,1
1000000US060855120231003,060855120231003,"Block 1003, Block Group 1, Census Tract 5120.23, Santa Clara County, California",45,40,5
1000000US060855120231004,060855120231004,"Block 1004, Block Group 1, Census Tract 5120.23, Santa Clara County, California",422,403,19
1000000US060855120231005,060855120231005,"Block 1005, Block Group 1, Census Tract 5120.23, Santa Clara County, California",32,28,4
1000000US060855120231006,060855120231006,"Block 1006, Block Group 1, Census Tract 5120.23, Santa Clara County, California",113,107,6
1000000US060855120231007,060855120231007,"Block 1007, Block Group 1, Census Tract 5120.23, Santa Clara County, California",25,25,0
1000000US060855120232000,060855120232000,"Block 2000, Block Group 2, Census Tract 5120.23, Santa Clara County, California",55,51,4
1000000US060855120232001,060855120232001,"Block 2001, Block Group 2, Census Tract 5120.23, Santa Clara County, California",144,140,4
1000000US060855120232002,060855120232002,"Block 2002, Block Group 2, Census Tract 5120.23, Santa Clara County, California",11,10,1
1000000US060855120232003,060855120232003,"Block 2003, Block Group 2, Census Tract 5120.23, Santa Clara County, California",11,11,0
1000000US060855120232004,060855120232004,"Block 2004, Block Group 2, Census Tract 5120.23, Santa Clara County, California",6,5,1
1000000US060855120232005,060855120232005,"Block 2005, Block Group 2, Census Tract 5120.23, Santa Clara County, California",55,45,10
1000000US060855120232006,060855120232006,"Block 2006, Block Group 2, Census Tract 5120.23, Santa Clara County, California",28,27,1
1000000US060855120232007,060855120232007,"Block 2007, Block Group 2, Census Tract 5120.23, Santa Clara County, California",284,258,26
1000000US060855120233000,060855120233000,"Block 3000, Block Group 3, Census Tract 5120.23, Santa Clara County, California",176,160,16
1000000US060855120233001,060855120233001,"Block 3001, Block Group 3, Census Tract 5120.23, Santa Clara County, California",156,146,10
1000000US060855120233002,060855120233002,"Block 3002, Block Group 3, Census Tract 5120.23, Santa Clara County, California",236,225,11
1000000US060855120233003,060855120233003,"Block 3003, Block Group 3, Census Tract 5120.23, Santa Clara County, California",36,34,2
1000000US060855120233004,060855120233004,"Block 3004, Block Group 3, Census Tract 5120.23, Santa Clara County, California",44,41,3
1000000US060855120241000,060855120241000,"Block 1000, Block Group 1, Census Tract 5120.24, Santa Clara County, California",283,272,11
1000000US060855120241001,060855120241001,"Block 1001, Block Group 1, Census Tract 5120.24, Santa Clara County, California",22,21,1
1000000US060855120241002,060855120241002,"Block 1002, Block Group 1, Census Tract 5120.24, Santa Clara County, California",12,12,0
1000000US060855120241003,060855120241003,"Block 1003, Block Group 1, Census Tract 5120.24, Santa Clara County, California",10,10,0
1000000US060855120241004,060855120241004,"Block 1004, Block Group 1, Census Tract 5120.24, Santa Clara County, California",14,14,0
1000000US060855120241005,060855120241005,"Block 1005, Block Group 1, Census Tract 5120.24, Santa Clara County, California",111,105,6
1000000US060855120241006,060855120241006,"Block 1006, Block Group 1, Census Tract 5120.24, Santa Clara County, California",31,31,0
1000000US060855120241007,060855120241007,"Block 1007, Block Group 1, Census Tract 5120.24, Santa Clara County, California",20,20,0
1000000US060855120241008,060855120241008,"Block 1008, Block Group 1, Census Tract 5120.24, Santa Clara County, California",50,47,3
1000000US060855120241009,060855120241009,"Block 1009, Block Group 1, Census Tract 5120.24, Santa Clara County, California",38,36,2
1000000US060855120241010,060855120241010,"Block 1010, Block Group 1, Census Tract 5120.24, Santa Clara County, California",45,43,2
1000000US060855120241011,060855120241011,"Block 1011, Block Group 1, Census Tract 5120.24, Santa Clara County, California",75,73,2
1000000US060855120241012,060855120241012,"Block 1012, Block Group 1, Census Tract 5120.24, Santa Clara County, California",82,81,1
1000000US060855120241013,060855120241013,"Block 1013, Block Group 1, Census Tract 5120.24, Santa Clara County, California",511,495,16
1000000US060855120241014,060855120241014,"Block 1014, Block Group 1, Census Tract 5120.24, Santa Clara County, California",1,1,0
1000000US060855120242000,060855120242000,"Block 2000, Block Group 2, Census Tract 5120.24, Santa Clara County, California",43,41,2
1000000US060855120242001,060855120242001,"Block 2001, Block Group 2, Census Tract 5120.24, Santa Clara County, California",16,15,1
1000000US060855120242002,060855120242002,"Block 2002, Block Group 2, Census Tract 5120.24, Santa Clara County, California",156,152,4
1000000US060855120242003,060855120242003,"Block 2003, Block Group 2, Census Tract 5120.24, Santa Clara County, California",22,20,2
1000000US060855120242004,060855120242004,"Block 2004, Block Group 2, Census Tract 5120.24, Santa Clara County, California",44,42,2
1000000US060855120242005,060855120242005,"Block 2005, Block Group 2, Census Tract 5120.24, Santa Clara County, California",58,58,0
1000000US060855120242006,060855120242006,"Block 2006, Block Group 2, Census Tract 5120.24, Santa Clara County, California",26,24,2
1000000US060855120242007,060855120242007,"Block 2007, Block Group 2, Census Tract 5120.24, Santa Clara County, California",2,2,0
1000000US060855120242008,060855120242008,"Block 2008, Block Group 2, Census Tract 5120.24, Santa Clara County, California",38,38,0
1000000US060855120251000,060855120251000,"Block 1000, Block Group 1, Census Tract 5120.25, Santa Clara County, California",132,124,8
1000000US060855120251001,060855120251001,"Block 1001, Block Group 1, Census Tract 5120.25, Santa Clara County, California",26,26,0
1000000US060855120251002,060855120251002,"Block 1002, Block Group 1, Census Tract 5120.25, Santa Clara County, California",74,72,2
1000000US060855120251003,060855120251003,"Block 1003, Block Group 1, Census Tract 5120.25, Santa Clara County, California",21,21,0
1000000US060855120251004,060855120251004,"Block 1004, Block Group 1, Census Tract 5120.25, Santa Clara County, California",28,28,0
1000000US060855120251005,060855120251005,"Block 1005, Block Group 1, Census Tract 5120.25, Santa Clara County, California",18,18,0
1000000US060855120251006,060855120251006,"Block 1006, Block Group 1, Census Tract 5120.25, Santa Clara County, California",15,15,0
1000000US060855120251007,060855120251007,"Block 1007, Block Group 1, Census Tract 5120.25, Santa Clara County, California",41,40,1
1000000US060855120251008,060855120251008,"Block 1008, Block Group 1, Census Tract 5120.25, Santa Clara County, California",11,11,0
1000000US060855120251009,060855120251009,"Block 1009, Block Group 1, Census Tract 5120.25, Santa Clara County, California",20,20,0
1000000US060855120251010,060855120251010,"Block 1010, Block Group 1, Census Tract 5120.25, Santa Clara County, California",86,85,1
1000000US060855120251011,060855120251011,"Block 1011, Block Group 1, Census Tract 5120.25, Santa Clara County, California",29,29,0
1000000US060855120251012,060855120251012,"Block 1012, Block Group 1, Census Tract 5120.25, Santa Clara County, California",15,15,0
1000000US060855120251013,060855120251013,"Block 1013, Block Group 1, Census Tract 5120.25, Santa Clara County, California",1,1,0
1000000US060855120251014,060855120251014,"Block 1014, Block Group 1, Census Tract 5120.25, Santa Clara County, California",27,27,0
1000000US060855120251015,060855120251015,"Block 1015, Block Group 1, Census Tract 5120.25, Santa Clara County, California",68,68,0
1000000US060855120251016,060855120251016,"Block 1016, Block Group 1, Census Tract 5120.25, Santa Clara County, California",9,9,0
1000000US060855120251017,060855120251017,"Block 1017, Block Group 1, Census Tract 5120.25, Santa Clara County, California",56,56,0
1000000US060855120251018,060855120251018,"Block 1018, Block Group 1, Census Tract 5120.25, Santa Clara County, California",31,31,0
1000000US060855120251019,060855120251019,"Block 1019, Block Group 1, Census Tract 5120.25, Santa Clara County, California",35,35,0
1000000US060855120251020,060855120251020,"Block 1020, Block Group 1, Census Tract 5120.25, Santa Clara County, California",31,31,0
1000000US060855120251021,060855120251021,"Block 1021, Block Group 1, Census Tract 5120.25, Santa Clara County, California",0,0,0
1000000US060855120252000,060855120252000,"Block 2000, Block Group 2, Census Tract 5120.25, Santa Clara County, California",194,191,3
1000000US060855120252001,060855120252001,"Block 2001, Block Group 2, Census Tract 5120.25, Santa Clara County, California",21,21,0
1000000US060855120252002,060855120252002,"Block 2002, Block Group 2, Census Tract 5120.25, Santa Clara County, California",15,14,1
1000000US060855120252003,060855120252003,"Block 2003, Block Group 2, Census Tract 5120.25, Santa Clara County, California",14,12,2
1000000US060855120252004,060855120252004,"Block 2004, Block Group 2, Census Tract 5120.25, Santa Clara County, California",43,41,2
1000000US060855120252005,060855120252005,"Block 2005, Block Group 2, Census Tract 5120.25, Santa Clara County, California",19,17,2
1000000US060855120261000,060855120261000,"Block 1000, Block Group 1, Census Tract 5120.26, Santa Clara County, California",1,1,0
1000000US060855120261001,060855120261001,"Block 1001, Block Group 1, Census Tract 5120.26, Santa Clara County, California",47,42,5
1000000US060855120261002,060855120261002,"Block 1002, Block Group 1, Census Tract 5120.26, Santa Clara County, California",264,254,10
1000000US060855120261003,060855120261003,"Block 1003, Block Group 1, Census Tract 5120.26, Santa Clara County, California",112,108,4
1000000US060855120261004,060855120261004,"Block 1004, Block Group 1, Census Tract 5120.26, Santa Clara County, California",16,16,0
1000000US060855120261005,060855120261005,"Block 1005, Block Group 1, Census Tract 5120.26, Santa Clara County, California",92,89,3
1000000US060855120261006,060855120261006,"Block 1006, Block Group 1, Census Tract 5120.26, Santa Clara County, California",20,20,0
1000000US060855120261007,060855120261007,"Block 1007, Block Group 1, Census Tract 5120.26, Santa Clara County, California",121,112,9
1000000US060855120261008,060855120261008,"Block 1008, Block Group 1, Census Tract 5120.26, Santa Clara County, California",32,29,3
1000000US060855120261009,060855120261009,"Block 1009, Block Group 1, Census Tract 5120.26, Santa Clara County, California",0,0,0
1000000US060855120261010,060855120261010,"Block 1010, Block Group 1, Census Tract 5120.26, Santa Clara County, California",0,0,0
1000000US060855120261011,060855120261011,"Block 1011, Block Group 1, Census Tract 5120.26, Santa Clara County, California",24,22,2
1000000US060855120261012,060855120261012,"Block 1012, Block Group 1, Census Tract 5120.26, Santa Clara County, California",8,8,0
1000000US060855120262000,060855120262000,"Block 2000, Block Group 2, Census Tract 5120.26, Santa Clara County, California",26,25,1
1000000US060855120262001,060855120262001,"Block 2001, Block Group 2, Census Tract 5120.26, Santa Clara County, California",4,4,0
1000000US060855120262002,060855120262002,"Block 2002, Block Group 2, Census Tract 5120.26, Santa Clara County, California",21,20,1
1000000US060855120262003,060855120262003,"Block 2003, Block Group 2, Census Tract 5120.26, Santa Clara County, California",80,78,2
1000000US060855120262004,060855120262004,"Block 2004, Block Group 2, Census Tract 5120.26, Santa Clara County, California",4,4,0
1000000US060855120262005,060855120262005,"Block 2005, Block Group 2, Census Tract 5120.26, Santa Clara County, California",4,4,0
1000000US060855120262006,060855120262006,"Block 2006, Block Group 2, Census Tract 5120.26, Santa Clara County, California",21,20,1
1000000US060855120262007,060855120262007,"Block 2007, Block Group 2, Census Tract 5120.26, Santa Clara County, California",36,36,0
1000000US060855120262008,060855120262008,"Block 2008, Block Group 2, Census Tract 5120.26, Santa Clara County, California",32,32,0
1000000US060855120262009,060855120262009,"Block 2009, Block Group 2, Census Tract 5120.26, Santa Clara County, California",48,47,1
1000000US060855120262010,060855120262010,"Block 2010, Block Group 2, Census Tract 5120.26, Santa Clara County, California",34,34,0
1000000US060855120262011,060855120262011,"Block 2011, Block Group 2, Census Tract 5120.26, Santa Clara County, California",18,17,1
1000000US060855120262012,060855120262012,"Block 2012, Block Group 2, Census Tract 5120.26, Santa Clara County, California",53,53,0
1000000US060855120262013,060855120262013,"Block 2013, Block Group 2, Census Tract 5120.26, Santa Clara County, California",122,119,3
1000000US060855120262014,060855120262014,"Block 2014, Block Group 2, Census Tract 5120.26, Santa Clara County, California",37,36,1
1000000US060855120262015,060855120262015,"Block 2015, Block Group 2, Census Tract 5120.26, Santa Clara County, California",73,68,5
1000000US060855120262016,060855120262016,"Block 2016, Block Group 2, Census Tract 5120.26, Santa Clara County, California",0,0,0
1000000US060855120271000,060855120271000,"Block 1000, Block Group 1, Census Tract 5120.27, Santa Clara County, California",0,0,0
1000000US060855120271001,060855120271001,"Block 1001, Block Group 1, Census Tract 5120.27, Santa Clara County, California",0,0,0
1000000US060855120271002,060855120271002,"Block 1002, Block Group 1, Census Tract 5120.27, Santa Clara County, California",294,238,56
1000000US060855120271003,060855120271003,"Block 1003, Block Group 1, Census Tract 5120.27, Santa Clara County, California",261,251,10
1000000US060855120271004,060855120271004,"Block 1004, Block Group 1, Census Tract 5120.27, Santa Clara County, California",232,227,5
1000000US060855120271005,060855120271005,"Block 1005, Block Group 1, Census Tract 5120.27, Santa Clara County, California",20,20,0
1000000US060855120271006,060855120271006,"Block 1006, Block Group 1, Census Tract 5120.27, Santa Clara County, California",0,0,0
1000000US060855120271007,060855120271007,"Block 1007, Block Group 1, Census Tract 5120.27, Santa Clara County, California",0,0,0
1000000US060855120271008,060855120271008,"Block 1008, Block Group 1, Census Tract 5120.27, Santa Clara County, California",144,140,4
1000000US060855120272000,060855120272000,"Block 2000, Block Group 2, Census Tract 5120.27, Santa Clara County, California",15,15,0
1000000US060855120272001,060855120272001,"Block 2001, Block Group 2, Census Tract 5120.27, Santa Clara County, California",0,0,0
1000000US060855120272002,060855120272002,"Block 2002, Block Group 2, Census Tract 5120.27, Santa Clara County, California",26,26,0
1000000US060855120272003,060855120272003,"Block 2003, Block Group 2, Census Tract 5120.27, Santa Clara County, California",92,91,1
1000000US060855120272004,060855120272004,"Block 2004, Block Group 2, Census Tract 5120.27, Santa Clara County, California",33,33,0
1000000US060855120272005,060855120272005,"Block 2005, Block Group 2, Census Tract 5120.27, Santa Clara County, California",32,32,0
1000000US060855120272006,060855120272006,"Block 2006, Block Group 2, Census Tract 5120.27, Santa Clara County, California",109,108,1
1000000US060855120272007,060855120272007,"Block 2007, Block Group 2, Census Tract 5120.27, Santa Clara County, California",19,19,0
1000000US060855120272008,060855120272008,"Block 2008, Block Group 2, Census Tract 5120.27, Santa Clara County, California",37,36,1
1000000US060855120272009,060855120272009,"Block 2009, Block Group 2, Census Tract 5120.27, Santa Clara County, California",35,35,0
1000000US060855120272010,060855120272010,"Block 2010, Block Group 2, Census Tract 5120.27, Santa Clara County, California",18,18,0
1000000US060855120272011,060855120272011,"Block 2011, Block Group 2, Census Tract 5120.27, Santa Clara County, California",23,22,1
1000000US060855120272012,060855120272012,"Block 2012, Block Group 2, Census Tract 5120.27, Santa Clara County, California",23,22,1
1000000US060855120272013,060855120272013,"Block 2013, Block Group 2, Census Tract 5120.27, Santa Clara County, California",46,46,0
1000000US060855120272014,060855120272014,"Block 2014, Block Group 2, Census Tract 5120.27, Santa Clara County, California",58,55,3
1000000US060855120272015,060855120272015,"Block 2015, Block Group 2, Census Tract 5120.27, Santa Clara County, California",38,35,3
1000000US060855120272016,060855120272016,"Block 2016, Block Group 2, Census Tract 5120.27, Santa Clara County, California",34,33,1
1000000US060855120272017,060855120272017,"Block 2017, Block Group 2, Census Tract 5120.27, Santa Clara County, California",9,9,0
1000000US060855120272018,060855120272018,"Block 2018, Block Group 2, Census Tract 5120.27, Santa Clara County, California",0,0,0
1000000US060855120272019,060855120272019,"Block 2019, Block Group 2, Census Tract 5120.27, Santa Clara County, California",24,24,0
1000000US060855120291000,060855120291000,"Block 1000, Block Group 1, Census Tract 5120.29, Santa Clara County, California",53,52,1
1000000US060855120291001,060855120291001,"Block 1001, Block Group 1, Census Tract 5120.29, Santa Clara County, California",22,22,0
1000000US060855120291002,060855120291002,"Block 1002, Block Group 1, Census Tract 5120.29, Santa Clara County, California",130,127,3
1000000US060855120291003,060855120291003,"Block 1003, Block Group 1, Census Tract 5120.29, Santa Clara County, California",68,65,3
1000000US060855120291004,060855120291004,"Block 1004, Block Group 1, Census Tract 5120.29, Santa Clara County, California",49,48,1
1000000US060855120291005,060855120291005,"Block 1005, Block Group 1, Census Tract 5120.29, Santa Clara County, California",37,37,0
1000000US060855120291006,060855120291006,"Block 1006, Block Group 1, Census Tract 5120.29, Santa Clara County, California",35,35,0
1000000US060855120291007,060855120291007,"Block 1007, Block Group 1, Census Tract 5120.29, Santa Clara County, California",46,46,0
1000000US060855120291008,060855120291008,"Block 1008, Block Group 1, Census Tract 5120.29, Santa Clara County, California",36,36,0
1000000US060855120291009,060855120291009,"Block 1009, Block Group 1, Census Tract 5120.29, Santa Clara County, California",19,19,0
1000000US060855120291010,060855120291010,"Block 1010, Block Group 1, Census Tract 5120.29, Santa Clara County, California",11,9,2
1000000US060855120291011,060855120291011,"Block 1011, Block Group 1, Census Tract 5120.29, Santa Clara County, California",33,32,1
1000000US060855120291012,060855120291012,"Block 1012, Block Group 1, Census Tract 5120.29, Santa Clara County, California",12,12,0
1000000US060855120292000,060855120292000,"Block 2000, Block Group 2, Census Tract 5120.29, Santa Clara County, California",51,51,0
1000000US060855120292001,060855120292001,"Block 2001, Block Group 2, Census Tract 5120.29, Santa Clara County, California",52,51,1
1000000US060855120292002,060855120292002,"Block 2002, Block Group 2, Census Tract 5120.29, Santa Clara County, California",12,12,0
1000000US060855120292003,060855120292003,"Block 2003, Block Group 2, Census Tract 5120.29, Santa Clara County, California",23,22,1
1000000US060855120292004,060855120292004,"Block 2004, Block Group 2, Census Tract 5120.29, Santa Clara County, California",67,65,2
1000000US060855120292005,060855120292005,"Block 2005, Block Group 2, Census Tract 5120.29, Santa Clara County, California",31,31,0
1000000US060855120292006,060855120292006,"Block 2006, Block Group 2, Census Tract 5120.29, Santa Clara County, California",54,53,1
1000000US060855120292007,060855120292007,"Block 2007, Block Group 2, Census Tract 5120.29, Santa Clara County, California",28,28,0
1000000US060855120292008,060855120292008,"Block 2008, Block Group 2, Census Tract 5120.29, Santa Clara County, California",21,21,0
1000000US060855120292009,060855120292009,"Block 2009, Block Group 2, Census Tract 5120.29, Santa Clara County, California",61,59,2
1000000US060855120292010,060855120292010,"Block 2010, Block Group 2, Census Tract 5120.29, Santa Clara County, California",60,59,1
1000000US060855120292011,060855120292011,"Block 2011, Block Group 2, Census Tract 5120.29, Santa Clara County, California",42,42,0
1000000US060855120292012,060855120292012,"Block 2012, Block Group 2, Census Tract 5120.29, Santa Clara County, California",42,41,1
1000000US060855120292013,060855120292013,"Block 2013, Block Group 2, Census Tract 5120.29, Santa Clara County, California",44,42,2
1000000US060855120292014,060855120292014,"Block 2014, Block Group 2, Census Tract 5120.29, Santa Clara County, California",71,68,3
1000000US060855120293000,060855120293000,"Block 3000, Block Group 3, Census Tract 5120.29, Santa Clara County, California",0,0,0
1000000US060855120293001,060855120293001,"Block 3001, Block Group 3, Census Tract 5120.29, Santa Clara County, California",63,62,1
1000000US060855120293002,060855120293002,"Block 3002, Block Group 3, Census Tract 5120.29, Santa Clara County, California",245,236,9
1000000US060855120293003,060855120293003,"Block 3003, Block Group 3, Census Tract 5120.29, Santa Clara County, California",64,58,6
1000000US060855120293004,060855120293004,"Block 3004, Block Group 3, Census Tract 5120.29, Santa Clara County, California",16,15,1
1000000US060855120293005,060855120293005,"Block 3005, Block Group 3, Census Tract 5120.29, Santa Clara County, California",58,58,0
1000000US060855120293006,060855120293006,"Block 3006, Block Group 3, Census Tract 5120.29, Santa Clara County, California",16,16,0
1000000US060855120294000,060855120294000,"Block 4000, Block Group 4, Census Tract 5120.29, Santa Clara County, California",49,48,1
1000000US060855120294001,060855120294001,"Block 4001, Block Group 4, Census Tract 5120.29, Santa Clara County, California",27,27,0
1000000US060855120294002,060855120294002,"Block 4002, Block Group 4, Census Tract 5120.29, Santa Clara County, California",48,47,1
1000000US060855120294003,060855120294003,"Block 4003, Block Group 4, Census Tract 5120.29, Santa Clara County, California",56,56,0
1000000US060855120294004,060855120294004,"Block 4004, Block Group 4, Census Tract 5120.29, Santa Clara County, California",19,18,1
1000000US060855120294005,060855120294005,"Block 4005, Block Group 4, Census Tract 5120.29, Santa Clara County, California",42,41,1
1000000US060855120294006,060855120294006,"Block 4006, Block Group 4, Census Tract 5120.29, Santa Clara County, California",43,42,1
1000000US060855120294007,060855120294007,"Block 4007, Block Group 4, Census Tract 5120.29, Santa Clara County, California",33,31,2
1000000US060855120294008,060855120294008,"Block 4008, Block Group 4, Census Tract 5120.29, Santa Clara County, California",62,62,0
1000000US060855120294009,060855120294009,"Block 4009, Block Group 4, Census Tract 5120.29, Santa Clara County, California",32,30,2
1000000US060855120294010,060855120294010,"Block 4010, Block Group 4, Census Tract 5120.29, Santa Clara County, California",25,25,0
1000000US060855120294011,060855120294011,"Block 4011, Block Group 4, Census Tract 5120.29, Santa Clara County, California",77,77,0
1000000US060855120294012,060855120294012,"Block 4012, Block Group 4, Census Tract 5120.29, Santa Clara County, California",42,39,3
1000000US060855120294013,060855120294013,"Block 4013, Block Group 4, Census Tract 5120.29, Santa Clara County, California",57,55,2
1000000US060855120294014,060855120294014,"Block 4014, Block Group 4, Census Tract 5120.29, Santa Clara County, California",17,17,0
1000000US060855120301000,060855120301000,"Block 1000, Block Group 1, Census Tract 5120.30, Santa Clara County, California",28,26,2
1000000US060855120301001,060855120301001,"Block 1001, Block Group 1, Census Tract 5120.30, Santa Clara County, California",18,18,0
1000000US060855120301002,060855120301002,"Block 1002, Block Group 1, Census Tract 5120.30, Santa Clara County, California",43,43,0
1000000US060855120301003,060855120301003,"Block 1003, Block Group 1, Census Tract 5120.30, Santa Clara County, California",20,20,0
1000000US060855120301004,060855120301004,"Block 1004, Block Group 1, Census Tract 5120.30, Santa Clara County, California",40,38,2
1000000US060855120301005,060855120301005,"Block 1005, Block Group 1, Census Tract 5120.30, Santa Clara County, California",34,34,0
1000000US060855120301006,060855120301006,"Block 1006, Block Group 1, Census Tract 5120.30, Santa Clara County, California",56,55,1
1000000US060855120301007,060855120301007,"Block 1007, Block Group 1, Census Tract 5120.30, Santa Clara County, California",42,40,2
1000000US060855120301008,060855120301008,"Block 1008, Block Group 1, Census Tract 5120.30, Santa Clara County, California",48,48,0
1000000US060855120301009,060855120301009,"Block 1009, Block Group 1, Census Tract 5120.30, Santa Clara County, California",44,43,1
1000000US060855120301010,060855120301010,"Block 1010, Block Group 1, Census Tract 5120.30, Santa Clara County, California",28,28,0
1000000US060855120301011,060855120301011,"Block 1011, Block Group 1, Census Tract 5120.30, Santa Clara County, California",40,39,1
1000000US060855120301012,060855120301012,"Block 1012, Block Group 1, Census Tract 5120.30, Santa Clara County, California",48,48,0
1000000US060855120301013,060855120301013,"Block 1013, Block Group 1, Census Tract 5120.30, Santa Clara County, California",20,19,1
1000000US060855120301014,060855120301014,"Block 1014, Block Group 1, Census Tract 5120.30, Santa Clara County, California",26,24,2
1000000US060855120301015,060855120301015,"Block 1015, Block Group 1, Census Tract 5120.30, Santa Clara County, California",25,25,0
1000000US060855120301016,060855120301016,"Block 1016, Block Group 1, Census Tract 5120.30, Santa Clara County, California",0,0,0
1000000US060855120301017,060855120301017,"Block 1017, Block Group 1, Census Tract 5120.30, Santa Clara County, California",25,25,0
1000000US060855120301018,060855120301018,"Block 1018, Block Group 1, Census Tract 5120.30, Santa Clara County, California",10,10,0
1000000US060855120302000,060855120302000,"Block 2000, Block Group 2, Census Tract 5120.30, Santa Clara County, California",20,20,0
1000000US060855120302001,060855120302001,"Block 2001, Block Group 2, Census Tract 5120.30, Santa Clara County, California",44,44,0
1000000US060855120302002,060855120302002,"Block 2002, Block Group 2, Census Tract 5120.30, Santa Clara County, California",40,38,2
1000000US060855120302003,060855120302003,"Block 2003, Block Group 2, Census Tract 5120.30, Santa Clara County, California",54,54,0
1000000US060855120302004,060855120302004,"Block 2004, Block Group 2, Census Tract 5120.30, Santa Clara County, California",31,30,1
1000000US060855120302005,060855120302005,"Block 2005, Block Group 2, Census Tract 5120.30, Santa Clara County, California",37,36,1
1000000US060855120302006,060855120302006,"Block 2006, Block Group 2, Census Tract 5120.30, Santa Clara County, California",22,22,0
1000000US060855120302007,060855120302007,"Block 2007, Block Group 2, Census Tract 5120.30, Santa Clara County, California",63,61,2
1000000US060855120302008,060855120302008,"Block 2008, Block Group 2, Census Tract 5120.30, Santa Clara County, California",21,21,0
1000000US060855120302009,060855120302009,"Block 2009, Block Group 2, Census Tract 5120.30, Santa Clara County, California",53,52,1
1000000US060855120311000,060855120311000,"Block 1000, Block Group 1, Census Tract 5120.31, Santa Clara County, California",30,30,0
1000000US060855120311001,060855120311001,"Block 1001, Block Group 1, Census Tract 5120.31, Santa Clara County, California",95,92,3
1000000US060855120311002,060855120311002,"Block 1002, Block Group 1, Census Tract 5120.31, Santa Clara County, California",34,34,0
1000000US060855120311003,060855120311003,"Block 1003, Block Group 1, Census Tract 5120.31, Santa Clara County, California",38,37,1
1000000US060855120311004,060855120311004,"Block 1004, Block Group 1, Census Tract 5120.31, Santa Clara County, California",60,58,2
1000000US060855120312000,060855120312000,"Block 2000, Block Group 2, Census Tract 5120.31, Santa Clara County, California",46,46,0
1000000US060855120312001,060855120312001,"Block 2001, Block Group 2, Census Tract 5120.31, Santa Clara County, California",39,36,3
1000000US060855120312002,060855120312002,"Block 2002, Block Group 2, Census Tract 5120.31, Santa Clara County, California",53,51,2
1000000US060855120312003,060855120312003,"Block 2003, Block Group 2, Census Tract 5120.31, Santa Clara County, California",129,127,2
1000000US060855120312004,060855120312004,"Block 2004, Block Group 2, Census Tract 5120.31, Santa Clara County, California",23,23,0
1000000US060855120312005,060855120312005,"Block 2005, Block Group 2, Census Tract 5120.31, Santa Clara County, California",31,31,0
1000000US060855120312006,060855120312006,"Block 2006, Block Group 2, Census Tract 5120.31, Santa Clara County, California",48,48,0
1000000US060855120312007,060855120312007,"Block 2007, Block Group 2, Census Tract 5120.31, Santa Clara County, California",42,42,0
1000000US060855120313000,060855120313000,"Block 3000, Block Group 3, Census Tract 5120.31, Santa Clara County, California",21,18,3
1000000US060855120313001,060855120313001,"Block 3001, Block Group 3, Census Tract 5120.31, Santa Clara County, California",68,66,2
1000000US060855120313002,060855120313002,"Block 3002, Block Group 3, Census Tract 5120.31, Santa Clara County, California",33,32,1
1000000US060855120313003,060855120313003,"Block 3003, Block Group 3, Census Tract 5120.31, Santa Clara County, California",41,41,0
1000000US060855120313004,060855120313004,"Block 3004, Block Group 3, Census Tract 5120.31, Santa Clara County, California",39,38,1
1000000US060855120313005,060855120313005,"Block 3005, Block Group 3, Census Tract 5120.31, Santa Clara County, California",52,52,0
1000000US060855120313006,060855120313006,"Block 3006, Block Group 3, Census Tract 5120.31, Santa Clara County, California",35,35,0
1000000US060855120313007,060855120313007,"Block 3007, Block Group 3, Census Tract 5120.31, Santa Clara County, California",40,38,2
1000000US060855120313008,060855120313008,"Block 3008, Block Group 3, Census Tract 5120.31, Santa Clara County, California",58,58,0
1000000US060855120314000,060855120314000,"Block 4000, Block Group 4, Census Tract 5120.31, Santa Clara County, California",41,40,1
1000000US060855120314001,060855120314001,"Block 4001, Block Group 4, Census Tract 5120.31, Santa Clara County, California",56,56,0
1000000US060855120314002,060855120314002,"Block 4002, Block Group 4, Census Tract 5120.31, Santa Clara County, California",50,49,1
1000000US060855120314003,060855120314003,"Block 4003, Block Group 4, Census Tract 5120.31, Santa Clara County, California",28,28,0
1000000US060855120314004,060855120314004,"Block 4004, Block Group 4, Census Tract 5120.31, Santa Clara County, California",8,8,0
1000000US060855120314005,060855120314005,"Block 4005, Block Group 4, Census Tract 5120.31, Santa Clara County, California",14,14,0
1000000US060855120314006,060855120314006,"Block 4006, Block Group 4, Census Tract 5120.31, Santa Clara County, California",41,41,0
1000000US060855120314007,060855120314007,"Block 4007, Block Group 4, Census Tract 5120.31, Santa Clara County, California",12,12,0
1000000US060855120314008,060855120314008,"Block 4008, Block Group 4, Census Tract 5120.31, Santa Clara County, California",56,55,1
1000000US060855120314009,060855120314009,"Block 4009, Block Group 4, Census Tract 5120.31, Santa Clara County, California",34,34,0
1000000US060855120321000,060855120321000,"Block 1000, Block Group 1, Census Tract 5120.32, Santa Clara County, California",82,80,2
1000000US060855120321001,060855120321001,"Block 1001, Block Group 1, Census Tract 5120.32, Santa Clara County, California",65,63,2
1000000US060855120321002,060855120321002,"Block 1002, Block Group 1, Census Tract 5120.32, Santa Clara County, California",19,18,1
1000000US060855120321003,060855120321003,"Block 1003, Block Group 1, Census Tract 5120.32, Santa Clara County, California",15,15,0
1000000US060855120321004,060855120321004,"Block 1004, Block Group 1, Census Tract 5120.32, Santa Clara County, California",59,57,2
1000000US060855120321005,060855120321005,"Block 1005, Block Group 1, Census Tract 5120.32, Santa Clara County, California",47,45,2
1000000US060855120321006,060855120321006,"Block 1006, Block Group 1, Census Tract 5120.32, Santa Clara County, California",48,47,1
1000000US060855120321007,060855120321007,"Block 1007, Block Group 1, Census Tract 5120.32, Santa Clara County, California",47,45,2
1000000US060855120321008,060855120321008,"Block 1008, Block Group 1, Census Tract 5120.32, Santa Clara County, California",24,24,0
1000000US060855120321009,060855120321009,"Block 1009, Block Group 1, Census Tract 5120.32, Santa Clara County, California",8,8,0
1000000US060855120322000,060855120322000,"Block 2000, Block Group 2, Census Tract 5120.32, Santa Clara County, California",52,52,0
1000000US060855120322001,060855120322001,"Block 2001, Block Group 2, Census Tract 5120.32, Santa Clara County, California",57,56,1
1000000US060855120322002,060855120322002,"Block 2002, Block Group 2, Census Tract 5120.32, Santa Clara County, California",58,56,2
1000000US060855120322003,060855120322003,"Block 2003, Block Group 2, Census Tract 5120.32, Santa Clara County, California",35,34,1
1000000US060855120322004,060855120322004,"Block 2004, Block Group 2, Census Tract 5120.32, Santa Clara County, California",29,29,0
1000000US060855120322005,060855120322005,"Block 2005, Block Group 2, Census Tract 5120.32, Santa Clara County, California",69,66,3
1000000US060855120323000,060855120323000,"Block 3000, Block Group 3, Census Tract 5120.32, Santa Clara County, California",0,0,0
1000000US060855120323001,060855120323001,"Block 3001, Block Group 3, Census Tract 5120.32, Santa Clara County, California",0,0,0
1000000US060855120323002,060855120323002,"Block 3002, Block Group 3, Census Tract 5120.32, Santa Clara County, California",0,0,0
1000000US060855120323003,060855120323003,"Block 3003, Block Group 3, Census Tract 5120.32, Santa Clara County, California",0,0,0
1000000US060855120323004,060855120323004,"Block 3004, Block Group 3, Census Tract 5120.32, Santa Clara County, California",0,0,0
1000000US060855120323005,060855120323005,"Block 3005, Block Group 3, Census Tract 5120.32, Santa Clara County, California",0,0,0
1000000US060855120323006,060855120323006,"Block 3006, Block Group 3, Census Tract 5120.32, Santa Clara County, California",1,1,0
1000000US060855120323007,060855120323007,"Block 3007, Block Group 3, Census Tract 5120.32, Santa Clara County, California",0,0,0
1000000US060855120323008,060855120323008,"Block 3008, Block Group 3, Census Tract 5120.32, Santa Clara County, California",0,0,0
1000000US060855120323009,060855120323009,"Block 3009, Block Group 3, Census Tract 5120.32, Santa Clara County, California",0,0,0
1000000US060855120323010,060855120323010,"Block 3010, Block Group 3, Census Tract 5120.32, Santa Clara County, California",0,0,0
1000000US060855120323011,060855120323011,"Block 3011, Block Group 3, Census Tract 5120.32, Santa Clara County, California",10,10,0
1000000US060855120323012,060855120323012,"Block 3012, Block Group 3, Census Tract 5120.32, Santa Clara County, California",1,1,0
1000000US060855120323013,060855120323013,"Block 3013, Block Group 3, Census Tract 5120.32, Santa Clara County, California",0,0,0
1000000US060855120323014,060855120323014,"Block 3014, Block Group 3, Census Tract 5120.32, Santa Clara County, California",0,0,0
1000000US060855120323015,060855120323015,"Block 3015, Block Group 3, Census Tract 5120.32, Santa Clara County, California",0,0,0
1000000US060855120323016,060855120323016,"Block 3016, Block Group 3, Census Tract 5120.32, Santa Clara County, California",10,9,1
1000000US060855120323017,060855120323017,"Block 3017, Block Group 3, Census Tract 5120.32, Santa Clara County, California",44,44,0
1000000US060855120323018,060855120323018,"Block 3018, Block Group 3, Census Tract 5120.32, Santa Clara County, California",34,33,1
1000000US060855120323019,060855120323019,"Block 3019, Block Group 3, Census Tract 5120.32, Santa Clara County, California",56,53,3
1000000US060855120323020,060855120323020,"Block 3020, Block Group 3, Census Tract 5120.32, Santa Clara County, California",86,84,2
1000000US060855120323021,060855120323021,"Block 3021, Block Group 3, Census Tract 5120.32, Santa Clara County, California",32,31,1
1000000US060855120323022,060855120323022,"Block 3022, Block Group 3, Census Tract 5120.32, Santa Clara County, California",49,46,3
1000000US060855120331000,060855120331000,"Block 1000, Block Group 1, Census Tract 5120.33, Santa Clara County, California",51,49,2
1000000US060855120331001,060855120331001,"Block 1001, Block Group 1, Census Tract 5120.33, Santa Clara County, California",54,51,3
1000000US060855120331002,060855120331002,"Block 1002, Block Group 1, Census Tract 5120.33, Santa Clara County, California",52,52,0
1000000US060855120331003,060855120331003,"Block 1003, Block Group 1, Census Tract 5120.33, Santa Clara County, California",42,42,0
1000000US060855120331004,060855120331004,"Block 1004, Block Group 1, Census Tract 5120.33, Santa Clara County, California",44,42,2
1000000US060855120331005,060855120331005,"Block 1005, Block Group 1, Census Tract 5120.33, Santa Clara County, California",42,42,0
1000000US060855120331006,060855120331006,"Block 1006, Block Group 1, Census Tract 5120.33, Santa Clara County, California",14,13,1
1000000US060855120331007,060855120331007,"Block 1007, Block Group 1, Census Tract 5120.33, Santa Clara County, California",40,39,1
1000000US060855120331008,060855120331008,"Block 1008, Block Group 1, Census Tract 5120.33, Santa Clara County, California",1,1,0
1000000US060855120331009,060855120331009,"Block 1009, Block Group 1, Census Tract 5120.33, Santa Clara County, California",16,15,1
1000000US060855120331010,060855120331010,"Block 1010, Block Group 1, Census Tract 5120.33, Santa Clara County, California",21,20,1
1000000US060855120331011,060855120331011,"Block 1011, Block Group 1, Census Tract 5120.33, Santa Clara County, California",32,32,0
1000000US060855120331012,060855120331012,"Block 1012, Block Group 1, Census Tract 5120.33, Santa Clara County, California",0,0,0
1000000US060855120332000,060855120332000,"Block 2000, Block Group 2, Census Tract 5120.33, Santa Clara County, California",0,0,0
1000000US060855120332001,060855120332001,"Block 2001, Block Group 2, Census Tract 5120.33, Santa Clara County, California",0,0,0
1000000US060855120332002,060855120332002,"Block 2002, Block Group 2, Census Tract 5120.33, Santa Clara County, California",0,0,0
1000000US060855120332003,060855120332003,"Block 2003, Block Group 2, Census Tract 5120.33, Santa Clara County, California",0,0,0
1000000US060855120332004,060855120332004,"Block 2004, Block Group 2, Census Tract 5120.33, Santa Clara County, California",0,0,0
1000000US060855120332005,060855120332005,"Block 2005, Block Group 2, Census Tract 5120.33, Santa Clara County, California",0,0,0
1000000US060855120332006,060855120332006,"Block 2006, Block Group 2, Census Tract 5120.33, Santa Clara County, California",0,0,0
1000000US060855120332007,060855120332007,"Block 2007, Block Group 2, Census Tract 5120.33, Santa Clara County, California",0,0,0
1000000US060855120332008,060855120332008,"Block 2008, Block Group 2, Census Tract 5120.33, Santa Clara County, California",0,0,0
1000000US060855120332009,060855120332009,"Block 2009, Block Group 2, Census Tract 5120.33, Santa Clara County, California",0,0,0
1000000US060855120332010,060855120332010,"Block 2010, Block Group 2, Census Tract 5120.33, Santa Clara County, California",0,0,0
1000000US060855120332011,060855120332011,"Block 2011, Block Group 2, Census Tract 5120.33, Santa Clara County, California",0,0,0
1000000US060855120332012,060855120332012,"Block 2012, Block Group 2, Census Tract 5120.33, Santa Clara County, California",0,0,0
1000000US060855120332013,060855120332013,"Block 2013, Block Group 2, Census Tract 5120.33, Santa Clara County, California",0,0,0
1000000US060855120332014,060855120332014,"Block 2014, Block Group 2, Census Tract 5120.33, Santa Clara County, California",0,0,0
1000000US060855120332015,060855120332015,"Block 2015, Block Group 2, Census Tract 5120.33, Santa Clara County, California",0,0,0
1000000US060855120332016,060855120332016,"Block 2016, Block Group 2, Census Tract 5120.33, Santa Clara County, California",0,0,0
1000000US060855120332017,060855120332017,"Block 2017, Block Group 2, Census Tract 5120.33, Santa Clara County, California",0,0,0
1000000US060855120332018,060855120332018,"Block 2018, Block Group 2, Census Tract 5120.33, Santa Clara County, California",144,138,6
1000000US060855120332019,060855120332019,"Block 2019, Block Group 2, Census Tract 5120.33, Santa Clara County, California",0,0,0
1000000US060855120332020,060855120332020,"Block 2020, Block Group 2, Census Tract 5120.33, Santa Clara County, California",176,147,29
1000000US060855120332021,060855120332021,"Block 2021, Block Group 2, Census Tract 5120.33, Santa Clara County, California",32,31,1
1000000US060855120332022,060855120332022,"Block 2022, Block Group 2, Census Tract 5120.33, Santa Clara County, California",0,0,0
1000000US060855120332023,060855120332023,"Block 2023, Block Group 2, Census Tract 5120.33, Santa Clara County, California",5,4,1
1000000US060855120332024,060855120332024,"Block 2024, Block Group 2, Census Tract 5120.33, Santa Clara County, California",54,53,1
1000000US060855120332025,060855120332025,"Block 2025, Block Group 2, Census Tract 5120.33, Santa Clara County, California",17,16,1
1000000US060855120332026,060855120332026,"Block 2026, Block Group 2, Census Tract 5120.33, Santa Clara County, California",12,11,1
1000000US060855120332027,060855120332027,"Block 2027, Block Group 2, Census Tract 5120.33, Santa Clara County, California",0,0,0
1000000US060855120332028,060855120332028,"Block 2028, Block Group 2, Census Tract 5120.33, Santa Clara County, California",0,0,0
1000000US060855120332029,060855120332029,"Block 2029, Block Group 2, Census Tract 5120.33, Santa Clara County, California",72,71,1
1000000US060855120332030,060855120332030,"Block 2030, Block Group 2, Census Tract 5120.33, Santa Clara County, California",39,39,0
1000000US060855120332031,060855120332031,"Block 2031, Block Group 2, Census Tract 5120.33, Santa Clara County, California",27,27,0
1000000US060855120332032,060855120332032,"Block 2032, Block Group 2, Census Tract 5120.33, Santa Clara County, California",38,38,0
1000000US060855120332033,060855120332033,"Block 2033, Block Group 2, Census Tract 5120.33, Santa Clara County, California",26,26,0
1000000US060855120332034,060855120332034,"Block 2034, Block Group 2, Census Tract 5120.33, Santa Clara County, California",44,44,0
1000000US060855120332035,060855120332035,"Block 2035, Block Group 2, Census Tract 5120.33, Santa Clara County, California",47,47,0
1000000US060855120333000,060855120333000,"Block 3000, Block Group 3, Census Tract 5120.33, Santa Clara County, California",41,41,0
1000000US060855120333001,060855120333001,"Block 3001, Block Group 3, Census Tract 5120.33, Santa Clara County, California",7,7,0
1000000US060855120333002,060855120333002,"Block 3002, Block Group 3, Census Tract 5120.33, Santa Clara County, California",36,36,0
1000000US060855120333003,060855120333003,"Block 3003, Block Group 3, Census Tract 5120.33, Santa Clara County, California",31,30,1
1000000US060855120333004,060855120333004,"Block 3004, Block Group 3, Census Tract 5120.33, Santa Clara County, California",37,36,1
1000000US060855120333005,060855120333005,"Block 3005, Block Group 3, Census Tract 5120.33, Santa Clara County, California",48,47,1
1000000US060855120333006,060855120333006,"Block 3006, Block Group 3, Census Tract 5120.33, Santa Clara County, California",39,39,0
1000000US060855120333007,060855120333007,"Block 3007, Block Group 3, Census Tract 5120.33, Santa Clara County, California",82,81,1
1000000US060855120333008,060855120333008,"Block 3008, Block Group 3, Census Tract 5120.33, Santa Clara County, California",33,33,0
1000000US060855120333009,060855120333009,"Block 3009, Block Group 3, Census Tract 5120.33, Santa Clara County, California",25,25,0
1000000US060855120334000,060855120334000,"Block 4000, Block Group 4, Census Tract 5120.33, Santa Clara County, California",214,199,15
1000000US060855120334001,060855120334001,"Block 4001, Block Group 4, Census Tract 5120.33, Santa Clara County, California",35,35,0
1000000US060855120334002,060855120334002,"Block 4002, Block Group 4, Census Tract 5120.33, Santa Clara County, California",25,25,0
1000000US060855120334003,060855120334003,"Block 4003, Block Group 4, Census Tract 5120.33, Santa Clara County, California",43,43,0
1000000US060855120334004,060855120334004,"Block 4004, Block Group 4, Census Tract 5120.33, Santa Clara County, California",42,41,1
1000000US060855120334005,060855120334005,"Block 4005, Block Group 4, Census Tract 5120.33, Santa Clara County, California",52,51,1
1000000US060855120334006,060855120334006,"Block 4006, Block Group 4, Census Tract 5120.33, Santa Clara County, California",42,42,0
1000000US060855120334007,060855120334007,"Block 4007, Block Group 4, Census Tract 5120.33, Santa Clara County, California",42,42,0
1000000US060855120334008,060855120334008,"Block 4008, Block Group 4, Census Tract 5120.33, Santa Clara County, California",33,32,1
1000000US060855120341000,060855120341000,"Block 1000, Block Group 1, Census Tract 5120.34, Santa Clara County, California",0,0,0
1000000US060855120341001,060855120341001,"Block 1001, Block Group 1, Census Tract 5120.34, Santa Clara County, California",49,49,0
1000000US060855120341002,060855120341002,"Block 1002, Block Group 1, Census Tract 5120.34, Santa Clara County, California",13,13,0
1000000US060855120341003,060855120341003,"Block 1003, Block Group 1, Census Tract 5120.34, Santa Clara County, California",34,34,0
1000000US060855120341004,060855120341004,"Block 1004, Block Group 1, Census Tract 5120.34, Santa Clara County, California",23,23,0
1000000US060855120341005,060855120341005,"Block 1005, Block Group 1, Census Tract 5120.34, Santa Clara County, California",13,11,2
1000000US060855120341006,060855120341006,"Block 1006, Block Group 1, Census Tract 5120.34, Santa Clara County, California",16,16,0
1000000US060855120341007,060855120341007,"Block 1007, Block Group 1, Census Tract 5120.34, Santa Clara County, California",0,0,0
1000000US060855120341008,060855120341008,"Block 1008, Block Group 1, Census Tract 5120.34, Santa Clara County, California",18,17,1
1000000US060855120341009,060855120341009,"Block 1009, Block Group 1, Census Tract 5120.34, Santa Clara County, California",448,434,14
1000000US060855120341010,060855120341010,"Block 1010, Block Group 1, Census Tract 5120.34, Santa Clara County, California",18,18,0
1000000US060855120341011,060855120341011,"Block 1011, Block Group 1, Census Tract 5120.34, Santa Clara County, California",60,59,1
1000000US060855120341012,060855120341012,"Block 1012, Block Group 1, Census Tract 5120.34, Santa Clara County, California",22,22,0
1000000US060855120341013,060855120341013,"Block 1013, Block Group 1, Census Tract 5120.34, Santa Clara County, California",74,74,0
1000000US060855120342000,060855120342000,"Block 2000, Block Group 2, Census Tract 5120.34, Santa Clara County, California",19,16,3
1000000US060855120342001,060855120342001,"Block 2001, Block Group 2, Census Tract 5120.34, Santa Clara County, California",82,80,2
1000000US060855120342002,060855120342002,"Block 2002, Block Group 2, Census Tract 5120.34, Santa Clara County, California",6,6,0
1000000US060855120342003,060855120342003,"Block 2003, Block Group 2, Census Tract 5120.34, Santa Clara County, California",121,116,5
1000000US060855120342004,060855120342004,"Block 2004, Block Group 2, Census Tract 5120.34, Santa Clara County, California",16,15,1
1000000US060855120342005,060855120342005,"Block 2005, Block Group 2, Census Tract 5120.34, Santa Clara County, California",0,0,0
1000000US060855120351000,060855120351000,"Block 1000, Block Group 1, Census Tract 5120.35, Santa Clara County, California",22,22,0
1000000US060855120351001,060855120351001,"Block 1001, Block Group 1, Census Tract 5120.35, Santa Clara County, California",128,119,9
1000000US060855120351002,060855120351002,"Block 1002, Block Group 1, Census Tract 5120.35, Santa Clara County, California",25,24,1
1000000US060855120351003,060855120351003,"Block 1003, Block Group 1, Census Tract 5120.35, Santa Clara County, California",17,17,0
1000000US060855120351004,060855120351004,"Block 1004, Block Group 1, Census Tract 5120.35, Santa Clara County, California",41,41,0
1000000US060855120351005,060855120351005,"Block 1005, Block Group 1, Census Tract 5120.35, Santa Clara County, California",0,0,0
1000000US060855120351006,060855120351006,"Block 1006, Block Group 1, Census Tract 5120.35, Santa Clara County, California",17,17,0
1000000US060855120351007,060855120351007,"Block 1007, Block Group 1, Census Tract 5120.35, Santa Clara County, California",26,24,2
1000000US060855120351008,060855120351008,"Block 1008, Block Group 1, Census Tract 5120.35, Santa Clara County, California",33,33,0
1000000US060855120351009,060855120351009,"Block 1009, Block Group 1, Census Tract 5120.35, Santa Clara County, California",123,121,2
1000000US060855120351010,060855120351010,"Block 1010, Block Group 1, Census Tract 5120.35, Santa Clara County, California",152,149,3
1000000US060855120351011,060855120351011,"Block 1011, Block Group 1, Census Tract 5120.35, Santa Clara County, California",15,15,0
1000000US060855120351012,060855120351012,"Block 1012, Block Group 1, Census Tract 5120.35, Santa Clara County, California",36,35,1
1000000US060855120351013,060855120351013,"Block 1013, Block Group 1, Census Tract 5120.35, Santa Clara County, California",15,15,0
1000000US060855120351014,060855120351014,"Block 1014, Block Group 1, Census Tract 5120.35, Santa Clara County, California",0,0,0
1000000US060855120351015,060855120351015,"Block 1015, Block Group 1, Census Tract 5120.35, Santa Clara County, California",22,22,0
1000000US060855120351016,060855120351016,"Block 1016, Block Group 1, Census Tract 5120.35, Santa Clara County, California",7,7,0
1000000US060855120351017,060855120351017,"Block 1017, Block Group 1, Census Tract 5120.35, Santa Clara County, California",0,0,0
1000000US060855120351018,060855120351018,"Block 1018, Block Group 1, Census Tract 5120.35, Santa Clara County, California",0,0,0
1000000US060855120351019,060855120351019,"Block 1019, Block Group 1, Census Tract 5120.35, Santa Clara County, California",2,2,0
1000000US060855120352000,060855120352000,"Block 2000, Block Group 2, Census Tract 5120.35, Santa Clara County, California",0,0,0
1000000US060855120352001,060855120352001,"Block 2001, Block Group 2, Census Tract 5120.35, Santa Clara County, California",77,76,1
1000000US060855120352002,060855120352002,"Block 2002, Block Group 2, Census Tract 5120.35, Santa Clara County, California",113,107,6
1000000US060855120352003,060855120352003,"Block 2003, Block Group 2, Census Tract 5120.35, Santa Clara County, California",47,47,0
1000000US060855120352004,060855120352004,"Block 2004, Block Group 2, Census Tract 5120.35, Santa Clara County, California",50,49,1
1000000US060855120352005,060855120352005,"Block 2005, Block Group 2, Census Tract 5120.35, Santa Clara County, California",0,0,0
1000000US060855120352006,060855120352006,"Block 2006, Block Group 2, Census Tract 5120.35, Santa Clara County, California",0,0,0
1000000US060855120352007,060855120352007,"Block 2007, Block Group 2, Census Tract 5120.35, Santa Clara County, California",8,7,1
1000000US060855120352008,060855120352008,"Block 2008, Block Group 2, Census Tract 5120.35, Santa Clara County, California",222,221,1
1000000US060855120352009,060855120352009,"Block 2009, Block Group 2, Census Tract 5120.35, Santa Clara County, California",58,56,2
1000000US060855120352010,060855120352010,"Block 2010, Block Group 2, Census Tract 5120.35, Santa Clara County, California",21,19,2
1000000US060855120352011,060855120352011,"Block 2011, Block Group 2, Census Tract 5120.35, Santa Clara County, California",45,44,1
1000000US060855120352012,060855120352012,"Block 2012, Block Group 2, Census Tract 5120.35, Santa Clara County, California",11,11,0
1000000US060855120352013,060855120352013,"Block 2013, Block Group 2, Census Tract 5120.35, Santa Clara County, California",30,30,0
1000000US060855120352014,060855120352014,"Block 2014, Block Group 2, Census Tract 5120.35, Santa Clara County, California",15,14,1
1000000US060855120352015,060855120352015,"Block 2015, Block Group 2, Census Tract 5120.35, Santa Clara County, California",0,0,0
1000000US060855120361000,060855120361000,"Block 1000, Block Group 1, Census Tract 5120.36, Santa Clara County, California",1455,1234,221
1000000US060855120361001,060855120361001,"Block 1001, Block Group 1, Census Tract 5120.36, Santa Clara County, California",48,47,1
1000000US060855120361002,060855120361002,"Block 1002, Block Group 1, Census Tract 5120.36, Santa Clara County, California",1,1,0
1000000US060855120361003,060855120361003,"Block 1003, Block Group 1, Census Tract 5120.36, Santa Clara County, California",37,37,0
1000000US060855120361004,060855120361004,"Block 1004, Block Group 1, Census Tract 5120.36, Santa Clara County, California",21,21,0
1000000US060855120361005,060855120361005,"Block 1005, Block Group 1, Census Tract 5120.36, Santa Clara County, California",36,36,0
1000000US060855120361006,060855120361006,"Block 1006, Block Group 1, Census Tract 5120.36, Santa Clara County, California",16,16,0
1000000US060855120361007,060855120361007,"Block 1007, Block Group 1, Census Tract 5120.36, Santa Clara County, California",13,13,0
1000000US060855120361008,060855120361008,"Block 1008, Block Group 1, Census Tract 5120.36, Santa Clara County, California",13,13,0
1000000US060855120361009,060855120361009,"Block 1009, Block Group 1, Census Tract 5120.36, Santa Clara County, California",36,34,2
1000000US060855120361010,060855120361010,"Block 1010, Block Group 1, Census Tract 5120.36, Santa Clara County, California",24,24,0
1000000US060855120361011,060855120361011,"Block 1011, Block Group 1, Census Tract 5120.36, Santa Clara County, California",32,31,1
1000000US060855120361012,060855120361012,"Block 1012, Block Group 1, Census Tract 5120.36, Santa Clara County, California",34,34,0
1000000US060855120361013,060855120361013,"Block 1013, Block Group 1, Census Tract 5120.36, Santa Clara County, California",62,61,1
1000000US060855120361014,060855120361014,"Block 1014, Block Group 1, Census Tract 5120.36, Santa Clara County, California",47,46,1
1000000US060855120361015,060855120361015,"Block 1015, Block Group 1, Census Tract 5120.36, Santa Clara County, California",25,25,0
1000000US060855120371000,060855120371000,"Block 1000, Block Group 1, Census Tract 5120.37, Santa Clara County, California",20,20,0
1000000US060855120371001,060855120371001,"Block 1001, Block Group 1, Census Tract 5120.37, Santa Clara County, California",45,44,1
1000000US060855120371002,060855120371002,"Block 1002, Block Group 1, Census Tract 5120.37, Santa Clara County, California",25,24,1
1000000US060855120371003,060855120371003,"Block 1003, Block Group 1, Census Tract 5120.37, Santa Clara County, California",34,32,2
1000000US060855120371004,060855120371004,"Block 1004, Block Group 1, Census Tract 5120.37, Santa Clara County, California",33,33,0
1000000US060855120371005,060855120371005,"Block 1005, Block Group 1, Census Tract 5120.37, Santa Clara County, California",25,25,0
1000000US060855120371006,060855120371006,"Block 1006, Block Group 1, Census Tract 5120.37, Santa Clara County, California",24,24,0
1000000US060855120371007,060855120371007,"Block 1007, Block Group 1, Census Tract 5120.37, Santa Clara County, California",40,39,1
1000000US060855120371008,060855120371008,"Block 1008, Block Group 1, Census Tract 5120.37, Santa Clara County, California",50,49,1
1000000US060855120371009,060855120371009,"Block 1009, Block Group 1, Census Tract 5120.37, Santa Clara County, California",47,46,1
1000000US060855120371010,060855120371010,"Block 1010, Block Group 1, Census Tract 5120.37, Santa Clara County, California",45,45,0
1000000US060855120371011,060855120371011,"Block 1011, Block Group 1, Census Tract 5120.37, Santa Clara County, California",16,16,0
1000000US060855120371012,060855120371012,"Block 1012, Block Group 1, Census Tract 5120.37, Santa Clara County, California",38,38,0
1000000US060855120371013,060855120371013,"Block 1013, Block Group 1, Census Tract 5120.37, Santa Clara County, California",28,28,0
1000000US060855120371014,060855120371014,"Block 1014, Block Group 1, Census Tract 5120.37, Santa Clara County, California",40,39,1
1000000US060855120371015,060855120371015,"Block 1015, Block Group 1, Census Tract 5120.37, Santa Clara County, California",60,57,3
1000000US060855120371016,060855120371016,"Block 1016, Block Group 1, Census Tract 5120.37, Santa Clara County, California",24,24,0
1000000US060855120372000,060855120372000,"Block 2000, Block Group 2, Census Tract 5120.37, Santa Clara County, California",180,173,7
1000000US060855120372001,060855120372001,"Block 2001, Block Group 2, Census Tract 5120.37, Santa Clara County, California",26,25,1
1000000US060855120372002,060855120372002,"Block 2002, Block Group 2, Census Tract 5120.37, Santa Clara County, California",53,53,0
1000000US060855120372003,060855120372003,"Block 2003, Block Group 2, Census Tract 5120.37, Santa Clara County, California",26,25,1
1000000US060855120372004,060855120372004,"Block 2004, Block Group 2, Census Tract 5120.37, Santa Clara County, California",44,44,0
1000000US060855120372005,060855120372005,"Block 2005, Block Group 2, Census Tract 5120.37, Santa Clara County, California",24,24,0
1000000US060855120372006,060855120372006,"Block 2006, Block Group 2, Census Tract 5120.37, Santa Clara County, California",34,33,1
1000000US060855120381000,060855120381000,"Block 1000, Block Group 1, Census Tract 5120.38, Santa Clara County, California",0,0,0
1000000US060855120381001,060855120381001,"Block 1001, Block Group 1, Census Tract 5120.38, Santa Clara County, California",0,0,0
1000000US060855120381002,060855120381002,"Block 1002, Block Group 1, Census Tract 5120.38, Santa Clara County, California",1,1,0
1000000US060855120381003,060855120381003,"Block 1003, Block Group 1, Census Tract 5120.38, Santa Clara County, California",292,277,15
1000000US060855120381004,060855120381004,"Block 1004, Block Group 1, Census Tract 5120.38, Santa Clara County, California",24,23,1
1000000US060855120381005,060855120381005,"Block 1005, Block Group 1, Census Tract 5120.38, Santa Clara County, California",16,16,0
1000000US060855120381006,060855120381006,"Block 1006, Block Group 1, Census Tract 5120.38, Santa Clara County, California",12,11,1
1000000US060855120381007,060855120381007,"Block 1007, Block Group 1, Census Tract 5120.38, Santa Clara County, California",17,17,0
1000000US060855120381008,060855120381008,"Block 1008, Block Group 1, Census Tract 5120.38, Santa Clara County, California",30,30,0
1000000US060855120381009,060855120381009,"Block 1009, Block Group 1, Census Tract 5120.38, Santa Clara County, California",10,10,0
1000000US060855120381010,060855120381010,"Block 1010, Block Group 1, Census Tract 5120.38, Santa Clara County, California",0,0,0
1000000US060855120381011,060855120381011,"Block 1011, Block Group 1, Census Tract 5120.38, Santa Clara County, California",12,12,0
1000000US060855120381012,060855120381012,"Block 1012, Block Group 1, Census Tract 5120.38, Santa Clara County, California",48,46,2
1000000US060855120381013,060855120381013,"Block 1013, Block Group 1, Census Tract 5120.38, Santa Clara County, California",18,17,1
1000000US060855120381014,060855120381014,"Block 1014, Block Group 1, Census Tract 5120.38, Santa Clara County, California",8,7,1
1000000US060855120381015,060855120381015,"Block 1015, Block Group 1, Census Tract 5120.38, Santa Clara County, California",32,32,0
1000000US060855120381016,060855120381016,"Block 1016, Block Group 1, Census Tract 5120.38, Santa Clara County, California",104,94,10
1000000US060855120381017,060855120381017,"Block 1017, Block Group 1, Census Tract 5120.38, Santa Clara County, California",111,108,3
1000000US060855120381018,060855120381018,"Block 1018, Block Group 1, Census Tract 5120.38, Santa Clara County, California",28,28,0
1000000US060855120381019,060855120381019,"Block 1019, Block Group 1, Census Tract 5120.38, Santa Clara County, California",37,33,4
1000000US060855120381020,060855120381020,"Block 1020, Block Group 1, Census Tract 5120.38, Santa Clara County, California",48,47,1
1000000US060855120381021,060855120381021,"Block 1021, Block Group 1, Census Tract 5120.38, Santa Clara County, California",95,93,2
1000000US060855120381022,060855120381022,"Block 1022, Block Group 1, Census Tract 5120.38, Santa Clara County, California",55,55,0
1000000US060855120381023,060855120381023,"Block 1023, Block Group 1, Census Tract 5120.38, Santa Clara County, California",11,10,1
1000000US060855120381024,060855120381024,"Block 1024, Block Group 1, Census Tract 5120.38, Santa Clara County, California",0,0,0
1000000US060855120381025,060855120381025,"Block 1025, Block Group 1, Census Tract 5120.38, Santa Clara County, California",0,0,0
1000000US060855120381026,060855120381026,"Block 1026, Block Group 1, Census Tract 5120.38, Santa Clara County, California",0,0,0
1000000US060855120381027,060855120381027,"Block 1027, Block Group 1, Census Tract 5120.38, Santa Clara County, California",0,0,0
1000000US060855120381028,060855120381028,"Block 1028, Block Group 1, Census Tract 5120.38, Santa Clara County, California",0,0,0
1000000US060855120381029,060855120381029,"Block 1029, Block Group 1, Census Tract 5120.38, Santa Clara County, California",0,0,0
1000000US060855120381030,060855120381030,"Block 1030, Block Group 1, Census Tract 5120.38, Santa Clara County, California",11,11,0
1000000US060855120381031,060855120381031,"Block 1031, Block Group 1, Census Tract 5120.38, Santa Clara County, California",22,22,0
1000000US060855120381032,060855120381032,"Block 1032, Block Group 1, Census Tract 5120.38, Santa Clara County, California",32,28,4
1000000US060855120391000,060855120391000,"Block 1000, Block Group 1, Census Tract 5120.39, Santa Clara County, California",23,22,1
1000000US060855120391001,060855120391001,"Block 1001, Block Group 1, Census Tract 5120.39, Santa Clara County, California",0,0,0
1000000US060855120391002,060855120391002,"Block 1002, Block Group 1, Census Tract 5120.39, Santa Clara County, California",17,16,1
1000000US060855120391003,060855120391003,"Block 1003, Block Group 1, Census Tract 5120.39, Santa Clara County, California",26,26,0
1000000US060855120391004,060855120391004,"Block 1004, Block Group 1, Census Tract 5120.39, Santa Clara County, California",9,6,3
1000000US060855120391005,060855120391005,"Block 1005, Block Group 1, Census Tract 5120.39, Santa Clara County, California",206,195,11
1000000US060855120391006,060855120391006,"Block 1006, Block Group 1, Census Tract 5120.39, Santa Clara County, California",14,14,0
1000000US060855120391007,060855120391007,"Block 1007, Block Group 1, Census Tract 5120.39, Santa Clara County, California",16,16,0
1000000US060855120391008,060855120391008,"Block 1008, Block Group 1, Census Tract 5120.39, Santa Clara County, California",14,13,1
1000000US060855120391009,060855120391009,"Block 1009, Block Group 1, Census Tract 5120.39, Santa Clara County, California",14,14,0
1000000US060855120391010,060855120391010,"Block 1010, Block Group 1, Census Tract 5120.39, Santa Clara County, California",20,19,1
1000000US060855120391011,060855120391011,"Block 1011, Block Group 1, Census Tract 5120.39, Santa Clara County, California",20,20,0
1000000US060855120391012,060855120391012,"Block 1012, Block Group 1, Census Tract 5120.39, Santa Clara County, California",13,13,0
1000000US060855120391013,060855120391013,"Block 1013, Block Group 1, Census Tract 5120.39, Santa Clara County, California",12,11,1
1000000US060855120391014,060855120391014,"Block 1014, Block Group 1, Census Tract 5120.39, Santa Clara County, California",32,31,1
1000000US060855120392000,060855120392000,"Block 2000, Block Group 2, Census Tract 5120.39, Santa Clara County, California",120,115,5
1000000US060855120392001,060855120392001,"Block 2001, Block Group 2, Census Tract 5120.39, Santa Clara County, California",45,45,0
1000000US060855120392002,060855120392002,"Block 2002, Block Group 2, Census Tract 5120.39, Santa Clara County, California",62,61,1
1000000US060855120392003,060855120392003,"Block 2003, Block Group 2, Census Tract 5120.39, Santa Clara County, California",25,25,0
1000000US060855120392004,060855120392004,"Block 2004, Block Group 2, Census Tract 5120.39, Santa Clara County, California",0,0,0
1000000US060855120392005,060855120392005,"Block 2005, Block Group 2, Census Tract 5120.39, Santa Clara County, California",12,12,0
1000000US060855120392006,060855120392006,"Block 2006, Block Group 2, Census Tract 5120.39, Santa Clara County, California",12,11,1
1000000US060855120392007,060855120392007,"Block 2007, Block Group 2, Census Tract 5120.39, Santa Clara County, California",21,21,0
1000000US060855120392008,060855120392008,"Block 2008, Block Group 2, Census Tract 5120.39, Santa Clara County, California",27,27,0
1000000US060855120392009,060855120392009,"Block 2009, Block Group 2, Census Tract 5120.39, Santa Clara County, California",30,30,0
1000000US060855120392010,060855120392010,"Block 2010, Block Group 2, Census Tract 5120.39, Santa Clara County, California",32,31,1
1000000US060855120393000,060855120393000,"Block 3000, Block Group 3, Census Tract 5120.39, Santa Clara County, California",111,111,0
1000000US060855120393001,060855120393001,"Block 3001, Block Group 3, Census Tract 5120.39, Santa Clara County, California",40,40,0
1000000US060855120393002,060855120393002,"Block 3002, Block Group 3, Census Tract 5120.39, Santa Clara County, California",0,0,0
1000000US060855120393003,060855120393003,"Block 3003, Block Group 3, Census Tract 5120.39, Santa Clara County, California",40,39,1
1000000US060855120393004,060855120393004,"Block 3004, Block Group 3, Census Tract 5120.39, Santa Clara County, California",102,95,7
1000000US060855120393005,060855120393005,"Block 3005, Block Group 3, Census Tract 5120.39, Santa Clara County, California",65,63,2
1000000US060855120393006,060855120393006,"Block 3006, Block Group 3, Census Tract 5120.39, Santa Clara County, California",39,36,3
1000000US060855120393007,060855120393007,"Block 3007, Block Group 3, Census Tract 5120.39, Santa Clara County, California",108,103,5
1000000US060855120393008,060855120393008,"Block 3008, Block Group 3, Census Tract 5120.39, Santa Clara County, California",0,0,0
1000000US060855120421000,060855120421000,"Block 1000, Block Group 1, Census Tract 5120.42, Santa Clara County, California",140,133,7
1000000US060855120421001,060855120421001,"Block 1001, Block Group 1, Census Tract 5120.42, Santa Clara County, California",60,58,2
1000000US060855120421002,060855120421002,"Block 1002, Block Group 1, Census Tract 5120.42, Santa Clara County, California",14,14,0
1000000US060855120421003,060855120421003,"Block 1003, Block Group 1, Census Tract 5120.42, Santa Clara County, California",21,20,1
1000000US060855120421004,060855120421004,"Block 1004, Block Group 1, Census Tract 5120.42, Santa Clara County, California",29,29,0
1000000US060855120421005,060855120421005,"Block 1005, Block Group 1, Census Tract 5120.42, Santa Clara County, California",81,81,0
1000000US060855120421006,060855120421006,"Block 1006, Block Group 1, Census Tract 5120.42, Santa Clara County, California",18,18,0
1000000US060855120421007,060855120421007,"Block 1007, Block Group 1, Census Tract 5120.42, Santa Clara County, California",19,18,1
1000000US060855120422000,060855120422000,"Block 2000, Block Group 2, Census Tract 5120.42, Santa Clara County, California",36,36,0
1000000US060855120422001,060855120422001,"Block 2001, Block Group 2, Census Tract 5120.42, Santa Clara County, California",34,34,0
1000000US060855120422002,060855120422002,"Block 2002, Block Group 2, Census Tract 5120.42, Santa Clara County, California",35,35,0
1000000US060855120422003,060855120422003,"Block 2003, Block Group 2, Census Tract 5120.42, Santa Clara County, California",60,58,2
1000000US060855120422004,060855120422004,"Block 2004, Block Group 2, Census Tract 5120.42, Santa Clara County, California",32,31,1
1000000US060855120422005,060855120422005,"Block 2005, Block Group 2, Census Tract 5120.42, Santa Clara County, California",24,24,0
1000000US060855120422006,060855120422006,"Block 2006, Block Group 2, Census Tract 5120.42, Santa Clara County, California",247,228,19
1000000US060855120431000,060855120431000,"Block 1000, Block Group 1, Census Tract 5120.43, Santa Clara County, California",252,246,6
1000000US060855120431001,060855120431001,"Block 1001, Block Group 1, Census Tract 5120.43, Santa Clara County, California",30,30,0
1000000US060855120431002,060855120431002,"Block 1002, Block Group 1, Census Tract 5120.43, Santa Clara County, California",21,21,0
1000000US060855120431003,060855120431003,"Block 1003, Block Group 1, Census Tract 5120.43, Santa Clara County, California",162,159,3
1000000US060855120431004,060855120431004,"Block 1004, Block Group 1, Census Tract 5120.43, Santa Clara County, California",23,23,0
1000000US060855120431005,060855120431005,"Block 1005, Block Group 1, Census Tract 5120.43, Santa Clara County, California",4,4,0
1000000US060855120431006,060855120431006,"Block 1006, Block Group 1, Census Tract 5120.43, Santa Clara County, California",40,35,5
1000000US060855120431007,060855120431007,"Block 1007, Block Group 1, Census Tract 5120.43, Santa Clara County, California",359,340,19
1000000US060855120431008,060855120431008,"Block 1008, Block Group 1, Census Tract 5120.43, Santa Clara County, California",119,113,6
1000000US060855120431009,060855120431009,"Block 1009, Block Group 1, Census Tract 5120.43, Santa Clara County, California",23,23,0
1000000US060855120432000,060855120432000,"Block 2000, Block Group 2, Census Tract 5120.43, Santa Clara County, California",91,88,3
1000000US060855120432001,060855120432001,"Block 2001, Block Group 2, Census Tract 5120.43, Santa Clara County, California",2,2,0
1000000US060855120432002,060855120432002,"Block 2002, Block Group 2, Census Tract 5120.43, Santa Clara County, California",4,4,0
1000000US060855120432003,060855120432003,"Block 2003, Block Group 2, Census Tract 5120.43, Santa Clara County, California",41,40,1
1000000US060855120432004,060855120432004,"Block 2004, Block Group 2, Census Tract 5120.43, Santa Clara County, California",25,25,0
1000000US060855120432005,060855120432005,"Block 2005, Block Group 2, Census Tract 5120.43, Santa Clara County, California",49,49,0
1000000US060855120432006,060855120432006,"Block 2006, Block Group 2, Census Tract 5120.43, Santa Clara County, California",22,22,0
1000000US060855120432007,060855120432007,"Block 2007, Block Group 2, Census Tract 5120.43, Santa Clara County, California",20,18,2
1000000US060855120432008,060855120432008,"Block 2008, Block Group 2, Census Tract 5120.43, Santa Clara County, California",25,24,1
1000000US060855120432009,060855120432009,"Block 2009, Block Group 2, Census Tract 5120.43, Santa Clara County, California",26,26,0
1000000US060855120432010,060855120432010,"Block 2010, Block Group 2, Census Tract 5120.43, Santa Clara County, California",27,26,1
1000000US060855120432011,060855120432011,"Block 2011, Block Group 2, Census Tract 5120.43, Santa Clara County, California",29,29,0
1000000US060855120432012,060855120432012,"Block 2012, Block Group 2, Census Tract 5120.43, Santa Clara County, California",27,27,0
1000000US060855120432013,060855120432013,"Block 2013, Block Group 2, Census Tract 5120.43, Santa Clara County, California",25,23,2
1000000US060855120432014,060855120432014,"Block 2014, Block Group 2, Census Tract 5120.43, Santa Clara County, California",34,33,1
1000000US060855120432015,060855120432015,"Block 2015, Block Group 2, Census Tract 5120.43, Santa Clara County, California",21,19,2
1000000US060855120432016,060855120432016,"Block 2016, Block Group 2, Census Tract 5120.43, Santa Clara County, California",37,36,1
1000000US060855120432017,060855120432017,"Block 2017, Block Group 2, Census Tract 5120.43, Santa Clara County, California",23,23,0
1000000US060855120451000,060855120451000,"Block 1000, Block Group 1, Census Tract 5120.45, Santa Clara County, California",93,92,1
1000000US060855120451001,060855120451001,"Block 1001, Block Group 1, Census Tract 5120.45, Santa Clara County, California",31,30,1
1000000US060855120451002,060855120451002,"Block 1002, Block Group 1, Census Tract 5120.45, Santa Clara County, California",46,42,4
1000000US060855120451003,060855120451003,"Block 1003, Block Group 1, Census Tract 5120.45, Santa Clara County, California",35,35,0
1000000US060855120451004,060855120451004,"Block 1004, Block Group 1, Census Tract 5120.45, Santa Clara County, California",50,49,1
1000000US060855120451005,060855120451005,"Block 1005, Block Group 1, Census Tract 5120.45, Santa Clara County, California",42,42,0
1000000US060855120451006,060855120451006,"Block 1006, Block Group 1, Census Tract 5120.45, Santa Clara County, California",25,25,0
1000000US060855120451007,060855120451007,"Block 1007, Block Group 1, Census Tract 5120.45, Santa Clara County, California",25,24,1
1000000US060855120451008,060855120451008,"Block 1008, Block Group 1, Census Tract 5120.45, Santa Clara County, California",48,47,1
1000000US060855120451009,060855120451009,"Block 1009, Block Group 1, Census Tract 5120.45, Santa Clara County, California",22,22,0
1000000US060855120451010,060855120451010,"Block 1010, Block Group 1, Census Tract 5120.45, Santa Clara County, California",22,22,0
1000000US060855120451011,060855120451011,"Block 1011, Block Group 1, Census Tract 5120.45, Santa Clara County, California",1,1,0
1000000US060855120451012,060855120451012,"Block 1012, Block Group 1, Census Tract 5120.45, Santa Clara County, California",53,49,4
1000000US060855120451013,060855120451013,"Block 1013, Block Group 1, Census Tract 5120.45, Santa Clara County, California",32,31,1
1000000US060855120451014,060855120451014,"Block 1014, Block Group 1, Census Tract 5120.45, Santa Clara County, California",63,62,1
1000000US060855120451015,060855120451015,"Block 1015, Block Group 1, Census Tract 5120.45, Santa Clara County, California",29,29,0
1000000US060855120452000,060855120452000,"Block 2000, Block Group 2, Census Tract 5120.45, Santa Clara County, California",41,41,0
1000000US060855120452001,060855120452001,"Block 2001, Block Group 2, Census Tract 5120.45, Santa Clara County, California",47,47,0
1000000US060855120452002,060855120452002,"Block 2002, Block Group 2, Census Tract 5120.45, Santa Clara County, California",44,42,2
1000000US060855120452003,060855120452003,"Block 2003, Block Group 2, Census Tract 5120.45, Santa Clara County, California",26,26,0
1000000US060855120452004,060855120452004,"Block 2004, Block Group 2, Census Tract 5120.45, Santa Clara County, California",73,73,0
1000000US060855120452005,060855120452005,"Block 2005, Block Group 2, Census Tract 5120.45, Santa Clara County, California",15,15,0
1000000US060855120452006,060855120452006,"Block 2006, Block Group 2, Census Tract 5120.45, Santa Clara County, California",28,26,2
1000000US060855120452007,060855120452007,"Block 2007, Block Group 2, Census Tract 5120.45, Santa Clara County, California",28,28,0
1000000US060855120452008,060855120452008,"Block 2008, Block Group 2, Census Tract 5120.45, Santa Clara County, California",59,59,0
1000000US060855120453000,060855120453000,"Block 3000, Block Group 3, Census Tract 5120.45, Santa Clara County, California",69,68,1
1000000US060855120453001,060855120453001,"Block 3001, Block Group 3, Census Tract 5120.45, Santa Clara County, California",23,23,0
1000000US060855120453002,060855120453002,"Block 3002, Block Group 3, Census Tract 5120.45, Santa Clara County, California",66,65,1
1000000US060855120453003,060855120453003,"Block 3003, Block Group 3, Census Tract 5120.45, Santa Clara County, California",30,29,1
1000000US060855120453004,060855120453004,"Block 3004, Block Group 3, Census Tract 5120.45, Santa Clara County, California",50,48,2
1000000US060855120453005,060855120453005,"Block 3005, Block Group 3, Census Tract 5120.45, Santa Clara County, California",20,19,1
1000000US060855120453006,060855120453006,"Block 3006, Block Group 3, Census Tract 5120.45, Santa Clara County, California",21,21,0
1000000US060855120453007,060855120453007,"Block 3007, Block Group 3, Census Tract 5120.45, Santa Clara County, California",26,26,0
1000000US060855120454000,060855120454000,"Block 4000, Block Group 4, Census Tract 5120.45, Santa Clara County, California",39,39,0
1000000US060855120454001,060855120454001,"Block 4001, Block Group 4, Census Tract 5120.45, Santa Clara County, California",31,31,0
1000000US060855120454002,060855120454002,"Block 4002, Block Group 4, Census Tract 5120.45, Santa Clara County, California",48,47,1
1000000US060855120454003,060855120454003,"Block 4003, Block Group 4, Census Tract 5120.45, Santa Clara County, California",43,42,1
1000000US060855120454004,060855120454004,"Block 4004, Block Group 4, Census Tract 5120.45, Santa Clara County, California",48,48,0
1000000US060855120454005,060855120454005,"Block 4005, Block Group 4, Census Tract 5120.45, Santa Clara County, California",38,38,0
1000000US060855120454006,060855120454006,"Block 4006, Block Group 4, Census Tract 5120.45, Santa Clara County, California",41,41,0
1000000US060855120454007,060855120454007,"Block 4007, Block Group 4, Census Tract 5120.45, Santa Clara County, California",37,37,0
1000000US060855120454008,060855120454008,"Block 4008, Block Group 4, Census Tract 5120.45, Santa Clara County, California",22,22,0
1000000US060855120454009,060855120454009,"Block 4009, Block Group 4, Census Tract 5120.45, Santa Clara County, California",42,42,0
1000000US060855120454010,060855120454010,"Block 4010, Block Group 4, Census Tract 5120.45, Santa Clara County, California",47,46,1
1000000US060855120454011,060855120454011,"Block 4011, Block Group 4, Census Tract 5120.45, Santa Clara County, California",38,36,2
1000000US060855120454012,060855120454012,"Block 4012, Block Group 4, Census Tract 5120.45, Santa Clara County, California",42,41,1
1000000US060855120454013,060855120454013,"Block 4013, Block Group 4, Census Tract 5120.45, Santa Clara County, California",21,21,0
1000000US060855120454014,060855120454014,"Block 4014, Block Group 4, Census Tract 5120.45, Santa Clara County, California",14,14,0
1000000US060855120471000,060855120471000,"Block 1000, Block Group 1, Census Tract 5120.47, Santa Clara County, California",0,0,0
1000000US060855120471001,060855120471001,"Block 1001, Block Group 1, Census Tract 5120.47, Santa Clara County, California",40,38,2
1000000US060855120471002,060855120471002,"Block 1002, Block Group 1, Census Tract 5120.47, Santa Clara County, California",48,46,2
1000000US060855120471003,060855120471003,"Block 1003, Block Group 1, Census Tract 5120.47, Santa Clara County, California",61,59,2
1000000US060855120471004,060855120471004,"Block 1004, Block Group 1, Census Tract 5120.47, Santa Clara County, California",93,88,5
1000000US060855120471005,060855120471005,"Block 1005, Block Group 1, Census Tract 5120.47, Santa Clara County, California",26,26,0
1000000US060855120471006,060855120471006,"Block 1006, Block Group 1, Census Tract 5120.47, Santa Clara County, California",38,37,1
1000000US060855120471007,060855120471007,"Block 1007, Block Group 1, Census Tract 5120.47, Santa Clara County, California",52,50,2
1000000US060855120471008,060855120471008,"Block 1008, Block Group 1, Census Tract 5120.47, Santa Clara County, California",56,52,4
1000000US060855120471009,060855120471009,"Block 1009, Block Group 1, Census Tract 5120.47, Santa Clara County, California",47,47,0
1000000US060855120471010,060855120471010,"Block 1010, Block Group 1, Census Tract 5120.47, Santa Clara County, California",24,24,0
1000000US060855120471011,060855120471011,"Block 1011, Block Group 1, Census Tract 5120.47, Santa Clara County, California",40,40,0
1000000US060855120471012,060855120471012,"Block 1012, Block Group 1, Census Tract 5120.47, Santa Clara County, California",23,22,1
1000000US060855120471013,060855120471013,"Block 1013, Block Group 1, Census Tract 5120.47, Santa Clara County, California",43,43,0
1000000US060855120471014,060855120471014,"Block 1014, Block Group 1, Census Tract 5120.47, Santa Clara County, California",39,39,0
1000000US060855120471015,060855120471015,"Block 1015, Block Group 1, Census Tract 5120.47, Santa Clara County, California",47,47,0
1000000US060855120472000,060855120472000,"Block 2000, Block Group 2, Census Tract 5120.47, Santa Clara County, California",31,31,0
1000000US060855120472001,060855120472001,"Block 2001, Block Group 2, Census Tract 5120.47, Santa Clara County, California",4,4,0
1000000US060855120472002,060855120472002,"Block 2002, Block Group 2, Census Tract 5120.47, Santa Clara County, California",35,34,1
1000000US060855120472003,060855120472003,"Block 2003, Block Group 2, Census Tract 5120.47, Santa Clara County, California",47,47,0
1000000US060855120472004,060855120472004,"Block 2004, Block Group 2, Census Tract 5120.47, Santa Clara County, California",41,40,1
1000000US060855120472005,060855120472005,"Block 2005, Block Group 2, Census Tract 5120.47, Santa Clara County, California",1,1,0
1000000US060855120472006,060855120472006,"Block 2006, Block Group 2, Census Tract 5120.47, Santa Clara County, California",22,22,0
1000000US060855120472007,060855120472007,"Block 2007, Block Group 2, Census Tract 5120.47, Santa Clara County, California",29,28,1
1000000US060855120472008,060855120472008,"Block 2008, Block Group 2, Census Tract 5120.47, Santa Clara County, California",31,31,0
1000000US060855120472009,060855120472009,"Block 2009, Block Group 2, Census Tract 5120.47, Santa Clara County, California",70,68,2
1000000US060855120472010,060855120472010,"Block 2010, Block Group 2, Census Tract 5120.47, Santa Clara County, California",52,52,0
1000000US060855120472011,060855120472011,"Block 2011, Block Group 2, Census Tract 5120.47, Santa Clara County, California",38,37,1
1000000US060855120472012,060855120472012,"Block 2012, Block Group 2, Census Tract 5120.47, Santa Clara County, California",27,27,0
1000000US060855120472013,060855120472013,"Block 2013, Block Group 2, Census Tract 5120.47, Santa Clara County, California",36,36,0
1000000US060855120472014,060855120472014,"Block 2014, Block Group 2, Census Tract 5120.47, Santa Clara County, California",32,29,3
1000000US060855120472015,060855120472015,"Block 2015, Block Group 2, Census Tract 5120.47, Santa Clara County, California",24,21,3
1000000US060855120472016,060855120472016,"Block 2016, Block Group 2, Census Tract 5120.47, Santa Clara County, California",40,39,1
1000000US060855120472017,060855120472017,"Block 2017, Block Group 2, Census Tract 5120.47, Santa Clara County, California",4,3,1
1000000US060855120473000,060855120473000,"Block 3000, Block Group 3, Census Tract 5120.47, Santa Clara County, California",52,52,0
1000000US060855120473001,060855120473001,"Block 3001, Block Group 3, Census Tract 5120.47, Santa Clara County, California",7,7,0
1000000US060855120473002,060855120473002,"Block 3002, Block Group 3, Census Tract 5120.47, Santa Clara County, California",72,72,0
1000000US060855120473003,060855120473003,"Block 3003, Block Group 3, Census Tract 5120.47, Santa Clara County, California",53,52,1
1000000US060855120473004,060855120473004,"Block 3004, Block Group 3, Census Tract 5120.47, Santa Clara County, California",30,30,0
1000000US060855120473005,060855120473005,"Block 3005, Block Group 3, Census Tract 5120.47, Santa Clara County, California",32,32,0
1000000US060855120473006,060855120473006,"Block 3006, Block Group 3, Census Tract 5120.47, Santa Clara County, California",56,55,1
1000000US060855120473007,060855120473007,"Block 3007, Block Group 3, Census Tract 5120.47, Santa Clara County, California",36,36,0
1000000US060855120473008,060855120473008,"Block 3008, Block Group 3, Census Tract 5120.47, Santa Clara County, California",70,70,0
1000000US060855120473009,060855120473009,"Block 3009, Block Group 3, Census Tract 5120.47, Santa Clara County, California",35,35,0
1000000US060855120473010,060855120473010,"Block 3010, Block Group 3, Census Tract 5120.47, Santa Clara County, California",0,0,0
1000000US060855120473011,060855120473011,"Block 3011, Block Group 3, Census Tract 5120.47, Santa Clara County, California",49,49,0
1000000US060855120521000,060855120521000,"Block 1000, Block Group 1, Census Tract 5120.52, Santa Clara County, California",135,128,7
1000000US060855120521001,060855120521001,"Block 1001, Block Group 1, Census Tract 5120.52, Santa Clara County, California",100,98,2
1000000US060855120521002,060855120521002,"Block 1002, Block Group 1, Census Tract 5120.52, Santa Clara County, California",0,0,0
1000000US060855120521003,060855120521003,"Block 1003, Block Group 1, Census Tract 5120.52, Santa Clara County, California",116,106,10
1000000US060855120521004,060855120521004,"Block 1004, Block Group 1, Census Tract 5120.52, Santa Clara County, California",0,0,0
1000000US060855120521005,060855120521005,"Block 1005, Block Group 1, Census Tract 5120.52, Santa Clara County, California",0,0,0
1000000US060855120521006,060855120521006,"Block 1006, Block Group 1, Census Tract 5120.52, Santa Clara County, California",0,0,0
1000000US060855120521007,060855120521007,"Block 1007, Block Group 1, Census Tract 5120.52, Santa Clara County, California",103,100,3
1000000US060855120522000,060855120522000,"Block 2000, Block Group 2, Census Tract 5120.52, Santa Clara County, California",90,85,5
1000000US060855120522001,060855120522001,"Block 2001, Block Group 2, Census Tract 5120.52, Santa Clara County, California",24,23,1
1000000US060855120522002,060855120522002,"Block 2002, Block Group 2, Census Tract 5120.52, Santa Clara County, California",163,154,9
1000000US060855120522003,060855120522003,"Block 2003, Block Group 2, Census Tract 5120.52, Santa Clara County, California",0,0,0
1000000US060855120522004,060855120522004,"Block 2004, Block Group 2, Census Tract 5120.52, Santa Clara County, California",5,4,1
1000000US060855120522005,060855120522005,"Block 2005, Block Group 2, Census Tract 5120.52, Santa Clara County, California",4,4,0
1000000US060855120522006,060855120522006,"Block 2006, Block Group 2, Census Tract 5120.52, Santa Clara County, California",12,12,0
1000000US060855120522007,060855120522007,"Block 2007, Block Group 2, Census Tract 5120.52, Santa Clara County, California",157,150,7
1000000US060855120522008,060855120522008,"Block 2008, Block Group 2, Census Tract 5120.52, Santa Clara County, California",16,15,1
1000000US060855120522009,060855120522009,"Block 2009, Block Group 2, Census Tract 5120.52, Santa Clara County, California",16,16,0
1000000US060855120522010,060855120522010,"Block 2010, Block Group 2, Census Tract 5120.52, Santa Clara County, California",18,18,0
1000000US060855120522011,060855120522011,"Block 2011, Block Group 2, Census Tract 5120.52, Santa Clara County, California",4,3,1
1000000US060855120522012,060855120522012,"Block 2012, Block Group 2, Census Tract 5120.52, Santa Clara County, California",16,16,0
1000000US060855120522013,060855120522013,"Block 2013, Block Group 2, Census Tract 5120.52, Santa Clara County, California",92,88,4
1000000US060855120522014,060855120522014,"Block 2014, Block Group 2, Census Tract 5120.52, Santa Clara County, California",0,0,0
1000000US060855120522015,060855120522015,"Block 2015, Block Group 2, Census Tract 5120.52, Santa Clara County, California",16,16,0
1000000US060855120522016,060855120522016,"Block 2016, Block Group 2, Census Tract 5120.52, Santa Clara County, California",0,0,0
1000000US060855120522017,060855120522017,"Block 2017, Block Group 2, Census Tract 5120.52, Santa Clara County, California",16,16,0
1000000US060855120522018,060855120522018,"Block 2018, Block Group 2, Census Tract 5120.52, Santa Clara County, California",4,4,0
1000000US060855120522019,060855120522019,"Block 2019, Block Group 2, Census Tract 5120.52, Santa Clara County, California",75,71,4
1000000US060855120522020,060855120522020,"Block 2020, Block Group 2, Census Tract 5120.52, Santa Clara County, California",41,41,0
1000000US060855120522021,060855120522021,"Block 2021, Block Group 2, Census Tract 5120.52, Santa Clara County, California",66,63,3
1000000US060855120522022,060855120522022,"Block 2022, Block Group 2, Census Tract 5120.52, Santa Clara County, California",38,33,5
1000000US060855120523000,060855120523000,"Block 3000, Block Group 3, Census Tract 5120.52, Santa Clara County, California",29,27,2
1000000US060855120523001,060855120523001,"Block 3001, Block Group 3, Census Tract 5120.52, Santa Clara County, California",28,25,3
1000000US060855120523002,060855120523002,"Block 3002, Block Group 3, Census Tract 5120.52, Santa Clara County, California",26,24,2
1000000US060855120523003,060855120523003,"Block 3003, Block Group 3, Census Tract 5120.52, Santa Clara County, California",9,9,0
1000000US060855120523004,060855120523004,"Block 3004, Block Group 3, Census Tract 5120.52, Santa Clara County, California",223,217,6
1000000US060855120523005,060855120523005,"Block 3005, Block Group 3, Census Tract 5120.52, Santa Clara County, California",58,57,1
1000000US060855120523006,060855120523006,"Block 3006, Block Group 3, Census Tract 5120.52, Santa Clara County, California",31,31,0
1000000US060855120523007,060855120523007,"Block 3007, Block Group 3, Census Tract 5120.52, Santa Clara County, California",6,5,1
1000000US060855120523008,060855120523008,"Block 3008, Block Group 3, Census Tract 5120.52, Santa Clara County, California",16,16,0
1000000US060855120523009,060855120523009,"Block 3009, Block Group 3, Census Tract 5120.52, Santa Clara County, California",30,30,0
1000000US060855120523010,060855120523010,"Block 3010, Block Group 3, Census Tract 5120.52, Santa Clara County, California",11,10,1
1000000US060855120523011,060855120523011,"Block 3011, Block Group 3, Census Tract 5120.52, Santa Clara County, California",7,7,0
1000000US060855120531000,060855120531000,"Block 1000, Block Group 1, Census Tract 5120.53, Santa Clara County, California",39,38,1
1000000US060855120531001,060855120531001,"Block 1001, Block Group 1, Census Tract 5120.53, Santa Clara County, California",91,87,4
1000000US060855120531002,060855120531002,"Block 1002, Block Group 1, Census Tract 5120.53, Santa Clara County, California",164,153,11
1000000US060855120531003,060855120531003,"Block 1003, Block Group 1, Census Tract 5120.53, Santa Clara County, California",116,100,16
1000000US060855120531004,060855120531004,"Block 1004, Block Group 1, Census Tract 5120.53, Santa Clara County, California",52,48,4
1000000US060855120531005,060855120531005,"Block 1005, Block Group 1, Census Tract 5120.53, Santa Clara County, California",47,46,1
1000000US060855120531006,060855120531006,"Block 1006, Block Group 1, Census Tract 5120.53, Santa Clara County, California",166,160,6
1000000US060855120531007,060855120531007,"Block 1007, Block Group 1, Census Tract 5120.53, Santa Clara County, California",120,109,11
1000000US060855120531008,060855120531008,"Block 1008, Block Group 1, Census Tract 5120.53, Santa Clara County, California",39,38,1
1000000US060855120532000,060855120532000,"Block 2000, Block Group 2, Census Tract 5120.53, Santa Clara County, California",31,31,0
1000000US060855120532001,060855120532001,"Block 2001, Block Group 2, Census Tract 5120.53, Santa Clara County, California",37,37,0
1000000US060855120532002,060855120532002,"Block 2002, Block Group 2, Census Tract 5120.53, Santa Clara County, California",40,40,0
1000000US060855120532003,060855120532003,"Block 2003, Block Group 2, Census Tract 5120.53, Santa Clara County, California",51,51,0
1000000US060855120532004,060855120532004,"Block 2004, Block Group 2, Census Tract 5120.53, Santa Clara County, California",51,49,2
1000000US060855120532005,060855120532005,"Block 2005, Block Group 2, Census Tract 5120.53, Santa Clara County, California",25,25,0
1000000US060855120532006,060855120532006,"Block 2006, Block Group 2, Census Tract 5120.53, Santa Clara County, California",59,56,3
1000000US060855120532007,060855120532007,"Block 2007, Block Group 2, Census Tract 5120.53, Santa Clara County, California",19,19,0
1000000US060855120532008,060855120532008,"Block 2008, Block Group 2, Census Tract 5120.53, Santa Clara County, California",53,52,1
1000000US060855120532009,060855120532009,"Block 2009, Block Group 2, Census Tract 5120.53, Santa Clara County, California",32,32,0
1000000US060855120532010,060855120532010,"Block 2010, Block Group 2, Census Tract 5120.53, Santa Clara County, California",21,21,0
1000000US060855120532011,060855120532011,"Block 2011, Block Group 2, Census Tract 5120.53, Santa Clara County, California",47,47,0
1000000US060855120533000,060855120533000,"Block 3000, Block Group 3, Census Tract 5120.53, Santa Clara County, California",71,71,0
1000000US060855120533001,060855120533001,"Block 3001, Block Group 3, Census Tract 5120.53, Santa Clara County, California",29,29,0
1000000US060855120533002,060855120533002,"Block 3002, Block Group 3, Census Tract 5120.53, Santa Clara County, California",12,12,0
1000000US060855120533003,060855120533003,"Block 3003, Block Group 3, Census Tract 5120.53, Santa Clara County, California",47,47,0
1000000US060855120533004,060855120533004,"Block 3004, Block Group 3, Census Tract 5120.53, Santa Clara County, California",53,53,0
1000000US060855120533005,060855120533005,"Block 3005, Block Group 3, Census Tract 5120.53, Santa Clara County, California",51,50,1
1000000US060855121001000,060855121001000,"Block 1000, Block Group 1, Census Tract 5121, Santa Clara County, California",1,1,0
1000000US060855121001001,060855121001001,"Block 1001, Block Group 1, Census Tract 5121, Santa Clara County, California",0,0,0
1000000US060855121001002,060855121001002,"Block 1002, Block Group 1, Census Tract 5121, Santa Clara County, California",0,0,0
1000000US060855121001003,060855121001003,"Block 1003, Block Group 1, Census Tract 5121, Santa Clara County, California",0,0,0
1000000US060855121001004,060855121001004,"Block 1004, Block Group 1, Census Tract 5121, Santa Clara County, California",0,0,0
1000000US060855121001005,060855121001005,"Block 1005, Block Group 1, Census Tract 5121, Santa Clara County, California",0,0,0
1000000US060855121001006,060855121001006,"Block 1006, Block Group 1, Census Tract 5121, Santa Clara County, California",0,0,0
1000000US060855121001007,060855121001007,"Block 1007, Block Group 1, Census Tract 5121, Santa Clara County, California",1,1,0
1000000US060855121001008,060855121001008,"Block 1008, Block Group 1, Census Tract 5121, Santa Clara County, California",0,0,0
1000000US060855121001009,060855121001009,"Block 1009, Block Group 1, Census Tract 5121, Santa Clara County, California",0,0,0
1000000US060855121001010,060855121001010,"Block 1010, Block Group 1, Census Tract 5121, Santa Clara County, California",0,0,0
1000000US060855121001011,060855121001011,"Block 1011, Block Group 1, Census Tract 5121, Santa Clara County, California",10,9,1
1000000US060855121001012,060855121001012,"Block 1012, Block Group 1, Census Tract 5121, Santa Clara County, California",0,0,0
1000000US060855121001013,060855121001013,"Block 1013, Block Group 1, Census Tract 5121, Santa Clara County, California",0,0,0
1000000US060855121001014,060855121001014,"Block 1014, Block Group 1, Census Tract 5121, Santa Clara County, California",0,0,0
1000000US060855121001015,060855121001015,"Block 1015, Block Group 1, Census Tract 5121, Santa Clara County, California",0,0,0
1000000US060855121001016,060855121001016,"Block 1016, Block Group 1, Census Tract 5121, Santa Clara County, California",0,0,0
1000000US060855121001017,060855121001017,"Block 1017, Block Group 1, Census Tract 5121, Santa Clara County, California",0,0,0
1000000US060855121001018,060855121001018,"Block 1018, Block Group 1, Census Tract 5121, Santa Clara County, California",3,2,1
1000000US060855121001019,060855121001019,"Block 1019, Block Group 1, Census Tract 5121, Santa Clara County, California",0,0,0
1000000US060855121001020,060855121001020,"Block 1020, Block Group 1, Census Tract 5121, Santa Clara County, California",0,0,0
1000000US060855121001021,060855121001021,"Block 1021, Block Group 1, Census Tract 5121, Santa Clara County, California",0,0,0
1000000US060855121001022,060855121001022,"Block 1022, Block Group 1, Census Tract 5121, Santa Clara County, California",0,0,0
1000000US060855121001023,060855121001023,"Block 1023, Block Group 1, Census Tract 5121, Santa Clara County, California",0,0,0
1000000US060855121001024,060855121001024,"Block 1024, Block Group 1, Census Tract 5121, Santa Clara County, California",0,0,0
1000000US060855121001025,060855121001025,"Block 1025, Block Group 1, Census Tract 5121, Santa Clara County, California",0,0,0
1000000US060855121001026,060855121001026,"Block 1026, Block Group 1, Census Tract 5121, Santa Clara County, California",0,0,0
1000000US060855121001027,060855121001027,"Block 1027, Block Group 1, Census Tract 5121, Santa Clara County, California",6,6,0
1000000US060855121001028,060855121001028,"Block 1028, Block Group 1, Census Tract 5121, Santa Clara County, California",0,0,0
1000000US060855121001029,060855121001029,"Block 1029, Block Group 1, Census Tract 5121, Santa Clara County, California",0,0,0
1000000US060855121001030,060855121001030,"Block 1030, Block Group 1, Census Tract 5121, Santa Clara County, California",0,0,0
1000000US060855121001031,060855121001031,"Block 1031, Block Group 1, Census Tract 5121, Santa Clara County, California",1,1,0
1000000US060855121001032,060855121001032,"Block 1032, Block Group 1, Census Tract 5121, Santa Clara County, California",0,0,0
1000000US060855121001033,060855121001033,"Block 1033, Block Group 1, Census Tract 5121, Santa Clara County, California",0,0,0
1000000US060855121001034,060855121001034,"Block 1034, Block Group 1, Census Tract 5121, Santa Clara County, California",2,2,0
1000000US060855121001035,060855121001035,"Block 1035, Block Group 1, Census Tract 5121, Santa Clara County, California",4,4,0
1000000US060855121001036,060855121001036,"Block 1036, Block Group 1, Census Tract 5121, Santa Clara County, California",0,0,0
1000000US060855121001037,060855121001037,"Block 1037, Block Group 1, Census Tract 5121, Santa Clara County, California",7,6,1
1000000US060855121001038,060855121001038,"Block 1038, Block Group 1, Census Tract 5121, Santa Clara County, California",6,5,1
1000000US060855121001039,060855121001039,"Block 1039, Block Group 1, Census Tract 5121, Santa Clara County, California",2,2,0
1000000US060855121001040,060855121001040,"Block 1040, Block Group 1, Census Tract 5121, Santa Clara County, California",14,12,2
1000000US060855121001041,060855121001041,"Block 1041, Block Group 1, Census Tract 5121, Santa Clara County, California",0,0,0
1000000US060855121001042,060855121001042,"Block 1042, Block Group 1, Census Tract 5121, Santa Clara County, California",1,1,0
1000000US060855121001043,060855121001043,"Block 1043, Block Group 1, Census Tract 5121, Santa Clara County, California",0,0,0
1000000US060855121001044,060855121001044,"Block 1044, Block Group 1, Census Tract 5121, Santa Clara County, California",0,0,0
1000000US060855121001045,060855121001045,"Block 1045, Block Group 1, Census Tract 5121, Santa Clara County, California",0,0,0
1000000US060855121001046,060855121001046,"Block 1046, Block Group 1, Census Tract 5121, Santa Clara County, California",0,0,0
1000000US060855121001047,060855121001047,"Block 1047, Block Group 1, Census Tract 5121, Santa Clara County, California",0,0,0
1000000US060855121001048,060855121001048,"Block 1048, Block Group 1, Census Tract 5121, Santa Clara County, California",2,1,1
1000000US060855121001049,060855121001049,"Block 1049, Block Group 1, Census Tract 5121, Santa Clara County, California",4,4,0
1000000US060855121001050,060855121001050,"Block 1050, Block Group 1, Census Tract 5121, Santa Clara County, California",11,11,0
1000000US060855121001051,060855121001051,"Block 1051, Block Group 1, Census Tract 5121, Santa Clara County, California",1,1,0
1000000US060855121001052,060855121001052,"Block 1052, Block Group 1, Census Tract 5121, Santa Clara County, California",0,0,0
1000000US060855121001053,060855121001053,"Block 1053, Block Group 1, Census Tract 5121, Santa Clara County, California",0,0,0
1000000US060855121001054,060855121001054,"Block 1054, Block Group 1, Census Tract 5121, Santa Clara County, California",0,0,0
1000000US060855121001055,060855121001055,"Block 1055, Block Group 1, Census Tract 5121, Santa Clara County, California",0,0,0
1000000US060855121001056,060855121001056,"Block 1056, Block Group 1, Census Tract 5121, Santa Clara County, California",0,0,0
1000000US060855121001057,060855121001057,"Block 1057, Block Group 1, Census Tract 5121, Santa Clara County, California",0,0,0
1000000US060855121001058,060855121001058,"Block 1058, Block Group 1, Census Tract 5121, Santa Clara County, California",4,4,0
1000000US060855121001059,060855121001059,"Block 1059, Block Group 1, Census Tract 5121, Santa Clara County, California",0,0,0
1000000US060855121001060,060855121001060,"Block 1060, Block Group 1, Census Tract 5121, Santa Clara County, California",0,0,0
1000000US060855121001061,060855121001061,"Block 1061, Block Group 1, Census Tract 5121, Santa Clara County, California",1,1,0
1000000US060855121001062,060855121001062,"Block 1062, Block Group 1, Census Tract 5121, Santa Clara County, California",0,0,0
1000000US060855121001063,060855121001063,"Block 1063, Block Group 1, Census Tract 5121, Santa Clara County, California",0,0,0
1000000US060855121001064,060855121001064,"Block 1064, Block Group 1, Census Tract 5121, Santa Clara County, California",1,1,0
1000000US060855121001065,060855121001065,"Block 1065, Block Group 1, Census Tract 5121, Santa Clara County, California",11,11,0
1000000US060855121001066,060855121001066,"Block 1066, Block Group 1, Census Tract 5121, Santa Clara County, California",0,0,0
1000000US060855121001067,060855121001067,"Block 1067, Block Group 1, Census Tract 5121, Santa Clara County, California",0,0,0
1000000US060855121001068,060855121001068,"Block 1068, Block Group 1, Census Tract 5121, Santa Clara County, California",33,33,0
1000000US060855121001069,060855121001069,"Block 1069, Block Group 1, Census Tract 5121, Santa Clara County, California",2,2,0
1000000US060855121001070,060855121001070,"Block 1070, Block Group 1, Census Tract 5121, Santa Clara County, California",4,4,0
1000000US060855121001071,060855121001071,"Block 1071, Block Group 1, Census Tract 5121, Santa Clara County, California",7,7,0
1000000US060855121001072,060855121001072,"Block 1072, Block Group 1, Census Tract 5121, Santa Clara County, California",17,17,0
1000000US060855121001073,060855121001073,"Block 1073, Block Group 1, Census Tract 5121, Santa Clara County, California",5,5,0
1000000US060855121001074,060855121001074,"Block 1074, Block Group 1, Census Tract 5121, Santa Clara County, California",0,0,0
1000000US060855121001075,060855121001075,"Block 1075, Block Group 1, Census Tract 5121, Santa Clara County, California",0,0,0
1000000US060855121001076,060855121001076,"Block 1076, Block Group 1, Census Tract 5121, Santa Clara County, California",1,1,0
1000000US060855121001077,060855121001077,"Block 1077, Block Group 1, Census Tract 5121, Santa Clara County, California",61,58,3
1000000US060855121001078,060855121001078,"Block 1078, Block Group 1, Census Tract 5121, Santa Clara County, California",19,19,0
1000000US060855121001079,060855121001079,"Block 1079, Block Group 1, Census Tract 5121, Santa Clara County, California",2,2,0
1000000US060855121001080,060855121001080,"Block 1080, Block Group 1, Census Tract 5121, Santa Clara County, California",18,17,1
1000000US060855121001081,060855121001081,"Block 1081, Block Group 1, Census Tract 5121, Santa Clara County, California",17,17,0
1000000US060855121001082,060855121001082,"Block 1082, Block Group 1, Census Tract 5121, Santa Clara County, California",5,5,0
1000000US060855121001083,060855121001083,"Block 1083, Block Group 1, Census Tract 5121, Santa Clara County, California",3,2,1
1000000US060855121001084,060855121001084,"Block 1084, Block Group 1, Census Tract 5121, Santa Clara County, California",0,0,0
1000000US060855121001085,060855121001085,"Block 1085, Block Group 1, Census Tract 5121, Santa Clara County, California",0,0,0
1000000US060855121001086,060855121001086,"Block 1086, Block Group 1, Census Tract 5121, Santa Clara County, California",58,58,0
1000000US060855121001087,060855121001087,"Block 1087, Block Group 1, Census Tract 5121, Santa Clara County, California",1,1,0
1000000US060855121001088,060855121001088,"Block 1088, Block Group 1, Census Tract 5121, Santa Clara County, California",0,0,0
1000000US060855121001089,060855121001089,"Block 1089, Block Group 1, Census Tract 5121, Santa Clara County, California",0,0,0
1000000US060855121001090,060855121001090,"Block 1090, Block Group 1, Census Tract 5121, Santa Clara County, California",0,0,0
1000000US060855121001091,060855121001091,"Block 1091, Block Group 1, Census Tract 5121, Santa Clara County, California",0,0,0
1000000US060855121001092,060855121001092,"Block 1092, Block Group 1, Census Tract 5121, Santa Clara County, California",7,7,0
1000000US060855121001093,060855121001093,"Block 1093, Block Group 1, Census Tract 5121, Santa Clara County, California",28,27,1
1000000US060855121001094,060855121001094,"Block 1094, Block Group 1, Census Tract 5121, Santa Clara County, California",0,0,0
1000000US060855121001095,060855121001095,"Block 1095, Block Group 1, Census Tract 5121, Santa Clara County, California",0,0,0
1000000US060855121001096,060855121001096,"Block 1096, Block Group 1, Census Tract 5121, Santa Clara County, California",0,0,0
1000000US060855121001097,060855121001097,"Block 1097, Block Group 1, Census Tract 5121, Santa Clara County, California",0,0,0
1000000US060855121001098,060855121001098,"Block 1098, Block Group 1, Census Tract 5121, Santa Clara County, California",9,9,0
1000000US060855121001099,060855121001099,"Block 1099, Block Group 1, Census Tract 5121, Santa Clara County, California",0,0,0
1000000US060855121001100,060855121001100,"Block 1100, Block Group 1, Census Tract 5121, Santa Clara County, California",0,0,0
1000000US060855121001101,060855121001101,"Block 1101, Block Group 1, Census Tract 5121, Santa Clara County, California",0,0,0
1000000US060855121001102,060855121001102,"Block 1102, Block Group 1, Census Tract 5121, Santa Clara County, California",24,23,1
1000000US060855121001103,060855121001103,"Block 1103, Block Group 1, Census Tract 5121, Santa Clara County, California",0,0,0
1000000US060855121001104,060855121001104,"Block 1104, Block Group 1, Census Tract 5121, Santa Clara County, California",1,1,0
1000000US060855121001105,060855121001105,"Block 1105, Block Group 1, Census Tract 5121, Santa Clara County, California",1,1,0
1000000US060855121001106,060855121001106,"Block 1106, Block Group 1, Census Tract 5121, Santa Clara County, California",10,7,3
1000000US060855121001107,060855121001107,"Block 1107, Block Group 1, Census Tract 5121, Santa Clara County, California",10,10,0
1000000US060855121001108,060855121001108,"Block 1108, Block Group 1, Census Tract 5121, Santa Clara County, California",5,4,1
1000000US060855121001109,060855121001109,"Block 1109, Block Group 1, Census Tract 5121, Santa Clara County, California",3,3,0
1000000US060855121001110,060855121001110,"Block 1110, Block Group 1, Census Tract 5121, Santa Clara County, California",23,20,3
1000000US060855121001111,060855121001111,"Block 1111, Block Group 1, Census Tract 5121, Santa Clara County, California",29,29,0
1000000US060855121001112,060855121001112,"Block 1112, Block Group 1, Census Tract 5121, Santa Clara County, California",8,8,0
1000000US060855121001113,060855121001113,"Block 1113, Block Group 1, Census Tract 5121, Santa Clara County, California",4,3,1
1000000US060855121001114,060855121001114,"Block 1114, Block Group 1, Census Tract 5121, Santa Clara County, California",0,0,0
1000000US060855121001115,060855121001115,"Block 1115, Block Group 1, Census Tract 5121, Santa Clara County, California",1,1,0
1000000US060855121001116,060855121001116,"Block 1116, Block Group 1, Census Tract 5121, Santa Clara County, California",0,0,0
1000000US060855121001117,060855121001117,"Block 1117, Block Group 1, Census Tract 5121, Santa Clara County, California",0,0,0
1000000US060855121001118,060855121001118,"Block 1118, Block Group 1, Census Tract 5121, Santa Clara County, California",17,15,2
1000000US060855121001119,060855121001119,"Block 1119, Block Group 1, Census Tract 5121, Santa Clara County, California",4,4,0
1000000US060855121001120,060855121001120,"Block 1120, Block Group 1, Census Tract 5121, Santa Clara County, California",2,2,0
1000000US060855121001121,060855121001121,"Block 1121, Block Group 1, Census Tract 5121, Santa Clara County, California",8,8,0
1000000US060855121001122,060855121001122,"Block 1122, Block Group 1, Census Tract 5121, Santa Clara County, California",0,0,0
1000000US060855121001123,060855121001123,"Block 1123, Block Group 1, Census Tract 5121, Santa Clara County, California",0,0,0
1000000US060855121001124,060855121001124,"Block 1124, Block Group 1, Census Tract 5121, Santa Clara County, California",0,0,0
1000000US060855121001125,060855121001125,"Block 1125, Block Group 1, Census Tract 5121, Santa Clara County, California",0,0,0
1000000US060855122001000,060855122001000,"Block 1000, Block Group 1, Census Tract 5122, Santa Clara County, California",0,0,0
1000000US060855122001001,060855122001001,"Block 1001, Block Group 1, Census Tract 5122, Santa Clara County, California",0,0,0
1000000US060855122001002,060855122001002,"Block 1002, Block Group 1, Census Tract 5122, Santa Clara County, California",1,1,0
1000000US060855122001003,060855122001003,"Block 1003, Block Group 1, Census Tract 5122, Santa Clara County, California",0,0,0
1000000US060855122001004,060855122001004,"Block 1004, Block Group 1, Census Tract 5122, Santa Clara County, California",1,1,0
1000000US060855122001005,060855122001005,"Block 1005, Block Group 1, Census Tract 5122, Santa Clara County, California",0,0,0
1000000US060855122001006,060855122001006,"Block 1006, Block Group 1, Census Tract 5122, Santa Clara County, California",0,0,0
1000000US060855122001007,060855122001007,"Block 1007, Block Group 1, Census Tract 5122, Santa Clara County, California",0,0,0
1000000US060855122001008,060855122001008,"Block 1008, Block Group 1, Census Tract 5122, Santa Clara County, California",0,0,0
1000000US060855122001009,060855122001009,"Block 1009, Block Group 1, Census Tract 5122, Santa Clara County, California",0,0,0
1000000US060855122001010,060855122001010,"Block 1010, Block Group 1, Census Tract 5122, Santa Clara County, California",0,0,0
1000000US060855122001011,060855122001011,"Block 1011, Block Group 1, Census Tract 5122, Santa Clara County, California",0,0,0
1000000US060855122001012,060855122001012,"Block 1012, Block Group 1, Census Tract 5122, Santa Clara County, California",6,5,1
1000000US060855122001013,060855122001013,"Block 1013, Block Group 1, Census Tract 5122, Santa Clara County, California",0,0,0
1000000US060855122001014,060855122001014,"Block 1014, Block Group 1, Census Tract 5122, Santa Clara County, California",0,0,0
1000000US060855122001015,060855122001015,"Block 1015, Block Group 1, Census Tract 5122, Santa Clara County, California",0,0,0
1000000US060855122001016,060855122001016,"Block 1016, Block Group 1, Census Tract 5122, Santa Clara County, California",0,0,0
1000000US060855122001017,060855122001017,"Block 1017, Block Group 1, Census Tract 5122, Santa Clara County, California",0,0,0
1000000US060855122001018,060855122001018,"Block 1018, Block Group 1, Census Tract 5122, Santa Clara County, California",1,1,0
1000000US060855122001019,060855122001019,"Block 1019, Block Group 1, Census Tract 5122, Santa Clara County, California",25,23,2
1000000US060855122001020,060855122001020,"Block 1020, Block Group 1, Census Tract 5122, Santa Clara County, California",12,11,1
1000000US060855122001021,060855122001021,"Block 1021, Block Group 1, Census Tract 5122, Santa Clara County, California",0,0,0
1000000US060855122001022,060855122001022,"Block 1022, Block Group 1, Census Tract 5122, Santa Clara County, California",0,0,0
1000000US060855122001023,060855122001023,"Block 1023, Block Group 1, Census Tract 5122, Santa Clara County, California",6,6,0
1000000US060855122001024,060855122001024,"Block 1024, Block Group 1, Census Tract 5122, Santa Clara County, California",0,0,0
1000000US060855122001025,060855122001025,"Block 1025, Block Group 1, Census Tract 5122, Santa Clara County, California",3,3,0
1000000US060855122001026,060855122001026,"Block 1026, Block Group 1, Census Tract 5122, Santa Clara County, California",1,1,0
1000000US060855122001027,060855122001027,"Block 1027, Block Group 1, Census Tract 5122, Santa Clara County, California",0,0,0
1000000US060855122001028,060855122001028,"Block 1028, Block Group 1, Census Tract 5122, Santa Clara County, California",0,0,0
1000000US060855122001029,060855122001029,"Block 1029, Block Group 1, Census Tract 5122, Santa Clara County, California",1,1,0
1000000US060855122001030,060855122001030,"Block 1030, Block Group 1, Census Tract 5122, Santa Clara County, California",0,0,0
1000000US060855122001031,060855122001031,"Block 1031, Block Group 1, Census Tract 5122, Santa Clara County, California",0,0,0
1000000US060855122001032,060855122001032,"Block 1032, Block Group 1, Census Tract 5122, Santa Clara County, California",0,0,0
1000000US060855122001033,060855122001033,"Block 1033, Block Group 1, Census Tract 5122, Santa Clara County, California",16,16,0
1000000US060855122001034,060855122001034,"Block 1034, Block Group 1, Census Tract 5122, Santa Clara County, California",1,1,0
1000000US060855122001035,060855122001035,"Block 1035, Block Group 1, Census Tract 5122, Santa Clara County, California",66,51,15
1000000US060855122001036,060855122001036,"Block 1036, Block Group 1, Census Tract 5122, Santa Clara County, California",0,0,0
1000000US060855122001037,060855122001037,"Block 1037, Block Group 1, Census Tract 5122, Santa Clara County, California",0,0,0
1000000US060855122001038,060855122001038,"Block 1038, Block Group 1, Census Tract 5122, Santa Clara County, California",0,0,0
1000000US060855122001039,060855122001039,"Block 1039, Block Group 1, Census Tract 5122, Santa Clara County, California",0,0,0
1000000US060855122001040,060855122001040,"Block 1040, Block Group 1, Census Tract 5122, Santa Clara County, California",0,0,0
1000000US060855122001041,060855122001041,"Block 1041, Block Group 1, Census Tract 5122, Santa Clara County, California",0,0,0
1000000US060855122001042,060855122001042,"Block 1042, Block Group 1, Census Tract 5122, Santa Clara County, California",0,0,0
1000000US060855122001043,060855122001043,"Block 1043, Block Group 1, Census Tract 5122, Santa Clara County, California",2,2,0
1000000US060855122001044,060855122001044,"Block 1044, Block Group 1, Census Tract 5122, Santa Clara County, California",0,0,0
1000000US060855122001045,060855122001045,"Block 1045, Block Group 1, Census Tract 5122, Santa Clara County, California",0,0,0
1000000US060855122001046,060855122001046,"Block 1046, Block Group 1, Census Tract 5122, Santa Clara County, California",0,0,0
1000000US060855122001047,060855122001047,"Block 1047, Block Group 1, Census Tract 5122, Santa Clara County, California",0,0,0
1000000US060855122001048,060855122001048,"Block 1048, Block Group 1, Census Tract 5122, Santa Clara County, California",1,1,0
1000000US060855122001049,060855122001049,"Block 1049, Block Group 1, Census Tract 5122, Santa Clara County, California",0,0,0
1000000US060855122001050,060855122001050,"Block 1050, Block Group 1, Census Tract 5122, Santa Clara County, California",0,0,0
1000000US060855122001051,060855122001051,"Block 1051, Block Group 1, Census Tract 5122, Santa Clara County, California",0,0,0
1000000US060855122001052,060855122001052,"Block 1052, Block Group 1, Census Tract 5122, Santa Clara County, California",2,0,2
1000000US060855122001053,060855122001053,"Block 1053, Block Group 1, Census Tract 5122, Santa Clara County, California",0,0,0
1000000US060855122001054,060855122001054,"Block 1054, Block Group 1, Census Tract 5122, Santa Clara County, California",0,0,0
1000000US060855122001055,060855122001055,"Block 1055, Block Group 1, Census Tract 5122, Santa Clara County, California",0,0,0
1000000US060855122001056,060855122001056,"Block 1056, Block Group 1, Census Tract 5122, Santa Clara County, California",0,0,0
1000000US060855122001057,060855122001057,"Block 1057, Block Group 1, Census Tract 5122, Santa Clara County, California",0,0,0
1000000US060855122001058,060855122001058,"Block 1058, Block Group 1, Census Tract 5122, Santa Clara County, California",1,1,0
1000000US060855122001059,060855122001059,"Block 1059, Block Group 1, Census Tract 5122, Santa Clara County, California",0,0,0
1000000US060855122001060,060855122001060,"Block 1060, Block Group 1, Census Tract 5122, Santa Clara County, California",0,0,0
1000000US060855122001061,060855122001061,"Block 1061, Block Group 1, Census Tract 5122, Santa Clara County, California",0,0,0
1000000US060855122001062,060855122001062,"Block 1062, Block Group 1, Census Tract 5122, Santa Clara County, California",333,314,19
1000000US060855122001063,060855122001063,"Block 1063, Block Group 1, Census Tract 5122, Santa Clara County, California",3,3,0
1000000US060855122001064,060855122001064,"Block 1064, Block Group 1, Census Tract 5122, Santa Clara County, California",8,8,0
1000000US060855122001065,060855122001065,"Block 1065, Block Group 1, Census Tract 5122, Santa Clara County, California",0,0,0
1000000US060855122001066,060855122001066,"Block 1066, Block Group 1, Census Tract 5122, Santa Clara County, California",5,5,0
1000000US060855122001067,060855122001067,"Block 1067, Block Group 1, Census Tract 5122, Santa Clara County, California",2,2,0
1000000US060855122001068,060855122001068,"Block 1068, Block Group 1, Census Tract 5122, Santa Clara County, California",0,0,0
1000000US060855122001069,060855122001069,"Block 1069, Block Group 1, Census Tract 5122, Santa Clara County, California",2,2,0
1000000US060855122001070,060855122001070,"Block 1070, Block Group 1, Census Tract 5122, Santa Clara County, California",1,1,0
1000000US060855122001071,060855122001071,"Block 1071, Block Group 1, Census Tract 5122, Santa Clara County, California",3,3,0
1000000US060855122001072,060855122001072,"Block 1072, Block Group 1, Census Tract 5122, Santa Clara County, California",0,0,0
1000000US060855122001073,060855122001073,"Block 1073, Block Group 1, Census Tract 5122, Santa Clara County, California",0,0,0
1000000US060855122001074,060855122001074,"Block 1074, Block Group 1, Census Tract 5122, Santa Clara County, California",6,4,2
1000000US060855122001075,060855122001075,"Block 1075, Block Group 1, Census Tract 5122, Santa Clara County, California",0,0,0
1000000US060855122001076,060855122001076,"Block 1076, Block Group 1, Census Tract 5122, Santa Clara County, California",0,0,0
1000000US060855122001077,060855122001077,"Block 1077, Block Group 1, Census Tract 5122, Santa Clara County, California",0,0,0
1000000US060855122001078,060855122001078,"Block 1078, Block Group 1, Census Tract 5122, Santa Clara County, California",0,0,0
1000000US060855122001079,060855122001079,"Block 1079, Block Group 1, Census Tract 5122, Santa Clara County, California",0,0,0
1000000US060855122001080,060855122001080,"Block 1080, Block Group 1, Census Tract 5122, Santa Clara County, California",0,0,0
1000000US060855122001081,060855122001081,"Block 1081, Block Group 1, Census Tract 5122, Santa Clara County, California",0,0,0
1000000US060855122001082,060855122001082,"Block 1082, Block Group 1, Census Tract 5122, Santa Clara County, California",0,0,0
1000000US060855122001083,060855122001083,"Block 1083, Block Group 1, Census Tract 5122, Santa Clara County, California",44,43,1
1000000US060855122001084,060855122001084,"Block 1084, Block Group 1, Census Tract 5122, Santa Clara County, California",0,0,0
1000000US060855122001085,060855122001085,"Block 1085, Block Group 1, Census Tract 5122, Santa Clara County, California",0,0,0
1000000US060855122001086,060855122001086,"Block 1086, Block Group 1, Census Tract 5122, Santa Clara County, California",18,14,4
1000000US060855122001087,060855122001087,"Block 1087, Block Group 1, Census Tract 5122, Santa Clara County, California",2,2,0
1000000US060855122001088,060855122001088,"Block 1088, Block Group 1, Census Tract 5122, Santa Clara County, California",1,1,0
1000000US060855122001089,060855122001089,"Block 1089, Block Group 1, Census Tract 5122, Santa Clara County, California",10,7,3
1000000US060855122001090,060855122001090,"Block 1090, Block Group 1, Census Tract 5122, Santa Clara County, California",0,0,0
1000000US060855122001091,060855122001091,"Block 1091, Block Group 1, Census Tract 5122, Santa Clara County, California",0,0,0
1000000US060855122001092,060855122001092,"Block 1092, Block Group 1, Census Tract 5122, Santa Clara County, California",0,0,0
1000000US060855122001093,060855122001093,"Block 1093, Block Group 1, Census Tract 5122, Santa Clara County, California",0,0,0
1000000US060855122001094,060855122001094,"Block 1094, Block Group 1, Census Tract 5122, Santa Clara County, California",1,1,0
1000000US060855122001095,060855122001095,"Block 1095, Block Group 1, Census Tract 5122, Santa Clara County, California",0,0,0
1000000US060855122001096,060855122001096,"Block 1096, Block Group 1, Census Tract 5122, Santa Clara County, California",0,0,0
1000000US060855122001097,060855122001097,"Block 1097, Block Group 1, Census Tract 5122, Santa Clara County, California",0,0,0
1000000US060855122001098,060855122001098,"Block 1098, Block Group 1, Census Tract 5122, Santa Clara County, California",0,0,0
1000000US060855122001099,060855122001099,"Block 1099, Block Group 1, Census Tract 5122, Santa Clara County, California",1,1,0
1000000US060855122001100,060855122001100,"Block 1100, Block Group 1, Census Tract 5122, Santa Clara County, California",0,0,0
1000000US060855122001101,060855122001101,"Block 1101, Block Group 1, Census Tract 5122, Santa Clara County, California",5,5,0
1000000US060855122001102,060855122001102,"Block 1102, Block Group 1, Census Tract 5122, Santa Clara County, California",0,0,0
1000000US060855122001103,060855122001103,"Block 1103, Block Group 1, Census Tract 5122, Santa Clara County, California",19,14,5
1000000US060855122001104,060855122001104,"Block 1104, Block Group 1, Census Tract 5122, Santa Clara County, California",0,0,0
1000000US060855122001105,060855122001105,"Block 1105, Block Group 1, Census Tract 5122, Santa Clara County, California",0,0,0
1000000US060855122001106,060855122001106,"Block 1106, Block Group 1, Census Tract 5122, Santa Clara County, California",0,0,0
1000000US060855122001107,060855122001107,"Block 1107, Block Group 1, Census Tract 5122, Santa Clara County, California",0,0,0
1000000US060855122001108,060855122001108,"Block 1108, Block Group 1, Census Tract 5122, Santa Clara County, California",0,0,0
1000000US060855122001109,060855122001109,"Block 1109, Block Group 1, Census Tract 5122, Santa Clara County, California",0,0,0
1000000US060855122001110,060855122001110,"Block 1110, Block Group 1, Census Tract 5122, Santa Clara County, California",0,0,0
1000000US060855122001111,060855122001111,"Block 1111, Block Group 1, Census Tract 5122, Santa Clara County, California",0,0,0
1000000US060855122002000,060855122002000,"Block 2000, Block Group 2, Census Tract 5122, Santa Clara County, California",31,26,5
1000000US060855122002001,060855122002001,"Block 2001, Block Group 2, Census Tract 5122, Santa Clara County, California",49,46,3
1000000US060855122002002,060855122002002,"Block 2002, Block Group 2, Census Tract 5122, Santa Clara County, California",4,4,0
1000000US060855122002003,060855122002003,"Block 2003, Block Group 2, Census Tract 5122, Santa Clara County, California",7,6,1
1000000US060855122002004,060855122002004,"Block 2004, Block Group 2, Census Tract 5122, Santa Clara County, California",0,0,0
1000000US060855122002005,060855122002005,"Block 2005, Block Group 2, Census Tract 5122, Santa Clara County, California",0,0,0
1000000US060855122002006,060855122002006,"Block 2006, Block Group 2, Census Tract 5122, Santa Clara County, California",32,23,9
1000000US060855122002007,060855122002007,"Block 2007, Block Group 2, Census Tract 5122, Santa Clara County, California",1,1,0
1000000US060855122002008,060855122002008,"Block 2008, Block Group 2, Census Tract 5122, Santa Clara County, California",1,0,1
1000000US060855122002009,060855122002009,"Block 2009, Block Group 2, Census Tract 5122, Santa Clara County, California",0,0,0
1000000US060855122002010,060855122002010,"Block 2010, Block Group 2, Census Tract 5122, Santa Clara County, California",2,2,0
1000000US060855122002011,060855122002011,"Block 2011, Block Group 2, Census Tract 5122, Santa Clara County, California",2,1,1
1000000US060855122002012,060855122002012,"Block 2012, Block Group 2, Census Tract 5122, Santa Clara County, California",27,21,6
1000000US060855122002013,060855122002013,"Block 2013, Block Group 2, Census Tract 5122, Santa Clara County, California",0,0,0
1000000US060855122002014,060855122002014,"Block 2014, Block Group 2, Census Tract 5122, Santa Clara County, California",0,0,0
1000000US060855122002015,060855122002015,"Block 2015, Block Group 2, Census Tract 5122, Santa Clara County, California",32,29,3
1000000US060855122002016,060855122002016,"Block 2016, Block Group 2, Census Tract 5122, Santa Clara County, California",3,3,0
1000000US060855122002017,060855122002017,"Block 2017, Block Group 2, Census Tract 5122, Santa Clara County, California",0,0,0
1000000US060855122002018,060855122002018,"Block 2018, Block Group 2, Census Tract 5122, Santa Clara County, California",2,2,0
1000000US060855122002019,060855122002019,"Block 2019, Block Group 2, Census Tract 5122, Santa Clara County, California",0,0,0
1000000US060855122002020,060855122002020,"Block 2020, Block Group 2, Census Tract 5122, Santa Clara County, California",0,0,0
1000000US060855122002021,060855122002021,"Block 2021, Block Group 2, Census Tract 5122, Santa Clara County, California",2,2,0
1000000US060855122002022,060855122002022,"Block 2022, Block Group 2, Census Tract 5122, Santa Clara County, California",8,7,1
1000000US060855122002023,060855122002023,"Block 2023, Block Group 2, Census Tract 5122, Santa Clara County, California",1,1,0
1000000US060855122002024,060855122002024,"Block 2024, Block Group 2, Census Tract 5122, Santa Clara County, California",0,0,0
1000000US060855122002025,060855122002025,"Block 2025, Block Group 2, Census Tract 5122, Santa Clara County, California",6,6,0
1000000US060855122002026,060855122002026,"Block 2026, Block Group 2, Census Tract 5122, Santa Clara County, California",10,9,1
1000000US060855122002027,060855122002027,"Block 2027, Block Group 2, Census Tract 5122, Santa Clara County, California",1,1,0
1000000US060855122002028,060855122002028,"Block 2028, Block Group 2, Census Tract 5122, Santa Clara County, California",0,0,0
1000000US060855122002029,060855122002029,"Block 2029, Block Group 2, Census Tract 5122, Santa Clara County, California",0,0,0
1000000US060855122002030,060855122002030,"Block 2030, Block Group 2, Census Tract 5122, Santa Clara County, California",4,3,1
1000000US060855122002031,060855122002031,"Block 2031, Block Group 2, Census Tract 5122, Santa Clara County, California",0,0,0
1000000US060855122002032,060855122002032,"Block 2032, Block Group 2, Census Tract 5122, Santa Clara County, California",9,9,0
1000000US060855122002033,060855122002033,"Block 2033, Block Group 2, Census Tract 5122, Santa Clara County, California",10,8,2
1000000US060855122002034,060855122002034,"Block 2034, Block Group 2, Census Tract 5122, Santa Clara County, California",8,8,0
1000000US060855122002035,060855122002035,"Block 2035, Block Group 2, Census Tract 5122, Santa Clara County, California",5,4,1
1000000US060855122002036,060855122002036,"Block 2036, Block Group 2, Census Tract 5122, Santa Clara County, California",0,0,0
1000000US060855122002037,060855122002037,"Block 2037, Block Group 2, Census Tract 5122, Santa Clara County, California",2,2,0
1000000US060855122002038,060855122002038,"Block 2038, Block Group 2, Census Tract 5122, Santa Clara County, California",1,1,0
1000000US060855122002039,060855122002039,"Block 2039, Block Group 2, Census Tract 5122, Santa Clara County, California",1,1,0
1000000US060855122002040,060855122002040,"Block 2040, Block Group 2, Census Tract 5122, Santa Clara County, California",1,1,0
1000000US060855122002041,060855122002041,"Block 2041, Block Group 2, Census Tract 5122, Santa Clara County, California",1,1,0
1000000US060855122002042,060855122002042,"Block 2042, Block Group 2, Census Tract 5122, Santa Clara County, California",5,5,0
1000000US060855122002043,060855122002043,"Block 2043, Block Group 2, Census Tract 5122, Santa Clara County, California",0,0,0
1000000US060855122002044,060855122002044,"Block 2044, Block Group 2, Census Tract 5122, Santa Clara County, California",3,3,0
1000000US060855122002045,060855122002045,"Block 2045, Block Group 2, Census Tract 5122, Santa Clara County, California",39,36,3
1000000US060855122002046,060855122002046,"Block 2046, Block Group 2, Census Tract 5122, Santa Clara County, California",1,1,0
1000000US060855122002047,060855122002047,"Block 2047, Block Group 2, Census Tract 5122, Santa Clara County, California",6,6,0
1000000US060855122002048,060855122002048,"Block 2048, Block Group 2, Census Tract 5122, Santa Clara County, California",32,31,1
1000000US060855122002049,060855122002049,"Block 2049, Block Group 2, Census Tract 5122, Santa Clara County, California",2,2,0
1000000US060855122002050,060855122002050,"Block 2050, Block Group 2, Census Tract 5122, Santa Clara County, California",0,0,0
1000000US060855122002051,060855122002051,"Block 2051, Block Group 2, Census Tract 5122, Santa Clara County, California",0,0,0
1000000US060855122002052,060855122002052,"Block 2052, Block Group 2, Census Tract 5122, Santa Clara County, California",0,0,0
1000000US060855122002053,060855122002053,"Block 2053, Block Group 2, Census Tract 5122, Santa Clara County, California",0,0,0
1000000US060855122002054,060855122002054,"Block 2054, Block Group 2, Census Tract 5122, Santa Clara County, California",0,0,0
1000000US060855122002055,060855122002055,"Block 2055, Block Group 2, Census Tract 5122, Santa Clara County, California",1,1,0
1000000US060855122002056,060855122002056,"Block 2056, Block Group 2, Census Tract 5122, Santa Clara County, California",0,0,0
1000000US060855122002057,060855122002057,"Block 2057, Block Group 2, Census Tract 5122, Santa Clara County, California",55,54,1
1000000US060855122002058,060855122002058,"Block 2058, Block Group 2, Census Tract 5122, Santa Clara County, California",32,32,0
1000000US060855122002059,060855122002059,"Block 2059, Block Group 2, Census Tract 5122, Santa Clara County, California",5,5,0
1000000US060855122002060,060855122002060,"Block 2060, Block Group 2, Census Tract 5122, Santa Clara County, California",13,12,1
1000000US060855122002061,060855122002061,"Block 2061, Block Group 2, Census Tract 5122, Santa Clara County, California",0,0,0
1000000US060855122002062,060855122002062,"Block 2062, Block Group 2, Census Tract 5122, Santa Clara County, California",0,0,0
1000000US060855122002063,060855122002063,"Block 2063, Block Group 2, Census Tract 5122, Santa Clara County, California",0,0,0
1000000US060855122002064,060855122002064,"Block 2064, Block Group 2, Census Tract 5122, Santa Clara County, California",0,0,0
1000000US060855122002065,060855122002065,"Block 2065, Block Group 2, Census Tract 5122, Santa Clara County, California",0,0,0
1000000US060855122002066,060855122002066,"Block 2066, Block Group 2, Census Tract 5122, Santa Clara County, California",0,0,0
1000000US060855122002067,060855122002067,"Block 2067, Block Group 2, Census Tract 5122, Santa Clara County, California",0,0,0
1000000US060855122002068,060855122002068,"Block 2068, Block Group 2, Census Tract 5122, Santa Clara County, California",0,0,0
1000000US060855122002069,060855122002069,"Block 2069, Block Group 2, Census Tract 5122, Santa Clara County, California",8,8,0
1000000US060855122002070,060855122002070,"Block 2070, Block Group 2, Census Tract 5122, Santa Clara County, California",0,0,0
1000000US060855122002071,060855122002071,"Block 2071, Block Group 2, Census Tract 5122, Santa Clara County, California",1,1,0
1000000US060855122002072,060855122002072,"Block 2072, Block Group 2, Census Tract 5122, Santa Clara County, California",6,5,1
1000000US060855122002073,060855122002073,"Block 2073, Block Group 2, Census Tract 5122, Santa Clara County, California",0,0,0
1000000US060855122002074,060855122002074,"Block 2074, Block Group 2, Census Tract 5122, Santa Clara County, California",0,0,0
1000000US060855122002075,060855122002075,"Block 2075, Block Group 2, Census Tract 5122, Santa Clara County, California",0,0,0
1000000US060855122002076,060855122002076,"Block 2076, Block Group 2, Census Tract 5122, Santa Clara County, California",7,6,1
1000000US060855122002077,060855122002077,"Block 2077, Block Group 2, Census Tract 5122, Santa Clara County, California",10,9,1
1000000US060855122002078,060855122002078,"Block 2078, Block Group 2, Census Tract 5122, Santa Clara County, California",26,23,3
1000000US060855122002079,060855122002079,"Block 2079, Block Group 2, Census Tract 5122, Santa Clara County, California",5,5,0
1000000US060855122002080,060855122002080,"Block 2080, Block Group 2, Census Tract 5122, Santa Clara County, California",5,5,0
1000000US060855122002081,060855122002081,"Block 2081, Block Group 2, Census Tract 5122, Santa Clara County, California",2,2,0
1000000US060855122002082,060855122002082,"Block 2082, Block Group 2, Census Tract 5122, Santa Clara County, California",0,0,0
1000000US060855122002083,060855122002083,"Block 2083, Block Group 2, Census Tract 5122, Santa Clara County, California",3,3,0
1000000US060855122002084,060855122002084,"Block 2084, Block Group 2, Census Tract 5122, Santa Clara County, California",10,9,1
1000000US060855122002085,060855122002085,"Block 2085, Block Group 2, Census Tract 5122, Santa Clara County, California",3,3,0
1000000US060855122002086,060855122002086,"Block 2086, Block Group 2, Census Tract 5122, Santa Clara County, California",1,1,0
1000000US060855122002087,060855122002087,"Block 2087, Block Group 2, Census Tract 5122, Santa Clara County, California",0,0,0
1000000US060855122002088,060855122002088,"Block 2088, Block Group 2, Census Tract 5122, Santa Clara County, California",30,29,1
1000000US060855122002089,060855122002089,"Block 2089, Block Group 2, Census Tract 5122, Santa Clara County, California",0,0,0
1000000US060855122002090,060855122002090,"Block 2090, Block Group 2, Census Tract 5122, Santa Clara County, California",4,0,4
1000000US060855122002091,060855122002091,"Block 2091, Block Group 2, Census Tract 5122, Santa Clara County, California",0,0,0
1000000US060855122002092,060855122002092,"Block 2092, Block Group 2, Census Tract 5122, Santa Clara County, California",11,11,0
1000000US060855122002093,060855122002093,"Block 2093, Block Group 2, Census Tract 5122, Santa Clara County, California",0,0,0
1000000US060855122002094,060855122002094,"Block 2094, Block Group 2, Census Tract 5122, Santa Clara County, California",19,19,0
1000000US060855122002095,060855122002095,"Block 2095, Block Group 2, Census Tract 5122, Santa Clara County, California",55,51,4
1000000US060855122002096,060855122002096,"Block 2096, Block Group 2, Census Tract 5122, Santa Clara County, California",0,0,0
1000000US060855122002097,060855122002097,"Block 2097, Block Group 2, Census Tract 5122, Santa Clara County, California",41,39,2
1000000US060855122002098,060855122002098,"Block 2098, Block Group 2, Census Tract 5122, Santa Clara County, California",0,0,0
1000000US060855122002099,060855122002099,"Block 2099, Block Group 2, Census Tract 5122, Santa Clara County, California",0,0,0
1000000US060855122002100,060855122002100,"Block 2100, Block Group 2, Census Tract 5122, Santa Clara County, California",19,19,0
1000000US060855122002101,060855122002101,"Block 2101, Block Group 2, Census Tract 5122, Santa Clara County, California",0,0,0
1000000US060855122002102,060855122002102,"Block 2102, Block Group 2, Census Tract 5122, Santa Clara County, California",12,12,0
1000000US060855122002103,060855122002103,"Block 2103, Block Group 2, Census Tract 5122, Santa Clara County, California",77,74,3
1000000US060855122002104,060855122002104,"Block 2104, Block Group 2, Census Tract 5122, Santa Clara County, California",10,9,1
1000000US060855122002105,060855122002105,"Block 2105, Block Group 2, Census Tract 5122, Santa Clara County, California",0,0,0
1000000US060855122002106,060855122002106,"Block 2106, Block Group 2, Census Tract 5122, Santa Clara County, California",0,0,0
1000000US060855122002107,060855122002107,"Block 2107, Block Group 2, Census Tract 5122, Santa Clara County, California",0,0,0
1000000US060855122002108,060855122002108,"Block 2108, Block Group 2, Census Tract 5122, Santa Clara County, California",10,10,0
1000000US060855122002109,060855122002109,"Block 2109, Block Group 2, Census Tract 5122, Santa Clara County, California",65,63,2
1000000US060855122002110,060855122002110,"Block 2110, Block Group 2, Census Tract 5122, Santa Clara County, California",0,0,0
1000000US060855122002111,060855122002111,"Block 2111, Block Group 2, Census Tract 5122, Santa Clara County, California",18,16,2
1000000US060855122002112,060855122002112,"Block 2112, Block Group 2, Census Tract 5122, Santa Clara County, California",0,0,0
1000000US060855122002113,060855122002113,"Block 2113, Block Group 2, Census Tract 5122, Santa Clara County, California",0,0,0
1000000US060855122002114,060855122002114,"Block 2114, Block Group 2, Census Tract 5122, Santa Clara County, California",11,11,0
1000000US060855122002115,060855122002115,"Block 2115, Block Group 2, Census Tract 5122, Santa Clara County, California",0,0,0
1000000US060855122002116,060855122002116,"Block 2116, Block Group 2, Census Tract 5122, Santa Clara County, California",0,0,0
1000000US060855122002117,060855122002117,"Block 2117, Block Group 2, Census Tract 5122, Santa Clara County, California",0,0,0
1000000US060855122002118,060855122002118,"Block 2118, Block Group 2, Census Tract 5122, Santa Clara County, California",0,0,0
1000000US060855122002119,060855122002119,"Block 2119, Block Group 2, Census Tract 5122, Santa Clara County, California",0,0,0
1000000US060855122002120,060855122002120,"Block 2120, Block Group 2, Census Tract 5122, Santa Clara County, California",0,0,0
1000000US060855122002121,060855122002121,"Block 2121, Block Group 2, Census Tract 5122, Santa Clara County, California",0,0,0
1000000US060855122002122,060855122002122,"Block 2122, Block Group 2, Census Tract 5122, Santa Clara County, California",0,0,0
1000000US060855122002123,060855122002123,"Block 2123, Block Group 2, Census Tract 5122, Santa Clara County, California",0,0,0
1000000US060855122002124,060855122002124,"Block 2124, Block Group 2, Census Tract 5122, Santa Clara County, California",0,0,0
1000000US060855122002125,060855122002125,"Block 2125, Block Group 2, Census Tract 5122, Santa Clara County, California",0,0,0
1000000US060855122002126,060855122002126,"Block 2126, Block Group 2, Census Tract 5122, Santa Clara County, California",0,0,0
1000000US060855122002127,060855122002127,"Block 2127, Block Group 2, Census Tract 5122, Santa Clara County, California",0,0,0
1000000US060855122002128,060855122002128,"Block 2128, Block Group 2, Census Tract 5122, Santa Clara County, California",1,1,0
1000000US060855122002129,060855122002129,"Block 2129, Block Group 2, Census Tract 5122, Santa Clara County, California",0,0,0
1000000US060855122002130,060855122002130,"Block 2130, Block Group 2, Census Tract 5122, Santa Clara County, California",0,0,0
1000000US060855122002131,060855122002131,"Block 2131, Block Group 2, Census Tract 5122, Santa Clara County, California",0,0,0
1000000US060855122002132,060855122002132,"Block 2132, Block Group 2, Census Tract 5122, Santa Clara County, California",1,1,0
1000000US060855122002133,060855122002133,"Block 2133, Block Group 2, Census Tract 5122, Santa Clara County, California",0,0,0
1000000US060855122002134,060855122002134,"Block 2134, Block Group 2, Census Tract 5122, Santa Clara County, California",0,0,0
1000000US060855122002135,060855122002135,"Block 2135, Block Group 2, Census Tract 5122, Santa Clara County, California",0,0,0
1000000US060855122002136,060855122002136,"Block 2136, Block Group 2, Census Tract 5122, Santa Clara County, California",0,0,0
1000000US060855122002137,060855122002137,"Block 2137, Block Group 2, Census Tract 5122, Santa Clara County, California",0,0,0
1000000US060855122002138,060855122002138,"Block 2138, Block Group 2, Census Tract 5122, Santa Clara County, California",0,0,0
1000000US060855122002139,060855122002139,"Block 2139, Block Group 2, Census Tract 5122, Santa Clara County, California",0,0,0
1000000US060855122002140,060855122002140,"Block 2140, Block Group 2, Census Tract 5122, Santa Clara County, California",0,0,0
1000000US060855122002141,060855122002141,"Block 2141, Block Group 2, Census Tract 5122, Santa Clara County, California",0,0,0
1000000US060855122002142,060855122002142,"Block 2142, Block Group 2, Census Tract 5122, Santa Clara County, California",0,0,0
1000000US060855122002143,060855122002143,"Block 2143, Block Group 2, Census Tract 5122, Santa Clara County, California",0,0,0
1000000US060855122002144,060855122002144,"Block 2144, Block Group 2, Census Tract 5122, Santa Clara County, California",0,0,0
1000000US060855122002145,060855122002145,"Block 2145, Block Group 2, Census Tract 5122, Santa Clara County, California",0,0,0
1000000US060855122002146,060855122002146,"Block 2146, Block Group 2, Census Tract 5122, Santa Clara County, California",0,0,0
1000000US060855122002147,060855122002147,"Block 2147, Block Group 2, Census Tract 5122, Santa Clara County, California",0,0,0
1000000US060855122002148,060855122002148,"Block 2148, Block Group 2, Census Tract 5122, Santa Clara County, California",6,6,0
1000000US060855122002149,060855122002149,"Block 2149, Block Group 2, Census Tract 5122, Santa Clara County, California",1,1,0
1000000US060855122002150,060855122002150,"Block 2150, Block Group 2, Census Tract 5122, Santa Clara County, California",1,1,0
1000000US060855122002151,060855122002151,"Block 2151, Block Group 2, Census Tract 5122, Santa Clara County, California",2,2,0
1000000US060855122002152,060855122002152,"Block 2152, Block Group 2, Census Tract 5122, Santa Clara County, California",0,0,0
1000000US060855122002153,060855122002153,"Block 2153, Block Group 2, Census Tract 5122, Santa Clara County, California",1,1,0
1000000US060855122002154,060855122002154,"Block 2154, Block Group 2, Census Tract 5122, Santa Clara County, California",0,0,0
1000000US060855122002155,060855122002155,"Block 2155, Block Group 2, Census Tract 5122, Santa Clara County, California",0,0,0
1000000US060855122002156,060855122002156,"Block 2156, Block Group 2, Census Tract 5122, Santa Clara County, California",0,0,0
1000000US060855122002157,060855122002157,"Block 2157, Block Group 2, Census Tract 5122, Santa Clara County, California",0,0,0
1000000US060855122002158,060855122002158,"Block 2158, Block Group 2, Census Tract 5122, Santa Clara County, California",0,0,0
1000000US060855122002159,060855122002159,"Block 2159, Block Group 2, Census Tract 5122, Santa Clara County, California",0,0,0
1000000US060855123051000,060855123051000,"Block 1000, Block Group 1, Census Tract 5123.05, Santa Clara County, California",0,0,0
1000000US060855123051001,060855123051001,"Block 1001, Block Group 1, Census Tract 5123.05, Santa Clara County, California",3,2,1
1000000US060855123051002,060855123051002,"Block 1002, Block Group 1, Census Tract 5123.05, Santa Clara County, California",16,16,0
1000000US060855123051003,060855123051003,"Block 1003, Block Group 1, Census Tract 5123.05, Santa Clara County, California",0,0,0
1000000US060855123051004,060855123051004,"Block 1004, Block Group 1, Census Tract 5123.05, Santa Clara County, California",2,2,0
1000000US060855123051005,060855123051005,"Block 1005, Block Group 1, Census Tract 5123.05, Santa Clara County, California",0,0,0
1000000US060855123051006,060855123051006,"Block 1006, Block Group 1, Census Tract 5123.05, Santa Clara County, California",109,101,8
1000000US060855123051007,060855123051007,"Block 1007, Block Group 1, Census Tract 5123.05, Santa Clara County, California",63,62,1
1000000US060855123051008,060855123051008,"Block 1008, Block Group 1, Census Tract 5123.05, Santa Clara County, California",52,51,1
1000000US060855123051009,060855123051009,"Block 1009, Block Group 1, Census Tract 5123.05, Santa Clara County, California",0,0,0
1000000US060855123051010,060855123051010,"Block 1010, Block Group 1, Census Tract 5123.05, Santa Clara County, California",67,62,5
1000000US060855123051011,060855123051011,"Block 1011, Block Group 1, Census Tract 5123.05, Santa Clara County, California",46,46,0
1000000US060855123051012,060855123051012,"Block 1012, Block Group 1, Census Tract 5123.05, Santa Clara County, California",0,0,0
1000000US060855123051013,060855123051013,"Block 1013, Block Group 1, Census Tract 5123.05, Santa Clara County, California",0,0,0
1000000US060855123051014,060855123051014,"Block 1014, Block Group 1, Census Tract 5123.05, Santa Clara County, California",2,2,0
1000000US060855123051015,060855123051015,"Block 1015, Block Group 1, Census Tract 5123.05, Santa Clara County, California",22,20,2
1000000US060855123051016,060855123051016,"Block 1016, Block Group 1, Census Tract 5123.05, Santa Clara County, California",0,0,0
1000000US060855123051017,060855123051017,"Block 1017, Block Group 1, Census Tract 5123.05, Santa Clara County, California",41,41,0
1000000US060855123051018,060855123051018,"Block 1018, Block Group 1, Census Tract 5123.05, Santa Clara County, California",1,1,0
1000000US060855123051019,060855123051019,"Block 1019, Block Group 1, Census Tract 5123.05, Santa Clara County, California",0,0,0
1000000US060855123051020,060855123051020,"Block 1020, Block Group 1, Census Tract 5123.05, Santa Clara County, California",14,14,0
1000000US060855123051021,060855123051021,"Block 1021, Block Group 1, Census Tract 5123.05, Santa Clara County, California",3,3,0
1000000US060855123051022,060855123051022,"Block 1022, Block Group 1, Census Tract 5123.05, Santa Clara County, California",27,25,2
1000000US060855123051023,060855123051023,"Block 1023, Block Group 1, Census Tract 5123.05, Santa Clara County, California",1,1,0
1000000US060855123051024,060855123051024,"Block 1024, Block Group 1, Census Tract 5123.05, Santa Clara County, California",1,1,0
1000000US060855123051025,060855123051025,"Block 1025, Block Group 1, Census Tract 5123.05, Santa Clara County, California",8,8,0
1000000US060855123051026,060855123051026,"Block 1026, Block Group 1, Census Tract 5123.05, Santa Clara County, California",1,1,0
1000000US060855123051027,060855123051027,"Block 1027, Block Group 1, Census Tract 5123.05, Santa Clara County, California",214,201,13
1000000US060855123051028,060855123051028,"Block 1028, Block Group 1, Census Tract 5123.05, Santa Clara County, California",0,0,0
1000000US060855123051029,060855123051029,"Block 1029, Block Group 1, Census Tract 5123.05, Santa Clara County, California",0,0,0
1000000US060855123051030,060855123051030,"Block 1030, Block Group 1, Census Tract 5123.05, Santa Clara County, California",0,0,0
1000000US060855123051031,060855123051031,"Block 1031, Block Group 1, Census Tract 5123.05, Santa Clara County, California",0,0,0
1000000US060855123051032,060855123051032,"Block 1032, Block Group 1, Census Tract 5123.05, Santa Clara County, California",27,27,0
1000000US060855123051033,060855123051033,"Block 1033, Block Group 1, Census Tract 5123.05, Santa Clara County, California",4,4,0
1000000US060855123051034,060855123051034,"Block 1034, Block Group 1, Census Tract 5123.05, Santa Clara County, California",2,2,0
1000000US060855123051035,060855123051035,"Block 1035, Block Group 1, Census Tract 5123.05, Santa Clara County, California",43,40,3
1000000US060855123051036,060855123051036,"Block 1036, Block Group 1, Census Tract 5123.05, Santa Clara County, California",40,38,2
1000000US060855123051037,060855123051037,"Block 1037, Block Group 1, Census Tract 5123.05, Santa Clara County, California",18,18,0
1000000US060855123051038,060855123051038,"Block 1038, Block Group 1, Census Tract 5123.05, Santa Clara County, California",32,31,1
1000000US060855123051039,060855123051039,"Block 1039, Block Group 1, Census Tract 5123.05, Santa Clara County, California",14,14,0
1000000US060855123051040,060855123051040,"Block 1040, Block Group 1, Census Tract 5123.05, Santa Clara County, California",7,6,1
1000000US060855123051041,060855123051041,"Block 1041, Block Group 1, Census Tract 5123.05, Santa Clara County, California",0,0,0
1000000US060855123051042,060855123051042,"Block 1042, Block Group 1, Census Tract 5123.05, Santa Clara County, California",0,0,0
1000000US060855123051043,060855123051043,"Block 1043, Block Group 1, Census Tract 5123.05, Santa Clara County, California",0,0,0
1000000US060855123051044,060855123051044,"Block 1044, Block Group 1, Census Tract 5123.05, Santa Clara County, California",3,3,0
1000000US060855123051045,060855123051045,"Block 1045, Block Group 1, Census Tract 5123.05, Santa Clara County, California",0,0,0
1000000US060855123052000,060855123052000,"Block 2000, Block Group 2, Census Tract 5123.05, Santa Clara County, California",0,0,0
1000000US060855123052001,060855123052001,"Block 2001, Block Group 2, Census Tract 5123.05, Santa Clara County, California",109,106,3
1000000US060855123052002,060855123052002,"Block 2002, Block Group 2, Census Tract 5123.05, Santa Clara County, California",8,8,0
1000000US060855123052003,060855123052003,"Block 2003, Block Group 2, Census Tract 5123.05, Santa Clara County, California",4,4,0
1000000US060855123052004,060855123052004,"Block 2004, Block Group 2, Census Tract 5123.05, Santa Clara County, California",47,45,2
1000000US060855123052005,060855123052005,"Block 2005, Block Group 2, Census Tract 5123.05, Santa Clara County, California",0,0,0
1000000US060855123052006,060855123052006,"Block 2006, Block Group 2, Census Tract 5123.05, Santa Clara County, California",0,0,0
1000000US060855123052007,060855123052007,"Block 2007, Block Group 2, Census Tract 5123.05, Santa Clara County, California",0,0,0
1000000US060855123052008,060855123052008,"Block 2008, Block Group 2, Census Tract 5123.05, Santa Clara County, California",0,0,0
1000000US060855123052009,060855123052009,"Block 2009, Block Group 2, Census Tract 5123.05, Santa Clara County, California",94,90,4
1000000US060855123052010,060855123052010,"Block 2010, Block Group 2, Census Tract 5123.05, Santa Clara County, California",0,0,0
1000000US060855123052011,060855123052011,"Block 2011, Block Group 2, Census Tract 5123.05, Santa Clara County, California",1,1,0
1000000US060855123052012,060855123052012,"Block 2012, Block Group 2, Census Tract 5123.05, Santa Clara County, California",74,71,3
1000000US060855123052013,060855123052013,"Block 2013, Block Group 2, Census Tract 5123.05, Santa Clara County, California",0,0,0
1000000US060855123052014,060855123052014,"Block 2014, Block Group 2, Census Tract 5123.05, Santa Clara County, California",11,10,1
1000000US060855123052015,060855123052015,"Block 2015, Block Group 2, Census Tract 5123.05, Santa Clara County, California",1,1,0
1000000US060855123052016,060855123052016,"Block 2016, Block Group 2, Census Tract 5123.05, Santa Clara County, California",43,38,5
1000000US060855123052017,060855123052017,"Block 2017, Block Group 2, Census Tract 5123.05, Santa Clara County, California",0,0,0
1000000US060855123052018,060855123052018,"Block 2018, Block Group 2, Census Tract 5123.05, Santa Clara County, California",0,0,0
1000000US060855123052019,060855123052019,"Block 2019, Block Group 2, Census Tract 5123.05, Santa Clara County, California",12,12,0
1000000US060855123052020,060855123052020,"Block 2020, Block Group 2, Census Tract 5123.05, Santa Clara County, California",0,0,0
1000000US060855123052021,060855123052021,"Block 2021, Block Group 2, Census Tract 5123.05, Santa Clara County, California",0,0,0
1000000US060855123052022,060855123052022,"Block 2022, Block Group 2, Census Tract 5123.05, Santa Clara County, California",8,8,0
1000000US060855123052023,060855123052023,"Block 2023, Block Group 2, Census Tract 5123.05, Santa Clara County, California",4,4,0
1000000US060855123052024,060855123052024,"Block 2024, Block Group 2, Census Tract 5123.05, Santa Clara County, California",0,0,0
1000000US060855123052025,060855123052025,"Block 2025, Block Group 2, Census Tract 5123.05, Santa Clara County, California",29,29,0
1000000US060855123052026,060855123052026,"Block 2026, Block Group 2, Census Tract 5123.05, Santa Clara County, California",4,4,0
1000000US060855123052027,060855123052027,"Block 2027, Block Group 2, Census Tract 5123.05, Santa Clara County, California",2,2,0
1000000US060855123052028,060855123052028,"Block 2028, Block Group 2, Census Tract 5123.05, Santa Clara County, California",1,1,0
1000000US060855123071000,060855123071000,"Block 1000, Block Group 1, Census Tract 5123.07, Santa Clara County, California",0,0,0
1000000US060855123071001,060855123071001,"Block 1001, Block Group 1, Census Tract 5123.07, Santa Clara County, California",0,0,0
1000000US060855123071002,060855123071002,"Block 1002, Block Group 1, Census Tract 5123.07, Santa Clara County, California",0,0,0
1000000US060855123071003,060855123071003,"Block 1003, Block Group 1, Census Tract 5123.07, Santa Clara County, California",0,0,0
1000000US060855123071004,060855123071004,"Block 1004, Block Group 1, Census Tract 5123.07, Santa Clara County, California",0,0,0
1000000US060855123071005,060855123071005,"Block 1005, Block Group 1, Census Tract 5123.07, Santa Clara County, California",0,0,0
1000000US060855123071006,060855123071006,"Block 1006, Block Group 1, Census Tract 5123.07, Santa Clara County, California",0,0,0
1000000US060855123071007,060855123071007,"Block 1007, Block Group 1, Census Tract 5123.07, Santa Clara County, California",0,0,0
1000000US060855123071008,060855123071008,"Block 1008, Block Group 1, Census Tract 5123.07, Santa Clara County, California",0,0,0
1000000US060855123071009,060855123071009,"Block 1009, Block Group 1, Census Tract 5123.07, Santa Clara County, California",0,0,0
1000000US060855123071010,060855123071010,"Block 1010, Block Group 1, Census Tract 5123.07, Santa Clara County, California",0,0,0
1000000US060855123071011,060855123071011,"Block 1011, Block Group 1, Census Tract 5123.07, Santa Clara County, California",0,0,0
1000000US060855123071012,060855123071012,"Block 1012, Block Group 1, Census Tract 5123.07, Santa Clara County, California",0,0,0
1000000US060855123071013,060855123071013,"Block 1013, Block Group 1, Census Tract 5123.07, Santa Clara County, California",152,147,5
1000000US060855123071014,060855123071014,"Block 1014, Block Group 1, Census Tract 5123.07, Santa Clara County, California",98,95,3
1000000US060855123071015,060855123071015,"Block 1015, Block Group 1, Census Tract 5123.07, Santa Clara County, California",30,30,0
1000000US060855123071016,060855123071016,"Block 1016, Block Group 1, Census Tract 5123.07, Santa Clara County, California",0,0,0
1000000US060855123071017,060855123071017,"Block 1017, Block Group 1, Census Tract 5123.07, Santa Clara County, California",7,7,0
1000000US060855123071018,060855123071018,"Block 1018, Block Group 1, Census Tract 5123.07, Santa Clara County, California",0,0,0
1000000US060855123071019,060855123071019,"Block 1019, Block Group 1, Census Tract 5123.07, Santa Clara County, California",0,0,0
1000000US060855123071020,060855123071020,"Block 1020, Block Group 1, Census Tract 5123.07, Santa Clara County, California",0,0,0
1000000US060855123071021,060855123071021,"Block 1021, Block Group 1, Census Tract 5123.07, Santa Clara County, California",0,0,0
1000000US060855123071022,060855123071022,"Block 1022, Block Group 1, Census Tract 5123.07, Santa Clara County, California",30,30,0
1000000US060855123071023,060855123071023,"Block 1023, Block Group 1, Census Tract 5123.07, Santa Clara County, California",0,0,0
1000000US060855123071024,060855123071024,"Block 1024, Block Group 1, Census Tract 5123.07, Santa Clara County, California",0,0,0
1000000US060855123071025,060855123071025,"Block 1025, Block Group 1, Census Tract 5123.07, Santa Clara County, California",8,8,0
1000000US060855123071026,060855123071026,"Block 1026, Block Group 1, Census Tract 5123.07, Santa Clara County, California",0,0,0
1000000US060855123071027,060855123071027,"Block 1027, Block Group 1, Census Tract 5123.07, Santa Clara County, California",44,44,0
1000000US060855123071028,060855123071028,"Block 1028, Block Group 1, Census Tract 5123.07, Santa Clara County, California",10,10,0
1000000US060855123071029,060855123071029,"Block 1029, Block Group 1, Census Tract 5123.07, Santa Clara County, California",71,70,1
1000000US060855123071030,060855123071030,"Block 1030, Block Group 1, Census Tract 5123.07, Santa Clara County, California",14,14,0
1000000US060855123071031,060855123071031,"Block 1031, Block Group 1, Census Tract 5123.07, Santa Clara County, California",13,13,0
1000000US060855123072000,060855123072000,"Block 2000, Block Group 2, Census Tract 5123.07, Santa Clara County, California",0,0,0
1000000US060855123072001,060855123072001,"Block 2001, Block Group 2, Census Tract 5123.07, Santa Clara County, California",91,91,0
1000000US060855123072002,060855123072002,"Block 2002, Block Group 2, Census Tract 5123.07, Santa Clara County, California",20,20,0
1000000US060855123072003,060855123072003,"Block 2003, Block Group 2, Census Tract 5123.07, Santa Clara County, California",29,29,0
1000000US060855123072004,060855123072004,"Block 2004, Block Group 2, Census Tract 5123.07, Santa Clara County, California",22,22,0
1000000US060855123072005,060855123072005,"Block 2005, Block Group 2, Census Tract 5123.07, Santa Clara County, California",5,5,0
1000000US060855123072006,060855123072006,"Block 2006, Block Group 2, Census Tract 5123.07, Santa Clara County, California",43,42,1
1000000US060855123072007,060855123072007,"Block 2007, Block Group 2, Census Tract 5123.07, Santa Clara County, California",61,60,1
1000000US060855123072008,060855123072008,"Block 2008, Block Group 2, Census Tract 5123.07, Santa Clara County, California",150,150,0
1000000US060855123072009,060855123072009,"Block 2009, Block Group 2, Census Tract 5123.07, Santa Clara County, California",0,0,0
1000000US060855123072010,060855123072010,"Block 2010, Block Group 2, Census Tract 5123.07, Santa Clara County, California",16,16,0
1000000US060855123072011,060855123072011,"Block 2011, Block Group 2, Census Tract 5123.07, Santa Clara County, California",11,11,0
1000000US060855123072012,060855123072012,"Block 2012, Block Group 2, Census Tract 5123.07, Santa Clara County, California",10,10,0
1000000US060855123072013,060855123072013,"Block 2013, Block Group 2, Census Tract 5123.07, Santa Clara County, California",32,31,1
1000000US060855123072014,060855123072014,"Block 2014, Block Group 2, Census Tract 5123.07, Santa Clara County, California",17,17,0
1000000US060855123072015,060855123072015,"Block 2015, Block Group 2, Census Tract 5123.07, Santa Clara County, California",24,23,1
1000000US060855123072016,060855123072016,"Block 2016, Block Group 2, Census Tract 5123.07, Santa Clara County, California",97,95,2
1000000US060855123072017,060855123072017,"Block 2017, Block Group 2, Census Tract 5123.07, Santa Clara County, California",38,36,2
1000000US060855123072018,060855123072018,"Block 2018, Block Group 2, Census Tract 5123.07, Santa Clara County, California",0,0,0
1000000US060855123072019,060855123072019,"Block 2019, Block Group 2, Census Tract 5123.07, Santa Clara County, California",47,46,1
1000000US060855123072020,060855123072020,"Block 2020, Block Group 2, Census Tract 5123.07, Santa Clara County, California",73,73,0
1000000US060855123072021,060855123072021,"Block 2021, Block Group 2, Census Tract 5123.07, Santa Clara County, California",15,15,0
1000000US060855123072022,060855123072022,"Block 2022, Block Group 2, Census Tract 5123.07, Santa Clara County, California",50,49,1
1000000US060855123072023,060855123072023,"Block 2023, Block Group 2, Census Tract 5123.07, Santa Clara County, California",0,0,0
1000000US060855123073000,060855123073000,"Block 3000, Block Group 3, Census Tract 5123.07, Santa Clara County, California",4,4,0
1000000US060855123073001,060855123073001,"Block 3001, Block Group 3, Census Tract 5123.07, Santa Clara County, California",28,26,2
1000000US060855123073002,060855123073002,"Block 3002, Block Group 3, Census Tract 5123.07, Santa Clara County, California",0,0,0
1000000US060855123073003,060855123073003,"Block 3003, Block Group 3, Census Tract 5123.07, Santa Clara County, California",0,0,0
1000000US060855123073004,060855123073004,"Block 3004, Block Group 3, Census Tract 5123.07, Santa Clara County, California",0,0,0
1000000US060855123073005,060855123073005,"Block 3005, Block Group 3, Census Tract 5123.07, Santa Clara County, California",2,2,0
1000000US060855123073006,060855123073006,"Block 3006, Block Group 3, Census Tract 5123.07, Santa Clara County, California",0,0,0
1000000US060855123073007,060855123073007,"Block 3007, Block Group 3, Census Tract 5123.07, Santa Clara County, California",0,0,0
1000000US060855123073008,060855123073008,"Block 3008, Block Group 3, Census Tract 5123.07, Santa Clara County, California",0,0,0
1000000US060855123073009,060855123073009,"Block 3009, Block Group 3, Census Tract 5123.07, Santa Clara County, California",8,7,1
1000000US060855123073010,060855123073010,"Block 3010, Block Group 3, Census Tract 5123.07, Santa Clara County, California",113,110,3
1000000US060855123073011,060855123073011,"Block 3011, Block Group 3, Census Tract 5123.07, Santa Clara County, California",33,32,1
1000000US060855123073012,060855123073012,"Block 3012, Block Group 3, Census Tract 5123.07, Santa Clara County, California",6,6,0
1000000US060855123073013,060855123073013,"Block 3013, Block Group 3, Census Tract 5123.07, Santa Clara County, California",52,49,3
1000000US060855123073014,060855123073014,"Block 3014, Block Group 3, Census Tract 5123.07, Santa Clara County, California",53,52,1
1000000US060855123073015,060855123073015,"Block 3015, Block Group 3, Census Tract 5123.07, Santa Clara County, California",73,66,7
1000000US060855123073016,060855123073016,"Block 3016, Block Group 3, Census Tract 5123.07, Santa Clara County, California",29,28,1
1000000US060855123073017,060855123073017,"Block 3017, Block Group 3, Census Tract 5123.07, Santa Clara County, California",16,16,0
1000000US060855123073018,060855123073018,"Block 3018, Block Group 3, Census Tract 5123.07, Santa Clara County, California",88,84,4
1000000US060855123073019,060855123073019,"Block 3019, Block Group 3, Census Tract 5123.07, Santa Clara County, California",4,4,0
1000000US060855123073020,060855123073020,"Block 3020, Block Group 3, Census Tract 5123.07, Santa Clara County, California",9,9,0
1000000US060855123073021,060855123073021,"Block 3021, Block Group 3, Census Tract 5123.07, Santa Clara County, California",0,0,0
1000000US060855123073022,060855123073022,"Block 3022, Block Group 3, Census Tract 5123.07, Santa Clara County, California",0,0,0
1000000US060855123073023,060855123073023,"Block 3023, Block Group 3, Census Tract 5123.07, Santa Clara County, California",15,15,0
1000000US060855123073024,060855123073024,"Block 3024, Block Group 3, Census Tract 5123.07, Santa Clara County, California",0,0,0
1000000US060855123073025,060855123073025,"Block 3025, Block Group 3, Census Tract 5123.07, Santa Clara County, California",21,21,0
1000000US060855123073026,060855123073026,"Block 3026, Block Group 3, Census Tract 5123.07, Santa Clara County, California",3,3,0
1000000US060855123073027,060855123073027,"Block 3027, Block Group 3, Census Tract 5123.07, Santa Clara County, California",23,23,0
1000000US060855123073028,060855123073028,"Block 3028, Block Group 3, Census Tract 5123.07, Santa Clara County, California",0,0,0
1000000US060855123073029,060855123073029,"Block 3029, Block Group 3, Census Tract 5123.07, Santa Clara County, California",11,11,0
1000000US060855123073030,060855123073030,"Block 3030, Block Group 3, Census Tract 5123.07, Santa Clara County, California",42,41,1
1000000US060855123073031,060855123073031,"Block 3031, Block Group 3, Census Tract 5123.07, Santa Clara County, California",142,126,16
1000000US060855123073032,060855123073032,"Block 3032, Block Group 3, Census Tract 5123.07, Santa Clara County, California",0,0,0
1000000US060855123073033,060855123073033,"Block 3033, Block Group 3, Census Tract 5123.07, Santa Clara County, California",78,73,5
1000000US060855123073034,060855123073034,"Block 3034, Block Group 3, Census Tract 5123.07, Santa Clara County, California",0,0,0
1000000US060855123073035,060855123073035,"Block 3035, Block Group 3, Census Tract 5123.07, Santa Clara County, California",43,42,1
1000000US060855123073036,060855123073036,"Block 3036, Block Group 3, Census Tract 5123.07, Santa Clara County, California",50,49,1
1000000US060855123073037,060855123073037,"Block 3037, Block Group 3, Census Tract 5123.07, Santa Clara County, California",4,4,0
1000000US060855123073038,060855123073038,"Block 3038, Block Group 3, Census Tract 5123.07, Santa Clara County, California",19,19,0
1000000US060855123073039,060855123073039,"Block 3039, Block Group 3, Census Tract 5123.07, Santa Clara County, California",0,0,0
1000000US060855123073040,060855123073040,"Block 3040, Block Group 3, Census Tract 5123.07, Santa Clara County, California",0,0,0
1000000US060855123081000,060855123081000,"Block 1000, Block Group 1, Census Tract 5123.08, Santa Clara County, California",7,7,0
1000000US060855123081001,060855123081001,"Block 1001, Block Group 1, Census Tract 5123.08, Santa Clara County, California",9,8,1
1000000US060855123081002,060855123081002,"Block 1002, Block Group 1, Census Tract 5123.08, Santa Clara County, California",2,2,0
1000000US060855123081003,060855123081003,"Block 1003, Block Group 1, Census Tract 5123.08, Santa Clara County, California",13,13,0
1000000US060855123081004,060855123081004,"Block 1004, Block Group 1, Census Tract 5123.08, Santa Clara County, California",0,0,0
1000000US060855123081005,060855123081005,"Block 1005, Block Group 1, Census Tract 5123.08, Santa Clara County, California",45,40,5
1000000US060855123081006,060855123081006,"Block 1006, Block Group 1, Census Tract 5123.08, Santa Clara County, California",1,1,0
1000000US060855123081007,060855123081007,"Block 1007, Block Group 1, Census Tract 5123.08, Santa Clara County, California",86,81,5
1000000US060855123081008,060855123081008,"Block 1008, Block Group 1, Census Tract 5123.08, Santa Clara County, California",0,0,0
1000000US060855123081009,060855123081009,"Block 1009, Block Group 1, Census Tract 5123.08, Santa Clara County, California",0,0,0
1000000US060855123081010,060855123081010,"Block 1010, Block Group 1, Census Tract 5123.08, Santa Clara County, California",0,0,0
1000000US060855123081011,060855123081011,"Block 1011, Block Group 1, Census Tract 5123.08, Santa Clara County, California",0,0,0
1000000US060855123081012,060855123081012,"Block 1012, Block Group 1, Census Tract 5123.08, Santa Clara County, California",28,26,2
1000000US060855123081013,060855123081013,"Block 1013, Block Group 1, Census Tract 5123.08, Santa Clara County, California",1,1,0
1000000US060855123081014,060855123081014,"Block 1014, Block Group 1, Census Tract 5123.08, Santa Clara County, California",51,50,1
1000000US060855123081015,060855123081015,"Block 1015, Block Group 1, Census Tract 5123.08, Santa Clara County, California",116,114,2
1000000US060855123081016,060855123081016,"Block 1016, Block Group 1, Census Tract 5123.08, Santa Clara County, California",26,26,0
1000000US060855123081017,060855123081017,"Block 1017, Block Group 1, Census Tract 5123.08, Santa Clara County, California",25,25,0
1000000US060855123081018,060855123081018,"Block 1018, Block Group 1, Census Tract 5123.08, Santa Clara County, California",29,29,0
1000000US060855123081019,060855123081019,"Block 1019, Block Group 1, Census Tract 5123.08, Santa Clara County, California",22,22,0
1000000US060855123081020,060855123081020,"Block 1020, Block Group 1, Census Tract 5123.08, Santa Clara County, California",22,22,0
1000000US060855123081021,060855123081021,"Block 1021, Block Group 1, Census Tract 5123.08, Santa Clara County, California",0,0,0
1000000US060855123081022,060855123081022,"Block 1022, Block Group 1, Census Tract 5123.08, Santa Clara County, California",0,0,0
1000000US060855123081023,060855123081023,"Block 1023, Block Group 1, Census Tract 5123.08, Santa Clara County, California",5,4,1
1000000US060855123081024,060855123081024,"Block 1024, Block Group 1, Census Tract 5123.08, Santa Clara County, California",0,0,0
1000000US060855123081025,060855123081025,"Block 1025, Block Group 1, Census Tract 5123.08, Santa Clara County, California",0,0,0
1000000US060855123081026,060855123081026,"Block 1026, Block Group 1, Census Tract 5123.08, Santa Clara County, California",2,2,0
1000000US060855123081027,060855123081027,"Block 1027, Block Group 1, Census Tract 5123.08, Santa Clara County, California",0,0,0
1000000US060855123081028,060855123081028,"Block 1028, Block Group 1, Census Tract 5123.08, Santa Clara County, California",0,0,0
1000000US060855123081029,060855123081029,"Block 1029, Block Group 1, Census Tract 5123.08, Santa Clara County, California",37,37,0
1000000US060855123081030,060855123081030,"Block 1030, Block Group 1, Census Tract 5123.08, Santa Clara County, California",17,16,1
1000000US060855123081031,060855123081031,"Block 1031, Block Group 1, Census Tract 5123.08, Santa Clara County, California",14,14,0
1000000US060855123081032,060855123081032,"Block 1032, Block Group 1, Census Tract 5123.08, Santa Clara County, California",11,11,0
1000000US060855123081033,060855123081033,"Block 1033, Block Group 1, Census Tract 5123.08, Santa Clara County, California",0,0,0
1000000US060855123081034,060855123081034,"Block 1034, Block Group 1, Census Tract 5123.08, Santa Clara County, California",0,0,0
1000000US060855123081035,060855123081035,"Block 1035, Block Group 1, Census Tract 5123.08, Santa Clara County, California",49,48,1
1000000US060855123081036,060855123081036,"Block 1036, Block Group 1, Census Tract 5123.08, Santa Clara County, California",8,8,0
1000000US060855123081037,060855123081037,"Block 1037, Block Group 1, Census Tract 5123.08, Santa Clara County, California",0,0,0
1000000US060855123081038,060855123081038,"Block 1038, Block Group 1, Census Tract 5123.08, Santa Clara County, California",0,0,0
1000000US060855123082000,060855123082000,"Block 2000, Block Group 2, Census Tract 5123.08, Santa Clara County, California",48,47,1
1000000US060855123082001,060855123082001,"Block 2001, Block Group 2, Census Tract 5123.08, Santa Clara County, California",0,0,0
1000000US060855123082002,060855123082002,"Block 2002, Block Group 2, Census Tract 5123.08, Santa Clara County, California",2,2,0
1000000US060855123082003,060855123082003,"Block 2003, Block Group 2, Census Tract 5123.08, Santa Clara County, California",11,11,0
1000000US060855123082004,060855123082004,"Block 2004, Block Group 2, Census Tract 5123.08, Santa Clara County, California",39,36,3
1000000US060855123082005,060855123082005,"Block 2005, Block Group 2, Census Tract 5123.08, Santa Clara County, California",0,0,0
1000000US060855123082006,060855123082006,"Block 2006, Block Group 2, Census Tract 5123.08, Santa Clara County, California",0,0,0
1000000US060855123082007,060855123082007,"Block 2007, Block Group 2, Census Tract 5123.08, Santa Clara County, California",0,0,0
1000000US060855123082008,060855123082008,"Block 2008, Block Group 2, Census Tract 5123.08, Santa Clara County, California",26,26,0
1000000US060855123082009,060855123082009,"Block 2009, Block Group 2, Census Tract 5123.08, Santa Clara County, California",287,287,0
1000000US060855123082010,060855123082010,"Block 2010, Block Group 2, Census Tract 5123.08, Santa Clara County, California",12,12,0
1000000US060855123082011,060855123082011,"Block 2011, Block Group 2, Census Tract 5123.08, Santa Clara County, California",12,12,0
1000000US060855123082012,060855123082012,"Block 2012, Block Group 2, Census Tract 5123.08, Santa Clara County, California",17,17,0
1000000US060855123082013,060855123082013,"Block 2013, Block Group 2, Census Tract 5123.08, Santa Clara County, California",11,10,1
1000000US060855123082014,060855123082014,"Block 2014, Block Group 2, Census Tract 5123.08, Santa Clara County, California",4,3,1
1000000US060855123082015,060855123082015,"Block 2015, Block Group 2, Census Tract 5123.08, Santa Clara County, California",0,0,0
1000000US060855123082016,060855123082016,"Block 2016, Block Group 2, Census Tract 5123.08, Santa Clara County, California",20,20,0
1000000US060855123082017,060855123082017,"Block 2017, Block Group 2, Census Tract 5123.08, Santa Clara County, California",12,11,1
1000000US060855123082018,060855123082018,"Block 2018, Block Group 2, Census Tract 5123.08, Santa Clara County, California",0,0,0
1000000US060855123082019,060855123082019,"Block 2019, Block Group 2, Census Tract 5123.08, Santa Clara County, California",0,0,0
1000000US060855123082020,060855123082020,"Block 2020, Block Group 2, Census Tract 5123.08, Santa Clara County, California",13,13,0
1000000US060855123082021,060855123082021,"Block 2021, Block Group 2, Census Tract 5123.08, Santa Clara County, California",0,0,0
1000000US060855123082022,060855123082022,"Block 2022, Block Group 2, Census Tract 5123.08, Santa Clara County, California",0,0,0
1000000US060855123082023,060855123082023,"Block 2023, Block Group 2, Census Tract 5123.08, Santa Clara County, California",22,20,2
1000000US060855123082024,060855123082024,"Block 2024, Block Group 2, Census Tract 5123.08, Santa Clara County, California",72,72,0
1000000US060855123082025,060855123082025,"Block 2025, Block Group 2, Census Tract 5123.08, Santa Clara County, California",5,5,0
1000000US060855123082026,060855123082026,"Block 2026, Block Group 2, Census Tract 5123.08, Santa Clara County, California",0,0,0
1000000US060855123082027,060855123082027,"Block 2027, Block Group 2, Census Tract 5123.08, Santa Clara County, California",5,5,0
1000000US060855123082028,060855123082028,"Block 2028, Block Group 2, Census Tract 5123.08, Santa Clara County, California",10,10,0
1000000US060855123082029,060855123082029,"Block 2029, Block Group 2, Census Tract 5123.08, Santa Clara County, California",5,5,0
1000000US060855123082030,060855123082030,"Block 2030, Block Group 2, Census Tract 5123.08, Santa Clara County, California",0,0,0
1000000US060855123082031,060855123082031,"Block 2031, Block Group 2, Census Tract 5123.08, Santa Clara County, California",0,0,0
1000000US060855123082032,060855123082032,"Block 2032, Block Group 2, Census Tract 5123.08, Santa Clara County, California",1,1,0
1000000US060855123082033,060855123082033,"Block 2033, Block Group 2, Census Tract 5123.08, Santa Clara County, California",0,0,0
1000000US060855123082034,060855123082034,"Block 2034, Block Group 2, Census Tract 5123.08, Santa Clara County, California",6,6,0
1000000US060855123082035,060855123082035,"Block 2035, Block Group 2, Census Tract 5123.08, Santa Clara County, California",0,0,0
1000000US060855123082036,060855123082036,"Block 2036, Block Group 2, Census Tract 5123.08, Santa Clara County, California",5,5,0
1000000US060855123082037,060855123082037,"Block 2037, Block Group 2, Census Tract 5123.08, Santa Clara County, California",0,0,0
1000000US060855123082038,060855123082038,"Block 2038, Block Group 2, Census Tract 5123.08, Santa Clara County, California",11,10,1
1000000US060855123082039,060855123082039,"Block 2039, Block Group 2, Census Tract 5123.08, Santa Clara County, California",15,14,1
1000000US060855123082040,060855123082040,"Block 2040, Block Group 2, Census Tract 5123.08, Santa Clara County, California",2,2,0
1000000US060855123082041,060855123082041,"Block 2041, Block Group 2, Census Tract 5123.08, Santa Clara County, California",0,0,0
1000000US060855123082042,060855123082042,"Block 2042, Block Group 2, Census Tract 5123.08, Santa Clara County, California",0,0,0
1000000US060855123082043,060855123082043,"Block 2043, Block Group 2, Census Tract 5123.08, Santa Clara County, California",0,0,0
1000000US060855123082044,060855123082044,"Block 2044, Block Group 2, Census Tract 5123.08, Santa Clara County, California",0,0,0
1000000US060855123082045,060855123082045,"Block 2045, Block Group 2, Census Tract 5123.08, Santa Clara County, California",11,10,1
1000000US060855123082046,060855123082046,"Block 2046, Block Group 2, Census Tract 5123.08, Santa Clara County, California",10,10,0
1000000US060855123082047,060855123082047,"Block 2047, Block Group 2, Census Tract 5123.08, Santa Clara County, California",56,52,4
1000000US060855123082048,060855123082048,"Block 2048, Block Group 2, Census Tract 5123.08, Santa Clara County, California",10,9,1
1000000US060855123082049,060855123082049,"Block 2049, Block Group 2, Census Tract 5123.08, Santa Clara County, California",12,12,0
1000000US060855123082050,060855123082050,"Block 2050, Block Group 2, Census Tract 5123.08, Santa Clara County, California",21,19,2
1000000US060855123082051,060855123082051,"Block 2051, Block Group 2, Census Tract 5123.08, Santa Clara County, California",11,11,0
1000000US060855123082052,060855123082052,"Block 2052, Block Group 2, Census Tract 5123.08, Santa Clara County, California",0,0,0
1000000US060855123082053,060855123082053,"Block 2053, Block Group 2, Census Tract 5123.08, Santa Clara County, California",0,0,0
1000000US060855123082054,060855123082054,"Block 2054, Block Group 2, Census Tract 5123.08, Santa Clara County, California",12,12,0
1000000US060855123082055,060855123082055,"Block 2055, Block Group 2, Census Tract 5123.08, Santa Clara County, California",0,0,0
1000000US060855123082056,060855123082056,"Block 2056, Block Group 2, Census Tract 5123.08, Santa Clara County, California",1,1,0
1000000US060855123082057,060855123082057,"Block 2057, Block Group 2, Census Tract 5123.08, Santa Clara County, California",0,0,0
1000000US060855123082058,060855123082058,"Block 2058, Block Group 2, Census Tract 5123.08, Santa Clara County, California",0,0,0
1000000US060855123082059,060855123082059,"Block 2059, Block Group 2, Census Tract 5123.08, Santa Clara County, California",0,0,0
1000000US060855123082060,060855123082060,"Block 2060, Block Group 2, Census Tract 5123.08, Santa Clara County, California",17,17,0
1000000US060855123082061,060855123082061,"Block 2061, Block Group 2, Census Tract 5123.08, Santa Clara County, California",0,0,0
1000000US060855123083000,060855123083000,"Block 3000, Block Group 3, Census Tract 5123.08, Santa Clara County, California",0,0,0
1000000US060855123083001,060855123083001,"Block 3001, Block Group 3, Census Tract 5123.08, Santa Clara County, California",122,111,11
1000000US060855123083002,060855123083002,"Block 3002, Block Group 3, Census Tract 5123.08, Santa Clara County, California",0,0,0
1000000US060855123083003,060855123083003,"Block 3003, Block Group 3, Census Tract 5123.08, Santa Clara County, California",6,5,1
1000000US060855123083004,060855123083004,"Block 3004, Block Group 3, Census Tract 5123.08, Santa Clara County, California",0,0,0
1000000US060855123083005,060855123083005,"Block 3005, Block Group 3, Census Tract 5123.08, Santa Clara County, California",0,0,0
1000000US060855123083006,060855123083006,"Block 3006, Block Group 3, Census Tract 5123.08, Santa Clara County, California",0,0,0
1000000US060855123083007,060855123083007,"Block 3007, Block Group 3, Census Tract 5123.08, Santa Clara County, California",0,0,0
1000000US060855123083008,060855123083008,"Block 3008, Block Group 3, Census Tract 5123.08, Santa Clara County, California",0,0,0
1000000US060855123083009,060855123083009,"Block 3009, Block Group 3, Census Tract 5123.08, Santa Clara County, California",0,0,0
1000000US060855123083010,060855123083010,"Block 3010, Block Group 3, Census Tract 5123.08, Santa Clara County, California",0,0,0
1000000US060855123083011,060855123083011,"Block 3011, Block Group 3, Census Tract 5123.08, Santa Clara County, California",0,0,0
1000000US060855123083012,060855123083012,"Block 3012, Block Group 3, Census Tract 5123.08, Santa Clara County, California",1,1,0
1000000US060855123083013,060855123083013,"Block 3013, Block Group 3, Census Tract 5123.08, Santa Clara County, California",0,0,0
1000000US060855123083014,060855123083014,"Block 3014, Block Group 3, Census Tract 5123.08, Santa Clara County, California",1,1,0
1000000US060855123083015,060855123083015,"Block 3015, Block Group 3, Census Tract 5123.08, Santa Clara County, California",0,0,0
1000000US060855123083016,060855123083016,"Block 3016, Block Group 3, Census Tract 5123.08, Santa Clara County, California",0,0,0
1000000US060855123083017,060855123083017,"Block 3017, Block Group 3, Census Tract 5123.08, Santa Clara County, California",91,86,5
1000000US060855123083018,060855123083018,"Block 3018, Block Group 3, Census Tract 5123.08, Santa Clara County, California",14,13,1
1000000US060855123083019,060855123083019,"Block 3019, Block Group 3, Census Tract 5123.08, Santa Clara County, California",2,2,0
1000000US060855123083020,060855123083020,"Block 3020, Block Group 3, Census Tract 5123.08, Santa Clara County, California",23,21,2
1000000US060855123083021,060855123083021,"Block 3021, Block Group 3, Census Tract 5123.08, Santa Clara County, California",14,13,1
1000000US060855123083022,060855123083022,"Block 3022, Block Group 3, Census Tract 5123.08, Santa Clara County, California",6,6,0
1000000US060855123083023,060855123083023,"Block 3023, Block Group 3, Census Tract 5123.08, Santa Clara County, California",7,7,0
1000000US060855123083024,060855123083024,"Block 3024, Block Group 3, Census Tract 5123.08, Santa Clara County, California",15,12,3
1000000US060855123083025,060855123083025,"Block 3025, Block Group 3, Census Tract 5123.08, Santa Clara County, California",18,18,0
1000000US060855123083026,060855123083026,"Block 3026, Block Group 3, Census Tract 5123.08, Santa Clara County, California",2,1,1
1000000US060855123083027,060855123083027,"Block 3027, Block Group 3, Census Tract 5123.08, Santa Clara County, California",235,226,9
1000000US060855123083028,060855123083028,"Block 3028, Block Group 3, Census Tract 5123.08, Santa Clara County, California",77,77,0
1000000US060855123083029,060855123083029,"Block 3029, Block Group 3, Census Tract 5123.08, Santa Clara County, California",35,34,1
1000000US060855123083030,060855123083030,"Block 3030, Block Group 3, Census Tract 5123.08, Santa Clara County, California",0,0,0
1000000US060855123083031,060855123083031,"Block 3031, Block Group 3, Census Tract 5123.08, Santa Clara County, California",33,33,0
1000000US060855123083032,060855123083032,"Block 3032, Block Group 3, Census Tract 5123.08, Santa Clara County, California",9,9,0
1000000US060855123083033,060855123083033,"Block 3033, Block Group 3, Census Tract 5123.08, Santa Clara County, California",30,30,0
1000000US060855123083034,060855123083034,"Block 3034, Block Group 3, Census Tract 5123.08, Santa Clara County, California",29,27,2
1000000US060855123083035,060855123083035,"Block 3035, Block Group 3, Census Tract 5123.08, Santa Clara County, California",36,35,1
1000000US060855123083036,060855123083036,"Block 3036, Block Group 3, Census Tract 5123.08, Santa Clara County, California",0,0,0
1000000US060855123083037,060855123083037,"Block 3037, Block Group 3, Census Tract 5123.08, Santa Clara County, California",12,12,0
1000000US060855123083038,060855123083038,"Block 3038, Block Group 3, Census Tract 5123.08, Santa Clara County, California",1,0,1
1000000US060855123083039,060855123083039,"Block 3039, Block Group 3, Census Tract 5123.08, Santa Clara County, California",0,0,0
1000000US060855123083040,060855123083040,"Block 3040, Block Group 3, Census Tract 5123.08, Santa Clara County, California",0,0,0
1000000US060855123083041,060855123083041,"Block 3041, Block Group 3, Census Tract 5123.08, Santa Clara County, California",0,0,0
1000000US060855123083042,060855123083042,"Block 3042, Block Group 3, Census Tract 5123.08, Santa Clara County, California",0,0,0
1000000US060855123083043,060855123083043,"Block 3043, Block Group 3, Census Tract 5123.08, Santa Clara County, California",1,1,0
1000000US060855123091000,060855123091000,"Block 1000, Block Group 1, Census Tract 5123.09, Santa Clara County, California",0,0,0
1000000US060855123091001,060855123091001,"Block 1001, Block Group 1, Census Tract 5123.09, Santa Clara County, California",0,0,0
1000000US060855123091002,060855123091002,"Block 1002, Block Group 1, Census Tract 5123.09, Santa Clara County, California",0,0,0
1000000US060855123091003,060855123091003,"Block 1003, Block Group 1, Census Tract 5123.09, Santa Clara County, California",66,62,4
1000000US060855123091004,060855123091004,"Block 1004, Block Group 1, Census Tract 5123.09, Santa Clara County, California",70,67,3
1000000US060855123091005,060855123091005,"Block 1005, Block Group 1, Census Tract 5123.09, Santa Clara County, California",16,15,1
1000000US060855123091006,060855123091006,"Block 1006, Block Group 1, Census Tract 5123.09, Santa Clara County, California",16,14,2
1000000US060855123091007,060855123091007,"Block 1007, Block Group 1, Census Tract 5123.09, Santa Clara County, California",19,19,0
1000000US060855123091008,060855123091008,"Block 1008, Block Group 1, Census Tract 5123.09, Santa Clara County, California",0,0,0
1000000US060855123091009,060855123091009,"Block 1009, Block Group 1, Census Tract 5123.09, Santa Clara County, California",92,91,1
1000000US060855123091010,060855123091010,"Block 1010, Block Group 1, Census Tract 5123.09, Santa Clara County, California",190,189,1
1000000US060855123091011,060855123091011,"Block 1011, Block Group 1, Census Tract 5123.09, Santa Clara County, California",12,12,0
1000000US060855123091012,060855123091012,"Block 1012, Block Group 1, Census Tract 5123.09, Santa Clara County, California",0,0,0
1000000US060855123091013,060855123091013,"Block 1013, Block Group 1, Census Tract 5123.09, Santa Clara County, California",8,7,1
1000000US060855123091014,060855123091014,"Block 1014, Block Group 1, Census Tract 5123.09, Santa Clara County, California",12,11,1
1000000US060855123091015,060855123091015,"Block 1015, Block Group 1, Census Tract 5123.09, Santa Clara County, California",5,5,0
1000000US060855123091016,060855123091016,"Block 1016, Block Group 1, Census Tract 5123.09, Santa Clara County, California",1,1,0
1000000US060855123091017,060855123091017,"Block 1017, Block Group 1, Census Tract 5123.09, Santa Clara County, California",0,0,0
1000000US060855123091018,060855123091018,"Block 1018, Block Group 1, Census Tract 5123.09, Santa Clara County, California",69,64,5
1000000US060855123091019,060855123091019,"Block 1019, Block Group 1, Census Tract 5123.09, Santa Clara County, California",9,9,0
1000000US060855123091020,060855123091020,"Block 1020, Block Group 1, Census Tract 5123.09, Santa Clara County, California",11,9,2
1000000US060855123091021,060855123091021,"Block 1021, Block Group 1, Census Tract 5123.09, Santa Clara County, California",22,20,2
1000000US060855123091022,060855123091022,"Block 1022, Block Group 1, Census Tract 5123.09, Santa Clara County, California",0,0,0
1000000US060855123091023,060855123091023,"Block 1023, Block Group 1, Census Tract 5123.09, Santa Clara County, California",27,25,2
1000000US060855123091024,060855123091024,"Block 1024, Block Group 1, Census Tract 5123.09, Santa Clara County, California",0,0,0
1000000US060855123091025,060855123091025,"Block 1025, Block Group 1, Census Tract 5123.09, Santa Clara County, California",1,1,0
1000000US060855123091026,060855123091026,"Block 1026, Block Group 1, Census Tract 5123.09, Santa Clara County, California",22,18,4
1000000US060855123091027,060855123091027,"Block 1027, Block Group 1, Census Tract 5123.09, Santa Clara County, California",46,44,2
1000000US060855123091028,060855123091028,"Block 1028, Block Group 1, Census Tract 5123.09, Santa Clara County, California",24,23,1
1000000US060855123091029,060855123091029,"Block 1029, Block Group 1, Census Tract 5123.09, Santa Clara County, California",0,0,0
1000000US060855123091030,060855123091030,"Block 1030, Block Group 1, Census Tract 5123.09, Santa Clara County, California",0,0,0
1000000US060855123091031,060855123091031,"Block 1031, Block Group 1, Census Tract 5123.09, Santa Clara County, California",18,18,0
1000000US060855123091032,060855123091032,"Block 1032, Block Group 1, Census Tract 5123.09, Santa Clara County, California",19,19,0
1000000US060855123091033,060855123091033,"Block 1033, Block Group 1, Census Tract 5123.09, Santa Clara County, California",4,4,0
1000000US060855123091034,060855123091034,"Block 1034, Block Group 1, Census Tract 5123.09, Santa Clara County, California",0,0,0
1000000US060855123091035,060855123091035,"Block 1035, Block Group 1, Census Tract 5123.09, Santa Clara County, California",0,0,0
1000000US060855123091036,060855123091036,"Block 1036, Block Group 1, Census Tract 5123.09, Santa Clara County, California",0,0,0
1000000US060855123091037,060855123091037,"Block 1037, Block Group 1, Census Tract 5123.09, Santa Clara County, California",0,0,0
1000000US060855123091038,060855123091038,"Block 1038, Block Group 1, Census Tract 5123.09, Santa Clara County, California",0,0,0
1000000US060855123091039,060855123091039,"Block 1039, Block Group 1, Census Tract 5123.09, Santa Clara County, California",0,0,0
1000000US060855123091040,060855123091040,"Block 1040, Block Group 1, Census Tract 5123.09, Santa Clara County, California",0,0,0
1000000US060855123091041,060855123091041,"Block 1041, Block Group 1, Census Tract 5123.09, Santa Clara County, California",2,2,0
1000000US060855123091042,060855123091042,"Block 1042, Block Group 1, Census Tract 5123.09, Santa Clara County, California",15,7,8
1000000US060855123091043,060855123091043,"Block 1043, Block Group 1, Census Tract 5123.09, Santa Clara County, California",31,29,2
1000000US060855123091044,060855123091044,"Block 1044, Block Group 1, Census Tract 5123.09, Santa Clara County, California",3,3,0
1000000US060855123091045,060855123091045,"Block 1045, Block Group 1, Census Tract 5123.09, Santa Clara County, California",27,27,0
1000000US060855123091046,060855123091046,"Block 1046, Block Group 1, Census Tract 5123.09, Santa Clara County, California",0,0,0
1000000US060855123091047,060855123091047,"Block 1047, Block Group 1, Census Tract 5123.09, Santa Clara County, California",0,0,0
1000000US060855123091048,060855123091048,"Block 1048, Block Group 1, Census Tract 5123.09, Santa Clara County, California",3,3,0
1000000US060855123091049,060855123091049,"Block 1049, Block Group 1, Census Tract 5123.09, Santa Clara County, California",38,33,5
1000000US060855123091050,060855123091050,"Block 1050, Block Group 1, Census Tract 5123.09, Santa Clara County, California",16,16,0
1000000US060855123091051,060855123091051,"Block 1051, Block Group 1, Census Tract 5123.09, Santa Clara County, California",0,0,0
1000000US060855123091052,060855123091052,"Block 1052, Block Group 1, Census Tract 5123.09, Santa Clara County, California",0,0,0
1000000US060855123091053,060855123091053,"Block 1053, Block Group 1, Census Tract 5123.09, Santa Clara County, California",8,8,0
1000000US060855123091054,060855123091054,"Block 1054, Block Group 1, Census Tract 5123.09, Santa Clara County, California",18,18,0
1000000US060855123091055,060855123091055,"Block 1055, Block Group 1, Census Tract 5123.09, Santa Clara County, California",0,0,0
1000000US060855123091056,060855123091056,"Block 1056, Block Group 1, Census Tract 5123.09, Santa Clara County, California",0,0,0
1000000US060855123091057,060855123091057,"Block 1057, Block Group 1, Census Tract 5123.09, Santa Clara County, California",44,38,6
1000000US060855123091058,060855123091058,"Block 1058, Block Group 1, Census Tract 5123.09, Santa Clara County, California",18,17,1
1000000US060855123092000,060855123092000,"Block 2000, Block Group 2, Census Tract 5123.09, Santa Clara County, California",552,542,10
1000000US060855123092001,060855123092001,"Block 2001, Block Group 2, Census Tract 5123.09, Santa Clara County, California",16,16,0
1000000US060855123092002,060855123092002,"Block 2002, Block Group 2, Census Tract 5123.09, Santa Clara County, California",0,0,0
1000000US060855123092003,060855123092003,"Block 2003, Block Group 2, Census Tract 5123.09, Santa Clara County, California",43,43,0
1000000US060855123092004,060855123092004,"Block 2004, Block Group 2, Census Tract 5123.09, Santa Clara County, California",0,0,0
1000000US060855123092005,060855123092005,"Block 2005, Block Group 2, Census Tract 5123.09, Santa Clara County, California",12,12,0
1000000US060855123092006,060855123092006,"Block 2006, Block Group 2, Census Tract 5123.09, Santa Clara County, California",0,0,0
1000000US060855123092007,060855123092007,"Block 2007, Block Group 2, Census Tract 5123.09, Santa Clara County, California",34,34,0
1000000US060855123092008,060855123092008,"Block 2008, Block Group 2, Census Tract 5123.09, Santa Clara County, California",60,59,1
1000000US060855123092009,060855123092009,"Block 2009, Block Group 2, Census Tract 5123.09, Santa Clara County, California",2,2,0
1000000US060855123092010,060855123092010,"Block 2010, Block Group 2, Census Tract 5123.09, Santa Clara County, California",3,3,0
1000000US060855123101000,060855123101000,"Block 1000, Block Group 1, Census Tract 5123.10, Santa Clara County, California",0,0,0
1000000US060855123101001,060855123101001,"Block 1001, Block Group 1, Census Tract 5123.10, Santa Clara County, California",0,0,0
1000000US060855123101002,060855123101002,"Block 1002, Block Group 1, Census Tract 5123.10, Santa Clara County, California",0,0,0
1000000US060855123101003,060855123101003,"Block 1003, Block Group 1, Census Tract 5123.10, Santa Clara County, California",62,57,5
1000000US060855123101004,060855123101004,"Block 1004, Block Group 1, Census Tract 5123.10, Santa Clara County, California",0,0,0
1000000US060855123101005,060855123101005,"Block 1005, Block Group 1, Census Tract 5123.10, Santa Clara County, California",0,0,0
1000000US060855123101006,060855123101006,"Block 1006, Block Group 1, Census Tract 5123.10, Santa Clara County, California",0,0,0
1000000US060855123101007,060855123101007,"Block 1007, Block Group 1, Census Tract 5123.10, Santa Clara County, California",137,132,5
1000000US060855123101008,060855123101008,"Block 1008, Block Group 1, Census Tract 5123.10, Santa Clara County, California",0,0,0
1000000US060855123101009,060855123101009,"Block 1009, Block Group 1, Census Tract 5123.10, Santa Clara County, California",191,185,6
1000000US060855123101010,060855123101010,"Block 1010, Block Group 1, Census Tract 5123.10, Santa Clara County, California",52,52,0
1000000US060855123101011,060855123101011,"Block 1011, Block Group 1, Census Tract 5123.10, Santa Clara County, California",14,13,1
1000000US060855123101012,060855123101012,"Block 1012, Block Group 1, Census Tract 5123.10, Santa Clara County, California",0,0,0
1000000US060855123101013,060855123101013,"Block 1013, Block Group 1, Census Tract 5123.10, Santa Clara County, California",16,14,2
1000000US060855123101014,060855123101014,"Block 1014, Block Group 1, Census Tract 5123.10, Santa Clara County, California",18,16,2
1000000US060855123101015,060855123101015,"Block 1015, Block Group 1, Census Tract 5123.10, Santa Clara County, California",0,0,0
1000000US060855123101016,060855123101016,"Block 1016, Block Group 1, Census Tract 5123.10, Santa Clara County, California",16,16,0
1000000US060855123101017,060855123101017,"Block 1017, Block Group 1, Census Tract 5123.10, Santa Clara County, California",16,14,2
1000000US060855123101018,060855123101018,"Block 1018, Block Group 1, Census Tract 5123.10, Santa Clara County, California",3,3,0
1000000US060855123101019,060855123101019,"Block 1019, Block Group 1, Census Tract 5123.10, Santa Clara County, California",2,2,0
1000000US060855123101020,060855123101020,"Block 1020, Block Group 1, Census Tract 5123.10, Santa Clara County, California",1,1,0
1000000US060855123101021,060855123101021,"Block 1021, Block Group 1, Census Tract 5123.10, Santa Clara County, California",16,15,1
1000000US060855123101022,060855123101022,"Block 1022, Block Group 1, Census Tract 5123.10, Santa Clara County, California",9,9,0
1000000US060855123101023,060855123101023,"Block 1023, Block Group 1, Census Tract 5123.10, Santa Clara County, California",111,108,3
1000000US060855123101024,060855123101024,"Block 1024, Block Group 1, Census Tract 5123.10, Santa Clara County, California",24,23,1
1000000US060855123101025,060855123101025,"Block 1025, Block Group 1, Census Tract 5123.10, Santa Clara County, California",21,21,0
1000000US060855123101026,060855123101026,"Block 1026, Block Group 1, Census Tract 5123.10, Santa Clara County, California",0,0,0
1000000US060855123101027,060855123101027,"Block 1027, Block Group 1, Census Tract 5123.10, Santa Clara County, California",1,1,0
1000000US060855123101028,060855123101028,"Block 1028, Block Group 1, Census Tract 5123.10, Santa Clara County, California",1,1,0
1000000US060855123101029,060855123101029,"Block 1029, Block Group 1, Census Tract 5123.10, Santa Clara County, California",43,41,2
1000000US060855123101030,060855123101030,"Block 1030, Block Group 1, Census Tract 5123.10, Santa Clara County, California",0,0,0
1000000US060855123101031,060855123101031,"Block 1031, Block Group 1, Census Tract 5123.10, Santa Clara County, California",146,138,8
1000000US060855123101032,060855123101032,"Block 1032, Block Group 1, Census Tract 5123.10, Santa Clara County, California",0,0,0
1000000US060855123101033,060855123101033,"Block 1033, Block Group 1, Census Tract 5123.10, Santa Clara County, California",1,1,0
1000000US060855123101034,060855123101034,"Block 1034, Block Group 1, Census Tract 5123.10, Santa Clara County, California",0,0,0
1000000US060855123101035,060855123101035,"Block 1035, Block Group 1, Census Tract 5123.10, Santa Clara County, California",0,0,0
1000000US060855123101036,060855123101036,"Block 1036, Block Group 1, Census Tract 5123.10, Santa Clara County, California",0,0,0
1000000US060855123101037,060855123101037,"Block 1037, Block Group 1, Census Tract 5123.10, Santa Clara County, California",0,0,0
1000000US060855123101038,060855123101038,"Block 1038, Block Group 1, Census Tract 5123.10, Santa Clara County, California",0,0,0
1000000US060855123101039,060855123101039,"Block 1039, Block Group 1, Census Tract 5123.10, Santa Clara County, California",0,0,0
1000000US060855123101040,060855123101040,"Block 1040, Block Group 1, Census Tract 5123.10, Santa Clara County, California",0,0,0
1000000US060855123101041,060855123101041,"Block 1041, Block Group 1, Census Tract 5123.10, Santa Clara County, California",0,0,0
1000000US060855123101042,060855123101042,"Block 1042, Block Group 1, Census Tract 5123.10, Santa Clara County, California",4,4,0
1000000US060855123101043,060855123101043,"Block 1043, Block Group 1, Census Tract 5123.10, Santa Clara County, California",0,0,0
1000000US060855123101044,060855123101044,"Block 1044, Block Group 1, Census Tract 5123.10, Santa Clara County, California",0,0,0
1000000US060855123102000,060855123102000,"Block 2000, Block Group 2, Census Tract 5123.10, Santa Clara County, California",0,0,0
1000000US060855123102001,060855123102001,"Block 2001, Block Group 2, Census Tract 5123.10, Santa Clara County, California",0,0,0
1000000US060855123102002,060855123102002,"Block 2002, Block Group 2, Census Tract 5123.10, Santa Clara County, California",0,0,0
1000000US060855123102003,060855123102003,"Block 2003, Block Group 2, Census Tract 5123.10, Santa Clara County, California",52,52,0
1000000US060855123102004,060855123102004,"Block 2004, Block Group 2, Census Tract 5123.10, Santa Clara County, California",26,26,0
1000000US060855123102005,060855123102005,"Block 2005, Block Group 2, Census Tract 5123.10, Santa Clara County, California",0,0,0
1000000US060855123102006,060855123102006,"Block 2006, Block Group 2, Census Tract 5123.10, Santa Clara County, California",0,0,0
1000000US060855123102007,060855123102007,"Block 2007, Block Group 2, Census Tract 5123.10, Santa Clara County, California",0,0,0
1000000US060855123102008,060855123102008,"Block 2008, Block Group 2, Census Tract 5123.10, Santa Clara County, California",0,0,0
1000000US060855123102009,060855123102009,"Block 2009, Block Group 2, Census Tract 5123.10, Santa Clara County, California",0,0,0
1000000US060855123102010,060855123102010,"Block 2010, Block Group 2, Census Tract 5123.10, Santa Clara County, California",0,0,0
1000000US060855123102011,060855123102011,"Block 2011, Block Group 2, Census Tract 5123.10, Santa Clara County, California",0,0,0
1000000US060855123102012,060855123102012,"Block 2012, Block Group 2, Census Tract 5123.10, Santa Clara County, California",0,0,0
1000000US060855123102013,060855123102013,"Block 2013, Block Group 2, Census Tract 5123.10, Santa Clara County, California",0,0,0
1000000US060855123102014,060855123102014,"Block 2014, Block Group 2, Census Tract 5123.10, Santa Clara County, California",3,2,1
1000000US060855123102015,060855123102015,"Block 2015, Block Group 2, Census Tract 5123.10, Santa Clara County, California",0,0,0
1000000US060855123102016,060855123102016,"Block 2016, Block Group 2, Census Tract 5123.10, Santa Clara County, California",0,0,0
1000000US060855123102017,060855123102017,"Block 2017, Block Group 2, Census Tract 5123.10, Santa Clara County, California",0,0,0
1000000US060855123102018,060855123102018,"Block 2018, Block Group 2, Census Tract 5123.10, Santa Clara County, California",0,0,0
1000000US060855123102019,060855123102019,"Block 2019, Block Group 2, Census Tract 5123.10, Santa Clara County, California",0,0,0
1000000US060855123102020,060855123102020,"Block 2020, Block Group 2, Census Tract 5123.10, Santa Clara County, California",0,0,0
1000000US060855123102021,060855123102021,"Block 2021, Block Group 2, Census Tract 5123.10, Santa Clara County, California",0,0,0
1000000US060855123102022,060855123102022,"Block 2022, Block Group 2, Census Tract 5123.10, Santa Clara County, California",0,0,0
1000000US060855123102023,060855123102023,"Block 2023, Block Group 2, Census Tract 5123.10, Santa Clara County, California",26,22,4
1000000US060855123102024,060855123102024,"Block 2024, Block Group 2, Census Tract 5123.10, Santa Clara County, California",0,0,0
1000000US060855123102025,060855123102025,"Block 2025, Block Group 2, Census Tract 5123.10, Santa Clara County, California",4,4,0
1000000US060855123102026,060855123102026,"Block 2026, Block Group 2, Census Tract 5123.10, Santa Clara County, California",10,10,0
1000000US060855123102027,060855123102027,"Block 2027, Block Group 2, Census Tract 5123.10, Santa Clara County, California",2,0,2
1000000US060855123102028,060855123102028,"Block 2028, Block Group 2, Census Tract 5123.10, Santa Clara County, California",0,0,0
1000000US060855123102029,060855123102029,"Block 2029, Block Group 2, Census Tract 5123.10, Santa Clara County, California",0,0,0
1000000US060855123102030,060855123102030,"Block 2030, Block Group 2, Census Tract 5123.10, Santa Clara County, California",5,5,0
1000000US060855123102031,060855123102031,"Block 2031, Block Group 2, Census Tract 5123.10, Santa Clara County, California",0,0,0
1000000US060855123102032,060855123102032,"Block 2032, Block Group 2, Census Tract 5123.10, Santa Clara County, California",0,0,0
1000000US060855123102033,060855123102033,"Block 2033, Block Group 2, Census Tract 5123.10, Santa Clara County, California",0,0,0
1000000US060855123102034,060855123102034,"Block 2034, Block Group 2, Census Tract 5123.10, Santa Clara County, California",0,0,0
1000000US060855123102035,060855123102035,"Block 2035, Block Group 2, Census Tract 5123.10, Santa Clara County, California",0,0,0
1000000US060855123102036,060855123102036,"Block 2036, Block Group 2, Census Tract 5123.10, Santa Clara County, California",0,0,0
1000000US060855123102037,060855123102037,"Block 2037, Block Group 2, Census Tract 5123.10, Santa Clara County, California",0,0,0
1000000US060855123102038,060855123102038,"Block 2038, Block Group 2, Census Tract 5123.10, Santa Clara County, California",0,0,0
1000000US060855123102039,060855123102039,"Block 2039, Block Group 2, Census Tract 5123.10, Santa Clara County, California",0,0,0
1000000US060855123102040,060855123102040,"Block 2040, Block Group 2, Census Tract 5123.10, Santa Clara County, California",0,0,0
1000000US060855123102041,060855123102041,"Block 2041, Block Group 2, Census Tract 5123.10, Santa Clara County, California",44,44,0
1000000US060855123102042,060855123102042,"Block 2042, Block Group 2, Census Tract 5123.10, Santa Clara County, California",10,9,1
1000000US060855123102043,060855123102043,"Block 2043, Block Group 2, Census Tract 5123.10, Santa Clara County, California",13,12,1
1000000US060855123102044,060855123102044,"Block 2044, Block Group 2, Census Tract 5123.10, Santa Clara County, California",17,9,8
1000000US060855123102045,060855123102045,"Block 2045, Block Group 2, Census Tract 5123.10, Santa Clara County, California",41,24,17
1000000US060855123102046,060855123102046,"Block 2046, Block Group 2, Census Tract 5123.10, Santa Clara County, California",6,6,0
1000000US060855123102047,060855123102047,"Block 2047, Block Group 2, Census Tract 5123.10, Santa Clara County, California",0,0,0
1000000US060855123102048,060855123102048,"Block 2048, Block Group 2, Census Tract 5123.10, Santa Clara County, California",0,0,0
1000000US060855123102049,060855123102049,"Block 2049, Block Group 2, Census Tract 5123.10, Santa Clara County, California",0,0,0
1000000US060855123102050,060855123102050,"Block 2050, Block Group 2, Census Tract 5123.10, Santa Clara County, California",47,16,31
1000000US060855123102051,060855123102051,"Block 2051, Block Group 2, Census Tract 5123.10, Santa Clara County, California",8,7,1
1000000US060855123102052,060855123102052,"Block 2052, Block Group 2, Census Tract 5123.10, Santa Clara County, California",26,11,15
1000000US060855123102053,060855123102053,"Block 2053, Block Group 2, Census Tract 5123.10, Santa Clara County, California",0,0,0
1000000US060855123102054,060855123102054,"Block 2054, Block Group 2, Census Tract 5123.10, Santa Clara County, California",25,13,12
1000000US060855123102055,060855123102055,"Block 2055, Block Group 2, Census Tract 5123.10, Santa Clara County, California",0,0,0
1000000US060855123102056,060855123102056,"Block 2056, Block Group 2, Census Tract 5123.10, Santa Clara County, California",0,0,0
1000000US060855123102057,060855123102057,"Block 2057, Block Group 2, Census Tract 5123.10, Santa Clara County, California",0,0,0
1000000US060855123102058,060855123102058,"Block 2058, Block Group 2, Census Tract 5123.10, Santa Clara County, California",0,0,0
1000000US060855123102059,060855123102059,"Block 2059, Block Group 2, Census Tract 5123.10, Santa Clara County, California",0,0,0
1000000US060855123102060,060855123102060,"Block 2060, Block Group 2, Census Tract 5123.10, Santa Clara County, California",3,2,1
1000000US060855123102061,060855123102061,"Block 2061, Block Group 2, Census Tract 5123.10, Santa Clara County, California",12,12,0
1000000US060855123102062,060855123102062,"Block 2062, Block Group 2, Census Tract 5123.10, Santa Clara County, California",12,12,0
1000000US060855123102063,060855123102063,"Block 2063, Block Group 2, Census Tract 5123.10, Santa Clara County, California",0,0,0
1000000US060855123102064,060855123102064,"Block 2064, Block Group 2, Census Tract 5123.10, Santa Clara County, California",0,0,0
1000000US060855123102065,060855123102065,"Block 2065, Block Group 2, Census Tract 5123.10, Santa Clara County, California",81,79,2
1000000US060855123102066,060855123102066,"Block 2066, Block Group 2, Census Tract 5123.10, Santa Clara County, California",0,0,0
1000000US060855123111000,060855123111000,"Block 1000, Block Group 1, Census Tract 5123.11, Santa Clara County, California",10,9,1
1000000US060855123111001,060855123111001,"Block 1001, Block Group 1, Census Tract 5123.11, Santa Clara County, California",22,20,2
1000000US060855123111002,060855123111002,"Block 1002, Block Group 1, Census Tract 5123.11, Santa Clara County, California",1,1,0
1000000US060855123111003,060855123111003,"Block 1003, Block Group 1, Census Tract 5123.11, Santa Clara County, California",21,20,1
1000000US060855123111004,060855123111004,"Block 1004, Block Group 1, Census Tract 5123.11, Santa Clara County, California",13,12,1
1000000US060855123111005,060855123111005,"Block 1005, Block Group 1, Census Tract 5123.11, Santa Clara County, California",6,4,2
1000000US060855123111006,060855123111006,"Block 1006, Block Group 1, Census Tract 5123.11, Santa Clara County, California",23,18,5
1000000US060855123111007,060855123111007,"Block 1007, Block Group 1, Census Tract 5123.11, Santa Clara County, California",0,0,0
1000000US060855123111008,060855123111008,"Block 1008, Block Group 1, Census Tract 5123.11, Santa Clara County, California",100,94,6
1000000US060855123111009,060855123111009,"Block 1009, Block Group 1, Census Tract 5123.11, Santa Clara County, California",12,11,1
1000000US060855123111010,060855123111010,"Block 1010, Block Group 1, Census Tract 5123.11, Santa Clara County, California",13,12,1
1000000US060855123111011,060855123111011,"Block 1011, Block Group 1, Census Tract 5123.11, Santa Clara County, California",0,0,0
1000000US060855123111012,060855123111012,"Block 1012, Block Group 1, Census Tract 5123.11, Santa Clara County, California",0,0,0
1000000US060855123111013,060855123111013,"Block 1013, Block Group 1, Census Tract 5123.11, Santa Clara County, California",0,0,0
1000000US060855123111014,060855123111014,"Block 1014, Block Group 1, Census Tract 5123.11, Santa Clara County, California",0,0,0
1000000US060855123111015,060855123111015,"Block 1015, Block Group 1, Census Tract 5123.11, Santa Clara County, California",0,0,0
1000000US060855123111016,060855123111016,"Block 1016, Block Group 1, Census Tract 5123.11, Santa Clara County, California",109,106,3
1000000US060855123111017,060855123111017,"Block 1017, Block Group 1, Census Tract 5123.11, Santa Clara County, California",48,48,0
1000000US060855123111018,060855123111018,"Block 1018, Block Group 1, Census Tract 5123.11, Santa Clara County, California",0,0,0
1000000US060855123111019,060855123111019,"Block 1019, Block Group 1, Census Tract 5123.11, Santa Clara County, California",0,0,0
1000000US060855123111020,060855123111020,"Block 1020, Block Group 1, Census Tract 5123.11, Santa Clara County, California",0,0,0
1000000US060855123111021,060855123111021,"Block 1021, Block Group 1, Census Tract 5123.11, Santa Clara County, California",0,0,0
1000000US060855123111022,060855123111022,"Block 1022, Block Group 1, Census Tract 5123.11, Santa Clara County, California",13,13,0
1000000US060855123111023,060855123111023,"Block 1023, Block Group 1, Census Tract 5123.11, Santa Clara County, California",2,2,0
1000000US060855123111024,060855123111024,"Block 1024, Block Group 1, Census Tract 5123.11, Santa Clara County, California",29,29,0
1000000US060855123111025,060855123111025,"Block 1025, Block Group 1, Census Tract 5123.11, Santa Clara County, California",0,0,0
1000000US060855123111026,060855123111026,"Block 1026, Block Group 1, Census Tract 5123.11, Santa Clara County, California",0,0,0
1000000US060855123111027,060855123111027,"Block 1027, Block Group 1, Census Tract 5123.11, Santa Clara County, California",0,0,0
1000000US060855123111028,060855123111028,"Block 1028, Block Group 1, Census Tract 5123.11, Santa Clara County, California",0,0,0
1000000US060855123111029,060855123111029,"Block 1029, Block Group 1, Census Tract 5123.11, Santa Clara County, California",0,0,0
1000000US060855123111030,060855123111030,"Block 1030, Block Group 1, Census Tract 5123.11, Santa Clara County, California",33,33,0
1000000US060855123111031,060855123111031,"Block 1031, Block Group 1, Census Tract 5123.11, Santa Clara County, California",0,0,0
1000000US060855123111032,060855123111032,"Block 1032, Block Group 1, Census Tract 5123.11, Santa Clara County, California",34,34,0
1000000US060855123111033,060855123111033,"Block 1033, Block Group 1, Census Tract 5123.11, Santa Clara County, California",0,0,0
1000000US060855123111034,060855123111034,"Block 1034, Block Group 1, Census Tract 5123.11, Santa Clara County, California",28,28,0
1000000US060855123111035,060855123111035,"Block 1035, Block Group 1, Census Tract 5123.11, Santa Clara County, California",0,0,0
1000000US060855123111036,060855123111036,"Block 1036, Block Group 1, Census Tract 5123.11, Santa Clara County, California",0,0,0
1000000US060855123111037,060855123111037,"Block 1037, Block Group 1, Census Tract 5123.11, Santa Clara County, California",0,0,0
1000000US060855123111038,060855123111038,"Block 1038, Block Group 1, Census Tract 5123.11, Santa Clara County, California",0,0,0
1000000US060855123111039,060855123111039,"Block 1039, Block Group 1, Census Tract 5123.11, Santa Clara County, California",0,0,0
1000000US060855123111040,060855123111040,"Block 1040, Block Group 1, Census Tract 5123.11, Santa Clara County, California",0,0,0
1000000US060855123111041,060855123111041,"Block 1041, Block Group 1, Census Tract 5123.11, Santa Clara County, California",0,0,0
1000000US060855123111042,060855123111042,"Block 1042, Block Group 1, Census Tract 5123.11, Santa Clara County, California",0,0,0
1000000US060855123111043,060855123111043,"Block 1043, Block Group 1, Census Tract 5123.11, Santa Clara County, California",3,3,0
1000000US060855123111044,060855123111044,"Block 1044, Block Group 1, Census Tract 5123.11, Santa Clara County, California",0,0,0
1000000US060855123111045,060855123111045,"Block 1045, Block Group 1, Census Tract 5123.11, Santa Clara County, California",0,0,0
1000000US060855123111046,060855123111046,"Block 1046, Block Group 1, Census Tract 5123.11, Santa Clara County, California",2,2,0
1000000US060855123111047,060855123111047,"Block 1047, Block Group 1, Census Tract 5123.11, Santa Clara County, California",5,5,0
1000000US060855123111048,060855123111048,"Block 1048, Block Group 1, Census Tract 5123.11, Santa Clara County, California",11,11,0
1000000US060855123111049,060855123111049,"Block 1049, Block Group 1, Census Tract 5123.11, Santa Clara County, California",0,0,0
1000000US060855123111050,060855123111050,"Block 1050, Block Group 1, Census Tract 5123.11, Santa Clara County, California",0,0,0
1000000US060855123111051,060855123111051,"Block 1051, Block Group 1, Census Tract 5123.11, Santa Clara County, California",17,17,0
1000000US060855123111052,060855123111052,"Block 1052, Block Group 1, Census Tract 5123.11, Santa Clara County, California",24,24,0
1000000US060855123111053,060855123111053,"Block 1053, Block Group 1, Census Tract 5123.11, Santa Clara County, California",12,12,0
1000000US060855123111054,060855123111054,"Block 1054, Block Group 1, Census Tract 5123.11, Santa Clara County, California",23,22,1
1000000US060855123111055,060855123111055,"Block 1055, Block Group 1, Census Tract 5123.11, Santa Clara County, California",22,22,0
1000000US060855123111056,060855123111056,"Block 1056, Block Group 1, Census Tract 5123.11, Santa Clara County, California",25,24,1
1000000US060855123111057,060855123111057,"Block 1057, Block Group 1, Census Tract 5123.11, Santa Clara County, California",35,34,1
1000000US060855123111058,060855123111058,"Block 1058, Block Group 1, Census Tract 5123.11, Santa Clara County, California",62,61,1
1000000US060855123111059,060855123111059,"Block 1059, Block Group 1, Census Tract 5123.11, Santa Clara County, California",0,0,0
1000000US060855123111060,060855123111060,"Block 1060, Block Group 1, Census Tract 5123.11, Santa Clara County, California",0,0,0
1000000US060855123111061,060855123111061,"Block 1061, Block Group 1, Census Tract 5123.11, Santa Clara County, California",0,0,0
1000000US060855123111062,060855123111062,"Block 1062, Block Group 1, Census Tract 5123.11, Santa Clara County, California",0,0,0
1000000US060855123111063,060855123111063,"Block 1063, Block Group 1, Census Tract 5123.11, Santa Clara County, California",0,0,0
1000000US060855123111064,060855123111064,"Block 1064, Block Group 1, Census Tract 5123.11, Santa Clara County, California",0,0,0
1000000US060855123111065,060855123111065,"Block 1065, Block Group 1, Census Tract 5123.11, Santa Clara County, California",0,0,0
1000000US060855123111066,060855123111066,"Block 1066, Block Group 1, Census Tract 5123.11, Santa Clara County, California",0,0,0
1000000US060855123111067,060855123111067,"Block 1067, Block Group 1, Census Tract 5123.11, Santa Clara County, California",0,0,0
1000000US060855123111068,060855123111068,"Block 1068, Block Group 1, Census Tract 5123.11, Santa Clara County, California",0,0,0
1000000US060855123111069,060855123111069,"Block 1069, Block Group 1, Census Tract 5123.11, Santa Clara County, California",0,0,0
1000000US060855123111070,060855123111070,"Block 1070, Block Group 1, Census Tract 5123.11, Santa Clara County, California",0,0,0
1000000US060855123111071,060855123111071,"Block 1071, Block Group 1, Census Tract 5123.11, Santa Clara County, California",0,0,0
1000000US060855123111072,060855123111072,"Block 1072, Block Group 1, Census Tract 5123.11, Santa Clara County, California",0,0,0
1000000US060855123111073,060855123111073,"Block 1073, Block Group 1, Census Tract 5123.11, Santa Clara County, California",0,0,0
1000000US060855123111074,060855123111074,"Block 1074, Block Group 1, Census Tract 5123.11, Santa Clara County, California",0,0,0
1000000US060855123111075,060855123111075,"Block 1075, Block Group 1, Census Tract 5123.11, Santa Clara County, California",0,0,0
1000000US060855123111076,060855123111076,"Block 1076, Block Group 1, Census Tract 5123.11, Santa Clara County, California",0,0,0
1000000US060855123111077,060855123111077,"Block 1077, Block Group 1, Census Tract 5123.11, Santa Clara County, California",0,0,0
1000000US060855123111078,060855123111078,"Block 1078, Block Group 1, Census Tract 5123.11, Santa Clara County, California",27,20,7
1000000US060855123111079,060855123111079,"Block 1079, Block Group 1, Census Tract 5123.11, Santa Clara County, California",20,20,0
1000000US060855123111080,060855123111080,"Block 1080, Block Group 1, Census Tract 5123.11, Santa Clara County, California",0,0,0
1000000US060855123111081,060855123111081,"Block 1081, Block Group 1, Census Tract 5123.11, Santa Clara County, California",15,13,2
1000000US060855123111082,060855123111082,"Block 1082, Block Group 1, Census Tract 5123.11, Santa Clara County, California",0,0,0
1000000US060855123111083,060855123111083,"Block 1083, Block Group 1, Census Tract 5123.11, Santa Clara County, California",3,3,0
1000000US060855123111084,060855123111084,"Block 1084, Block Group 1, Census Tract 5123.11, Santa Clara County, California",0,0,0
1000000US060855123111085,060855123111085,"Block 1085, Block Group 1, Census Tract 5123.11, Santa Clara County, California",0,0,0
1000000US060855123111086,060855123111086,"Block 1086, Block Group 1, Census Tract 5123.11, Santa Clara County, California",0,0,0
1000000US060855123111087,060855123111087,"Block 1087, Block Group 1, Census Tract 5123.11, Santa Clara County, California",0,0,0
1000000US060855123111088,060855123111088,"Block 1088, Block Group 1, Census Tract 5123.11, Santa Clara County, California",0,0,0
1000000US060855123111089,060855123111089,"Block 1089, Block Group 1, Census Tract 5123.11, Santa Clara County, California",0,0,0
1000000US060855123111090,060855123111090,"Block 1090, Block Group 1, Census Tract 5123.11, Santa Clara County, California",24,24,0
1000000US060855123111091,060855123111091,"Block 1091, Block Group 1, Census Tract 5123.11, Santa Clara County, California",0,0,0
1000000US060855123111092,060855123111092,"Block 1092, Block Group 1, Census Tract 5123.11, Santa Clara County, California",0,0,0
1000000US060855123111093,060855123111093,"Block 1093, Block Group 1, Census Tract 5123.11, Santa Clara County, California",14,14,0
1000000US060855123111094,060855123111094,"Block 1094, Block Group 1, Census Tract 5123.11, Santa Clara County, California",0,0,0
1000000US060855123111095,060855123111095,"Block 1095, Block Group 1, Census Tract 5123.11, Santa Clara County, California",0,0,0
1000000US060855123111096,060855123111096,"Block 1096, Block Group 1, Census Tract 5123.11, Santa Clara County, California",0,0,0
1000000US060855123111097,060855123111097,"Block 1097, Block Group 1, Census Tract 5123.11, Santa Clara County, California",0,0,0
1000000US060855123111098,060855123111098,"Block 1098, Block Group 1, Census Tract 5123.11, Santa Clara County, California",158,144,14
1000000US060855123111099,060855123111099,"Block 1099, Block Group 1, Census Tract 5123.11, Santa Clara County, California",9,9,0
1000000US060855123111100,060855123111100,"Block 1100, Block Group 1, Census Tract 5123.11, Santa Clara County, California",11,9,2
1000000US060855123111101,060855123111101,"Block 1101, Block Group 1, Census Tract 5123.11, Santa Clara County, California",0,0,0
1000000US060855123111102,060855123111102,"Block 1102, Block Group 1, Census Tract 5123.11, Santa Clara County, California",9,8,1
1000000US060855123111103,060855123111103,"Block 1103, Block Group 1, Census Tract 5123.11, Santa Clara County, California",0,0,0
1000000US060855123111104,060855123111104,"Block 1104, Block Group 1, Census Tract 5123.11, Santa Clara County, California",0,0,0
1000000US060855123111105,060855123111105,"Block 1105, Block Group 1, Census Tract 5123.11, Santa Clara County, California",0,0,0
1000000US060855123111106,060855123111106,"Block 1106, Block Group 1, Census Tract 5123.11, Santa Clara County, California",8,7,1
1000000US060855123111107,060855123111107,"Block 1107, Block Group 1, Census Tract 5123.11, Santa Clara County, California",2,2,0
1000000US060855123111108,060855123111108,"Block 1108, Block Group 1, Census Tract 5123.11, Santa Clara County, California",10,9,1
1000000US060855123111109,060855123111109,"Block 1109, Block Group 1, Census Tract 5123.11, Santa Clara County, California",13,13,0
1000000US060855123111110,060855123111110,"Block 1110, Block Group 1, Census Tract 5123.11, Santa Clara County, California",0,0,0
1000000US060855123111111,060855123111111,"Block 1111, Block Group 1, Census Tract 5123.11, Santa Clara County, California",0,0,0
1000000US060855123111112,060855123111112,"Block 1112, Block Group 1, Census Tract 5123.11, Santa Clara County, California",0,0,0
1000000US060855123111113,060855123111113,"Block 1113, Block Group 1, Census Tract 5123.11, Santa Clara County, California",0,0,0
1000000US060855123111114,060855123111114,"Block 1114, Block Group 1, Census Tract 5123.11, Santa Clara County, California",0,0,0
1000000US060855123111115,060855123111115,"Block 1115, Block Group 1, Census Tract 5123.11, Santa Clara County, California",1,1,0
1000000US060855123111116,060855123111116,"Block 1116, Block Group 1, Census Tract 5123.11, Santa Clara County, California",0,0,0
1000000US060855123111117,060855123111117,"Block 1117, Block Group 1, Census Tract 5123.11, Santa Clara County, California",0,0,0
1000000US060855123111118,060855123111118,"Block 1118, Block Group 1, Census Tract 5123.11, Santa Clara County, California",0,0,0
1000000US060855123111119,060855123111119,"Block 1119, Block Group 1, Census Tract 5123.11, Santa Clara County, California",0,0,0
1000000US060855123111120,060855123111120,"Block 1120, Block Group 1, Census Tract 5123.11, Santa Clara County, California",0,0,0
1000000US060855123111121,060855123111121,"Block 1121, Block Group 1, Census Tract 5123.11, Santa Clara County, California",2,2,0
1000000US060855123111122,060855123111122,"Block 1122, Block Group 1, Census Tract 5123.11, Santa Clara County, California",0,0,0
1000000US060855123111123,060855123111123,"Block 1123, Block Group 1, Census Tract 5123.11, Santa Clara County, California",0,0,0
1000000US060855123111124,060855123111124,"Block 1124, Block Group 1, Census Tract 5123.11, Santa Clara County, California",0,0,0
1000000US060855123111125,060855123111125,"Block 1125, Block Group 1, Census Tract 5123.11, Santa Clara County, California",0,0,0
1000000US060855123111126,060855123111126,"Block 1126, Block Group 1, Census Tract 5123.11, Santa Clara County, California",0,0,0
1000000US060855123111127,060855123111127,"Block 1127, Block Group 1, Census Tract 5123.11, Santa Clara County, California",0,0,0
1000000US060855123111128,060855123111128,"Block 1128, Block Group 1, Census Tract 5123.11, Santa Clara County, California",0,0,0
1000000US060855123111129,060855123111129,"Block 1129, Block Group 1, Census Tract 5123.11, Santa Clara County, California",0,0,0
1000000US060855123111130,060855123111130,"Block 1130, Block Group 1, Census Tract 5123.11, Santa Clara County, California",0,0,0
1000000US060855123111131,060855123111131,"Block 1131, Block Group 1, Census Tract 5123.11, Santa Clara County, California",0,0,0
1000000US060855123111132,060855123111132,"Block 1132, Block Group 1, Census Tract 5123.11, Santa Clara County, California",0,0,0
1000000US060855123111133,060855123111133,"Block 1133, Block Group 1, Census Tract 5123.11, Santa Clara County, California",0,0,0
1000000US060855123111134,060855123111134,"Block 1134, Block Group 1, Census Tract 5123.11, Santa Clara County, California",0,0,0
1000000US060855123111135,060855123111135,"Block 1135, Block Group 1, Census Tract 5123.11, Santa Clara County, California",0,0,0
1000000US060855123111136,060855123111136,"Block 1136, Block Group 1, Census Tract 5123.11, Santa Clara County, California",0,0,0
1000000US060855123111137,060855123111137,"Block 1137, Block Group 1, Census Tract 5123.11, Santa Clara County, California",0,0,0
1000000US060855123111138,060855123111138,"Block 1138, Block Group 1, Census Tract 5123.11, Santa Clara County, California",0,0,0
1000000US060855123111139,060855123111139,"Block 1139, Block Group 1, Census Tract 5123.11, Santa Clara County, California",0,0,0
1000000US060855123111140,060855123111140,"Block 1140, Block Group 1, Census Tract 5123.11, Santa Clara County, California",0,0,0
1000000US060855123111141,060855123111141,"Block 1141, Block Group 1, Census Tract 5123.11, Santa Clara County, California",96,94,2
1000000US060855123111142,060855123111142,"Block 1142, Block Group 1, Census Tract 5123.11, Santa Clara County, California",0,0,0
1000000US060855123111143,060855123111143,"Block 1143, Block Group 1, Census Tract 5123.11, Santa Clara County, California",0,0,0
1000000US060855123111144,060855123111144,"Block 1144, Block Group 1, Census Tract 5123.11, Santa Clara County, California",0,0,0
1000000US060855123111145,060855123111145,"Block 1145, Block Group 1, Census Tract 5123.11, Santa Clara County, California",0,0,0
1000000US060855123111146,060855123111146,"Block 1146, Block Group 1, Census Tract 5123.11, Santa Clara County, California",0,0,0
1000000US060855123111147,060855123111147,"Block 1147, Block Group 1, Census Tract 5123.11, Santa Clara County, California",0,0,0
1000000US060855123111148,060855123111148,"Block 1148, Block Group 1, Census Tract 5123.11, Santa Clara County, California",0,0,0
1000000US060855123111149,060855123111149,"Block 1149, Block Group 1, Census Tract 5123.11, Santa Clara County, California",1,1,0
1000000US060855123111150,060855123111150,"Block 1150, Block Group 1, Census Tract 5123.11, Santa Clara County, California",0,0,0
1000000US060855123111151,060855123111151,"Block 1151, Block Group 1, Census Tract 5123.11, Santa Clara County, California",0,0,0
1000000US060855123111152,060855123111152,"Block 1152, Block Group 1, Census Tract 5123.11, Santa Clara County, California",0,0,0
1000000US060855123111153,060855123111153,"Block 1153, Block Group 1, Census Tract 5123.11, Santa Clara County, California",0,0,0
1000000US060855123111154,060855123111154,"Block 1154, Block Group 1, Census Tract 5123.11, Santa Clara County, California",0,0,0
1000000US060855123111155,060855123111155,"Block 1155, Block Group 1, Census Tract 5123.11, Santa Clara County, California",0,0,0
1000000US060855123111156,060855123111156,"Block 1156, Block Group 1, Census Tract 5123.11, Santa Clara County, California",0,0,0
1000000US060855123111157,060855123111157,"Block 1157, Block Group 1, Census Tract 5123.11, Santa Clara County, California",0,0,0
1000000US060855123111158,060855123111158,"Block 1158, Block Group 1, Census Tract 5123.11, Santa Clara County, California",0,0,0
1000000US060855123111159,060855123111159,"Block 1159, Block Group 1, Census Tract 5123.11, Santa Clara County, California",0,0,0
1000000US060855123111160,060855123111160,"Block 1160, Block Group 1, Census Tract 5123.11, Santa Clara County, California",0,0,0
1000000US060855123111161,060855123111161,"Block 1161, Block Group 1, Census Tract 5123.11, Santa Clara County, California",0,0,0
1000000US060855123111162,060855123111162,"Block 1162, Block Group 1, Census Tract 5123.11, Santa Clara County, California",0,0,0
1000000US060855123111163,060855123111163,"Block 1163, Block Group 1, Census Tract 5123.11, Santa Clara County, California",0,0,0
1000000US060855123111164,060855123111164,"Block 1164, Block Group 1, Census Tract 5123.11, Santa Clara County, California",0,0,0
1000000US060855123111165,060855123111165,"Block 1165, Block Group 1, Census Tract 5123.11, Santa Clara County, California",0,0,0
1000000US060855123121000,060855123121000,"Block 1000, Block Group 1, Census Tract 5123.12, Santa Clara County, California",0,0,0
1000000US060855123121001,060855123121001,"Block 1001, Block Group 1, Census Tract 5123.12, Santa Clara County, California",0,0,0
1000000US060855123121002,060855123121002,"Block 1002, Block Group 1, Census Tract 5123.12, Santa Clara County, California",139,137,2
1000000US060855123121003,060855123121003,"Block 1003, Block Group 1, Census Tract 5123.12, Santa Clara County, California",27,26,1
1000000US060855123121004,060855123121004,"Block 1004, Block Group 1, Census Tract 5123.12, Santa Clara County, California",0,0,0
1000000US060855123121005,060855123121005,"Block 1005, Block Group 1, Census Tract 5123.12, Santa Clara County, California",0,0,0
1000000US060855123121006,060855123121006,"Block 1006, Block Group 1, Census Tract 5123.12, Santa Clara County, California",0,0,0
1000000US060855123121007,060855123121007,"Block 1007, Block Group 1, Census Tract 5123.12, Santa Clara County, California",0,0,0
1000000US060855123121008,060855123121008,"Block 1008, Block Group 1, Census Tract 5123.12, Santa Clara County, California",19,18,1
1000000US060855123121009,060855123121009,"Block 1009, Block Group 1, Census Tract 5123.12, Santa Clara County, California",30,30,0
1000000US060855123121010,060855123121010,"Block 1010, Block Group 1, Census Tract 5123.12, Santa Clara County, California",20,20,0
1000000US060855123121011,060855123121011,"Block 1011, Block Group 1, Census Tract 5123.12, Santa Clara County, California",0,0,0
1000000US060855123121012,060855123121012,"Block 1012, Block Group 1, Census Tract 5123.12, Santa Clara County, California",30,29,1
1000000US060855123121013,060855123121013,"Block 1013, Block Group 1, Census Tract 5123.12, Santa Clara County, California",0,0,0
1000000US060855123121014,060855123121014,"Block 1014, Block Group 1, Census Tract 5123.12, Santa Clara County, California",169,166,3
1000000US060855123121015,060855123121015,"Block 1015, Block Group 1, Census Tract 5123.12, Santa Clara County, California",0,0,0
1000000US060855123121016,060855123121016,"Block 1016, Block Group 1, Census Tract 5123.12, Santa Clara County, California",0,0,0
1000000US060855123121017,060855123121017,"Block 1017, Block Group 1, Census Tract 5123.12, Santa Clara County, California",0,0,0
1000000US060855123121018,060855123121018,"Block 1018, Block Group 1, Census Tract 5123.12, Santa Clara County, California",0,0,0
1000000US060855123121019,060855123121019,"Block 1019, Block Group 1, Census Tract 5123.12, Santa Clara County, California",0,0,0
1000000US060855123121020,060855123121020,"Block 1020, Block Group 1, Census Tract 5123.12, Santa Clara County, California",31,30,1
1000000US060855123121021,060855123121021,"Block 1021, Block Group 1, Census Tract 5123.12, Santa Clara County, California",44,41,3
1000000US060855123121022,060855123121022,"Block 1022, Block Group 1, Census Tract 5123.12, Santa Clara County, California",111,109,2
1000000US060855123121023,060855123121023,"Block 1023, Block Group 1, Census Tract 5123.12, Santa Clara County, California",15,15,0
1000000US060855123121024,060855123121024,"Block 1024, Block Group 1, Census Tract 5123.12, Santa Clara County, California",67,65,2
1000000US060855123121025,060855123121025,"Block 1025, Block Group 1, Census Tract 5123.12, Santa Clara County, California",21,19,2
1000000US060855123121026,060855123121026,"Block 1026, Block Group 1, Census Tract 5123.12, Santa Clara County, California",106,103,3
1000000US060855123121027,060855123121027,"Block 1027, Block Group 1, Census Tract 5123.12, Santa Clara County, California",15,14,1
1000000US060855123121028,060855123121028,"Block 1028, Block Group 1, Census Tract 5123.12, Santa Clara County, California",15,13,2
1000000US060855123121029,060855123121029,"Block 1029, Block Group 1, Census Tract 5123.12, Santa Clara County, California",15,15,0
1000000US060855123121030,060855123121030,"Block 1030, Block Group 1, Census Tract 5123.12, Santa Clara County, California",0,0,0
1000000US060855123121031,060855123121031,"Block 1031, Block Group 1, Census Tract 5123.12, Santa Clara County, California",14,1,13
1000000US060855123121032,060855123121032,"Block 1032, Block Group 1, Census Tract 5123.12, Santa Clara County, California",0,0,0
1000000US060855123121033,060855123121033,"Block 1033, Block Group 1, Census Tract 5123.12, Santa Clara County, California",0,0,0
1000000US060855123121034,060855123121034,"Block 1034, Block Group 1, Census Tract 5123.12, Santa Clara County, California",0,0,0
1000000US060855123121035,060855123121035,"Block 1035, Block Group 1, Census Tract 5123.12, Santa Clara County, California",65,62,3
1000000US060855123131000,060855123131000,"Block 1000, Block Group 1, Census Tract 5123.13, Santa Clara County, California",0,0,0
1000000US060855123131001,060855123131001,"Block 1001, Block Group 1, Census Tract 5123.13, Santa Clara County, California",13,13,0
1000000US060855123131002,060855123131002,"Block 1002, Block Group 1, Census Tract 5123.13, Santa Clara County, California",1,1,0
1000000US060855123131003,060855123131003,"Block 1003, Block Group 1, Census Tract 5123.13, Santa Clara County, California",0,0,0
1000000US060855123131004,060855123131004,"Block 1004, Block Group 1, Census Tract 5123.13, Santa Clara County, California",13,11,2
1000000US060855123131005,060855123131005,"Block 1005, Block Group 1, Census Tract 5123.13, Santa Clara County, California",16,15,1
1000000US060855123131006,060855123131006,"Block 1006, Block Group 1, Census Tract 5123.13, Santa Clara County, California",8,8,0
1000000US060855123131007,060855123131007,"Block 1007, Block Group 1, Census Tract 5123.13, Santa Clara County, California",0,0,0
1000000US060855123131008,060855123131008,"Block 1008, Block Group 1, Census Tract 5123.13, Santa Clara County, California",16,15,1
1000000US060855123131009,060855123131009,"Block 1009, Block Group 1, Census Tract 5123.13, Santa Clara County, California",66,64,2
1000000US060855123131010,060855123131010,"Block 1010, Block Group 1, Census Tract 5123.13, Santa Clara County, California",64,63,1
1000000US060855123131011,060855123131011,"Block 1011, Block Group 1, Census Tract 5123.13, Santa Clara County, California",189,180,9
1000000US060855123131012,060855123131012,"Block 1012, Block Group 1, Census Tract 5123.13, Santa Clara County, California",205,198,7
1000000US060855123131013,060855123131013,"Block 1013, Block Group 1, Census Tract 5123.13, Santa Clara County, California",48,48,0
1000000US060855123131014,060855123131014,"Block 1014, Block Group 1, Census Tract 5123.13, Santa Clara County, California",16,16,0
1000000US060855123131015,060855123131015,"Block 1015, Block Group 1, Census Tract 5123.13, Santa Clara County, California",3,3,0
1000000US060855123131016,060855123131016,"Block 1016, Block Group 1, Census Tract 5123.13, Santa Clara County, California",4,4,0
1000000US060855123131017,060855123131017,"Block 1017, Block Group 1, Census Tract 5123.13, Santa Clara County, California",4,3,1
1000000US060855123131018,060855123131018,"Block 1018, Block Group 1, Census Tract 5123.13, Santa Clara County, California",35,35,0
1000000US060855123132000,060855123132000,"Block 2000, Block Group 2, Census Tract 5123.13, Santa Clara County, California",73,73,0
1000000US060855123132001,060855123132001,"Block 2001, Block Group 2, Census Tract 5123.13, Santa Clara County, California",0,0,0
1000000US060855123132002,060855123132002,"Block 2002, Block Group 2, Census Tract 5123.13, Santa Clara County, California",0,0,0
1000000US060855123132003,060855123132003,"Block 2003, Block Group 2, Census Tract 5123.13, Santa Clara County, California",0,0,0
1000000US060855123132004,060855123132004,"Block 2004, Block Group 2, Census Tract 5123.13, Santa Clara County, California",3,3,0
1000000US060855123132005,060855123132005,"Block 2005, Block Group 2, Census Tract 5123.13, Santa Clara County, California",149,149,0
1000000US060855123132006,060855123132006,"Block 2006, Block Group 2, Census Tract 5123.13, Santa Clara County, California",10,10,0
1000000US060855123132007,060855123132007,"Block 2007, Block Group 2, Census Tract 5123.13, Santa Clara County, California",63,62,1
1000000US060855123132008,060855123132008,"Block 2008, Block Group 2, Census Tract 5123.13, Santa Clara County, California",0,0,0
1000000US060855123132009,060855123132009,"Block 2009, Block Group 2, Census Tract 5123.13, Santa Clara County, California",2,2,0
1000000US060855123132010,060855123132010,"Block 2010, Block Group 2, Census Tract 5123.13, Santa Clara County, California",10,10,0
1000000US060855123132011,060855123132011,"Block 2011, Block Group 2, Census Tract 5123.13, Santa Clara County, California",0,0,0
1000000US060855123132012,060855123132012,"Block 2012, Block Group 2, Census Tract 5123.13, Santa Clara County, California",10,10,0
1000000US060855123132013,060855123132013,"Block 2013, Block Group 2, Census Tract 5123.13, Santa Clara County, California",0,0,0
1000000US060855123132014,060855123132014,"Block 2014, Block Group 2, Census Tract 5123.13, Santa Clara County, California",0,0,0
1000000US060855123132015,060855123132015,"Block 2015, Block Group 2, Census Tract 5123.13, Santa Clara County, California",64,62,2
1000000US060855123132016,060855123132016,"Block 2016, Block Group 2, Census Tract 5123.13, Santa Clara County, California",24,24,0
1000000US060855123132017,060855123132017,"Block 2017, Block Group 2, Census Tract 5123.13, Santa Clara County, California",0,0,0
1000000US060855123132018,060855123132018,"Block 2018, Block Group 2, Census Tract 5123.13, Santa Clara County, California",0,0,0
1000000US060855123132019,060855123132019,"Block 2019, Block Group 2, Census Tract 5123.13, Santa Clara County, California",0,0,0
1000000US060855123132020,060855123132020,"Block 2020, Block Group 2, Census Tract 5123.13, Santa Clara County, California",24,22,2
1000000US060855123132021,060855123132021,"Block 2021, Block Group 2, Census Tract 5123.13, Santa Clara County, California",11,11,0
1000000US060855123132022,060855123132022,"Block 2022, Block Group 2, Census Tract 5123.13, Santa Clara County, California",11,11,0
1000000US060855123132023,060855123132023,"Block 2023, Block Group 2, Census Tract 5123.13, Santa Clara County, California",0,0,0
1000000US060855123132024,060855123132024,"Block 2024, Block Group 2, Census Tract 5123.13, Santa Clara County, California",7,7,0
1000000US060855123132025,060855123132025,"Block 2025, Block Group 2, Census Tract 5123.13, Santa Clara County, California",9,8,1
1000000US060855123141000,060855123141000,"Block 1000, Block Group 1, Census Tract 5123.14, Santa Clara County, California",35,34,1
1000000US060855123141001,060855123141001,"Block 1001, Block Group 1, Census Tract 5123.14, Santa Clara County, California",0,0,0
1000000US060855123141002,060855123141002,"Block 1002, Block Group 1, Census Tract 5123.14, Santa Clara County, California",5,5,0
1000000US060855123141003,060855123141003,"Block 1003, Block Group 1, Census Tract 5123.14, Santa Clara County, California",191,187,4
1000000US060855123141004,060855123141004,"Block 1004, Block Group 1, Census Tract 5123.14, Santa Clara County, California",1,0,1
1000000US060855123141005,060855123141005,"Block 1005, Block Group 1, Census Tract 5123.14, Santa Clara County, California",1,1,0
1000000US060855123141006,060855123141006,"Block 1006, Block Group 1, Census Tract 5123.14, Santa Clara County, California",14,13,1
1000000US060855123141007,060855123141007,"Block 1007, Block Group 1, Census Tract 5123.14, Santa Clara County, California",2,2,0
1000000US060855123141008,060855123141008,"Block 1008, Block Group 1, Census Tract 5123.14, Santa Clara County, California",7,7,0
1000000US060855123141009,060855123141009,"Block 1009, Block Group 1, Census Tract 5123.14, Santa Clara County, California",37,37,0
1000000US060855123141010,060855123141010,"Block 1010, Block Group 1, Census Tract 5123.14, Santa Clara County, California",1,1,0
1000000US060855123141011,060855123141011,"Block 1011, Block Group 1, Census Tract 5123.14, Santa Clara County, California",10,10,0
1000000US060855123141012,060855123141012,"Block 1012, Block Group 1, Census Tract 5123.14, Santa Clara County, California",9,9,0
1000000US060855123141013,060855123141013,"Block 1013, Block Group 1, Census Tract 5123.14, Santa Clara County, California",0,0,0
1000000US060855123141014,060855123141014,"Block 1014, Block Group 1, Census Tract 5123.14, Santa Clara County, California",0,0,0
1000000US060855123141015,060855123141015,"Block 1015, Block Group 1, Census Tract 5123.14, Santa Clara County, California",64,61,3
1000000US060855123141016,060855123141016,"Block 1016, Block Group 1, Census Tract 5123.14, Santa Clara County, California",19,19,0
1000000US060855123141017,060855123141017,"Block 1017, Block Group 1, Census Tract 5123.14, Santa Clara County, California",0,0,0
1000000US060855123141018,060855123141018,"Block 1018, Block Group 1, Census Tract 5123.14, Santa Clara County, California",33,32,1
1000000US060855123141019,060855123141019,"Block 1019, Block Group 1, Census Tract 5123.14, Santa Clara County, California",46,46,0
1000000US060855123141020,060855123141020,"Block 1020, Block Group 1, Census Tract 5123.14, Santa Clara County, California",0,0,0
1000000US060855123141021,060855123141021,"Block 1021, Block Group 1, Census Tract 5123.14, Santa Clara County, California",13,13,0
1000000US060855123141022,060855123141022,"Block 1022, Block Group 1, Census Tract 5123.14, Santa Clara County, California",27,26,1
1000000US060855123141023,060855123141023,"Block 1023, Block Group 1, Census Tract 5123.14, Santa Clara County, California",41,40,1
1000000US060855123141024,060855123141024,"Block 1024, Block Group 1, Census Tract 5123.14, Santa Clara County, California",35,35,0
1000000US060855123141025,060855123141025,"Block 1025, Block Group 1, Census Tract 5123.14, Santa Clara County, California",5,5,0
1000000US060855123141026,060855123141026,"Block 1026, Block Group 1, Census Tract 5123.14, Santa Clara County, California",0,0,0
1000000US060855123141027,060855123141027,"Block 1027, Block Group 1, Census Tract 5123.14, Santa Clara County, California",0,0,0
1000000US060855123141028,060855123141028,"Block 1028, Block Group 1, Census Tract 5123.14, Santa Clara County, California",3,3,0
1000000US060855123141029,060855123141029,"Block 1029, Block Group 1, Census Tract 5123.14, Santa Clara County, California",6,6,0
1000000US060855123142000,060855123142000,"Block 2000, Block Group 2, Census Tract 5123.14, Santa Clara County, California",20,18,2
1000000US060855123142001,060855123142001,"Block 2001, Block Group 2, Census Tract 5123.14, Santa Clara County, California",80,72,8
1000000US060855123142002,060855123142002,"Block 2002, Block Group 2, Census Tract 5123.14, Santa Clara County, California",18,17,1
1000000US060855123142003,060855123142003,"Block 2003, Block Group 2, Census Tract 5123.14, Santa Clara County, California",18,16,2
1000000US060855123142004,060855123142004,"Block 2004, Block Group 2, Census Tract 5123.14, Santa Clara County, California",0,0,0
1000000US060855123142005,060855123142005,"Block 2005, Block Group 2, Census Tract 5123.14, Santa Clara County, California",0,0,0
1000000US060855123142006,060855123142006,"Block 2006, Block Group 2, Census Tract 5123.14, Santa Clara County, California",9,9,0
1000000US060855123142007,060855123142007,"Block 2007, Block Group 2, Census Tract 5123.14, Santa Clara County, California",0,0,0
1000000US060855123142008,060855123142008,"Block 2008, Block Group 2, Census Tract 5123.14, Santa Clara County, California",0,0,0
1000000US060855123142009,060855123142009,"Block 2009, Block Group 2, Census Tract 5123.14, Santa Clara County, California",67,66,1
1000000US060855123142010,060855123142010,"Block 2010, Block Group 2, Census Tract 5123.14, Santa Clara County, California",46,46,0
1000000US060855123142011,060855123142011,"Block 2011, Block Group 2, Census Tract 5123.14, Santa Clara County, California",12,12,0
1000000US060855123142012,060855123142012,"Block 2012, Block Group 2, Census Tract 5123.14, Santa Clara County, California",12,11,1
1000000US060855123142013,060855123142013,"Block 2013, Block Group 2, Census Tract 5123.14, Santa Clara County, California",9,8,1
1000000US060855123143000,060855123143000,"Block 3000, Block Group 3, Census Tract 5123.14, Santa Clara County, California",0,0,0
1000000US060855123143001,060855123143001,"Block 3001, Block Group 3, Census Tract 5123.14, Santa Clara County, California",1,1,0
1000000US060855123143002,060855123143002,"Block 3002, Block Group 3, Census Tract 5123.14, Santa Clara County, California",0,0,0
1000000US060855123143003,060855123143003,"Block 3003, Block Group 3, Census Tract 5123.14, Santa Clara County, California",75,71,4
1000000US060855123143004,060855123143004,"Block 3004, Block Group 3, Census Tract 5123.14, Santa Clara County, California",0,0,0
1000000US060855123143005,060855123143005,"Block 3005, Block Group 3, Census Tract 5123.14, Santa Clara County, California",0,0,0
1000000US060855123143006,060855123143006,"Block 3006, Block Group 3, Census Tract 5123.14, Santa Clara County, California",38,36,2
1000000US060855123143007,060855123143007,"Block 3007, Block Group 3, Census Tract 5123.14, Santa Clara County, California",196,194,2
1000000US060855123143008,060855123143008,"Block 3008, Block Group 3, Census Tract 5123.14, Santa Clara County, California",49,43,6
1000000US060855123143009,060855123143009,"Block 3009, Block Group 3, Census Tract 5123.14, Santa Clara County, California",19,18,1
1000000US060855123143010,060855123143010,"Block 3010, Block Group 3, Census Tract 5123.14, Santa Clara County, California",28,27,1
1000000US060855123143011,060855123143011,"Block 3011, Block Group 3, Census Tract 5123.14, Santa Clara County, California",18,18,0
1000000US060855123143012,060855123143012,"Block 3012, Block Group 3, Census Tract 5123.14, Santa Clara County, California",0,0,0
1000000US060855123143013,060855123143013,"Block 3013, Block Group 3, Census Tract 5123.14, Santa Clara County, California",10,9,1
1000000US060855123143014,060855123143014,"Block 3014, Block Group 3, Census Tract 5123.14, Santa Clara County, California",0,0,0
1000000US060855123143015,060855123143015,"Block 3015, Block Group 3, Census Tract 5123.14, Santa Clara County, California",20,20,0
1000000US060855123143016,060855123143016,"Block 3016, Block Group 3, Census Tract 5123.14, Santa Clara County, California",60,55,5
1000000US060855123143017,060855123143017,"Block 3017, Block Group 3, Census Tract 5123.14, Santa Clara County, California",50,48,2
1000000US060855123143018,060855123143018,"Block 3018, Block Group 3, Census Tract 5123.14, Santa Clara County, California",99,79,20
1000000US060855123143019,060855123143019,"Block 3019, Block Group 3, Census Tract 5123.14, Santa Clara County, California",16,16,0
1000000US060855123143020,060855123143020,"Block 3020, Block Group 3, Census Tract 5123.14, Santa Clara County, California",20,20,0
1000000US060855123143021,060855123143021,"Block 3021, Block Group 3, Census Tract 5123.14, Santa Clara County, California",0,0,0
1000000US060855123143022,060855123143022,"Block 3022, Block Group 3, Census Tract 5123.14, Santa Clara County, California",0,0,0
1000000US060855123143023,060855123143023,"Block 3023, Block Group 3, Census Tract 5123.14, Santa Clara County, California",1,1,0
1000000US060855123143024,060855123143024,"Block 3024, Block Group 3, Census Tract 5123.14, Santa Clara County, California",0,0,0
1000000US060855123144000,060855123144000,"Block 4000, Block Group 4, Census Tract 5123.14, Santa Clara County, California",0,0,0
1000000US060855123144001,060855123144001,"Block 4001, Block Group 4, Census Tract 5123.14, Santa Clara County, California",31,29,2
1000000US060855123144002,060855123144002,"Block 4002, Block Group 4, Census Tract 5123.14, Santa Clara County, California",8,6,2
1000000US060855123144003,060855123144003,"Block 4003, Block Group 4, Census Tract 5123.14, Santa Clara County, California",0,0,0
1000000US060855123144004,060855123144004,"Block 4004, Block Group 4, Census Tract 5123.14, Santa Clara County, California",24,23,1
1000000US060855123144005,060855123144005,"Block 4005, Block Group 4, Census Tract 5123.14, Santa Clara County, California",23,23,0
1000000US060855123144006,060855123144006,"Block 4006, Block Group 4, Census Tract 5123.14, Santa Clara County, California",0,0,0
1000000US060855123144007,060855123144007,"Block 4007, Block Group 4, Census Tract 5123.14, Santa Clara County, California",0,0,0
1000000US060855123144008,060855123144008,"Block 4008, Block Group 4, Census Tract 5123.14, Santa Clara County, California",14,12,2
1000000US060855123144009,060855123144009,"Block 4009, Block Group 4, Census Tract 5123.14, Santa Clara County, California",32,30,2
1000000US060855123144010,060855123144010,"Block 4010, Block Group 4, Census Tract 5123.14, Santa Clara County, California",50,46,4
1000000US060855123144011,060855123144011,"Block 4011, Block Group 4, Census Tract 5123.14, Santa Clara County, California",150,140,10
1000000US060855123144012,060855123144012,"Block 4012, Block Group 4, Census Tract 5123.14, Santa Clara County, California",18,18,0
1000000US060855123144013,060855123144013,"Block 4013, Block Group 4, Census Tract 5123.14, Santa Clara County, California",0,0,0
1000000US060855123144014,060855123144014,"Block 4014, Block Group 4, Census Tract 5123.14, Santa Clara County, California",0,0,0
1000000US060855123144015,060855123144015,"Block 4015, Block Group 4, Census Tract 5123.14, Santa Clara County, California",0,0,0
1000000US060855123144016,060855123144016,"Block 4016, Block Group 4, Census Tract 5123.14, Santa Clara County, California",9,9,0
1000000US060855123144017,060855123144017,"Block 4017, Block Group 4, Census Tract 5123.14, Santa Clara County, California",0,0,0
1000000US060855123144018,060855123144018,"Block 4018, Block Group 4, Census Tract 5123.14, Santa Clara County, California",24,23,1
1000000US060855123144019,060855123144019,"Block 4019, Block Group 4, Census Tract 5123.14, Santa Clara County, California",0,0,0
1000000US060855124011000,060855124011000,"Block 1000, Block Group 1, Census Tract 5124.01, Santa Clara County, California",20,19,1
1000000US060855124011001,060855124011001,"Block 1001, Block Group 1, Census Tract 5124.01, Santa Clara County, California",2,2,0
1000000US060855124011002,060855124011002,"Block 1002, Block Group 1, Census Tract 5124.01, Santa Clara County, California",53,51,2
1000000US060855124011003,060855124011003,"Block 1003, Block Group 1, Census Tract 5124.01, Santa Clara County, California",37,35,2
1000000US060855124011004,060855124011004,"Block 1004, Block Group 1, Census Tract 5124.01, Santa Clara County, California",48,45,3
1000000US060855124011005,060855124011005,"Block 1005, Block Group 1, Census Tract 5124.01, Santa Clara County, California",40,38,2
1000000US060855124011006,060855124011006,"Block 1006, Block Group 1, Census Tract 5124.01, Santa Clara County, California",102,101,1
1000000US060855124011007,060855124011007,"Block 1007, Block Group 1, Census Tract 5124.01, Santa Clara County, California",2,1,1
1000000US060855124011008,060855124011008,"Block 1008, Block Group 1, Census Tract 5124.01, Santa Clara County, California",60,53,7
1000000US060855124011009,060855124011009,"Block 1009, Block Group 1, Census Tract 5124.01, Santa Clara County, California",20,19,1
1000000US060855124011010,060855124011010,"Block 1010, Block Group 1, Census Tract 5124.01, Santa Clara County, California",6,5,1
1000000US060855124011011,060855124011011,"Block 1011, Block Group 1, Census Tract 5124.01, Santa Clara County, California",0,0,0
1000000US060855124011012,060855124011012,"Block 1012, Block Group 1, Census Tract 5124.01, Santa Clara County, California",22,21,1
1000000US060855124011013,060855124011013,"Block 1013, Block Group 1, Census Tract 5124.01, Santa Clara County, California",12,8,4
1000000US060855124011014,060855124011014,"Block 1014, Block Group 1, Census Tract 5124.01, Santa Clara County, California",5,5,0
1000000US060855124011015,060855124011015,"Block 1015, Block Group 1, Census Tract 5124.01, Santa Clara County, California",0,0,0
1000000US060855124011016,060855124011016,"Block 1016, Block Group 1, Census Tract 5124.01, Santa Clara County, California",0,0,0
1000000US060855124011017,060855124011017,"Block 1017, Block Group 1, Census Tract 5124.01, Santa Clara County, California",0,0,0
1000000US060855124011018,060855124011018,"Block 1018, Block Group 1, Census Tract 5124.01, Santa Clara County, California",0,0,0
1000000US060855124011019,060855124011019,"Block 1019, Block Group 1, Census Tract 5124.01, Santa Clara County, California",10,10,0
1000000US060855124011020,060855124011020,"Block 1020, Block Group 1, Census Tract 5124.01, Santa Clara County, California",4,4,0
1000000US060855124011021,060855124011021,"Block 1021, Block Group 1, Census Tract 5124.01, Santa Clara County, California",9,9,0
1000000US060855124011022,060855124011022,"Block 1022, Block Group 1, Census Tract 5124.01, Santa Clara County, California",1,1,0
1000000US060855124011023,060855124011023,"Block 1023, Block Group 1, Census Tract 5124.01, Santa Clara County, California",3,3,0
1000000US060855124011024,060855124011024,"Block 1024, Block Group 1, Census Tract 5124.01, Santa Clara County, California",0,0,0
1000000US060855124011025,060855124011025,"Block 1025, Block Group 1, Census Tract 5124.01, Santa Clara County, California",0,0,0
1000000US060855124011026,060855124011026,"Block 1026, Block Group 1, Census Tract 5124.01, Santa Clara County, California",0,0,0
1000000US060855124011027,060855124011027,"Block 1027, Block Group 1, Census Tract 5124.01, Santa Clara County, California",0,0,0
1000000US060855124011028,060855124011028,"Block 1028, Block Group 1, Census Tract 5124.01, Santa Clara County, California",5,5,0
1000000US060855124011029,060855124011029,"Block 1029, Block Group 1, Census Tract 5124.01, Santa Clara County, California",10,10,0
1000000US060855124011030,060855124011030,"Block 1030, Block Group 1, Census Tract 5124.01, Santa Clara County, California",0,0,0
1000000US060855124011031,060855124011031,"Block 1031, Block Group 1, Census Tract 5124.01, Santa Clara County, California",2,2,0
1000000US060855124011032,060855124011032,"Block 1032, Block Group 1, Census Tract 5124.01, Santa Clara County, California",5,4,1
1000000US060855124011033,060855124011033,"Block 1033, Block Group 1, Census Tract 5124.01, Santa Clara County, California",30,29,1
1000000US060855124011034,060855124011034,"Block 1034, Block Group 1, Census Tract 5124.01, Santa Clara County, California",2,2,0
1000000US060855124011035,060855124011035,"Block 1035, Block Group 1, Census Tract 5124.01, Santa Clara County, California",14,13,1
1000000US060855124011036,060855124011036,"Block 1036, Block Group 1, Census Tract 5124.01, Santa Clara County, California",10,8,2
1000000US060855124011037,060855124011037,"Block 1037, Block Group 1, Census Tract 5124.01, Santa Clara County, California",54,54,0
1000000US060855124011038,060855124011038,"Block 1038, Block Group 1, Census Tract 5124.01, Santa Clara County, California",0,0,0
1000000US060855124011039,060855124011039,"Block 1039, Block Group 1, Census Tract 5124.01, Santa Clara County, California",1,1,0
1000000US060855124011040,060855124011040,"Block 1040, Block Group 1, Census Tract 5124.01, Santa Clara County, California",26,25,1
1000000US060855124011041,060855124011041,"Block 1041, Block Group 1, Census Tract 5124.01, Santa Clara County, California",0,0,0
1000000US060855124011042,060855124011042,"Block 1042, Block Group 1, Census Tract 5124.01, Santa Clara County, California",0,0,0
1000000US060855124011043,060855124011043,"Block 1043, Block Group 1, Census Tract 5124.01, Santa Clara County, California",0,0,0
1000000US060855124011044,060855124011044,"Block 1044, Block Group 1, Census Tract 5124.01, Santa Clara County, California",0,0,0
1000000US060855124011045,060855124011045,"Block 1045, Block Group 1, Census Tract 5124.01, Santa Clara County, California",0,0,0
1000000US060855124011046,060855124011046,"Block 1046, Block Group 1, Census Tract 5124.01, Santa Clara County, California",9,9,0
1000000US060855124011047,060855124011047,"Block 1047, Block Group 1, Census Tract 5124.01, Santa Clara County, California",95,92,3
1000000US060855124011048,060855124011048,"Block 1048, Block Group 1, Census Tract 5124.01, Santa Clara County, California",0,0,0
1000000US060855124011049,060855124011049,"Block 1049, Block Group 1, Census Tract 5124.01, Santa Clara County, California",7,6,1
1000000US060855124011050,060855124011050,"Block 1050, Block Group 1, Census Tract 5124.01, Santa Clara County, California",0,0,0
1000000US060855124011051,060855124011051,"Block 1051, Block Group 1, Census Tract 5124.01, Santa Clara County, California",0,0,0
1000000US060855124011052,060855124011052,"Block 1052, Block Group 1, Census Tract 5124.01, Santa Clara County, California",0,0,0
1000000US060855124011053,060855124011053,"Block 1053, Block Group 1, Census Tract 5124.01, Santa Clara County, California",0,0,0
1000000US060855124011054,060855124011054,"Block 1054, Block Group 1, Census Tract 5124.01, Santa Clara County, California",0,0,0
1000000US060855124011055,060855124011055,"Block 1055, Block Group 1, Census Tract 5124.01, Santa Clara County, California",2,2,0
1000000US060855124011056,060855124011056,"Block 1056, Block Group 1, Census Tract 5124.01, Santa Clara County, California",25,25,0
1000000US060855124011057,060855124011057,"Block 1057, Block Group 1, Census Tract 5124.01, Santa Clara County, California",8,8,0
1000000US060855124011058,060855124011058,"Block 1058, Block Group 1, Census Tract 5124.01, Santa Clara County, California",0,0,0
1000000US060855124011059,060855124011059,"Block 1059, Block Group 1, Census Tract 5124.01, Santa Clara County, California",2,2,0
1000000US060855124011060,060855124011060,"Block 1060, Block Group 1, Census Tract 5124.01, Santa Clara County, California",7,7,0
1000000US060855124011061,060855124011061,"Block 1061, Block Group 1, Census Tract 5124.01, Santa Clara County, California",11,11,0
1000000US060855124011062,060855124011062,"Block 1062, Block Group 1, Census Tract 5124.01, Santa Clara County, California",0,0,0
1000000US060855124011063,060855124011063,"Block 1063, Block Group 1, Census Tract 5124.01, Santa Clara County, California",0,0,0
1000000US060855124011064,060855124011064,"Block 1064, Block Group 1, Census Tract 5124.01, Santa Clara County, California",0,0,0
1000000US060855124011065,060855124011065,"Block 1065, Block Group 1, Census Tract 5124.01, Santa Clara County, California",0,0,0
1000000US060855124011066,060855124011066,"Block 1066, Block Group 1, Census Tract 5124.01, Santa Clara County, California",7,7,0
1000000US060855124011067,060855124011067,"Block 1067, Block Group 1, Census Tract 5124.01, Santa Clara County, California",0,0,0
1000000US060855124011068,060855124011068,"Block 1068, Block Group 1, Census Tract 5124.01, Santa Clara County, California",5,4,1
1000000US060855124011069,060855124011069,"Block 1069, Block Group 1, Census Tract 5124.01, Santa Clara County, California",8,8,0
1000000US060855124011070,060855124011070,"Block 1070, Block Group 1, Census Tract 5124.01, Santa Clara County, California",0,0,0
1000000US060855124011071,060855124011071,"Block 1071, Block Group 1, Census Tract 5124.01, Santa Clara County, California",0,0,0
1000000US060855124011072,060855124011072,"Block 1072, Block Group 1, Census Tract 5124.01, Santa Clara County, California",0,0,0
1000000US060855124011073,060855124011073,"Block 1073, Block Group 1, Census Tract 5124.01, Santa Clara County, California",0,0,0
1000000US060855124011074,060855124011074,"Block 1074, Block Group 1, Census Tract 5124.01, Santa Clara County, California",23,23,0
1000000US060855124011075,060855124011075,"Block 1075, Block Group 1, Census Tract 5124.01, Santa Clara County, California",0,0,0
1000000US060855124011076,060855124011076,"Block 1076, Block Group 1, Census Tract 5124.01, Santa Clara County, California",6,6,0
1000000US060855124011077,060855124011077,"Block 1077, Block Group 1, Census Tract 5124.01, Santa Clara County, California",7,7,0
1000000US060855124011078,060855124011078,"Block 1078, Block Group 1, Census Tract 5124.01, Santa Clara County, California",3,3,0
1000000US060855124011079,060855124011079,"Block 1079, Block Group 1, Census Tract 5124.01, Santa Clara County, California",0,0,0
1000000US060855124011080,060855124011080,"Block 1080, Block Group 1, Census Tract 5124.01, Santa Clara County, California",1,1,0
1000000US060855124011081,060855124011081,"Block 1081, Block Group 1, Census Tract 5124.01, Santa Clara County, California",0,0,0
1000000US060855124011082,060855124011082,"Block 1082, Block Group 1, Census Tract 5124.01, Santa Clara County, California",0,0,0
1000000US060855124011083,060855124011083,"Block 1083, Block Group 1, Census Tract 5124.01, Santa Clara County, California",4,4,0
1000000US060855124011084,060855124011084,"Block 1084, Block Group 1, Census Tract 5124.01, Santa Clara County, California",3,3,0
1000000US060855124011085,060855124011085,"Block 1085, Block Group 1, Census Tract 5124.01, Santa Clara County, California",1,1,0
1000000US060855124011086,060855124011086,"Block 1086, Block Group 1, Census Tract 5124.01, Santa Clara County, California",33,32,1
1000000US060855124011087,060855124011087,"Block 1087, Block Group 1, Census Tract 5124.01, Santa Clara County, California",1,1,0
1000000US060855124011088,060855124011088,"Block 1088, Block Group 1, Census Tract 5124.01, Santa Clara County, California",0,0,0
1000000US060855124011089,060855124011089,"Block 1089, Block Group 1, Census Tract 5124.01, Santa Clara County, California",7,7,0
1000000US060855124011090,060855124011090,"Block 1090, Block Group 1, Census Tract 5124.01, Santa Clara County, California",4,3,1
1000000US060855124011091,060855124011091,"Block 1091, Block Group 1, Census Tract 5124.01, Santa Clara County, California",0,0,0
1000000US060855124011092,060855124011092,"Block 1092, Block Group 1, Census Tract 5124.01, Santa Clara County, California",0,0,0
1000000US060855124011093,060855124011093,"Block 1093, Block Group 1, Census Tract 5124.01, Santa Clara County, California",0,0,0
1000000US060855124011094,060855124011094,"Block 1094, Block Group 1, Census Tract 5124.01, Santa Clara County, California",0,0,0
1000000US060855124011095,060855124011095,"Block 1095, Block Group 1, Census Tract 5124.01, Santa Clara County, California",0,0,0
1000000US060855124011096,060855124011096,"Block 1096, Block Group 1, Census Tract 5124.01, Santa Clara County, California",0,0,0
1000000US060855124012000,060855124012000,"Block 2000, Block Group 2, Census Tract 5124.01, Santa Clara County, California",13,9,4
1000000US060855124012001,060855124012001,"Block 2001, Block Group 2, Census Tract 5124.01, Santa Clara County, California",0,0,0
1000000US060855124012002,060855124012002,"Block 2002, Block Group 2, Census Tract 5124.01, Santa Clara County, California",0,0,0
1000000US060855124012003,060855124012003,"Block 2003, Block Group 2, Census Tract 5124.01, Santa Clara County, California",20,18,2
1000000US060855124012004,060855124012004,"Block 2004, Block Group 2, Census Tract 5124.01, Santa Clara County, California",14,13,1
1000000US060855124012005,060855124012005,"Block 2005, Block Group 2, Census Tract 5124.01, Santa Clara County, California",44,40,4
1000000US060855124012006,060855124012006,"Block 2006, Block Group 2, Census Tract 5124.01, Santa Clara County, California",0,0,0
1000000US060855124012007,060855124012007,"Block 2007, Block Group 2, Census Tract 5124.01, Santa Clara County, California",15,15,0
1000000US060855124012008,060855124012008,"Block 2008, Block Group 2, Census Tract 5124.01, Santa Clara County, California",5,5,0
1000000US060855124012009,060855124012009,"Block 2009, Block Group 2, Census Tract 5124.01, Santa Clara County, California",0,0,0
1000000US060855124012010,060855124012010,"Block 2010, Block Group 2, Census Tract 5124.01, Santa Clara County, California",0,0,0
1000000US060855124012011,060855124012011,"Block 2011, Block Group 2, Census Tract 5124.01, Santa Clara County, California",0,0,0
1000000US060855124012012,060855124012012,"Block 2012, Block Group 2, Census Tract 5124.01, Santa Clara County, California",0,0,0
1000000US060855124012013,060855124012013,"Block 2013, Block Group 2, Census Tract 5124.01, Santa Clara County, California",8,8,0
1000000US060855124012014,060855124012014,"Block 2014, Block Group 2, Census Tract 5124.01, Santa Clara County, California",11,11,0
1000000US060855124012015,060855124012015,"Block 2015, Block Group 2, Census Tract 5124.01, Santa Clara County, California",60,56,4
1000000US060855124012016,060855124012016,"Block 2016, Block Group 2, Census Tract 5124.01, Santa Clara County, California",7,7,0
1000000US060855124012017,060855124012017,"Block 2017, Block Group 2, Census Tract 5124.01, Santa Clara County, California",11,10,1
1000000US060855124012018,060855124012018,"Block 2018, Block Group 2, Census Tract 5124.01, Santa Clara County, California",22,21,1
1000000US060855124012019,060855124012019,"Block 2019, Block Group 2, Census Tract 5124.01, Santa Clara County, California",9,9,0
1000000US060855124012020,060855124012020,"Block 2020, Block Group 2, Census Tract 5124.01, Santa Clara County, California",1,1,0
1000000US060855124012021,060855124012021,"Block 2021, Block Group 2, Census Tract 5124.01, Santa Clara County, California",11,10,1
1000000US060855124012022,060855124012022,"Block 2022, Block Group 2, Census Tract 5124.01, Santa Clara County, California",32,29,3
1000000US060855124012023,060855124012023,"Block 2023, Block Group 2, Census Tract 5124.01, Santa Clara County, California",0,0,0
1000000US060855124012024,060855124012024,"Block 2024, Block Group 2, Census Tract 5124.01, Santa Clara County, California",3,3,0
1000000US060855124012025,060855124012025,"Block 2025, Block Group 2, Census Tract 5124.01, Santa Clara County, California",2,2,0
1000000US060855124012026,060855124012026,"Block 2026, Block Group 2, Census Tract 5124.01, Santa Clara County, California",0,0,0
1000000US060855124012027,060855124012027,"Block 2027, Block Group 2, Census Tract 5124.01, Santa Clara County, California",18,18,0
1000000US060855124012028,060855124012028,"Block 2028, Block Group 2, Census Tract 5124.01, Santa Clara County, California",16,14,2
1000000US060855124012029,060855124012029,"Block 2029, Block Group 2, Census Tract 5124.01, Santa Clara County, California",0,0,0
1000000US060855124012030,060855124012030,"Block 2030, Block Group 2, Census Tract 5124.01, Santa Clara County, California",14,10,4
1000000US060855124012031,060855124012031,"Block 2031, Block Group 2, Census Tract 5124.01, Santa Clara County, California",17,15,2
1000000US060855124012032,060855124012032,"Block 2032, Block Group 2, Census Tract 5124.01, Santa Clara County, California",18,17,1
1000000US060855124012033,060855124012033,"Block 2033, Block Group 2, Census Tract 5124.01, Santa Clara County, California",11,11,0
1000000US060855124012034,060855124012034,"Block 2034, Block Group 2, Census Tract 5124.01, Santa Clara County, California",31,28,3
1000000US060855124012035,060855124012035,"Block 2035, Block Group 2, Census Tract 5124.01, Santa Clara County, California",0,0,0
1000000US060855124012036,060855124012036,"Block 2036, Block Group 2, Census Tract 5124.01, Santa Clara County, California",52,52,0
1000000US060855124012037,060855124012037,"Block 2037, Block Group 2, Census Tract 5124.01, Santa Clara County, California",0,0,0
1000000US060855124012038,060855124012038,"Block 2038, Block Group 2, Census Tract 5124.01, Santa Clara County, California",21,20,1
1000000US060855124012039,060855124012039,"Block 2039, Block Group 2, Census Tract 5124.01, Santa Clara County, California",0,0,0
1000000US060855124012040,060855124012040,"Block 2040, Block Group 2, Census Tract 5124.01, Santa Clara County, California",0,0,0
1000000US060855124012041,060855124012041,"Block 2041, Block Group 2, Census Tract 5124.01, Santa Clara County, California",2,2,0
1000000US060855124012042,060855124012042,"Block 2042, Block Group 2, Census Tract 5124.01, Santa Clara County, California",1,1,0
1000000US060855124012043,060855124012043,"Block 2043, Block Group 2, Census Tract 5124.01, Santa Clara County, California",1,1,0
1000000US060855124012044,060855124012044,"Block 2044, Block Group 2, Census Tract 5124.01, Santa Clara County, California",2,2,0
1000000US060855124012045,060855124012045,"Block 2045, Block Group 2, Census Tract 5124.01, Santa Clara County, California",10,10,0
1000000US060855124012046,060855124012046,"Block 2046, Block Group 2, Census Tract 5124.01, Santa Clara County, California",0,0,0
1000000US060855124012047,060855124012047,"Block 2047, Block Group 2, Census Tract 5124.01, Santa Clara County, California",1,1,0
1000000US060855124012048,060855124012048,"Block 2048, Block Group 2, Census Tract 5124.01, Santa Clara County, California",91,89,2
1000000US060855124012049,060855124012049,"Block 2049, Block Group 2, Census Tract 5124.01, Santa Clara County, California",0,0,0
1000000US060855124012050,060855124012050,"Block 2050, Block Group 2, Census Tract 5124.01, Santa Clara County, California",0,0,0
1000000US060855124012051,060855124012051,"Block 2051, Block Group 2, Census Tract 5124.01, Santa Clara County, California",0,0,0
1000000US060855124012052,060855124012052,"Block 2052, Block Group 2, Census Tract 5124.01, Santa Clara County, California",2,2,0
1000000US060855124012053,060855124012053,"Block 2053, Block Group 2, Census Tract 5124.01, Santa Clara County, California",9,9,0
1000000US060855124012054,060855124012054,"Block 2054, Block Group 2, Census Tract 5124.01, Santa Clara County, California",4,4,0
1000000US060855124012055,060855124012055,"Block 2055, Block Group 2, Census Tract 5124.01, Santa Clara County, California",0,0,0
1000000US060855124021000,060855124021000,"Block 1000, Block Group 1, Census Tract 5124.02, Santa Clara County, California",37,33,4
1000000US060855124021001,060855124021001,"Block 1001, Block Group 1, Census Tract 5124.02, Santa Clara County, California",24,22,2
1000000US060855124021002,060855124021002,"Block 1002, Block Group 1, Census Tract 5124.02, Santa Clara County, California",35,32,3
1000000US060855124021003,060855124021003,"Block 1003, Block Group 1, Census Tract 5124.02, Santa Clara County, California",18,17,1
1000000US060855124021004,060855124021004,"Block 1004, Block Group 1, Census Tract 5124.02, Santa Clara County, California",0,0,0
1000000US060855124021005,060855124021005,"Block 1005, Block Group 1, Census Tract 5124.02, Santa Clara County, California",26,23,3
1000000US060855124021006,060855124021006,"Block 1006, Block Group 1, Census Tract 5124.02, Santa Clara County, California",11,9,2
1000000US060855124021007,060855124021007,"Block 1007, Block Group 1, Census Tract 5124.02, Santa Clara County, California",4,4,0
1000000US060855124021008,060855124021008,"Block 1008, Block Group 1, Census Tract 5124.02, Santa Clara County, California",35,32,3
1000000US060855124021009,060855124021009,"Block 1009, Block Group 1, Census Tract 5124.02, Santa Clara County, California",72,68,4
1000000US060855124021010,060855124021010,"Block 1010, Block Group 1, Census Tract 5124.02, Santa Clara County, California",104,96,8
1000000US060855124021011,060855124021011,"Block 1011, Block Group 1, Census Tract 5124.02, Santa Clara County, California",22,21,1
1000000US060855124021012,060855124021012,"Block 1012, Block Group 1, Census Tract 5124.02, Santa Clara County, California",0,0,0
1000000US060855124021013,060855124021013,"Block 1013, Block Group 1, Census Tract 5124.02, Santa Clara County, California",0,0,0
1000000US060855124021014,060855124021014,"Block 1014, Block Group 1, Census Tract 5124.02, Santa Clara County, California",21,20,1
1000000US060855124021015,060855124021015,"Block 1015, Block Group 1, Census Tract 5124.02, Santa Clara County, California",0,0,0
1000000US060855124021016,060855124021016,"Block 1016, Block Group 1, Census Tract 5124.02, Santa Clara County, California",0,0,0
1000000US060855124021017,060855124021017,"Block 1017, Block Group 1, Census Tract 5124.02, Santa Clara County, California",0,0,0
1000000US060855124021018,060855124021018,"Block 1018, Block Group 1, Census Tract 5124.02, Santa Clara County, California",0,0,0
1000000US060855124021019,060855124021019,"Block 1019, Block Group 1, Census Tract 5124.02, Santa Clara County, California",35,29,6
1000000US060855124021020,060855124021020,"Block 1020, Block Group 1, Census Tract 5124.02, Santa Clara County, California",2,2,0
1000000US060855124021021,060855124021021,"Block 1021, Block Group 1, Census Tract 5124.02, Santa Clara County, California",21,20,1
1000000US060855124021022,060855124021022,"Block 1022, Block Group 1, Census Tract 5124.02, Santa Clara County, California",46,44,2
1000000US060855124021023,060855124021023,"Block 1023, Block Group 1, Census Tract 5124.02, Santa Clara County, California",3,3,0
1000000US060855124021024,060855124021024,"Block 1024, Block Group 1, Census Tract 5124.02, Santa Clara County, California",71,68,3
1000000US060855124021025,060855124021025,"Block 1025, Block Group 1, Census Tract 5124.02, Santa Clara County, California",0,0,0
1000000US060855124021026,060855124021026,"Block 1026, Block Group 1, Census Tract 5124.02, Santa Clara County, California",0,0,0
1000000US060855124021027,060855124021027,"Block 1027, Block Group 1, Census Tract 5124.02, Santa Clara County, California",0,0,0
1000000US060855124021028,060855124021028,"Block 1028, Block Group 1, Census Tract 5124.02, Santa Clara County, California",0,0,0
1000000US060855124021029,060855124021029,"Block 1029, Block Group 1, Census Tract 5124.02, Santa Clara County, California",1,0,1
1000000US060855124021030,060855124021030,"Block 1030, Block Group 1, Census Tract 5124.02, Santa Clara County, California",63,59,4
1000000US060855124021031,060855124021031,"Block 1031, Block Group 1, Census Tract 5124.02, Santa Clara County, California",79,76,3
1000000US060855124021032,060855124021032,"Block 1032, Block Group 1, Census Tract 5124.02, Santa Clara County, California",19,19,0
1000000US060855124021033,060855124021033,"Block 1033, Block Group 1, Census Tract 5124.02, Santa Clara County, California",37,37,0
1000000US060855124021034,060855124021034,"Block 1034, Block Group 1, Census Tract 5124.02, Santa Clara County, California",55,52,3
1000000US060855124021035,060855124021035,"Block 1035, Block Group 1, Census Tract 5124.02, Santa Clara County, California",5,5,0
1000000US060855124021036,060855124021036,"Block 1036, Block Group 1, Census Tract 5124.02, Santa Clara County, California",3,3,0
1000000US060855124021037,060855124021037,"Block 1037, Block Group 1, Census Tract 5124.02, Santa Clara County, California",2,2,0
1000000US060855124021038,060855124021038,"Block 1038, Block Group 1, Census Tract 5124.02, Santa Clara County, California",75,72,3
1000000US060855124021039,060855124021039,"Block 1039, Block Group 1, Census Tract 5124.02, Santa Clara County, California",1,1,0
1000000US060855124021040,060855124021040,"Block 1040, Block Group 1, Census Tract 5124.02, Santa Clara County, California",17,17,0
1000000US060855124021041,060855124021041,"Block 1041, Block Group 1, Census Tract 5124.02, Santa Clara County, California",48,44,4
1000000US060855124021042,060855124021042,"Block 1042, Block Group 1, Census Tract 5124.02, Santa Clara County, California",0,0,0
1000000US060855124022000,060855124022000,"Block 2000, Block Group 2, Census Tract 5124.02, Santa Clara County, California",0,0,0
1000000US060855124022001,060855124022001,"Block 2001, Block Group 2, Census Tract 5124.02, Santa Clara County, California",16,16,0
1000000US060855124022002,060855124022002,"Block 2002, Block Group 2, Census Tract 5124.02, Santa Clara County, California",1,1,0
1000000US060855124022003,060855124022003,"Block 2003, Block Group 2, Census Tract 5124.02, Santa Clara County, California",11,10,1
1000000US060855124022004,060855124022004,"Block 2004, Block Group 2, Census Tract 5124.02, Santa Clara County, California",1,1,0
1000000US060855124022005,060855124022005,"Block 2005, Block Group 2, Census Tract 5124.02, Santa Clara County, California",5,5,0
1000000US060855124022006,060855124022006,"Block 2006, Block Group 2, Census Tract 5124.02, Santa Clara County, California",5,5,0
1000000US060855124022007,060855124022007,"Block 2007, Block Group 2, Census Tract 5124.02, Santa Clara County, California",2,2,0
1000000US060855124022008,060855124022008,"Block 2008, Block Group 2, Census Tract 5124.02, Santa Clara County, California",13,11,2
1000000US060855124022009,060855124022009,"Block 2009, Block Group 2, Census Tract 5124.02, Santa Clara County, California",0,0,0
1000000US060855124022010,060855124022010,"Block 2010, Block Group 2, Census Tract 5124.02, Santa Clara County, California",0,0,0
1000000US060855124022011,060855124022011,"Block 2011, Block Group 2, Census Tract 5124.02, Santa Clara County, California",0,0,0
1000000US060855124022012,060855124022012,"Block 2012, Block Group 2, Census Tract 5124.02, Santa Clara County, California",12,11,1
1000000US060855124022013,060855124022013,"Block 2013, Block Group 2, Census Tract 5124.02, Santa Clara County, California",3,3,0
1000000US060855124022014,060855124022014,"Block 2014, Block Group 2, Census Tract 5124.02, Santa Clara County, California",0,0,0
1000000US060855124022015,060855124022015,"Block 2015, Block Group 2, Census Tract 5124.02, Santa Clara County, California",0,0,0
1000000US060855124022016,060855124022016,"Block 2016, Block Group 2, Census Tract 5124.02, Santa Clara County, California",0,0,0
1000000US060855124022017,060855124022017,"Block 2017, Block Group 2, Census Tract 5124.02, Santa Clara County, California",0,0,0
1000000US060855124022018,060855124022018,"Block 2018, Block Group 2, Census Tract 5124.02, Santa Clara County, California",0,0,0
1000000US060855124022019,060855124022019,"Block 2019, Block Group 2, Census Tract 5124.02, Santa Clara County, California",48,46,2
1000000US060855124022020,060855124022020,"Block 2020, Block Group 2, Census Tract 5124.02, Santa Clara County, California",1,1,0
1000000US060855124022021,060855124022021,"Block 2021, Block Group 2, Census Tract 5124.02, Santa Clara County, California",9,6,3
1000000US060855124022022,060855124022022,"Block 2022, Block Group 2, Census Tract 5124.02, Santa Clara County, California",1,1,0
1000000US060855124022023,060855124022023,"Block 2023, Block Group 2, Census Tract 5124.02, Santa Clara County, California",27,26,1
1000000US060855124022024,060855124022024,"Block 2024, Block Group 2, Census Tract 5124.02, Santa Clara County, California",17,16,1
1000000US060855124022025,060855124022025,"Block 2025, Block Group 2, Census Tract 5124.02, Santa Clara County, California",30,29,1
1000000US060855124022026,060855124022026,"Block 2026, Block Group 2, Census Tract 5124.02, Santa Clara County, California",4,4,0
1000000US060855124022027,060855124022027,"Block 2027, Block Group 2, Census Tract 5124.02, Santa Clara County, California",6,6,0
1000000US060855124022028,060855124022028,"Block 2028, Block Group 2, Census Tract 5124.02, Santa Clara County, California",0,0,0
1000000US060855124022029,060855124022029,"Block 2029, Block Group 2, Census Tract 5124.02, Santa Clara County, California",0,0,0
1000000US060855124022030,060855124022030,"Block 2030, Block Group 2, Census Tract 5124.02, Santa Clara County, California",18,18,0
1000000US060855124022031,060855124022031,"Block 2031, Block Group 2, Census Tract 5124.02, Santa Clara County, California",24,22,2
1000000US060855124022032,060855124022032,"Block 2032, Block Group 2, Census Tract 5124.02, Santa Clara County, California",44,40,4
1000000US060855124022033,060855124022033,"Block 2033, Block Group 2, Census Tract 5124.02, Santa Clara County, California",0,0,0
1000000US060855124022034,060855124022034,"Block 2034, Block Group 2, Census Tract 5124.02, Santa Clara County, California",17,17,0
1000000US060855124023000,060855124023000,"Block 3000, Block Group 3, Census Tract 5124.02, Santa Clara County, California",0,0,0
1000000US060855124023001,060855124023001,"Block 3001, Block Group 3, Census Tract 5124.02, Santa Clara County, California",54,52,2
1000000US060855124023002,060855124023002,"Block 3002, Block Group 3, Census Tract 5124.02, Santa Clara County, California",0,0,0
1000000US060855124023003,060855124023003,"Block 3003, Block Group 3, Census Tract 5124.02, Santa Clara County, California",0,0,0
1000000US060855124023004,060855124023004,"Block 3004, Block Group 3, Census Tract 5124.02, Santa Clara County, California",0,0,0
1000000US060855124023005,060855124023005,"Block 3005, Block Group 3, Census Tract 5124.02, Santa Clara County, California",0,0,0
1000000US060855124023006,060855124023006,"Block 3006, Block Group 3, Census Tract 5124.02, Santa Clara County, California",1,1,0
1000000US060855124023007,060855124023007,"Block 3007, Block Group 3, Census Tract 5124.02, Santa Clara County, California",7,6,1
1000000US060855124023008,060855124023008,"Block 3008, Block Group 3, Census Tract 5124.02, Santa Clara County, California",11,11,0
1000000US060855124023009,060855124023009,"Block 3009, Block Group 3, Census Tract 5124.02, Santa Clara County, California",2,2,0
1000000US060855124023010,060855124023010,"Block 3010, Block Group 3, Census Tract 5124.02, Santa Clara County, California",2,2,0
1000000US060855124023011,060855124023011,"Block 3011, Block Group 3, Census Tract 5124.02, Santa Clara County, California",33,30,3
1000000US060855124023012,060855124023012,"Block 3012, Block Group 3, Census Tract 5124.02, Santa Clara County, California",0,0,0
1000000US060855124023013,060855124023013,"Block 3013, Block Group 3, Census Tract 5124.02, Santa Clara County, California",0,0,0
1000000US060855124023014,060855124023014,"Block 3014, Block Group 3, Census Tract 5124.02, Santa Clara County, California",18,17,1
1000000US060855124023015,060855124023015,"Block 3015, Block Group 3, Census Tract 5124.02, Santa Clara County, California",6,6,0
1000000US060855124023016,060855124023016,"Block 3016, Block Group 3, Census Tract 5124.02, Santa Clara County, California",67,62,5
1000000US060855124023017,060855124023017,"Block 3017, Block Group 3, Census Tract 5124.02, Santa Clara County, California",0,0,0
1000000US060855124023018,060855124023018,"Block 3018, Block Group 3, Census Tract 5124.02, Santa Clara County, California",0,0,0
1000000US060855124023019,060855124023019,"Block 3019, Block Group 3, Census Tract 5124.02, Santa Clara County, California",0,0,0
1000000US060855124023020,060855124023020,"Block 3020, Block Group 3, Census Tract 5124.02, Santa Clara County, California",1,1,0
1000000US060855124023021,060855124023021,"Block 3021, Block Group 3, Census Tract 5124.02, Santa Clara County, California",0,0,0
1000000US060855124023022,060855124023022,"Block 3022, Block Group 3, Census Tract 5124.02, Santa Clara County, California",0,0,0
1000000US060855124023023,060855124023023,"Block 3023, Block Group 3, Census Tract 5124.02, Santa Clara County, California",0,0,0
1000000US060855124023024,060855124023024,"Block 3024, Block Group 3, Census Tract 5124.02, Santa Clara County, California",0,0,0
1000000US060855124023025,060855124023025,"Block 3025, Block Group 3, Census Tract 5124.02, Santa Clara County, California",24,24,0
1000000US060855124023026,060855124023026,"Block 3026, Block Group 3, Census Tract 5124.02, Santa Clara County, California",1,1,0
1000000US060855124023027,060855124023027,"Block 3027, Block Group 3, Census Tract 5124.02, Santa Clara County, California",63,61,2
1000000US060855124023028,060855124023028,"Block 3028, Block Group 3, Census Tract 5124.02, Santa Clara County, California",0,0,0
1000000US060855124023029,060855124023029,"Block 3029, Block Group 3, Census Tract 5124.02, Santa Clara County, California",0,0,0
1000000US060855124023030,060855124023030,"Block 3030, Block Group 3, Census Tract 5124.02, Santa Clara County, California",8,6,2
1000000US060855124023031,060855124023031,"Block 3031, Block Group 3, Census Tract 5124.02, Santa Clara County, California",19,19,0
1000000US060855124023032,060855124023032,"Block 3032, Block Group 3, Census Tract 5124.02, Santa Clara County, California",1,1,0
1000000US060855124023033,060855124023033,"Block 3033, Block Group 3, Census Tract 5124.02, Santa Clara County, California",2,2,0
1000000US060855124023034,060855124023034,"Block 3034, Block Group 3, Census Tract 5124.02, Santa Clara County, California",1,1,0
1000000US060855124023035,060855124023035,"Block 3035, Block Group 3, Census Tract 5124.02, Santa Clara County, California",0,0,0
1000000US060855124023036,060855124023036,"Block 3036, Block Group 3, Census Tract 5124.02, Santa Clara County, California",0,0,0
1000000US060855124023037,060855124023037,"Block 3037, Block Group 3, Census Tract 5124.02, Santa Clara County, California",0,0,0
1000000US060855124023038,060855124023038,"Block 3038, Block Group 3, Census Tract 5124.02, Santa Clara County, California",0,0,0
1000000US060855124023039,060855124023039,"Block 3039, Block Group 3, Census Tract 5124.02, Santa Clara County, California",0,0,0
1000000US060855125031000,060855125031000,"Block 1000, Block Group 1, Census Tract 5125.03, Santa Clara County, California",3,3,0
1000000US060855125031001,060855125031001,"Block 1001, Block Group 1, Census Tract 5125.03, Santa Clara County, California",0,0,0
1000000US060855125031002,060855125031002,"Block 1002, Block Group 1, Census Tract 5125.03, Santa Clara County, California",96,93,3
1000000US060855125031003,060855125031003,"Block 1003, Block Group 1, Census Tract 5125.03, Santa Clara County, California",9,9,0
1000000US060855125031004,060855125031004,"Block 1004, Block Group 1, Census Tract 5125.03, Santa Clara County, California",10,10,0
1000000US060855125031005,060855125031005,"Block 1005, Block Group 1, Census Tract 5125.03, Santa Clara County, California",0,0,0
1000000US060855125031006,060855125031006,"Block 1006, Block Group 1, Census Tract 5125.03, Santa Clara County, California",10,10,0
1000000US060855125031007,060855125031007,"Block 1007, Block Group 1, Census Tract 5125.03, Santa Clara County, California",0,0,0
1000000US060855125031008,060855125031008,"Block 1008, Block Group 1, Census Tract 5125.03, Santa Clara County, California",0,0,0
1000000US060855125031009,060855125031009,"Block 1009, Block Group 1, Census Tract 5125.03, Santa Clara County, California",310,304,6
1000000US060855125031010,060855125031010,"Block 1010, Block Group 1, Census Tract 5125.03, Santa Clara County, California",9,8,1
1000000US060855125031011,060855125031011,"Block 1011, Block Group 1, Census Tract 5125.03, Santa Clara County, California",33,33,0
1000000US060855125031012,060855125031012,"Block 1012, Block Group 1, Census Tract 5125.03, Santa Clara County, California",38,37,1
1000000US060855125031013,060855125031013,"Block 1013, Block Group 1, Census Tract 5125.03, Santa Clara County, California",46,45,1
1000000US060855125031014,060855125031014,"Block 1014, Block Group 1, Census Tract 5125.03, Santa Clara County, California",37,37,0
1000000US060855125031015,060855125031015,"Block 1015, Block Group 1, Census Tract 5125.03, Santa Clara County, California",4,4,0
1000000US060855125031016,060855125031016,"Block 1016, Block Group 1, Census Tract 5125.03, Santa Clara County, California",5,5,0
1000000US060855125031017,060855125031017,"Block 1017, Block Group 1, Census Tract 5125.03, Santa Clara County, California",7,7,0
1000000US060855125031018,060855125031018,"Block 1018, Block Group 1, Census Tract 5125.03, Santa Clara County, California",33,30,3
1000000US060855125031019,060855125031019,"Block 1019, Block Group 1, Census Tract 5125.03, Santa Clara County, California",30,24,6
1000000US060855125031020,060855125031020,"Block 1020, Block Group 1, Census Tract 5125.03, Santa Clara County, California",4,4,0
1000000US060855125031021,060855125031021,"Block 1021, Block Group 1, Census Tract 5125.03, Santa Clara County, California",1,1,0
1000000US060855125031022,060855125031022,"Block 1022, Block Group 1, Census Tract 5125.03, Santa Clara County, California",185,179,6
1000000US060855125031023,060855125031023,"Block 1023, Block Group 1, Census Tract 5125.03, Santa Clara County, California",52,51,1
1000000US060855125031024,060855125031024,"Block 1024, Block Group 1, Census Tract 5125.03, Santa Clara County, California",15,14,1
1000000US060855125031025,060855125031025,"Block 1025, Block Group 1, Census Tract 5125.03, Santa Clara County, California",12,12,0
1000000US060855125031026,060855125031026,"Block 1026, Block Group 1, Census Tract 5125.03, Santa Clara County, California",12,11,1
1000000US060855125031027,060855125031027,"Block 1027, Block Group 1, Census Tract 5125.03, Santa Clara County, California",0,0,0
1000000US060855125031028,060855125031028,"Block 1028, Block Group 1, Census Tract 5125.03, Santa Clara County, California",175,170,5
1000000US060855125031029,060855125031029,"Block 1029, Block Group 1, Census Tract 5125.03, Santa Clara County, California",27,26,1
1000000US060855125031030,060855125031030,"Block 1030, Block Group 1, Census Tract 5125.03, Santa Clara County, California",28,28,0
1000000US060855125031031,060855125031031,"Block 1031, Block Group 1, Census Tract 5125.03, Santa Clara County, California",0,0,0
1000000US060855125031032,060855125031032,"Block 1032, Block Group 1, Census Tract 5125.03, Santa Clara County, California",48,48,0
1000000US060855125031033,060855125031033,"Block 1033, Block Group 1, Census Tract 5125.03, Santa Clara County, California",21,19,2
1000000US060855125031034,060855125031034,"Block 1034, Block Group 1, Census Tract 5125.03, Santa Clara County, California",40,39,1
1000000US060855125031035,060855125031035,"Block 1035, Block Group 1, Census Tract 5125.03, Santa Clara County, California",39,39,0
1000000US060855125031036,060855125031036,"Block 1036, Block Group 1, Census Tract 5125.03, Santa Clara County, California",8,7,1
1000000US060855125031037,060855125031037,"Block 1037, Block Group 1, Census Tract 5125.03, Santa Clara County, California",0,0,0
1000000US060855125031038,060855125031038,"Block 1038, Block Group 1, Census Tract 5125.03, Santa Clara County, California",3,3,0
1000000US060855125031039,060855125031039,"Block 1039, Block Group 1, Census Tract 5125.03, Santa Clara County, California",46,45,1
1000000US060855125031040,060855125031040,"Block 1040, Block Group 1, Census Tract 5125.03, Santa Clara County, California",12,12,0
1000000US060855125031041,060855125031041,"Block 1041, Block Group 1, Census Tract 5125.03, Santa Clara County, California",19,18,1
1000000US060855125031042,060855125031042,"Block 1042, Block Group 1, Census Tract 5125.03, Santa Clara County, California",10,10,0
1000000US060855125032000,060855125032000,"Block 2000, Block Group 2, Census Tract 5125.03, Santa Clara County, California",0,0,0
1000000US060855125032001,060855125032001,"Block 2001, Block Group 2, Census Tract 5125.03, Santa Clara County, California",51,50,1
1000000US060855125032002,060855125032002,"Block 2002, Block Group 2, Census Tract 5125.03, Santa Clara County, California",14,14,0
1000000US060855125032003,060855125032003,"Block 2003, Block Group 2, Census Tract 5125.03, Santa Clara County, California",39,36,3
1000000US060855125032004,060855125032004,"Block 2004, Block Group 2, Census Tract 5125.03, Santa Clara County, California",27,27,0
1000000US060855125032005,060855125032005,"Block 2005, Block Group 2, Census Tract 5125.03, Santa Clara County, California",45,45,0
1000000US060855125032006,060855125032006,"Block 2006, Block Group 2, Census Tract 5125.03, Santa Clara County, California",62,60,2
1000000US060855125032007,060855125032007,"Block 2007, Block Group 2, Census Tract 5125.03, Santa Clara County, California",93,93,0
1000000US060855125032008,060855125032008,"Block 2008, Block Group 2, Census Tract 5125.03, Santa Clara County, California",13,13,0
1000000US060855125032009,060855125032009,"Block 2009, Block Group 2, Census Tract 5125.03, Santa Clara County, California",95,95,0
1000000US060855125032010,060855125032010,"Block 2010, Block Group 2, Census Tract 5125.03, Santa Clara County, California",0,0,0
1000000US060855125032011,060855125032011,"Block 2011, Block Group 2, Census Tract 5125.03, Santa Clara County, California",29,28,1
1000000US060855125032012,060855125032012,"Block 2012, Block Group 2, Census Tract 5125.03, Santa Clara County, California",26,24,2
1000000US060855125032013,060855125032013,"Block 2013, Block Group 2, Census Tract 5125.03, Santa Clara County, California",41,41,0
1000000US060855125032014,060855125032014,"Block 2014, Block Group 2, Census Tract 5125.03, Santa Clara County, California",28,26,2
1000000US060855125032015,060855125032015,"Block 2015, Block Group 2, Census Tract 5125.03, Santa Clara County, California",32,30,2
1000000US060855125032016,060855125032016,"Block 2016, Block Group 2, Census Tract 5125.03, Santa Clara County, California",58,55,3
1000000US060855125032017,060855125032017,"Block 2017, Block Group 2, Census Tract 5125.03, Santa Clara County, California",35,32,3
1000000US060855125032018,060855125032018,"Block 2018, Block Group 2, Census Tract 5125.03, Santa Clara County, California",0,0,0
1000000US060855125032019,060855125032019,"Block 2019, Block Group 2, Census Tract 5125.03, Santa Clara County, California",120,116,4
1000000US060855125032020,060855125032020,"Block 2020, Block Group 2, Census Tract 5125.03, Santa Clara County, California",4,4,0
1000000US060855125032021,060855125032021,"Block 2021, Block Group 2, Census Tract 5125.03, Santa Clara County, California",15,15,0
1000000US060855125032022,060855125032022,"Block 2022, Block Group 2, Census Tract 5125.03, Santa Clara County, California",3,3,0
1000000US060855125032023,060855125032023,"Block 2023, Block Group 2, Census Tract 5125.03, Santa Clara County, California",8,8,0
1000000US060855125032024,060855125032024,"Block 2024, Block Group 2, Census Tract 5125.03, Santa Clara County, California",4,4,0
1000000US060855125032025,060855125032025,"Block 2025, Block Group 2, Census Tract 5125.03, Santa Clara County, California",18,18,0
1000000US060855125032026,060855125032026,"Block 2026, Block Group 2, Census Tract 5125.03, Santa Clara County, California",5,5,0
1000000US060855125032027,060855125032027,"Block 2027, Block Group 2, Census Tract 5125.03, Santa Clara County, California",4,4,0
1000000US060855125032028,060855125032028,"Block 2028, Block Group 2, Census Tract 5125.03, Santa Clara County, California",15,15,0
1000000US060855125032029,060855125032029,"Block 2029, Block Group 2, Census Tract 5125.03, Santa Clara County, California",33,31,2
1000000US060855125032030,060855125032030,"Block 2030, Block Group 2, Census Tract 5125.03, Santa Clara County, California",13,12,1
1000000US060855125032031,060855125032031,"Block 2031, Block Group 2, Census Tract 5125.03, Santa Clara County, California",0,0,0
1000000US060855125032032,060855125032032,"Block 2032, Block Group 2, Census Tract 5125.03, Santa Clara County, California",0,0,0
1000000US060855125032033,060855125032033,"Block 2033, Block Group 2, Census Tract 5125.03, Santa Clara County, California",0,0,0
1000000US060855125032034,060855125032034,"Block 2034, Block Group 2, Census Tract 5125.03, Santa Clara County, California",0,0,0
1000000US060855125032035,060855125032035,"Block 2035, Block Group 2, Census Tract 5125.03, Santa Clara County, California",43,34,9
1000000US060855125032036,060855125032036,"Block 2036, Block Group 2, Census Tract 5125.03, Santa Clara County, California",0,0,0
1000000US060855125032037,060855125032037,"Block 2037, Block Group 2, Census Tract 5125.03, Santa Clara County, California",0,0,0
1000000US060855125032038,060855125032038,"Block 2038, Block Group 2, Census Tract 5125.03, Santa Clara County, California",12,12,0
1000000US060855125032039,060855125032039,"Block 2039, Block Group 2, Census Tract 5125.03, Santa Clara County, California",22,20,2
1000000US060855125032040,060855125032040,"Block 2040, Block Group 2, Census Tract 5125.03, Santa Clara County, California",24,24,0
1000000US060855125032041,060855125032041,"Block 2041, Block Group 2, Census Tract 5125.03, Santa Clara County, California",3,3,0
1000000US060855125051000,060855125051000,"Block 1000, Block Group 1, Census Tract 5125.05, Santa Clara County, California",0,0,0
1000000US060855125051001,060855125051001,"Block 1001, Block Group 1, Census Tract 5125.05, Santa Clara County, California",58,56,2
1000000US060855125051002,060855125051002,"Block 1002, Block Group 1, Census Tract 5125.05, Santa Clara County, California",23,21,2
1000000US060855125051003,060855125051003,"Block 1003, Block Group 1, Census Tract 5125.05, Santa Clara County, California",1,1,0
1000000US060855125051004,060855125051004,"Block 1004, Block Group 1, Census Tract 5125.05, Santa Clara County, California",9,8,1
1000000US060855125051005,060855125051005,"Block 1005, Block Group 1, Census Tract 5125.05, Santa Clara County, California",0,0,0
1000000US060855125051006,060855125051006,"Block 1006, Block Group 1, Census Tract 5125.05, Santa Clara County, California",0,0,0
1000000US060855125051007,060855125051007,"Block 1007, Block Group 1, Census Tract 5125.05, Santa Clara County, California",0,0,0
1000000US060855125051008,060855125051008,"Block 1008, Block Group 1, Census Tract 5125.05, Santa Clara County, California",15,15,0
1000000US060855125051009,060855125051009,"Block 1009, Block Group 1, Census Tract 5125.05, Santa Clara County, California",32,32,0
1000000US060855125051010,060855125051010,"Block 1010, Block Group 1, Census Tract 5125.05, Santa Clara County, California",169,166,3
1000000US060855125051011,060855125051011,"Block 1011, Block Group 1, Census Tract 5125.05, Santa Clara County, California",25,24,1
1000000US060855125051012,060855125051012,"Block 1012, Block Group 1, Census Tract 5125.05, Santa Clara County, California",39,37,2
1000000US060855125051013,060855125051013,"Block 1013, Block Group 1, Census Tract 5125.05, Santa Clara County, California",29,29,0
1000000US060855125051014,060855125051014,"Block 1014, Block Group 1, Census Tract 5125.05, Santa Clara County, California",14,14,0
1000000US060855125051015,060855125051015,"Block 1015, Block Group 1, Census Tract 5125.05, Santa Clara County, California",4,4,0
1000000US060855125051016,060855125051016,"Block 1016, Block Group 1, Census Tract 5125.05, Santa Clara County, California",126,123,3
1000000US060855125051017,060855125051017,"Block 1017, Block Group 1, Census Tract 5125.05, Santa Clara County, California",21,20,1
1000000US060855125051018,060855125051018,"Block 1018, Block Group 1, Census Tract 5125.05, Santa Clara County, California",25,25,0
1000000US060855125051019,060855125051019,"Block 1019, Block Group 1, Census Tract 5125.05, Santa Clara County, California",0,0,0
1000000US060855125051020,060855125051020,"Block 1020, Block Group 1, Census Tract 5125.05, Santa Clara County, California",27,27,0
1000000US060855125051021,060855125051021,"Block 1021, Block Group 1, Census Tract 5125.05, Santa Clara County, California",9,9,0
1000000US060855125051022,060855125051022,"Block 1022, Block Group 1, Census Tract 5125.05, Santa Clara County, California",10,10,0
1000000US060855125051023,060855125051023,"Block 1023, Block Group 1, Census Tract 5125.05, Santa Clara County, California",34,34,0
1000000US060855125051024,060855125051024,"Block 1024, Block Group 1, Census Tract 5125.05, Santa Clara County, California",0,0,0
1000000US060855125051025,060855125051025,"Block 1025, Block Group 1, Census Tract 5125.05, Santa Clara County, California",110,106,4
1000000US060855125051026,060855125051026,"Block 1026, Block Group 1, Census Tract 5125.05, Santa Clara County, California",3,3,0
1000000US060855125051027,060855125051027,"Block 1027, Block Group 1, Census Tract 5125.05, Santa Clara County, California",0,0,0
1000000US060855125051028,060855125051028,"Block 1028, Block Group 1, Census Tract 5125.05, Santa Clara County, California",18,17,1
1000000US060855125051029,060855125051029,"Block 1029, Block Group 1, Census Tract 5125.05, Santa Clara County, California",24,22,2
1000000US060855125051030,060855125051030,"Block 1030, Block Group 1, Census Tract 5125.05, Santa Clara County, California",24,23,1
1000000US060855125051031,060855125051031,"Block 1031, Block Group 1, Census Tract 5125.05, Santa Clara County, California",23,23,0
1000000US060855125051032,060855125051032,"Block 1032, Block Group 1, Census Tract 5125.05, Santa Clara County, California",172,168,4
1000000US060855125051033,060855125051033,"Block 1033, Block Group 1, Census Tract 5125.05, Santa Clara County, California",8,8,0
1000000US060855125051034,060855125051034,"Block 1034, Block Group 1, Census Tract 5125.05, Santa Clara County, California",6,6,0
1000000US060855125051035,060855125051035,"Block 1035, Block Group 1, Census Tract 5125.05, Santa Clara County, California",23,23,0
1000000US060855125051036,060855125051036,"Block 1036, Block Group 1, Census Tract 5125.05, Santa Clara County, California",61,56,5
1000000US060855125051037,060855125051037,"Block 1037, Block Group 1, Census Tract 5125.05, Santa Clara County, California",0,0,0
1000000US060855125051038,060855125051038,"Block 1038, Block Group 1, Census Tract 5125.05, Santa Clara County, California",0,0,0
1000000US060855125051039,060855125051039,"Block 1039, Block Group 1, Census Tract 5125.05, Santa Clara County, California",58,56,2
1000000US060855125051040,060855125051040,"Block 1040, Block Group 1, Census Tract 5125.05, Santa Clara County, California",1,1,0
1000000US060855125052000,060855125052000,"Block 2000, Block Group 2, Census Tract 5125.05, Santa Clara County, California",63,62,1
1000000US060855125052001,060855125052001,"Block 2001, Block Group 2, Census Tract 5125.05, Santa Clara County, California",25,24,1
1000000US060855125052002,060855125052002,"Block 2002, Block Group 2, Census Tract 5125.05, Santa Clara County, California",24,24,0
1000000US060855125052003,060855125052003,"Block 2003, Block Group 2, Census Tract 5125.05, Santa Clara County, California",22,22,0
1000000US060855125052004,060855125052004,"Block 2004, Block Group 2, Census Tract 5125.05, Santa Clara County, California",25,22,3
1000000US060855125052005,060855125052005,"Block 2005, Block Group 2, Census Tract 5125.05, Santa Clara County, California",26,26,0
1000000US060855125052006,060855125052006,"Block 2006, Block Group 2, Census Tract 5125.05, Santa Clara County, California",121,101,20
1000000US060855125052007,060855125052007,"Block 2007, Block Group 2, Census Tract 5125.05, Santa Clara County, California",147,136,11
1000000US060855125052008,060855125052008,"Block 2008, Block Group 2, Census Tract 5125.05, Santa Clara County, California",12,12,0
1000000US060855125052009,060855125052009,"Block 2009, Block Group 2, Census Tract 5125.05, Santa Clara County, California",19,18,1
1000000US060855125052010,060855125052010,"Block 2010, Block Group 2, Census Tract 5125.05, Santa Clara County, California",151,140,11
1000000US060855125052011,060855125052011,"Block 2011, Block Group 2, Census Tract 5125.05, Santa Clara County, California",159,154,5
1000000US060855125052012,060855125052012,"Block 2012, Block Group 2, Census Tract 5125.05, Santa Clara County, California",64,62,2
1000000US060855125052013,060855125052013,"Block 2013, Block Group 2, Census Tract 5125.05, Santa Clara County, California",0,0,0
1000000US060855125052014,060855125052014,"Block 2014, Block Group 2, Census Tract 5125.05, Santa Clara County, California",45,42,3
1000000US060855125052015,060855125052015,"Block 2015, Block Group 2, Census Tract 5125.05, Santa Clara County, California",6,6,0
1000000US060855125052016,060855125052016,"Block 2016, Block Group 2, Census Tract 5125.05, Santa Clara County, California",12,12,0
1000000US060855125052017,060855125052017,"Block 2017, Block Group 2, Census Tract 5125.05, Santa Clara County, California",8,8,0
1000000US060855125052018,060855125052018,"Block 2018, Block Group 2, Census Tract 5125.05, Santa Clara County, California",0,0,0
1000000US060855125052019,060855125052019,"Block 2019, Block Group 2, Census Tract 5125.05, Santa Clara County, California",0,0,0
1000000US060855125052020,060855125052020,"Block 2020, Block Group 2, Census Tract 5125.05, Santa Clara County, California",0,0,0
1000000US060855125052021,060855125052021,"Block 2021, Block Group 2, Census Tract 5125.05, Santa Clara County, California",0,0,0
1000000US060855125052022,060855125052022,"Block 2022, Block Group 2, Census Tract 5125.05, Santa Clara County, California",0,0,0
1000000US060855125061000,060855125061000,"Block 1000, Block Group 1, Census Tract 5125.06, Santa Clara County, California",4,4,0
1000000US060855125061001,060855125061001,"Block 1001, Block Group 1, Census Tract 5125.06, Santa Clara County, California",99,96,3
1000000US060855125061002,060855125061002,"Block 1002, Block Group 1, Census Tract 5125.06, Santa Clara County, California",20,20,0
1000000US060855125061003,060855125061003,"Block 1003, Block Group 1, Census Tract 5125.06, Santa Clara County, California",64,63,1
1000000US060855125061004,060855125061004,"Block 1004, Block Group 1, Census Tract 5125.06, Santa Clara County, California",10,10,0
1000000US060855125061005,060855125061005,"Block 1005, Block Group 1, Census Tract 5125.06, Santa Clara County, California",24,23,1
1000000US060855125061006,060855125061006,"Block 1006, Block Group 1, Census Tract 5125.06, Santa Clara County, California",2,2,0
1000000US060855125061007,060855125061007,"Block 1007, Block Group 1, Census Tract 5125.06, Santa Clara County, California",16,16,0
1000000US060855125061008,060855125061008,"Block 1008, Block Group 1, Census Tract 5125.06, Santa Clara County, California",29,29,0
1000000US060855125061009,060855125061009,"Block 1009, Block Group 1, Census Tract 5125.06, Santa Clara County, California",31,28,3
1000000US060855125061010,060855125061010,"Block 1010, Block Group 1, Census Tract 5125.06, Santa Clara County, California",5,5,0
1000000US060855125061011,060855125061011,"Block 1011, Block Group 1, Census Tract 5125.06, Santa Clara County, California",17,17,0
1000000US060855125061012,060855125061012,"Block 1012, Block Group 1, Census Tract 5125.06, Santa Clara County, California",84,84,0
1000000US060855125061013,060855125061013,"Block 1013, Block Group 1, Census Tract 5125.06, Santa Clara County, California",61,59,2
1000000US060855125061014,060855125061014,"Block 1014, Block Group 1, Census Tract 5125.06, Santa Clara County, California",0,0,0
1000000US060855125061015,060855125061015,"Block 1015, Block Group 1, Census Tract 5125.06, Santa Clara County, California",53,52,1
1000000US060855125061016,060855125061016,"Block 1016, Block Group 1, Census Tract 5125.06, Santa Clara County, California",0,0,0
1000000US060855125062000,060855125062000,"Block 2000, Block Group 2, Census Tract 5125.06, Santa Clara County, California",25,24,1
1000000US060855125062001,060855125062001,"Block 2001, Block Group 2, Census Tract 5125.06, Santa Clara County, California",0,0,0
1000000US060855125062002,060855125062002,"Block 2002, Block Group 2, Census Tract 5125.06, Santa Clara County, California",19,18,1
1000000US060855125062003,060855125062003,"Block 2003, Block Group 2, Census Tract 5125.06, Santa Clara County, California",4,4,0
1000000US060855125062004,060855125062004,"Block 2004, Block Group 2, Census Tract 5125.06, Santa Clara County, California",18,18,0
1000000US060855125062005,060855125062005,"Block 2005, Block Group 2, Census Tract 5125.06, Santa Clara County, California",24,24,0
1000000US060855125062006,060855125062006,"Block 2006, Block Group 2, Census Tract 5125.06, Santa Clara County, California",10,10,0
1000000US060855125062007,060855125062007,"Block 2007, Block Group 2, Census Tract 5125.06, Santa Clara County, California",0,0,0
1000000US060855125062008,060855125062008,"Block 2008, Block Group 2, Census Tract 5125.06, Santa Clara County, California",3,3,0
1000000US060855125062009,060855125062009,"Block 2009, Block Group 2, Census Tract 5125.06, Santa Clara County, California",4,4,0
1000000US060855125062010,060855125062010,"Block 2010, Block Group 2, Census Tract 5125.06, Santa Clara County, California",4,4,0
1000000US060855125062011,060855125062011,"Block 2011, Block Group 2, Census Tract 5125.06, Santa Clara County, California",4,4,0
1000000US060855125062012,060855125062012,"Block 2012, Block Group 2, Census Tract 5125.06, Santa Clara County, California",10,10,0
1000000US060855125062013,060855125062013,"Block 2013, Block Group 2, Census Tract 5125.06, Santa Clara County, California",10,10,0
1000000US060855125062014,060855125062014,"Block 2014, Block Group 2, Census Tract 5125.06, Santa Clara County, California",9,9,0
1000000US060855125062015,060855125062015,"Block 2015, Block Group 2, Census Tract 5125.06, Santa Clara County, California",8,8,0
1000000US060855125062016,060855125062016,"Block 2016, Block Group 2, Census Tract 5125.06, Santa Clara County, California",6,6,0
1000000US060855125062017,060855125062017,"Block 2017, Block Group 2, Census Tract 5125.06, Santa Clara County, California",7,7,0
1000000US060855125062018,060855125062018,"Block 2018, Block Group 2, Census Tract 5125.06, Santa Clara County, California",7,7,0
1000000US060855125062019,060855125062019,"Block 2019, Block Group 2, Census Tract 5125.06, Santa Clara County, California",21,21,0
1000000US060855125062020,060855125062020,"Block 2020, Block Group 2, Census Tract 5125.06, Santa Clara County, California",21,21,0
1000000US060855125062021,060855125062021,"Block 2021, Block Group 2, Census Tract 5125.06, Santa Clara County, California",41,41,0
1000000US060855125062022,060855125062022,"Block 2022, Block Group 2, Census Tract 5125.06, Santa Clara County, California",29,27,2
1000000US060855125062023,060855125062023,"Block 2023, Block Group 2, Census Tract 5125.06, Santa Clara County, California",18,18,0
1000000US060855125062024,060855125062024,"Block 2024, Block Group 2, Census Tract 5125.06, Santa Clara County, California",7,6,1
1000000US060855125062025,060855125062025,"Block 2025, Block Group 2, Census Tract 5125.06, Santa Clara County, California",6,6,0
1000000US060855125062026,060855125062026,"Block 2026, Block Group 2, Census Tract 5125.06, Santa Clara County, California",0,0,0
1000000US060855125062027,060855125062027,"Block 2027, Block Group 2, Census Tract 5125.06, Santa Clara County, California",0,0,0
1000000US060855125062028,060855125062028,"Block 2028, Block Group 2, Census Tract 5125.06, Santa Clara County, California",9,9,0
1000000US060855125062029,060855125062029,"Block 2029, Block Group 2, Census Tract 5125.06, Santa Clara County, California",21,16,5
1000000US060855125062030,060855125062030,"Block 2030, Block Group 2, Census Tract 5125.06, Santa Clara County, California",6,6,0
1000000US060855125062031,060855125062031,"Block 2031, Block Group 2, Census Tract 5125.06, Santa Clara County, California",9,9,0
1000000US060855125062032,060855125062032,"Block 2032, Block Group 2, Census Tract 5125.06, Santa Clara County, California",2,1,1
1000000US060855125062033,060855125062033,"Block 2033, Block Group 2, Census Tract 5125.06, Santa Clara County, California",2,2,0
1000000US060855125062034,060855125062034,"Block 2034, Block Group 2, Census Tract 5125.06, Santa Clara County, California",8,8,0
1000000US060855125062035,060855125062035,"Block 2035, Block Group 2, Census Tract 5125.06, Santa Clara County, California",8,8,0
1000000US060855125062036,060855125062036,"Block 2036, Block Group 2, Census Tract 5125.06, Santa Clara County, California",2,2,0
1000000US060855125062037,060855125062037,"Block 2037, Block Group 2, Census Tract 5125.06, Santa Clara County, California",2,2,0
1000000US060855125062038,060855125062038,"Block 2038, Block Group 2, Census Tract 5125.06, Santa Clara County, California",9,9,0
1000000US060855125062039,060855125062039,"Block 2039, Block Group 2, Census Tract 5125.06, Santa Clara County, California",0,0,0
1000000US060855125062040,060855125062040,"Block 2040, Block Group 2, Census Tract 5125.06, Santa Clara County, California",7,5,2
1000000US060855125062041,060855125062041,"Block 2041, Block Group 2, Census Tract 5125.06, Santa Clara County, California",25,24,1
1000000US060855125062042,060855125062042,"Block 2042, Block Group 2, Census Tract 5125.06, Santa Clara County, California",24,23,1
1000000US060855125062043,060855125062043,"Block 2043, Block Group 2, Census Tract 5125.06, Santa Clara County, California",26,26,0
1000000US060855125062044,060855125062044,"Block 2044, Block Group 2, Census Tract 5125.06, Santa Clara County, California",0,0,0
1000000US060855125062045,060855125062045,"Block 2045, Block Group 2, Census Tract 5125.06, Santa Clara County, California",0,0,0
1000000US060855125062046,060855125062046,"Block 2046, Block Group 2, Census Tract 5125.06, Santa Clara County, California",0,0,0
1000000US060855125062047,060855125062047,"Block 2047, Block Group 2, Census Tract 5125.06, Santa Clara County, California",0,0,0
1000000US060855125062048,060855125062048,"Block 2048, Block Group 2, Census Tract 5125.06, Santa Clara County, California",0,0,0
1000000US060855125062049,060855125062049,"Block 2049, Block Group 2, Census Tract 5125.06, Santa Clara County, California",0,0,0
1000000US060855125062050,060855125062050,"Block 2050, Block Group 2, Census Tract 5125.06, Santa Clara County, California",0,0,0
1000000US060855125063000,060855125063000,"Block 3000, Block Group 3, Census Tract 5125.06, Santa Clara County, California",33,32,1
1000000US060855125063001,060855125063001,"Block 3001, Block Group 3, Census Tract 5125.06, Santa Clara County, California",24,23,1
1000000US060855125063002,060855125063002,"Block 3002, Block Group 3, Census Tract 5125.06, Santa Clara County, California",33,33,0
1000000US060855125063003,060855125063003,"Block 3003, Block Group 3, Census Tract 5125.06, Santa Clara County, California",20,19,1
1000000US060855125063004,060855125063004,"Block 3004, Block Group 3, Census Tract 5125.06, Santa Clara County, California",12,12,0
1000000US060855125063005,060855125063005,"Block 3005, Block Group 3, Census Tract 5125.06, Santa Clara County, California",36,36,0
1000000US060855125063006,060855125063006,"Block 3006, Block Group 3, Census Tract 5125.06, Santa Clara County, California",44,42,2
1000000US060855125063007,060855125063007,"Block 3007, Block Group 3, Census Tract 5125.06, Santa Clara County, California",20,19,1
1000000US060855125063008,060855125063008,"Block 3008, Block Group 3, Census Tract 5125.06, Santa Clara County, California",38,37,1
1000000US060855125063009,060855125063009,"Block 3009, Block Group 3, Census Tract 5125.06, Santa Clara County, California",10,10,0
1000000US060855125063010,060855125063010,"Block 3010, Block Group 3, Census Tract 5125.06, Santa Clara County, California",22,21,1
1000000US060855125063011,060855125063011,"Block 3011, Block Group 3, Census Tract 5125.06, Santa Clara County, California",75,71,4
1000000US060855125063012,060855125063012,"Block 3012, Block Group 3, Census Tract 5125.06, Santa Clara County, California",31,31,0
1000000US060855125063013,060855125063013,"Block 3013, Block Group 3, Census Tract 5125.06, Santa Clara County, California",44,43,1
1000000US060855125063014,060855125063014,"Block 3014, Block Group 3, Census Tract 5125.06, Santa Clara County, California",15,15,0
1000000US060855125063015,060855125063015,"Block 3015, Block Group 3, Census Tract 5125.06, Santa Clara County, California",0,0,0
1000000US060855125063016,060855125063016,"Block 3016, Block Group 3, Census Tract 5125.06, Santa Clara County, California",0,0,0
1000000US060855125063017,060855125063017,"Block 3017, Block Group 3, Census Tract 5125.06, Santa Clara County, California",56,55,1
1000000US060855125063018,060855125063018,"Block 3018, Block Group 3, Census Tract 5125.06, Santa Clara County, California",18,15,3
1000000US060855125063019,060855125063019,"Block 3019, Block Group 3, Census Tract 5125.06, Santa Clara County, California",49,44,5
1000000US060855125063020,060855125063020,"Block 3020, Block Group 3, Census Tract 5125.06, Santa Clara County, California",4,4,0
1000000US060855125063021,060855125063021,"Block 3021, Block Group 3, Census Tract 5125.06, Santa Clara County, California",17,16,1
1000000US060855125063022,060855125063022,"Block 3022, Block Group 3, Census Tract 5125.06, Santa Clara County, California",33,32,1
1000000US060855125063023,060855125063023,"Block 3023, Block Group 3, Census Tract 5125.06, Santa Clara County, California",30,29,1
1000000US060855125063024,060855125063024,"Block 3024, Block Group 3, Census Tract 5125.06, Santa Clara County, California",38,36,2
1000000US060855125063025,060855125063025,"Block 3025, Block Group 3, Census Tract 5125.06, Santa Clara County, California",40,40,0
1000000US060855125063026,060855125063026,"Block 3026, Block Group 3, Census Tract 5125.06, Santa Clara County, California",18,17,1
1000000US060855125081000,060855125081000,"Block 1000, Block Group 1, Census Tract 5125.08, Santa Clara County, California",37,36,1
1000000US060855125081001,060855125081001,"Block 1001, Block Group 1, Census Tract 5125.08, Santa Clara County, California",17,16,1
1000000US060855125081002,060855125081002,"Block 1002, Block Group 1, Census Tract 5125.08, Santa Clara County, California",11,11,0
1000000US060855125081003,060855125081003,"Block 1003, Block Group 1, Census Tract 5125.08, Santa Clara County, California",14,12,2
1000000US060855125081004,060855125081004,"Block 1004, Block Group 1, Census Tract 5125.08, Santa Clara County, California",13,13,0
1000000US060855125081005,060855125081005,"Block 1005, Block Group 1, Census Tract 5125.08, Santa Clara County, California",28,26,2
1000000US060855125081006,060855125081006,"Block 1006, Block Group 1, Census Tract 5125.08, Santa Clara County, California",37,37,0
1000000US060855125081007,060855125081007,"Block 1007, Block Group 1, Census Tract 5125.08, Santa Clara County, California",10,10,0
1000000US060855125081008,060855125081008,"Block 1008, Block Group 1, Census Tract 5125.08, Santa Clara County, California",11,11,0
1000000US060855125081009,060855125081009,"Block 1009, Block Group 1, Census Tract 5125.08, Santa Clara County, California",11,11,0
1000000US060855125081010,060855125081010,"Block 1010, Block Group 1, Census Tract 5125.08, Santa Clara County, California",14,14,0
1000000US060855125081011,060855125081011,"Block 1011, Block Group 1, Census Tract 5125.08, Santa Clara County, California",8,7,1
1000000US060855125081012,060855125081012,"Block 1012, Block Group 1, Census Tract 5125.08, Santa Clara County, California",6,6,0
1000000US060855125081013,060855125081013,"Block 1013, Block Group 1, Census Tract 5125.08, Santa Clara County, California",6,6,0
1000000US060855125081014,060855125081014,"Block 1014, Block Group 1, Census Tract 5125.08, Santa Clara County, California",5,5,0
1000000US060855125081015,060855125081015,"Block 1015, Block Group 1, Census Tract 5125.08, Santa Clara County, California",9,8,1
1000000US060855125081016,060855125081016,"Block 1016, Block Group 1, Census Tract 5125.08, Santa Clara County, California",10,10,0
1000000US060855125081017,060855125081017,"Block 1017, Block Group 1, Census Tract 5125.08, Santa Clara County, California",6,6,0
1000000US060855125081018,060855125081018,"Block 1018, Block Group 1, Census Tract 5125.08, Santa Clara County, California",14,14,0
1000000US060855125081019,060855125081019,"Block 1019, Block Group 1, Census Tract 5125.08, Santa Clara County, California",11,10,1
1000000US060855125081020,060855125081020,"Block 1020, Block Group 1, Census Tract 5125.08, Santa Clara County, California",9,8,1
1000000US060855125081021,060855125081021,"Block 1021, Block Group 1, Census Tract 5125.08, Santa Clara County, California",10,8,2
1000000US060855125081022,060855125081022,"Block 1022, Block Group 1, Census Tract 5125.08, Santa Clara County, California",7,6,1
1000000US060855125081023,060855125081023,"Block 1023, Block Group 1, Census Tract 5125.08, Santa Clara County, California",17,17,0
1000000US060855125081024,060855125081024,"Block 1024, Block Group 1, Census Tract 5125.08, Santa Clara County, California",23,22,1
1000000US060855125081025,060855125081025,"Block 1025, Block Group 1, Census Tract 5125.08, Santa Clara County, California",24,23,1
1000000US060855125081026,060855125081026,"Block 1026, Block Group 1, Census Tract 5125.08, Santa Clara County, California",34,31,3
1000000US060855125081027,060855125081027,"Block 1027, Block Group 1, Census Tract 5125.08, Santa Clara County, California",24,24,0
1000000US060855125081028,060855125081028,"Block 1028, Block Group 1, Census Tract 5125.08, Santa Clara County, California",9,7,2
1000000US060855125081029,060855125081029,"Block 1029, Block Group 1, Census Tract 5125.08, Santa Clara County, California",12,12,0
1000000US060855125081030,060855125081030,"Block 1030, Block Group 1, Census Tract 5125.08, Santa Clara County, California",12,12,0
1000000US060855125081031,060855125081031,"Block 1031, Block Group 1, Census Tract 5125.08, Santa Clara County, California",10,10,0
1000000US060855125081032,060855125081032,"Block 1032, Block Group 1, Census Tract 5125.08, Santa Clara County, California",109,108,1
1000000US060855125081033,060855125081033,"Block 1033, Block Group 1, Census Tract 5125.08, Santa Clara County, California",36,35,1
1000000US060855125081034,060855125081034,"Block 1034, Block Group 1, Census Tract 5125.08, Santa Clara County, California",52,49,3
1000000US060855125081035,060855125081035,"Block 1035, Block Group 1, Census Tract 5125.08, Santa Clara County, California",5,5,0
1000000US060855125081036,060855125081036,"Block 1036, Block Group 1, Census Tract 5125.08, Santa Clara County, California",38,38,0
1000000US060855125082000,060855125082000,"Block 2000, Block Group 2, Census Tract 5125.08, Santa Clara County, California",50,43,7
1000000US060855125082001,060855125082001,"Block 2001, Block Group 2, Census Tract 5125.08, Santa Clara County, California",52,50,2
1000000US060855125082002,060855125082002,"Block 2002, Block Group 2, Census Tract 5125.08, Santa Clara County, California",18,14,4
1000000US060855125082003,060855125082003,"Block 2003, Block Group 2, Census Tract 5125.08, Santa Clara County, California",14,14,0
1000000US060855125082004,060855125082004,"Block 2004, Block Group 2, Census Tract 5125.08, Santa Clara County, California",0,0,0
1000000US060855125082005,060855125082005,"Block 2005, Block Group 2, Census Tract 5125.08, Santa Clara County, California",81,77,4
1000000US060855125082006,060855125082006,"Block 2006, Block Group 2, Census Tract 5125.08, Santa Clara County, California",58,57,1
1000000US060855125082007,060855125082007,"Block 2007, Block Group 2, Census Tract 5125.08, Santa Clara County, California",37,34,3
1000000US060855125082008,060855125082008,"Block 2008, Block Group 2, Census Tract 5125.08, Santa Clara County, California",64,61,3
1000000US060855125082009,060855125082009,"Block 2009, Block Group 2, Census Tract 5125.08, Santa Clara County, California",49,48,1
1000000US060855125082010,060855125082010,"Block 2010, Block Group 2, Census Tract 5125.08, Santa Clara County, California",60,59,1
1000000US060855125082011,060855125082011,"Block 2011, Block Group 2, Census Tract 5125.08, Santa Clara County, California",11,11,0
1000000US060855125082012,060855125082012,"Block 2012, Block Group 2, Census Tract 5125.08, Santa Clara County, California",11,10,1
1000000US060855125082013,060855125082013,"Block 2013, Block Group 2, Census Tract 5125.08, Santa Clara County, California",31,29,2
1000000US060855125082014,060855125082014,"Block 2014, Block Group 2, Census Tract 5125.08, Santa Clara County, California",28,26,2
1000000US060855125082015,060855125082015,"Block 2015, Block Group 2, Census Tract 5125.08, Santa Clara County, California",52,51,1
1000000US060855125082016,060855125082016,"Block 2016, Block Group 2, Census Tract 5125.08, Santa Clara County, California",43,41,2
1000000US060855125082017,060855125082017,"Block 2017, Block Group 2, Census Tract 5125.08, Santa Clara County, California",78,78,0
1000000US060855125083000,060855125083000,"Block 3000, Block Group 3, Census Tract 5125.08, Santa Clara County, California",299,271,28
1000000US060855125083001,060855125083001,"Block 3001, Block Group 3, Census Tract 5125.08, Santa Clara County, California",37,33,4
1000000US060855125083002,060855125083002,"Block 3002, Block Group 3, Census Tract 5125.08, Santa Clara County, California",15,15,0
1000000US060855125083003,060855125083003,"Block 3003, Block Group 3, Census Tract 5125.08, Santa Clara County, California",8,7,1
1000000US060855125083004,060855125083004,"Block 3004, Block Group 3, Census Tract 5125.08, Santa Clara County, California",8,8,0
1000000US060855125083005,060855125083005,"Block 3005, Block Group 3, Census Tract 5125.08, Santa Clara County, California",28,21,7
1000000US060855125083006,060855125083006,"Block 3006, Block Group 3, Census Tract 5125.08, Santa Clara County, California",25,23,2
1000000US060855125083007,060855125083007,"Block 3007, Block Group 3, Census Tract 5125.08, Santa Clara County, California",8,8,0
1000000US060855125083008,060855125083008,"Block 3008, Block Group 3, Census Tract 5125.08, Santa Clara County, California",8,7,1
1000000US060855125083009,060855125083009,"Block 3009, Block Group 3, Census Tract 5125.08, Santa Clara County, California",17,16,1
1000000US060855125083010,060855125083010,"Block 3010, Block Group 3, Census Tract 5125.08, Santa Clara County, California",56,55,1
1000000US060855125083011,060855125083011,"Block 3011, Block Group 3, Census Tract 5125.08, Santa Clara County, California",8,8,0
1000000US060855125083012,060855125083012,"Block 3012, Block Group 3, Census Tract 5125.08, Santa Clara County, California",9,9,0
1000000US060855125083013,060855125083013,"Block 3013, Block Group 3, Census Tract 5125.08, Santa Clara County, California",113,111,2
1000000US060855125083014,060855125083014,"Block 3014, Block Group 3, Census Tract 5125.08, Santa Clara County, California",34,34,0
1000000US060855125083015,060855125083015,"Block 3015, Block Group 3, Census Tract 5125.08, Santa Clara County, California",44,43,1
1000000US060855125083016,060855125083016,"Block 3016, Block Group 3, Census Tract 5125.08, Santa Clara County, California",0,0,0
1000000US060855125084000,060855125084000,"Block 4000, Block Group 4, Census Tract 5125.08, Santa Clara County, California",40,37,3
1000000US060855125084001,060855125084001,"Block 4001, Block Group 4, Census Tract 5125.08, Santa Clara County, California",47,45,2
1000000US060855125084002,060855125084002,"Block 4002, Block Group 4, Census Tract 5125.08, Santa Clara County, California",56,48,8
1000000US060855125084003,060855125084003,"Block 4003, Block Group 4, Census Tract 5125.08, Santa Clara County, California",0,0,0
1000000US060855125084004,060855125084004,"Block 4004, Block Group 4, Census Tract 5125.08, Santa Clara County, California",5,5,0
1000000US060855125084005,060855125084005,"Block 4005, Block Group 4, Census Tract 5125.08, Santa Clara County, California",10,10,0
1000000US060855125084006,060855125084006,"Block 4006, Block Group 4, Census Tract 5125.08, Santa Clara County, California",9,9,0
1000000US060855125084007,060855125084007,"Block 4007, Block Group 4, Census Tract 5125.08, Santa Clara County, California",9,9,0
1000000US060855125084008,060855125084008,"Block 4008, Block Group 4, Census Tract 5125.08, Santa Clara County, California",7,6,1
1000000US060855125084009,060855125084009,"Block 4009, Block Group 4, Census Tract 5125.08, Santa Clara County, California",87,86,1
1000000US060855125084010,060855125084010,"Block 4010, Block Group 4, Census Tract 5125.08, Santa Clara County, California",27,26,1
1000000US060855125084011,060855125084011,"Block 4011, Block Group 4, Census Tract 5125.08, Santa Clara County, California",67,66,1
1000000US060855125084012,060855125084012,"Block 4012, Block Group 4, Census Tract 5125.08, Santa Clara County, California",13,13,0
1000000US060855125084013,060855125084013,"Block 4013, Block Group 4, Census Tract 5125.08, Santa Clara County, California",30,29,1
1000000US060855125084014,060855125084014,"Block 4014, Block Group 4, Census Tract 5125.08, Santa Clara County, California",44,43,1
1000000US060855125084015,060855125084015,"Block 4015, Block Group 4, Census Tract 5125.08, Santa Clara County, California",13,13,0
1000000US060855125084016,060855125084016,"Block 4016, Block Group 4, Census Tract 5125.08, Santa Clara County, California",13,13,0
1000000US060855125091000,060855125091000,"Block 1000, Block Group 1, Census Tract 5125.09, Santa Clara County, California",201,190,11
1000000US060855125091001,060855125091001,"Block 1001, Block Group 1, Census Tract 5125.09, Santa Clara County, California",53,51,2
1000000US060855125091002,060855125091002,"Block 1002, Block Group 1, Census Tract 5125.09, Santa Clara County, California",33,32,1
1000000US060855125091003,060855125091003,"Block 1003, Block Group 1, Census Tract 5125.09, Santa Clara County, California",117,111,6
1000000US060855125091004,060855125091004,"Block 1004, Block Group 1, Census Tract 5125.09, Santa Clara County, California",22,22,0
1000000US060855125091005,060855125091005,"Block 1005, Block Group 1, Census Tract 5125.09, Santa Clara County, California",22,21,1
1000000US060855125091006,060855125091006,"Block 1006, Block Group 1, Census Tract 5125.09, Santa Clara County, California",21,21,0
1000000US060855125091007,060855125091007,"Block 1007, Block Group 1, Census Tract 5125.09, Santa Clara County, California",0,0,0
1000000US060855125091008,060855125091008,"Block 1008, Block Group 1, Census Tract 5125.09, Santa Clara County, California",0,0,0
1000000US060855125091009,060855125091009,"Block 1009, Block Group 1, Census Tract 5125.09, Santa Clara County, California",19,19,0
1000000US060855125091010,060855125091010,"Block 1010, Block Group 1, Census Tract 5125.09, Santa Clara County, California",23,22,1
1000000US060855125091011,060855125091011,"Block 1011, Block Group 1, Census Tract 5125.09, Santa Clara County, California",23,21,2
1000000US060855125091012,060855125091012,"Block 1012, Block Group 1, Census Tract 5125.09, Santa Clara County, California",0,0,0
1000000US060855125091013,060855125091013,"Block 1013, Block Group 1, Census Tract 5125.09, Santa Clara County, California",39,38,1
1000000US060855125091014,060855125091014,"Block 1014, Block Group 1, Census Tract 5125.09, Santa Clara County, California",0,0,0
1000000US060855125091015,060855125091015,"Block 1015, Block Group 1, Census Tract 5125.09, Santa Clara County, California",0,0,0
1000000US060855125091016,060855125091016,"Block 1016, Block Group 1, Census Tract 5125.09, Santa Clara County, California",76,75,1
1000000US060855125091017,060855125091017,"Block 1017, Block Group 1, Census Tract 5125.09, Santa Clara County, California",20,20,0
1000000US060855125091018,060855125091018,"Block 1018, Block Group 1, Census Tract 5125.09, Santa Clara County, California",0,0,0
1000000US060855125091019,060855125091019,"Block 1019, Block Group 1, Census Tract 5125.09, Santa Clara County, California",48,45,3
1000000US060855125091020,060855125091020,"Block 1020, Block Group 1, Census Tract 5125.09, Santa Clara County, California",17,17,0
1000000US060855125091021,060855125091021,"Block 1021, Block Group 1, Census Tract 5125.09, Santa Clara County, California",61,60,1
1000000US060855125091022,060855125091022,"Block 1022, Block Group 1, Census Tract 5125.09, Santa Clara County, California",0,0,0
1000000US060855125091023,060855125091023,"Block 1023, Block Group 1, Census Tract 5125.09, Santa Clara County, California",13,13,0
1000000US060855125092000,060855125092000,"Block 2000, Block Group 2, Census Tract 5125.09, Santa Clara County, California",6,6,0
1000000US060855125092001,060855125092001,"Block 2001, Block Group 2, Census Tract 5125.09, Santa Clara County, California",0,0,0
1000000US060855125092002,060855125092002,"Block 2002, Block Group 2, Census Tract 5125.09, Santa Clara County, California",8,8,0
1000000US060855125092003,060855125092003,"Block 2003, Block Group 2, Census Tract 5125.09, Santa Clara County, California",17,16,1
1000000US060855125092004,060855125092004,"Block 2004, Block Group 2, Census Tract 5125.09, Santa Clara County, California",0,0,0
1000000US060855125092005,060855125092005,"Block 2005, Block Group 2, Census Tract 5125.09, Santa Clara County, California",0,0,0
1000000US060855125092006,060855125092006,"Block 2006, Block Group 2, Census Tract 5125.09, Santa Clara County, California",27,25,2
1000000US060855125092007,060855125092007,"Block 2007, Block Group 2, Census Tract 5125.09, Santa Clara County, California",0,0,0
1000000US060855125092008,060855125092008,"Block 2008, Block Group 2, Census Tract 5125.09, Santa Clara County, California",52,51,1
1000000US060855125092009,060855125092009,"Block 2009, Block Group 2, Census Tract 5125.09, Santa Clara County, California",16,15,1
1000000US060855125092010,060855125092010,"Block 2010, Block Group 2, Census Tract 5125.09, Santa Clara County, California",0,0,0
1000000US060855125092011,060855125092011,"Block 2011, Block Group 2, Census Tract 5125.09, Santa Clara County, California",15,15,0
1000000US060855125092012,060855125092012,"Block 2012, Block Group 2, Census Tract 5125.09, Santa Clara County, California",110,110,0
1000000US060855125092013,060855125092013,"Block 2013, Block Group 2, Census Tract 5125.09, Santa Clara County, California",60,60,0
1000000US060855125092014,060855125092014,"Block 2014, Block Group 2, Census Tract 5125.09, Santa Clara County, California",20,20,0
1000000US060855125092015,060855125092015,"Block 2015, Block Group 2, Census Tract 5125.09, Santa Clara County, California",43,43,0
1000000US060855125092016,060855125092016,"Block 2016, Block Group 2, Census Tract 5125.09, Santa Clara County, California",11,11,0
1000000US060855125092017,060855125092017,"Block 2017, Block Group 2, Census Tract 5125.09, Santa Clara County, California",3,3,0
1000000US060855125092018,060855125092018,"Block 2018, Block Group 2, Census Tract 5125.09, Santa Clara County, California",0,0,0
1000000US060855125092019,060855125092019,"Block 2019, Block Group 2, Census Tract 5125.09, Santa Clara County, California",0,0,0
1000000US060855125092020,060855125092020,"Block 2020, Block Group 2, Census Tract 5125.09, Santa Clara County, California",11,11,0
1000000US060855125092021,060855125092021,"Block 2021, Block Group 2, Census Tract 5125.09, Santa Clara County, California",0,0,0
1000000US060855125092022,060855125092022,"Block 2022, Block Group 2, Census Tract 5125.09, Santa Clara County, California",0,0,0
1000000US060855125092023,060855125092023,"Block 2023, Block Group 2, Census Tract 5125.09, Santa Clara County, California",0,0,0
1000000US060855125092024,060855125092024,"Block 2024, Block Group 2, Census Tract 5125.09, Santa Clara County, California",0,0,0
1000000US060855125092025,060855125092025,"Block 2025, Block Group 2, Census Tract 5125.09, Santa Clara County, California",0,0,0
1000000US060855125092026,060855125092026,"Block 2026, Block Group 2, Census Tract 5125.09, Santa Clara County, California",0,0,0
1000000US060855125092027,060855125092027,"Block 2027, Block Group 2, Census Tract 5125.09, Santa Clara County, California",0,0,0
1000000US060855125101000,060855125101000,"Block 1000, Block Group 1, Census Tract 5125.10, Santa Clara County, California",0,0,0
1000000US060855125101001,060855125101001,"Block 1001, Block Group 1, Census Tract 5125.10, Santa Clara County, California",8,5,3
1000000US060855125101002,060855125101002,"Block 1002, Block Group 1, Census Tract 5125.10, Santa Clara County, California",37,27,10
1000000US060855125101003,060855125101003,"Block 1003, Block Group 1, Census Tract 5125.10, Santa Clara County, California",3,3,0
1000000US060855125101004,060855125101004,"Block 1004, Block Group 1, Census Tract 5125.10, Santa Clara County, California",0,0,0
1000000US060855125101005,060855125101005,"Block 1005, Block Group 1, Census Tract 5125.10, Santa Clara County, California",3,3,0
1000000US060855125101006,060855125101006,"Block 1006, Block Group 1, Census Tract 5125.10, Santa Clara County, California",3,3,0
1000000US060855125101007,060855125101007,"Block 1007, Block Group 1, Census Tract 5125.10, Santa Clara County, California",182,123,59
1000000US060855125101008,060855125101008,"Block 1008, Block Group 1, Census Tract 5125.10, Santa Clara County, California",6,6,0
1000000US060855125101009,060855125101009,"Block 1009, Block Group 1, Census Tract 5125.10, Santa Clara County, California",6,6,0
1000000US060855125101010,060855125101010,"Block 1010, Block Group 1, Census Tract 5125.10, Santa Clara County, California",6,6,0
1000000US060855125101011,060855125101011,"Block 1011, Block Group 1, Census Tract 5125.10, Santa Clara County, California",0,0,0
1000000US060855125101012,060855125101012,"Block 1012, Block Group 1, Census Tract 5125.10, Santa Clara County, California",0,0,0
1000000US060855125101013,060855125101013,"Block 1013, Block Group 1, Census Tract 5125.10, Santa Clara County, California",53,52,1
1000000US060855125101014,060855125101014,"Block 1014, Block Group 1, Census Tract 5125.10, Santa Clara County, California",44,44,0
1000000US060855125101015,060855125101015,"Block 1015, Block Group 1, Census Tract 5125.10, Santa Clara County, California",31,31,0
1000000US060855125101016,060855125101016,"Block 1016, Block Group 1, Census Tract 5125.10, Santa Clara County, California",0,0,0
1000000US060855125101017,060855125101017,"Block 1017, Block Group 1, Census Tract 5125.10, Santa Clara County, California",43,42,1
1000000US060855125101018,060855125101018,"Block 1018, Block Group 1, Census Tract 5125.10, Santa Clara County, California",9,9,0
1000000US060855125101019,060855125101019,"Block 1019, Block Group 1, Census Tract 5125.10, Santa Clara County, California",5,5,0
1000000US060855125101020,060855125101020,"Block 1020, Block Group 1, Census Tract 5125.10, Santa Clara County, California",0,0,0
1000000US060855125101021,060855125101021,"Block 1021, Block Group 1, Census Tract 5125.10, Santa Clara County, California",45,43,2
1000000US060855125101022,060855125101022,"Block 1022, Block Group 1, Census Tract 5125.10, Santa Clara County, California",33,32,1
1000000US060855125101023,060855125101023,"Block 1023, Block Group 1, Census Tract 5125.10, Santa Clara County, California",25,24,1
1000000US060855125101024,060855125101024,"Block 1024, Block Group 1, Census Tract 5125.10, Santa Clara County, California",0,0,0
1000000US060855125101025,060855125101025,"Block 1025, Block Group 1, Census Tract 5125.10, Santa Clara County, California",0,0,0
1000000US060855125101026,060855125101026,"Block 1026, Block Group 1, Census Tract 5125.10, Santa Clara County, California",105,99,6
1000000US060855125101027,060855125101027,"Block 1027, Block Group 1, Census Tract 5125.10, Santa Clara County, California",0,0,0
1000000US060855125101028,060855125101028,"Block 1028, Block Group 1, Census Tract 5125.10, Santa Clara County, California",31,28,3
1000000US060855125101029,060855125101029,"Block 1029, Block Group 1, Census Tract 5125.10, Santa Clara County, California",21,20,1
1000000US060855125101030,060855125101030,"Block 1030, Block Group 1, Census Tract 5125.10, Santa Clara County, California",0,0,0
1000000US060855125101031,060855125101031,"Block 1031, Block Group 1, Census Tract 5125.10, Santa Clara County, California",7,7,0
1000000US060855125101032,060855125101032,"Block 1032, Block Group 1, Census Tract 5125.10, Santa Clara County, California",0,0,0
1000000US060855125101033,060855125101033,"Block 1033, Block Group 1, Census Tract 5125.10, Santa Clara County, California",0,0,0
1000000US060855125101034,060855125101034,"Block 1034, Block Group 1, Census Tract 5125.10, Santa Clara County, California",5,5,0
1000000US060855125101035,060855125101035,"Block 1035, Block Group 1, Census Tract 5125.10, Santa Clara County, California",0,0,0
1000000US060855125101036,060855125101036,"Block 1036, Block Group 1, Census Tract 5125.10, Santa Clara County, California",6,4,2
1000000US060855125101037,060855125101037,"Block 1037, Block Group 1, Census Tract 5125.10, Santa Clara County, California",0,0,0
1000000US060855125101038,060855125101038,"Block 1038, Block Group 1, Census Tract 5125.10, Santa Clara County, California",0,0,0
1000000US060855125101039,060855125101039,"Block 1039, Block Group 1, Census Tract 5125.10, Santa Clara County, California",0,0,0
1000000US060855125101040,060855125101040,"Block 1040, Block Group 1, Census Tract 5125.10, Santa Clara County, California",0,0,0
1000000US060855125101041,060855125101041,"Block 1041, Block Group 1, Census Tract 5125.10, Santa Clara County, California",89,87,2
1000000US060855125101042,060855125101042,"Block 1042, Block Group 1, Census Tract 5125.10, Santa Clara County, California",0,0,0
1000000US060855125101043,060855125101043,"Block 1043, Block Group 1, Census Tract 5125.10, Santa Clara County, California",0,0,0
1000000US060855125101044,060855125101044,"Block 1044, Block Group 1, Census Tract 5125.10, Santa Clara County, California",11,7,4
1000000US060855125101045,060855125101045,"Block 1045, Block Group 1, Census Tract 5125.10, Santa Clara County, California",0,0,0
1000000US060855125101046,060855125101046,"Block 1046, Block Group 1, Census Tract 5125.10, Santa Clara County, California",1,0,1
1000000US060855125101047,060855125101047,"Block 1047, Block Group 1, Census Tract 5125.10, Santa Clara County, California",0,0,0
1000000US060855125101048,060855125101048,"Block 1048, Block Group 1, Census Tract 5125.10, Santa Clara County, California",4,2,2
1000000US060855125101049,060855125101049,"Block 1049, Block Group 1, Census Tract 5125.10, Santa Clara County, California",0,0,0
1000000US060855125101050,060855125101050,"Block 1050, Block Group 1, Census Tract 5125.10, Santa Clara County, California",0,0,0
1000000US060855125101051,060855125101051,"Block 1051, Block Group 1, Census Tract 5125.10, Santa Clara County, California",0,0,0
1000000US060855125101052,060855125101052,"Block 1052, Block Group 1, Census Tract 5125.10, Santa Clara County, California",0,0,0
1000000US060855125101053,060855125101053,"Block 1053, Block Group 1, Census Tract 5125.10, Santa Clara County, California",0,0,0
1000000US060855125101054,060855125101054,"Block 1054, Block Group 1, Census Tract 5125.10, Santa Clara County, California",0,0,0
1000000US060855125101055,060855125101055,"Block 1055, Block Group 1, Census Tract 5125.10, Santa Clara County, California",0,0,0
1000000US060855125101056,060855125101056,"Block 1056, Block Group 1, Census Tract 5125.10, Santa Clara County, California",9,9,0
1000000US060855125101057,060855125101057,"Block 1057, Block Group 1, Census Tract 5125.10, Santa Clara County, California",25,24,1
1000000US060855125101058,060855125101058,"Block 1058, Block Group 1, Census Tract 5125.10, Santa Clara County, California",19,19,0
1000000US060855125102000,060855125102000,"Block 2000, Block Group 2, Census Tract 5125.10, Santa Clara County, California",57,57,0
1000000US060855125102001,060855125102001,"Block 2001, Block Group 2, Census Tract 5125.10, Santa Clara County, California",78,76,2
1000000US060855125102002,060855125102002,"Block 2002, Block Group 2, Census Tract 5125.10, Santa Clara County, California",128,123,5
1000000US060855125102003,060855125102003,"Block 2003, Block Group 2, Census Tract 5125.10, Santa Clara County, California",29,29,0
1000000US060855125102004,060855125102004,"Block 2004, Block Group 2, Census Tract 5125.10, Santa Clara County, California",22,21,1
1000000US060855125102005,060855125102005,"Block 2005, Block Group 2, Census Tract 5125.10, Santa Clara County, California",12,11,1
1000000US060855125102006,060855125102006,"Block 2006, Block Group 2, Census Tract 5125.10, Santa Clara County, California",43,43,0
1000000US060855125102007,060855125102007,"Block 2007, Block Group 2, Census Tract 5125.10, Santa Clara County, California",0,0,0
1000000US060855125102008,060855125102008,"Block 2008, Block Group 2, Census Tract 5125.10, Santa Clara County, California",29,28,1
1000000US060855125102009,060855125102009,"Block 2009, Block Group 2, Census Tract 5125.10, Santa Clara County, California",0,0,0
1000000US060855125102010,060855125102010,"Block 2010, Block Group 2, Census Tract 5125.10, Santa Clara County, California",0,0,0
1000000US060855125102011,060855125102011,"Block 2011, Block Group 2, Census Tract 5125.10, Santa Clara County, California",0,0,0
1000000US060855125102012,060855125102012,"Block 2012, Block Group 2, Census Tract 5125.10, Santa Clara County, California",0,0,0
1000000US060855125102013,060855125102013,"Block 2013, Block Group 2, Census Tract 5125.10, Santa Clara County, California",25,25,0
1000000US060855125102014,060855125102014,"Block 2014, Block Group 2, Census Tract 5125.10, Santa Clara County, California",54,50,4
1000000US060855125102015,060855125102015,"Block 2015, Block Group 2, Census Tract 5125.10, Santa Clara County, California",43,42,1
1000000US060855125102016,060855125102016,"Block 2016, Block Group 2, Census Tract 5125.10, Santa Clara County, California",0,0,0
1000000US060855125102017,060855125102017,"Block 2017, Block Group 2, Census Tract 5125.10, Santa Clara County, California",0,0,0
1000000US060855125102018,060855125102018,"Block 2018, Block Group 2, Census Tract 5125.10, Santa Clara County, California",0,0,0
1000000US060855125102019,060855125102019,"Block 2019, Block Group 2, Census Tract 5125.10, Santa Clara County, California",0,0,0
1000000US060855125103000,060855125103000,"Block 3000, Block Group 3, Census Tract 5125.10, Santa Clara County, California",444,422,22
1000000US060855125103001,060855125103001,"Block 3001, Block Group 3, Census Tract 5125.10, Santa Clara County, California",0,0,0
1000000US060855125103002,060855125103002,"Block 3002, Block Group 3, Census Tract 5125.10, Santa Clara County, California",116,108,8
1000000US060855125103003,060855125103003,"Block 3003, Block Group 3, Census Tract 5125.10, Santa Clara County, California",35,35,0
1000000US060855125103004,060855125103004,"Block 3004, Block Group 3, Census Tract 5125.10, Santa Clara County, California",55,53,2
1000000US060855125103005,060855125103005,"Block 3005, Block Group 3, Census Tract 5125.10, Santa Clara County, California",0,0,0
1000000US060855125103006,060855125103006,"Block 3006, Block Group 3, Census Tract 5125.10, Santa Clara County, California",49,49,0
1000000US060855125103007,060855125103007,"Block 3007, Block Group 3, Census Tract 5125.10, Santa Clara County, California",10,10,0
1000000US060855125103008,060855125103008,"Block 3008, Block Group 3, Census Tract 5125.10, Santa Clara County, California",0,0,0
1000000US060855125103009,060855125103009,"Block 3009, Block Group 3, Census Tract 5125.10, Santa Clara County, California",2,0,2
1000000US060855125103010,060855125103010,"Block 3010, Block Group 3, Census Tract 5125.10, Santa Clara County, California",100,100,0
1000000US060855125103011,060855125103011,"Block 3011, Block Group 3, Census Tract 5125.10, Santa Clara County, California",56,55,1
1000000US060855125103012,060855125103012,"Block 3012, Block Group 3, Census Tract 5125.10, Santa Clara County, California",27,25,2
1000000US060855126021000,060855126021000,"Block 1000, Block Group 1, Census Tract 5126.02, Santa Clara County, California",15,15,0
1000000US060855126021001,060855126021001,"Block 1001, Block Group 1, Census Tract 5126.02, Santa Clara County, California",23,23,0
1000000US060855126021002,060855126021002,"Block 1002, Block Group 1, Census Tract 5126.02, Santa Clara County, California",4,4,0
1000000US060855126021003,060855126021003,"Block 1003, Block Group 1, Census Tract 5126.02, Santa Clara County, California",15,15,0
1000000US060855126021004,060855126021004,"Block 1004, Block Group 1, Census Tract 5126.02, Santa Clara County, California",7,6,1
1000000US060855126021005,060855126021005,"Block 1005, Block Group 1, Census Tract 5126.02, Santa Clara County, California",4,4,0
1000000US060855126021006,060855126021006,"Block 1006, Block Group 1, Census Tract 5126.02, Santa Clara County, California",10,9,1
1000000US060855126021007,060855126021007,"Block 1007, Block Group 1, Census Tract 5126.02, Santa Clara County, California",3,3,0
1000000US060855126021008,060855126021008,"Block 1008, Block Group 1, Census Tract 5126.02, Santa Clara County, California",0,0,0
1000000US060855126021009,060855126021009,"Block 1009, Block Group 1, Census Tract 5126.02, Santa Clara County, California",0,0,0
1000000US060855126021010,060855126021010,"Block 1010, Block Group 1, Census Tract 5126.02, Santa Clara County, California",0,0,0
1000000US060855126021011,060855126021011,"Block 1011, Block Group 1, Census Tract 5126.02, Santa Clara County, California",0,0,0
1000000US060855126021012,060855126021012,"Block 1012, Block Group 1, Census Tract 5126.02, Santa Clara County, California",0,0,0
1000000US060855126021013,060855126021013,"Block 1013, Block Group 1, Census Tract 5126.02, Santa Clara County, California",0,0,0
1000000US060855126021014,060855126021014,"Block 1014, Block Group 1, Census Tract 5126.02, Santa Clara County, California",0,0,0
1000000US060855126021015,060855126021015,"Block 1015, Block Group 1, Census Tract 5126.02, Santa Clara County, California",0,0,0
1000000US060855126021016,060855126021016,"Block 1016, Block Group 1, Census Tract 5126.02, Santa Clara County, California",2,1,1
1000000US060855126021017,060855126021017,"Block 1017, Block Group 1, Census Tract 5126.02, Santa Clara County, California",0,0,0
1000000US060855126021018,060855126021018,"Block 1018, Block Group 1, Census Tract 5126.02, Santa Clara County, California",0,0,0
1000000US060855126021019,060855126021019,"Block 1019, Block Group 1, Census Tract 5126.02, Santa Clara County, California",0,0,0
1000000US060855126021020,060855126021020,"Block 1020, Block Group 1, Census Tract 5126.02, Santa Clara County, California",0,0,0
1000000US060855126021021,060855126021021,"Block 1021, Block Group 1, Census Tract 5126.02, Santa Clara County, California",0,0,0
1000000US060855126021022,060855126021022,"Block 1022, Block Group 1, Census Tract 5126.02, Santa Clara County, California",0,0,0
1000000US060855126021023,060855126021023,"Block 1023, Block Group 1, Census Tract 5126.02, Santa Clara County, California",0,0,0
1000000US060855126021024,060855126021024,"Block 1024, Block Group 1, Census Tract 5126.02, Santa Clara County, California",0,0,0
1000000US060855126021025,060855126021025,"Block 1025, Block Group 1, Census Tract 5126.02, Santa Clara County, California",0,0,0
1000000US060855126021026,060855126021026,"Block 1026, Block Group 1, Census Tract 5126.02, Santa Clara County, California",0,0,0
1000000US060855126021027,060855126021027,"Block 1027, Block Group 1, Census Tract 5126.02, Santa Clara County, California",0,0,0
1000000US060855126021028,060855126021028,"Block 1028, Block Group 1, Census Tract 5126.02, Santa Clara County, California",0,0,0
1000000US060855126021029,060855126021029,"Block 1029, Block Group 1, Census Tract 5126.02, Santa Clara County, California",0,0,0
1000000US060855126021030,060855126021030,"Block 1030, Block Group 1, Census Tract 5126.02, Santa Clara County, California",0,0,0
1000000US060855126021031,060855126021031,"Block 1031, Block Group 1, Census Tract 5126.02, Santa Clara County, California",0,0,0
1000000US060855126021032,060855126021032,"Block 1032, Block Group 1, Census Tract 5126.02, Santa Clara County, California",0,0,0
1000000US060855126021033,060855126021033,"Block 1033, Block Group 1, Census Tract 5126.02, Santa Clara County, California",0,0,0
1000000US060855126021034,060855126021034,"Block 1034, Block Group 1, Census Tract 5126.02, Santa Clara County, California",0,0,0
1000000US060855126021035,060855126021035,"Block 1035, Block Group 1, Census Tract 5126.02, Santa Clara County, California",0,0,0
1000000US060855126021036,060855126021036,"Block 1036, Block Group 1, Census Tract 5126.02, Santa Clara County, California",0,0,0
1000000US060855126021037,060855126021037,"Block 1037, Block Group 1, Census Tract 5126.02, Santa Clara County, California",0,0,0
1000000US060855126021038,060855126021038,"Block 1038, Block Group 1, Census Tract 5126.02, Santa Clara County, California",0,0,0
1000000US060855126021039,060855126021039,"Block 1039, Block Group 1, Census Tract 5126.02, Santa Clara County, California",0,0,0
1000000US060855126021040,060855126021040,"Block 1040, Block Group 1, Census Tract 5126.02, Santa Clara County, California",2,2,0
1000000US060855126021041,060855126021041,"Block 1041, Block Group 1, Census Tract 5126.02, Santa Clara County, California",1,1,0
1000000US060855126021042,060855126021042,"Block 1042, Block Group 1, Census Tract 5126.02, Santa Clara County, California",12,11,1
1000000US060855126021043,060855126021043,"Block 1043, Block Group 1, Census Tract 5126.02, Santa Clara County, California",2,1,1
1000000US060855126021044,060855126021044,"Block 1044, Block Group 1, Census Tract 5126.02, Santa Clara County, California",2,2,0
1000000US060855126021045,060855126021045,"Block 1045, Block Group 1, Census Tract 5126.02, Santa Clara County, California",0,0,0
1000000US060855126021046,060855126021046,"Block 1046, Block Group 1, Census Tract 5126.02, Santa Clara County, California",0,0,0
1000000US060855126021047,060855126021047,"Block 1047, Block Group 1, Census Tract 5126.02, Santa Clara County, California",0,0,0
1000000US060855126021048,060855126021048,"Block 1048, Block Group 1, Census Tract 5126.02, Santa Clara County, California",0,0,0
1000000US060855126021049,060855126021049,"Block 1049, Block Group 1, Census Tract 5126.02, Santa Clara County, California",0,0,0
1000000US060855126021050,060855126021050,"Block 1050, Block Group 1, Census Tract 5126.02, Santa Clara County, California",17,17,0
1000000US060855126021051,060855126021051,"Block 1051, Block Group 1, Census Tract 5126.02, Santa Clara County, California",2,2,0
1000000US060855126021052,060855126021052,"Block 1052, Block Group 1, Census Tract 5126.02, Santa Clara County, California",6,6,0
1000000US060855126021053,060855126021053,"Block 1053, Block Group 1, Census Tract 5126.02, Santa Clara County, California",9,9,0
1000000US060855126021054,060855126021054,"Block 1054, Block Group 1, Census Tract 5126.02, Santa Clara County, California",0,0,0
1000000US060855126021055,060855126021055,"Block 1055, Block Group 1, Census Tract 5126.02, Santa Clara County, California",78,69,9
1000000US060855126021056,060855126021056,"Block 1056, Block Group 1, Census Tract 5126.02, Santa Clara County, California",0,0,0
1000000US060855126021057,060855126021057,"Block 1057, Block Group 1, Census Tract 5126.02, Santa Clara County, California",1,1,0
1000000US060855126021058,060855126021058,"Block 1058, Block Group 1, Census Tract 5126.02, Santa Clara County, California",0,0,0
1000000US060855126021059,060855126021059,"Block 1059, Block Group 1, Census Tract 5126.02, Santa Clara County, California",16,14,2
1000000US060855126021060,060855126021060,"Block 1060, Block Group 1, Census Tract 5126.02, Santa Clara County, California",5,5,0
1000000US060855126021061,060855126021061,"Block 1061, Block Group 1, Census Tract 5126.02, Santa Clara County, California",2,2,0
1000000US060855126021062,060855126021062,"Block 1062, Block Group 1, Census Tract 5126.02, Santa Clara County, California",0,0,0
1000000US060855126021063,060855126021063,"Block 1063, Block Group 1, Census Tract 5126.02, Santa Clara County, California",0,0,0
1000000US060855126021064,060855126021064,"Block 1064, Block Group 1, Census Tract 5126.02, Santa Clara County, California",24,22,2
1000000US060855126021065,060855126021065,"Block 1065, Block Group 1, Census Tract 5126.02, Santa Clara County, California",7,6,1
1000000US060855126021066,060855126021066,"Block 1066, Block Group 1, Census Tract 5126.02, Santa Clara County, California",0,0,0
1000000US060855126021067,060855126021067,"Block 1067, Block Group 1, Census Tract 5126.02, Santa Clara County, California",0,0,0
1000000US060855126021068,060855126021068,"Block 1068, Block Group 1, Census Tract 5126.02, Santa Clara County, California",0,0,0
1000000US060855126021069,060855126021069,"Block 1069, Block Group 1, Census Tract 5126.02, Santa Clara County, California",0,0,0
1000000US060855126021070,060855126021070,"Block 1070, Block Group 1, Census Tract 5126.02, Santa Clara County, California",0,0,0
1000000US060855126021071,060855126021071,"Block 1071, Block Group 1, Census Tract 5126.02, Santa Clara County, California",0,0,0
1000000US060855126021072,060855126021072,"Block 1072, Block Group 1, Census Tract 5126.02, Santa Clara County, California",0,0,0
1000000US060855126021073,060855126021073,"Block 1073, Block Group 1, Census Tract 5126.02, Santa Clara County, California",1,1,0
1000000US060855126021074,060855126021074,"Block 1074, Block Group 1, Census Tract 5126.02, Santa Clara County, California",0,0,0
1000000US060855126021075,060855126021075,"Block 1075, Block Group 1, Census Tract 5126.02, Santa Clara County, California",0,0,0
1000000US060855126021076,060855126021076,"Block 1076, Block Group 1, Census Tract 5126.02, Santa Clara County, California",0,0,0
1000000US060855126021077,060855126021077,"Block 1077, Block Group 1, Census Tract 5126.02, Santa Clara County, California",2,2,0
1000000US060855126021078,060855126021078,"Block 1078, Block Group 1, Census Tract 5126.02, Santa Clara County, California",0,0,0
1000000US060855126021079,060855126021079,"Block 1079, Block Group 1, Census Tract 5126.02, Santa Clara County, California",0,0,0
1000000US060855126021080,060855126021080,"Block 1080, Block Group 1, Census Tract 5126.02, Santa Clara County, California",0,0,0
1000000US060855126021081,060855126021081,"Block 1081, Block Group 1, Census Tract 5126.02, Santa Clara County, California",1,1,0
1000000US060855126021082,060855126021082,"Block 1082, Block Group 1, Census Tract 5126.02, Santa Clara County, California",0,0,0
1000000US060855126021083,060855126021083,"Block 1083, Block Group 1, Census Tract 5126.02, Santa Clara County, California",0,0,0
1000000US060855126021084,060855126021084,"Block 1084, Block Group 1, Census Tract 5126.02, Santa Clara County, California",0,0,0
1000000US060855126021085,060855126021085,"Block 1085, Block Group 1, Census Tract 5126.02, Santa Clara County, California",0,0,0
1000000US060855126021086,060855126021086,"Block 1086, Block Group 1, Census Tract 5126.02, Santa Clara County, California",29,29,0
1000000US060855126021087,060855126021087,"Block 1087, Block Group 1, Census Tract 5126.02, Santa Clara County, California",0,0,0
1000000US060855126021088,060855126021088,"Block 1088, Block Group 1, Census Tract 5126.02, Santa Clara County, California",0,0,0
1000000US060855126021089,060855126021089,"Block 1089, Block Group 1, Census Tract 5126.02, Santa Clara County, California",0,0,0
1000000US060855126021090,060855126021090,"Block 1090, Block Group 1, Census Tract 5126.02, Santa Clara County, California",0,0,0
1000000US060855126021091,060855126021091,"Block 1091, Block Group 1, Census Tract 5126.02, Santa Clara County, California",0,0,0
1000000US060855126021092,060855126021092,"Block 1092, Block Group 1, Census Tract 5126.02, Santa Clara County, California",0,0,0
1000000US060855126021093,060855126021093,"Block 1093, Block Group 1, Census Tract 5126.02, Santa Clara County, California",0,0,0
1000000US060855126021094,060855126021094,"Block 1094, Block Group 1, Census Tract 5126.02, Santa Clara County, California",0,0,0
1000000US060855126021095,060855126021095,"Block 1095, Block Group 1, Census Tract 5126.02, Santa Clara County, California",0,0,0
1000000US060855126021096,060855126021096,"Block 1096, Block Group 1, Census Tract 5126.02, Santa Clara County, California",0,0,0
1000000US060855126021097,060855126021097,"Block 1097, Block Group 1, Census Tract 5126.02, Santa Clara County, California",36,19,17
1000000US060855126021098,060855126021098,"Block 1098, Block Group 1, Census Tract 5126.02, Santa Clara County, California",0,0,0
1000000US060855126021099,060855126021099,"Block 1099, Block Group 1, Census Tract 5126.02, Santa Clara County, California",0,0,0
1000000US060855126021100,060855126021100,"Block 1100, Block Group 1, Census Tract 5126.02, Santa Clara County, California",0,0,0
1000000US060855126021101,060855126021101,"Block 1101, Block Group 1, Census Tract 5126.02, Santa Clara County, California",0,0,0
1000000US060855126021102,060855126021102,"Block 1102, Block Group 1, Census Tract 5126.02, Santa Clara County, California",0,0,0
1000000US060855126021103,060855126021103,"Block 1103, Block Group 1, Census Tract 5126.02, Santa Clara County, California",0,0,0
1000000US060855126021104,060855126021104,"Block 1104, Block Group 1, Census Tract 5126.02, Santa Clara County, California",0,0,0
1000000US060855126021105,060855126021105,"Block 1105, Block Group 1, Census Tract 5126.02, Santa Clara County, California",0,0,0
1000000US060855126021106,060855126021106,"Block 1106, Block Group 1, Census Tract 5126.02, Santa Clara County, California",0,0,0
1000000US060855126021107,060855126021107,"Block 1107, Block Group 1, Census Tract 5126.02, Santa Clara County, California",0,0,0
1000000US060855126021108,060855126021108,"Block 1108, Block Group 1, Census Tract 5126.02, Santa Clara County, California",6,5,1
1000000US060855126021109,060855126021109,"Block 1109, Block Group 1, Census Tract 5126.02, Santa Clara County, California",0,0,0
1000000US060855126021110,060855126021110,"Block 1110, Block Group 1, Census Tract 5126.02, Santa Clara County, California",21,15,6
1000000US060855126021111,060855126021111,"Block 1111, Block Group 1, Census Tract 5126.02, Santa Clara County, California",2,2,0
1000000US060855126021112,060855126021112,"Block 1112, Block Group 1, Census Tract 5126.02, Santa Clara County, California",10,8,2
1000000US060855126021113,060855126021113,"Block 1113, Block Group 1, Census Tract 5126.02, Santa Clara County, California",1,1,0
1000000US060855126021114,060855126021114,"Block 1114, Block Group 1, Census Tract 5126.02, Santa Clara County, California",1,0,1
1000000US060855126021115,060855126021115,"Block 1115, Block Group 1, Census Tract 5126.02, Santa Clara County, California",0,0,0
1000000US060855126021116,060855126021116,"Block 1116, Block Group 1, Census Tract 5126.02, Santa Clara County, California",51,51,0
1000000US060855126021117,060855126021117,"Block 1117, Block Group 1, Census Tract 5126.02, Santa Clara County, California",0,0,0
1000000US060855126021118,060855126021118,"Block 1118, Block Group 1, Census Tract 5126.02, Santa Clara County, California",0,0,0
1000000US060855126021119,060855126021119,"Block 1119, Block Group 1, Census Tract 5126.02, Santa Clara County, California",5,5,0
1000000US060855126021120,060855126021120,"Block 1120, Block Group 1, Census Tract 5126.02, Santa Clara County, California",0,0,0
1000000US060855126021121,060855126021121,"Block 1121, Block Group 1, Census Tract 5126.02, Santa Clara County, California",0,0,0
1000000US060855126021122,060855126021122,"Block 1122, Block Group 1, Census Tract 5126.02, Santa Clara County, California",0,0,0
1000000US060855126021123,060855126021123,"Block 1123, Block Group 1, Census Tract 5126.02, Santa Clara County, California",0,0,0
1000000US060855126021124,060855126021124,"Block 1124, Block Group 1, Census Tract 5126.02, Santa Clara County, California",0,0,0
1000000US060855126021125,060855126021125,"Block 1125, Block Group 1, Census Tract 5126.02, Santa Clara County, California",0,0,0
1000000US060855126021126,060855126021126,"Block 1126, Block Group 1, Census Tract 5126.02, Santa Clara County, California",0,0,0
1000000US060855126021127,060855126021127,"Block 1127, Block Group 1, Census Tract 5126.02, Santa Clara County, California",0,0,0
1000000US060855126021128,060855126021128,"Block 1128, Block Group 1, Census Tract 5126.02, Santa Clara County, California",0,0,0
1000000US060855126021129,060855126021129,"Block 1129, Block Group 1, Census Tract 5126.02, Santa Clara County, California",0,0,0
1000000US060855126021130,060855126021130,"Block 1130, Block Group 1, Census Tract 5126.02, Santa Clara County, California",0,0,0
1000000US060855126021131,060855126021131,"Block 1131, Block Group 1, Census Tract 5126.02, Santa Clara County, California",0,0,0
1000000US060855126021132,060855126021132,"Block 1132, Block Group 1, Census Tract 5126.02, Santa Clara County, California",1,1,0
1000000US060855126021133,060855126021133,"Block 1133, Block Group 1, Census Tract 5126.02, Santa Clara County, California",0,0,0
1000000US060855126021134,060855126021134,"Block 1134, Block Group 1, Census Tract 5126.02, Santa Clara County, California",0,0,0
1000000US060855126021135,060855126021135,"Block 1135, Block Group 1, Census Tract 5126.02, Santa Clara County, California",5,5,0
1000000US060855126021136,060855126021136,"Block 1136, Block Group 1, Census Tract 5126.02, Santa Clara County, California",0,0,0
1000000US060855126021137,060855126021137,"Block 1137, Block Group 1, Census Tract 5126.02, Santa Clara County, California",0,0,0
1000000US060855126021138,060855126021138,"Block 1138, Block Group 1, Census Tract 5126.02, Santa Clara County, California",0,0,0
1000000US060855126021139,060855126021139,"Block 1139, Block Group 1, Census Tract 5126.02, Santa Clara County, California",2,2,0
1000000US060855126021140,060855126021140,"Block 1140, Block Group 1, Census Tract 5126.02, Santa Clara County, California",0,0,0
1000000US060855126021141,060855126021141,"Block 1141, Block Group 1, Census Tract 5126.02, Santa Clara County, California",1,1,0
1000000US060855126021142,060855126021142,"Block 1142, Block Group 1, Census Tract 5126.02, Santa Clara County, California",0,0,0
1000000US060855126021143,060855126021143,"Block 1143, Block Group 1, Census Tract 5126.02, Santa Clara County, California",8,8,0
1000000US060855126021144,060855126021144,"Block 1144, Block Group 1, Census Tract 5126.02, Santa Clara County, California",0,0,0
1000000US060855126021145,060855126021145,"Block 1145, Block Group 1, Census Tract 5126.02, Santa Clara County, California",18,18,0
1000000US060855126021146,060855126021146,"Block 1146, Block Group 1, Census Tract 5126.02, Santa Clara County, California",3,3,0
1000000US060855126021147,060855126021147,"Block 1147, Block Group 1, Census Tract 5126.02, Santa Clara County, California",0,0,0
1000000US060855126021148,060855126021148,"Block 1148, Block Group 1, Census Tract 5126.02, Santa Clara County, California",6,5,1
1000000US060855126021149,060855126021149,"Block 1149, Block Group 1, Census Tract 5126.02, Santa Clara County, California",0,0,0
1000000US060855126021150,060855126021150,"Block 1150, Block Group 1, Census Tract 5126.02, Santa Clara County, California",4,4,0
1000000US060855126021151,060855126021151,"Block 1151, Block Group 1, Census Tract 5126.02, Santa Clara County, California",0,0,0
1000000US060855126021152,060855126021152,"Block 1152, Block Group 1, Census Tract 5126.02, Santa Clara County, California",0,0,0
1000000US060855126021153,060855126021153,"Block 1153, Block Group 1, Census Tract 5126.02, Santa Clara County, California",0,0,0
1000000US060855126021154,060855126021154,"Block 1154, Block Group 1, Census Tract 5126.02, Santa Clara County, California",0,0,0
1000000US060855126021155,060855126021155,"Block 1155, Block Group 1, Census Tract 5126.02, Santa Clara County, California",1,1,0
1000000US060855126021156,060855126021156,"Block 1156, Block Group 1, Census Tract 5126.02, Santa Clara County, California",0,0,0
1000000US060855126021157,060855126021157,"Block 1157, Block Group 1, Census Tract 5126.02, Santa Clara County, California",4,4,0
1000000US060855126021158,060855126021158,"Block 1158, Block Group 1, Census Tract 5126.02, Santa Clara County, California",0,0,0
1000000US060855126021159,060855126021159,"Block 1159, Block Group 1, Census Tract 5126.02, Santa Clara County, California",0,0,0
1000000US060855126021160,060855126021160,"Block 1160, Block Group 1, Census Tract 5126.02, Santa Clara County, California",0,0,0
1000000US060855126021161,060855126021161,"Block 1161, Block Group 1, Census Tract 5126.02, Santa Clara County, California",0,0,0
1000000US060855126021162,060855126021162,"Block 1162, Block Group 1, Census Tract 5126.02, Santa Clara County, California",0,0,0
1000000US060855126021163,060855126021163,"Block 1163, Block Group 1, Census Tract 5126.02, Santa Clara County, California",0,0,0
1000000US060855126021164,060855126021164,"Block 1164, Block Group 1, Census Tract 5126.02, Santa Clara County, California",1,1,0
1000000US060855126021165,060855126021165,"Block 1165, Block Group 1, Census Tract 5126.02, Santa Clara County, California",0,0,0
1000000US060855126021166,060855126021166,"Block 1166, Block Group 1, Census Tract 5126.02, Santa Clara County, California",0,0,0
1000000US060855126021167,060855126021167,"Block 1167, Block Group 1, Census Tract 5126.02, Santa Clara County, California",0,0,0
1000000US060855126021168,060855126021168,"Block 1168, Block Group 1, Census Tract 5126.02, Santa Clara County, California",0,0,0
1000000US060855126021169,060855126021169,"Block 1169, Block Group 1, Census Tract 5126.02, Santa Clara County, California",0,0,0
1000000US060855126021170,060855126021170,"Block 1170, Block Group 1, Census Tract 5126.02, Santa Clara County, California",18,16,2
1000000US060855126021171,060855126021171,"Block 1171, Block Group 1, Census Tract 5126.02, Santa Clara County, California",0,0,0
1000000US060855126021172,060855126021172,"Block 1172, Block Group 1, Census Tract 5126.02, Santa Clara County, California",1,1,0
1000000US060855126021173,060855126021173,"Block 1173, Block Group 1, Census Tract 5126.02, Santa Clara County, California",1,1,0
1000000US060855126021174,060855126021174,"Block 1174, Block Group 1, Census Tract 5126.02, Santa Clara County, California",0,0,0
1000000US060855126021175,060855126021175,"Block 1175, Block Group 1, Census Tract 5126.02, Santa Clara County, California",0,0,0
1000000US060855126021176,060855126021176,"Block 1176, Block Group 1, Census Tract 5126.02, Santa Clara County, California",0,0,0
1000000US060855126021177,060855126021177,"Block 1177, Block Group 1, Census Tract 5126.02, Santa Clara County, California",0,0,0
1000000US060855126021178,060855126021178,"Block 1178, Block Group 1, Census Tract 5126.02, Santa Clara County, California",0,0,0
1000000US060855126021179,060855126021179,"Block 1179, Block Group 1, Census Tract 5126.02, Santa Clara County, California",0,0,0
1000000US060855126021180,060855126021180,"Block 1180, Block Group 1, Census Tract 5126.02, Santa Clara County, California",0,0,0
1000000US060855126021181,060855126021181,"Block 1181, Block Group 1, Census Tract 5126.02, Santa Clara County, California",0,0,0
1000000US060855126021182,060855126021182,"Block 1182, Block Group 1, Census Tract 5126.02, Santa Clara County, California",0,0,0
1000000US060855126022000,060855126022000,"Block 2000, Block Group 2, Census Tract 5126.02, Santa Clara County, California",0,0,0
1000000US060855126022001,060855126022001,"Block 2001, Block Group 2, Census Tract 5126.02, Santa Clara County, California",140,124,16
1000000US060855126022002,060855126022002,"Block 2002, Block Group 2, Census Tract 5126.02, Santa Clara County, California",0,0,0
1000000US060855126022003,060855126022003,"Block 2003, Block Group 2, Census Tract 5126.02, Santa Clara County, California",1,1,0
1000000US060855126022004,060855126022004,"Block 2004, Block Group 2, Census Tract 5126.02, Santa Clara County, California",1,1,0
1000000US060855126022005,060855126022005,"Block 2005, Block Group 2, Census Tract 5126.02, Santa Clara County, California",0,0,0
1000000US060855126022006,060855126022006,"Block 2006, Block Group 2, Census Tract 5126.02, Santa Clara County, California",0,0,0
1000000US060855126022007,060855126022007,"Block 2007, Block Group 2, Census Tract 5126.02, Santa Clara County, California",0,0,0
1000000US060855126022008,060855126022008,"Block 2008, Block Group 2, Census Tract 5126.02, Santa Clara County, California",61,59,2
1000000US060855126022009,060855126022009,"Block 2009, Block Group 2, Census Tract 5126.02, Santa Clara County, California",1,1,0
1000000US060855126022010,060855126022010,"Block 2010, Block Group 2, Census Tract 5126.02, Santa Clara County, California",2,2,0
1000000US060855126022011,060855126022011,"Block 2011, Block Group 2, Census Tract 5126.02, Santa Clara County, California",4,3,1
1000000US060855126022012,060855126022012,"Block 2012, Block Group 2, Census Tract 5126.02, Santa Clara County, California",6,5,1
1000000US060855126022013,060855126022013,"Block 2013, Block Group 2, Census Tract 5126.02, Santa Clara County, California",0,0,0
1000000US060855126022014,060855126022014,"Block 2014, Block Group 2, Census Tract 5126.02, Santa Clara County, California",8,7,1
1000000US060855126022015,060855126022015,"Block 2015, Block Group 2, Census Tract 5126.02, Santa Clara County, California",13,12,1
1000000US060855126022016,060855126022016,"Block 2016, Block Group 2, Census Tract 5126.02, Santa Clara County, California",29,28,1
1000000US060855126022017,060855126022017,"Block 2017, Block Group 2, Census Tract 5126.02, Santa Clara County, California",1,1,0
1000000US060855126022018,060855126022018,"Block 2018, Block Group 2, Census Tract 5126.02, Santa Clara County, California",51,46,5
1000000US060855126022019,060855126022019,"Block 2019, Block Group 2, Census Tract 5126.02, Santa Clara County, California",0,0,0
1000000US060855126022020,060855126022020,"Block 2020, Block Group 2, Census Tract 5126.02, Santa Clara County, California",55,53,2
1000000US060855126022021,060855126022021,"Block 2021, Block Group 2, Census Tract 5126.02, Santa Clara County, California",0,0,0
1000000US060855126022022,060855126022022,"Block 2022, Block Group 2, Census Tract 5126.02, Santa Clara County, California",0,0,0
1000000US060855126022023,060855126022023,"Block 2023, Block Group 2, Census Tract 5126.02, Santa Clara County, California",23,20,3
1000000US060855126022024,060855126022024,"Block 2024, Block Group 2, Census Tract 5126.02, Santa Clara County, California",0,0,0
1000000US060855126022025,060855126022025,"Block 2025, Block Group 2, Census Tract 5126.02, Santa Clara County, California",2,2,0
1000000US060855126022026,060855126022026,"Block 2026, Block Group 2, Census Tract 5126.02, Santa Clara County, California",17,15,2
1000000US060855126022027,060855126022027,"Block 2027, Block Group 2, Census Tract 5126.02, Santa Clara County, California",53,53,0
1000000US060855126022028,060855126022028,"Block 2028, Block Group 2, Census Tract 5126.02, Santa Clara County, California",1,1,0
1000000US060855126022029,060855126022029,"Block 2029, Block Group 2, Census Tract 5126.02, Santa Clara County, California",1,0,1
1000000US060855126022030,060855126022030,"Block 2030, Block Group 2, Census Tract 5126.02, Santa Clara County, California",6,6,0
1000000US060855126022031,060855126022031,"Block 2031, Block Group 2, Census Tract 5126.02, Santa Clara County, California",0,0,0
1000000US060855126022032,060855126022032,"Block 2032, Block Group 2, Census Tract 5126.02, Santa Clara County, California",6,3,3
1000000US060855126022033,060855126022033,"Block 2033, Block Group 2, Census Tract 5126.02, Santa Clara County, California",7,7,0
1000000US060855126022034,060855126022034,"Block 2034, Block Group 2, Census Tract 5126.02, Santa Clara County, California",0,0,0
1000000US060855126022035,060855126022035,"Block 2035, Block Group 2, Census Tract 5126.02, Santa Clara County, California",8,7,1
1000000US060855126022036,060855126022036,"Block 2036, Block Group 2, Census Tract 5126.02, Santa Clara County, California",0,0,0
1000000US060855126022037,060855126022037,"Block 2037, Block Group 2, Census Tract 5126.02, Santa Clara County, California",0,0,0
1000000US060855126022038,060855126022038,"Block 2038, Block Group 2, Census Tract 5126.02, Santa Clara County, California",0,0,0
1000000US060855126031000,060855126031000,"Block 1000, Block Group 1, Census Tract 5126.03, Santa Clara County, California",22,22,0
1000000US060855126031001,060855126031001,"Block 1001, Block Group 1, Census Tract 5126.03, Santa Clara County, California",38,34,4
1000000US060855126031002,060855126031002,"Block 1002, Block Group 1, Census Tract 5126.03, Santa Clara County, California",84,79,5
1000000US060855126031003,060855126031003,"Block 1003, Block Group 1, Census Tract 5126.03, Santa Clara County, California",21,21,0
1000000US060855126031004,060855126031004,"Block 1004, Block Group 1, Census Tract 5126.03, Santa Clara County, California",21,18,3
1000000US060855126031005,060855126031005,"Block 1005, Block Group 1, Census Tract 5126.03, Santa Clara County, California",38,36,2
1000000US060855126031006,060855126031006,"Block 1006, Block Group 1, Census Tract 5126.03, Santa Clara County, California",24,23,1
1000000US060855126031007,060855126031007,"Block 1007, Block Group 1, Census Tract 5126.03, Santa Clara County, California",2,2,0
1000000US060855126031008,060855126031008,"Block 1008, Block Group 1, Census Tract 5126.03, Santa Clara County, California",13,12,1
1000000US060855126031009,060855126031009,"Block 1009, Block Group 1, Census Tract 5126.03, Santa Clara County, California",1,1,0
1000000US060855126031010,060855126031010,"Block 1010, Block Group 1, Census Tract 5126.03, Santa Clara County, California",2,2,0
1000000US060855126031011,060855126031011,"Block 1011, Block Group 1, Census Tract 5126.03, Santa Clara County, California",0,0,0
1000000US060855126031012,060855126031012,"Block 1012, Block Group 1, Census Tract 5126.03, Santa Clara County, California",0,0,0
1000000US060855126031013,060855126031013,"Block 1013, Block Group 1, Census Tract 5126.03, Santa Clara County, California",18,18,0
1000000US060855126032000,060855126032000,"Block 2000, Block Group 2, Census Tract 5126.03, Santa Clara County, California",1,1,0
1000000US060855126032001,060855126032001,"Block 2001, Block Group 2, Census Tract 5126.03, Santa Clara County, California",6,6,0
1000000US060855126032002,060855126032002,"Block 2002, Block Group 2, Census Tract 5126.03, Santa Clara County, California",25,23,2
1000000US060855126032003,060855126032003,"Block 2003, Block Group 2, Census Tract 5126.03, Santa Clara County, California",34,33,1
1000000US060855126032004,060855126032004,"Block 2004, Block Group 2, Census Tract 5126.03, Santa Clara County, California",4,4,0
1000000US060855126032005,060855126032005,"Block 2005, Block Group 2, Census Tract 5126.03, Santa Clara County, California",21,19,2
1000000US060855126032006,060855126032006,"Block 2006, Block Group 2, Census Tract 5126.03, Santa Clara County, California",1,0,1
1000000US060855126032007,060855126032007,"Block 2007, Block Group 2, Census Tract 5126.03, Santa Clara County, California",49,37,12
1000000US060855126032008,060855126032008,"Block 2008, Block Group 2, Census Tract 5126.03, Santa Clara County, California",42,42,0
1000000US060855126032009,060855126032009,"Block 2009, Block Group 2, Census Tract 5126.03, Santa Clara County, California",0,0,0
1000000US060855126032010,060855126032010,"Block 2010, Block Group 2, Census Tract 5126.03, Santa Clara County, California",21,20,1
1000000US060855126033000,060855126033000,"Block 3000, Block Group 3, Census Tract 5126.03, Santa Clara County, California",0,0,0
1000000US060855126033001,060855126033001,"Block 3001, Block Group 3, Census Tract 5126.03, Santa Clara County, California",65,65,0
1000000US060855126033002,060855126033002,"Block 3002, Block Group 3, Census Tract 5126.03, Santa Clara County, California",65,63,2
1000000US060855126033003,060855126033003,"Block 3003, Block Group 3, Census Tract 5126.03, Santa Clara County, California",0,0,0
1000000US060855126033004,060855126033004,"Block 3004, Block Group 3, Census Tract 5126.03, Santa Clara County, California",45,42,3
1000000US060855126033005,060855126033005,"Block 3005, Block Group 3, Census Tract 5126.03, Santa Clara County, California",12,11,1
1000000US060855126033006,060855126033006,"Block 3006, Block Group 3, Census Tract 5126.03, Santa Clara County, California",30,29,1
1000000US060855126033007,060855126033007,"Block 3007, Block Group 3, Census Tract 5126.03, Santa Clara County, California",27,24,3
1000000US060855126033008,060855126033008,"Block 3008, Block Group 3, Census Tract 5126.03, Santa Clara County, California",20,19,1
1000000US060855126033009,060855126033009,"Block 3009, Block Group 3, Census Tract 5126.03, Santa Clara County, California",23,23,0
1000000US060855126033010,060855126033010,"Block 3010, Block Group 3, Census Tract 5126.03, Santa Clara County, California",0,0,0
1000000US060855126033011,060855126033011,"Block 3011, Block Group 3, Census Tract 5126.03, Santa Clara County, California",0,0,0
1000000US060855126033012,060855126033012,"Block 3012, Block Group 3, Census Tract 5126.03, Santa Clara County, California",0,0,0
1000000US060855126033013,060855126033013,"Block 3013, Block Group 3, Census Tract 5126.03, Santa Clara County, California",25,25,0
1000000US060855126033014,060855126033014,"Block 3014, Block Group 3, Census Tract 5126.03, Santa Clara County, California",30,29,1
1000000US060855126033015,060855126033015,"Block 3015, Block Group 3, Census Tract 5126.03, Santa Clara County, California",0,0,0
1000000US060855126033016,060855126033016,"Block 3016, Block Group 3, Census Tract 5126.03, Santa Clara County, California",0,0,0
1000000US060855126033017,060855126033017,"Block 3017, Block Group 3, Census Tract 5126.03, Santa Clara County, California",0,0,0
1000000US060855126033018,060855126033018,"Block 3018, Block Group 3, Census Tract 5126.03, Santa Clara County, California",14,11,3
1000000US060855126033019,060855126033019,"Block 3019, Block Group 3, Census Tract 5126.03, Santa Clara County, California",0,0,0
1000000US060855126033020,060855126033020,"Block 3020, Block Group 3, Census Tract 5126.03, Santa Clara County, California",3,3,0
1000000US060855126033021,060855126033021,"Block 3021, Block Group 3, Census Tract 5126.03, Santa Clara County, California",7,7,0
1000000US060855126033022,060855126033022,"Block 3022, Block Group 3, Census Tract 5126.03, Santa Clara County, California",22,20,2
1000000US060855126033023,060855126033023,"Block 3023, Block Group 3, Census Tract 5126.03, Santa Clara County, California",6,6,0
1000000US060855126033024,060855126033024,"Block 3024, Block Group 3, Census Tract 5126.03, Santa Clara County, California",34,32,2
1000000US060855126033025,060855126033025,"Block 3025, Block Group 3, Census Tract 5126.03, Santa Clara County, California",14,14,0
1000000US060855126033026,060855126033026,"Block 3026, Block Group 3, Census Tract 5126.03, Santa Clara County, California",17,16,1
1000000US060855126033027,060855126033027,"Block 3027, Block Group 3, Census Tract 5126.03, Santa Clara County, California",0,0,0
1000000US060855126033028,060855126033028,"Block 3028, Block Group 3, Census Tract 5126.03, Santa Clara County, California",0,0,0
1000000US060855126033029,060855126033029,"Block 3029, Block Group 3, Census Tract 5126.03, Santa Clara County, California",0,0,0
1000000US060855126033030,060855126033030,"Block 3030, Block Group 3, Census Tract 5126.03, Santa Clara County, California",0,0,0
1000000US060855126033031,060855126033031,"Block 3031, Block Group 3, Census Tract 5126.03, Santa Clara County, California",0,0,0
1000000US060855126033032,060855126033032,"Block 3032, Block Group 3, Census Tract 5126.03, Santa Clara County, California",0,0,0
1000000US060855126033033,060855126033033,"Block 3033, Block Group 3, Census Tract 5126.03, Santa Clara County, California",0,0,0
1000000US060855126033034,060855126033034,"Block 3034, Block Group 3, Census Tract 5126.03, Santa Clara County, California",0,0,0
1000000US060855126033035,060855126033035,"Block 3035, Block Group 3, Census Tract 5126.03, Santa Clara County, California",0,0,0
1000000US060855126033036,060855126033036,"Block 3036, Block Group 3, Census Tract 5126.03, Santa Clara County, California",46,45,1
1000000US060855126033037,060855126033037,"Block 3037, Block Group 3, Census Tract 5126.03, Santa Clara County, California",0,0,0
1000000US060855126033038,060855126033038,"Block 3038, Block Group 3, Census Tract 5126.03, Santa Clara County, California",0,0,0
1000000US060855126033039,060855126033039,"Block 3039, Block Group 3, Census Tract 5126.03, Santa Clara County, California",0,0,0
1000000US060855126033040,060855126033040,"Block 3040, Block Group 3, Census Tract 5126.03, Santa Clara County, California",0,0,0
1000000US060855126033041,060855126033041,"Block 3041, Block Group 3, Census Tract 5126.03, Santa Clara County, California",0,0,0
1000000US060855126033042,060855126033042,"Block 3042, Block Group 3, Census Tract 5126.03, Santa Clara County, California",0,0,0
1000000US060855126033043,060855126033043,"Block 3043, Block Group 3, Census Tract 5126.03, Santa Clara County, California",0,0,0
1000000US060855126033044,060855126033044,"Block 3044, Block Group 3, Census Tract 5126.03, Santa Clara County, California",0,0,0
1000000US060855126033045,060855126033045,"Block 3045, Block Group 3, Census Tract 5126.03, Santa Clara County, California",10,10,0
1000000US060855126033046,060855126033046,"Block 3046, Block Group 3, Census Tract 5126.03, Santa Clara County, California",0,0,0
1000000US060855126033047,060855126033047,"Block 3047, Block Group 3, Census Tract 5126.03, Santa Clara County, California",0,0,0
1000000US060855126033048,060855126033048,"Block 3048, Block Group 3, Census Tract 5126.03, Santa Clara County, California",0,0,0
1000000US060855126033049,060855126033049,"Block 3049, Block Group 3, Census Tract 5126.03, Santa Clara County, California",2,2,0
1000000US060855126033050,060855126033050,"Block 3050, Block Group 3, Census Tract 5126.03, Santa Clara County, California",27,16,11
1000000US060855126033051,060855126033051,"Block 3051, Block Group 3, Census Tract 5126.03, Santa Clara County, California",1,1,0
1000000US060855126033052,060855126033052,"Block 3052, Block Group 3, Census Tract 5126.03, Santa Clara County, California",0,0,0
1000000US060855126033053,060855126033053,"Block 3053, Block Group 3, Census Tract 5126.03, Santa Clara County, California",0,0,0
1000000US060855126033054,060855126033054,"Block 3054, Block Group 3, Census Tract 5126.03, Santa Clara County, California",0,0,0
1000000US060855126033055,060855126033055,"Block 3055, Block Group 3, Census Tract 5126.03, Santa Clara County, California",0,0,0
1000000US060855126033056,060855126033056,"Block 3056, Block Group 3, Census Tract 5126.03, Santa Clara County, California",0,0,0
1000000US060855126033057,060855126033057,"Block 3057, Block Group 3, Census Tract 5126.03, Santa Clara County, California",0,0,0
1000000US060855126033058,060855126033058,"Block 3058, Block Group 3, Census Tract 5126.03, Santa Clara County, California",0,0,0
1000000US060855126033059,060855126033059,"Block 3059, Block Group 3, Census Tract 5126.03, Santa Clara County, California",0,0,0
1000000US060855126033060,060855126033060,"Block 3060, Block Group 3, Census Tract 5126.03, Santa Clara County, California",0,0,0
1000000US060855126033061,060855126033061,"Block 3061, Block Group 3, Census Tract 5126.03, Santa Clara County, California",0,0,0
1000000US060855126041000,060855126041000,"Block 1000, Block Group 1, Census Tract 5126.04, Santa Clara County, California",0,0,0
1000000US060855126041001,060855126041001,"Block 1001, Block Group 1, Census Tract 5126.04, Santa Clara County, California",5,5,0
1000000US060855126041002,060855126041002,"Block 1002, Block Group 1, Census Tract 5126.04, Santa Clara County, California",14,12,2
1000000US060855126041003,060855126041003,"Block 1003, Block Group 1, Census Tract 5126.04, Santa Clara County, California",7,7,0
1000000US060855126041004,060855126041004,"Block 1004, Block Group 1, Census Tract 5126.04, Santa Clara County, California",16,16,0
1000000US060855126041005,060855126041005,"Block 1005, Block Group 1, Census Tract 5126.04, Santa Clara County, California",3,3,0
1000000US060855126041006,060855126041006,"Block 1006, Block Group 1, Census Tract 5126.04, Santa Clara County, California",0,0,0
1000000US060855126041007,060855126041007,"Block 1007, Block Group 1, Census Tract 5126.04, Santa Clara County, California",0,0,0
1000000US060855126041008,060855126041008,"Block 1008, Block Group 1, Census Tract 5126.04, Santa Clara County, California",0,0,0
1000000US060855126041009,060855126041009,"Block 1009, Block Group 1, Census Tract 5126.04, Santa Clara County, California",0,0,0
1000000US060855126041010,060855126041010,"Block 1010, Block Group 1, Census Tract 5126.04, Santa Clara County, California",1,1,0
1000000US060855126041011,060855126041011,"Block 1011, Block Group 1, Census Tract 5126.04, Santa Clara County, California",0,0,0
1000000US060855126041012,060855126041012,"Block 1012, Block Group 1, Census Tract 5126.04, Santa Clara County, California",14,12,2
1000000US060855126041013,060855126041013,"Block 1013, Block Group 1, Census Tract 5126.04, Santa Clara County, California",17,16,1
1000000US060855126041014,060855126041014,"Block 1014, Block Group 1, Census Tract 5126.04, Santa Clara County, California",67,67,0
1000000US060855126041015,060855126041015,"Block 1015, Block Group 1, Census Tract 5126.04, Santa Clara County, California",0,0,0
1000000US060855126041016,060855126041016,"Block 1016, Block Group 1, Census Tract 5126.04, Santa Clara County, California",0,0,0
1000000US060855126041017,060855126041017,"Block 1017, Block Group 1, Census Tract 5126.04, Santa Clara County, California",0,0,0
1000000US060855126041018,060855126041018,"Block 1018, Block Group 1, Census Tract 5126.04, Santa Clara County, California",0,0,0
1000000US060855126041019,060855126041019,"Block 1019, Block Group 1, Census Tract 5126.04, Santa Clara County, California",0,0,0
1000000US060855126041020,060855126041020,"Block 1020, Block Group 1, Census Tract 5126.04, Santa Clara County, California",0,0,0
1000000US060855126041021,060855126041021,"Block 1021, Block Group 1, Census Tract 5126.04, Santa Clara County, California",0,0,0
1000000US060855126041022,060855126041022,"Block 1022, Block Group 1, Census Tract 5126.04, Santa Clara County, California",93,90,3
1000000US060855126041023,060855126041023,"Block 1023, Block Group 1, Census Tract 5126.04, Santa Clara County, California",12,11,1
1000000US060855126041024,060855126041024,"Block 1024, Block Group 1, Census Tract 5126.04, Santa Clara County, California",115,113,2
1000000US060855126041025,060855126041025,"Block 1025, Block Group 1, Census Tract 5126.04, Santa Clara County, California",12,12,0
1000000US060855126041026,060855126041026,"Block 1026, Block Group 1, Census Tract 5126.04, Santa Clara County, California",12,11,1
1000000US060855126041027,060855126041027,"Block 1027, Block Group 1, Census Tract 5126.04, Santa Clara County, California",12,12,0
1000000US060855126041028,060855126041028,"Block 1028, Block Group 1, Census Tract 5126.04, Santa Clara County, California",3,3,0
1000000US060855126041029,060855126041029,"Block 1029, Block Group 1, Census Tract 5126.04, Santa Clara County, California",12,11,1
1000000US060855126041030,060855126041030,"Block 1030, Block Group 1, Census Tract 5126.04, Santa Clara County, California",12,12,0
1000000US060855126041031,060855126041031,"Block 1031, Block Group 1, Census Tract 5126.04, Santa Clara County, California",12,12,0
1000000US060855126041032,060855126041032,"Block 1032, Block Group 1, Census Tract 5126.04, Santa Clara County, California",12,12,0
1000000US060855126041033,060855126041033,"Block 1033, Block Group 1, Census Tract 5126.04, Santa Clara County, California",0,0,0
1000000US060855126041034,060855126041034,"Block 1034, Block Group 1, Census Tract 5126.04, Santa Clara County, California",0,0,0
1000000US060855126042000,060855126042000,"Block 2000, Block Group 2, Census Tract 5126.04, Santa Clara County, California",0,0,0
1000000US060855126042001,060855126042001,"Block 2001, Block Group 2, Census Tract 5126.04, Santa Clara County, California",0,0,0
1000000US060855126042002,060855126042002,"Block 2002, Block Group 2, Census Tract 5126.04, Santa Clara County, California",201,196,5
1000000US060855126042003,060855126042003,"Block 2003, Block Group 2, Census Tract 5126.04, Santa Clara County, California",30,29,1
1000000US060855126042004,060855126042004,"Block 2004, Block Group 2, Census Tract 5126.04, Santa Clara County, California",14,14,0
1000000US060855126042005,060855126042005,"Block 2005, Block Group 2, Census Tract 5126.04, Santa Clara County, California",102,100,2
1000000US060855126042006,060855126042006,"Block 2006, Block Group 2, Census Tract 5126.04, Santa Clara County, California",14,12,2
1000000US060855126042007,060855126042007,"Block 2007, Block Group 2, Census Tract 5126.04, Santa Clara County, California",14,13,1
1000000US060855126042008,060855126042008,"Block 2008, Block Group 2, Census Tract 5126.04, Santa Clara County, California",0,0,0
1000000US060855126042009,060855126042009,"Block 2009, Block Group 2, Census Tract 5126.04, Santa Clara County, California",28,21,7
1000000US060855126042010,060855126042010,"Block 2010, Block Group 2, Census Tract 5126.04, Santa Clara County, California",14,9,5
1000000US060855126042011,060855126042011,"Block 2011, Block Group 2, Census Tract 5126.04, Santa Clara County, California",44,44,0
1000000US060855126042012,060855126042012,"Block 2012, Block Group 2, Census Tract 5126.04, Santa Clara County, California",1,1,0
1000000US060855126042013,060855126042013,"Block 2013, Block Group 2, Census Tract 5126.04, Santa Clara County, California",18,18,0
1000000US060855126042014,060855126042014,"Block 2014, Block Group 2, Census Tract 5126.04, Santa Clara County, California",18,0,18
1000000US060855126043000,060855126043000,"Block 3000, Block Group 3, Census Tract 5126.04, Santa Clara County, California",4,4,0
1000000US060855126043001,060855126043001,"Block 3001, Block Group 3, Census Tract 5126.04, Santa Clara County, California",18,16,2
1000000US060855126043002,060855126043002,"Block 3002, Block Group 3, Census Tract 5126.04, Santa Clara County, California",10,10,0
1000000US060855126043003,060855126043003,"Block 3003, Block Group 3, Census Tract 5126.04, Santa Clara County, California",13,13,0
1000000US060855126043004,060855126043004,"Block 3004, Block Group 3, Census Tract 5126.04, Santa Clara County, California",18,14,4
1000000US060855126043005,060855126043005,"Block 3005, Block Group 3, Census Tract 5126.04, Santa Clara County, California",15,15,0
1000000US060855126043006,060855126043006,"Block 3006, Block Group 3, Census Tract 5126.04, Santa Clara County, California",24,23,1
1000000US060855126043007,060855126043007,"Block 3007, Block Group 3, Census Tract 5126.04, Santa Clara County, California",15,12,3
1000000US060855126043008,060855126043008,"Block 3008, Block Group 3, Census Tract 5126.04, Santa Clara County, California",13,13,0
1000000US060855126043009,060855126043009,"Block 3009, Block Group 3, Census Tract 5126.04, Santa Clara County, California",31,28,3
1000000US060855126043010,060855126043010,"Block 3010, Block Group 3, Census Tract 5126.04, Santa Clara County, California",24,21,3
1000000US060855126043011,060855126043011,"Block 3011, Block Group 3, Census Tract 5126.04, Santa Clara County, California",10,9,1
1000000US060855130001000,060855130001000,"Block 1000, Block Group 1, Census Tract 5130, Santa Clara County, California",0,0,0
1000000US060855130001001,060855130001001,"Block 1001, Block Group 1, Census Tract 5130, Santa Clara County, California",0,0,0
1000000US060855130001002,060855130001002,"Block 1002, Block Group 1, Census Tract 5130, Santa Clara County, California",0,0,0
1000000US060855130001003,060855130001003,"Block 1003, Block Group 1, Census Tract 5130, Santa Clara County, California",0,0,0
1000000US060855130001004,060855130001004,"Block 1004, Block Group 1, Census Tract 5130, Santa Clara County, California",0,0,0
1000000US060855130001005,060855130001005,"Block 1005, Block Group 1, Census Tract 5130, Santa Clara County, California",0,0,0
1000000US060855130001006,060855130001006,"Block 1006, Block Group 1, Census Tract 5130, Santa Clara County, California",0,0,0
1000000US060855130001007,060855130001007,"Block 1007, Block Group 1, Census Tract 5130, Santa Clara County, California",0,0,0
1000000US060855130001008,060855130001008,"Block 1008, Block Group 1, Census Tract 5130, Santa Clara County, California",0,0,0
1000000US060855130001009,060855130001009,"Block 1009, Block Group 1, Census Tract 5130, Santa Clara County, California",0,0,0
1000000US060855130001010,060855130001010,"Block 1010, Block Group 1, Census Tract 5130, Santa Clara County, California",0,0,0
1000000US060855130001011,060855130001011,"Block 1011, Block Group 1, Census Tract 5130, Santa Clara County, California",0,0,0
1000000US060855130001012,060855130001012,"Block 1012, Block Group 1, Census Tract 5130, Santa Clara County, California",0,0,0
1000000US060855130001013,060855130001013,"Block 1013, Block Group 1, Census Tract 5130, Santa Clara County, California",0,0,0
1000000US060855130001014,060855130001014,"Block 1014, Block Group 1, Census Tract 5130, Santa Clara County, California",0,0,0
1000000US060855130001015,060855130001015,"Block 1015, Block Group 1, Census Tract 5130, Santa Clara County, California",0,0,0
1000000US060855130001016,060855130001016,"Block 1016, Block Group 1, Census Tract 5130, Santa Clara County, California",83,81,2
1000000US060855130001017,060855130001017,"Block 1017, Block Group 1, Census Tract 5130, Santa Clara County, California",0,0,0
1000000US060855130001018,060855130001018,"Block 1018, Block Group 1, Census Tract 5130, Santa Clara County, California",1,1,0
1000000US060855130001019,060855130001019,"Block 1019, Block Group 1, Census Tract 5130, Santa Clara County, California",164,163,1
1000000US060855130001020,060855130001020,"Block 1020, Block Group 1, Census Tract 5130, Santa Clara County, California",0,0,0
1000000US060855130001021,060855130001021,"Block 1021, Block Group 1, Census Tract 5130, Santa Clara County, California",0,0,0
1000000US060855130001022,060855130001022,"Block 1022, Block Group 1, Census Tract 5130, Santa Clara County, California",0,0,0
1000000US060855130001023,060855130001023,"Block 1023, Block Group 1, Census Tract 5130, Santa Clara County, California",1,1,0
1000000US060855130001024,060855130001024,"Block 1024, Block Group 1, Census Tract 5130, Santa Clara County, California",1,1,0
1000000US060855130001025,060855130001025,"Block 1025, Block Group 1, Census Tract 5130, Santa Clara County, California",0,0,0
1000000US060855130001026,060855130001026,"Block 1026, Block Group 1, Census Tract 5130, Santa Clara County, California",0,0,0
1000000US060855130001027,060855130001027,"Block 1027, Block Group 1, Census Tract 5130, Santa Clara County, California",0,0,0
1000000US060855130001028,060855130001028,"Block 1028, Block Group 1, Census Tract 5130, Santa Clara County, California",2,2,0
1000000US060855130001029,060855130001029,"Block 1029, Block Group 1, Census Tract 5130, Santa Clara County, California",0,0,0
1000000US060855130001030,060855130001030,"Block 1030, Block Group 1, Census Tract 5130, Santa Clara County, California",0,0,0
1000000US060855130001031,060855130001031,"Block 1031, Block Group 1, Census Tract 5130, Santa Clara County, California",0,0,0
1000000US060855130001032,060855130001032,"Block 1032, Block Group 1, Census Tract 5130, Santa Clara County, California",0,0,0
1000000US060855130001033,060855130001033,"Block 1033, Block Group 1, Census Tract 5130, Santa Clara County, California",0,0,0
1000000US060855130001034,060855130001034,"Block 1034, Block Group 1, Census Tract 5130, Santa Clara County, California",0,0,0
1000000US060855130001035,060855130001035,"Block 1035, Block Group 1, Census Tract 5130, Santa Clara County, California",0,0,0
1000000US060855130001036,060855130001036,"Block 1036, Block Group 1, Census Tract 5130, Santa Clara County, California",0,0,0
1000000US060855130001037,060855130001037,"Block 1037, Block Group 1, Census Tract 5130, Santa Clara County, California",0,0,0
1000000US060855130001038,060855130001038,"Block 1038, Block Group 1, Census Tract 5130, Santa Clara County, California",0,0,0
1000000US060855130001039,060855130001039,"Block 1039, Block Group 1, Census Tract 5130, Santa Clara County, California",1,1,0
1000000US060855130001040,060855130001040,"Block 1040, Block Group 1, Census Tract 5130, Santa Clara County, California",0,0,0
1000000US060855130001041,060855130001041,"Block 1041, Block Group 1, Census Tract 5130, Santa Clara County, California",0,0,0
1000000US060855130001042,060855130001042,"Block 1042, Block Group 1, Census Tract 5130, Santa Clara County, California",0,0,0
1000000US060855130001043,060855130001043,"Block 1043, Block Group 1, Census Tract 5130, Santa Clara County, California",0,0,0
1000000US060855130001044,060855130001044,"Block 1044, Block Group 1, Census Tract 5130, Santa Clara County, California",0,0,0
1000000US060855130001045,060855130001045,"Block 1045, Block Group 1, Census Tract 5130, Santa Clara County, California",0,0,0
1000000US060855130001046,060855130001046,"Block 1046, Block Group 1, Census Tract 5130, Santa Clara County, California",0,0,0
1000000US060855130001047,060855130001047,"Block 1047, Block Group 1, Census Tract 5130, Santa Clara County, California",0,0,0
1000000US060855130001048,060855130001048,"Block 1048, Block Group 1, Census Tract 5130, Santa Clara County, California",0,0,0
1000000US060855130001049,060855130001049,"Block 1049, Block Group 1, Census Tract 5130, Santa Clara County, California",0,0,0
1000000US060855130001050,060855130001050,"Block 1050, Block Group 1, Census Tract 5130, Santa Clara County, California",0,0,0
1000000US060855130001051,060855130001051,"Block 1051, Block Group 1, Census Tract 5130, Santa Clara County, California",2,2,0
1000000US060855130001052,060855130001052,"Block 1052, Block Group 1, Census Tract 5130, Santa Clara County, California",114,114,0
1000000US060855130001053,060855130001053,"Block 1053, Block Group 1, Census Tract 5130, Santa Clara County, California",0,0,0
1000000US060855130001054,060855130001054,"Block 1054, Block Group 1, Census Tract 5130, Santa Clara County, California",221,218,3
1000000US060855130001055,060855130001055,"Block 1055, Block Group 1, Census Tract 5130, Santa Clara County, California",0,0,0
1000000US060855130001056,060855130001056,"Block 1056, Block Group 1, Census Tract 5130, Santa Clara County, California",0,0,0
1000000US060855130001057,060855130001057,"Block 1057, Block Group 1, Census Tract 5130, Santa Clara County, California",0,0,0
1000000US060855130001058,060855130001058,"Block 1058, Block Group 1, Census Tract 5130, Santa Clara County, California",0,0,0
1000000US060855130001059,060855130001059,"Block 1059, Block Group 1, Census Tract 5130, Santa Clara County, California",0,0,0
1000000US060855130001060,060855130001060,"Block 1060, Block Group 1, Census Tract 5130, Santa Clara County, California",0,0,0
1000000US060855130001061,060855130001061,"Block 1061, Block Group 1, Census Tract 5130, Santa Clara County, California",143,143,0
1000000US060855130001062,060855130001062,"Block 1062, Block Group 1, Census Tract 5130, Santa Clara County, California",0,0,0
1000000US060855130001063,060855130001063,"Block 1063, Block Group 1, Census Tract 5130, Santa Clara County, California",0,0,0
1000000US060855130001064,060855130001064,"Block 1064, Block Group 1, Census Tract 5130, Santa Clara County, California",0,0,0
1000000US060855130001065,060855130001065,"Block 1065, Block Group 1, Census Tract 5130, Santa Clara County, California",0,0,0
1000000US060855130001066,060855130001066,"Block 1066, Block Group 1, Census Tract 5130, Santa Clara County, California",318,318,0
1000000US060855130001067,060855130001067,"Block 1067, Block Group 1, Census Tract 5130, Santa Clara County, California",0,0,0
1000000US060855130001068,060855130001068,"Block 1068, Block Group 1, Census Tract 5130, Santa Clara County, California",88,88,0
1000000US060855130001069,060855130001069,"Block 1069, Block Group 1, Census Tract 5130, Santa Clara County, California",0,0,0
1000000US060855130001070,060855130001070,"Block 1070, Block Group 1, Census Tract 5130, Santa Clara County, California",0,0,0
1000000US060855130001071,060855130001071,"Block 1071, Block Group 1, Census Tract 5130, Santa Clara County, California",0,0,0
1000000US060855130001072,060855130001072,"Block 1072, Block Group 1, Census Tract 5130, Santa Clara County, California",0,0,0
1000000US060855130001073,060855130001073,"Block 1073, Block Group 1, Census Tract 5130, Santa Clara County, California",0,0,0
1000000US060855130001074,060855130001074,"Block 1074, Block Group 1, Census Tract 5130, Santa Clara County, California",0,0,0
1000000US060855130001075,060855130001075,"Block 1075, Block Group 1, Census Tract 5130, Santa Clara County, California",0,0,0
1000000US060855130001076,060855130001076,"Block 1076, Block Group 1, Census Tract 5130, Santa Clara County, California",0,0,0
1000000US060855130001077,060855130001077,"Block 1077, Block Group 1, Census Tract 5130, Santa Clara County, California",0,0,0
1000000US060855130002000,060855130002000,"Block 2000, Block Group 2, Census Tract 5130, Santa Clara County, California",300,297,3
1000000US060855130002001,060855130002001,"Block 2001, Block Group 2, Census Tract 5130, Santa Clara County, California",0,0,0
1000000US060855130002002,060855130002002,"Block 2002, Block Group 2, Census Tract 5130, Santa Clara County, California",0,0,0
1000000US060855130002003,060855130002003,"Block 2003, Block Group 2, Census Tract 5130, Santa Clara County, California",141,140,1
1000000US060855130002004,060855130002004,"Block 2004, Block Group 2, Census Tract 5130, Santa Clara County, California",0,0,0
1000000US060855130002005,060855130002005,"Block 2005, Block Group 2, Census Tract 5130, Santa Clara County, California",0,0,0
1000000US060855130002006,060855130002006,"Block 2006, Block Group 2, Census Tract 5130, Santa Clara County, California",0,0,0
1000000US060855130002007,060855130002007,"Block 2007, Block Group 2, Census Tract 5130, Santa Clara County, California",0,0,0
1000000US060855130002008,060855130002008,"Block 2008, Block Group 2, Census Tract 5130, Santa Clara County, California",0,0,0
1000000US060855130002009,060855130002009,"Block 2009, Block Group 2, Census Tract 5130, Santa Clara County, California",0,0,0
1000000US060855130002010,060855130002010,"Block 2010, Block Group 2, Census Tract 5130, Santa Clara County, California",394,376,18
1000000US060855130002011,060855130002011,"Block 2011, Block Group 2, Census Tract 5130, Santa Clara County, California",0,0,0
1000000US060855130002012,060855130002012,"Block 2012, Block Group 2, Census Tract 5130, Santa Clara County, California",0,0,0
1000000US060855130002013,060855130002013,"Block 2013, Block Group 2, Census Tract 5130, Santa Clara County, California",0,0,0
1000000US060855130003000,060855130003000,"Block 3000, Block Group 3, Census Tract 5130, Santa Clara County, California",0,0,0
1000000US060855130003001,060855130003001,"Block 3001, Block Group 3, Census Tract 5130, Santa Clara County, California",1008,1000,8
1000000US060855130003002,060855130003002,"Block 3002, Block Group 3, Census Tract 5130, Santa Clara County, California",0,0,0
1000000US060855130003003,060855130003003,"Block 3003, Block Group 3, Census Tract 5130, Santa Clara County, California",0,0,0
1000000US060855130003004,060855130003004,"Block 3004, Block Group 3, Census Tract 5130, Santa Clara County, California",0,0,0
1000000US060855130003005,060855130003005,"Block 3005, Block Group 3, Census Tract 5130, Santa Clara County, California",0,0,0
1000000US060855130003006,060855130003006,"Block 3006, Block Group 3, Census Tract 5130, Santa Clara County, California",0,0,0
1000000US060855130003007,060855130003007,"Block 3007, Block Group 3, Census Tract 5130, Santa Clara County, California",0,0,0
1000000US060855135001000,060855135001000,"Block 1000, Block Group 1, Census Tract 5135, Santa Clara County, California",6,3,3
1000000US060855135001001,060855135001001,"Block 1001, Block Group 1, Census Tract 5135, Santa Clara County, California",0,0,0
1000000US060855135001002,060855135001002,"Block 1002, Block Group 1, Census Tract 5135, Santa Clara County, California",1,0,1
1000000US060855135001003,060855135001003,"Block 1003, Block Group 1, Census Tract 5135, Santa Clara County, California",1,1,0
1000000US060855135001004,060855135001004,"Block 1004, Block Group 1, Census Tract 5135, Santa Clara County, California",1,0,1
1000000US060855135001005,060855135001005,"Block 1005, Block Group 1, Census Tract 5135, Santa Clara County, California",0,0,0
1000000US060855135001006,060855135001006,"Block 1006, Block Group 1, Census Tract 5135, Santa Clara County, California",0,0,0
1000000US060855135001007,060855135001007,"Block 1007, Block Group 1, Census Tract 5135, Santa Clara County, California",0,0,0
1000000US060855135001008,060855135001008,"Block 1008, Block Group 1, Census Tract 5135, Santa Clara County, California",0,0,0
1000000US060855135001009,060855135001009,"Block 1009, Block Group 1, Census Tract 5135, Santa Clara County, California",0,0,0
1000000US060855135001010,060855135001010,"Block 1010, Block Group 1, Census Tract 5135, Santa Clara County, California",0,0,0
1000000US060855135001011,060855135001011,"Block 1011, Block Group 1, Census Tract 5135, Santa Clara County, California",0,0,0
1000000US060855135001012,060855135001012,"Block 1012, Block Group 1, Census Tract 5135, Santa Clara County, California",0,0,0
1000000US060855135001013,060855135001013,"Block 1013, Block Group 1, Census Tract 5135, Santa Clara County, California",0,0,0
1000000US060855135001014,060855135001014,"Block 1014, Block Group 1, Census Tract 5135, Santa Clara County, California",0,0,0
1000000US060855135001015,060855135001015,"Block 1015, Block Group 1, Census Tract 5135, Santa Clara County, California",0,0,0
1000000US060855135001016,060855135001016,"Block 1016, Block Group 1, Census Tract 5135, Santa Clara County, California",0,0,0
1000000US060855135001017,060855135001017,"Block 1017, Block Group 1, Census Tract 5135, Santa Clara County, California",0,0,0
1000000US060855135001018,060855135001018,"Block 1018, Block Group 1, Census Tract 5135, Santa Clara County, California",0,0,0
1000000US060855135001019,060855135001019,"Block 1019, Block Group 1, Census Tract 5135, Santa Clara County, California",17,7,10
1000000US060855135001020,060855135001020,"Block 1020, Block Group 1, Census Tract 5135, Santa Clara County, California",0,0,0
1000000US060855135001021,060855135001021,"Block 1021, Block Group 1, Census Tract 5135, Santa Clara County, California",0,0,0
1000000US060855135001022,060855135001022,"Block 1022, Block Group 1, Census Tract 5135, Santa Clara County, California",2,2,0
1000000US060855135001023,060855135001023,"Block 1023, Block Group 1, Census Tract 5135, Santa Clara County, California",1,0,1
1000000US060855135001024,060855135001024,"Block 1024, Block Group 1, Census Tract 5135, Santa Clara County, California",0,0,0
1000000US060855135001025,060855135001025,"Block 1025, Block Group 1, Census Tract 5135, Santa Clara County, California",0,0,0
1000000US060855135001026,060855135001026,"Block 1026, Block Group 1, Census Tract 5135, Santa Clara County, California",0,0,0
1000000US060855135001027,060855135001027,"Block 1027, Block Group 1, Census Tract 5135, Santa Clara County, California",0,0,0
1000000US060855135001028,060855135001028,"Block 1028, Block Group 1, Census Tract 5135, Santa Clara County, California",0,0,0
1000000US060855135001029,060855135001029,"Block 1029, Block Group 1, Census Tract 5135, Santa Clara County, California",1,1,0
1000000US060855135001030,060855135001030,"Block 1030, Block Group 1, Census Tract 5135, Santa Clara County, California",0,0,0
1000000US060855135001031,060855135001031,"Block 1031, Block Group 1, Census Tract 5135, Santa Clara County, California",0,0,0
1000000US060855135001032,060855135001032,"Block 1032, Block Group 1, Census Tract 5135, Santa Clara County, California",0,0,0
1000000US060855135001033,060855135001033,"Block 1033, Block Group 1, Census Tract 5135, Santa Clara County, California",4,3,1
1000000US060855135001034,060855135001034,"Block 1034, Block Group 1, Census Tract 5135, Santa Clara County, California",1,1,0
1000000US060855135001035,060855135001035,"Block 1035, Block Group 1, Census Tract 5135, Santa Clara County, California",0,0,0
1000000US060855135001036,060855135001036,"Block 1036, Block Group 1, Census Tract 5135, Santa Clara County, California",6,0,6
1000000US060855135001037,060855135001037,"Block 1037, Block Group 1, Census Tract 5135, Santa Clara County, California",0,0,0
1000000US060855135001038,060855135001038,"Block 1038, Block Group 1, Census Tract 5135, Santa Clara County, California",0,0,0
1000000US060855135001039,060855135001039,"Block 1039, Block Group 1, Census Tract 5135, Santa Clara County, California",0,0,0
1000000US060855135001040,060855135001040,"Block 1040, Block Group 1, Census Tract 5135, Santa Clara County, California",1,0,1
1000000US060855135001041,060855135001041,"Block 1041, Block Group 1, Census Tract 5135, Santa Clara County, California",0,0,0
1000000US060855135001042,060855135001042,"Block 1042, Block Group 1, Census Tract 5135, Santa Clara County, California",0,0,0
1000000US060855135001043,060855135001043,"Block 1043, Block Group 1, Census Tract 5135, Santa Clara County, California",0,0,0
1000000US060855135001044,060855135001044,"Block 1044, Block Group 1, Census Tract 5135, Santa Clara County, California",0,0,0
1000000US060855135001045,060855135001045,"Block 1045, Block Group 1, Census Tract 5135, Santa Clara County, California",0,0,0
1000000US060855135001046,060855135001046,"Block 1046, Block Group 1, Census Tract 5135, Santa Clara County, California",0,0,0
1000000US060855135001047,060855135001047,"Block 1047, Block Group 1, Census Tract 5135, Santa Clara County, California",0,0,0
1000000US060855135001048,060855135001048,"Block 1048, Block Group 1, Census Tract 5135, Santa Clara County, California",0,0,0
1000000US060855135001049,060855135001049,"Block 1049, Block Group 1, Census Tract 5135, Santa Clara County, California",0,0,0
1000000US060855135001050,060855135001050,"Block 1050, Block Group 1, Census Tract 5135, Santa Clara County, California",0,0,0
1000000US060855135001051,060855135001051,"Block 1051, Block Group 1, Census Tract 5135, Santa Clara County, California",0,0,0
1000000US060855135001052,060855135001052,"Block 1052, Block Group 1, Census Tract 5135, Santa Clara County, California",0,0,0
1000000US060855135001053,060855135001053,"Block 1053, Block Group 1, Census Tract 5135, Santa Clara County, California",0,0,0
1000000US060855135001054,060855135001054,"Block 1054, Block Group 1, Census Tract 5135, Santa Clara County, California",0,0,0
1000000US060855135001055,060855135001055,"Block 1055, Block Group 1, Census Tract 5135, Santa Clara County, California",0,0,0
1000000US060855135001056,060855135001056,"Block 1056, Block Group 1, Census Tract 5135, Santa Clara County, California",0,0,0
1000000US060855135001057,060855135001057,"Block 1057, Block Group 1, Census Tract 5135, Santa Clara County, California",0,0,0
1000000US060855135001058,060855135001058,"Block 1058, Block Group 1, Census Tract 5135, Santa Clara County, California",0,0,0
1000000US060855135001059,060855135001059,"Block 1059, Block Group 1, Census Tract 5135, Santa Clara County, California",0,0,0
1000000US060855135001060,060855135001060,"Block 1060, Block Group 1, Census Tract 5135, Santa Clara County, California",0,0,0
1000000US060855135001061,060855135001061,"Block 1061, Block Group 1, Census Tract 5135, Santa Clara County, California",0,0,0
1000000US060855135001062,060855135001062,"Block 1062, Block Group 1, Census Tract 5135, Santa Clara County, California",0,0,0
1000000US060855135001063,060855135001063,"Block 1063, Block Group 1, Census Tract 5135, Santa Clara County, California",2,0,2
1000000US060855135001064,060855135001064,"Block 1064, Block Group 1, Census Tract 5135, Santa Clara County, California",0,0,0
1000000US060855135001065,060855135001065,"Block 1065, Block Group 1, Census Tract 5135, Santa Clara County, California",15,14,1
1000000US060855135001066,060855135001066,"Block 1066, Block Group 1, Census Tract 5135, Santa Clara County, California",16,15,1
1000000US060855135001067,060855135001067,"Block 1067, Block Group 1, Census Tract 5135, Santa Clara County, California",3,3,0
1000000US060855135001068,060855135001068,"Block 1068, Block Group 1, Census Tract 5135, Santa Clara County, California",0,0,0
1000000US060855135001069,060855135001069,"Block 1069, Block Group 1, Census Tract 5135, Santa Clara County, California",6,5,1
1000000US060855135001070,060855135001070,"Block 1070, Block Group 1, Census Tract 5135, Santa Clara County, California",0,0,0
1000000US060855135001071,060855135001071,"Block 1071, Block Group 1, Census Tract 5135, Santa Clara County, California",0,0,0
1000000US060855135001072,060855135001072,"Block 1072, Block Group 1, Census Tract 5135, Santa Clara County, California",0,0,0
1000000US060855135001073,060855135001073,"Block 1073, Block Group 1, Census Tract 5135, Santa Clara County, California",0,0,0
1000000US060855135001074,060855135001074,"Block 1074, Block Group 1, Census Tract 5135, Santa Clara County, California",0,0,0
1000000US060855135001075,060855135001075,"Block 1075, Block Group 1, Census Tract 5135, Santa Clara County, California",0,0,0
1000000US060855135001076,060855135001076,"Block 1076, Block Group 1, Census Tract 5135, Santa Clara County, California",0,0,0
1000000US060855135001077,060855135001077,"Block 1077, Block Group 1, Census Tract 5135, Santa Clara County, California",1,1,0
1000000US060855135001078,060855135001078,"Block 1078, Block Group 1, Census Tract 5135, Santa Clara County, California",0,0,0
1000000US060855135001079,060855135001079,"Block 1079, Block Group 1, Census Tract 5135, Santa Clara County, California",0,0,0
1000000US060855135001080,060855135001080,"Block 1080, Block Group 1, Census Tract 5135, Santa Clara County, California",2,2,0
1000000US060855135001081,060855135001081,"Block 1081, Block Group 1, Census Tract 5135, Santa Clara County, California",11,8,3
1000000US060855135001082,060855135001082,"Block 1082, Block Group 1, Census Tract 5135, Santa Clara County, California",0,0,0
1000000US060855135001083,060855135001083,"Block 1083, Block Group 1, Census Tract 5135, Santa Clara County, California",11,8,3
1000000US060855135001084,060855135001084,"Block 1084, Block Group 1, Census Tract 5135, Santa Clara County, California",1,1,0
1000000US060855135001085,060855135001085,"Block 1085, Block Group 1, Census Tract 5135, Santa Clara County, California",6,6,0
1000000US060855135001086,060855135001086,"Block 1086, Block Group 1, Census Tract 5135, Santa Clara County, California",0,0,0
1000000US060855135001087,060855135001087,"Block 1087, Block Group 1, Census Tract 5135, Santa Clara County, California",1,1,0
1000000US060855135001088,060855135001088,"Block 1088, Block Group 1, Census Tract 5135, Santa Clara County, California",0,0,0
1000000US060855135001089,060855135001089,"Block 1089, Block Group 1, Census Tract 5135, Santa Clara County, California",0,0,0
1000000US060855135001090,060855135001090,"Block 1090, Block Group 1, Census Tract 5135, Santa Clara County, California",0,0,0
1000000US060855135001091,060855135001091,"Block 1091, Block Group 1, Census Tract 5135, Santa Clara County, California",0,0,0
1000000US060855135001092,060855135001092,"Block 1092, Block Group 1, Census Tract 5135, Santa Clara County, California",0,0,0
1000000US060855135001093,060855135001093,"Block 1093, Block Group 1, Census Tract 5135, Santa Clara County, California",1,1,0
1000000US060855135001094,060855135001094,"Block 1094, Block Group 1, Census Tract 5135, Santa Clara County, California",0,0,0
1000000US060855135001095,060855135001095,"Block 1095, Block Group 1, Census Tract 5135, Santa Clara County, California",3,1,2
1000000US060855135001096,060855135001096,"Block 1096, Block Group 1, Census Tract 5135, Santa Clara County, California",0,0,0
1000000US060855135001097,060855135001097,"Block 1097, Block Group 1, Census Tract 5135, Santa Clara County, California",1,1,0
1000000US060855135001098,060855135001098,"Block 1098, Block Group 1, Census Tract 5135, Santa Clara County, California",0,0,0
1000000US060855135001099,060855135001099,"Block 1099, Block Group 1, Census Tract 5135, Santa Clara County, California",0,0,0
1000000US060855135001100,060855135001100,"Block 1100, Block Group 1, Census Tract 5135, Santa Clara County, California",0,0,0
1000000US060855135001101,060855135001101,"Block 1101, Block Group 1, Census Tract 5135, Santa Clara County, California",0,0,0
1000000US060855135001102,060855135001102,"Block 1102, Block Group 1, Census Tract 5135, Santa Clara County, California",0,0,0
1000000US060855135001103,060855135001103,"Block 1103, Block Group 1, Census Tract 5135, Santa Clara County, California",0,0,0
1000000US060855135001104,060855135001104,"Block 1104, Block Group 1, Census Tract 5135, Santa Clara County, California",0,0,0
1000000US060855135001105,060855135001105,"Block 1105, Block Group 1, Census Tract 5135, Santa Clara County, California",0,0,0
1000000US060855135001106,060855135001106,"Block 1106, Block Group 1, Census Tract 5135, Santa Clara County, California",0,0,0
1000000US060855135001107,060855135001107,"Block 1107, Block Group 1, Census Tract 5135, Santa Clara County, California",4,3,1
1000000US060855135001108,060855135001108,"Block 1108, Block Group 1, Census Tract 5135, Santa Clara County, California",2,0,2
1000000US060855135001109,060855135001109,"Block 1109, Block Group 1, Census Tract 5135, Santa Clara County, California",0,0,0
1000000US060855135001110,060855135001110,"Block 1110, Block Group 1, Census Tract 5135, Santa Clara County, California",0,0,0
1000000US060855135001111,060855135001111,"Block 1111, Block Group 1, Census Tract 5135, Santa Clara County, California",5,4,1
1000000US060855135001112,060855135001112,"Block 1112, Block Group 1, Census Tract 5135, Santa Clara County, California",0,0,0
1000000US060855135001113,060855135001113,"Block 1113, Block Group 1, Census Tract 5135, Santa Clara County, California",0,0,0
1000000US060855135001114,060855135001114,"Block 1114, Block Group 1, Census Tract 5135, Santa Clara County, California",0,0,0
1000000US060855135001115,060855135001115,"Block 1115, Block Group 1, Census Tract 5135, Santa Clara County, California",1,0,1
1000000US060855135001116,060855135001116,"Block 1116, Block Group 1, Census Tract 5135, Santa Clara County, California",5,4,1
1000000US060855135001117,060855135001117,"Block 1117, Block Group 1, Census Tract 5135, Santa Clara County, California",1,0,1
1000000US060855135001118,060855135001118,"Block 1118, Block Group 1, Census Tract 5135, Santa Clara County, California",0,0,0
1000000US060855135001119,060855135001119,"Block 1119, Block Group 1, Census Tract 5135, Santa Clara County, California",4,2,2
1000000US060855135001120,060855135001120,"Block 1120, Block Group 1, Census Tract 5135, Santa Clara County, California",0,0,0
1000000US060855135001121,060855135001121,"Block 1121, Block Group 1, Census Tract 5135, Santa Clara County, California",0,0,0
1000000US060855135001122,060855135001122,"Block 1122, Block Group 1, Census Tract 5135, Santa Clara County, California",0,0,0
1000000US060855135001123,060855135001123,"Block 1123, Block Group 1, Census Tract 5135, Santa Clara County, California",0,0,0
1000000US060855135001124,060855135001124,"Block 1124, Block Group 1, Census Tract 5135, Santa Clara County, California",0,0,0
1000000US060855135001125,060855135001125,"Block 1125, Block Group 1, Census Tract 5135, Santa Clara County, California",0,0,0
1000000US060855135001126,060855135001126,"Block 1126, Block Group 1, Census Tract 5135, Santa Clara County, California",0,0,0
1000000US060855135001127,060855135001127,"Block 1127, Block Group 1, Census Tract 5135, Santa Clara County, California",5,2,3
1000000US060855135001128,060855135001128,"Block 1128, Block Group 1, Census Tract 5135, Santa Clara County, California",0,0,0
1000000US060855135001129,060855135001129,"Block 1129, Block Group 1, Census Tract 5135, Santa Clara County, California",0,0,0
1000000US060855135001130,060855135001130,"Block 1130, Block Group 1, Census Tract 5135, Santa Clara County, California",0,0,0
1000000US060855135001131,060855135001131,"Block 1131, Block Group 1, Census Tract 5135, Santa Clara County, California",3,0,3
1000000US060855135001132,060855135001132,"Block 1132, Block Group 1, Census Tract 5135, Santa Clara County, California",0,0,0
1000000US060855135001133,060855135001133,"Block 1133, Block Group 1, Census Tract 5135, Santa Clara County, California",0,0,0
1000000US060855135001134,060855135001134,"Block 1134, Block Group 1, Census Tract 5135, Santa Clara County, California",0,0,0
1000000US060855135001135,060855135001135,"Block 1135, Block Group 1, Census Tract 5135, Santa Clara County, California",2,1,1
1000000US060855135001136,060855135001136,"Block 1136, Block Group 1, Census Tract 5135, Santa Clara County, California",0,0,0
1000000US060855135001137,060855135001137,"Block 1137, Block Group 1, Census Tract 5135, Santa Clara County, California",0,0,0
1000000US060855135001138,060855135001138,"Block 1138, Block Group 1, Census Tract 5135, Santa Clara County, California",0,0,0
1000000US060855135001139,060855135001139,"Block 1139, Block Group 1, Census Tract 5135, Santa Clara County, California",0,0,0
1000000US060855135001140,060855135001140,"Block 1140, Block Group 1, Census Tract 5135, Santa Clara County, California",0,0,0
1000000US060855135001141,060855135001141,"Block 1141, Block Group 1, Census Tract 5135, Santa Clara County, California",0,0,0
1000000US060855135001142,060855135001142,"Block 1142, Block Group 1, Census Tract 5135, Santa Clara County, California",17,11,6
1000000US060855135001143,060855135001143,"Block 1143, Block Group 1, Census Tract 5135, Santa Clara County, California",8,5,3
1000000US060855135001144,060855135001144,"Block 1144, Block Group 1, Census Tract 5135, Santa Clara County, California",0,0,0
1000000US060855135001145,060855135001145,"Block 1145, Block Group 1, Census Tract 5135, Santa Clara County, California",0,0,0
1000000US060855135001146,060855135001146,"Block 1146, Block Group 1, Census Tract 5135, Santa Clara County, California",0,0,0
1000000US060855135001147,060855135001147,"Block 1147, Block Group 1, Census Tract 5135, Santa Clara County, California",0,0,0
1000000US060855135001148,060855135001148,"Block 1148, Block Group 1, Census Tract 5135, Santa Clara County, California",0,0,0
1000000US060855135001149,060855135001149,"Block 1149, Block Group 1, Census Tract 5135, Santa Clara County, California",0,0,0
1000000US060855135001150,060855135001150,"Block 1150, Block Group 1, Census Tract 5135, Santa Clara County, California",0,0,0
1000000US060855135001151,060855135001151,"Block 1151, Block Group 1, Census Tract 5135, Santa Clara County, California",11,7,4
1000000US060855135001152,060855135001152,"Block 1152, Block Group 1, Census Tract 5135, Santa Clara County, California",0,0,0
1000000US060855135001153,060855135001153,"Block 1153, Block Group 1, Census Tract 5135, Santa Clara County, California",0,0,0
1000000US060855135001154,060855135001154,"Block 1154, Block Group 1, Census Tract 5135, Santa Clara County, California",1,1,0
1000000US060855135001155,060855135001155,"Block 1155, Block Group 1, Census Tract 5135, Santa Clara County, California",0,0,0
1000000US060855135001156,060855135001156,"Block 1156, Block Group 1, Census Tract 5135, Santa Clara County, California",0,0,0
1000000US060855135001157,060855135001157,"Block 1157, Block Group 1, Census Tract 5135, Santa Clara County, California",2,1,1
1000000US060855135001158,060855135001158,"Block 1158, Block Group 1, Census Tract 5135, Santa Clara County, California",0,0,0
1000000US060855135001159,060855135001159,"Block 1159, Block Group 1, Census Tract 5135, Santa Clara County, California",0,0,0
1000000US060855135001160,060855135001160,"Block 1160, Block Group 1, Census Tract 5135, Santa Clara County, California",0,0,0
1000000US060855135001161,060855135001161,"Block 1161, Block Group 1, Census Tract 5135, Santa Clara County, California",32,21,11
1000000US060855135001162,060855135001162,"Block 1162, Block Group 1, Census Tract 5135, Santa Clara County, California",0,0,0
1000000US060855135001163,060855135001163,"Block 1163, Block Group 1, Census Tract 5135, Santa Clara County, California",0,0,0
1000000US060855135001164,060855135001164,"Block 1164, Block Group 1, Census Tract 5135, Santa Clara County, California",0,0,0
1000000US060855135001165,060855135001165,"Block 1165, Block Group 1, Census Tract 5135, Santa Clara County, California",0,0,0
1000000US060855135001166,060855135001166,"Block 1166, Block Group 1, Census Tract 5135, Santa Clara County, California",0,0,0
1000000US060855135001167,060855135001167,"Block 1167, Block Group 1, Census Tract 5135, Santa Clara County, California",1,0,1
1000000US060855135001168,060855135001168,"Block 1168, Block Group 1, Census Tract 5135, Santa Clara County, California",0,0,0
1000000US060855135001169,060855135001169,"Block 1169, Block Group 1, Census Tract 5135, Santa Clara County, California",17,10,7
1000000US060855135001170,060855135001170,"Block 1170, Block Group 1, Census Tract 5135, Santa Clara County, California",0,0,0
1000000US060855135001171,060855135001171,"Block 1171, Block Group 1, Census Tract 5135, Santa Clara County, California",0,0,0
1000000US060855135001172,060855135001172,"Block 1172, Block Group 1, Census Tract 5135, Santa Clara County, California",0,0,0
1000000US060855135001173,060855135001173,"Block 1173, Block Group 1, Census Tract 5135, Santa Clara County, California",0,0,0
1000000US060855135001174,060855135001174,"Block 1174, Block Group 1, Census Tract 5135, Santa Clara County, California",0,0,0
1000000US060855135001175,060855135001175,"Block 1175, Block Group 1, Census Tract 5135, Santa Clara County, California",0,0,0
1000000US060855135001176,060855135001176,"Block 1176, Block Group 1, Census Tract 5135, Santa Clara County, California",0,0,0
1000000US060855135001177,060855135001177,"Block 1177, Block Group 1, Census Tract 5135, Santa Clara County, California",0,0,0
1000000US060855135001178,060855135001178,"Block 1178, Block Group 1, Census Tract 5135, Santa Clara County, California",0,0,0
1000000US060855135001179,060855135001179,"Block 1179, Block Group 1, Census Tract 5135, Santa Clara County, California",0,0,0
1000000US060855135001180,060855135001180,"Block 1180, Block Group 1, Census Tract 5135, Santa Clara County, California",1,1,0
1000000US060855135001181,060855135001181,"Block 1181, Block Group 1, Census Tract 5135, Santa Clara County, California",3,2,1
1000000US060855135001182,060855135001182,"Block 1182, Block Group 1, Census Tract 5135, Santa Clara County, California",0,0,0
1000000US060855135001183,060855135001183,"Block 1183, Block Group 1, Census Tract 5135, Santa Clara County, California",0,0,0
1000000US060855135001184,060855135001184,"Block 1184, Block Group 1, Census Tract 5135, Santa Clara County, California",0,0,0
1000000US060855135001185,060855135001185,"Block 1185, Block Group 1, Census Tract 5135, Santa Clara County, California",0,0,0
1000000US060855135001186,060855135001186,"Block 1186, Block Group 1, Census Tract 5135, Santa Clara County, California",1,0,1
1000000US060855135001187,060855135001187,"Block 1187, Block Group 1, Census Tract 5135, Santa Clara County, California",0,0,0
1000000US060855135001188,060855135001188,"Block 1188, Block Group 1, Census Tract 5135, Santa Clara County, California",0,0,0
1000000US060855135001189,060855135001189,"Block 1189, Block Group 1, Census Tract 5135, Santa Clara County, California",0,0,0
1000000US060855135001190,060855135001190,"Block 1190, Block Group 1, Census Tract 5135, Santa Clara County, California",0,0,0
1000000US060855135001191,060855135001191,"Block 1191, Block Group 1, Census Tract 5135, Santa Clara County, California",0,0,0
1000000US060855135001192,060855135001192,"Block 1192, Block Group 1, Census Tract 5135, Santa Clara County, California",4,1,3
1000000US060855135001193,060855135001193,"Block 1193, Block Group 1, Census Tract 5135, Santa Clara County, California",0,0,0
1000000US060855135001194,060855135001194,"Block 1194, Block Group 1, Census Tract 5135, Santa Clara County, California",0,0,0
1000000US060855135001195,060855135001195,"Block 1195, Block Group 1, Census Tract 5135, Santa Clara County, California",0,0,0
1000000US060855135001196,060855135001196,"Block 1196, Block Group 1, Census Tract 5135, Santa Clara County, California",0,0,0
1000000US060855135001197,060855135001197,"Block 1197, Block Group 1, Census Tract 5135, Santa Clara County, California",0,0,0
1000000US060855135001198,060855135001198,"Block 1198, Block Group 1, Census Tract 5135, Santa Clara County, California",0,0,0
1000000US060855135001199,060855135001199,"Block 1199, Block Group 1, Census Tract 5135, Santa Clara County, California",0,0,0
1000000US060855135001200,060855135001200,"Block 1200, Block Group 1, Census Tract 5135, Santa Clara County, California",0,0,0
1000000US060855135001201,060855135001201,"Block 1201, Block Group 1, Census Tract 5135, Santa Clara County, California",0,0,0
1000000US060855135001202,060855135001202,"Block 1202, Block Group 1, Census Tract 5135, Santa Clara County, California",28,24,4
1000000US060855135001203,060855135001203,"Block 1203, Block Group 1, Census Tract 5135, Santa Clara County, California",0,0,0
1000000US060855135001204,060855135001204,"Block 1204, Block Group 1, Census Tract 5135, Santa Clara County, California",0,0,0
1000000US060855135001205,060855135001205,"Block 1205, Block Group 1, Census Tract 5135, Santa Clara County, California",0,0,0
1000000US060855135001206,060855135001206,"Block 1206, Block Group 1, Census Tract 5135, Santa Clara County, California",0,0,0
1000000US060855135001207,060855135001207,"Block 1207, Block Group 1, Census Tract 5135, Santa Clara County, California",0,0,0
1000000US060855135001208,060855135001208,"Block 1208, Block Group 1, Census Tract 5135, Santa Clara County, California",0,0,0
1000000US060855135001209,060855135001209,"Block 1209, Block Group 1, Census Tract 5135, Santa Clara County, California",0,0,0
1000000US060855135001210,060855135001210,"Block 1210, Block Group 1, Census Tract 5135, Santa Clara County, California",1,1,0
1000000US060855135001211,060855135001211,"Block 1211, Block Group 1, Census Tract 5135, Santa Clara County, California",0,0,0
1000000US060855135001212,060855135001212,"Block 1212, Block Group 1, Census Tract 5135, Santa Clara County, California",0,0,0
1000000US060855135001213,060855135001213,"Block 1213, Block Group 1, Census Tract 5135, Santa Clara County, California",0,0,0
1000000US060855135001214,060855135001214,"Block 1214, Block Group 1, Census Tract 5135, Santa Clara County, California",0,0,0
1000000US060855135001215,060855135001215,"Block 1215, Block Group 1, Census Tract 5135, Santa Clara County, California",0,0,0
1000000US060855135001216,060855135001216,"Block 1216, Block Group 1, Census Tract 5135, Santa Clara County, California",0,0,0
1000000US060855135001217,060855135001217,"Block 1217, Block Group 1, Census Tract 5135, Santa Clara County, California",1,1,0
1000000US060855135001218,060855135001218,"Block 1218, Block Group 1, Census Tract 5135, Santa Clara County, California",0,0,0
1000000US060855135001219,060855135001219,"Block 1219, Block Group 1, Census Tract 5135, Santa Clara County, California",0,0,0
1000000US060855135001220,060855135001220,"Block 1220, Block Group 1, Census Tract 5135, Santa Clara County, California",1,1,0
1000000US060855135001221,060855135001221,"Block 1221, Block Group 1, Census Tract 5135, Santa Clara County, California",0,0,0
1000000US060855135001222,060855135001222,"Block 1222, Block Group 1, Census Tract 5135, Santa Clara County, California",0,0,0
1000000US060855135001223,060855135001223,"Block 1223, Block Group 1, Census Tract 5135, Santa Clara County, California",0,0,0
1000000US060855135001224,060855135001224,"Block 1224, Block Group 1, Census Tract 5135, Santa Clara County, California",0,0,0
1000000US060855135001225,060855135001225,"Block 1225, Block Group 1, Census Tract 5135, Santa Clara County, California",0,0,0
1000000US060855135001226,060855135001226,"Block 1226, Block Group 1, Census Tract 5135, Santa Clara County, California",0,0,0
1000000US060855135001227,060855135001227,"Block 1227, Block Group 1, Census Tract 5135, Santa Clara County, California",0,0,0
1000000US060855135001228,060855135001228,"Block 1228, Block Group 1, Census Tract 5135, Santa Clara County, California",0,0,0
1000000US060855135001229,060855135001229,"Block 1229, Block Group 1, Census Tract 5135, Santa Clara County, California",0,0,0
1000000US060855135001230,060855135001230,"Block 1230, Block Group 1, Census Tract 5135, Santa Clara County, California",0,0,0
1000000US060855135001231,060855135001231,"Block 1231, Block Group 1, Census Tract 5135, Santa Clara County, California",0,0,0
1000000US060855135001232,060855135001232,"Block 1232, Block Group 1, Census Tract 5135, Santa Clara County, California",0,0,0
1000000US060855135001233,060855135001233,"Block 1233, Block Group 1, Census Tract 5135, Santa Clara County, California",0,0,0
1000000US060855135001234,060855135001234,"Block 1234, Block Group 1, Census Tract 5135, Santa Clara County, California",0,0,0
1000000US060855135001235,060855135001235,"Block 1235, Block Group 1, Census Tract 5135, Santa Clara County, California",4,3,1
1000000US060855135001236,060855135001236,"Block 1236, Block Group 1, Census Tract 5135, Santa Clara County, California",1,1,0
1000000US060855135001237,060855135001237,"Block 1237, Block Group 1, Census Tract 5135, Santa Clara County, California",0,0,0
1000000US060855135001238,060855135001238,"Block 1238, Block Group 1, Census Tract 5135, Santa Clara County, California",0,0,0
1000000US060855135001239,060855135001239,"Block 1239, Block Group 1, Census Tract 5135, Santa Clara County, California",0,0,0
1000000US060855135001240,060855135001240,"Block 1240, Block Group 1, Census Tract 5135, Santa Clara County, California",4,4,0
1000000US060855135001241,060855135001241,"Block 1241, Block Group 1, Census Tract 5135, Santa Clara County, California",0,0,0
1000000US060855135001242,060855135001242,"Block 1242, Block Group 1, Census Tract 5135, Santa Clara County, California",1,1,0
1000000US060855135001243,060855135001243,"Block 1243, Block Group 1, Census Tract 5135, Santa Clara County, California",0,0,0
1000000US060855135001244,060855135001244,"Block 1244, Block Group 1, Census Tract 5135, Santa Clara County, California",0,0,0
1000000US060855135001245,060855135001245,"Block 1245, Block Group 1, Census Tract 5135, Santa Clara County, California",0,0,0
1000000US060855135001246,060855135001246,"Block 1246, Block Group 1, Census Tract 5135, Santa Clara County, California",0,0,0
1000000US060855135001247,060855135001247,"Block 1247, Block Group 1, Census Tract 5135, Santa Clara County, California",1,1,0
1000000US060855135001248,060855135001248,"Block 1248, Block Group 1, Census Tract 5135, Santa Clara County, California",0,0,0
1000000US060855135001249,060855135001249,"Block 1249, Block Group 1, Census Tract 5135, Santa Clara County, California",0,0,0
1000000US060855135001250,060855135001250,"Block 1250, Block Group 1, Census Tract 5135, Santa Clara County, California",0,0,0
1000000US060855135001251,060855135001251,"Block 1251, Block Group 1, Census Tract 5135, Santa Clara County, California",0,0,0
1000000US060855135001252,060855135001252,"Block 1252, Block Group 1, Census Tract 5135, Santa Clara County, California",0,0,0
1000000US060855135001253,060855135001253,"Block 1253, Block Group 1, Census Tract 5135, Santa Clara County, California",0,0,0
1000000US060855135001254,060855135001254,"Block 1254, Block Group 1, Census Tract 5135, Santa Clara County, California",0,0,0
1000000US060855135001255,060855135001255,"Block 1255, Block Group 1, Census Tract 5135, Santa Clara County, California",2,2,0
1000000US060855135001256,060855135001256,"Block 1256, Block Group 1, Census Tract 5135, Santa Clara County, California",0,0,0
1000000US060855135001257,060855135001257,"Block 1257, Block Group 1, Census Tract 5135, Santa Clara County, California",0,0,0
1000000US060855135001258,060855135001258,"Block 1258, Block Group 1, Census Tract 5135, Santa Clara County, California",0,0,0
1000000US060855135001259,060855135001259,"Block 1259, Block Group 1, Census Tract 5135, Santa Clara County, California",0,0,0
1000000US060855135001260,060855135001260,"Block 1260, Block Group 1, Census Tract 5135, Santa Clara County, California",0,0,0
1000000US060855135001261,060855135001261,"Block 1261, Block Group 1, Census Tract 5135, Santa Clara County, California",0,0,0
1000000US060855135001262,060855135001262,"Block 1262, Block Group 1, Census Tract 5135, Santa Clara County, California",0,0,0
1000000US060855135001263,060855135001263,"Block 1263, Block Group 1, Census Tract 5135, Santa Clara County, California",1,0,1
1000000US060855135001264,060855135001264,"Block 1264, Block Group 1, Census Tract 5135, Santa Clara County, California",0,0,0
1000000US060855135001265,060855135001265,"Block 1265, Block Group 1, Census Tract 5135, Santa Clara County, California",0,0,0
1000000US060855135001266,060855135001266,"Block 1266, Block Group 1, Census Tract 5135, Santa Clara County, California",0,0,0
1000000US060855135001267,060855135001267,"Block 1267, Block Group 1, Census Tract 5135, Santa Clara County, California",5,5,0
1000000US060855135001268,060855135001268,"Block 1268, Block Group 1, Census Tract 5135, Santa Clara County, California",0,0,0
1000000US060855135001269,060855135001269,"Block 1269, Block Group 1, Census Tract 5135, Santa Clara County, California",0,0,0
1000000US060855135001270,060855135001270,"Block 1270, Block Group 1, Census Tract 5135, Santa Clara County, California",0,0,0
1000000US060855135001271,060855135001271,"Block 1271, Block Group 1, Census Tract 5135, Santa Clara County, California",0,0,0
1000000US060855135001272,060855135001272,"Block 1272, Block Group 1, Census Tract 5135, Santa Clara County, California",0,0,0
1000000US060855135001273,060855135001273,"Block 1273, Block Group 1, Census Tract 5135, Santa Clara County, California",0,0,0
1000000US060855135001274,060855135001274,"Block 1274, Block Group 1, Census Tract 5135, Santa Clara County, California",0,0,0
1000000US060855135001275,060855135001275,"Block 1275, Block Group 1, Census Tract 5135, Santa Clara County, California",0,0,0
1000000US060855135001276,060855135001276,"Block 1276, Block Group 1, Census Tract 5135, Santa Clara County, California",0,0,0
1000000US060855135001277,060855135001277,"Block 1277, Block Group 1, Census Tract 5135, Santa Clara County, California",5,3,2
1000000US060855135001278,060855135001278,"Block 1278, Block Group 1, Census Tract 5135, Santa Clara County, California",0,0,0
1000000US060855135001279,060855135001279,"Block 1279, Block Group 1, Census Tract 5135, Santa Clara County, California",0,0,0
1000000US060855135001280,060855135001280,"Block 1280, Block Group 1, Census Tract 5135, Santa Clara County, California",0,0,0
1000000US060855135001281,060855135001281,"Block 1281, Block Group 1, Census Tract 5135, Santa Clara County, California",0,0,0
1000000US060855135001282,060855135001282,"Block 1282, Block Group 1, Census Tract 5135, Santa Clara County, California",0,0,0
1000000US060855135001283,060855135001283,"Block 1283, Block Group 1, Census Tract 5135, Santa Clara County, California",0,0,0
1000000US060855135001284,060855135001284,"Block 1284, Block Group 1, Census Tract 5135, Santa Clara County, California",0,0,0
1000000US060855135001285,060855135001285,"Block 1285, Block Group 1, Census Tract 5135, Santa Clara County, California",2,1,1
1000000US060855135001286,060855135001286,"Block 1286, Block Group 1, Census Tract 5135, Santa Clara County, California",0,0,0
1000000US060855135001287,060855135001287,"Block 1287, Block Group 1, Census Tract 5135, Santa Clara County, California",9,9,0
1000000US060855135001288,060855135001288,"Block 1288, Block Group 1, Census Tract 5135, Santa Clara County, California",0,0,0
1000000US060855135001289,060855135001289,"Block 1289, Block Group 1, Census Tract 5135, Santa Clara County, California",0,0,0
1000000US060855135001290,060855135001290,"Block 1290, Block Group 1, Census Tract 5135, Santa Clara County, California",0,0,0
1000000US060855135001291,060855135001291,"Block 1291, Block Group 1, Census Tract 5135, Santa Clara County, California",0,0,0
1000000US060855135001292,060855135001292,"Block 1292, Block Group 1, Census Tract 5135, Santa Clara County, California",0,0,0
1000000US060855135001293,060855135001293,"Block 1293, Block Group 1, Census Tract 5135, Santa Clara County, California",0,0,0
1000000US060855135001294,060855135001294,"Block 1294, Block Group 1, Census Tract 5135, Santa Clara County, California",0,0,0
1000000US060855135001295,060855135001295,"Block 1295, Block Group 1, Census Tract 5135, Santa Clara County, California",0,0,0
1000000US060855135001296,060855135001296,"Block 1296, Block Group 1, Census Tract 5135, Santa Clara County, California",0,0,0
1000000US060855135001297,060855135001297,"Block 1297, Block Group 1, Census Tract 5135, Santa Clara County, California",0,0,0
1000000US060855135001298,060855135001298,"Block 1298, Block Group 1, Census Tract 5135, Santa Clara County, California",0,0,0
1000000US060855135001299,060855135001299,"Block 1299, Block Group 1, Census Tract 5135, Santa Clara County, California",0,0,0
1000000US060855135001300,060855135001300,"Block 1300, Block Group 1, Census Tract 5135, Santa Clara County, California",0,0,0
1000000US060855135001301,060855135001301,"Block 1301, Block Group 1, Census Tract 5135, Santa Clara County, California",0,0,0
1000000US060855135001302,060855135001302,"Block 1302, Block Group 1, Census Tract 5135, Santa Clara County, California",0,0,0
1000000US060855135001303,060855135001303,"Block 1303, Block Group 1, Census Tract 5135, Santa Clara County, California",0,0,0
1000000US060855135001304,060855135001304,"Block 1304, Block Group 1, Census Tract 5135, Santa Clara County, California",0,0,0
1000000US060855135001305,060855135001305,"Block 1305, Block Group 1, Census Tract 5135, Santa Clara County, California",0,0,0
1000000US060855135001306,060855135001306,"Block 1306, Block Group 1, Census Tract 5135, Santa Clara County, California",0,0,0
1000000US060855135001307,060855135001307,"Block 1307, Block Group 1, Census Tract 5135, Santa Clara County, California",0,0,0
1000000US060855135001308,060855135001308,"Block 1308, Block Group 1, Census Tract 5135, Santa Clara County, California",0,0,0
1000000US060855135001309,060855135001309,"Block 1309, Block Group 1, Census Tract 5135, Santa Clara County, California",0,0,0
1000000US060855135001310,060855135001310,"Block 1310, Block Group 1, Census Tract 5135, Santa Clara County, California",0,0,0
1000000US060855135001311,060855135001311,"Block 1311, Block Group 1, Census Tract 5135, Santa Clara County, California",0,0,0
1000000US060855135001312,060855135001312,"Block 1312, Block Group 1, Census Tract 5135, Santa Clara County, California",0,0,0
1000000US060855135001313,060855135001313,"Block 1313, Block Group 1, Census Tract 5135, Santa Clara County, California",0,0,0
1000000US060855135001314,060855135001314,"Block 1314, Block Group 1, Census Tract 5135, Santa Clara County, California",0,0,0
1000000US060855135001315,060855135001315,"Block 1315, Block Group 1, Census Tract 5135, Santa Clara County, California",4,4,0
1000000US060855135001316,060855135001316,"Block 1316, Block Group 1, Census Tract 5135, Santa Clara County, California",0,0,0
1000000US060855135001317,060855135001317,"Block 1317, Block Group 1, Census Tract 5135, Santa Clara County, California",0,0,0
1000000US060855135001318,060855135001318,"Block 1318, Block Group 1, Census Tract 5135, Santa Clara County, California",0,0,0
1000000US060855135001319,060855135001319,"Block 1319, Block Group 1, Census Tract 5135, Santa Clara County, California",0,0,0
1000000US060855135001320,060855135001320,"Block 1320, Block Group 1, Census Tract 5135, Santa Clara County, California",0,0,0
1000000US060855135001321,060855135001321,"Block 1321, Block Group 1, Census Tract 5135, Santa Clara County, California",0,0,0
1000000US060855135001322,060855135001322,"Block 1322, Block Group 1, Census Tract 5135, Santa Clara County, California",0,0,0
1000000US060855135001323,060855135001323,"Block 1323, Block Group 1, Census Tract 5135, Santa Clara County, California",0,0,0
1000000US060855135001324,060855135001324,"Block 1324, Block Group 1, Census Tract 5135, Santa Clara County, California",0,0,0
1000000US060855135001325,060855135001325,"Block 1325, Block Group 1, Census Tract 5135, Santa Clara County, California",0,0,0
1000000US060855135001326,060855135001326,"Block 1326, Block Group 1, Census Tract 5135, Santa Clara County, California",13,12,1
1000000US060855135001327,060855135001327,"Block 1327, Block Group 1, Census Tract 5135, Santa Clara County, California",0,0,0
1000000US060855135001328,060855135001328,"Block 1328, Block Group 1, Census Tract 5135, Santa Clara County, California",1,1,0
1000000US060855135001329,060855135001329,"Block 1329, Block Group 1, Census Tract 5135, Santa Clara County, California",0,0,0
1000000US060855135001330,060855135001330,"Block 1330, Block Group 1, Census Tract 5135, Santa Clara County, California",0,0,0
1000000US060855135001331,060855135001331,"Block 1331, Block Group 1, Census Tract 5135, Santa Clara County, California",0,0,0
1000000US060855135001332,060855135001332,"Block 1332, Block Group 1, Census Tract 5135, Santa Clara County, California",0,0,0
1000000US060855135001333,060855135001333,"Block 1333, Block Group 1, Census Tract 5135, Santa Clara County, California",0,0,0
1000000US060855135001334,060855135001334,"Block 1334, Block Group 1, Census Tract 5135, Santa Clara County, California",0,0,0
1000000US060855135001335,060855135001335,"Block 1335, Block Group 1, Census Tract 5135, Santa Clara County, California",3,3,0
1000000US060855135001336,060855135001336,"Block 1336, Block Group 1, Census Tract 5135, Santa Clara County, California",0,0,0
1000000US060855135001337,060855135001337,"Block 1337, Block Group 1, Census Tract 5135, Santa Clara County, California",0,0,0
1000000US060855135001338,060855135001338,"Block 1338, Block Group 1, Census Tract 5135, Santa Clara County, California",0,0,0
1000000US060855135001339,060855135001339,"Block 1339, Block Group 1, Census Tract 5135, Santa Clara County, California",0,0,0
1000000US060855135001340,060855135001340,"Block 1340, Block Group 1, Census Tract 5135, Santa Clara County, California",0,0,0
1000000US060855135001341,060855135001341,"Block 1341, Block Group 1, Census Tract 5135, Santa Clara County, California",0,0,0
1000000US060855135001342,060855135001342,"Block 1342, Block Group 1, Census Tract 5135, Santa Clara County, California",0,0,0
1000000US060855135001343,060855135001343,"Block 1343, Block Group 1, Census Tract 5135, Santa Clara County, California",0,0,0
1000000US060855135001344,060855135001344,"Block 1344, Block Group 1, Census Tract 5135, Santa Clara County, California",0,0,0
1000000US060855135001345,060855135001345,"Block 1345, Block Group 1, Census Tract 5135, Santa Clara County, California",0,0,0
1000000US060855135001346,060855135001346,"Block 1346, Block Group 1, Census Tract 5135, Santa Clara County, California",0,0,0
1000000US060855135001347,060855135001347,"Block 1347, Block Group 1, Census Tract 5135, Santa Clara County, California",0,0,0
1000000US060855135001348,060855135001348,"Block 1348, Block Group 1, Census Tract 5135, Santa Clara County, California",0,0,0
1000000US060855135001349,060855135001349,"Block 1349, Block Group 1, Census Tract 5135, Santa Clara County, California",0,0,0
1000000US060855135001350,060855135001350,"Block 1350, Block Group 1, Census Tract 5135, Santa Clara County, California",0,0,0
1000000US060855135001351,060855135001351,"Block 1351, Block Group 1, Census Tract 5135, Santa Clara County, California",0,0,0
1000000US060855135001352,060855135001352,"Block 1352, Block Group 1, Census Tract 5135, Santa Clara County, California",0,0,0
1000000US060855135001353,060855135001353,"Block 1353, Block Group 1, Census Tract 5135, Santa Clara County, California",0,0,0
1000000US060855135001354,060855135001354,"Block 1354, Block Group 1, Census Tract 5135, Santa Clara County, California",0,0,0
1000000US060855135001355,060855135001355,"Block 1355, Block Group 1, Census Tract 5135, Santa Clara County, California",0,0,0
1000000US060855135001356,060855135001356,"Block 1356, Block Group 1, Census Tract 5135, Santa Clara County, California",0,0,0
1000000US060855135001357,060855135001357,"Block 1357, Block Group 1, Census Tract 5135, Santa Clara County, California",0,0,0
1000000US060855135001358,060855135001358,"Block 1358, Block Group 1, Census Tract 5135, Santa Clara County, California",0,0,0
1000000US060855135001359,060855135001359,"Block 1359, Block Group 1, Census Tract 5135, Santa Clara County, California",0,0,0
1000000US060855135001360,060855135001360,"Block 1360, Block Group 1, Census Tract 5135, Santa Clara County, California",0,0,0
1000000US060855135001361,060855135001361,"Block 1361, Block Group 1, Census Tract 5135, Santa Clara County, California",0,0,0
1000000US060855135001362,060855135001362,"Block 1362, Block Group 1, Census Tract 5135, Santa Clara County, California",4,3,1
1000000US060855135001363,060855135001363,"Block 1363, Block Group 1, Census Tract 5135, Santa Clara County, California",0,0,0
1000000US060855135001364,060855135001364,"Block 1364, Block Group 1, Census Tract 5135, Santa Clara County, California",0,0,0
1000000US060855135001365,060855135001365,"Block 1365, Block Group 1, Census Tract 5135, Santa Clara County, California",0,0,0
1000000US060855135001366,060855135001366,"Block 1366, Block Group 1, Census Tract 5135, Santa Clara County, California",0,0,0
1000000US060855135001367,060855135001367,"Block 1367, Block Group 1, Census Tract 5135, Santa Clara County, California",1,1,0
1000000US060855135001368,060855135001368,"Block 1368, Block Group 1, Census Tract 5135, Santa Clara County, California",0,0,0
1000000US060855135001369,060855135001369,"Block 1369, Block Group 1, Census Tract 5135, Santa Clara County, California",0,0,0
1000000US060855135001370,060855135001370,"Block 1370, Block Group 1, Census Tract 5135, Santa Clara County, California",0,0,0
1000000US060855135001371,060855135001371,"Block 1371, Block Group 1, Census Tract 5135, Santa Clara County, California",3,2,1
1000000US060855135001372,060855135001372,"Block 1372, Block Group 1, Census Tract 5135, Santa Clara County, California",0,0,0
1000000US060855135001373,060855135001373,"Block 1373, Block Group 1, Census Tract 5135, Santa Clara County, California",9,9,0
1000000US060855135001374,060855135001374,"Block 1374, Block Group 1, Census Tract 5135, Santa Clara County, California",0,0,0
1000000US060855135001375,060855135001375,"Block 1375, Block Group 1, Census Tract 5135, Santa Clara County, California",0,0,0
1000000US060855135001376,060855135001376,"Block 1376, Block Group 1, Census Tract 5135, Santa Clara County, California",0,0,0
1000000US060855135001377,060855135001377,"Block 1377, Block Group 1, Census Tract 5135, Santa Clara County, California",0,0,0
1000000US060855135001378,060855135001378,"Block 1378, Block Group 1, Census Tract 5135, Santa Clara County, California",2,2,0
1000000US060855135001379,060855135001379,"Block 1379, Block Group 1, Census Tract 5135, Santa Clara County, California",2,2,0
1000000US060855135001380,060855135001380,"Block 1380, Block Group 1, Census Tract 5135, Santa Clara County, California",0,0,0
1000000US060855135001381,060855135001381,"Block 1381, Block Group 1, Census Tract 5135, Santa Clara County, California",0,0,0
1000000US060855135001382,060855135001382,"Block 1382, Block Group 1, Census Tract 5135, Santa Clara County, California",0,0,0
1000000US060855135001383,060855135001383,"Block 1383, Block Group 1, Census Tract 5135, Santa Clara County, California",0,0,0
1000000US060855135001384,060855135001384,"Block 1384, Block Group 1, Census Tract 5135, Santa Clara County, California",0,0,0
1000000US060855135001385,060855135001385,"Block 1385, Block Group 1, Census Tract 5135, Santa Clara County, California",0,0,0
1000000US060855135001386,060855135001386,"Block 1386, Block Group 1, Census Tract 5135, Santa Clara County, California",0,0,0
1000000US060855135001387,060855135001387,"Block 1387, Block Group 1, Census Tract 5135, Santa Clara County, California",1,1,0
1000000US060855135001388,060855135001388,"Block 1388, Block Group 1, Census Tract 5135, Santa Clara County, California",0,0,0
1000000US060855135001389,060855135001389,"Block 1389, Block Group 1, Census Tract 5135, Santa Clara County, California",0,0,0
1000000US060855135001390,060855135001390,"Block 1390, Block Group 1, Census Tract 5135, Santa Clara County, California",0,0,0
1000000US060855135001391,060855135001391,"Block 1391, Block Group 1, Census Tract 5135, Santa Clara County, California",0,0,0
1000000US060855135001392,060855135001392,"Block 1392, Block Group 1, Census Tract 5135, Santa Clara County, California",0,0,0
1000000US060855135001393,060855135001393,"Block 1393, Block Group 1, Census Tract 5135, Santa Clara County, California",0,0,0
1000000US060855135001394,060855135001394,"Block 1394, Block Group 1, Census Tract 5135, Santa Clara County, California",0,0,0
1000000US060855135001395,060855135001395,"Block 1395, Block Group 1, Census Tract 5135, Santa Clara County, California",0,0,0
1000000US060855135001396,060855135001396,"Block 1396, Block Group 1, Census Tract 5135, Santa Clara County, California",0,0,0
1000000US060855135001397,060855135001397,"Block 1397, Block Group 1, Census Tract 5135, Santa Clara County, California",0,0,0
1000000US060855135001398,060855135001398,"Block 1398, Block Group 1, Census Tract 5135, Santa Clara County, California",0,0,0
1000000US060855135001399,060855135001399,"Block 1399, Block Group 1, Census Tract 5135, Santa Clara County, California",0,0,0
1000000US060855135001400,060855135001400,"Block 1400, Block Group 1, Census Tract 5135, Santa Clara County, California",1,1,0
1000000US060855135001401,060855135001401,"Block 1401, Block Group 1, Census Tract 5135, Santa Clara County, California",11,9,2
1000000US060855135001402,060855135001402,"Block 1402, Block Group 1, Census Tract 5135, Santa Clara County, California",0,0,0
1000000US060855135001403,060855135001403,"Block 1403, Block Group 1, Census Tract 5135, Santa Clara County, California",0,0,0
1000000US060855135001404,060855135001404,"Block 1404, Block Group 1, Census Tract 5135, Santa Clara County, California",0,0,0
1000000US060855135001405,060855135001405,"Block 1405, Block Group 1, Census Tract 5135, Santa Clara County, California",3,3,0
1000000US060855135001406,060855135001406,"Block 1406, Block Group 1, Census Tract 5135, Santa Clara County, California",18,18,0
1000000US060855135001407,060855135001407,"Block 1407, Block Group 1, Census Tract 5135, Santa Clara County, California",5,5,0
1000000US060855135001408,060855135001408,"Block 1408, Block Group 1, Census Tract 5135, Santa Clara County, California",0,0,0
1000000US060855135001409,060855135001409,"Block 1409, Block Group 1, Census Tract 5135, Santa Clara County, California",0,0,0
1000000US060855135001410,060855135001410,"Block 1410, Block Group 1, Census Tract 5135, Santa Clara County, California",8,8,0
1000000US060855135001411,060855135001411,"Block 1411, Block Group 1, Census Tract 5135, Santa Clara County, California",0,0,0
1000000US060855135001412,060855135001412,"Block 1412, Block Group 1, Census Tract 5135, Santa Clara County, California",0,0,0
1000000US060855135001413,060855135001413,"Block 1413, Block Group 1, Census Tract 5135, Santa Clara County, California",0,0,0
1000000US060855135001414,060855135001414,"Block 1414, Block Group 1, Census Tract 5135, Santa Clara County, California",1,0,1
1000000US060855135001415,060855135001415,"Block 1415, Block Group 1, Census Tract 5135, Santa Clara County, California",0,0,0
1000000US060855135001416,060855135001416,"Block 1416, Block Group 1, Census Tract 5135, Santa Clara County, California",0,0,0
1000000US060855135001417,060855135001417,"Block 1417, Block Group 1, Census Tract 5135, Santa Clara County, California",0,0,0
1000000US060855135001418,060855135001418,"Block 1418, Block Group 1, Census Tract 5135, Santa Clara County, California",0,0,0
1000000US060855135001419,060855135001419,"Block 1419, Block Group 1, Census Tract 5135, Santa Clara County, California",26,23,3
1000000US060855135001420,060855135001420,"Block 1420, Block Group 1, Census Tract 5135, Santa Clara County, California",0,0,0
1000000US060855135001421,060855135001421,"Block 1421, Block Group 1, Census Tract 5135, Santa Clara County, California",0,0,0
1000000US060855135001422,060855135001422,"Block 1422, Block Group 1, Census Tract 5135, Santa Clara County, California",0,0,0
1000000US060855135001423,060855135001423,"Block 1423, Block Group 1, Census Tract 5135, Santa Clara County, California",0,0,0
1000000US060855135001424,060855135001424,"Block 1424, Block Group 1, Census Tract 5135, Santa Clara County, California",3,3,0
1000000US060855135001425,060855135001425,"Block 1425, Block Group 1, Census Tract 5135, Santa Clara County, California",1,1,0
1000000US060855135001426,060855135001426,"Block 1426, Block Group 1, Census Tract 5135, Santa Clara County, California",3,3,0
1000000US060855135001427,060855135001427,"Block 1427, Block Group 1, Census Tract 5135, Santa Clara County, California",2,1,1
1000000US060855135001428,060855135001428,"Block 1428, Block Group 1, Census Tract 5135, Santa Clara County, California",0,0,0
1000000US060855135001429,060855135001429,"Block 1429, Block Group 1, Census Tract 5135, Santa Clara County, California",3,3,0
1000000US060855135001430,060855135001430,"Block 1430, Block Group 1, Census Tract 5135, Santa Clara County, California",4,4,0
1000000US060855135001431,060855135001431,"Block 1431, Block Group 1, Census Tract 5135, Santa Clara County, California",0,0,0
1000000US060855135001432,060855135001432,"Block 1432, Block Group 1, Census Tract 5135, Santa Clara County, California",0,0,0
1000000US060855135001433,060855135001433,"Block 1433, Block Group 1, Census Tract 5135, Santa Clara County, California",0,0,0
1000000US060855135001434,060855135001434,"Block 1434, Block Group 1, Census Tract 5135, Santa Clara County, California",0,0,0
1000000US060855135001435,060855135001435,"Block 1435, Block Group 1, Census Tract 5135, Santa Clara County, California",0,0,0
1000000US060855135001436,060855135001436,"Block 1436, Block Group 1, Census Tract 5135, Santa Clara County, California",0,0,0
1000000US060855135001437,060855135001437,"Block 1437, Block Group 1, Census Tract 5135, Santa Clara County, California",4,4,0
1000000US060855135001438,060855135001438,"Block 1438, Block Group 1, Census Tract 5135, Santa Clara County, California",3,3,0
1000000US060855135001439,060855135001439,"Block 1439, Block Group 1, Census Tract 5135, Santa Clara County, California",0,0,0
1000000US060855135001440,060855135001440,"Block 1440, Block Group 1, Census Tract 5135, Santa Clara County, California",0,0,0
1000000US060855135001441,060855135001441,"Block 1441, Block Group 1, Census Tract 5135, Santa Clara County, California",9,8,1
1000000US060855135001442,060855135001442,"Block 1442, Block Group 1, Census Tract 5135, Santa Clara County, California",0,0,0
1000000US060855135001443,060855135001443,"Block 1443, Block Group 1, Census Tract 5135, Santa Clara County, California",1,1,0
1000000US060855135001444,060855135001444,"Block 1444, Block Group 1, Census Tract 5135, Santa Clara County, California",4,4,0
1000000US060855135001445,060855135001445,"Block 1445, Block Group 1, Census Tract 5135, Santa Clara County, California",0,0,0
1000000US060855135001446,060855135001446,"Block 1446, Block Group 1, Census Tract 5135, Santa Clara County, California",0,0,0
1000000US060855135001447,060855135001447,"Block 1447, Block Group 1, Census Tract 5135, Santa Clara County, California",1,1,0
1000000US060855135001448,060855135001448,"Block 1448, Block Group 1, Census Tract 5135, Santa Clara County, California",2,2,0
1000000US060855135001449,060855135001449,"Block 1449, Block Group 1, Census Tract 5135, Santa Clara County, California",4,4,0
1000000US060855135001450,060855135001450,"Block 1450, Block Group 1, Census Tract 5135, Santa Clara County, California",1,1,0
1000000US060855135001451,060855135001451,"Block 1451, Block Group 1, Census Tract 5135, Santa Clara County, California",0,0,0
1000000US060855135001452,060855135001452,"Block 1452, Block Group 1, Census Tract 5135, Santa Clara County, California",4,4,0
1000000US060855135001453,060855135001453,"Block 1453, Block Group 1, Census Tract 5135, Santa Clara County, California",0,0,0
1000000US060855135001454,060855135001454,"Block 1454, Block Group 1, Census Tract 5135, Santa Clara County, California",0,0,0
1000000US060855135001455,060855135001455,"Block 1455, Block Group 1, Census Tract 5135, Santa Clara County, California",0,0,0
1000000US060855135001456,060855135001456,"Block 1456, Block Group 1, Census Tract 5135, Santa Clara County, California",0,0,0
1000000US060855135001457,060855135001457,"Block 1457, Block Group 1, Census Tract 5135, Santa Clara County, California",0,0,0
1000000US060855135001458,060855135001458,"Block 1458, Block Group 1, Census Tract 5135, Santa Clara County, California",0,0,0
1000000US060855135001459,060855135001459,"Block 1459, Block Group 1, Census Tract 5135, Santa Clara County, California",2,2,0
1000000US060855135001460,060855135001460,"Block 1460, Block Group 1, Census Tract 5135, Santa Clara County, California",2,2,0
1000000US060855135001461,060855135001461,"Block 1461, Block Group 1, Census Tract 5135, Santa Clara County, California",0,0,0
1000000US060855135001462,060855135001462,"Block 1462, Block Group 1, Census Tract 5135, Santa Clara County, California",0,0,0
1000000US060855135001463,060855135001463,"Block 1463, Block Group 1, Census Tract 5135, Santa Clara County, California",0,0,0
1000000US060855135001464,060855135001464,"Block 1464, Block Group 1, Census Tract 5135, Santa Clara County, California",0,0,0
1000000US060855135001465,060855135001465,"Block 1465, Block Group 1, Census Tract 5135, Santa Clara County, California",0,0,0
1000000US060855135001466,060855135001466,"Block 1466, Block Group 1, Census Tract 5135, Santa Clara County, California",0,0,0
1000000US060855135001467,060855135001467,"Block 1467, Block Group 1, Census Tract 5135, Santa Clara County, California",0,0,0
1000000US060855135001468,060855135001468,"Block 1468, Block Group 1, Census Tract 5135, Santa Clara County, California",0,0,0
1000000US060855135001469,060855135001469,"Block 1469, Block Group 1, Census Tract 5135, Santa Clara County, California",0,0,0
1000000US060855135001470,060855135001470,"Block 1470, Block Group 1, Census Tract 5135, Santa Clara County, California",0,0,0
1000000US060855135001471,060855135001471,"Block 1471, Block Group 1, Census Tract 5135, Santa Clara County, California",0,0,0
1000000US060855135001472,060855135001472,"Block 1472, Block Group 1, Census Tract 5135, Santa Clara County, California",0,0,0
1000000US060855135001473,060855135001473,"Block 1473, Block Group 1, Census Tract 5135, Santa Clara County, California",0,0,0
1000000US060855135001474,060855135001474,"Block 1474, Block Group 1, Census Tract 5135, Santa Clara County, California",0,0,0
1000000US060855135001475,060855135001475,"Block 1475, Block Group 1, Census Tract 5135, Santa Clara County, California",0,0,0
1000000US060855135001476,060855135001476,"Block 1476, Block Group 1, Census Tract 5135, Santa Clara County, California",0,0,0
1000000US060855135001477,060855135001477,"Block 1477, Block Group 1, Census Tract 5135, Santa Clara County, California",0,0,0
1000000US060855135001478,060855135001478,"Block 1478, Block Group 1, Census Tract 5135, Santa Clara County, California",0,0,0
1000000US060855135001479,060855135001479,"Block 1479, Block Group 1, Census Tract 5135, Santa Clara County, California",0,0,0
1000000US060855135001480,060855135001480,"Block 1480, Block Group 1, Census Tract 5135, Santa Clara County, California",0,0,0
1000000US060855135001481,060855135001481,"Block 1481, Block Group 1, Census Tract 5135, Santa Clara County, California",0,0,0
1000000US060855135001482,060855135001482,"Block 1482, Block Group 1, Census Tract 5135, Santa Clara County, California",0,0,0
1000000US060855135001483,060855135001483,"Block 1483, Block Group 1, Census Tract 5135, Santa Clara County, California",6,4,2
1000000US060855135001484,060855135001484,"Block 1484, Block Group 1, Census Tract 5135, Santa Clara County, California",1,0,1
1000000US060855135001485,060855135001485,"Block 1485, Block Group 1, Census Tract 5135, Santa Clara County, California",0,0,0
1000000US060855135001486,060855135001486,"Block 1486, Block Group 1, Census Tract 5135, Santa Clara County, California",0,0,0
1000000US060855135001487,060855135001487,"Block 1487, Block Group 1, Census Tract 5135, Santa Clara County, California",0,0,0
1000000US060855135001488,060855135001488,"Block 1488, Block Group 1, Census Tract 5135, Santa Clara County, California",0,0,0
1000000US060855135001489,060855135001489,"Block 1489, Block Group 1, Census Tract 5135, Santa Clara County, California",0,0,0
1000000US060855135001490,060855135001490,"Block 1490, Block Group 1, Census Tract 5135, Santa Clara County, California",0,0,0
1000000US060855135001491,060855135001491,"Block 1491, Block Group 1, Census Tract 5135, Santa Clara County, California",0,0,0
1000000US060855135001492,060855135001492,"Block 1492, Block Group 1, Census Tract 5135, Santa Clara County, California",2,1,1
1000000US060855135001493,060855135001493,"Block 1493, Block Group 1, Census Tract 5135, Santa Clara County, California",0,0,0
1000000US060855135001494,060855135001494,"Block 1494, Block Group 1, Census Tract 5135, Santa Clara County, California",0,0,0
1000000US060855135001495,060855135001495,"Block 1495, Block Group 1, Census Tract 5135, Santa Clara County, California",0,0,0
1000000US060855135001496,060855135001496,"Block 1496, Block Group 1, Census Tract 5135, Santa Clara County, California",0,0,0
1000000US060855135001497,060855135001497,"Block 1497, Block Group 1, Census Tract 5135, Santa Clara County, California",0,0,0
1000000US060855135001498,060855135001498,"Block 1498, Block Group 1, Census Tract 5135, Santa Clara County, California",0,0,0
1000000US060855135001499,060855135001499,"Block 1499, Block Group 1, Census Tract 5135, Santa Clara County, California",0,0,0
1000000US060855135001500,060855135001500,"Block 1500, Block Group 1, Census Tract 5135, Santa Clara County, California",0,0,0
1000000US060855135001501,060855135001501,"Block 1501, Block Group 1, Census Tract 5135, Santa Clara County, California",0,0,0
