Id,Id2,Geography,Number,Occupied,Vacant
1000000US060552002011000,060552002011000,"Block 1000, Block Group 1, Census Tract 2002.01, Napa County, California",22,16,6
1000000US060552002011001,060552002011001,"Block 1001, Block Group 1, Census Tract 2002.01, Napa County, California",224,215,9
1000000US060552002011002,060552002011002,"Block 1002, Block Group 1, Census Tract 2002.01, Napa County, California",0,0,0
1000000US060552002011003,060552002011003,"Block 1003, Block Group 1, Census Tract 2002.01, Napa County, California",0,0,0
1000000US060552002011004,060552002011004,"Block 1004, Block Group 1, Census Tract 2002.01, Napa County, California",0,0,0
1000000US060552002011005,060552002011005,"Block 1005, Block Group 1, Census Tract 2002.01, Napa County, California",0,0,0
1000000US060552002011006,060552002011006,"Block 1006, Block Group 1, Census Tract 2002.01, Napa County, California",0,0,0
1000000US060552002011007,060552002011007,"Block 1007, Block Group 1, Census Tract 2002.01, Napa County, California",0,0,0
1000000US060552002011008,060552002011008,"Block 1008, Block Group 1, Census Tract 2002.01, Napa County, California",1,0,1
1000000US060552002011009,060552002011009,"Block 1009, Block Group 1, Census Tract 2002.01, Napa County, California",31,29,2
1000000US060552002011010,060552002011010,"Block 1010, Block Group 1, Census Tract 2002.01, Napa County, California",0,0,0
1000000US060552002011011,060552002011011,"Block 1011, Block Group 1, Census Tract 2002.01, Napa County, California",2,1,1
1000000US060552002011012,060552002011012,"Block 1012, Block Group 1, Census Tract 2002.01, Napa County, California",37,32,5
1000000US060552002011013,060552002011013,"Block 1013, Block Group 1, Census Tract 2002.01, Napa County, California",7,7,0
1000000US060552002011014,060552002011014,"Block 1014, Block Group 1, Census Tract 2002.01, Napa County, California",16,14,2
1000000US060552002011015,060552002011015,"Block 1015, Block Group 1, Census Tract 2002.01, Napa County, California",0,0,0
1000000US060552002011016,060552002011016,"Block 1016, Block Group 1, Census Tract 2002.01, Napa County, California",4,4,0
1000000US060552002011017,060552002011017,"Block 1017, Block Group 1, Census Tract 2002.01, Napa County, California",31,25,6
1000000US060552002011018,060552002011018,"Block 1018, Block Group 1, Census Tract 2002.01, Napa County, California",37,36,1
1000000US060552002011019,060552002011019,"Block 1019, Block Group 1, Census Tract 2002.01, Napa County, California",4,4,0
1000000US060552002011020,060552002011020,"Block 1020, Block Group 1, Census Tract 2002.01, Napa County, California",10,9,1
1000000US060552002011021,060552002011021,"Block 1021, Block Group 1, Census Tract 2002.01, Napa County, California",25,25,0
1000000US060552002011022,060552002011022,"Block 1022, Block Group 1, Census Tract 2002.01, Napa County, California",11,11,0
1000000US060552002011023,060552002011023,"Block 1023, Block Group 1, Census Tract 2002.01, Napa County, California",9,9,0
1000000US060552002011024,060552002011024,"Block 1024, Block Group 1, Census Tract 2002.01, Napa County, California",12,12,0
1000000US060552002011025,060552002011025,"Block 1025, Block Group 1, Census Tract 2002.01, Napa County, California",13,11,2
1000000US060552002011026,060552002011026,"Block 1026, Block Group 1, Census Tract 2002.01, Napa County, California",9,6,3
1000000US060552002011027,060552002011027,"Block 1027, Block Group 1, Census Tract 2002.01, Napa County, California",9,9,0
1000000US060552002012000,060552002012000,"Block 2000, Block Group 2, Census Tract 2002.01, Napa County, California",9,8,1
1000000US060552002012001,060552002012001,"Block 2001, Block Group 2, Census Tract 2002.01, Napa County, California",13,11,2
1000000US060552002012002,060552002012002,"Block 2002, Block Group 2, Census Tract 2002.01, Napa County, California",10,8,2
1000000US060552002012003,060552002012003,"Block 2003, Block Group 2, Census Tract 2002.01, Napa County, California",14,12,2
1000000US060552002012004,060552002012004,"Block 2004, Block Group 2, Census Tract 2002.01, Napa County, California",12,11,1
1000000US060552002012005,060552002012005,"Block 2005, Block Group 2, Census Tract 2002.01, Napa County, California",7,6,1
1000000US060552002012006,060552002012006,"Block 2006, Block Group 2, Census Tract 2002.01, Napa County, California",0,0,0
1000000US060552002012007,060552002012007,"Block 2007, Block Group 2, Census Tract 2002.01, Napa County, California",0,0,0
1000000US060552002012008,060552002012008,"Block 2008, Block Group 2, Census Tract 2002.01, Napa County, California",2,1,1
1000000US060552002012009,060552002012009,"Block 2009, Block Group 2, Census Tract 2002.01, Napa County, California",12,11,1
1000000US060552002012010,060552002012010,"Block 2010, Block Group 2, Census Tract 2002.01, Napa County, California",13,13,0
1000000US060552002012011,060552002012011,"Block 2011, Block Group 2, Census Tract 2002.01, Napa County, California",26,26,0
1000000US060552002012012,060552002012012,"Block 2012, Block Group 2, Census Tract 2002.01, Napa County, California",23,20,3
1000000US060552002012013,060552002012013,"Block 2013, Block Group 2, Census Tract 2002.01, Napa County, California",24,24,0
1000000US060552002012014,060552002012014,"Block 2014, Block Group 2, Census Tract 2002.01, Napa County, California",20,19,1
1000000US060552002012015,060552002012015,"Block 2015, Block Group 2, Census Tract 2002.01, Napa County, California",20,19,1
1000000US060552002012016,060552002012016,"Block 2016, Block Group 2, Census Tract 2002.01, Napa County, California",18,16,2
1000000US060552002012017,060552002012017,"Block 2017, Block Group 2, Census Tract 2002.01, Napa County, California",48,44,4
1000000US060552002012018,060552002012018,"Block 2018, Block Group 2, Census Tract 2002.01, Napa County, California",27,23,4
1000000US060552002012019,060552002012019,"Block 2019, Block Group 2, Census Tract 2002.01, Napa County, California",108,104,4
1000000US060552002012020,060552002012020,"Block 2020, Block Group 2, Census Tract 2002.01, Napa County, California",9,8,1
1000000US060552002012021,060552002012021,"Block 2021, Block Group 2, Census Tract 2002.01, Napa County, California",16,15,1
1000000US060552002012022,060552002012022,"Block 2022, Block Group 2, Census Tract 2002.01, Napa County, California",1,0,1
1000000US060552002012023,060552002012023,"Block 2023, Block Group 2, Census Tract 2002.01, Napa County, California",0,0,0
1000000US060552002012024,060552002012024,"Block 2024, Block Group 2, Census Tract 2002.01, Napa County, California",0,0,0
1000000US060552002012025,060552002012025,"Block 2025, Block Group 2, Census Tract 2002.01, Napa County, California",48,47,1
1000000US060552002012026,060552002012026,"Block 2026, Block Group 2, Census Tract 2002.01, Napa County, California",19,18,1
1000000US060552002013000,060552002013000,"Block 3000, Block Group 3, Census Tract 2002.01, Napa County, California",0,0,0
1000000US060552002013001,060552002013001,"Block 3001, Block Group 3, Census Tract 2002.01, Napa County, California",17,15,2
1000000US060552002013002,060552002013002,"Block 3002, Block Group 3, Census Tract 2002.01, Napa County, California",15,14,1
1000000US060552002013003,060552002013003,"Block 3003, Block Group 3, Census Tract 2002.01, Napa County, California",141,139,2
1000000US060552002013004,060552002013004,"Block 3004, Block Group 3, Census Tract 2002.01, Napa County, California",12,12,0
1000000US060552002013005,060552002013005,"Block 3005, Block Group 3, Census Tract 2002.01, Napa County, California",9,9,0
1000000US060552002013006,060552002013006,"Block 3006, Block Group 3, Census Tract 2002.01, Napa County, California",11,11,0
1000000US060552002013007,060552002013007,"Block 3007, Block Group 3, Census Tract 2002.01, Napa County, California",0,0,0
1000000US060552002013008,060552002013008,"Block 3008, Block Group 3, Census Tract 2002.01, Napa County, California",0,0,0
1000000US060552002013009,060552002013009,"Block 3009, Block Group 3, Census Tract 2002.01, Napa County, California",9,9,0
1000000US060552002013010,060552002013010,"Block 3010, Block Group 3, Census Tract 2002.01, Napa County, California",21,20,1
1000000US060552002013011,060552002013011,"Block 3011, Block Group 3, Census Tract 2002.01, Napa County, California",21,20,1
1000000US060552002013012,060552002013012,"Block 3012, Block Group 3, Census Tract 2002.01, Napa County, California",19,17,2
1000000US060552002013013,060552002013013,"Block 3013, Block Group 3, Census Tract 2002.01, Napa County, California",14,14,0
1000000US060552002013014,060552002013014,"Block 3014, Block Group 3, Census Tract 2002.01, Napa County, California",18,18,0
1000000US060552002013015,060552002013015,"Block 3015, Block Group 3, Census Tract 2002.01, Napa County, California",20,20,0
1000000US060552002013016,060552002013016,"Block 3016, Block Group 3, Census Tract 2002.01, Napa County, California",6,6,0
1000000US060552002013017,060552002013017,"Block 3017, Block Group 3, Census Tract 2002.01, Napa County, California",22,18,4
1000000US060552002013018,060552002013018,"Block 3018, Block Group 3, Census Tract 2002.01, Napa County, California",6,5,1
1000000US060552002013019,060552002013019,"Block 3019, Block Group 3, Census Tract 2002.01, Napa County, California",7,7,0
1000000US060552002021000,060552002021000,"Block 1000, Block Group 1, Census Tract 2002.02, Napa County, California",0,0,0
1000000US060552002021001,060552002021001,"Block 1001, Block Group 1, Census Tract 2002.02, Napa County, California",1,1,0
1000000US060552002021002,060552002021002,"Block 1002, Block Group 1, Census Tract 2002.02, Napa County, California",11,10,1
1000000US060552002021003,060552002021003,"Block 1003, Block Group 1, Census Tract 2002.02, Napa County, California",29,28,1
1000000US060552002021004,060552002021004,"Block 1004, Block Group 1, Census Tract 2002.02, Napa County, California",11,10,1
1000000US060552002021005,060552002021005,"Block 1005, Block Group 1, Census Tract 2002.02, Napa County, California",121,117,4
1000000US060552002021006,060552002021006,"Block 1006, Block Group 1, Census Tract 2002.02, Napa County, California",35,25,10
1000000US060552002021007,060552002021007,"Block 1007, Block Group 1, Census Tract 2002.02, Napa County, California",9,9,0
1000000US060552002021008,060552002021008,"Block 1008, Block Group 1, Census Tract 2002.02, Napa County, California",1,1,0
1000000US060552002021009,060552002021009,"Block 1009, Block Group 1, Census Tract 2002.02, Napa County, California",0,0,0
1000000US060552002021010,060552002021010,"Block 1010, Block Group 1, Census Tract 2002.02, Napa County, California",1,1,0
1000000US060552002021011,060552002021011,"Block 1011, Block Group 1, Census Tract 2002.02, Napa County, California",4,2,2
1000000US060552002021012,060552002021012,"Block 1012, Block Group 1, Census Tract 2002.02, Napa County, California",0,0,0
1000000US060552002021013,060552002021013,"Block 1013, Block Group 1, Census Tract 2002.02, Napa County, California",0,0,0
1000000US060552002021014,060552002021014,"Block 1014, Block Group 1, Census Tract 2002.02, Napa County, California",1,1,0
1000000US060552002021015,060552002021015,"Block 1015, Block Group 1, Census Tract 2002.02, Napa County, California",0,0,0
1000000US060552002021016,060552002021016,"Block 1016, Block Group 1, Census Tract 2002.02, Napa County, California",0,0,0
1000000US060552002021017,060552002021017,"Block 1017, Block Group 1, Census Tract 2002.02, Napa County, California",0,0,0
1000000US060552002021018,060552002021018,"Block 1018, Block Group 1, Census Tract 2002.02, Napa County, California",0,0,0
1000000US060552002021019,060552002021019,"Block 1019, Block Group 1, Census Tract 2002.02, Napa County, California",0,0,0
1000000US060552002021020,060552002021020,"Block 1020, Block Group 1, Census Tract 2002.02, Napa County, California",0,0,0
1000000US060552002021021,060552002021021,"Block 1021, Block Group 1, Census Tract 2002.02, Napa County, California",0,0,0
1000000US060552002021022,060552002021022,"Block 1022, Block Group 1, Census Tract 2002.02, Napa County, California",0,0,0
1000000US060552002021023,060552002021023,"Block 1023, Block Group 1, Census Tract 2002.02, Napa County, California",0,0,0
1000000US060552002021024,060552002021024,"Block 1024, Block Group 1, Census Tract 2002.02, Napa County, California",0,0,0
1000000US060552002021025,060552002021025,"Block 1025, Block Group 1, Census Tract 2002.02, Napa County, California",2,1,1
1000000US060552002021026,060552002021026,"Block 1026, Block Group 1, Census Tract 2002.02, Napa County, California",0,0,0
1000000US060552002021027,060552002021027,"Block 1027, Block Group 1, Census Tract 2002.02, Napa County, California",1,1,0
1000000US060552002021028,060552002021028,"Block 1028, Block Group 1, Census Tract 2002.02, Napa County, California",22,15,7
1000000US060552002021029,060552002021029,"Block 1029, Block Group 1, Census Tract 2002.02, Napa County, California",0,0,0
1000000US060552002021030,060552002021030,"Block 1030, Block Group 1, Census Tract 2002.02, Napa County, California",3,2,1
1000000US060552002021031,060552002021031,"Block 1031, Block Group 1, Census Tract 2002.02, Napa County, California",0,0,0
1000000US060552002021032,060552002021032,"Block 1032, Block Group 1, Census Tract 2002.02, Napa County, California",0,0,0
1000000US060552002021033,060552002021033,"Block 1033, Block Group 1, Census Tract 2002.02, Napa County, California",10,9,1
1000000US060552002021034,060552002021034,"Block 1034, Block Group 1, Census Tract 2002.02, Napa County, California",7,7,0
1000000US060552002021035,060552002021035,"Block 1035, Block Group 1, Census Tract 2002.02, Napa County, California",25,24,1
1000000US060552002021036,060552002021036,"Block 1036, Block Group 1, Census Tract 2002.02, Napa County, California",10,10,0
1000000US060552002021037,060552002021037,"Block 1037, Block Group 1, Census Tract 2002.02, Napa County, California",26,23,3
1000000US060552002022000,060552002022000,"Block 2000, Block Group 2, Census Tract 2002.02, Napa County, California",0,0,0
1000000US060552002022001,060552002022001,"Block 2001, Block Group 2, Census Tract 2002.02, Napa County, California",4,3,1
1000000US060552002022002,060552002022002,"Block 2002, Block Group 2, Census Tract 2002.02, Napa County, California",18,16,2
1000000US060552002022003,060552002022003,"Block 2003, Block Group 2, Census Tract 2002.02, Napa County, California",0,0,0
1000000US060552002022004,060552002022004,"Block 2004, Block Group 2, Census Tract 2002.02, Napa County, California",0,0,0
1000000US060552002022005,060552002022005,"Block 2005, Block Group 2, Census Tract 2002.02, Napa County, California",0,0,0
1000000US060552002022006,060552002022006,"Block 2006, Block Group 2, Census Tract 2002.02, Napa County, California",4,2,2
1000000US060552002022007,060552002022007,"Block 2007, Block Group 2, Census Tract 2002.02, Napa County, California",0,0,0
1000000US060552002022008,060552002022008,"Block 2008, Block Group 2, Census Tract 2002.02, Napa County, California",0,0,0
1000000US060552002022009,060552002022009,"Block 2009, Block Group 2, Census Tract 2002.02, Napa County, California",0,0,0
1000000US060552002022010,060552002022010,"Block 2010, Block Group 2, Census Tract 2002.02, Napa County, California",0,0,0
1000000US060552002022011,060552002022011,"Block 2011, Block Group 2, Census Tract 2002.02, Napa County, California",73,65,8
1000000US060552002022012,060552002022012,"Block 2012, Block Group 2, Census Tract 2002.02, Napa County, California",0,0,0
1000000US060552002022013,060552002022013,"Block 2013, Block Group 2, Census Tract 2002.02, Napa County, California",5,4,1
1000000US060552002022014,060552002022014,"Block 2014, Block Group 2, Census Tract 2002.02, Napa County, California",7,6,1
1000000US060552002022015,060552002022015,"Block 2015, Block Group 2, Census Tract 2002.02, Napa County, California",1,1,0
1000000US060552002022016,060552002022016,"Block 2016, Block Group 2, Census Tract 2002.02, Napa County, California",0,0,0
1000000US060552002022017,060552002022017,"Block 2017, Block Group 2, Census Tract 2002.02, Napa County, California",59,56,3
1000000US060552002022018,060552002022018,"Block 2018, Block Group 2, Census Tract 2002.02, Napa County, California",18,17,1
1000000US060552002022019,060552002022019,"Block 2019, Block Group 2, Census Tract 2002.02, Napa County, California",47,37,10
1000000US060552002023000,060552002023000,"Block 3000, Block Group 3, Census Tract 2002.02, Napa County, California",0,0,0
1000000US060552002023001,060552002023001,"Block 3001, Block Group 3, Census Tract 2002.02, Napa County, California",32,30,2
1000000US060552002023002,060552002023002,"Block 3002, Block Group 3, Census Tract 2002.02, Napa County, California",35,28,7
1000000US060552002023003,060552002023003,"Block 3003, Block Group 3, Census Tract 2002.02, Napa County, California",25,25,0
1000000US060552002023004,060552002023004,"Block 3004, Block Group 3, Census Tract 2002.02, Napa County, California",39,34,5
1000000US060552002023005,060552002023005,"Block 3005, Block Group 3, Census Tract 2002.02, Napa County, California",34,32,2
1000000US060552002023006,060552002023006,"Block 3006, Block Group 3, Census Tract 2002.02, Napa County, California",47,40,7
1000000US060552002023007,060552002023007,"Block 3007, Block Group 3, Census Tract 2002.02, Napa County, California",26,24,2
1000000US060552002023008,060552002023008,"Block 3008, Block Group 3, Census Tract 2002.02, Napa County, California",14,12,2
1000000US060552002023009,060552002023009,"Block 3009, Block Group 3, Census Tract 2002.02, Napa County, California",0,0,0
1000000US060552002023010,060552002023010,"Block 3010, Block Group 3, Census Tract 2002.02, Napa County, California",41,38,3
1000000US060552002023011,060552002023011,"Block 3011, Block Group 3, Census Tract 2002.02, Napa County, California",22,19,3
1000000US060552002023012,060552002023012,"Block 3012, Block Group 3, Census Tract 2002.02, Napa County, California",15,15,0
1000000US060552002023013,060552002023013,"Block 3013, Block Group 3, Census Tract 2002.02, Napa County, California",36,35,1
1000000US060552002023014,060552002023014,"Block 3014, Block Group 3, Census Tract 2002.02, Napa County, California",34,32,2
1000000US060552002023015,060552002023015,"Block 3015, Block Group 3, Census Tract 2002.02, Napa County, California",33,29,4
1000000US060552002023016,060552002023016,"Block 3016, Block Group 3, Census Tract 2002.02, Napa County, California",20,19,1
1000000US060552002023017,060552002023017,"Block 3017, Block Group 3, Census Tract 2002.02, Napa County, California",20,18,2
1000000US060552002023018,060552002023018,"Block 3018, Block Group 3, Census Tract 2002.02, Napa County, California",76,76,0
1000000US060552002023019,060552002023019,"Block 3019, Block Group 3, Census Tract 2002.02, Napa County, California",9,8,1
1000000US060552002023020,060552002023020,"Block 3020, Block Group 3, Census Tract 2002.02, Napa County, California",45,38,7
1000000US060552002023021,060552002023021,"Block 3021, Block Group 3, Census Tract 2002.02, Napa County, California",26,24,2
1000000US060552002031000,060552002031000,"Block 1000, Block Group 1, Census Tract 2002.03, Napa County, California",25,24,1
1000000US060552002031001,060552002031001,"Block 1001, Block Group 1, Census Tract 2002.03, Napa County, California",25,22,3
1000000US060552002031002,060552002031002,"Block 1002, Block Group 1, Census Tract 2002.03, Napa County, California",28,25,3
1000000US060552002031003,060552002031003,"Block 1003, Block Group 1, Census Tract 2002.03, Napa County, California",17,17,0
1000000US060552002031004,060552002031004,"Block 1004, Block Group 1, Census Tract 2002.03, Napa County, California",18,16,2
1000000US060552002031005,060552002031005,"Block 1005, Block Group 1, Census Tract 2002.03, Napa County, California",21,21,0
1000000US060552002031006,060552002031006,"Block 1006, Block Group 1, Census Tract 2002.03, Napa County, California",118,114,4
1000000US060552002031007,060552002031007,"Block 1007, Block Group 1, Census Tract 2002.03, Napa County, California",21,20,1
1000000US060552002031008,060552002031008,"Block 1008, Block Group 1, Census Tract 2002.03, Napa County, California",13,13,0
1000000US060552002031009,060552002031009,"Block 1009, Block Group 1, Census Tract 2002.03, Napa County, California",57,56,1
1000000US060552002031010,060552002031010,"Block 1010, Block Group 1, Census Tract 2002.03, Napa County, California",18,18,0
1000000US060552002031011,060552002031011,"Block 1011, Block Group 1, Census Tract 2002.03, Napa County, California",10,10,0
1000000US060552002031012,060552002031012,"Block 1012, Block Group 1, Census Tract 2002.03, Napa County, California",44,42,2
1000000US060552002031013,060552002031013,"Block 1013, Block Group 1, Census Tract 2002.03, Napa County, California",0,0,0
1000000US060552002032000,060552002032000,"Block 2000, Block Group 2, Census Tract 2002.03, Napa County, California",74,66,8
1000000US060552002032001,060552002032001,"Block 2001, Block Group 2, Census Tract 2002.03, Napa County, California",49,47,2
1000000US060552002032002,060552002032002,"Block 2002, Block Group 2, Census Tract 2002.03, Napa County, California",28,23,5
1000000US060552002032003,060552002032003,"Block 2003, Block Group 2, Census Tract 2002.03, Napa County, California",27,25,2
1000000US060552002032004,060552002032004,"Block 2004, Block Group 2, Census Tract 2002.03, Napa County, California",54,52,2
1000000US060552002032005,060552002032005,"Block 2005, Block Group 2, Census Tract 2002.03, Napa County, California",68,65,3
1000000US060552002032006,060552002032006,"Block 2006, Block Group 2, Census Tract 2002.03, Napa County, California",21,20,1
1000000US060552002032007,060552002032007,"Block 2007, Block Group 2, Census Tract 2002.03, Napa County, California",19,18,1
1000000US060552002032008,060552002032008,"Block 2008, Block Group 2, Census Tract 2002.03, Napa County, California",15,11,4
1000000US060552002032009,060552002032009,"Block 2009, Block Group 2, Census Tract 2002.03, Napa County, California",101,94,7
1000000US060552002032010,060552002032010,"Block 2010, Block Group 2, Census Tract 2002.03, Napa County, California",0,0,0
1000000US060552002032011,060552002032011,"Block 2011, Block Group 2, Census Tract 2002.03, Napa County, California",0,0,0
1000000US060552002032012,060552002032012,"Block 2012, Block Group 2, Census Tract 2002.03, Napa County, California",26,26,0
1000000US060552003011000,060552003011000,"Block 1000, Block Group 1, Census Tract 2003.01, Napa County, California",177,170,7
1000000US060552003011001,060552003011001,"Block 1001, Block Group 1, Census Tract 2003.01, Napa County, California",16,16,0
1000000US060552003011002,060552003011002,"Block 1002, Block Group 1, Census Tract 2003.01, Napa County, California",12,12,0
1000000US060552003011003,060552003011003,"Block 1003, Block Group 1, Census Tract 2003.01, Napa County, California",22,22,0
1000000US060552003011004,060552003011004,"Block 1004, Block Group 1, Census Tract 2003.01, Napa County, California",11,11,0
1000000US060552003011005,060552003011005,"Block 1005, Block Group 1, Census Tract 2003.01, Napa County, California",21,21,0
1000000US060552003011006,060552003011006,"Block 1006, Block Group 1, Census Tract 2003.01, Napa County, California",6,6,0
1000000US060552003011007,060552003011007,"Block 1007, Block Group 1, Census Tract 2003.01, Napa County, California",12,12,0
1000000US060552003011008,060552003011008,"Block 1008, Block Group 1, Census Tract 2003.01, Napa County, California",9,8,1
1000000US060552003011009,060552003011009,"Block 1009, Block Group 1, Census Tract 2003.01, Napa County, California",10,9,1
1000000US060552003011010,060552003011010,"Block 1010, Block Group 1, Census Tract 2003.01, Napa County, California",17,16,1
1000000US060552003011011,060552003011011,"Block 1011, Block Group 1, Census Tract 2003.01, Napa County, California",0,0,0
1000000US060552003011012,060552003011012,"Block 1012, Block Group 1, Census Tract 2003.01, Napa County, California",0,0,0
1000000US060552003011013,060552003011013,"Block 1013, Block Group 1, Census Tract 2003.01, Napa County, California",0,0,0
1000000US060552003011014,060552003011014,"Block 1014, Block Group 1, Census Tract 2003.01, Napa County, California",0,0,0
1000000US060552003011015,060552003011015,"Block 1015, Block Group 1, Census Tract 2003.01, Napa County, California",0,0,0
1000000US060552003011016,060552003011016,"Block 1016, Block Group 1, Census Tract 2003.01, Napa County, California",0,0,0
1000000US060552003011017,060552003011017,"Block 1017, Block Group 1, Census Tract 2003.01, Napa County, California",0,0,0
1000000US060552003011018,060552003011018,"Block 1018, Block Group 1, Census Tract 2003.01, Napa County, California",39,36,3
1000000US060552003011019,060552003011019,"Block 1019, Block Group 1, Census Tract 2003.01, Napa County, California",0,0,0
1000000US060552003011020,060552003011020,"Block 1020, Block Group 1, Census Tract 2003.01, Napa County, California",0,0,0
1000000US060552003011021,060552003011021,"Block 1021, Block Group 1, Census Tract 2003.01, Napa County, California",0,0,0
1000000US060552003011022,060552003011022,"Block 1022, Block Group 1, Census Tract 2003.01, Napa County, California",43,38,5
1000000US060552003011023,060552003011023,"Block 1023, Block Group 1, Census Tract 2003.01, Napa County, California",11,10,1
1000000US060552003011024,060552003011024,"Block 1024, Block Group 1, Census Tract 2003.01, Napa County, California",2,2,0
1000000US060552003011025,060552003011025,"Block 1025, Block Group 1, Census Tract 2003.01, Napa County, California",1,1,0
1000000US060552003011026,060552003011026,"Block 1026, Block Group 1, Census Tract 2003.01, Napa County, California",6,5,1
1000000US060552003011027,060552003011027,"Block 1027, Block Group 1, Census Tract 2003.01, Napa County, California",5,5,0
1000000US060552003011028,060552003011028,"Block 1028, Block Group 1, Census Tract 2003.01, Napa County, California",36,36,0
1000000US060552003011029,060552003011029,"Block 1029, Block Group 1, Census Tract 2003.01, Napa County, California",21,16,5
1000000US060552003011030,060552003011030,"Block 1030, Block Group 1, Census Tract 2003.01, Napa County, California",37,37,0
1000000US060552003011031,060552003011031,"Block 1031, Block Group 1, Census Tract 2003.01, Napa County, California",0,0,0
1000000US060552003011032,060552003011032,"Block 1032, Block Group 1, Census Tract 2003.01, Napa County, California",0,0,0
1000000US060552003011033,060552003011033,"Block 1033, Block Group 1, Census Tract 2003.01, Napa County, California",0,0,0
1000000US060552003011034,060552003011034,"Block 1034, Block Group 1, Census Tract 2003.01, Napa County, California",23,21,2
1000000US060552003011035,060552003011035,"Block 1035, Block Group 1, Census Tract 2003.01, Napa County, California",14,14,0
1000000US060552003011036,060552003011036,"Block 1036, Block Group 1, Census Tract 2003.01, Napa County, California",9,9,0
1000000US060552003011037,060552003011037,"Block 1037, Block Group 1, Census Tract 2003.01, Napa County, California",21,20,1
1000000US060552003011038,060552003011038,"Block 1038, Block Group 1, Census Tract 2003.01, Napa County, California",3,3,0
1000000US060552003011039,060552003011039,"Block 1039, Block Group 1, Census Tract 2003.01, Napa County, California",0,0,0
1000000US060552003011040,060552003011040,"Block 1040, Block Group 1, Census Tract 2003.01, Napa County, California",19,19,0
1000000US060552003011041,060552003011041,"Block 1041, Block Group 1, Census Tract 2003.01, Napa County, California",21,20,1
1000000US060552003012000,060552003012000,"Block 2000, Block Group 2, Census Tract 2003.01, Napa County, California",7,7,0
1000000US060552003012001,060552003012001,"Block 2001, Block Group 2, Census Tract 2003.01, Napa County, California",98,96,2
1000000US060552003012002,060552003012002,"Block 2002, Block Group 2, Census Tract 2003.01, Napa County, California",0,0,0
1000000US060552003012003,060552003012003,"Block 2003, Block Group 2, Census Tract 2003.01, Napa County, California",0,0,0
1000000US060552003012004,060552003012004,"Block 2004, Block Group 2, Census Tract 2003.01, Napa County, California",0,0,0
1000000US060552003012005,060552003012005,"Block 2005, Block Group 2, Census Tract 2003.01, Napa County, California",0,0,0
1000000US060552003012006,060552003012006,"Block 2006, Block Group 2, Census Tract 2003.01, Napa County, California",162,154,8
1000000US060552003012007,060552003012007,"Block 2007, Block Group 2, Census Tract 2003.01, Napa County, California",109,105,4
1000000US060552003012008,060552003012008,"Block 2008, Block Group 2, Census Tract 2003.01, Napa County, California",12,10,2
1000000US060552003012009,060552003012009,"Block 2009, Block Group 2, Census Tract 2003.01, Napa County, California",14,11,3
1000000US060552003012010,060552003012010,"Block 2010, Block Group 2, Census Tract 2003.01, Napa County, California",2,2,0
1000000US060552003012011,060552003012011,"Block 2011, Block Group 2, Census Tract 2003.01, Napa County, California",32,30,2
1000000US060552003012012,060552003012012,"Block 2012, Block Group 2, Census Tract 2003.01, Napa County, California",25,23,2
1000000US060552003012013,060552003012013,"Block 2013, Block Group 2, Census Tract 2003.01, Napa County, California",11,10,1
1000000US060552003012014,060552003012014,"Block 2014, Block Group 2, Census Tract 2003.01, Napa County, California",0,0,0
1000000US060552003012015,060552003012015,"Block 2015, Block Group 2, Census Tract 2003.01, Napa County, California",0,0,0
1000000US060552003012016,060552003012016,"Block 2016, Block Group 2, Census Tract 2003.01, Napa County, California",26,25,1
1000000US060552003012017,060552003012017,"Block 2017, Block Group 2, Census Tract 2003.01, Napa County, California",26,25,1
1000000US060552003013000,060552003013000,"Block 3000, Block Group 3, Census Tract 2003.01, Napa County, California",3,3,0
1000000US060552003013001,060552003013001,"Block 3001, Block Group 3, Census Tract 2003.01, Napa County, California",18,18,0
1000000US060552003013002,060552003013002,"Block 3002, Block Group 3, Census Tract 2003.01, Napa County, California",19,18,1
1000000US060552003013003,060552003013003,"Block 3003, Block Group 3, Census Tract 2003.01, Napa County, California",116,111,5
1000000US060552003013004,060552003013004,"Block 3004, Block Group 3, Census Tract 2003.01, Napa County, California",58,54,4
1000000US060552003013005,060552003013005,"Block 3005, Block Group 3, Census Tract 2003.01, Napa County, California",0,0,0
1000000US060552003013006,060552003013006,"Block 3006, Block Group 3, Census Tract 2003.01, Napa County, California",14,14,0
1000000US060552003013007,060552003013007,"Block 3007, Block Group 3, Census Tract 2003.01, Napa County, California",48,46,2
1000000US060552003013008,060552003013008,"Block 3008, Block Group 3, Census Tract 2003.01, Napa County, California",22,22,0
1000000US060552003013009,060552003013009,"Block 3009, Block Group 3, Census Tract 2003.01, Napa County, California",27,27,0
1000000US060552003013010,060552003013010,"Block 3010, Block Group 3, Census Tract 2003.01, Napa County, California",0,0,0
1000000US060552003013011,060552003013011,"Block 3011, Block Group 3, Census Tract 2003.01, Napa County, California",26,26,0
1000000US060552003013012,060552003013012,"Block 3012, Block Group 3, Census Tract 2003.01, Napa County, California",9,8,1
1000000US060552003013013,060552003013013,"Block 3013, Block Group 3, Census Tract 2003.01, Napa County, California",0,0,0
1000000US060552003013014,060552003013014,"Block 3014, Block Group 3, Census Tract 2003.01, Napa County, California",38,36,2
1000000US060552003013015,060552003013015,"Block 3015, Block Group 3, Census Tract 2003.01, Napa County, California",7,7,0
1000000US060552003013016,060552003013016,"Block 3016, Block Group 3, Census Tract 2003.01, Napa County, California",17,16,1
1000000US060552003013017,060552003013017,"Block 3017, Block Group 3, Census Tract 2003.01, Napa County, California",10,10,0
1000000US060552003013018,060552003013018,"Block 3018, Block Group 3, Census Tract 2003.01, Napa County, California",25,23,2
1000000US060552003013019,060552003013019,"Block 3019, Block Group 3, Census Tract 2003.01, Napa County, California",16,16,0
1000000US060552003013020,060552003013020,"Block 3020, Block Group 3, Census Tract 2003.01, Napa County, California",5,4,1
1000000US060552003013021,060552003013021,"Block 3021, Block Group 3, Census Tract 2003.01, Napa County, California",17,16,1
1000000US060552003013022,060552003013022,"Block 3022, Block Group 3, Census Tract 2003.01, Napa County, California",13,13,0
1000000US060552003013023,060552003013023,"Block 3023, Block Group 3, Census Tract 2003.01, Napa County, California",21,20,1
1000000US060552003013024,060552003013024,"Block 3024, Block Group 3, Census Tract 2003.01, Napa County, California",16,15,1
1000000US060552003013025,060552003013025,"Block 3025, Block Group 3, Census Tract 2003.01, Napa County, California",4,4,0
1000000US060552003013026,060552003013026,"Block 3026, Block Group 3, Census Tract 2003.01, Napa County, California",23,23,0
1000000US060552003013027,060552003013027,"Block 3027, Block Group 3, Census Tract 2003.01, Napa County, California",13,13,0
1000000US060552003013028,060552003013028,"Block 3028, Block Group 3, Census Tract 2003.01, Napa County, California",43,43,0
1000000US060552003013029,060552003013029,"Block 3029, Block Group 3, Census Tract 2003.01, Napa County, California",16,14,2
1000000US060552003013030,060552003013030,"Block 3030, Block Group 3, Census Tract 2003.01, Napa County, California",16,15,1
1000000US060552003021000,060552003021000,"Block 1000, Block Group 1, Census Tract 2003.02, Napa County, California",8,5,3
1000000US060552003021001,060552003021001,"Block 1001, Block Group 1, Census Tract 2003.02, Napa County, California",60,60,0
1000000US060552003021002,060552003021002,"Block 1002, Block Group 1, Census Tract 2003.02, Napa County, California",52,50,2
1000000US060552003021003,060552003021003,"Block 1003, Block Group 1, Census Tract 2003.02, Napa County, California",57,57,0
1000000US060552003021004,060552003021004,"Block 1004, Block Group 1, Census Tract 2003.02, Napa County, California",5,5,0
1000000US060552003021005,060552003021005,"Block 1005, Block Group 1, Census Tract 2003.02, Napa County, California",8,5,3
1000000US060552003021006,060552003021006,"Block 1006, Block Group 1, Census Tract 2003.02, Napa County, California",0,0,0
1000000US060552003021007,060552003021007,"Block 1007, Block Group 1, Census Tract 2003.02, Napa County, California",0,0,0
1000000US060552003021008,060552003021008,"Block 1008, Block Group 1, Census Tract 2003.02, Napa County, California",28,20,8
1000000US060552003021009,060552003021009,"Block 1009, Block Group 1, Census Tract 2003.02, Napa County, California",87,83,4
1000000US060552003021010,060552003021010,"Block 1010, Block Group 1, Census Tract 2003.02, Napa County, California",0,0,0
1000000US060552003021011,060552003021011,"Block 1011, Block Group 1, Census Tract 2003.02, Napa County, California",41,38,3
1000000US060552003021012,060552003021012,"Block 1012, Block Group 1, Census Tract 2003.02, Napa County, California",27,27,0
1000000US060552003021013,060552003021013,"Block 1013, Block Group 1, Census Tract 2003.02, Napa County, California",3,3,0
1000000US060552003021014,060552003021014,"Block 1014, Block Group 1, Census Tract 2003.02, Napa County, California",0,0,0
1000000US060552003021015,060552003021015,"Block 1015, Block Group 1, Census Tract 2003.02, Napa County, California",12,12,0
1000000US060552003021016,060552003021016,"Block 1016, Block Group 1, Census Tract 2003.02, Napa County, California",14,14,0
1000000US060552003022000,060552003022000,"Block 2000, Block Group 2, Census Tract 2003.02, Napa County, California",93,90,3
1000000US060552003022001,060552003022001,"Block 2001, Block Group 2, Census Tract 2003.02, Napa County, California",26,25,1
1000000US060552003022002,060552003022002,"Block 2002, Block Group 2, Census Tract 2003.02, Napa County, California",28,28,0
1000000US060552003022003,060552003022003,"Block 2003, Block Group 2, Census Tract 2003.02, Napa County, California",19,18,1
1000000US060552003022004,060552003022004,"Block 2004, Block Group 2, Census Tract 2003.02, Napa County, California",18,18,0
1000000US060552003022005,060552003022005,"Block 2005, Block Group 2, Census Tract 2003.02, Napa County, California",37,37,0
1000000US060552003022006,060552003022006,"Block 2006, Block Group 2, Census Tract 2003.02, Napa County, California",9,9,0
1000000US060552003022007,060552003022007,"Block 2007, Block Group 2, Census Tract 2003.02, Napa County, California",42,42,0
1000000US060552003022008,060552003022008,"Block 2008, Block Group 2, Census Tract 2003.02, Napa County, California",0,0,0
1000000US060552003022009,060552003022009,"Block 2009, Block Group 2, Census Tract 2003.02, Napa County, California",8,8,0
1000000US060552003022010,060552003022010,"Block 2010, Block Group 2, Census Tract 2003.02, Napa County, California",10,10,0
1000000US060552003022011,060552003022011,"Block 2011, Block Group 2, Census Tract 2003.02, Napa County, California",18,18,0
1000000US060552003022012,060552003022012,"Block 2012, Block Group 2, Census Tract 2003.02, Napa County, California",24,23,1
1000000US060552003022013,060552003022013,"Block 2013, Block Group 2, Census Tract 2003.02, Napa County, California",17,16,1
1000000US060552003022014,060552003022014,"Block 2014, Block Group 2, Census Tract 2003.02, Napa County, California",12,12,0
1000000US060552003022015,060552003022015,"Block 2015, Block Group 2, Census Tract 2003.02, Napa County, California",79,75,4
1000000US060552003022016,060552003022016,"Block 2016, Block Group 2, Census Tract 2003.02, Napa County, California",23,21,2
1000000US060552003022017,060552003022017,"Block 2017, Block Group 2, Census Tract 2003.02, Napa County, California",6,6,0
1000000US060552003022018,060552003022018,"Block 2018, Block Group 2, Census Tract 2003.02, Napa County, California",18,12,6
1000000US060552004001000,060552004001000,"Block 1000, Block Group 1, Census Tract 2004, Napa County, California",65,60,5
1000000US060552004001001,060552004001001,"Block 1001, Block Group 1, Census Tract 2004, Napa County, California",34,32,2
1000000US060552004001002,060552004001002,"Block 1002, Block Group 1, Census Tract 2004, Napa County, California",3,3,0
1000000US060552004001003,060552004001003,"Block 1003, Block Group 1, Census Tract 2004, Napa County, California",5,5,0
1000000US060552004001004,060552004001004,"Block 1004, Block Group 1, Census Tract 2004, Napa County, California",10,8,2
1000000US060552004001005,060552004001005,"Block 1005, Block Group 1, Census Tract 2004, Napa County, California",5,5,0
1000000US060552004001006,060552004001006,"Block 1006, Block Group 1, Census Tract 2004, Napa County, California",47,45,2
1000000US060552004001007,060552004001007,"Block 1007, Block Group 1, Census Tract 2004, Napa County, California",5,5,0
1000000US060552004001008,060552004001008,"Block 1008, Block Group 1, Census Tract 2004, Napa County, California",17,17,0
1000000US060552004001009,060552004001009,"Block 1009, Block Group 1, Census Tract 2004, Napa County, California",10,9,1
1000000US060552004001010,060552004001010,"Block 1010, Block Group 1, Census Tract 2004, Napa County, California",13,13,0
1000000US060552004001011,060552004001011,"Block 1011, Block Group 1, Census Tract 2004, Napa County, California",16,16,0
1000000US060552004001012,060552004001012,"Block 1012, Block Group 1, Census Tract 2004, Napa County, California",4,4,0
1000000US060552004001013,060552004001013,"Block 1013, Block Group 1, Census Tract 2004, Napa County, California",3,0,3
1000000US060552004001014,060552004001014,"Block 1014, Block Group 1, Census Tract 2004, Napa County, California",25,20,5
1000000US060552004001015,060552004001015,"Block 1015, Block Group 1, Census Tract 2004, Napa County, California",47,47,0
1000000US060552004001016,060552004001016,"Block 1016, Block Group 1, Census Tract 2004, Napa County, California",14,14,0
1000000US060552004001017,060552004001017,"Block 1017, Block Group 1, Census Tract 2004, Napa County, California",10,8,2
1000000US060552004001018,060552004001018,"Block 1018, Block Group 1, Census Tract 2004, Napa County, California",1,1,0
1000000US060552004001019,060552004001019,"Block 1019, Block Group 1, Census Tract 2004, Napa County, California",3,3,0
1000000US060552004001020,060552004001020,"Block 1020, Block Group 1, Census Tract 2004, Napa County, California",5,5,0
1000000US060552004001021,060552004001021,"Block 1021, Block Group 1, Census Tract 2004, Napa County, California",133,123,10
1000000US060552004001022,060552004001022,"Block 1022, Block Group 1, Census Tract 2004, Napa County, California",53,51,2
1000000US060552004001023,060552004001023,"Block 1023, Block Group 1, Census Tract 2004, Napa County, California",14,13,1
1000000US060552004001024,060552004001024,"Block 1024, Block Group 1, Census Tract 2004, Napa County, California",1,1,0
1000000US060552004001025,060552004001025,"Block 1025, Block Group 1, Census Tract 2004, Napa County, California",25,23,2
1000000US060552004001026,060552004001026,"Block 1026, Block Group 1, Census Tract 2004, Napa County, California",34,33,1
1000000US060552004002000,060552004002000,"Block 2000, Block Group 2, Census Tract 2004, Napa County, California",38,37,1
1000000US060552004002001,060552004002001,"Block 2001, Block Group 2, Census Tract 2004, Napa County, California",32,29,3
1000000US060552004002002,060552004002002,"Block 2002, Block Group 2, Census Tract 2004, Napa County, California",31,29,2
1000000US060552004002003,060552004002003,"Block 2003, Block Group 2, Census Tract 2004, Napa County, California",39,34,5
1000000US060552004002004,060552004002004,"Block 2004, Block Group 2, Census Tract 2004, Napa County, California",0,0,0
1000000US060552004002005,060552004002005,"Block 2005, Block Group 2, Census Tract 2004, Napa County, California",8,8,0
1000000US060552004002006,060552004002006,"Block 2006, Block Group 2, Census Tract 2004, Napa County, California",101,90,11
1000000US060552004002007,060552004002007,"Block 2007, Block Group 2, Census Tract 2004, Napa County, California",2,2,0
1000000US060552004002008,060552004002008,"Block 2008, Block Group 2, Census Tract 2004, Napa County, California",40,38,2
1000000US060552004002009,060552004002009,"Block 2009, Block Group 2, Census Tract 2004, Napa County, California",3,3,0
1000000US060552004002010,060552004002010,"Block 2010, Block Group 2, Census Tract 2004, Napa County, California",6,5,1
1000000US060552004002011,060552004002011,"Block 2011, Block Group 2, Census Tract 2004, Napa County, California",8,8,0
1000000US060552004002012,060552004002012,"Block 2012, Block Group 2, Census Tract 2004, Napa County, California",7,7,0
1000000US060552004002013,060552004002013,"Block 2013, Block Group 2, Census Tract 2004, Napa County, California",35,35,0
1000000US060552004002014,060552004002014,"Block 2014, Block Group 2, Census Tract 2004, Napa County, California",2,0,2
1000000US060552004002015,060552004002015,"Block 2015, Block Group 2, Census Tract 2004, Napa County, California",15,15,0
1000000US060552004002016,060552004002016,"Block 2016, Block Group 2, Census Tract 2004, Napa County, California",0,0,0
1000000US060552004002017,060552004002017,"Block 2017, Block Group 2, Census Tract 2004, Napa County, California",0,0,0
1000000US060552004002018,060552004002018,"Block 2018, Block Group 2, Census Tract 2004, Napa County, California",0,0,0
1000000US060552004002019,060552004002019,"Block 2019, Block Group 2, Census Tract 2004, Napa County, California",0,0,0
1000000US060552004002020,060552004002020,"Block 2020, Block Group 2, Census Tract 2004, Napa County, California",0,0,0
1000000US060552004002021,060552004002021,"Block 2021, Block Group 2, Census Tract 2004, Napa County, California",51,46,5
1000000US060552004002022,060552004002022,"Block 2022, Block Group 2, Census Tract 2004, Napa County, California",8,8,0
1000000US060552004002023,060552004002023,"Block 2023, Block Group 2, Census Tract 2004, Napa County, California",16,14,2
1000000US060552004002024,060552004002024,"Block 2024, Block Group 2, Census Tract 2004, Napa County, California",16,16,0
1000000US060552004002025,060552004002025,"Block 2025, Block Group 2, Census Tract 2004, Napa County, California",17,16,1
1000000US060552004002026,060552004002026,"Block 2026, Block Group 2, Census Tract 2004, Napa County, California",17,17,0
1000000US060552004002027,060552004002027,"Block 2027, Block Group 2, Census Tract 2004, Napa County, California",15,14,1
1000000US060552004002028,060552004002028,"Block 2028, Block Group 2, Census Tract 2004, Napa County, California",18,17,1
1000000US060552004002029,060552004002029,"Block 2029, Block Group 2, Census Tract 2004, Napa County, California",12,11,1
1000000US060552004002030,060552004002030,"Block 2030, Block Group 2, Census Tract 2004, Napa County, California",17,16,1
1000000US060552004002031,060552004002031,"Block 2031, Block Group 2, Census Tract 2004, Napa County, California",15,15,0
1000000US060552004002032,060552004002032,"Block 2032, Block Group 2, Census Tract 2004, Napa County, California",36,34,2
1000000US060552004002033,060552004002033,"Block 2033, Block Group 2, Census Tract 2004, Napa County, California",16,16,0
1000000US060552004002034,060552004002034,"Block 2034, Block Group 2, Census Tract 2004, Napa County, California",16,15,1
1000000US060552004002035,060552004002035,"Block 2035, Block Group 2, Census Tract 2004, Napa County, California",18,16,2
1000000US060552004002036,060552004002036,"Block 2036, Block Group 2, Census Tract 2004, Napa County, California",13,11,2
1000000US060552004002037,060552004002037,"Block 2037, Block Group 2, Census Tract 2004, Napa County, California",12,12,0
1000000US060552004003000,060552004003000,"Block 3000, Block Group 3, Census Tract 2004, Napa County, California",42,41,1
1000000US060552004003001,060552004003001,"Block 3001, Block Group 3, Census Tract 2004, Napa County, California",7,7,0
1000000US060552004003002,060552004003002,"Block 3002, Block Group 3, Census Tract 2004, Napa County, California",19,19,0
1000000US060552004003003,060552004003003,"Block 3003, Block Group 3, Census Tract 2004, Napa County, California",17,15,2
1000000US060552004003004,060552004003004,"Block 3004, Block Group 3, Census Tract 2004, Napa County, California",15,12,3
1000000US060552004003005,060552004003005,"Block 3005, Block Group 3, Census Tract 2004, Napa County, California",36,34,2
1000000US060552004003006,060552004003006,"Block 3006, Block Group 3, Census Tract 2004, Napa County, California",0,0,0
1000000US060552004003007,060552004003007,"Block 3007, Block Group 3, Census Tract 2004, Napa County, California",4,4,0
1000000US060552004003008,060552004003008,"Block 3008, Block Group 3, Census Tract 2004, Napa County, California",10,8,2
1000000US060552004003009,060552004003009,"Block 3009, Block Group 3, Census Tract 2004, Napa County, California",0,0,0
1000000US060552004003010,060552004003010,"Block 3010, Block Group 3, Census Tract 2004, Napa County, California",9,9,0
1000000US060552004003011,060552004003011,"Block 3011, Block Group 3, Census Tract 2004, Napa County, California",6,6,0
1000000US060552004003012,060552004003012,"Block 3012, Block Group 3, Census Tract 2004, Napa County, California",12,11,1
1000000US060552004003013,060552004003013,"Block 3013, Block Group 3, Census Tract 2004, Napa County, California",10,10,0
1000000US060552004003014,060552004003014,"Block 3014, Block Group 3, Census Tract 2004, Napa County, California",38,35,3
1000000US060552004003015,060552004003015,"Block 3015, Block Group 3, Census Tract 2004, Napa County, California",3,3,0
1000000US060552004003016,060552004003016,"Block 3016, Block Group 3, Census Tract 2004, Napa County, California",0,0,0
1000000US060552004003017,060552004003017,"Block 3017, Block Group 3, Census Tract 2004, Napa County, California",113,102,11
1000000US060552004003018,060552004003018,"Block 3018, Block Group 3, Census Tract 2004, Napa County, California",19,19,0
1000000US060552004003019,060552004003019,"Block 3019, Block Group 3, Census Tract 2004, Napa County, California",5,5,0
1000000US060552004003020,060552004003020,"Block 3020, Block Group 3, Census Tract 2004, Napa County, California",0,0,0
1000000US060552004003021,060552004003021,"Block 3021, Block Group 3, Census Tract 2004, Napa County, California",14,14,0
1000000US060552004003022,060552004003022,"Block 3022, Block Group 3, Census Tract 2004, Napa County, California",7,7,0
1000000US060552004003023,060552004003023,"Block 3023, Block Group 3, Census Tract 2004, Napa County, California",1,1,0
1000000US060552004003024,060552004003024,"Block 3024, Block Group 3, Census Tract 2004, Napa County, California",0,0,0
1000000US060552004003025,060552004003025,"Block 3025, Block Group 3, Census Tract 2004, Napa County, California",0,0,0
1000000US060552005011000,060552005011000,"Block 1000, Block Group 1, Census Tract 2005.01, Napa County, California",0,0,0
1000000US060552005011001,060552005011001,"Block 1001, Block Group 1, Census Tract 2005.01, Napa County, California",0,0,0
1000000US060552005011002,060552005011002,"Block 1002, Block Group 1, Census Tract 2005.01, Napa County, California",0,0,0
1000000US060552005011003,060552005011003,"Block 1003, Block Group 1, Census Tract 2005.01, Napa County, California",0,0,0
1000000US060552005011004,060552005011004,"Block 1004, Block Group 1, Census Tract 2005.01, Napa County, California",0,0,0
1000000US060552005011005,060552005011005,"Block 1005, Block Group 1, Census Tract 2005.01, Napa County, California",14,12,2
1000000US060552005011006,060552005011006,"Block 1006, Block Group 1, Census Tract 2005.01, Napa County, California",39,38,1
1000000US060552005011007,060552005011007,"Block 1007, Block Group 1, Census Tract 2005.01, Napa County, California",0,0,0
1000000US060552005011008,060552005011008,"Block 1008, Block Group 1, Census Tract 2005.01, Napa County, California",27,27,0
1000000US060552005011009,060552005011009,"Block 1009, Block Group 1, Census Tract 2005.01, Napa County, California",30,30,0
1000000US060552005011010,060552005011010,"Block 1010, Block Group 1, Census Tract 2005.01, Napa County, California",88,83,5
1000000US060552005011011,060552005011011,"Block 1011, Block Group 1, Census Tract 2005.01, Napa County, California",26,25,1
1000000US060552005011012,060552005011012,"Block 1012, Block Group 1, Census Tract 2005.01, Napa County, California",22,21,1
1000000US060552005011013,060552005011013,"Block 1013, Block Group 1, Census Tract 2005.01, Napa County, California",6,6,0
1000000US060552005011014,060552005011014,"Block 1014, Block Group 1, Census Tract 2005.01, Napa County, California",30,28,2
1000000US060552005011015,060552005011015,"Block 1015, Block Group 1, Census Tract 2005.01, Napa County, California",13,13,0
1000000US060552005011016,060552005011016,"Block 1016, Block Group 1, Census Tract 2005.01, Napa County, California",181,172,9
1000000US060552005011017,060552005011017,"Block 1017, Block Group 1, Census Tract 2005.01, Napa County, California",21,19,2
1000000US060552005011018,060552005011018,"Block 1018, Block Group 1, Census Tract 2005.01, Napa County, California",21,19,2
1000000US060552005012000,060552005012000,"Block 2000, Block Group 2, Census Tract 2005.01, Napa County, California",0,0,0
1000000US060552005012001,060552005012001,"Block 2001, Block Group 2, Census Tract 2005.01, Napa County, California",15,15,0
1000000US060552005012002,060552005012002,"Block 2002, Block Group 2, Census Tract 2005.01, Napa County, California",11,11,0
1000000US060552005012003,060552005012003,"Block 2003, Block Group 2, Census Tract 2005.01, Napa County, California",27,27,0
1000000US060552005012004,060552005012004,"Block 2004, Block Group 2, Census Tract 2005.01, Napa County, California",34,34,0
1000000US060552005012005,060552005012005,"Block 2005, Block Group 2, Census Tract 2005.01, Napa County, California",0,0,0
1000000US060552005012006,060552005012006,"Block 2006, Block Group 2, Census Tract 2005.01, Napa County, California",6,5,1
1000000US060552005012007,060552005012007,"Block 2007, Block Group 2, Census Tract 2005.01, Napa County, California",31,25,6
1000000US060552005012008,060552005012008,"Block 2008, Block Group 2, Census Tract 2005.01, Napa County, California",33,31,2
1000000US060552005012009,060552005012009,"Block 2009, Block Group 2, Census Tract 2005.01, Napa County, California",23,22,1
1000000US060552005012010,060552005012010,"Block 2010, Block Group 2, Census Tract 2005.01, Napa County, California",5,5,0
1000000US060552005012011,060552005012011,"Block 2011, Block Group 2, Census Tract 2005.01, Napa County, California",13,13,0
1000000US060552005012012,060552005012012,"Block 2012, Block Group 2, Census Tract 2005.01, Napa County, California",18,15,3
1000000US060552005012013,060552005012013,"Block 2013, Block Group 2, Census Tract 2005.01, Napa County, California",2,2,0
1000000US060552005012014,060552005012014,"Block 2014, Block Group 2, Census Tract 2005.01, Napa County, California",0,0,0
1000000US060552005012015,060552005012015,"Block 2015, Block Group 2, Census Tract 2005.01, Napa County, California",15,15,0
1000000US060552005012016,060552005012016,"Block 2016, Block Group 2, Census Tract 2005.01, Napa County, California",22,20,2
1000000US060552005012017,060552005012017,"Block 2017, Block Group 2, Census Tract 2005.01, Napa County, California",22,21,1
1000000US060552005012018,060552005012018,"Block 2018, Block Group 2, Census Tract 2005.01, Napa County, California",22,21,1
1000000US060552005012019,060552005012019,"Block 2019, Block Group 2, Census Tract 2005.01, Napa County, California",15,15,0
1000000US060552005012020,060552005012020,"Block 2020, Block Group 2, Census Tract 2005.01, Napa County, California",10,7,3
1000000US060552005012021,060552005012021,"Block 2021, Block Group 2, Census Tract 2005.01, Napa County, California",56,53,3
1000000US060552005012022,060552005012022,"Block 2022, Block Group 2, Census Tract 2005.01, Napa County, California",0,0,0
1000000US060552005012023,060552005012023,"Block 2023, Block Group 2, Census Tract 2005.01, Napa County, California",0,0,0
1000000US060552005012024,060552005012024,"Block 2024, Block Group 2, Census Tract 2005.01, Napa County, California",0,0,0
1000000US060552005012025,060552005012025,"Block 2025, Block Group 2, Census Tract 2005.01, Napa County, California",10,10,0
1000000US060552005012026,060552005012026,"Block 2026, Block Group 2, Census Tract 2005.01, Napa County, California",18,16,2
1000000US060552005012027,060552005012027,"Block 2027, Block Group 2, Census Tract 2005.01, Napa County, California",23,20,3
1000000US060552005013000,060552005013000,"Block 3000, Block Group 3, Census Tract 2005.01, Napa County, California",3,3,0
1000000US060552005013001,060552005013001,"Block 3001, Block Group 3, Census Tract 2005.01, Napa County, California",8,7,1
1000000US060552005013002,060552005013002,"Block 3002, Block Group 3, Census Tract 2005.01, Napa County, California",3,3,0
1000000US060552005013003,060552005013003,"Block 3003, Block Group 3, Census Tract 2005.01, Napa County, California",36,33,3
1000000US060552005013004,060552005013004,"Block 3004, Block Group 3, Census Tract 2005.01, Napa County, California",135,98,37
1000000US060552005013005,060552005013005,"Block 3005, Block Group 3, Census Tract 2005.01, Napa County, California",104,97,7
1000000US060552005013006,060552005013006,"Block 3006, Block Group 3, Census Tract 2005.01, Napa County, California",0,0,0
1000000US060552005013007,060552005013007,"Block 3007, Block Group 3, Census Tract 2005.01, Napa County, California",0,0,0
1000000US060552005013008,060552005013008,"Block 3008, Block Group 3, Census Tract 2005.01, Napa County, California",60,55,5
1000000US060552005013009,060552005013009,"Block 3009, Block Group 3, Census Tract 2005.01, Napa County, California",9,9,0
1000000US060552005013010,060552005013010,"Block 3010, Block Group 3, Census Tract 2005.01, Napa County, California",9,8,1
1000000US060552005013011,060552005013011,"Block 3011, Block Group 3, Census Tract 2005.01, Napa County, California",11,10,1
1000000US060552005013012,060552005013012,"Block 3012, Block Group 3, Census Tract 2005.01, Napa County, California",11,11,0
1000000US060552005013013,060552005013013,"Block 3013, Block Group 3, Census Tract 2005.01, Napa County, California",9,9,0
1000000US060552005013014,060552005013014,"Block 3014, Block Group 3, Census Tract 2005.01, Napa County, California",6,5,1
1000000US060552005013015,060552005013015,"Block 3015, Block Group 3, Census Tract 2005.01, Napa County, California",14,13,1
1000000US060552005013016,060552005013016,"Block 3016, Block Group 3, Census Tract 2005.01, Napa County, California",7,7,0
1000000US060552005013017,060552005013017,"Block 3017, Block Group 3, Census Tract 2005.01, Napa County, California",9,7,2
1000000US060552005013018,060552005013018,"Block 3018, Block Group 3, Census Tract 2005.01, Napa County, California",7,6,1
1000000US060552005013019,060552005013019,"Block 3019, Block Group 3, Census Tract 2005.01, Napa County, California",9,8,1
1000000US060552005013020,060552005013020,"Block 3020, Block Group 3, Census Tract 2005.01, Napa County, California",8,8,0
1000000US060552005013021,060552005013021,"Block 3021, Block Group 3, Census Tract 2005.01, Napa County, California",9,8,1
1000000US060552005013022,060552005013022,"Block 3022, Block Group 3, Census Tract 2005.01, Napa County, California",9,7,2
1000000US060552005013023,060552005013023,"Block 3023, Block Group 3, Census Tract 2005.01, Napa County, California",14,11,3
1000000US060552005013024,060552005013024,"Block 3024, Block Group 3, Census Tract 2005.01, Napa County, California",12,12,0
1000000US060552005013025,060552005013025,"Block 3025, Block Group 3, Census Tract 2005.01, Napa County, California",10,10,0
1000000US060552005013026,060552005013026,"Block 3026, Block Group 3, Census Tract 2005.01, Napa County, California",10,10,0
1000000US060552005013027,060552005013027,"Block 3027, Block Group 3, Census Tract 2005.01, Napa County, California",41,35,6
1000000US060552005013028,060552005013028,"Block 3028, Block Group 3, Census Tract 2005.01, Napa County, California",136,123,13
1000000US060552005013029,060552005013029,"Block 3029, Block Group 3, Census Tract 2005.01, Napa County, California",16,16,0
1000000US060552005013030,060552005013030,"Block 3030, Block Group 3, Census Tract 2005.01, Napa County, California",9,6,3
1000000US060552005013031,060552005013031,"Block 3031, Block Group 3, Census Tract 2005.01, Napa County, California",13,11,2
1000000US060552005013032,060552005013032,"Block 3032, Block Group 3, Census Tract 2005.01, Napa County, California",4,4,0
1000000US060552005013033,060552005013033,"Block 3033, Block Group 3, Census Tract 2005.01, Napa County, California",8,8,0
1000000US060552005013034,060552005013034,"Block 3034, Block Group 3, Census Tract 2005.01, Napa County, California",8,7,1
1000000US060552005013035,060552005013035,"Block 3035, Block Group 3, Census Tract 2005.01, Napa County, California",5,4,1
1000000US060552005013036,060552005013036,"Block 3036, Block Group 3, Census Tract 2005.01, Napa County, California",21,20,1
1000000US060552005013037,060552005013037,"Block 3037, Block Group 3, Census Tract 2005.01, Napa County, California",27,24,3
1000000US060552005013038,060552005013038,"Block 3038, Block Group 3, Census Tract 2005.01, Napa County, California",25,24,1
1000000US060552005013039,060552005013039,"Block 3039, Block Group 3, Census Tract 2005.01, Napa County, California",11,10,1
1000000US060552005013040,060552005013040,"Block 3040, Block Group 3, Census Tract 2005.01, Napa County, California",9,7,2
1000000US060552005031000,060552005031000,"Block 1000, Block Group 1, Census Tract 2005.03, Napa County, California",11,9,2
1000000US060552005031001,060552005031001,"Block 1001, Block Group 1, Census Tract 2005.03, Napa County, California",16,15,1
1000000US060552005031002,060552005031002,"Block 1002, Block Group 1, Census Tract 2005.03, Napa County, California",21,17,4
1000000US060552005031003,060552005031003,"Block 1003, Block Group 1, Census Tract 2005.03, Napa County, California",11,8,3
1000000US060552005031004,060552005031004,"Block 1004, Block Group 1, Census Tract 2005.03, Napa County, California",16,14,2
1000000US060552005031005,060552005031005,"Block 1005, Block Group 1, Census Tract 2005.03, Napa County, California",20,18,2
1000000US060552005031006,060552005031006,"Block 1006, Block Group 1, Census Tract 2005.03, Napa County, California",65,63,2
1000000US060552005031007,060552005031007,"Block 1007, Block Group 1, Census Tract 2005.03, Napa County, California",24,22,2
1000000US060552005031008,060552005031008,"Block 1008, Block Group 1, Census Tract 2005.03, Napa County, California",22,21,1
1000000US060552005031009,060552005031009,"Block 1009, Block Group 1, Census Tract 2005.03, Napa County, California",33,31,2
1000000US060552005031010,060552005031010,"Block 1010, Block Group 1, Census Tract 2005.03, Napa County, California",0,0,0
1000000US060552005031011,060552005031011,"Block 1011, Block Group 1, Census Tract 2005.03, Napa County, California",2,2,0
1000000US060552005031012,060552005031012,"Block 1012, Block Group 1, Census Tract 2005.03, Napa County, California",13,11,2
1000000US060552005031013,060552005031013,"Block 1013, Block Group 1, Census Tract 2005.03, Napa County, California",14,14,0
1000000US060552005031014,060552005031014,"Block 1014, Block Group 1, Census Tract 2005.03, Napa County, California",14,13,1
1000000US060552005031015,060552005031015,"Block 1015, Block Group 1, Census Tract 2005.03, Napa County, California",0,0,0
1000000US060552005031016,060552005031016,"Block 1016, Block Group 1, Census Tract 2005.03, Napa County, California",12,12,0
1000000US060552005031017,060552005031017,"Block 1017, Block Group 1, Census Tract 2005.03, Napa County, California",68,65,3
1000000US060552005031018,060552005031018,"Block 1018, Block Group 1, Census Tract 2005.03, Napa County, California",13,10,3
1000000US060552005031019,060552005031019,"Block 1019, Block Group 1, Census Tract 2005.03, Napa County, California",24,20,4
1000000US060552005031020,060552005031020,"Block 1020, Block Group 1, Census Tract 2005.03, Napa County, California",33,31,2
1000000US060552005031021,060552005031021,"Block 1021, Block Group 1, Census Tract 2005.03, Napa County, California",46,42,4
1000000US060552005031022,060552005031022,"Block 1022, Block Group 1, Census Tract 2005.03, Napa County, California",49,46,3
1000000US060552005031023,060552005031023,"Block 1023, Block Group 1, Census Tract 2005.03, Napa County, California",3,3,0
1000000US060552005032000,060552005032000,"Block 2000, Block Group 2, Census Tract 2005.03, Napa County, California",0,0,0
1000000US060552005032001,060552005032001,"Block 2001, Block Group 2, Census Tract 2005.03, Napa County, California",3,3,0
1000000US060552005032002,060552005032002,"Block 2002, Block Group 2, Census Tract 2005.03, Napa County, California",0,0,0
1000000US060552005032003,060552005032003,"Block 2003, Block Group 2, Census Tract 2005.03, Napa County, California",0,0,0
1000000US060552005032004,060552005032004,"Block 2004, Block Group 2, Census Tract 2005.03, Napa County, California",0,0,0
1000000US060552005032005,060552005032005,"Block 2005, Block Group 2, Census Tract 2005.03, Napa County, California",1,1,0
1000000US060552005032006,060552005032006,"Block 2006, Block Group 2, Census Tract 2005.03, Napa County, California",0,0,0
1000000US060552005032007,060552005032007,"Block 2007, Block Group 2, Census Tract 2005.03, Napa County, California",1,1,0
1000000US060552005032008,060552005032008,"Block 2008, Block Group 2, Census Tract 2005.03, Napa County, California",17,16,1
1000000US060552005032009,060552005032009,"Block 2009, Block Group 2, Census Tract 2005.03, Napa County, California",0,0,0
1000000US060552005032010,060552005032010,"Block 2010, Block Group 2, Census Tract 2005.03, Napa County, California",22,19,3
1000000US060552005032011,060552005032011,"Block 2011, Block Group 2, Census Tract 2005.03, Napa County, California",0,0,0
1000000US060552005032012,060552005032012,"Block 2012, Block Group 2, Census Tract 2005.03, Napa County, California",0,0,0
1000000US060552005032013,060552005032013,"Block 2013, Block Group 2, Census Tract 2005.03, Napa County, California",5,5,0
1000000US060552005032014,060552005032014,"Block 2014, Block Group 2, Census Tract 2005.03, Napa County, California",4,3,1
1000000US060552005032015,060552005032015,"Block 2015, Block Group 2, Census Tract 2005.03, Napa County, California",0,0,0
1000000US060552005032016,060552005032016,"Block 2016, Block Group 2, Census Tract 2005.03, Napa County, California",0,0,0
1000000US060552005032017,060552005032017,"Block 2017, Block Group 2, Census Tract 2005.03, Napa County, California",0,0,0
1000000US060552005032018,060552005032018,"Block 2018, Block Group 2, Census Tract 2005.03, Napa County, California",0,0,0
1000000US060552005032019,060552005032019,"Block 2019, Block Group 2, Census Tract 2005.03, Napa County, California",0,0,0
1000000US060552005032020,060552005032020,"Block 2020, Block Group 2, Census Tract 2005.03, Napa County, California",0,0,0
1000000US060552005032021,060552005032021,"Block 2021, Block Group 2, Census Tract 2005.03, Napa County, California",25,24,1
1000000US060552005032022,060552005032022,"Block 2022, Block Group 2, Census Tract 2005.03, Napa County, California",0,0,0
1000000US060552005032023,060552005032023,"Block 2023, Block Group 2, Census Tract 2005.03, Napa County, California",22,20,2
1000000US060552005032024,060552005032024,"Block 2024, Block Group 2, Census Tract 2005.03, Napa County, California",14,13,1
1000000US060552005032025,060552005032025,"Block 2025, Block Group 2, Census Tract 2005.03, Napa County, California",0,0,0
1000000US060552005032026,060552005032026,"Block 2026, Block Group 2, Census Tract 2005.03, Napa County, California",1,1,0
1000000US060552005032027,060552005032027,"Block 2027, Block Group 2, Census Tract 2005.03, Napa County, California",0,0,0
1000000US060552005032028,060552005032028,"Block 2028, Block Group 2, Census Tract 2005.03, Napa County, California",0,0,0
1000000US060552005032029,060552005032029,"Block 2029, Block Group 2, Census Tract 2005.03, Napa County, California",4,4,0
1000000US060552005032030,060552005032030,"Block 2030, Block Group 2, Census Tract 2005.03, Napa County, California",1,1,0
1000000US060552005032031,060552005032031,"Block 2031, Block Group 2, Census Tract 2005.03, Napa County, California",5,5,0
1000000US060552005032032,060552005032032,"Block 2032, Block Group 2, Census Tract 2005.03, Napa County, California",0,0,0
1000000US060552005032033,060552005032033,"Block 2033, Block Group 2, Census Tract 2005.03, Napa County, California",7,6,1
1000000US060552005032034,060552005032034,"Block 2034, Block Group 2, Census Tract 2005.03, Napa County, California",12,12,0
1000000US060552005032035,060552005032035,"Block 2035, Block Group 2, Census Tract 2005.03, Napa County, California",14,11,3
1000000US060552005032036,060552005032036,"Block 2036, Block Group 2, Census Tract 2005.03, Napa County, California",18,18,0
1000000US060552005032037,060552005032037,"Block 2037, Block Group 2, Census Tract 2005.03, Napa County, California",0,0,0
1000000US060552005032038,060552005032038,"Block 2038, Block Group 2, Census Tract 2005.03, Napa County, California",3,3,0
1000000US060552005032039,060552005032039,"Block 2039, Block Group 2, Census Tract 2005.03, Napa County, California",40,36,4
1000000US060552005032040,060552005032040,"Block 2040, Block Group 2, Census Tract 2005.03, Napa County, California",8,8,0
1000000US060552005032041,060552005032041,"Block 2041, Block Group 2, Census Tract 2005.03, Napa County, California",1,1,0
1000000US060552005032042,060552005032042,"Block 2042, Block Group 2, Census Tract 2005.03, Napa County, California",0,0,0
1000000US060552005032043,060552005032043,"Block 2043, Block Group 2, Census Tract 2005.03, Napa County, California",0,0,0
1000000US060552005041000,060552005041000,"Block 1000, Block Group 1, Census Tract 2005.04, Napa County, California",354,339,15
1000000US060552005041001,060552005041001,"Block 1001, Block Group 1, Census Tract 2005.04, Napa County, California",16,14,2
1000000US060552005041002,060552005041002,"Block 1002, Block Group 1, Census Tract 2005.04, Napa County, California",14,14,0
1000000US060552005041003,060552005041003,"Block 1003, Block Group 1, Census Tract 2005.04, Napa County, California",4,4,0
1000000US060552005041004,060552005041004,"Block 1004, Block Group 1, Census Tract 2005.04, Napa County, California",29,29,0
1000000US060552005041005,060552005041005,"Block 1005, Block Group 1, Census Tract 2005.04, Napa County, California",19,17,2
1000000US060552005041006,060552005041006,"Block 1006, Block Group 1, Census Tract 2005.04, Napa County, California",27,25,2
1000000US060552005041007,060552005041007,"Block 1007, Block Group 1, Census Tract 2005.04, Napa County, California",74,68,6
1000000US060552005041008,060552005041008,"Block 1008, Block Group 1, Census Tract 2005.04, Napa County, California",102,90,12
1000000US060552005041009,060552005041009,"Block 1009, Block Group 1, Census Tract 2005.04, Napa County, California",7,7,0
1000000US060552005041010,060552005041010,"Block 1010, Block Group 1, Census Tract 2005.04, Napa County, California",7,6,1
1000000US060552005041011,060552005041011,"Block 1011, Block Group 1, Census Tract 2005.04, Napa County, California",30,30,0
1000000US060552005041012,060552005041012,"Block 1012, Block Group 1, Census Tract 2005.04, Napa County, California",12,11,1
1000000US060552005042000,060552005042000,"Block 2000, Block Group 2, Census Tract 2005.04, Napa County, California",111,99,12
1000000US060552005042001,060552005042001,"Block 2001, Block Group 2, Census Tract 2005.04, Napa County, California",0,0,0
1000000US060552005042002,060552005042002,"Block 2002, Block Group 2, Census Tract 2005.04, Napa County, California",302,280,22
1000000US060552005042003,060552005042003,"Block 2003, Block Group 2, Census Tract 2005.04, Napa County, California",125,98,27
1000000US060552005042004,060552005042004,"Block 2004, Block Group 2, Census Tract 2005.04, Napa County, California",61,57,4
1000000US060552005042005,060552005042005,"Block 2005, Block Group 2, Census Tract 2005.04, Napa County, California",204,187,17
1000000US060552005042006,060552005042006,"Block 2006, Block Group 2, Census Tract 2005.04, Napa County, California",45,43,2
1000000US060552005042007,060552005042007,"Block 2007, Block Group 2, Census Tract 2005.04, Napa County, California",21,19,2
1000000US060552005042008,060552005042008,"Block 2008, Block Group 2, Census Tract 2005.04, Napa County, California",38,36,2
1000000US060552005042009,060552005042009,"Block 2009, Block Group 2, Census Tract 2005.04, Napa County, California",152,134,18
1000000US060552005042010,060552005042010,"Block 2010, Block Group 2, Census Tract 2005.04, Napa County, California",6,6,0
1000000US060552005042011,060552005042011,"Block 2011, Block Group 2, Census Tract 2005.04, Napa County, California",20,19,1
1000000US060552005042012,060552005042012,"Block 2012, Block Group 2, Census Tract 2005.04, Napa County, California",59,58,1
1000000US060552005042013,060552005042013,"Block 2013, Block Group 2, Census Tract 2005.04, Napa County, California",1,1,0
1000000US060552005042014,060552005042014,"Block 2014, Block Group 2, Census Tract 2005.04, Napa County, California",39,37,2
1000000US060552005042015,060552005042015,"Block 2015, Block Group 2, Census Tract 2005.04, Napa County, California",91,87,4
1000000US060552005042016,060552005042016,"Block 2016, Block Group 2, Census Tract 2005.04, Napa County, California",7,6,1
1000000US060552005042017,060552005042017,"Block 2017, Block Group 2, Census Tract 2005.04, Napa County, California",20,19,1
1000000US060552005042018,060552005042018,"Block 2018, Block Group 2, Census Tract 2005.04, Napa County, California",22,20,2
1000000US060552005042019,060552005042019,"Block 2019, Block Group 2, Census Tract 2005.04, Napa County, California",22,21,1
1000000US060552005043000,060552005043000,"Block 3000, Block Group 3, Census Tract 2005.04, Napa County, California",20,18,2
1000000US060552005043001,060552005043001,"Block 3001, Block Group 3, Census Tract 2005.04, Napa County, California",41,38,3
1000000US060552005043002,060552005043002,"Block 3002, Block Group 3, Census Tract 2005.04, Napa County, California",112,110,2
1000000US060552005043003,060552005043003,"Block 3003, Block Group 3, Census Tract 2005.04, Napa County, California",8,8,0
1000000US060552005043004,060552005043004,"Block 3004, Block Group 3, Census Tract 2005.04, Napa County, California",49,46,3
1000000US060552005043005,060552005043005,"Block 3005, Block Group 3, Census Tract 2005.04, Napa County, California",45,41,4
1000000US060552005043006,060552005043006,"Block 3006, Block Group 3, Census Tract 2005.04, Napa County, California",30,28,2
1000000US060552005043007,060552005043007,"Block 3007, Block Group 3, Census Tract 2005.04, Napa County, California",20,20,0
1000000US060552005043008,060552005043008,"Block 3008, Block Group 3, Census Tract 2005.04, Napa County, California",35,26,9
1000000US060552005043009,060552005043009,"Block 3009, Block Group 3, Census Tract 2005.04, Napa County, California",34,33,1
1000000US060552005043010,060552005043010,"Block 3010, Block Group 3, Census Tract 2005.04, Napa County, California",12,12,0
1000000US060552005051000,060552005051000,"Block 1000, Block Group 1, Census Tract 2005.05, Napa County, California",318,255,63
1000000US060552005051001,060552005051001,"Block 1001, Block Group 1, Census Tract 2005.05, Napa County, California",0,0,0
1000000US060552005051002,060552005051002,"Block 1002, Block Group 1, Census Tract 2005.05, Napa County, California",6,6,0
1000000US060552005051003,060552005051003,"Block 1003, Block Group 1, Census Tract 2005.05, Napa County, California",12,10,2
1000000US060552005051004,060552005051004,"Block 1004, Block Group 1, Census Tract 2005.05, Napa County, California",178,168,10
1000000US060552005051005,060552005051005,"Block 1005, Block Group 1, Census Tract 2005.05, Napa County, California",101,95,6
1000000US060552005052000,060552005052000,"Block 2000, Block Group 2, Census Tract 2005.05, Napa County, California",263,204,59
1000000US060552005052001,060552005052001,"Block 2001, Block Group 2, Census Tract 2005.05, Napa County, California",0,0,0
1000000US060552005052002,060552005052002,"Block 2002, Block Group 2, Census Tract 2005.05, Napa County, California",0,0,0
1000000US060552005052003,060552005052003,"Block 2003, Block Group 2, Census Tract 2005.05, Napa County, California",35,34,1
1000000US060552005052004,060552005052004,"Block 2004, Block Group 2, Census Tract 2005.05, Napa County, California",9,9,0
1000000US060552005052005,060552005052005,"Block 2005, Block Group 2, Census Tract 2005.05, Napa County, California",30,29,1
1000000US060552005052006,060552005052006,"Block 2006, Block Group 2, Census Tract 2005.05, Napa County, California",0,0,0
1000000US060552005052007,060552005052007,"Block 2007, Block Group 2, Census Tract 2005.05, Napa County, California",0,0,0
1000000US060552005052008,060552005052008,"Block 2008, Block Group 2, Census Tract 2005.05, Napa County, California",27,26,1
1000000US060552005052009,060552005052009,"Block 2009, Block Group 2, Census Tract 2005.05, Napa County, California",0,0,0
1000000US060552005052010,060552005052010,"Block 2010, Block Group 2, Census Tract 2005.05, Napa County, California",21,20,1
1000000US060552005052011,060552005052011,"Block 2011, Block Group 2, Census Tract 2005.05, Napa County, California",43,42,1
1000000US060552005052012,060552005052012,"Block 2012, Block Group 2, Census Tract 2005.05, Napa County, California",21,20,1
1000000US060552005052013,060552005052013,"Block 2013, Block Group 2, Census Tract 2005.05, Napa County, California",21,21,0
1000000US060552006011000,060552006011000,"Block 1000, Block Group 1, Census Tract 2006.01, Napa County, California",39,38,1
1000000US060552006011001,060552006011001,"Block 1001, Block Group 1, Census Tract 2006.01, Napa County, California",52,50,2
1000000US060552006011002,060552006011002,"Block 1002, Block Group 1, Census Tract 2006.01, Napa County, California",27,26,1
1000000US060552006011003,060552006011003,"Block 1003, Block Group 1, Census Tract 2006.01, Napa County, California",24,24,0
1000000US060552006011004,060552006011004,"Block 1004, Block Group 1, Census Tract 2006.01, Napa County, California",53,52,1
1000000US060552006011005,060552006011005,"Block 1005, Block Group 1, Census Tract 2006.01, Napa County, California",6,5,1
1000000US060552006011006,060552006011006,"Block 1006, Block Group 1, Census Tract 2006.01, Napa County, California",0,0,0
1000000US060552006011007,060552006011007,"Block 1007, Block Group 1, Census Tract 2006.01, Napa County, California",2,2,0
1000000US060552006011008,060552006011008,"Block 1008, Block Group 1, Census Tract 2006.01, Napa County, California",0,0,0
1000000US060552006011009,060552006011009,"Block 1009, Block Group 1, Census Tract 2006.01, Napa County, California",114,111,3
1000000US060552006011010,060552006011010,"Block 1010, Block Group 1, Census Tract 2006.01, Napa County, California",26,25,1
1000000US060552006011011,060552006011011,"Block 1011, Block Group 1, Census Tract 2006.01, Napa County, California",0,0,0
1000000US060552006011012,060552006011012,"Block 1012, Block Group 1, Census Tract 2006.01, Napa County, California",147,145,2
1000000US060552006011013,060552006011013,"Block 1013, Block Group 1, Census Tract 2006.01, Napa County, California",20,20,0
1000000US060552006011014,060552006011014,"Block 1014, Block Group 1, Census Tract 2006.01, Napa County, California",36,35,1
1000000US060552006011015,060552006011015,"Block 1015, Block Group 1, Census Tract 2006.01, Napa County, California",0,0,0
1000000US060552006012000,060552006012000,"Block 2000, Block Group 2, Census Tract 2006.01, Napa County, California",39,36,3
1000000US060552006012001,060552006012001,"Block 2001, Block Group 2, Census Tract 2006.01, Napa County, California",29,25,4
1000000US060552006012002,060552006012002,"Block 2002, Block Group 2, Census Tract 2006.01, Napa County, California",26,26,0
1000000US060552006012003,060552006012003,"Block 2003, Block Group 2, Census Tract 2006.01, Napa County, California",23,23,0
1000000US060552006012004,060552006012004,"Block 2004, Block Group 2, Census Tract 2006.01, Napa County, California",35,33,2
1000000US060552006012005,060552006012005,"Block 2005, Block Group 2, Census Tract 2006.01, Napa County, California",16,15,1
1000000US060552006012006,060552006012006,"Block 2006, Block Group 2, Census Tract 2006.01, Napa County, California",29,29,0
1000000US060552006012007,060552006012007,"Block 2007, Block Group 2, Census Tract 2006.01, Napa County, California",32,31,1
1000000US060552006012008,060552006012008,"Block 2008, Block Group 2, Census Tract 2006.01, Napa County, California",19,19,0
1000000US060552006012009,060552006012009,"Block 2009, Block Group 2, Census Tract 2006.01, Napa County, California",32,31,1
1000000US060552006012010,060552006012010,"Block 2010, Block Group 2, Census Tract 2006.01, Napa County, California",18,17,1
1000000US060552006012011,060552006012011,"Block 2011, Block Group 2, Census Tract 2006.01, Napa County, California",22,22,0
1000000US060552006012012,060552006012012,"Block 2012, Block Group 2, Census Tract 2006.01, Napa County, California",0,0,0
1000000US060552006012013,060552006012013,"Block 2013, Block Group 2, Census Tract 2006.01, Napa County, California",31,30,1
1000000US060552006012014,060552006012014,"Block 2014, Block Group 2, Census Tract 2006.01, Napa County, California",10,10,0
1000000US060552006012015,060552006012015,"Block 2015, Block Group 2, Census Tract 2006.01, Napa County, California",6,6,0
1000000US060552006013000,060552006013000,"Block 3000, Block Group 3, Census Tract 2006.01, Napa County, California",38,35,3
1000000US060552006013001,060552006013001,"Block 3001, Block Group 3, Census Tract 2006.01, Napa County, California",32,30,2
1000000US060552006013002,060552006013002,"Block 3002, Block Group 3, Census Tract 2006.01, Napa County, California",42,41,1
1000000US060552006013003,060552006013003,"Block 3003, Block Group 3, Census Tract 2006.01, Napa County, California",29,28,1
1000000US060552006013004,060552006013004,"Block 3004, Block Group 3, Census Tract 2006.01, Napa County, California",23,21,2
1000000US060552006013005,060552006013005,"Block 3005, Block Group 3, Census Tract 2006.01, Napa County, California",7,6,1
1000000US060552006013006,060552006013006,"Block 3006, Block Group 3, Census Tract 2006.01, Napa County, California",0,0,0
1000000US060552006013007,060552006013007,"Block 3007, Block Group 3, Census Tract 2006.01, Napa County, California",36,34,2
1000000US060552006013008,060552006013008,"Block 3008, Block Group 3, Census Tract 2006.01, Napa County, California",16,16,0
1000000US060552006013009,060552006013009,"Block 3009, Block Group 3, Census Tract 2006.01, Napa County, California",48,45,3
1000000US060552006013010,060552006013010,"Block 3010, Block Group 3, Census Tract 2006.01, Napa County, California",15,14,1
1000000US060552006013011,060552006013011,"Block 3011, Block Group 3, Census Tract 2006.01, Napa County, California",26,25,1
1000000US060552006013012,060552006013012,"Block 3012, Block Group 3, Census Tract 2006.01, Napa County, California",11,11,0
1000000US060552006013013,060552006013013,"Block 3013, Block Group 3, Census Tract 2006.01, Napa County, California",30,30,0
1000000US060552006013014,060552006013014,"Block 3014, Block Group 3, Census Tract 2006.01, Napa County, California",34,31,3
1000000US060552006013015,060552006013015,"Block 3015, Block Group 3, Census Tract 2006.01, Napa County, California",16,16,0
1000000US060552006013016,060552006013016,"Block 3016, Block Group 3, Census Tract 2006.01, Napa County, California",21,20,1
1000000US060552006013017,060552006013017,"Block 3017, Block Group 3, Census Tract 2006.01, Napa County, California",34,33,1
1000000US060552006013018,060552006013018,"Block 3018, Block Group 3, Census Tract 2006.01, Napa County, California",12,12,0
1000000US060552006013019,060552006013019,"Block 3019, Block Group 3, Census Tract 2006.01, Napa County, California",0,0,0
1000000US060552006014000,060552006014000,"Block 4000, Block Group 4, Census Tract 2006.01, Napa County, California",25,23,2
1000000US060552006014001,060552006014001,"Block 4001, Block Group 4, Census Tract 2006.01, Napa County, California",10,10,0
1000000US060552006014002,060552006014002,"Block 4002, Block Group 4, Census Tract 2006.01, Napa County, California",28,28,0
1000000US060552006014003,060552006014003,"Block 4003, Block Group 4, Census Tract 2006.01, Napa County, California",8,8,0
1000000US060552006014004,060552006014004,"Block 4004, Block Group 4, Census Tract 2006.01, Napa County, California",29,28,1
1000000US060552006014005,060552006014005,"Block 4005, Block Group 4, Census Tract 2006.01, Napa County, California",0,0,0
1000000US060552006014006,060552006014006,"Block 4006, Block Group 4, Census Tract 2006.01, Napa County, California",0,0,0
1000000US060552006014007,060552006014007,"Block 4007, Block Group 4, Census Tract 2006.01, Napa County, California",0,0,0
1000000US060552006014008,060552006014008,"Block 4008, Block Group 4, Census Tract 2006.01, Napa County, California",0,0,0
1000000US060552006014009,060552006014009,"Block 4009, Block Group 4, Census Tract 2006.01, Napa County, California",15,15,0
1000000US060552006014010,060552006014010,"Block 4010, Block Group 4, Census Tract 2006.01, Napa County, California",70,70,0
1000000US060552006014011,060552006014011,"Block 4011, Block Group 4, Census Tract 2006.01, Napa County, California",68,66,2
1000000US060552006014012,060552006014012,"Block 4012, Block Group 4, Census Tract 2006.01, Napa County, California",1,1,0
1000000US060552006014013,060552006014013,"Block 4013, Block Group 4, Census Tract 2006.01, Napa County, California",32,32,0
1000000US060552006014014,060552006014014,"Block 4014, Block Group 4, Census Tract 2006.01, Napa County, California",33,32,1
1000000US060552006014015,060552006014015,"Block 4015, Block Group 4, Census Tract 2006.01, Napa County, California",0,0,0
1000000US060552006021000,060552006021000,"Block 1000, Block Group 1, Census Tract 2006.02, Napa County, California",262,249,13
1000000US060552006021001,060552006021001,"Block 1001, Block Group 1, Census Tract 2006.02, Napa County, California",44,39,5
1000000US060552006021002,060552006021002,"Block 1002, Block Group 1, Census Tract 2006.02, Napa County, California",16,15,1
1000000US060552006021003,060552006021003,"Block 1003, Block Group 1, Census Tract 2006.02, Napa County, California",28,27,1
1000000US060552006021004,060552006021004,"Block 1004, Block Group 1, Census Tract 2006.02, Napa County, California",10,10,0
1000000US060552006021005,060552006021005,"Block 1005, Block Group 1, Census Tract 2006.02, Napa County, California",42,40,2
1000000US060552006021006,060552006021006,"Block 1006, Block Group 1, Census Tract 2006.02, Napa County, California",88,80,8
1000000US060552006021007,060552006021007,"Block 1007, Block Group 1, Census Tract 2006.02, Napa County, California",9,9,0
1000000US060552006021008,060552006021008,"Block 1008, Block Group 1, Census Tract 2006.02, Napa County, California",38,35,3
1000000US060552006021009,060552006021009,"Block 1009, Block Group 1, Census Tract 2006.02, Napa County, California",0,0,0
1000000US060552006021010,060552006021010,"Block 1010, Block Group 1, Census Tract 2006.02, Napa County, California",25,25,0
1000000US060552006021011,060552006021011,"Block 1011, Block Group 1, Census Tract 2006.02, Napa County, California",35,34,1
1000000US060552006021012,060552006021012,"Block 1012, Block Group 1, Census Tract 2006.02, Napa County, California",22,22,0
1000000US060552006021013,060552006021013,"Block 1013, Block Group 1, Census Tract 2006.02, Napa County, California",8,8,0
1000000US060552006021014,060552006021014,"Block 1014, Block Group 1, Census Tract 2006.02, Napa County, California",18,18,0
1000000US060552006021015,060552006021015,"Block 1015, Block Group 1, Census Tract 2006.02, Napa County, California",60,57,3
1000000US060552006021016,060552006021016,"Block 1016, Block Group 1, Census Tract 2006.02, Napa County, California",21,19,2
1000000US060552006021017,060552006021017,"Block 1017, Block Group 1, Census Tract 2006.02, Napa County, California",16,15,1
1000000US060552006021018,060552006021018,"Block 1018, Block Group 1, Census Tract 2006.02, Napa County, California",0,0,0
1000000US060552006021019,060552006021019,"Block 1019, Block Group 1, Census Tract 2006.02, Napa County, California",12,12,0
1000000US060552006021020,060552006021020,"Block 1020, Block Group 1, Census Tract 2006.02, Napa County, California",158,116,42
1000000US060552006021021,060552006021021,"Block 1021, Block Group 1, Census Tract 2006.02, Napa County, California",167,157,10
1000000US060552006021022,060552006021022,"Block 1022, Block Group 1, Census Tract 2006.02, Napa County, California",21,21,0
1000000US060552006021023,060552006021023,"Block 1023, Block Group 1, Census Tract 2006.02, Napa County, California",47,43,4
1000000US060552006022000,060552006022000,"Block 2000, Block Group 2, Census Tract 2006.02, Napa County, California",5,4,1
1000000US060552006022001,060552006022001,"Block 2001, Block Group 2, Census Tract 2006.02, Napa County, California",70,67,3
1000000US060552006022002,060552006022002,"Block 2002, Block Group 2, Census Tract 2006.02, Napa County, California",10,9,1
1000000US060552006022003,060552006022003,"Block 2003, Block Group 2, Census Tract 2006.02, Napa County, California",21,21,0
1000000US060552006022004,060552006022004,"Block 2004, Block Group 2, Census Tract 2006.02, Napa County, California",33,29,4
1000000US060552006022005,060552006022005,"Block 2005, Block Group 2, Census Tract 2006.02, Napa County, California",18,18,0
1000000US060552006022006,060552006022006,"Block 2006, Block Group 2, Census Tract 2006.02, Napa County, California",26,25,1
1000000US060552006022007,060552006022007,"Block 2007, Block Group 2, Census Tract 2006.02, Napa County, California",35,33,2
1000000US060552006022008,060552006022008,"Block 2008, Block Group 2, Census Tract 2006.02, Napa County, California",53,53,0
1000000US060552006022009,060552006022009,"Block 2009, Block Group 2, Census Tract 2006.02, Napa County, California",29,29,0
1000000US060552006022010,060552006022010,"Block 2010, Block Group 2, Census Tract 2006.02, Napa County, California",22,22,0
1000000US060552006022011,060552006022011,"Block 2011, Block Group 2, Census Tract 2006.02, Napa County, California",24,24,0
1000000US060552006023000,060552006023000,"Block 3000, Block Group 3, Census Tract 2006.02, Napa County, California",33,33,0
1000000US060552006023001,060552006023001,"Block 3001, Block Group 3, Census Tract 2006.02, Napa County, California",42,40,2
1000000US060552006023002,060552006023002,"Block 3002, Block Group 3, Census Tract 2006.02, Napa County, California",17,15,2
1000000US060552006023003,060552006023003,"Block 3003, Block Group 3, Census Tract 2006.02, Napa County, California",3,3,0
1000000US060552006023004,060552006023004,"Block 3004, Block Group 3, Census Tract 2006.02, Napa County, California",2,2,0
1000000US060552006023005,060552006023005,"Block 3005, Block Group 3, Census Tract 2006.02, Napa County, California",12,12,0
1000000US060552006023006,060552006023006,"Block 3006, Block Group 3, Census Tract 2006.02, Napa County, California",110,86,24
1000000US060552006023007,060552006023007,"Block 3007, Block Group 3, Census Tract 2006.02, Napa County, California",40,28,12
1000000US060552006023008,060552006023008,"Block 3008, Block Group 3, Census Tract 2006.02, Napa County, California",7,6,1
1000000US060552006023009,060552006023009,"Block 3009, Block Group 3, Census Tract 2006.02, Napa County, California",62,54,8
1000000US060552006023010,060552006023010,"Block 3010, Block Group 3, Census Tract 2006.02, Napa County, California",18,18,0
1000000US060552006023011,060552006023011,"Block 3011, Block Group 3, Census Tract 2006.02, Napa County, California",30,27,3
1000000US060552006023012,060552006023012,"Block 3012, Block Group 3, Census Tract 2006.02, Napa County, California",43,42,1
1000000US060552006023013,060552006023013,"Block 3013, Block Group 3, Census Tract 2006.02, Napa County, California",44,40,4
1000000US060552007031000,060552007031000,"Block 1000, Block Group 1, Census Tract 2007.03, Napa County, California",29,29,0
1000000US060552007031001,060552007031001,"Block 1001, Block Group 1, Census Tract 2007.03, Napa County, California",197,194,3
1000000US060552007031002,060552007031002,"Block 1002, Block Group 1, Census Tract 2007.03, Napa County, California",47,46,1
1000000US060552007031003,060552007031003,"Block 1003, Block Group 1, Census Tract 2007.03, Napa County, California",11,9,2
1000000US060552007031004,060552007031004,"Block 1004, Block Group 1, Census Tract 2007.03, Napa County, California",5,5,0
1000000US060552007031005,060552007031005,"Block 1005, Block Group 1, Census Tract 2007.03, Napa County, California",32,31,1
1000000US060552007031006,060552007031006,"Block 1006, Block Group 1, Census Tract 2007.03, Napa County, California",91,88,3
1000000US060552007031007,060552007031007,"Block 1007, Block Group 1, Census Tract 2007.03, Napa County, California",11,11,0
1000000US060552007031008,060552007031008,"Block 1008, Block Group 1, Census Tract 2007.03, Napa County, California",32,29,3
1000000US060552007031009,060552007031009,"Block 1009, Block Group 1, Census Tract 2007.03, Napa County, California",15,14,1
1000000US060552007031010,060552007031010,"Block 1010, Block Group 1, Census Tract 2007.03, Napa County, California",1,1,0
1000000US060552007031011,060552007031011,"Block 1011, Block Group 1, Census Tract 2007.03, Napa County, California",1,1,0
1000000US060552007031012,060552007031012,"Block 1012, Block Group 1, Census Tract 2007.03, Napa County, California",48,47,1
1000000US060552007031013,060552007031013,"Block 1013, Block Group 1, Census Tract 2007.03, Napa County, California",19,19,0
1000000US060552007031014,060552007031014,"Block 1014, Block Group 1, Census Tract 2007.03, Napa County, California",0,0,0
1000000US060552007031015,060552007031015,"Block 1015, Block Group 1, Census Tract 2007.03, Napa County, California",31,29,2
1000000US060552007031016,060552007031016,"Block 1016, Block Group 1, Census Tract 2007.03, Napa County, California",23,21,2
1000000US060552007031017,060552007031017,"Block 1017, Block Group 1, Census Tract 2007.03, Napa County, California",60,59,1
1000000US060552007031018,060552007031018,"Block 1018, Block Group 1, Census Tract 2007.03, Napa County, California",9,9,0
1000000US060552007031019,060552007031019,"Block 1019, Block Group 1, Census Tract 2007.03, Napa County, California",13,13,0
1000000US060552007031020,060552007031020,"Block 1020, Block Group 1, Census Tract 2007.03, Napa County, California",10,9,1
1000000US060552007031021,060552007031021,"Block 1021, Block Group 1, Census Tract 2007.03, Napa County, California",87,86,1
1000000US060552007031022,060552007031022,"Block 1022, Block Group 1, Census Tract 2007.03, Napa County, California",9,8,1
1000000US060552007031023,060552007031023,"Block 1023, Block Group 1, Census Tract 2007.03, Napa County, California",19,19,0
1000000US060552007031024,060552007031024,"Block 1024, Block Group 1, Census Tract 2007.03, Napa County, California",15,15,0
1000000US060552007031025,060552007031025,"Block 1025, Block Group 1, Census Tract 2007.03, Napa County, California",14,14,0
1000000US060552007032000,060552007032000,"Block 2000, Block Group 2, Census Tract 2007.03, Napa County, California",16,16,0
1000000US060552007032001,060552007032001,"Block 2001, Block Group 2, Census Tract 2007.03, Napa County, California",24,23,1
1000000US060552007032002,060552007032002,"Block 2002, Block Group 2, Census Tract 2007.03, Napa County, California",31,30,1
1000000US060552007032003,060552007032003,"Block 2003, Block Group 2, Census Tract 2007.03, Napa County, California",141,133,8
1000000US060552007032004,060552007032004,"Block 2004, Block Group 2, Census Tract 2007.03, Napa County, California",12,10,2
1000000US060552007032005,060552007032005,"Block 2005, Block Group 2, Census Tract 2007.03, Napa County, California",19,19,0
1000000US060552007032006,060552007032006,"Block 2006, Block Group 2, Census Tract 2007.03, Napa County, California",10,10,0
1000000US060552007032007,060552007032007,"Block 2007, Block Group 2, Census Tract 2007.03, Napa County, California",38,34,4
1000000US060552007032008,060552007032008,"Block 2008, Block Group 2, Census Tract 2007.03, Napa County, California",9,9,0
1000000US060552007032009,060552007032009,"Block 2009, Block Group 2, Census Tract 2007.03, Napa County, California",7,6,1
1000000US060552007032010,060552007032010,"Block 2010, Block Group 2, Census Tract 2007.03, Napa County, California",2,2,0
1000000US060552007032011,060552007032011,"Block 2011, Block Group 2, Census Tract 2007.03, Napa County, California",4,4,0
1000000US060552007032012,060552007032012,"Block 2012, Block Group 2, Census Tract 2007.03, Napa County, California",8,8,0
1000000US060552007032013,060552007032013,"Block 2013, Block Group 2, Census Tract 2007.03, Napa County, California",25,23,2
1000000US060552007032014,060552007032014,"Block 2014, Block Group 2, Census Tract 2007.03, Napa County, California",22,22,0
1000000US060552007041000,060552007041000,"Block 1000, Block Group 1, Census Tract 2007.04, Napa County, California",77,76,1
1000000US060552007041001,060552007041001,"Block 1001, Block Group 1, Census Tract 2007.04, Napa County, California",17,16,1
1000000US060552007041002,060552007041002,"Block 1002, Block Group 1, Census Tract 2007.04, Napa County, California",44,44,0
1000000US060552007041003,060552007041003,"Block 1003, Block Group 1, Census Tract 2007.04, Napa County, California",73,72,1
1000000US060552007041004,060552007041004,"Block 1004, Block Group 1, Census Tract 2007.04, Napa County, California",45,44,1
1000000US060552007041005,060552007041005,"Block 1005, Block Group 1, Census Tract 2007.04, Napa County, California",14,14,0
1000000US060552007041006,060552007041006,"Block 1006, Block Group 1, Census Tract 2007.04, Napa County, California",14,13,1
1000000US060552007041007,060552007041007,"Block 1007, Block Group 1, Census Tract 2007.04, Napa County, California",36,36,0
1000000US060552007041008,060552007041008,"Block 1008, Block Group 1, Census Tract 2007.04, Napa County, California",128,106,22
1000000US060552007041009,060552007041009,"Block 1009, Block Group 1, Census Tract 2007.04, Napa County, California",93,84,9
1000000US060552007041010,060552007041010,"Block 1010, Block Group 1, Census Tract 2007.04, Napa County, California",157,146,11
1000000US060552007041011,060552007041011,"Block 1011, Block Group 1, Census Tract 2007.04, Napa County, California",54,53,1
1000000US060552007041012,060552007041012,"Block 1012, Block Group 1, Census Tract 2007.04, Napa County, California",16,16,0
1000000US060552007041013,060552007041013,"Block 1013, Block Group 1, Census Tract 2007.04, Napa County, California",31,29,2
1000000US060552007041014,060552007041014,"Block 1014, Block Group 1, Census Tract 2007.04, Napa County, California",10,10,0
1000000US060552007041015,060552007041015,"Block 1015, Block Group 1, Census Tract 2007.04, Napa County, California",5,5,0
1000000US060552007041016,060552007041016,"Block 1016, Block Group 1, Census Tract 2007.04, Napa County, California",8,8,0
1000000US060552007041017,060552007041017,"Block 1017, Block Group 1, Census Tract 2007.04, Napa County, California",3,3,0
1000000US060552007042000,060552007042000,"Block 2000, Block Group 2, Census Tract 2007.04, Napa County, California",14,14,0
1000000US060552007042001,060552007042001,"Block 2001, Block Group 2, Census Tract 2007.04, Napa County, California",40,40,0
1000000US060552007042002,060552007042002,"Block 2002, Block Group 2, Census Tract 2007.04, Napa County, California",10,9,1
1000000US060552007042003,060552007042003,"Block 2003, Block Group 2, Census Tract 2007.04, Napa County, California",10,10,0
1000000US060552007042004,060552007042004,"Block 2004, Block Group 2, Census Tract 2007.04, Napa County, California",42,40,2
1000000US060552007042005,060552007042005,"Block 2005, Block Group 2, Census Tract 2007.04, Napa County, California",24,24,0
1000000US060552007042006,060552007042006,"Block 2006, Block Group 2, Census Tract 2007.04, Napa County, California",28,24,4
1000000US060552007042007,060552007042007,"Block 2007, Block Group 2, Census Tract 2007.04, Napa County, California",6,6,0
1000000US060552007042008,060552007042008,"Block 2008, Block Group 2, Census Tract 2007.04, Napa County, California",25,24,1
1000000US060552007042009,060552007042009,"Block 2009, Block Group 2, Census Tract 2007.04, Napa County, California",37,35,2
1000000US060552007042010,060552007042010,"Block 2010, Block Group 2, Census Tract 2007.04, Napa County, California",12,10,2
1000000US060552007042011,060552007042011,"Block 2011, Block Group 2, Census Tract 2007.04, Napa County, California",20,20,0
1000000US060552007042012,060552007042012,"Block 2012, Block Group 2, Census Tract 2007.04, Napa County, California",7,6,1
1000000US060552007042013,060552007042013,"Block 2013, Block Group 2, Census Tract 2007.04, Napa County, California",7,7,0
1000000US060552007042014,060552007042014,"Block 2014, Block Group 2, Census Tract 2007.04, Napa County, California",0,0,0
1000000US060552007042015,060552007042015,"Block 2015, Block Group 2, Census Tract 2007.04, Napa County, California",21,20,1
1000000US060552007042016,060552007042016,"Block 2016, Block Group 2, Census Tract 2007.04, Napa County, California",6,6,0
1000000US060552007042017,060552007042017,"Block 2017, Block Group 2, Census Tract 2007.04, Napa County, California",14,14,0
1000000US060552007042018,060552007042018,"Block 2018, Block Group 2, Census Tract 2007.04, Napa County, California",3,2,1
1000000US060552007042019,060552007042019,"Block 2019, Block Group 2, Census Tract 2007.04, Napa County, California",11,11,0
1000000US060552007042020,060552007042020,"Block 2020, Block Group 2, Census Tract 2007.04, Napa County, California",4,4,0
1000000US060552007042021,060552007042021,"Block 2021, Block Group 2, Census Tract 2007.04, Napa County, California",80,74,6
1000000US060552007042022,060552007042022,"Block 2022, Block Group 2, Census Tract 2007.04, Napa County, California",4,3,1
1000000US060552007042023,060552007042023,"Block 2023, Block Group 2, Census Tract 2007.04, Napa County, California",5,5,0
1000000US060552007042024,060552007042024,"Block 2024, Block Group 2, Census Tract 2007.04, Napa County, California",36,34,2
1000000US060552007042025,060552007042025,"Block 2025, Block Group 2, Census Tract 2007.04, Napa County, California",0,0,0
1000000US060552007042026,060552007042026,"Block 2026, Block Group 2, Census Tract 2007.04, Napa County, California",8,8,0
1000000US060552007042027,060552007042027,"Block 2027, Block Group 2, Census Tract 2007.04, Napa County, California",0,0,0
1000000US060552007042028,060552007042028,"Block 2028, Block Group 2, Census Tract 2007.04, Napa County, California",2,2,0
1000000US060552007042029,060552007042029,"Block 2029, Block Group 2, Census Tract 2007.04, Napa County, California",12,12,0
1000000US060552007043000,060552007043000,"Block 3000, Block Group 3, Census Tract 2007.04, Napa County, California",0,0,0
1000000US060552007043001,060552007043001,"Block 3001, Block Group 3, Census Tract 2007.04, Napa County, California",2,2,0
1000000US060552007043002,060552007043002,"Block 3002, Block Group 3, Census Tract 2007.04, Napa County, California",17,17,0
1000000US060552007043003,060552007043003,"Block 3003, Block Group 3, Census Tract 2007.04, Napa County, California",12,12,0
1000000US060552007043004,060552007043004,"Block 3004, Block Group 3, Census Tract 2007.04, Napa County, California",19,19,0
1000000US060552007043005,060552007043005,"Block 3005, Block Group 3, Census Tract 2007.04, Napa County, California",40,38,2
1000000US060552007043006,060552007043006,"Block 3006, Block Group 3, Census Tract 2007.04, Napa County, California",15,15,0
1000000US060552007043007,060552007043007,"Block 3007, Block Group 3, Census Tract 2007.04, Napa County, California",66,66,0
1000000US060552007043008,060552007043008,"Block 3008, Block Group 3, Census Tract 2007.04, Napa County, California",0,0,0
1000000US060552007043009,060552007043009,"Block 3009, Block Group 3, Census Tract 2007.04, Napa County, California",22,22,0
1000000US060552007043010,060552007043010,"Block 3010, Block Group 3, Census Tract 2007.04, Napa County, California",11,10,1
1000000US060552007043011,060552007043011,"Block 3011, Block Group 3, Census Tract 2007.04, Napa County, California",17,17,0
1000000US060552007043012,060552007043012,"Block 3012, Block Group 3, Census Tract 2007.04, Napa County, California",14,13,1
1000000US060552007043013,060552007043013,"Block 3013, Block Group 3, Census Tract 2007.04, Napa County, California",76,73,3
1000000US060552007043014,060552007043014,"Block 3014, Block Group 3, Census Tract 2007.04, Napa County, California",3,2,1
1000000US060552007043015,060552007043015,"Block 3015, Block Group 3, Census Tract 2007.04, Napa County, California",15,15,0
1000000US060552007043016,060552007043016,"Block 3016, Block Group 3, Census Tract 2007.04, Napa County, California",19,19,0
1000000US060552007043017,060552007043017,"Block 3017, Block Group 3, Census Tract 2007.04, Napa County, California",39,37,2
1000000US060552007043018,060552007043018,"Block 3018, Block Group 3, Census Tract 2007.04, Napa County, California",3,3,0
1000000US060552007051000,060552007051000,"Block 1000, Block Group 1, Census Tract 2007.05, Napa County, California",0,0,0
1000000US060552007051001,060552007051001,"Block 1001, Block Group 1, Census Tract 2007.05, Napa County, California",53,51,2
1000000US060552007051002,060552007051002,"Block 1002, Block Group 1, Census Tract 2007.05, Napa County, California",0,0,0
1000000US060552007051003,060552007051003,"Block 1003, Block Group 1, Census Tract 2007.05, Napa County, California",0,0,0
1000000US060552007051004,060552007051004,"Block 1004, Block Group 1, Census Tract 2007.05, Napa County, California",24,21,3
1000000US060552007051005,060552007051005,"Block 1005, Block Group 1, Census Tract 2007.05, Napa County, California",88,84,4
1000000US060552007051006,060552007051006,"Block 1006, Block Group 1, Census Tract 2007.05, Napa County, California",99,96,3
1000000US060552007051007,060552007051007,"Block 1007, Block Group 1, Census Tract 2007.05, Napa County, California",11,11,0
1000000US060552007051008,060552007051008,"Block 1008, Block Group 1, Census Tract 2007.05, Napa County, California",23,21,2
1000000US060552007051009,060552007051009,"Block 1009, Block Group 1, Census Tract 2007.05, Napa County, California",10,9,1
1000000US060552007051010,060552007051010,"Block 1010, Block Group 1, Census Tract 2007.05, Napa County, California",77,74,3
1000000US060552007051011,060552007051011,"Block 1011, Block Group 1, Census Tract 2007.05, Napa County, California",46,44,2
1000000US060552007051012,060552007051012,"Block 1012, Block Group 1, Census Tract 2007.05, Napa County, California",10,10,0
1000000US060552007051013,060552007051013,"Block 1013, Block Group 1, Census Tract 2007.05, Napa County, California",30,29,1
1000000US060552007051014,060552007051014,"Block 1014, Block Group 1, Census Tract 2007.05, Napa County, California",36,34,2
1000000US060552007051015,060552007051015,"Block 1015, Block Group 1, Census Tract 2007.05, Napa County, California",28,25,3
1000000US060552007051016,060552007051016,"Block 1016, Block Group 1, Census Tract 2007.05, Napa County, California",9,9,0
1000000US060552007051017,060552007051017,"Block 1017, Block Group 1, Census Tract 2007.05, Napa County, California",2,2,0
1000000US060552007051018,060552007051018,"Block 1018, Block Group 1, Census Tract 2007.05, Napa County, California",0,0,0
1000000US060552007051019,060552007051019,"Block 1019, Block Group 1, Census Tract 2007.05, Napa County, California",3,3,0
1000000US060552007051020,060552007051020,"Block 1020, Block Group 1, Census Tract 2007.05, Napa County, California",30,29,1
1000000US060552007051021,060552007051021,"Block 1021, Block Group 1, Census Tract 2007.05, Napa County, California",30,28,2
1000000US060552007051022,060552007051022,"Block 1022, Block Group 1, Census Tract 2007.05, Napa County, California",34,33,1
1000000US060552007052000,060552007052000,"Block 2000, Block Group 2, Census Tract 2007.05, Napa County, California",253,230,23
1000000US060552007052001,060552007052001,"Block 2001, Block Group 2, Census Tract 2007.05, Napa County, California",8,8,0
1000000US060552007052002,060552007052002,"Block 2002, Block Group 2, Census Tract 2007.05, Napa County, California",4,4,0
1000000US060552007052003,060552007052003,"Block 2003, Block Group 2, Census Tract 2007.05, Napa County, California",11,10,1
1000000US060552007052004,060552007052004,"Block 2004, Block Group 2, Census Tract 2007.05, Napa County, California",27,25,2
1000000US060552007052005,060552007052005,"Block 2005, Block Group 2, Census Tract 2007.05, Napa County, California",33,31,2
1000000US060552007052006,060552007052006,"Block 2006, Block Group 2, Census Tract 2007.05, Napa County, California",26,25,1
1000000US060552007052007,060552007052007,"Block 2007, Block Group 2, Census Tract 2007.05, Napa County, California",15,14,1
1000000US060552007052008,060552007052008,"Block 2008, Block Group 2, Census Tract 2007.05, Napa County, California",17,17,0
1000000US060552007061000,060552007061000,"Block 1000, Block Group 1, Census Tract 2007.06, Napa County, California",0,0,0
1000000US060552007061001,060552007061001,"Block 1001, Block Group 1, Census Tract 2007.06, Napa County, California",0,0,0
1000000US060552007061002,060552007061002,"Block 1002, Block Group 1, Census Tract 2007.06, Napa County, California",24,24,0
1000000US060552007061003,060552007061003,"Block 1003, Block Group 1, Census Tract 2007.06, Napa County, California",13,13,0
1000000US060552007061004,060552007061004,"Block 1004, Block Group 1, Census Tract 2007.06, Napa County, California",22,22,0
1000000US060552007061005,060552007061005,"Block 1005, Block Group 1, Census Tract 2007.06, Napa County, California",44,44,0
1000000US060552007061006,060552007061006,"Block 1006, Block Group 1, Census Tract 2007.06, Napa County, California",11,11,0
1000000US060552007061007,060552007061007,"Block 1007, Block Group 1, Census Tract 2007.06, Napa County, California",27,26,1
1000000US060552007061008,060552007061008,"Block 1008, Block Group 1, Census Tract 2007.06, Napa County, California",32,30,2
1000000US060552007061009,060552007061009,"Block 1009, Block Group 1, Census Tract 2007.06, Napa County, California",25,25,0
1000000US060552007061010,060552007061010,"Block 1010, Block Group 1, Census Tract 2007.06, Napa County, California",24,24,0
1000000US060552007061011,060552007061011,"Block 1011, Block Group 1, Census Tract 2007.06, Napa County, California",16,16,0
1000000US060552007061012,060552007061012,"Block 1012, Block Group 1, Census Tract 2007.06, Napa County, California",91,91,0
1000000US060552007061013,060552007061013,"Block 1013, Block Group 1, Census Tract 2007.06, Napa County, California",29,28,1
1000000US060552007061014,060552007061014,"Block 1014, Block Group 1, Census Tract 2007.06, Napa County, California",43,39,4
1000000US060552007062000,060552007062000,"Block 2000, Block Group 2, Census Tract 2007.06, Napa County, California",19,19,0
1000000US060552007062001,060552007062001,"Block 2001, Block Group 2, Census Tract 2007.06, Napa County, California",69,66,3
1000000US060552007062002,060552007062002,"Block 2002, Block Group 2, Census Tract 2007.06, Napa County, California",53,52,1
1000000US060552007062003,060552007062003,"Block 2003, Block Group 2, Census Tract 2007.06, Napa County, California",18,18,0
1000000US060552007062004,060552007062004,"Block 2004, Block Group 2, Census Tract 2007.06, Napa County, California",25,24,1
1000000US060552007062005,060552007062005,"Block 2005, Block Group 2, Census Tract 2007.06, Napa County, California",47,47,0
1000000US060552007062006,060552007062006,"Block 2006, Block Group 2, Census Tract 2007.06, Napa County, California",145,141,4
1000000US060552007062007,060552007062007,"Block 2007, Block Group 2, Census Tract 2007.06, Napa County, California",48,43,5
1000000US060552007063000,060552007063000,"Block 3000, Block Group 3, Census Tract 2007.06, Napa County, California",16,16,0
1000000US060552007063001,060552007063001,"Block 3001, Block Group 3, Census Tract 2007.06, Napa County, California",10,10,0
1000000US060552007063002,060552007063002,"Block 3002, Block Group 3, Census Tract 2007.06, Napa County, California",124,120,4
1000000US060552007063003,060552007063003,"Block 3003, Block Group 3, Census Tract 2007.06, Napa County, California",12,12,0
1000000US060552007063004,060552007063004,"Block 3004, Block Group 3, Census Tract 2007.06, Napa County, California",20,19,1
1000000US060552007063005,060552007063005,"Block 3005, Block Group 3, Census Tract 2007.06, Napa County, California",20,19,1
1000000US060552007063006,060552007063006,"Block 3006, Block Group 3, Census Tract 2007.06, Napa County, California",37,37,0
1000000US060552007063007,060552007063007,"Block 3007, Block Group 3, Census Tract 2007.06, Napa County, California",5,5,0
1000000US060552007063008,060552007063008,"Block 3008, Block Group 3, Census Tract 2007.06, Napa County, California",20,20,0
1000000US060552007063009,060552007063009,"Block 3009, Block Group 3, Census Tract 2007.06, Napa County, California",35,33,2
1000000US060552007063010,060552007063010,"Block 3010, Block Group 3, Census Tract 2007.06, Napa County, California",21,21,0
1000000US060552007063011,060552007063011,"Block 3011, Block Group 3, Census Tract 2007.06, Napa County, California",12,12,0
1000000US060552007063012,060552007063012,"Block 3012, Block Group 3, Census Tract 2007.06, Napa County, California",13,13,0
1000000US060552007071000,060552007071000,"Block 1000, Block Group 1, Census Tract 2007.07, Napa County, California",0,0,0
1000000US060552007071001,060552007071001,"Block 1001, Block Group 1, Census Tract 2007.07, Napa County, California",0,0,0
1000000US060552007071002,060552007071002,"Block 1002, Block Group 1, Census Tract 2007.07, Napa County, California",13,13,0
1000000US060552007071003,060552007071003,"Block 1003, Block Group 1, Census Tract 2007.07, Napa County, California",37,37,0
1000000US060552007071004,060552007071004,"Block 1004, Block Group 1, Census Tract 2007.07, Napa County, California",23,22,1
1000000US060552007071005,060552007071005,"Block 1005, Block Group 1, Census Tract 2007.07, Napa County, California",33,33,0
1000000US060552007071006,060552007071006,"Block 1006, Block Group 1, Census Tract 2007.07, Napa County, California",24,22,2
1000000US060552007071007,060552007071007,"Block 1007, Block Group 1, Census Tract 2007.07, Napa County, California",322,289,33
1000000US060552007071008,060552007071008,"Block 1008, Block Group 1, Census Tract 2007.07, Napa County, California",25,24,1
1000000US060552007071009,060552007071009,"Block 1009, Block Group 1, Census Tract 2007.07, Napa County, California",3,3,0
1000000US060552007071010,060552007071010,"Block 1010, Block Group 1, Census Tract 2007.07, Napa County, California",22,21,1
1000000US060552007071011,060552007071011,"Block 1011, Block Group 1, Census Tract 2007.07, Napa County, California",24,23,1
1000000US060552007071012,060552007071012,"Block 1012, Block Group 1, Census Tract 2007.07, Napa County, California",65,62,3
1000000US060552007071013,060552007071013,"Block 1013, Block Group 1, Census Tract 2007.07, Napa County, California",336,292,44
1000000US060552007071014,060552007071014,"Block 1014, Block Group 1, Census Tract 2007.07, Napa County, California",38,36,2
1000000US060552007071015,060552007071015,"Block 1015, Block Group 1, Census Tract 2007.07, Napa County, California",13,12,1
1000000US060552007071016,060552007071016,"Block 1016, Block Group 1, Census Tract 2007.07, Napa County, California",0,0,0
1000000US060552007072000,060552007072000,"Block 2000, Block Group 2, Census Tract 2007.07, Napa County, California",20,19,1
1000000US060552007072001,060552007072001,"Block 2001, Block Group 2, Census Tract 2007.07, Napa County, California",12,12,0
1000000US060552007072002,060552007072002,"Block 2002, Block Group 2, Census Tract 2007.07, Napa County, California",35,35,0
1000000US060552007072003,060552007072003,"Block 2003, Block Group 2, Census Tract 2007.07, Napa County, California",30,30,0
1000000US060552007072004,060552007072004,"Block 2004, Block Group 2, Census Tract 2007.07, Napa County, California",66,65,1
1000000US060552007072005,060552007072005,"Block 2005, Block Group 2, Census Tract 2007.07, Napa County, California",48,45,3
1000000US060552007072006,060552007072006,"Block 2006, Block Group 2, Census Tract 2007.07, Napa County, California",11,11,0
1000000US060552007072007,060552007072007,"Block 2007, Block Group 2, Census Tract 2007.07, Napa County, California",17,16,1
1000000US060552007072008,060552007072008,"Block 2008, Block Group 2, Census Tract 2007.07, Napa County, California",57,55,2
1000000US060552007072009,060552007072009,"Block 2009, Block Group 2, Census Tract 2007.07, Napa County, California",59,58,1
1000000US060552007072010,060552007072010,"Block 2010, Block Group 2, Census Tract 2007.07, Napa County, California",9,9,0
1000000US060552007072011,060552007072011,"Block 2011, Block Group 2, Census Tract 2007.07, Napa County, California",11,10,1
1000000US060552007072012,060552007072012,"Block 2012, Block Group 2, Census Tract 2007.07, Napa County, California",12,11,1
1000000US060552007072013,060552007072013,"Block 2013, Block Group 2, Census Tract 2007.07, Napa County, California",13,13,0
1000000US060552007072014,060552007072014,"Block 2014, Block Group 2, Census Tract 2007.07, Napa County, California",32,31,1
1000000US060552007072015,060552007072015,"Block 2015, Block Group 2, Census Tract 2007.07, Napa County, California",23,21,2
1000000US060552008021000,060552008021000,"Block 1000, Block Group 1, Census Tract 2008.02, Napa County, California",12,12,0
1000000US060552008021001,060552008021001,"Block 1001, Block Group 1, Census Tract 2008.02, Napa County, California",159,149,10
1000000US060552008021002,060552008021002,"Block 1002, Block Group 1, Census Tract 2008.02, Napa County, California",65,62,3
1000000US060552008021003,060552008021003,"Block 1003, Block Group 1, Census Tract 2008.02, Napa County, California",37,35,2
1000000US060552008021004,060552008021004,"Block 1004, Block Group 1, Census Tract 2008.02, Napa County, California",21,20,1
1000000US060552008021005,060552008021005,"Block 1005, Block Group 1, Census Tract 2008.02, Napa County, California",20,20,0
1000000US060552008021006,060552008021006,"Block 1006, Block Group 1, Census Tract 2008.02, Napa County, California",19,19,0
1000000US060552008021007,060552008021007,"Block 1007, Block Group 1, Census Tract 2008.02, Napa County, California",10,10,0
1000000US060552008021008,060552008021008,"Block 1008, Block Group 1, Census Tract 2008.02, Napa County, California",0,0,0
1000000US060552008021009,060552008021009,"Block 1009, Block Group 1, Census Tract 2008.02, Napa County, California",0,0,0
1000000US060552008022000,060552008022000,"Block 2000, Block Group 2, Census Tract 2008.02, Napa County, California",28,24,4
1000000US060552008022001,060552008022001,"Block 2001, Block Group 2, Census Tract 2008.02, Napa County, California",29,29,0
1000000US060552008022002,060552008022002,"Block 2002, Block Group 2, Census Tract 2008.02, Napa County, California",26,25,1
1000000US060552008022003,060552008022003,"Block 2003, Block Group 2, Census Tract 2008.02, Napa County, California",23,20,3
1000000US060552008022004,060552008022004,"Block 2004, Block Group 2, Census Tract 2008.02, Napa County, California",4,3,1
1000000US060552008022005,060552008022005,"Block 2005, Block Group 2, Census Tract 2008.02, Napa County, California",37,35,2
1000000US060552008022006,060552008022006,"Block 2006, Block Group 2, Census Tract 2008.02, Napa County, California",48,45,3
1000000US060552008022007,060552008022007,"Block 2007, Block Group 2, Census Tract 2008.02, Napa County, California",2,2,0
1000000US060552008022008,060552008022008,"Block 2008, Block Group 2, Census Tract 2008.02, Napa County, California",2,2,0
1000000US060552008022009,060552008022009,"Block 2009, Block Group 2, Census Tract 2008.02, Napa County, California",10,9,1
1000000US060552008022010,060552008022010,"Block 2010, Block Group 2, Census Tract 2008.02, Napa County, California",28,28,0
1000000US060552008022011,060552008022011,"Block 2011, Block Group 2, Census Tract 2008.02, Napa County, California",8,8,0
1000000US060552008022012,060552008022012,"Block 2012, Block Group 2, Census Tract 2008.02, Napa County, California",2,2,0
1000000US060552008022013,060552008022013,"Block 2013, Block Group 2, Census Tract 2008.02, Napa County, California",24,24,0
1000000US060552008022014,060552008022014,"Block 2014, Block Group 2, Census Tract 2008.02, Napa County, California",23,22,1
1000000US060552008022015,060552008022015,"Block 2015, Block Group 2, Census Tract 2008.02, Napa County, California",24,23,1
1000000US060552008022016,060552008022016,"Block 2016, Block Group 2, Census Tract 2008.02, Napa County, California",83,76,7
1000000US060552008022017,060552008022017,"Block 2017, Block Group 2, Census Tract 2008.02, Napa County, California",87,85,2
1000000US060552008022018,060552008022018,"Block 2018, Block Group 2, Census Tract 2008.02, Napa County, California",72,69,3
1000000US060552008022019,060552008022019,"Block 2019, Block Group 2, Census Tract 2008.02, Napa County, California",68,65,3
1000000US060552008022020,060552008022020,"Block 2020, Block Group 2, Census Tract 2008.02, Napa County, California",26,24,2
1000000US060552008022021,060552008022021,"Block 2021, Block Group 2, Census Tract 2008.02, Napa County, California",7,7,0
1000000US060552008022022,060552008022022,"Block 2022, Block Group 2, Census Tract 2008.02, Napa County, California",3,3,0
1000000US060552008022023,060552008022023,"Block 2023, Block Group 2, Census Tract 2008.02, Napa County, California",0,0,0
1000000US060552008022024,060552008022024,"Block 2024, Block Group 2, Census Tract 2008.02, Napa County, California",0,0,0
1000000US060552008022025,060552008022025,"Block 2025, Block Group 2, Census Tract 2008.02, Napa County, California",0,0,0
1000000US060552008022026,060552008022026,"Block 2026, Block Group 2, Census Tract 2008.02, Napa County, California",13,13,0
1000000US060552008022027,060552008022027,"Block 2027, Block Group 2, Census Tract 2008.02, Napa County, California",10,9,1
1000000US060552008022028,060552008022028,"Block 2028, Block Group 2, Census Tract 2008.02, Napa County, California",0,0,0
1000000US060552008022029,060552008022029,"Block 2029, Block Group 2, Census Tract 2008.02, Napa County, California",0,0,0
1000000US060552008022030,060552008022030,"Block 2030, Block Group 2, Census Tract 2008.02, Napa County, California",13,13,0
1000000US060552008023000,060552008023000,"Block 3000, Block Group 3, Census Tract 2008.02, Napa County, California",0,0,0
1000000US060552008023001,060552008023001,"Block 3001, Block Group 3, Census Tract 2008.02, Napa County, California",377,349,28
1000000US060552008023002,060552008023002,"Block 3002, Block Group 3, Census Tract 2008.02, Napa County, California",8,8,0
1000000US060552008023003,060552008023003,"Block 3003, Block Group 3, Census Tract 2008.02, Napa County, California",0,0,0
1000000US060552008023004,060552008023004,"Block 3004, Block Group 3, Census Tract 2008.02, Napa County, California",0,0,0
1000000US060552008023005,060552008023005,"Block 3005, Block Group 3, Census Tract 2008.02, Napa County, California",0,0,0
1000000US060552008023006,060552008023006,"Block 3006, Block Group 3, Census Tract 2008.02, Napa County, California",52,46,6
1000000US060552008023007,060552008023007,"Block 3007, Block Group 3, Census Tract 2008.02, Napa County, California",36,32,4
1000000US060552008023008,060552008023008,"Block 3008, Block Group 3, Census Tract 2008.02, Napa County, California",175,162,13
1000000US060552008023009,060552008023009,"Block 3009, Block Group 3, Census Tract 2008.02, Napa County, California",4,4,0
1000000US060552008023010,060552008023010,"Block 3010, Block Group 3, Census Tract 2008.02, Napa County, California",26,22,4
1000000US060552008023011,060552008023011,"Block 3011, Block Group 3, Census Tract 2008.02, Napa County, California",17,16,1
1000000US060552008023012,060552008023012,"Block 3012, Block Group 3, Census Tract 2008.02, Napa County, California",415,317,98
1000000US060552008023013,060552008023013,"Block 3013, Block Group 3, Census Tract 2008.02, Napa County, California",27,26,1
1000000US060552008023014,060552008023014,"Block 3014, Block Group 3, Census Tract 2008.02, Napa County, California",8,8,0
1000000US060552008023015,060552008023015,"Block 3015, Block Group 3, Census Tract 2008.02, Napa County, California",27,25,2
1000000US060552008023016,060552008023016,"Block 3016, Block Group 3, Census Tract 2008.02, Napa County, California",8,8,0
1000000US060552008023017,060552008023017,"Block 3017, Block Group 3, Census Tract 2008.02, Napa County, California",20,20,0
1000000US060552008023018,060552008023018,"Block 3018, Block Group 3, Census Tract 2008.02, Napa County, California",24,23,1
1000000US060552008023019,060552008023019,"Block 3019, Block Group 3, Census Tract 2008.02, Napa County, California",68,63,5
1000000US060552008023020,060552008023020,"Block 3020, Block Group 3, Census Tract 2008.02, Napa County, California",0,0,0
1000000US060552008023021,060552008023021,"Block 3021, Block Group 3, Census Tract 2008.02, Napa County, California",0,0,0
1000000US060552008023022,060552008023022,"Block 3022, Block Group 3, Census Tract 2008.02, Napa County, California",0,0,0
1000000US060552008023023,060552008023023,"Block 3023, Block Group 3, Census Tract 2008.02, Napa County, California",0,0,0
1000000US060552008023024,060552008023024,"Block 3024, Block Group 3, Census Tract 2008.02, Napa County, California",47,46,1
1000000US060552008023025,060552008023025,"Block 3025, Block Group 3, Census Tract 2008.02, Napa County, California",6,6,0
1000000US060552008023026,060552008023026,"Block 3026, Block Group 3, Census Tract 2008.02, Napa County, California",8,0,8
1000000US060552008023027,060552008023027,"Block 3027, Block Group 3, Census Tract 2008.02, Napa County, California",0,0,0
1000000US060552008023028,060552008023028,"Block 3028, Block Group 3, Census Tract 2008.02, Napa County, California",0,0,0
1000000US060552008023029,060552008023029,"Block 3029, Block Group 3, Census Tract 2008.02, Napa County, California",0,0,0
1000000US060552008023030,060552008023030,"Block 3030, Block Group 3, Census Tract 2008.02, Napa County, California",0,0,0
1000000US060552008023031,060552008023031,"Block 3031, Block Group 3, Census Tract 2008.02, Napa County, California",0,0,0
1000000US060552008023032,060552008023032,"Block 3032, Block Group 3, Census Tract 2008.02, Napa County, California",0,0,0
1000000US060552008023033,060552008023033,"Block 3033, Block Group 3, Census Tract 2008.02, Napa County, California",0,0,0
1000000US060552008023034,060552008023034,"Block 3034, Block Group 3, Census Tract 2008.02, Napa County, California",0,0,0
1000000US060552008023035,060552008023035,"Block 3035, Block Group 3, Census Tract 2008.02, Napa County, California",0,0,0
1000000US060552008023036,060552008023036,"Block 3036, Block Group 3, Census Tract 2008.02, Napa County, California",0,0,0
1000000US060552008023037,060552008023037,"Block 3037, Block Group 3, Census Tract 2008.02, Napa County, California",0,0,0
1000000US060552008023038,060552008023038,"Block 3038, Block Group 3, Census Tract 2008.02, Napa County, California",0,0,0
1000000US060552008023039,060552008023039,"Block 3039, Block Group 3, Census Tract 2008.02, Napa County, California",0,0,0
1000000US060552008023040,060552008023040,"Block 3040, Block Group 3, Census Tract 2008.02, Napa County, California",0,0,0
1000000US060552008023041,060552008023041,"Block 3041, Block Group 3, Census Tract 2008.02, Napa County, California",0,0,0
1000000US060552008023042,060552008023042,"Block 3042, Block Group 3, Census Tract 2008.02, Napa County, California",0,0,0
1000000US060552008031000,060552008031000,"Block 1000, Block Group 1, Census Tract 2008.03, Napa County, California",169,161,8
1000000US060552008031001,060552008031001,"Block 1001, Block Group 1, Census Tract 2008.03, Napa County, California",0,0,0
1000000US060552008031002,060552008031002,"Block 1002, Block Group 1, Census Tract 2008.03, Napa County, California",0,0,0
1000000US060552008031003,060552008031003,"Block 1003, Block Group 1, Census Tract 2008.03, Napa County, California",22,20,2
1000000US060552008031004,060552008031004,"Block 1004, Block Group 1, Census Tract 2008.03, Napa County, California",11,11,0
1000000US060552008031005,060552008031005,"Block 1005, Block Group 1, Census Tract 2008.03, Napa County, California",0,0,0
1000000US060552008031006,060552008031006,"Block 1006, Block Group 1, Census Tract 2008.03, Napa County, California",0,0,0
1000000US060552008031007,060552008031007,"Block 1007, Block Group 1, Census Tract 2008.03, Napa County, California",2,2,0
1000000US060552008031008,060552008031008,"Block 1008, Block Group 1, Census Tract 2008.03, Napa County, California",57,54,3
1000000US060552008031009,060552008031009,"Block 1009, Block Group 1, Census Tract 2008.03, Napa County, California",12,12,0
1000000US060552008031010,060552008031010,"Block 1010, Block Group 1, Census Tract 2008.03, Napa County, California",9,9,0
1000000US060552008031011,060552008031011,"Block 1011, Block Group 1, Census Tract 2008.03, Napa County, California",29,25,4
1000000US060552008031012,060552008031012,"Block 1012, Block Group 1, Census Tract 2008.03, Napa County, California",19,17,2
1000000US060552008031013,060552008031013,"Block 1013, Block Group 1, Census Tract 2008.03, Napa County, California",15,15,0
1000000US060552008031014,060552008031014,"Block 1014, Block Group 1, Census Tract 2008.03, Napa County, California",16,14,2
1000000US060552008031015,060552008031015,"Block 1015, Block Group 1, Census Tract 2008.03, Napa County, California",10,10,0
1000000US060552008031016,060552008031016,"Block 1016, Block Group 1, Census Tract 2008.03, Napa County, California",10,10,0
1000000US060552008032000,060552008032000,"Block 2000, Block Group 2, Census Tract 2008.03, Napa County, California",199,195,4
1000000US060552008032001,060552008032001,"Block 2001, Block Group 2, Census Tract 2008.03, Napa County, California",0,0,0
1000000US060552008032002,060552008032002,"Block 2002, Block Group 2, Census Tract 2008.03, Napa County, California",28,28,0
1000000US060552008032003,060552008032003,"Block 2003, Block Group 2, Census Tract 2008.03, Napa County, California",16,15,1
1000000US060552008032004,060552008032004,"Block 2004, Block Group 2, Census Tract 2008.03, Napa County, California",53,52,1
1000000US060552008032005,060552008032005,"Block 2005, Block Group 2, Census Tract 2008.03, Napa County, California",47,47,0
1000000US060552008032006,060552008032006,"Block 2006, Block Group 2, Census Tract 2008.03, Napa County, California",113,112,1
1000000US060552008032007,060552008032007,"Block 2007, Block Group 2, Census Tract 2008.03, Napa County, California",40,36,4
1000000US060552008032008,060552008032008,"Block 2008, Block Group 2, Census Tract 2008.03, Napa County, California",4,4,0
1000000US060552008041000,060552008041000,"Block 1000, Block Group 1, Census Tract 2008.04, Napa County, California",0,0,0
1000000US060552008041001,060552008041001,"Block 1001, Block Group 1, Census Tract 2008.04, Napa County, California",0,0,0
1000000US060552008041002,060552008041002,"Block 1002, Block Group 1, Census Tract 2008.04, Napa County, California",0,0,0
1000000US060552008041003,060552008041003,"Block 1003, Block Group 1, Census Tract 2008.04, Napa County, California",0,0,0
1000000US060552008041004,060552008041004,"Block 1004, Block Group 1, Census Tract 2008.04, Napa County, California",151,131,20
1000000US060552008041005,060552008041005,"Block 1005, Block Group 1, Census Tract 2008.04, Napa County, California",34,31,3
1000000US060552008041006,060552008041006,"Block 1006, Block Group 1, Census Tract 2008.04, Napa County, California",33,30,3
1000000US060552008041007,060552008041007,"Block 1007, Block Group 1, Census Tract 2008.04, Napa County, California",34,30,4
1000000US060552008041008,060552008041008,"Block 1008, Block Group 1, Census Tract 2008.04, Napa County, California",15,14,1
1000000US060552008041009,060552008041009,"Block 1009, Block Group 1, Census Tract 2008.04, Napa County, California",32,30,2
1000000US060552008041010,060552008041010,"Block 1010, Block Group 1, Census Tract 2008.04, Napa County, California",39,34,5
1000000US060552008041011,060552008041011,"Block 1011, Block Group 1, Census Tract 2008.04, Napa County, California",48,45,3
1000000US060552008042000,060552008042000,"Block 2000, Block Group 2, Census Tract 2008.04, Napa County, California",40,39,1
1000000US060552008042001,060552008042001,"Block 2001, Block Group 2, Census Tract 2008.04, Napa County, California",35,34,1
1000000US060552008042002,060552008042002,"Block 2002, Block Group 2, Census Tract 2008.04, Napa County, California",34,31,3
1000000US060552008042003,060552008042003,"Block 2003, Block Group 2, Census Tract 2008.04, Napa County, California",31,29,2
1000000US060552008042004,060552008042004,"Block 2004, Block Group 2, Census Tract 2008.04, Napa County, California",27,25,2
1000000US060552008042005,060552008042005,"Block 2005, Block Group 2, Census Tract 2008.04, Napa County, California",114,110,4
1000000US060552008042006,060552008042006,"Block 2006, Block Group 2, Census Tract 2008.04, Napa County, California",41,40,1
1000000US060552008042007,060552008042007,"Block 2007, Block Group 2, Census Tract 2008.04, Napa County, California",29,29,0
1000000US060552008042008,060552008042008,"Block 2008, Block Group 2, Census Tract 2008.04, Napa County, California",27,25,2
1000000US060552008042009,060552008042009,"Block 2009, Block Group 2, Census Tract 2008.04, Napa County, California",13,12,1
1000000US060552008043000,060552008043000,"Block 3000, Block Group 3, Census Tract 2008.04, Napa County, California",0,0,0
1000000US060552008043001,060552008043001,"Block 3001, Block Group 3, Census Tract 2008.04, Napa County, California",361,331,30
1000000US060552008043002,060552008043002,"Block 3002, Block Group 3, Census Tract 2008.04, Napa County, California",14,13,1
1000000US060552008043003,060552008043003,"Block 3003, Block Group 3, Census Tract 2008.04, Napa County, California",18,18,0
1000000US060552008043004,060552008043004,"Block 3004, Block Group 3, Census Tract 2008.04, Napa County, California",16,16,0
1000000US060552008043005,060552008043005,"Block 3005, Block Group 3, Census Tract 2008.04, Napa County, California",23,22,1
1000000US060552008044000,060552008044000,"Block 4000, Block Group 4, Census Tract 2008.04, Napa County, California",0,0,0
1000000US060552008044001,060552008044001,"Block 4001, Block Group 4, Census Tract 2008.04, Napa County, California",28,28,0
1000000US060552008044002,060552008044002,"Block 4002, Block Group 4, Census Tract 2008.04, Napa County, California",32,32,0
1000000US060552008044003,060552008044003,"Block 4003, Block Group 4, Census Tract 2008.04, Napa County, California",44,42,2
1000000US060552008044004,060552008044004,"Block 4004, Block Group 4, Census Tract 2008.04, Napa County, California",24,24,0
1000000US060552008044005,060552008044005,"Block 4005, Block Group 4, Census Tract 2008.04, Napa County, California",20,18,2
1000000US060552008044006,060552008044006,"Block 4006, Block Group 4, Census Tract 2008.04, Napa County, California",28,25,3
1000000US060552008044007,060552008044007,"Block 4007, Block Group 4, Census Tract 2008.04, Napa County, California",226,216,10
1000000US060552008044008,060552008044008,"Block 4008, Block Group 4, Census Tract 2008.04, Napa County, California",1,1,0
1000000US060552008044009,060552008044009,"Block 4009, Block Group 4, Census Tract 2008.04, Napa County, California",36,36,0
1000000US060552008044010,060552008044010,"Block 4010, Block Group 4, Census Tract 2008.04, Napa County, California",1,1,0
1000000US060552009001000,060552009001000,"Block 1000, Block Group 1, Census Tract 2009, Napa County, California",0,0,0
1000000US060552009001001,060552009001001,"Block 1001, Block Group 1, Census Tract 2009, Napa County, California",0,0,0
1000000US060552009001002,060552009001002,"Block 1002, Block Group 1, Census Tract 2009, Napa County, California",0,0,0
1000000US060552009001003,060552009001003,"Block 1003, Block Group 1, Census Tract 2009, Napa County, California",19,18,1
1000000US060552009001004,060552009001004,"Block 1004, Block Group 1, Census Tract 2009, Napa County, California",0,0,0
1000000US060552009001005,060552009001005,"Block 1005, Block Group 1, Census Tract 2009, Napa County, California",0,0,0
1000000US060552009001006,060552009001006,"Block 1006, Block Group 1, Census Tract 2009, Napa County, California",0,0,0
1000000US060552009001007,060552009001007,"Block 1007, Block Group 1, Census Tract 2009, Napa County, California",0,0,0
1000000US060552009001008,060552009001008,"Block 1008, Block Group 1, Census Tract 2009, Napa County, California",0,0,0
1000000US060552009001009,060552009001009,"Block 1009, Block Group 1, Census Tract 2009, Napa County, California",0,0,0
1000000US060552009001010,060552009001010,"Block 1010, Block Group 1, Census Tract 2009, Napa County, California",0,0,0
1000000US060552009001011,060552009001011,"Block 1011, Block Group 1, Census Tract 2009, Napa County, California",0,0,0
1000000US060552009001012,060552009001012,"Block 1012, Block Group 1, Census Tract 2009, Napa County, California",0,0,0
1000000US060552009001013,060552009001013,"Block 1013, Block Group 1, Census Tract 2009, Napa County, California",0,0,0
1000000US060552009001014,060552009001014,"Block 1014, Block Group 1, Census Tract 2009, Napa County, California",0,0,0
1000000US060552009001015,060552009001015,"Block 1015, Block Group 1, Census Tract 2009, Napa County, California",0,0,0
1000000US060552009001016,060552009001016,"Block 1016, Block Group 1, Census Tract 2009, Napa County, California",0,0,0
1000000US060552009001017,060552009001017,"Block 1017, Block Group 1, Census Tract 2009, Napa County, California",0,0,0
1000000US060552009001018,060552009001018,"Block 1018, Block Group 1, Census Tract 2009, Napa County, California",0,0,0
1000000US060552009001019,060552009001019,"Block 1019, Block Group 1, Census Tract 2009, Napa County, California",0,0,0
1000000US060552009001020,060552009001020,"Block 1020, Block Group 1, Census Tract 2009, Napa County, California",0,0,0
1000000US060552009001021,060552009001021,"Block 1021, Block Group 1, Census Tract 2009, Napa County, California",0,0,0
1000000US060552009001022,060552009001022,"Block 1022, Block Group 1, Census Tract 2009, Napa County, California",0,0,0
1000000US060552009001023,060552009001023,"Block 1023, Block Group 1, Census Tract 2009, Napa County, California",1,1,0
1000000US060552009001024,060552009001024,"Block 1024, Block Group 1, Census Tract 2009, Napa County, California",0,0,0
1000000US060552009001025,060552009001025,"Block 1025, Block Group 1, Census Tract 2009, Napa County, California",0,0,0
1000000US060552009001026,060552009001026,"Block 1026, Block Group 1, Census Tract 2009, Napa County, California",0,0,0
1000000US060552009001027,060552009001027,"Block 1027, Block Group 1, Census Tract 2009, Napa County, California",2,0,2
1000000US060552009001028,060552009001028,"Block 1028, Block Group 1, Census Tract 2009, Napa County, California",0,0,0
1000000US060552009001029,060552009001029,"Block 1029, Block Group 1, Census Tract 2009, Napa County, California",0,0,0
1000000US060552009001030,060552009001030,"Block 1030, Block Group 1, Census Tract 2009, Napa County, California",0,0,0
1000000US060552009001031,060552009001031,"Block 1031, Block Group 1, Census Tract 2009, Napa County, California",0,0,0
1000000US060552009001032,060552009001032,"Block 1032, Block Group 1, Census Tract 2009, Napa County, California",0,0,0
1000000US060552009001033,060552009001033,"Block 1033, Block Group 1, Census Tract 2009, Napa County, California",0,0,0
1000000US060552009001034,060552009001034,"Block 1034, Block Group 1, Census Tract 2009, Napa County, California",0,0,0
1000000US060552009001035,060552009001035,"Block 1035, Block Group 1, Census Tract 2009, Napa County, California",0,0,0
1000000US060552009001036,060552009001036,"Block 1036, Block Group 1, Census Tract 2009, Napa County, California",7,3,4
1000000US060552009001037,060552009001037,"Block 1037, Block Group 1, Census Tract 2009, Napa County, California",0,0,0
1000000US060552009001038,060552009001038,"Block 1038, Block Group 1, Census Tract 2009, Napa County, California",0,0,0
1000000US060552009001039,060552009001039,"Block 1039, Block Group 1, Census Tract 2009, Napa County, California",0,0,0
1000000US060552009001040,060552009001040,"Block 1040, Block Group 1, Census Tract 2009, Napa County, California",0,0,0
1000000US060552009001041,060552009001041,"Block 1041, Block Group 1, Census Tract 2009, Napa County, California",0,0,0
1000000US060552009001042,060552009001042,"Block 1042, Block Group 1, Census Tract 2009, Napa County, California",0,0,0
1000000US060552009001043,060552009001043,"Block 1043, Block Group 1, Census Tract 2009, Napa County, California",0,0,0
1000000US060552009001044,060552009001044,"Block 1044, Block Group 1, Census Tract 2009, Napa County, California",0,0,0
1000000US060552009001045,060552009001045,"Block 1045, Block Group 1, Census Tract 2009, Napa County, California",0,0,0
1000000US060552009001046,060552009001046,"Block 1046, Block Group 1, Census Tract 2009, Napa County, California",0,0,0
1000000US060552009001047,060552009001047,"Block 1047, Block Group 1, Census Tract 2009, Napa County, California",0,0,0
1000000US060552009001048,060552009001048,"Block 1048, Block Group 1, Census Tract 2009, Napa County, California",0,0,0
1000000US060552010031000,060552010031000,"Block 1000, Block Group 1, Census Tract 2010.03, Napa County, California",28,28,0
1000000US060552010031001,060552010031001,"Block 1001, Block Group 1, Census Tract 2010.03, Napa County, California",120,105,15
1000000US060552010031002,060552010031002,"Block 1002, Block Group 1, Census Tract 2010.03, Napa County, California",0,0,0
1000000US060552010031003,060552010031003,"Block 1003, Block Group 1, Census Tract 2010.03, Napa County, California",1,1,0
1000000US060552010031004,060552010031004,"Block 1004, Block Group 1, Census Tract 2010.03, Napa County, California",0,0,0
1000000US060552010031005,060552010031005,"Block 1005, Block Group 1, Census Tract 2010.03, Napa County, California",0,0,0
1000000US060552010031006,060552010031006,"Block 1006, Block Group 1, Census Tract 2010.03, Napa County, California",64,57,7
1000000US060552010031007,060552010031007,"Block 1007, Block Group 1, Census Tract 2010.03, Napa County, California",0,0,0
1000000US060552010031008,060552010031008,"Block 1008, Block Group 1, Census Tract 2010.03, Napa County, California",0,0,0
1000000US060552010031009,060552010031009,"Block 1009, Block Group 1, Census Tract 2010.03, Napa County, California",30,24,6
1000000US060552010031010,060552010031010,"Block 1010, Block Group 1, Census Tract 2010.03, Napa County, California",0,0,0
1000000US060552010031011,060552010031011,"Block 1011, Block Group 1, Census Tract 2010.03, Napa County, California",0,0,0
1000000US060552010031012,060552010031012,"Block 1012, Block Group 1, Census Tract 2010.03, Napa County, California",0,0,0
1000000US060552010031013,060552010031013,"Block 1013, Block Group 1, Census Tract 2010.03, Napa County, California",0,0,0
1000000US060552010031014,060552010031014,"Block 1014, Block Group 1, Census Tract 2010.03, Napa County, California",0,0,0
1000000US060552010031015,060552010031015,"Block 1015, Block Group 1, Census Tract 2010.03, Napa County, California",0,0,0
1000000US060552010031016,060552010031016,"Block 1016, Block Group 1, Census Tract 2010.03, Napa County, California",0,0,0
1000000US060552010031017,060552010031017,"Block 1017, Block Group 1, Census Tract 2010.03, Napa County, California",0,0,0
1000000US060552010031018,060552010031018,"Block 1018, Block Group 1, Census Tract 2010.03, Napa County, California",0,0,0
1000000US060552010031019,060552010031019,"Block 1019, Block Group 1, Census Tract 2010.03, Napa County, California",0,0,0
1000000US060552010031020,060552010031020,"Block 1020, Block Group 1, Census Tract 2010.03, Napa County, California",1,1,0
1000000US060552010031021,060552010031021,"Block 1021, Block Group 1, Census Tract 2010.03, Napa County, California",5,5,0
1000000US060552010031022,060552010031022,"Block 1022, Block Group 1, Census Tract 2010.03, Napa County, California",2,1,1
1000000US060552010031023,060552010031023,"Block 1023, Block Group 1, Census Tract 2010.03, Napa County, California",0,0,0
1000000US060552010031024,060552010031024,"Block 1024, Block Group 1, Census Tract 2010.03, Napa County, California",2,2,0
1000000US060552010031025,060552010031025,"Block 1025, Block Group 1, Census Tract 2010.03, Napa County, California",0,0,0
1000000US060552010031026,060552010031026,"Block 1026, Block Group 1, Census Tract 2010.03, Napa County, California",0,0,0
1000000US060552010031027,060552010031027,"Block 1027, Block Group 1, Census Tract 2010.03, Napa County, California",2,2,0
1000000US060552010031028,060552010031028,"Block 1028, Block Group 1, Census Tract 2010.03, Napa County, California",0,0,0
1000000US060552010031029,060552010031029,"Block 1029, Block Group 1, Census Tract 2010.03, Napa County, California",0,0,0
1000000US060552010031030,060552010031030,"Block 1030, Block Group 1, Census Tract 2010.03, Napa County, California",0,0,0
1000000US060552010031031,060552010031031,"Block 1031, Block Group 1, Census Tract 2010.03, Napa County, California",0,0,0
1000000US060552010031032,060552010031032,"Block 1032, Block Group 1, Census Tract 2010.03, Napa County, California",0,0,0
1000000US060552010031033,060552010031033,"Block 1033, Block Group 1, Census Tract 2010.03, Napa County, California",0,0,0
1000000US060552010031034,060552010031034,"Block 1034, Block Group 1, Census Tract 2010.03, Napa County, California",0,0,0
1000000US060552010031035,060552010031035,"Block 1035, Block Group 1, Census Tract 2010.03, Napa County, California",0,0,0
1000000US060552010031036,060552010031036,"Block 1036, Block Group 1, Census Tract 2010.03, Napa County, California",8,6,2
1000000US060552010031037,060552010031037,"Block 1037, Block Group 1, Census Tract 2010.03, Napa County, California",5,5,0
1000000US060552010031038,060552010031038,"Block 1038, Block Group 1, Census Tract 2010.03, Napa County, California",2,2,0
1000000US060552010031039,060552010031039,"Block 1039, Block Group 1, Census Tract 2010.03, Napa County, California",13,12,1
1000000US060552010031040,060552010031040,"Block 1040, Block Group 1, Census Tract 2010.03, Napa County, California",0,0,0
1000000US060552010031041,060552010031041,"Block 1041, Block Group 1, Census Tract 2010.03, Napa County, California",0,0,0
1000000US060552010031042,060552010031042,"Block 1042, Block Group 1, Census Tract 2010.03, Napa County, California",1,1,0
1000000US060552010031043,060552010031043,"Block 1043, Block Group 1, Census Tract 2010.03, Napa County, California",0,0,0
1000000US060552010031044,060552010031044,"Block 1044, Block Group 1, Census Tract 2010.03, Napa County, California",0,0,0
1000000US060552010031045,060552010031045,"Block 1045, Block Group 1, Census Tract 2010.03, Napa County, California",0,0,0
1000000US060552010031046,060552010031046,"Block 1046, Block Group 1, Census Tract 2010.03, Napa County, California",0,0,0
1000000US060552010032000,060552010032000,"Block 2000, Block Group 2, Census Tract 2010.03, Napa County, California",29,29,0
1000000US060552010032001,060552010032001,"Block 2001, Block Group 2, Census Tract 2010.03, Napa County, California",0,0,0
1000000US060552010032002,060552010032002,"Block 2002, Block Group 2, Census Tract 2010.03, Napa County, California",1,1,0
1000000US060552010032003,060552010032003,"Block 2003, Block Group 2, Census Tract 2010.03, Napa County, California",13,13,0
1000000US060552010032004,060552010032004,"Block 2004, Block Group 2, Census Tract 2010.03, Napa County, California",1,1,0
1000000US060552010032005,060552010032005,"Block 2005, Block Group 2, Census Tract 2010.03, Napa County, California",220,200,20
1000000US060552010032006,060552010032006,"Block 2006, Block Group 2, Census Tract 2010.03, Napa County, California",0,0,0
1000000US060552010032007,060552010032007,"Block 2007, Block Group 2, Census Tract 2010.03, Napa County, California",0,0,0
1000000US060552010032008,060552010032008,"Block 2008, Block Group 2, Census Tract 2010.03, Napa County, California",0,0,0
1000000US060552010032009,060552010032009,"Block 2009, Block Group 2, Census Tract 2010.03, Napa County, California",0,0,0
1000000US060552010032010,060552010032010,"Block 2010, Block Group 2, Census Tract 2010.03, Napa County, California",86,86,0
1000000US060552010032011,060552010032011,"Block 2011, Block Group 2, Census Tract 2010.03, Napa County, California",23,22,1
1000000US060552010032012,060552010032012,"Block 2012, Block Group 2, Census Tract 2010.03, Napa County, California",7,4,3
1000000US060552010032013,060552010032013,"Block 2013, Block Group 2, Census Tract 2010.03, Napa County, California",0,0,0
1000000US060552010032014,060552010032014,"Block 2014, Block Group 2, Census Tract 2010.03, Napa County, California",1,1,0
1000000US060552010032015,060552010032015,"Block 2015, Block Group 2, Census Tract 2010.03, Napa County, California",0,0,0
1000000US060552010032016,060552010032016,"Block 2016, Block Group 2, Census Tract 2010.03, Napa County, California",101,93,8
1000000US060552010032017,060552010032017,"Block 2017, Block Group 2, Census Tract 2010.03, Napa County, California",7,7,0
1000000US060552010032018,060552010032018,"Block 2018, Block Group 2, Census Tract 2010.03, Napa County, California",23,21,2
1000000US060552010032019,060552010032019,"Block 2019, Block Group 2, Census Tract 2010.03, Napa County, California",126,114,12
1000000US060552010032020,060552010032020,"Block 2020, Block Group 2, Census Tract 2010.03, Napa County, California",65,45,20
1000000US060552010032021,060552010032021,"Block 2021, Block Group 2, Census Tract 2010.03, Napa County, California",20,20,0
1000000US060552010032022,060552010032022,"Block 2022, Block Group 2, Census Tract 2010.03, Napa County, California",29,27,2
1000000US060552010032023,060552010032023,"Block 2023, Block Group 2, Census Tract 2010.03, Napa County, California",14,14,0
1000000US060552010032024,060552010032024,"Block 2024, Block Group 2, Census Tract 2010.03, Napa County, California",12,11,1
1000000US060552010032025,060552010032025,"Block 2025, Block Group 2, Census Tract 2010.03, Napa County, California",4,0,4
1000000US060552010032026,060552010032026,"Block 2026, Block Group 2, Census Tract 2010.03, Napa County, California",36,36,0
1000000US060552010032027,060552010032027,"Block 2027, Block Group 2, Census Tract 2010.03, Napa County, California",25,23,2
1000000US060552010032028,060552010032028,"Block 2028, Block Group 2, Census Tract 2010.03, Napa County, California",21,20,1
1000000US060552010032029,060552010032029,"Block 2029, Block Group 2, Census Tract 2010.03, Napa County, California",14,13,1
1000000US060552010032030,060552010032030,"Block 2030, Block Group 2, Census Tract 2010.03, Napa County, California",0,0,0
1000000US060552010032031,060552010032031,"Block 2031, Block Group 2, Census Tract 2010.03, Napa County, California",4,3,1
1000000US060552010032032,060552010032032,"Block 2032, Block Group 2, Census Tract 2010.03, Napa County, California",0,0,0
1000000US060552010032033,060552010032033,"Block 2033, Block Group 2, Census Tract 2010.03, Napa County, California",56,51,5
1000000US060552010032034,060552010032034,"Block 2034, Block Group 2, Census Tract 2010.03, Napa County, California",44,39,5
1000000US060552010032035,060552010032035,"Block 2035, Block Group 2, Census Tract 2010.03, Napa County, California",32,30,2
1000000US060552010032036,060552010032036,"Block 2036, Block Group 2, Census Tract 2010.03, Napa County, California",58,49,9
1000000US060552010032037,060552010032037,"Block 2037, Block Group 2, Census Tract 2010.03, Napa County, California",9,9,0
1000000US060552010032038,060552010032038,"Block 2038, Block Group 2, Census Tract 2010.03, Napa County, California",20,19,1
1000000US060552010032039,060552010032039,"Block 2039, Block Group 2, Census Tract 2010.03, Napa County, California",20,20,0
1000000US060552010041000,060552010041000,"Block 1000, Block Group 1, Census Tract 2010.04, Napa County, California",484,453,31
1000000US060552010041001,060552010041001,"Block 1001, Block Group 1, Census Tract 2010.04, Napa County, California",6,6,0
1000000US060552010041002,060552010041002,"Block 1002, Block Group 1, Census Tract 2010.04, Napa County, California",12,11,1
1000000US060552010041003,060552010041003,"Block 1003, Block Group 1, Census Tract 2010.04, Napa County, California",33,29,4
1000000US060552010041004,060552010041004,"Block 1004, Block Group 1, Census Tract 2010.04, Napa County, California",31,31,0
1000000US060552010041005,060552010041005,"Block 1005, Block Group 1, Census Tract 2010.04, Napa County, California",27,27,0
1000000US060552010041006,060552010041006,"Block 1006, Block Group 1, Census Tract 2010.04, Napa County, California",12,12,0
1000000US060552010041007,060552010041007,"Block 1007, Block Group 1, Census Tract 2010.04, Napa County, California",29,28,1
1000000US060552010041008,060552010041008,"Block 1008, Block Group 1, Census Tract 2010.04, Napa County, California",2,2,0
1000000US060552010041009,060552010041009,"Block 1009, Block Group 1, Census Tract 2010.04, Napa County, California",21,20,1
1000000US060552010041010,060552010041010,"Block 1010, Block Group 1, Census Tract 2010.04, Napa County, California",12,12,0
1000000US060552010041011,060552010041011,"Block 1011, Block Group 1, Census Tract 2010.04, Napa County, California",5,4,1
1000000US060552010041012,060552010041012,"Block 1012, Block Group 1, Census Tract 2010.04, Napa County, California",24,24,0
1000000US060552010041013,060552010041013,"Block 1013, Block Group 1, Census Tract 2010.04, Napa County, California",35,33,2
1000000US060552010041014,060552010041014,"Block 1014, Block Group 1, Census Tract 2010.04, Napa County, California",12,10,2
1000000US060552010041015,060552010041015,"Block 1015, Block Group 1, Census Tract 2010.04, Napa County, California",12,11,1
1000000US060552010041016,060552010041016,"Block 1016, Block Group 1, Census Tract 2010.04, Napa County, California",7,7,0
1000000US060552010041017,060552010041017,"Block 1017, Block Group 1, Census Tract 2010.04, Napa County, California",27,23,4
1000000US060552010041018,060552010041018,"Block 1018, Block Group 1, Census Tract 2010.04, Napa County, California",38,36,2
1000000US060552010041019,060552010041019,"Block 1019, Block Group 1, Census Tract 2010.04, Napa County, California",2,2,0
1000000US060552010041020,060552010041020,"Block 1020, Block Group 1, Census Tract 2010.04, Napa County, California",24,22,2
1000000US060552010041021,060552010041021,"Block 1021, Block Group 1, Census Tract 2010.04, Napa County, California",3,3,0
1000000US060552010041022,060552010041022,"Block 1022, Block Group 1, Census Tract 2010.04, Napa County, California",25,24,1
1000000US060552010041023,060552010041023,"Block 1023, Block Group 1, Census Tract 2010.04, Napa County, California",36,34,2
1000000US060552010041024,060552010041024,"Block 1024, Block Group 1, Census Tract 2010.04, Napa County, California",11,11,0
1000000US060552010041025,060552010041025,"Block 1025, Block Group 1, Census Tract 2010.04, Napa County, California",12,12,0
1000000US060552010041026,060552010041026,"Block 1026, Block Group 1, Census Tract 2010.04, Napa County, California",12,11,1
1000000US060552010041027,060552010041027,"Block 1027, Block Group 1, Census Tract 2010.04, Napa County, California",9,9,0
1000000US060552010041028,060552010041028,"Block 1028, Block Group 1, Census Tract 2010.04, Napa County, California",19,19,0
1000000US060552010041029,060552010041029,"Block 1029, Block Group 1, Census Tract 2010.04, Napa County, California",7,7,0
1000000US060552010041030,060552010041030,"Block 1030, Block Group 1, Census Tract 2010.04, Napa County, California",30,29,1
1000000US060552010041031,060552010041031,"Block 1031, Block Group 1, Census Tract 2010.04, Napa County, California",12,11,1
1000000US060552010041032,060552010041032,"Block 1032, Block Group 1, Census Tract 2010.04, Napa County, California",33,29,4
1000000US060552010041033,060552010041033,"Block 1033, Block Group 1, Census Tract 2010.04, Napa County, California",24,23,1
1000000US060552010041034,060552010041034,"Block 1034, Block Group 1, Census Tract 2010.04, Napa County, California",12,11,1
1000000US060552010041035,060552010041035,"Block 1035, Block Group 1, Census Tract 2010.04, Napa County, California",12,12,0
1000000US060552010041036,060552010041036,"Block 1036, Block Group 1, Census Tract 2010.04, Napa County, California",12,11,1
1000000US060552010041037,060552010041037,"Block 1037, Block Group 1, Census Tract 2010.04, Napa County, California",2,2,0
1000000US060552010041038,060552010041038,"Block 1038, Block Group 1, Census Tract 2010.04, Napa County, California",20,19,1
1000000US060552010041039,060552010041039,"Block 1039, Block Group 1, Census Tract 2010.04, Napa County, California",0,0,0
1000000US060552010041040,060552010041040,"Block 1040, Block Group 1, Census Tract 2010.04, Napa County, California",0,0,0
1000000US060552010041041,060552010041041,"Block 1041, Block Group 1, Census Tract 2010.04, Napa County, California",0,0,0
1000000US060552010041042,060552010041042,"Block 1042, Block Group 1, Census Tract 2010.04, Napa County, California",0,0,0
1000000US060552010041043,060552010041043,"Block 1043, Block Group 1, Census Tract 2010.04, Napa County, California",12,12,0
1000000US060552010041044,060552010041044,"Block 1044, Block Group 1, Census Tract 2010.04, Napa County, California",0,0,0
1000000US060552010041045,060552010041045,"Block 1045, Block Group 1, Census Tract 2010.04, Napa County, California",4,4,0
1000000US060552010042000,060552010042000,"Block 2000, Block Group 2, Census Tract 2010.04, Napa County, California",0,0,0
1000000US060552010042001,060552010042001,"Block 2001, Block Group 2, Census Tract 2010.04, Napa County, California",151,147,4
1000000US060552010042002,060552010042002,"Block 2002, Block Group 2, Census Tract 2010.04, Napa County, California",27,25,2
1000000US060552010042003,060552010042003,"Block 2003, Block Group 2, Census Tract 2010.04, Napa County, California",28,26,2
1000000US060552010042004,060552010042004,"Block 2004, Block Group 2, Census Tract 2010.04, Napa County, California",7,7,0
1000000US060552010042005,060552010042005,"Block 2005, Block Group 2, Census Tract 2010.04, Napa County, California",36,35,1
1000000US060552010042006,060552010042006,"Block 2006, Block Group 2, Census Tract 2010.04, Napa County, California",23,20,3
1000000US060552010042007,060552010042007,"Block 2007, Block Group 2, Census Tract 2010.04, Napa County, California",0,0,0
1000000US060552010042008,060552010042008,"Block 2008, Block Group 2, Census Tract 2010.04, Napa County, California",17,15,2
1000000US060552010042009,060552010042009,"Block 2009, Block Group 2, Census Tract 2010.04, Napa County, California",54,51,3
1000000US060552010042010,060552010042010,"Block 2010, Block Group 2, Census Tract 2010.04, Napa County, California",19,18,1
1000000US060552010042011,060552010042011,"Block 2011, Block Group 2, Census Tract 2010.04, Napa County, California",42,37,5
1000000US060552010042012,060552010042012,"Block 2012, Block Group 2, Census Tract 2010.04, Napa County, California",22,21,1
1000000US060552010042013,060552010042013,"Block 2013, Block Group 2, Census Tract 2010.04, Napa County, California",14,11,3
1000000US060552010042014,060552010042014,"Block 2014, Block Group 2, Census Tract 2010.04, Napa County, California",31,28,3
1000000US060552010042015,060552010042015,"Block 2015, Block Group 2, Census Tract 2010.04, Napa County, California",23,22,1
1000000US060552010042016,060552010042016,"Block 2016, Block Group 2, Census Tract 2010.04, Napa County, California",21,21,0
1000000US060552010042017,060552010042017,"Block 2017, Block Group 2, Census Tract 2010.04, Napa County, California",19,19,0
1000000US060552010042018,060552010042018,"Block 2018, Block Group 2, Census Tract 2010.04, Napa County, California",0,0,0
1000000US060552010042019,060552010042019,"Block 2019, Block Group 2, Census Tract 2010.04, Napa County, California",0,0,0
1000000US060552010042020,060552010042020,"Block 2020, Block Group 2, Census Tract 2010.04, Napa County, California",4,4,0
1000000US060552010042021,060552010042021,"Block 2021, Block Group 2, Census Tract 2010.04, Napa County, California",8,8,0
1000000US060552010042022,060552010042022,"Block 2022, Block Group 2, Census Tract 2010.04, Napa County, California",4,4,0
1000000US060552010042023,060552010042023,"Block 2023, Block Group 2, Census Tract 2010.04, Napa County, California",47,45,2
1000000US060552010042024,060552010042024,"Block 2024, Block Group 2, Census Tract 2010.04, Napa County, California",31,29,2
1000000US060552010042025,060552010042025,"Block 2025, Block Group 2, Census Tract 2010.04, Napa County, California",18,18,0
1000000US060552010042026,060552010042026,"Block 2026, Block Group 2, Census Tract 2010.04, Napa County, California",28,27,1
1000000US060552010042027,060552010042027,"Block 2027, Block Group 2, Census Tract 2010.04, Napa County, California",32,30,2
1000000US060552010042028,060552010042028,"Block 2028, Block Group 2, Census Tract 2010.04, Napa County, California",6,6,0
1000000US060552010042029,060552010042029,"Block 2029, Block Group 2, Census Tract 2010.04, Napa County, California",20,20,0
1000000US060552010042030,060552010042030,"Block 2030, Block Group 2, Census Tract 2010.04, Napa County, California",26,26,0
1000000US060552010042031,060552010042031,"Block 2031, Block Group 2, Census Tract 2010.04, Napa County, California",30,29,1
1000000US060552010042032,060552010042032,"Block 2032, Block Group 2, Census Tract 2010.04, Napa County, California",29,28,1
1000000US060552010042033,060552010042033,"Block 2033, Block Group 2, Census Tract 2010.04, Napa County, California",12,10,2
1000000US060552010042034,060552010042034,"Block 2034, Block Group 2, Census Tract 2010.04, Napa County, California",17,15,2
1000000US060552010042035,060552010042035,"Block 2035, Block Group 2, Census Tract 2010.04, Napa County, California",9,9,0
1000000US060552010042036,060552010042036,"Block 2036, Block Group 2, Census Tract 2010.04, Napa County, California",5,5,0
1000000US060552010042037,060552010042037,"Block 2037, Block Group 2, Census Tract 2010.04, Napa County, California",6,6,0
1000000US060552010051000,060552010051000,"Block 1000, Block Group 1, Census Tract 2010.05, Napa County, California",0,0,0
1000000US060552010051001,060552010051001,"Block 1001, Block Group 1, Census Tract 2010.05, Napa County, California",0,0,0
1000000US060552010051002,060552010051002,"Block 1002, Block Group 1, Census Tract 2010.05, Napa County, California",0,0,0
1000000US060552010051003,060552010051003,"Block 1003, Block Group 1, Census Tract 2010.05, Napa County, California",0,0,0
1000000US060552010051004,060552010051004,"Block 1004, Block Group 1, Census Tract 2010.05, Napa County, California",0,0,0
1000000US060552010051005,060552010051005,"Block 1005, Block Group 1, Census Tract 2010.05, Napa County, California",0,0,0
1000000US060552010051006,060552010051006,"Block 1006, Block Group 1, Census Tract 2010.05, Napa County, California",0,0,0
1000000US060552010051007,060552010051007,"Block 1007, Block Group 1, Census Tract 2010.05, Napa County, California",0,0,0
1000000US060552010051008,060552010051008,"Block 1008, Block Group 1, Census Tract 2010.05, Napa County, California",0,0,0
1000000US060552010051009,060552010051009,"Block 1009, Block Group 1, Census Tract 2010.05, Napa County, California",0,0,0
1000000US060552010051010,060552010051010,"Block 1010, Block Group 1, Census Tract 2010.05, Napa County, California",0,0,0
1000000US060552010051011,060552010051011,"Block 1011, Block Group 1, Census Tract 2010.05, Napa County, California",0,0,0
1000000US060552010051012,060552010051012,"Block 1012, Block Group 1, Census Tract 2010.05, Napa County, California",0,0,0
1000000US060552010051013,060552010051013,"Block 1013, Block Group 1, Census Tract 2010.05, Napa County, California",0,0,0
1000000US060552010051014,060552010051014,"Block 1014, Block Group 1, Census Tract 2010.05, Napa County, California",0,0,0
1000000US060552010051015,060552010051015,"Block 1015, Block Group 1, Census Tract 2010.05, Napa County, California",0,0,0
1000000US060552010051016,060552010051016,"Block 1016, Block Group 1, Census Tract 2010.05, Napa County, California",3,3,0
1000000US060552010051017,060552010051017,"Block 1017, Block Group 1, Census Tract 2010.05, Napa County, California",0,0,0
1000000US060552010051018,060552010051018,"Block 1018, Block Group 1, Census Tract 2010.05, Napa County, California",0,0,0
1000000US060552010051019,060552010051019,"Block 1019, Block Group 1, Census Tract 2010.05, Napa County, California",0,0,0
1000000US060552010051020,060552010051020,"Block 1020, Block Group 1, Census Tract 2010.05, Napa County, California",0,0,0
1000000US060552010051021,060552010051021,"Block 1021, Block Group 1, Census Tract 2010.05, Napa County, California",0,0,0
1000000US060552010051022,060552010051022,"Block 1022, Block Group 1, Census Tract 2010.05, Napa County, California",0,0,0
1000000US060552010051023,060552010051023,"Block 1023, Block Group 1, Census Tract 2010.05, Napa County, California",0,0,0
1000000US060552010051024,060552010051024,"Block 1024, Block Group 1, Census Tract 2010.05, Napa County, California",0,0,0
1000000US060552010051025,060552010051025,"Block 1025, Block Group 1, Census Tract 2010.05, Napa County, California",0,0,0
1000000US060552010051026,060552010051026,"Block 1026, Block Group 1, Census Tract 2010.05, Napa County, California",0,0,0
1000000US060552010051027,060552010051027,"Block 1027, Block Group 1, Census Tract 2010.05, Napa County, California",0,0,0
1000000US060552010051028,060552010051028,"Block 1028, Block Group 1, Census Tract 2010.05, Napa County, California",0,0,0
1000000US060552010051029,060552010051029,"Block 1029, Block Group 1, Census Tract 2010.05, Napa County, California",0,0,0
1000000US060552010051030,060552010051030,"Block 1030, Block Group 1, Census Tract 2010.05, Napa County, California",0,0,0
1000000US060552010051031,060552010051031,"Block 1031, Block Group 1, Census Tract 2010.05, Napa County, California",0,0,0
1000000US060552010051032,060552010051032,"Block 1032, Block Group 1, Census Tract 2010.05, Napa County, California",0,0,0
1000000US060552010051033,060552010051033,"Block 1033, Block Group 1, Census Tract 2010.05, Napa County, California",0,0,0
1000000US060552010051034,060552010051034,"Block 1034, Block Group 1, Census Tract 2010.05, Napa County, California",0,0,0
1000000US060552010051035,060552010051035,"Block 1035, Block Group 1, Census Tract 2010.05, Napa County, California",0,0,0
1000000US060552010051036,060552010051036,"Block 1036, Block Group 1, Census Tract 2010.05, Napa County, California",0,0,0
1000000US060552010051037,060552010051037,"Block 1037, Block Group 1, Census Tract 2010.05, Napa County, California",0,0,0
1000000US060552010051038,060552010051038,"Block 1038, Block Group 1, Census Tract 2010.05, Napa County, California",0,0,0
1000000US060552010051039,060552010051039,"Block 1039, Block Group 1, Census Tract 2010.05, Napa County, California",0,0,0
1000000US060552010051040,060552010051040,"Block 1040, Block Group 1, Census Tract 2010.05, Napa County, California",0,0,0
1000000US060552010051041,060552010051041,"Block 1041, Block Group 1, Census Tract 2010.05, Napa County, California",0,0,0
1000000US060552010051042,060552010051042,"Block 1042, Block Group 1, Census Tract 2010.05, Napa County, California",0,0,0
1000000US060552010051043,060552010051043,"Block 1043, Block Group 1, Census Tract 2010.05, Napa County, California",0,0,0
1000000US060552010051044,060552010051044,"Block 1044, Block Group 1, Census Tract 2010.05, Napa County, California",0,0,0
1000000US060552010051045,060552010051045,"Block 1045, Block Group 1, Census Tract 2010.05, Napa County, California",0,0,0
1000000US060552010051046,060552010051046,"Block 1046, Block Group 1, Census Tract 2010.05, Napa County, California",0,0,0
1000000US060552010051047,060552010051047,"Block 1047, Block Group 1, Census Tract 2010.05, Napa County, California",2,2,0
1000000US060552010051048,060552010051048,"Block 1048, Block Group 1, Census Tract 2010.05, Napa County, California",0,0,0
1000000US060552010051049,060552010051049,"Block 1049, Block Group 1, Census Tract 2010.05, Napa County, California",0,0,0
1000000US060552010051050,060552010051050,"Block 1050, Block Group 1, Census Tract 2010.05, Napa County, California",0,0,0
1000000US060552010051051,060552010051051,"Block 1051, Block Group 1, Census Tract 2010.05, Napa County, California",0,0,0
1000000US060552010051052,060552010051052,"Block 1052, Block Group 1, Census Tract 2010.05, Napa County, California",0,0,0
1000000US060552010051053,060552010051053,"Block 1053, Block Group 1, Census Tract 2010.05, Napa County, California",0,0,0
1000000US060552010051054,060552010051054,"Block 1054, Block Group 1, Census Tract 2010.05, Napa County, California",0,0,0
1000000US060552010051055,060552010051055,"Block 1055, Block Group 1, Census Tract 2010.05, Napa County, California",0,0,0
1000000US060552010051056,060552010051056,"Block 1056, Block Group 1, Census Tract 2010.05, Napa County, California",0,0,0
1000000US060552010051057,060552010051057,"Block 1057, Block Group 1, Census Tract 2010.05, Napa County, California",2,2,0
1000000US060552010051058,060552010051058,"Block 1058, Block Group 1, Census Tract 2010.05, Napa County, California",0,0,0
1000000US060552010051059,060552010051059,"Block 1059, Block Group 1, Census Tract 2010.05, Napa County, California",0,0,0
1000000US060552010051060,060552010051060,"Block 1060, Block Group 1, Census Tract 2010.05, Napa County, California",0,0,0
1000000US060552010051061,060552010051061,"Block 1061, Block Group 1, Census Tract 2010.05, Napa County, California",9,9,0
1000000US060552010051062,060552010051062,"Block 1062, Block Group 1, Census Tract 2010.05, Napa County, California",3,3,0
1000000US060552010051063,060552010051063,"Block 1063, Block Group 1, Census Tract 2010.05, Napa County, California",0,0,0
1000000US060552010051064,060552010051064,"Block 1064, Block Group 1, Census Tract 2010.05, Napa County, California",0,0,0
1000000US060552010051065,060552010051065,"Block 1065, Block Group 1, Census Tract 2010.05, Napa County, California",0,0,0
1000000US060552010051066,060552010051066,"Block 1066, Block Group 1, Census Tract 2010.05, Napa County, California",0,0,0
1000000US060552010051067,060552010051067,"Block 1067, Block Group 1, Census Tract 2010.05, Napa County, California",0,0,0
1000000US060552010051068,060552010051068,"Block 1068, Block Group 1, Census Tract 2010.05, Napa County, California",7,7,0
1000000US060552010051069,060552010051069,"Block 1069, Block Group 1, Census Tract 2010.05, Napa County, California",0,0,0
1000000US060552010051070,060552010051070,"Block 1070, Block Group 1, Census Tract 2010.05, Napa County, California",0,0,0
1000000US060552010051071,060552010051071,"Block 1071, Block Group 1, Census Tract 2010.05, Napa County, California",2,2,0
1000000US060552010051072,060552010051072,"Block 1072, Block Group 1, Census Tract 2010.05, Napa County, California",0,0,0
1000000US060552010051073,060552010051073,"Block 1073, Block Group 1, Census Tract 2010.05, Napa County, California",0,0,0
1000000US060552010051074,060552010051074,"Block 1074, Block Group 1, Census Tract 2010.05, Napa County, California",0,0,0
1000000US060552010051075,060552010051075,"Block 1075, Block Group 1, Census Tract 2010.05, Napa County, California",0,0,0
1000000US060552010051076,060552010051076,"Block 1076, Block Group 1, Census Tract 2010.05, Napa County, California",0,0,0
1000000US060552010051077,060552010051077,"Block 1077, Block Group 1, Census Tract 2010.05, Napa County, California",0,0,0
1000000US060552010051078,060552010051078,"Block 1078, Block Group 1, Census Tract 2010.05, Napa County, California",0,0,0
1000000US060552010051079,060552010051079,"Block 1079, Block Group 1, Census Tract 2010.05, Napa County, California",0,0,0
1000000US060552010051080,060552010051080,"Block 1080, Block Group 1, Census Tract 2010.05, Napa County, California",9,7,2
1000000US060552010051081,060552010051081,"Block 1081, Block Group 1, Census Tract 2010.05, Napa County, California",11,10,1
1000000US060552010051082,060552010051082,"Block 1082, Block Group 1, Census Tract 2010.05, Napa County, California",59,57,2
1000000US060552010051083,060552010051083,"Block 1083, Block Group 1, Census Tract 2010.05, Napa County, California",0,0,0
1000000US060552010051084,060552010051084,"Block 1084, Block Group 1, Census Tract 2010.05, Napa County, California",0,0,0
1000000US060552010051085,060552010051085,"Block 1085, Block Group 1, Census Tract 2010.05, Napa County, California",23,21,2
1000000US060552010051086,060552010051086,"Block 1086, Block Group 1, Census Tract 2010.05, Napa County, California",56,55,1
1000000US060552010051087,060552010051087,"Block 1087, Block Group 1, Census Tract 2010.05, Napa County, California",18,16,2
1000000US060552010051088,060552010051088,"Block 1088, Block Group 1, Census Tract 2010.05, Napa County, California",20,18,2
1000000US060552010051089,060552010051089,"Block 1089, Block Group 1, Census Tract 2010.05, Napa County, California",14,14,0
1000000US060552010051090,060552010051090,"Block 1090, Block Group 1, Census Tract 2010.05, Napa County, California",42,39,3
1000000US060552010051091,060552010051091,"Block 1091, Block Group 1, Census Tract 2010.05, Napa County, California",0,0,0
1000000US060552010051092,060552010051092,"Block 1092, Block Group 1, Census Tract 2010.05, Napa County, California",0,0,0
1000000US060552010051093,060552010051093,"Block 1093, Block Group 1, Census Tract 2010.05, Napa County, California",0,0,0
1000000US060552010052000,060552010052000,"Block 2000, Block Group 2, Census Tract 2010.05, Napa County, California",10,10,0
1000000US060552010052001,060552010052001,"Block 2001, Block Group 2, Census Tract 2010.05, Napa County, California",69,68,1
1000000US060552010052002,060552010052002,"Block 2002, Block Group 2, Census Tract 2010.05, Napa County, California",60,59,1
1000000US060552010052003,060552010052003,"Block 2003, Block Group 2, Census Tract 2010.05, Napa County, California",20,20,0
1000000US060552010052004,060552010052004,"Block 2004, Block Group 2, Census Tract 2010.05, Napa County, California",33,33,0
1000000US060552010052005,060552010052005,"Block 2005, Block Group 2, Census Tract 2010.05, Napa County, California",12,12,0
1000000US060552010052006,060552010052006,"Block 2006, Block Group 2, Census Tract 2010.05, Napa County, California",56,54,2
1000000US060552010052007,060552010052007,"Block 2007, Block Group 2, Census Tract 2010.05, Napa County, California",31,28,3
1000000US060552010052008,060552010052008,"Block 2008, Block Group 2, Census Tract 2010.05, Napa County, California",17,16,1
1000000US060552010052009,060552010052009,"Block 2009, Block Group 2, Census Tract 2010.05, Napa County, California",23,22,1
1000000US060552010052010,060552010052010,"Block 2010, Block Group 2, Census Tract 2010.05, Napa County, California",14,14,0
1000000US060552010052011,060552010052011,"Block 2011, Block Group 2, Census Tract 2010.05, Napa County, California",34,33,1
1000000US060552010052012,060552010052012,"Block 2012, Block Group 2, Census Tract 2010.05, Napa County, California",28,26,2
1000000US060552010052013,060552010052013,"Block 2013, Block Group 2, Census Tract 2010.05, Napa County, California",21,18,3
1000000US060552010061000,060552010061000,"Block 1000, Block Group 1, Census Tract 2010.06, Napa County, California",9,8,1
1000000US060552010061001,060552010061001,"Block 1001, Block Group 1, Census Tract 2010.06, Napa County, California",15,15,0
1000000US060552010061002,060552010061002,"Block 1002, Block Group 1, Census Tract 2010.06, Napa County, California",109,102,7
1000000US060552010061003,060552010061003,"Block 1003, Block Group 1, Census Tract 2010.06, Napa County, California",11,10,1
1000000US060552010061004,060552010061004,"Block 1004, Block Group 1, Census Tract 2010.06, Napa County, California",25,24,1
1000000US060552010061005,060552010061005,"Block 1005, Block Group 1, Census Tract 2010.06, Napa County, California",54,54,0
1000000US060552010061006,060552010061006,"Block 1006, Block Group 1, Census Tract 2010.06, Napa County, California",12,12,0
1000000US060552010061007,060552010061007,"Block 1007, Block Group 1, Census Tract 2010.06, Napa County, California",37,36,1
1000000US060552010061008,060552010061008,"Block 1008, Block Group 1, Census Tract 2010.06, Napa County, California",20,17,3
1000000US060552010061009,060552010061009,"Block 1009, Block Group 1, Census Tract 2010.06, Napa County, California",18,17,1
1000000US060552010061010,060552010061010,"Block 1010, Block Group 1, Census Tract 2010.06, Napa County, California",33,32,1
1000000US060552010061011,060552010061011,"Block 1011, Block Group 1, Census Tract 2010.06, Napa County, California",30,29,1
1000000US060552010061012,060552010061012,"Block 1012, Block Group 1, Census Tract 2010.06, Napa County, California",23,23,0
1000000US060552010061013,060552010061013,"Block 1013, Block Group 1, Census Tract 2010.06, Napa County, California",32,32,0
1000000US060552010061014,060552010061014,"Block 1014, Block Group 1, Census Tract 2010.06, Napa County, California",22,21,1
1000000US060552010061015,060552010061015,"Block 1015, Block Group 1, Census Tract 2010.06, Napa County, California",12,11,1
1000000US060552010061016,060552010061016,"Block 1016, Block Group 1, Census Tract 2010.06, Napa County, California",33,32,1
1000000US060552010061017,060552010061017,"Block 1017, Block Group 1, Census Tract 2010.06, Napa County, California",23,22,1
1000000US060552010061018,060552010061018,"Block 1018, Block Group 1, Census Tract 2010.06, Napa County, California",23,22,1
1000000US060552010062000,060552010062000,"Block 2000, Block Group 2, Census Tract 2010.06, Napa County, California",8,6,2
1000000US060552010062001,060552010062001,"Block 2001, Block Group 2, Census Tract 2010.06, Napa County, California",29,27,2
1000000US060552010062002,060552010062002,"Block 2002, Block Group 2, Census Tract 2010.06, Napa County, California",59,58,1
1000000US060552010062003,060552010062003,"Block 2003, Block Group 2, Census Tract 2010.06, Napa County, California",34,33,1
1000000US060552010062004,060552010062004,"Block 2004, Block Group 2, Census Tract 2010.06, Napa County, California",31,30,1
1000000US060552010062005,060552010062005,"Block 2005, Block Group 2, Census Tract 2010.06, Napa County, California",28,27,1
1000000US060552010062006,060552010062006,"Block 2006, Block Group 2, Census Tract 2010.06, Napa County, California",17,17,0
1000000US060552010062007,060552010062007,"Block 2007, Block Group 2, Census Tract 2010.06, Napa County, California",39,39,0
1000000US060552010062008,060552010062008,"Block 2008, Block Group 2, Census Tract 2010.06, Napa County, California",25,23,2
1000000US060552010062009,060552010062009,"Block 2009, Block Group 2, Census Tract 2010.06, Napa County, California",23,22,1
1000000US060552010062010,060552010062010,"Block 2010, Block Group 2, Census Tract 2010.06, Napa County, California",44,44,0
1000000US060552010062011,060552010062011,"Block 2011, Block Group 2, Census Tract 2010.06, Napa County, California",30,30,0
1000000US060552010062012,060552010062012,"Block 2012, Block Group 2, Census Tract 2010.06, Napa County, California",8,8,0
1000000US060552010062013,060552010062013,"Block 2013, Block Group 2, Census Tract 2010.06, Napa County, California",18,17,1
1000000US060552010062014,060552010062014,"Block 2014, Block Group 2, Census Tract 2010.06, Napa County, California",28,22,6
1000000US060552010062015,060552010062015,"Block 2015, Block Group 2, Census Tract 2010.06, Napa County, California",14,14,0
1000000US060552010062016,060552010062016,"Block 2016, Block Group 2, Census Tract 2010.06, Napa County, California",10,10,0
1000000US060552010062017,060552010062017,"Block 2017, Block Group 2, Census Tract 2010.06, Napa County, California",19,18,1
1000000US060552010071000,060552010071000,"Block 1000, Block Group 1, Census Tract 2010.07, Napa County, California",0,0,0
1000000US060552010071001,060552010071001,"Block 1001, Block Group 1, Census Tract 2010.07, Napa County, California",0,0,0
1000000US060552010071002,060552010071002,"Block 1002, Block Group 1, Census Tract 2010.07, Napa County, California",0,0,0
1000000US060552010071003,060552010071003,"Block 1003, Block Group 1, Census Tract 2010.07, Napa County, California",0,0,0
1000000US060552010071004,060552010071004,"Block 1004, Block Group 1, Census Tract 2010.07, Napa County, California",0,0,0
1000000US060552010071005,060552010071005,"Block 1005, Block Group 1, Census Tract 2010.07, Napa County, California",39,38,1
1000000US060552010071006,060552010071006,"Block 1006, Block Group 1, Census Tract 2010.07, Napa County, California",18,18,0
1000000US060552010071007,060552010071007,"Block 1007, Block Group 1, Census Tract 2010.07, Napa County, California",14,14,0
1000000US060552010071008,060552010071008,"Block 1008, Block Group 1, Census Tract 2010.07, Napa County, California",73,70,3
1000000US060552010071009,060552010071009,"Block 1009, Block Group 1, Census Tract 2010.07, Napa County, California",17,17,0
1000000US060552010071010,060552010071010,"Block 1010, Block Group 1, Census Tract 2010.07, Napa County, California",10,9,1
1000000US060552010071011,060552010071011,"Block 1011, Block Group 1, Census Tract 2010.07, Napa County, California",26,25,1
1000000US060552010071012,060552010071012,"Block 1012, Block Group 1, Census Tract 2010.07, Napa County, California",41,41,0
1000000US060552010071013,060552010071013,"Block 1013, Block Group 1, Census Tract 2010.07, Napa County, California",11,11,0
1000000US060552010071014,060552010071014,"Block 1014, Block Group 1, Census Tract 2010.07, Napa County, California",58,56,2
1000000US060552010071015,060552010071015,"Block 1015, Block Group 1, Census Tract 2010.07, Napa County, California",93,90,3
1000000US060552010071016,060552010071016,"Block 1016, Block Group 1, Census Tract 2010.07, Napa County, California",101,95,6
1000000US060552010071017,060552010071017,"Block 1017, Block Group 1, Census Tract 2010.07, Napa County, California",40,38,2
1000000US060552010071018,060552010071018,"Block 1018, Block Group 1, Census Tract 2010.07, Napa County, California",13,13,0
1000000US060552010072000,060552010072000,"Block 2000, Block Group 2, Census Tract 2010.07, Napa County, California",47,45,2
1000000US060552010072001,060552010072001,"Block 2001, Block Group 2, Census Tract 2010.07, Napa County, California",9,9,0
1000000US060552010072002,060552010072002,"Block 2002, Block Group 2, Census Tract 2010.07, Napa County, California",18,18,0
1000000US060552010072003,060552010072003,"Block 2003, Block Group 2, Census Tract 2010.07, Napa County, California",72,69,3
1000000US060552010072004,060552010072004,"Block 2004, Block Group 2, Census Tract 2010.07, Napa County, California",19,18,1
1000000US060552010072005,060552010072005,"Block 2005, Block Group 2, Census Tract 2010.07, Napa County, California",8,8,0
1000000US060552010072006,060552010072006,"Block 2006, Block Group 2, Census Tract 2010.07, Napa County, California",12,12,0
1000000US060552010072007,060552010072007,"Block 2007, Block Group 2, Census Tract 2010.07, Napa County, California",15,15,0
1000000US060552010072008,060552010072008,"Block 2008, Block Group 2, Census Tract 2010.07, Napa County, California",36,36,0
1000000US060552010072009,060552010072009,"Block 2009, Block Group 2, Census Tract 2010.07, Napa County, California",15,13,2
1000000US060552010072010,060552010072010,"Block 2010, Block Group 2, Census Tract 2010.07, Napa County, California",31,30,1
1000000US060552010072011,060552010072011,"Block 2011, Block Group 2, Census Tract 2010.07, Napa County, California",30,28,2
1000000US060552010072012,060552010072012,"Block 2012, Block Group 2, Census Tract 2010.07, Napa County, California",17,16,1
1000000US060552010072013,060552010072013,"Block 2013, Block Group 2, Census Tract 2010.07, Napa County, California",15,14,1
1000000US060552010072014,060552010072014,"Block 2014, Block Group 2, Census Tract 2010.07, Napa County, California",21,20,1
1000000US060552010072015,060552010072015,"Block 2015, Block Group 2, Census Tract 2010.07, Napa County, California",21,21,0
1000000US060552010072016,060552010072016,"Block 2016, Block Group 2, Census Tract 2010.07, Napa County, California",30,28,2
1000000US060552010072017,060552010072017,"Block 2017, Block Group 2, Census Tract 2010.07, Napa County, California",12,12,0
1000000US060552010072018,060552010072018,"Block 2018, Block Group 2, Census Tract 2010.07, Napa County, California",44,44,0
1000000US060552010072019,060552010072019,"Block 2019, Block Group 2, Census Tract 2010.07, Napa County, California",26,25,1
1000000US060552010072020,060552010072020,"Block 2020, Block Group 2, Census Tract 2010.07, Napa County, California",26,24,2
1000000US060552010072021,060552010072021,"Block 2021, Block Group 2, Census Tract 2010.07, Napa County, California",32,30,2
1000000US060552010072022,060552010072022,"Block 2022, Block Group 2, Census Tract 2010.07, Napa County, California",18,18,0
1000000US060552010072023,060552010072023,"Block 2023, Block Group 2, Census Tract 2010.07, Napa County, California",18,17,1
1000000US060552010072024,060552010072024,"Block 2024, Block Group 2, Census Tract 2010.07, Napa County, California",22,19,3
1000000US060552011011000,060552011011000,"Block 1000, Block Group 1, Census Tract 2011.01, Napa County, California",19,19,0
1000000US060552011011001,060552011011001,"Block 1001, Block Group 1, Census Tract 2011.01, Napa County, California",10,10,0
1000000US060552011011002,060552011011002,"Block 1002, Block Group 1, Census Tract 2011.01, Napa County, California",11,11,0
1000000US060552011011003,060552011011003,"Block 1003, Block Group 1, Census Tract 2011.01, Napa County, California",52,45,7
1000000US060552011011004,060552011011004,"Block 1004, Block Group 1, Census Tract 2011.01, Napa County, California",23,23,0
1000000US060552011011005,060552011011005,"Block 1005, Block Group 1, Census Tract 2011.01, Napa County, California",12,9,3
1000000US060552011011006,060552011011006,"Block 1006, Block Group 1, Census Tract 2011.01, Napa County, California",0,0,0
1000000US060552011011007,060552011011007,"Block 1007, Block Group 1, Census Tract 2011.01, Napa County, California",55,54,1
1000000US060552011011008,060552011011008,"Block 1008, Block Group 1, Census Tract 2011.01, Napa County, California",26,25,1
1000000US060552011011009,060552011011009,"Block 1009, Block Group 1, Census Tract 2011.01, Napa County, California",22,22,0
1000000US060552011011010,060552011011010,"Block 1010, Block Group 1, Census Tract 2011.01, Napa County, California",1,1,0
1000000US060552011011011,060552011011011,"Block 1011, Block Group 1, Census Tract 2011.01, Napa County, California",23,22,1
1000000US060552011011012,060552011011012,"Block 1012, Block Group 1, Census Tract 2011.01, Napa County, California",0,0,0
1000000US060552011011013,060552011011013,"Block 1013, Block Group 1, Census Tract 2011.01, Napa County, California",8,8,0
1000000US060552011011014,060552011011014,"Block 1014, Block Group 1, Census Tract 2011.01, Napa County, California",54,52,2
1000000US060552011011015,060552011011015,"Block 1015, Block Group 1, Census Tract 2011.01, Napa County, California",18,17,1
1000000US060552011011016,060552011011016,"Block 1016, Block Group 1, Census Tract 2011.01, Napa County, California",116,109,7
1000000US060552011011017,060552011011017,"Block 1017, Block Group 1, Census Tract 2011.01, Napa County, California",0,0,0
1000000US060552011011018,060552011011018,"Block 1018, Block Group 1, Census Tract 2011.01, Napa County, California",6,6,0
1000000US060552011012000,060552011012000,"Block 2000, Block Group 2, Census Tract 2011.01, Napa County, California",1,1,0
1000000US060552011012001,060552011012001,"Block 2001, Block Group 2, Census Tract 2011.01, Napa County, California",6,6,0
1000000US060552011012002,060552011012002,"Block 2002, Block Group 2, Census Tract 2011.01, Napa County, California",6,6,0
1000000US060552011012003,060552011012003,"Block 2003, Block Group 2, Census Tract 2011.01, Napa County, California",0,0,0
1000000US060552011012004,060552011012004,"Block 2004, Block Group 2, Census Tract 2011.01, Napa County, California",6,4,2
1000000US060552011012005,060552011012005,"Block 2005, Block Group 2, Census Tract 2011.01, Napa County, California",79,77,2
1000000US060552011012006,060552011012006,"Block 2006, Block Group 2, Census Tract 2011.01, Napa County, California",13,12,1
1000000US060552011012007,060552011012007,"Block 2007, Block Group 2, Census Tract 2011.01, Napa County, California",24,23,1
1000000US060552011012008,060552011012008,"Block 2008, Block Group 2, Census Tract 2011.01, Napa County, California",16,16,0
1000000US060552011012009,060552011012009,"Block 2009, Block Group 2, Census Tract 2011.01, Napa County, California",4,4,0
1000000US060552011012010,060552011012010,"Block 2010, Block Group 2, Census Tract 2011.01, Napa County, California",62,60,2
1000000US060552011012011,060552011012011,"Block 2011, Block Group 2, Census Tract 2011.01, Napa County, California",14,13,1
1000000US060552011012012,060552011012012,"Block 2012, Block Group 2, Census Tract 2011.01, Napa County, California",0,0,0
1000000US060552011012013,060552011012013,"Block 2013, Block Group 2, Census Tract 2011.01, Napa County, California",12,11,1
1000000US060552011012014,060552011012014,"Block 2014, Block Group 2, Census Tract 2011.01, Napa County, California",72,70,2
1000000US060552011012015,060552011012015,"Block 2015, Block Group 2, Census Tract 2011.01, Napa County, California",23,23,0
1000000US060552011021000,060552011021000,"Block 1000, Block Group 1, Census Tract 2011.02, Napa County, California",33,27,6
1000000US060552011021001,060552011021001,"Block 1001, Block Group 1, Census Tract 2011.02, Napa County, California",3,3,0
1000000US060552011021002,060552011021002,"Block 1002, Block Group 1, Census Tract 2011.02, Napa County, California",0,0,0
1000000US060552011021003,060552011021003,"Block 1003, Block Group 1, Census Tract 2011.02, Napa County, California",16,11,5
1000000US060552011021004,060552011021004,"Block 1004, Block Group 1, Census Tract 2011.02, Napa County, California",8,2,6
1000000US060552011021005,060552011021005,"Block 1005, Block Group 1, Census Tract 2011.02, Napa County, California",0,0,0
1000000US060552011021006,060552011021006,"Block 1006, Block Group 1, Census Tract 2011.02, Napa County, California",2,2,0
1000000US060552011021007,060552011021007,"Block 1007, Block Group 1, Census Tract 2011.02, Napa County, California",8,6,2
1000000US060552011021008,060552011021008,"Block 1008, Block Group 1, Census Tract 2011.02, Napa County, California",281,226,55
1000000US060552011021009,060552011021009,"Block 1009, Block Group 1, Census Tract 2011.02, Napa County, California",2,2,0
1000000US060552011021010,060552011021010,"Block 1010, Block Group 1, Census Tract 2011.02, Napa County, California",0,0,0
1000000US060552011021011,060552011021011,"Block 1011, Block Group 1, Census Tract 2011.02, Napa County, California",0,0,0
1000000US060552011021012,060552011021012,"Block 1012, Block Group 1, Census Tract 2011.02, Napa County, California",0,0,0
1000000US060552011021013,060552011021013,"Block 1013, Block Group 1, Census Tract 2011.02, Napa County, California",5,5,0
1000000US060552011021014,060552011021014,"Block 1014, Block Group 1, Census Tract 2011.02, Napa County, California",0,0,0
1000000US060552011021015,060552011021015,"Block 1015, Block Group 1, Census Tract 2011.02, Napa County, California",0,0,0
1000000US060552011021016,060552011021016,"Block 1016, Block Group 1, Census Tract 2011.02, Napa County, California",0,0,0
1000000US060552011021017,060552011021017,"Block 1017, Block Group 1, Census Tract 2011.02, Napa County, California",14,10,4
1000000US060552011021018,060552011021018,"Block 1018, Block Group 1, Census Tract 2011.02, Napa County, California",0,0,0
1000000US060552011021019,060552011021019,"Block 1019, Block Group 1, Census Tract 2011.02, Napa County, California",0,0,0
1000000US060552011021020,060552011021020,"Block 1020, Block Group 1, Census Tract 2011.02, Napa County, California",0,0,0
1000000US060552011021021,060552011021021,"Block 1021, Block Group 1, Census Tract 2011.02, Napa County, California",10,9,1
1000000US060552011021022,060552011021022,"Block 1022, Block Group 1, Census Tract 2011.02, Napa County, California",74,61,13
1000000US060552011021023,060552011021023,"Block 1023, Block Group 1, Census Tract 2011.02, Napa County, California",0,0,0
1000000US060552011021024,060552011021024,"Block 1024, Block Group 1, Census Tract 2011.02, Napa County, California",0,0,0
1000000US060552011021025,060552011021025,"Block 1025, Block Group 1, Census Tract 2011.02, Napa County, California",12,11,1
1000000US060552011021026,060552011021026,"Block 1026, Block Group 1, Census Tract 2011.02, Napa County, California",2,1,1
1000000US060552011021027,060552011021027,"Block 1027, Block Group 1, Census Tract 2011.02, Napa County, California",0,0,0
1000000US060552011021028,060552011021028,"Block 1028, Block Group 1, Census Tract 2011.02, Napa County, California",83,70,13
1000000US060552011021029,060552011021029,"Block 1029, Block Group 1, Census Tract 2011.02, Napa County, California",0,0,0
1000000US060552011021030,060552011021030,"Block 1030, Block Group 1, Census Tract 2011.02, Napa County, California",6,5,1
1000000US060552011021031,060552011021031,"Block 1031, Block Group 1, Census Tract 2011.02, Napa County, California",0,0,0
1000000US060552011021032,060552011021032,"Block 1032, Block Group 1, Census Tract 2011.02, Napa County, California",0,0,0
1000000US060552011021033,060552011021033,"Block 1033, Block Group 1, Census Tract 2011.02, Napa County, California",0,0,0
1000000US060552011021034,060552011021034,"Block 1034, Block Group 1, Census Tract 2011.02, Napa County, California",19,18,1
1000000US060552011021035,060552011021035,"Block 1035, Block Group 1, Census Tract 2011.02, Napa County, California",38,23,15
1000000US060552011021036,060552011021036,"Block 1036, Block Group 1, Census Tract 2011.02, Napa County, California",8,6,2
1000000US060552011021037,060552011021037,"Block 1037, Block Group 1, Census Tract 2011.02, Napa County, California",3,2,1
1000000US060552011021038,060552011021038,"Block 1038, Block Group 1, Census Tract 2011.02, Napa County, California",0,0,0
1000000US060552011021039,060552011021039,"Block 1039, Block Group 1, Census Tract 2011.02, Napa County, California",9,8,1
1000000US060552011021040,060552011021040,"Block 1040, Block Group 1, Census Tract 2011.02, Napa County, California",0,0,0
1000000US060552011021041,060552011021041,"Block 1041, Block Group 1, Census Tract 2011.02, Napa County, California",0,0,0
1000000US060552011021042,060552011021042,"Block 1042, Block Group 1, Census Tract 2011.02, Napa County, California",0,0,0
1000000US060552011021043,060552011021043,"Block 1043, Block Group 1, Census Tract 2011.02, Napa County, California",2,2,0
1000000US060552011021044,060552011021044,"Block 1044, Block Group 1, Census Tract 2011.02, Napa County, California",0,0,0
1000000US060552011021045,060552011021045,"Block 1045, Block Group 1, Census Tract 2011.02, Napa County, California",0,0,0
1000000US060552011021046,060552011021046,"Block 1046, Block Group 1, Census Tract 2011.02, Napa County, California",5,5,0
1000000US060552011021047,060552011021047,"Block 1047, Block Group 1, Census Tract 2011.02, Napa County, California",3,2,1
1000000US060552011022000,060552011022000,"Block 2000, Block Group 2, Census Tract 2011.02, Napa County, California",110,92,18
1000000US060552011022001,060552011022001,"Block 2001, Block Group 2, Census Tract 2011.02, Napa County, California",7,5,2
1000000US060552011022002,060552011022002,"Block 2002, Block Group 2, Census Tract 2011.02, Napa County, California",19,18,1
1000000US060552011022003,060552011022003,"Block 2003, Block Group 2, Census Tract 2011.02, Napa County, California",0,0,0
1000000US060552011022004,060552011022004,"Block 2004, Block Group 2, Census Tract 2011.02, Napa County, California",0,0,0
1000000US060552011022005,060552011022005,"Block 2005, Block Group 2, Census Tract 2011.02, Napa County, California",0,0,0
1000000US060552011022006,060552011022006,"Block 2006, Block Group 2, Census Tract 2011.02, Napa County, California",11,10,1
1000000US060552011022007,060552011022007,"Block 2007, Block Group 2, Census Tract 2011.02, Napa County, California",76,70,6
1000000US060552011022008,060552011022008,"Block 2008, Block Group 2, Census Tract 2011.02, Napa County, California",18,15,3
1000000US060552011022009,060552011022009,"Block 2009, Block Group 2, Census Tract 2011.02, Napa County, California",6,6,0
1000000US060552011022010,060552011022010,"Block 2010, Block Group 2, Census Tract 2011.02, Napa County, California",10,8,2
1000000US060552011022011,060552011022011,"Block 2011, Block Group 2, Census Tract 2011.02, Napa County, California",1,1,0
1000000US060552011022012,060552011022012,"Block 2012, Block Group 2, Census Tract 2011.02, Napa County, California",9,9,0
1000000US060552011022013,060552011022013,"Block 2013, Block Group 2, Census Tract 2011.02, Napa County, California",12,10,2
1000000US060552011022014,060552011022014,"Block 2014, Block Group 2, Census Tract 2011.02, Napa County, California",103,83,20
1000000US060552011022015,060552011022015,"Block 2015, Block Group 2, Census Tract 2011.02, Napa County, California",0,0,0
1000000US060552011022016,060552011022016,"Block 2016, Block Group 2, Census Tract 2011.02, Napa County, California",0,0,0
1000000US060552011022017,060552011022017,"Block 2017, Block Group 2, Census Tract 2011.02, Napa County, California",0,0,0
1000000US060552011022018,060552011022018,"Block 2018, Block Group 2, Census Tract 2011.02, Napa County, California",0,0,0
1000000US060552011022019,060552011022019,"Block 2019, Block Group 2, Census Tract 2011.02, Napa County, California",0,0,0
1000000US060552011022020,060552011022020,"Block 2020, Block Group 2, Census Tract 2011.02, Napa County, California",0,0,0
1000000US060552011022021,060552011022021,"Block 2021, Block Group 2, Census Tract 2011.02, Napa County, California",0,0,0
1000000US060552011022022,060552011022022,"Block 2022, Block Group 2, Census Tract 2011.02, Napa County, California",1,1,0
1000000US060552011022023,060552011022023,"Block 2023, Block Group 2, Census Tract 2011.02, Napa County, California",0,0,0
1000000US060552011022024,060552011022024,"Block 2024, Block Group 2, Census Tract 2011.02, Napa County, California",0,0,0
1000000US060552011022025,060552011022025,"Block 2025, Block Group 2, Census Tract 2011.02, Napa County, California",0,0,0
1000000US060552011022026,060552011022026,"Block 2026, Block Group 2, Census Tract 2011.02, Napa County, California",0,0,0
1000000US060552011022027,060552011022027,"Block 2027, Block Group 2, Census Tract 2011.02, Napa County, California",0,0,0
1000000US060552011022028,060552011022028,"Block 2028, Block Group 2, Census Tract 2011.02, Napa County, California",0,0,0
1000000US060552011022029,060552011022029,"Block 2029, Block Group 2, Census Tract 2011.02, Napa County, California",0,0,0
1000000US060552011022030,060552011022030,"Block 2030, Block Group 2, Census Tract 2011.02, Napa County, California",0,0,0
1000000US060552011022031,060552011022031,"Block 2031, Block Group 2, Census Tract 2011.02, Napa County, California",0,0,0
1000000US060552012001000,060552012001000,"Block 1000, Block Group 1, Census Tract 2012, Napa County, California",107,81,26
1000000US060552012001001,060552012001001,"Block 1001, Block Group 1, Census Tract 2012, Napa County, California",13,10,3
1000000US060552012001002,060552012001002,"Block 1002, Block Group 1, Census Tract 2012, Napa County, California",1,1,0
1000000US060552012001003,060552012001003,"Block 1003, Block Group 1, Census Tract 2012, Napa County, California",13,9,4
1000000US060552012001004,060552012001004,"Block 1004, Block Group 1, Census Tract 2012, Napa County, California",1,1,0
1000000US060552012001005,060552012001005,"Block 1005, Block Group 1, Census Tract 2012, Napa County, California",8,7,1
1000000US060552012001006,060552012001006,"Block 1006, Block Group 1, Census Tract 2012, Napa County, California",0,0,0
1000000US060552012001007,060552012001007,"Block 1007, Block Group 1, Census Tract 2012, Napa County, California",0,0,0
1000000US060552012001008,060552012001008,"Block 1008, Block Group 1, Census Tract 2012, Napa County, California",6,3,3
1000000US060552012001009,060552012001009,"Block 1009, Block Group 1, Census Tract 2012, Napa County, California",4,2,2
1000000US060552012001010,060552012001010,"Block 1010, Block Group 1, Census Tract 2012, Napa County, California",1,1,0
1000000US060552012001011,060552012001011,"Block 1011, Block Group 1, Census Tract 2012, Napa County, California",33,22,11
1000000US060552012001012,060552012001012,"Block 1012, Block Group 1, Census Tract 2012, Napa County, California",0,0,0
1000000US060552012001013,060552012001013,"Block 1013, Block Group 1, Census Tract 2012, Napa County, California",8,3,5
1000000US060552012001014,060552012001014,"Block 1014, Block Group 1, Census Tract 2012, Napa County, California",4,4,0
1000000US060552012001015,060552012001015,"Block 1015, Block Group 1, Census Tract 2012, Napa County, California",1,0,1
1000000US060552012001016,060552012001016,"Block 1016, Block Group 1, Census Tract 2012, Napa County, California",1,1,0
1000000US060552012001017,060552012001017,"Block 1017, Block Group 1, Census Tract 2012, Napa County, California",1,0,1
1000000US060552012001018,060552012001018,"Block 1018, Block Group 1, Census Tract 2012, Napa County, California",25,24,1
1000000US060552012001019,060552012001019,"Block 1019, Block Group 1, Census Tract 2012, Napa County, California",30,23,7
1000000US060552012001020,060552012001020,"Block 1020, Block Group 1, Census Tract 2012, Napa County, California",0,0,0
1000000US060552012001021,060552012001021,"Block 1021, Block Group 1, Census Tract 2012, Napa County, California",0,0,0
1000000US060552012001022,060552012001022,"Block 1022, Block Group 1, Census Tract 2012, Napa County, California",0,0,0
1000000US060552012001023,060552012001023,"Block 1023, Block Group 1, Census Tract 2012, Napa County, California",12,11,1
1000000US060552012002000,060552012002000,"Block 2000, Block Group 2, Census Tract 2012, Napa County, California",0,0,0
1000000US060552012002001,060552012002001,"Block 2001, Block Group 2, Census Tract 2012, Napa County, California",0,0,0
1000000US060552012002002,060552012002002,"Block 2002, Block Group 2, Census Tract 2012, Napa County, California",0,0,0
1000000US060552012002003,060552012002003,"Block 2003, Block Group 2, Census Tract 2012, Napa County, California",0,0,0
1000000US060552012002004,060552012002004,"Block 2004, Block Group 2, Census Tract 2012, Napa County, California",0,0,0
1000000US060552012002005,060552012002005,"Block 2005, Block Group 2, Census Tract 2012, Napa County, California",0,0,0
1000000US060552012002006,060552012002006,"Block 2006, Block Group 2, Census Tract 2012, Napa County, California",35,27,8
1000000US060552012002007,060552012002007,"Block 2007, Block Group 2, Census Tract 2012, Napa County, California",37,34,3
1000000US060552012002008,060552012002008,"Block 2008, Block Group 2, Census Tract 2012, Napa County, California",57,48,9
1000000US060552012002009,060552012002009,"Block 2009, Block Group 2, Census Tract 2012, Napa County, California",0,0,0
1000000US060552012002010,060552012002010,"Block 2010, Block Group 2, Census Tract 2012, Napa County, California",0,0,0
1000000US060552012002011,060552012002011,"Block 2011, Block Group 2, Census Tract 2012, Napa County, California",45,38,7
1000000US060552012002012,060552012002012,"Block 2012, Block Group 2, Census Tract 2012, Napa County, California",0,0,0
1000000US060552012002013,060552012002013,"Block 2013, Block Group 2, Census Tract 2012, Napa County, California",0,0,0
1000000US060552012002014,060552012002014,"Block 2014, Block Group 2, Census Tract 2012, Napa County, California",0,0,0
1000000US060552012002015,060552012002015,"Block 2015, Block Group 2, Census Tract 2012, Napa County, California",0,0,0
1000000US060552012002016,060552012002016,"Block 2016, Block Group 2, Census Tract 2012, Napa County, California",0,0,0
1000000US060552012002017,060552012002017,"Block 2017, Block Group 2, Census Tract 2012, Napa County, California",0,0,0
1000000US060552012002018,060552012002018,"Block 2018, Block Group 2, Census Tract 2012, Napa County, California",0,0,0
1000000US060552012002019,060552012002019,"Block 2019, Block Group 2, Census Tract 2012, Napa County, California",0,0,0
1000000US060552012002020,060552012002020,"Block 2020, Block Group 2, Census Tract 2012, Napa County, California",0,0,0
1000000US060552012002021,060552012002021,"Block 2021, Block Group 2, Census Tract 2012, Napa County, California",0,0,0
1000000US060552012002022,060552012002022,"Block 2022, Block Group 2, Census Tract 2012, Napa County, California",22,15,7
1000000US060552012002023,060552012002023,"Block 2023, Block Group 2, Census Tract 2012, Napa County, California",13,10,3
1000000US060552012002024,060552012002024,"Block 2024, Block Group 2, Census Tract 2012, Napa County, California",0,0,0
1000000US060552012002025,060552012002025,"Block 2025, Block Group 2, Census Tract 2012, Napa County, California",29,26,3
1000000US060552012002026,060552012002026,"Block 2026, Block Group 2, Census Tract 2012, Napa County, California",28,26,2
1000000US060552012002027,060552012002027,"Block 2027, Block Group 2, Census Tract 2012, Napa County, California",16,14,2
1000000US060552012002028,060552012002028,"Block 2028, Block Group 2, Census Tract 2012, Napa County, California",13,11,2
1000000US060552012002029,060552012002029,"Block 2029, Block Group 2, Census Tract 2012, Napa County, California",16,15,1
1000000US060552012002030,060552012002030,"Block 2030, Block Group 2, Census Tract 2012, Napa County, California",0,0,0
1000000US060552012002031,060552012002031,"Block 2031, Block Group 2, Census Tract 2012, Napa County, California",34,34,0
1000000US060552012002032,060552012002032,"Block 2032, Block Group 2, Census Tract 2012, Napa County, California",22,21,1
1000000US060552012002033,060552012002033,"Block 2033, Block Group 2, Census Tract 2012, Napa County, California",22,20,2
1000000US060552012002034,060552012002034,"Block 2034, Block Group 2, Census Tract 2012, Napa County, California",5,5,0
1000000US060552012002035,060552012002035,"Block 2035, Block Group 2, Census Tract 2012, Napa County, California",17,16,1
1000000US060552012002036,060552012002036,"Block 2036, Block Group 2, Census Tract 2012, Napa County, California",18,17,1
1000000US060552012002037,060552012002037,"Block 2037, Block Group 2, Census Tract 2012, Napa County, California",22,19,3
1000000US060552012002038,060552012002038,"Block 2038, Block Group 2, Census Tract 2012, Napa County, California",13,12,1
1000000US060552012003000,060552012003000,"Block 3000, Block Group 3, Census Tract 2012, Napa County, California",0,0,0
1000000US060552012003001,060552012003001,"Block 3001, Block Group 3, Census Tract 2012, Napa County, California",7,7,0
1000000US060552012003002,060552012003002,"Block 3002, Block Group 3, Census Tract 2012, Napa County, California",3,3,0
1000000US060552012003003,060552012003003,"Block 3003, Block Group 3, Census Tract 2012, Napa County, California",32,32,0
1000000US060552012003004,060552012003004,"Block 3004, Block Group 3, Census Tract 2012, Napa County, California",21,21,0
1000000US060552012003005,060552012003005,"Block 3005, Block Group 3, Census Tract 2012, Napa County, California",65,60,5
1000000US060552012003006,060552012003006,"Block 3006, Block Group 3, Census Tract 2012, Napa County, California",11,11,0
1000000US060552012003007,060552012003007,"Block 3007, Block Group 3, Census Tract 2012, Napa County, California",75,71,4
1000000US060552012003008,060552012003008,"Block 3008, Block Group 3, Census Tract 2012, Napa County, California",29,27,2
1000000US060552012003009,060552012003009,"Block 3009, Block Group 3, Census Tract 2012, Napa County, California",15,13,2
1000000US060552012003010,060552012003010,"Block 3010, Block Group 3, Census Tract 2012, Napa County, California",41,40,1
1000000US060552012003011,060552012003011,"Block 3011, Block Group 3, Census Tract 2012, Napa County, California",26,21,5
1000000US060552012003012,060552012003012,"Block 3012, Block Group 3, Census Tract 2012, Napa County, California",12,12,0
1000000US060552012003013,060552012003013,"Block 3013, Block Group 3, Census Tract 2012, Napa County, California",35,35,0
1000000US060552012003014,060552012003014,"Block 3014, Block Group 3, Census Tract 2012, Napa County, California",32,32,0
1000000US060552012003015,060552012003015,"Block 3015, Block Group 3, Census Tract 2012, Napa County, California",1,1,0
1000000US060552012003016,060552012003016,"Block 3016, Block Group 3, Census Tract 2012, Napa County, California",33,32,1
1000000US060552012003017,060552012003017,"Block 3017, Block Group 3, Census Tract 2012, Napa County, California",84,76,8
1000000US060552012003018,060552012003018,"Block 3018, Block Group 3, Census Tract 2012, Napa County, California",41,40,1
1000000US060552012003019,060552012003019,"Block 3019, Block Group 3, Census Tract 2012, Napa County, California",0,0,0
1000000US060552012003020,060552012003020,"Block 3020, Block Group 3, Census Tract 2012, Napa County, California",0,0,0
1000000US060552012003021,060552012003021,"Block 3021, Block Group 3, Census Tract 2012, Napa County, California",0,0,0
1000000US060552012003022,060552012003022,"Block 3022, Block Group 3, Census Tract 2012, Napa County, California",27,24,3
1000000US060552012003023,060552012003023,"Block 3023, Block Group 3, Census Tract 2012, Napa County, California",59,54,5
1000000US060552012003024,060552012003024,"Block 3024, Block Group 3, Census Tract 2012, Napa County, California",17,17,0
1000000US060552012003025,060552012003025,"Block 3025, Block Group 3, Census Tract 2012, Napa County, California",108,100,8
1000000US060552012003026,060552012003026,"Block 3026, Block Group 3, Census Tract 2012, Napa County, California",15,15,0
1000000US060552012003027,060552012003027,"Block 3027, Block Group 3, Census Tract 2012, Napa County, California",69,66,3
1000000US060552012003028,060552012003028,"Block 3028, Block Group 3, Census Tract 2012, Napa County, California",17,16,1
1000000US060552012004000,060552012004000,"Block 4000, Block Group 4, Census Tract 2012, Napa County, California",35,33,2
1000000US060552012004001,060552012004001,"Block 4001, Block Group 4, Census Tract 2012, Napa County, California",15,15,0
1000000US060552012004002,060552012004002,"Block 4002, Block Group 4, Census Tract 2012, Napa County, California",29,28,1
1000000US060552012004003,060552012004003,"Block 4003, Block Group 4, Census Tract 2012, Napa County, California",71,69,2
1000000US060552012004004,060552012004004,"Block 4004, Block Group 4, Census Tract 2012, Napa County, California",10,9,1
1000000US060552012004005,060552012004005,"Block 4005, Block Group 4, Census Tract 2012, Napa County, California",0,0,0
1000000US060552012004006,060552012004006,"Block 4006, Block Group 4, Census Tract 2012, Napa County, California",0,0,0
1000000US060552012004007,060552012004007,"Block 4007, Block Group 4, Census Tract 2012, Napa County, California",11,7,4
1000000US060552012004008,060552012004008,"Block 4008, Block Group 4, Census Tract 2012, Napa County, California",25,25,0
1000000US060552012004009,060552012004009,"Block 4009, Block Group 4, Census Tract 2012, Napa County, California",16,16,0
1000000US060552012004010,060552012004010,"Block 4010, Block Group 4, Census Tract 2012, Napa County, California",45,43,2
1000000US060552012004011,060552012004011,"Block 4011, Block Group 4, Census Tract 2012, Napa County, California",32,31,1
1000000US060552012004012,060552012004012,"Block 4012, Block Group 4, Census Tract 2012, Napa County, California",28,27,1
1000000US060552012004013,060552012004013,"Block 4013, Block Group 4, Census Tract 2012, Napa County, California",27,26,1
1000000US060552012004014,060552012004014,"Block 4014, Block Group 4, Census Tract 2012, Napa County, California",36,30,6
1000000US060552012004015,060552012004015,"Block 4015, Block Group 4, Census Tract 2012, Napa County, California",43,41,2
1000000US060552012004016,060552012004016,"Block 4016, Block Group 4, Census Tract 2012, Napa County, California",31,30,1
1000000US060552012004017,060552012004017,"Block 4017, Block Group 4, Census Tract 2012, Napa County, California",4,4,0
1000000US060552012004018,060552012004018,"Block 4018, Block Group 4, Census Tract 2012, Napa County, California",18,18,0
1000000US060552012004019,060552012004019,"Block 4019, Block Group 4, Census Tract 2012, Napa County, California",39,38,1
1000000US060552012004020,060552012004020,"Block 4020, Block Group 4, Census Tract 2012, Napa County, California",53,49,4
1000000US060552013001000,060552013001000,"Block 1000, Block Group 1, Census Tract 2013, Napa County, California",27,20,7
1000000US060552013001001,060552013001001,"Block 1001, Block Group 1, Census Tract 2013, Napa County, California",85,80,5
1000000US060552013001002,060552013001002,"Block 1002, Block Group 1, Census Tract 2013, Napa County, California",17,15,2
1000000US060552013001003,060552013001003,"Block 1003, Block Group 1, Census Tract 2013, Napa County, California",36,29,7
1000000US060552013001004,060552013001004,"Block 1004, Block Group 1, Census Tract 2013, Napa County, California",5,3,2
1000000US060552013001005,060552013001005,"Block 1005, Block Group 1, Census Tract 2013, Napa County, California",14,13,1
1000000US060552013001006,060552013001006,"Block 1006, Block Group 1, Census Tract 2013, Napa County, California",14,14,0
1000000US060552013001007,060552013001007,"Block 1007, Block Group 1, Census Tract 2013, Napa County, California",133,95,38
1000000US060552013001008,060552013001008,"Block 1008, Block Group 1, Census Tract 2013, Napa County, California",4,3,1
1000000US060552013001009,060552013001009,"Block 1009, Block Group 1, Census Tract 2013, Napa County, California",90,82,8
1000000US060552013001010,060552013001010,"Block 1010, Block Group 1, Census Tract 2013, Napa County, California",11,8,3
1000000US060552013001011,060552013001011,"Block 1011, Block Group 1, Census Tract 2013, Napa County, California",24,21,3
1000000US060552013001012,060552013001012,"Block 1012, Block Group 1, Census Tract 2013, Napa County, California",16,13,3
1000000US060552013001013,060552013001013,"Block 1013, Block Group 1, Census Tract 2013, Napa County, California",22,15,7
1000000US060552013001014,060552013001014,"Block 1014, Block Group 1, Census Tract 2013, Napa County, California",19,19,0
1000000US060552013001015,060552013001015,"Block 1015, Block Group 1, Census Tract 2013, Napa County, California",15,11,4
1000000US060552013001016,060552013001016,"Block 1016, Block Group 1, Census Tract 2013, Napa County, California",5,4,1
1000000US060552013001017,060552013001017,"Block 1017, Block Group 1, Census Tract 2013, Napa County, California",11,10,1
1000000US060552013001018,060552013001018,"Block 1018, Block Group 1, Census Tract 2013, Napa County, California",21,15,6
1000000US060552013001019,060552013001019,"Block 1019, Block Group 1, Census Tract 2013, Napa County, California",22,17,5
1000000US060552013001020,060552013001020,"Block 1020, Block Group 1, Census Tract 2013, Napa County, California",0,0,0
1000000US060552013001021,060552013001021,"Block 1021, Block Group 1, Census Tract 2013, Napa County, California",0,0,0
1000000US060552013001022,060552013001022,"Block 1022, Block Group 1, Census Tract 2013, Napa County, California",12,10,2
1000000US060552013001023,060552013001023,"Block 1023, Block Group 1, Census Tract 2013, Napa County, California",11,8,3
1000000US060552013001024,060552013001024,"Block 1024, Block Group 1, Census Tract 2013, Napa County, California",6,4,2
1000000US060552013001025,060552013001025,"Block 1025, Block Group 1, Census Tract 2013, Napa County, California",3,2,1
1000000US060552013001026,060552013001026,"Block 1026, Block Group 1, Census Tract 2013, Napa County, California",16,15,1
1000000US060552013001027,060552013001027,"Block 1027, Block Group 1, Census Tract 2013, Napa County, California",0,0,0
1000000US060552013001028,060552013001028,"Block 1028, Block Group 1, Census Tract 2013, Napa County, California",0,0,0
1000000US060552013001029,060552013001029,"Block 1029, Block Group 1, Census Tract 2013, Napa County, California",0,0,0
1000000US060552013001030,060552013001030,"Block 1030, Block Group 1, Census Tract 2013, Napa County, California",14,12,2
1000000US060552013001031,060552013001031,"Block 1031, Block Group 1, Census Tract 2013, Napa County, California",0,0,0
1000000US060552013001032,060552013001032,"Block 1032, Block Group 1, Census Tract 2013, Napa County, California",0,0,0
1000000US060552013001033,060552013001033,"Block 1033, Block Group 1, Census Tract 2013, Napa County, California",0,0,0
1000000US060552013001034,060552013001034,"Block 1034, Block Group 1, Census Tract 2013, Napa County, California",11,10,1
1000000US060552013001035,060552013001035,"Block 1035, Block Group 1, Census Tract 2013, Napa County, California",0,0,0
1000000US060552013002000,060552013002000,"Block 2000, Block Group 2, Census Tract 2013, Napa County, California",292,256,36
1000000US060552013002001,060552013002001,"Block 2001, Block Group 2, Census Tract 2013, Napa County, California",20,19,1
1000000US060552013002002,060552013002002,"Block 2002, Block Group 2, Census Tract 2013, Napa County, California",17,15,2
1000000US060552013002003,060552013002003,"Block 2003, Block Group 2, Census Tract 2013, Napa County, California",14,11,3
1000000US060552013002004,060552013002004,"Block 2004, Block Group 2, Census Tract 2013, Napa County, California",19,17,2
1000000US060552013002005,060552013002005,"Block 2005, Block Group 2, Census Tract 2013, Napa County, California",12,11,1
1000000US060552013002006,060552013002006,"Block 2006, Block Group 2, Census Tract 2013, Napa County, California",15,14,1
1000000US060552013002007,060552013002007,"Block 2007, Block Group 2, Census Tract 2013, Napa County, California",21,16,5
1000000US060552013002008,060552013002008,"Block 2008, Block Group 2, Census Tract 2013, Napa County, California",9,7,2
1000000US060552013002009,060552013002009,"Block 2009, Block Group 2, Census Tract 2013, Napa County, California",47,40,7
1000000US060552013002010,060552013002010,"Block 2010, Block Group 2, Census Tract 2013, Napa County, California",12,10,2
1000000US060552013002011,060552013002011,"Block 2011, Block Group 2, Census Tract 2013, Napa County, California",3,1,2
1000000US060552013002012,060552013002012,"Block 2012, Block Group 2, Census Tract 2013, Napa County, California",26,20,6
1000000US060552013002013,060552013002013,"Block 2013, Block Group 2, Census Tract 2013, Napa County, California",23,21,2
1000000US060552013002014,060552013002014,"Block 2014, Block Group 2, Census Tract 2013, Napa County, California",13,11,2
1000000US060552013002015,060552013002015,"Block 2015, Block Group 2, Census Tract 2013, Napa County, California",6,4,2
1000000US060552013002016,060552013002016,"Block 2016, Block Group 2, Census Tract 2013, Napa County, California",18,14,4
1000000US060552013002017,060552013002017,"Block 2017, Block Group 2, Census Tract 2013, Napa County, California",11,9,2
1000000US060552013002018,060552013002018,"Block 2018, Block Group 2, Census Tract 2013, Napa County, California",5,4,1
1000000US060552013002019,060552013002019,"Block 2019, Block Group 2, Census Tract 2013, Napa County, California",1,1,0
1000000US060552013003000,060552013003000,"Block 3000, Block Group 3, Census Tract 2013, Napa County, California",0,0,0
1000000US060552013003001,060552013003001,"Block 3001, Block Group 3, Census Tract 2013, Napa County, California",4,1,3
1000000US060552013003002,060552013003002,"Block 3002, Block Group 3, Census Tract 2013, Napa County, California",0,0,0
1000000US060552013003003,060552013003003,"Block 3003, Block Group 3, Census Tract 2013, Napa County, California",0,0,0
1000000US060552013003004,060552013003004,"Block 3004, Block Group 3, Census Tract 2013, Napa County, California",0,0,0
1000000US060552013003005,060552013003005,"Block 3005, Block Group 3, Census Tract 2013, Napa County, California",0,0,0
1000000US060552013003006,060552013003006,"Block 3006, Block Group 3, Census Tract 2013, Napa County, California",0,0,0
1000000US060552014011000,060552014011000,"Block 1000, Block Group 1, Census Tract 2014.01, Napa County, California",133,107,26
1000000US060552014011001,060552014011001,"Block 1001, Block Group 1, Census Tract 2014.01, Napa County, California",1,1,0
1000000US060552014011002,060552014011002,"Block 1002, Block Group 1, Census Tract 2014.01, Napa County, California",1,1,0
1000000US060552014011003,060552014011003,"Block 1003, Block Group 1, Census Tract 2014.01, Napa County, California",7,5,2
1000000US060552014011004,060552014011004,"Block 1004, Block Group 1, Census Tract 2014.01, Napa County, California",6,4,2
1000000US060552014011005,060552014011005,"Block 1005, Block Group 1, Census Tract 2014.01, Napa County, California",4,3,1
1000000US060552014011006,060552014011006,"Block 1006, Block Group 1, Census Tract 2014.01, Napa County, California",14,8,6
1000000US060552014011007,060552014011007,"Block 1007, Block Group 1, Census Tract 2014.01, Napa County, California",0,0,0
1000000US060552014011008,060552014011008,"Block 1008, Block Group 1, Census Tract 2014.01, Napa County, California",9,8,1
1000000US060552014011009,060552014011009,"Block 1009, Block Group 1, Census Tract 2014.01, Napa County, California",56,43,13
1000000US060552014011010,060552014011010,"Block 1010, Block Group 1, Census Tract 2014.01, Napa County, California",0,0,0
1000000US060552014011011,060552014011011,"Block 1011, Block Group 1, Census Tract 2014.01, Napa County, California",0,0,0
1000000US060552014011012,060552014011012,"Block 1012, Block Group 1, Census Tract 2014.01, Napa County, California",0,0,0
1000000US060552014011013,060552014011013,"Block 1013, Block Group 1, Census Tract 2014.01, Napa County, California",64,54,10
1000000US060552014011014,060552014011014,"Block 1014, Block Group 1, Census Tract 2014.01, Napa County, California",70,60,10
1000000US060552014011015,060552014011015,"Block 1015, Block Group 1, Census Tract 2014.01, Napa County, California",0,0,0
1000000US060552014011016,060552014011016,"Block 1016, Block Group 1, Census Tract 2014.01, Napa County, California",3,3,0
1000000US060552014011017,060552014011017,"Block 1017, Block Group 1, Census Tract 2014.01, Napa County, California",15,14,1
1000000US060552014011018,060552014011018,"Block 1018, Block Group 1, Census Tract 2014.01, Napa County, California",29,24,5
1000000US060552014011019,060552014011019,"Block 1019, Block Group 1, Census Tract 2014.01, Napa County, California",39,39,0
1000000US060552014011020,060552014011020,"Block 1020, Block Group 1, Census Tract 2014.01, Napa County, California",30,28,2
1000000US060552014011021,060552014011021,"Block 1021, Block Group 1, Census Tract 2014.01, Napa County, California",11,11,0
1000000US060552014012000,060552014012000,"Block 2000, Block Group 2, Census Tract 2014.01, Napa County, California",140,125,15
1000000US060552014012001,060552014012001,"Block 2001, Block Group 2, Census Tract 2014.01, Napa County, California",0,0,0
1000000US060552014012002,060552014012002,"Block 2002, Block Group 2, Census Tract 2014.01, Napa County, California",1,1,0
1000000US060552014012003,060552014012003,"Block 2003, Block Group 2, Census Tract 2014.01, Napa County, California",30,29,1
1000000US060552014012004,060552014012004,"Block 2004, Block Group 2, Census Tract 2014.01, Napa County, California",0,0,0
1000000US060552014012005,060552014012005,"Block 2005, Block Group 2, Census Tract 2014.01, Napa County, California",15,15,0
1000000US060552014012006,060552014012006,"Block 2006, Block Group 2, Census Tract 2014.01, Napa County, California",39,32,7
1000000US060552014012007,060552014012007,"Block 2007, Block Group 2, Census Tract 2014.01, Napa County, California",137,114,23
1000000US060552014012008,060552014012008,"Block 2008, Block Group 2, Census Tract 2014.01, Napa County, California",14,14,0
1000000US060552014012009,060552014012009,"Block 2009, Block Group 2, Census Tract 2014.01, Napa County, California",19,18,1
1000000US060552014012010,060552014012010,"Block 2010, Block Group 2, Census Tract 2014.01, Napa County, California",5,5,0
1000000US060552014012011,060552014012011,"Block 2011, Block Group 2, Census Tract 2014.01, Napa County, California",5,3,2
1000000US060552014012012,060552014012012,"Block 2012, Block Group 2, Census Tract 2014.01, Napa County, California",20,20,0
1000000US060552014012013,060552014012013,"Block 2013, Block Group 2, Census Tract 2014.01, Napa County, California",0,0,0
1000000US060552014012014,060552014012014,"Block 2014, Block Group 2, Census Tract 2014.01, Napa County, California",1,1,0
1000000US060552014012015,060552014012015,"Block 2015, Block Group 2, Census Tract 2014.01, Napa County, California",4,4,0
1000000US060552014012016,060552014012016,"Block 2016, Block Group 2, Census Tract 2014.01, Napa County, California",43,38,5
1000000US060552014012017,060552014012017,"Block 2017, Block Group 2, Census Tract 2014.01, Napa County, California",16,13,3
1000000US060552014012018,060552014012018,"Block 2018, Block Group 2, Census Tract 2014.01, Napa County, California",8,6,2
1000000US060552014012019,060552014012019,"Block 2019, Block Group 2, Census Tract 2014.01, Napa County, California",9,7,2
1000000US060552014012020,060552014012020,"Block 2020, Block Group 2, Census Tract 2014.01, Napa County, California",9,9,0
1000000US060552014012021,060552014012021,"Block 2021, Block Group 2, Census Tract 2014.01, Napa County, California",4,3,1
1000000US060552014012022,060552014012022,"Block 2022, Block Group 2, Census Tract 2014.01, Napa County, California",0,0,0
1000000US060552014012023,060552014012023,"Block 2023, Block Group 2, Census Tract 2014.01, Napa County, California",59,51,8
1000000US060552014012024,060552014012024,"Block 2024, Block Group 2, Census Tract 2014.01, Napa County, California",0,0,0
1000000US060552014012025,060552014012025,"Block 2025, Block Group 2, Census Tract 2014.01, Napa County, California",0,0,0
1000000US060552014012026,060552014012026,"Block 2026, Block Group 2, Census Tract 2014.01, Napa County, California",20,18,2
1000000US060552014012027,060552014012027,"Block 2027, Block Group 2, Census Tract 2014.01, Napa County, California",0,0,0
1000000US060552014012028,060552014012028,"Block 2028, Block Group 2, Census Tract 2014.01, Napa County, California",0,0,0
1000000US060552014012029,060552014012029,"Block 2029, Block Group 2, Census Tract 2014.01, Napa County, California",0,0,0
1000000US060552014012030,060552014012030,"Block 2030, Block Group 2, Census Tract 2014.01, Napa County, California",17,13,4
1000000US060552014012031,060552014012031,"Block 2031, Block Group 2, Census Tract 2014.01, Napa County, California",1,0,1
1000000US060552014012032,060552014012032,"Block 2032, Block Group 2, Census Tract 2014.01, Napa County, California",0,0,0
1000000US060552014012033,060552014012033,"Block 2033, Block Group 2, Census Tract 2014.01, Napa County, California",7,6,1
1000000US060552014012034,060552014012034,"Block 2034, Block Group 2, Census Tract 2014.01, Napa County, California",1,0,1
1000000US060552014012035,060552014012035,"Block 2035, Block Group 2, Census Tract 2014.01, Napa County, California",26,19,7
1000000US060552014012036,060552014012036,"Block 2036, Block Group 2, Census Tract 2014.01, Napa County, California",5,5,0
1000000US060552014012037,060552014012037,"Block 2037, Block Group 2, Census Tract 2014.01, Napa County, California",7,3,4
1000000US060552014012038,060552014012038,"Block 2038, Block Group 2, Census Tract 2014.01, Napa County, California",2,1,1
1000000US060552014012039,060552014012039,"Block 2039, Block Group 2, Census Tract 2014.01, Napa County, California",4,4,0
1000000US060552014012040,060552014012040,"Block 2040, Block Group 2, Census Tract 2014.01, Napa County, California",0,0,0
1000000US060552014012041,060552014012041,"Block 2041, Block Group 2, Census Tract 2014.01, Napa County, California",0,0,0
1000000US060552014012042,060552014012042,"Block 2042, Block Group 2, Census Tract 2014.01, Napa County, California",0,0,0
1000000US060552014012043,060552014012043,"Block 2043, Block Group 2, Census Tract 2014.01, Napa County, California",0,0,0
1000000US060552014012044,060552014012044,"Block 2044, Block Group 2, Census Tract 2014.01, Napa County, California",4,4,0
1000000US060552014012045,060552014012045,"Block 2045, Block Group 2, Census Tract 2014.01, Napa County, California",3,3,0
1000000US060552014013000,060552014013000,"Block 3000, Block Group 3, Census Tract 2014.01, Napa County, California",806,162,644
1000000US060552014013001,060552014013001,"Block 3001, Block Group 3, Census Tract 2014.01, Napa County, California",0,0,0
1000000US060552014013002,060552014013002,"Block 3002, Block Group 3, Census Tract 2014.01, Napa County, California",6,4,2
1000000US060552014013003,060552014013003,"Block 3003, Block Group 3, Census Tract 2014.01, Napa County, California",0,0,0
1000000US060552014013004,060552014013004,"Block 3004, Block Group 3, Census Tract 2014.01, Napa County, California",0,0,0
1000000US060552014013005,060552014013005,"Block 3005, Block Group 3, Census Tract 2014.01, Napa County, California",18,13,5
1000000US060552014013006,060552014013006,"Block 3006, Block Group 3, Census Tract 2014.01, Napa County, California",8,3,5
1000000US060552014013007,060552014013007,"Block 3007, Block Group 3, Census Tract 2014.01, Napa County, California",0,0,0
1000000US060552014013008,060552014013008,"Block 3008, Block Group 3, Census Tract 2014.01, Napa County, California",0,0,0
1000000US060552014013009,060552014013009,"Block 3009, Block Group 3, Census Tract 2014.01, Napa County, California",0,0,0
1000000US060552014013010,060552014013010,"Block 3010, Block Group 3, Census Tract 2014.01, Napa County, California",0,0,0
1000000US060552014013011,060552014013011,"Block 3011, Block Group 3, Census Tract 2014.01, Napa County, California",6,4,2
1000000US060552014013012,060552014013012,"Block 3012, Block Group 3, Census Tract 2014.01, Napa County, California",14,12,2
1000000US060552014013013,060552014013013,"Block 3013, Block Group 3, Census Tract 2014.01, Napa County, California",59,46,13
1000000US060552014013014,060552014013014,"Block 3014, Block Group 3, Census Tract 2014.01, Napa County, California",102,83,19
1000000US060552014013015,060552014013015,"Block 3015, Block Group 3, Census Tract 2014.01, Napa County, California",50,45,5
1000000US060552014013016,060552014013016,"Block 3016, Block Group 3, Census Tract 2014.01, Napa County, California",19,14,5
1000000US060552014013017,060552014013017,"Block 3017, Block Group 3, Census Tract 2014.01, Napa County, California",0,0,0
1000000US060552014021000,060552014021000,"Block 1000, Block Group 1, Census Tract 2014.02, Napa County, California",251,230,21
1000000US060552014021001,060552014021001,"Block 1001, Block Group 1, Census Tract 2014.02, Napa County, California",9,8,1
1000000US060552014021002,060552014021002,"Block 1002, Block Group 1, Census Tract 2014.02, Napa County, California",21,21,0
1000000US060552014021003,060552014021003,"Block 1003, Block Group 1, Census Tract 2014.02, Napa County, California",9,8,1
1000000US060552014021004,060552014021004,"Block 1004, Block Group 1, Census Tract 2014.02, Napa County, California",10,10,0
1000000US060552014021005,060552014021005,"Block 1005, Block Group 1, Census Tract 2014.02, Napa County, California",23,20,3
1000000US060552014021006,060552014021006,"Block 1006, Block Group 1, Census Tract 2014.02, Napa County, California",0,0,0
1000000US060552014021007,060552014021007,"Block 1007, Block Group 1, Census Tract 2014.02, Napa County, California",0,0,0
1000000US060552014021008,060552014021008,"Block 1008, Block Group 1, Census Tract 2014.02, Napa County, California",0,0,0
1000000US060552014022000,060552014022000,"Block 2000, Block Group 2, Census Tract 2014.02, Napa County, California",67,61,6
1000000US060552014022001,060552014022001,"Block 2001, Block Group 2, Census Tract 2014.02, Napa County, California",31,30,1
1000000US060552014022002,060552014022002,"Block 2002, Block Group 2, Census Tract 2014.02, Napa County, California",0,0,0
1000000US060552014022003,060552014022003,"Block 2003, Block Group 2, Census Tract 2014.02, Napa County, California",98,81,17
1000000US060552014022004,060552014022004,"Block 2004, Block Group 2, Census Tract 2014.02, Napa County, California",0,0,0
1000000US060552014022005,060552014022005,"Block 2005, Block Group 2, Census Tract 2014.02, Napa County, California",84,79,5
1000000US060552014022006,060552014022006,"Block 2006, Block Group 2, Census Tract 2014.02, Napa County, California",57,49,8
1000000US060552014023000,060552014023000,"Block 3000, Block Group 3, Census Tract 2014.02, Napa County, California",11,10,1
1000000US060552014023001,060552014023001,"Block 3001, Block Group 3, Census Tract 2014.02, Napa County, California",0,0,0
1000000US060552014023002,060552014023002,"Block 3002, Block Group 3, Census Tract 2014.02, Napa County, California",302,270,32
1000000US060552014023003,060552014023003,"Block 3003, Block Group 3, Census Tract 2014.02, Napa County, California",44,42,2
1000000US060552014023004,060552014023004,"Block 3004, Block Group 3, Census Tract 2014.02, Napa County, California",251,227,24
1000000US060552014023005,060552014023005,"Block 3005, Block Group 3, Census Tract 2014.02, Napa County, California",0,0,0
1000000US060552014023006,060552014023006,"Block 3006, Block Group 3, Census Tract 2014.02, Napa County, California",0,0,0
1000000US060552014023007,060552014023007,"Block 3007, Block Group 3, Census Tract 2014.02, Napa County, California",5,4,1
1000000US060552014031000,060552014031000,"Block 1000, Block Group 1, Census Tract 2014.03, Napa County, California",20,14,6
1000000US060552014031001,060552014031001,"Block 1001, Block Group 1, Census Tract 2014.03, Napa County, California",0,0,0
1000000US060552014031002,060552014031002,"Block 1002, Block Group 1, Census Tract 2014.03, Napa County, California",0,0,0
1000000US060552014031003,060552014031003,"Block 1003, Block Group 1, Census Tract 2014.03, Napa County, California",0,0,0
1000000US060552014031004,060552014031004,"Block 1004, Block Group 1, Census Tract 2014.03, Napa County, California",0,0,0
1000000US060552014031005,060552014031005,"Block 1005, Block Group 1, Census Tract 2014.03, Napa County, California",0,0,0
1000000US060552014031006,060552014031006,"Block 1006, Block Group 1, Census Tract 2014.03, Napa County, California",35,32,3
1000000US060552014031007,060552014031007,"Block 1007, Block Group 1, Census Tract 2014.03, Napa County, California",0,0,0
1000000US060552014031008,060552014031008,"Block 1008, Block Group 1, Census Tract 2014.03, Napa County, California",0,0,0
1000000US060552014031009,060552014031009,"Block 1009, Block Group 1, Census Tract 2014.03, Napa County, California",0,0,0
1000000US060552014031010,060552014031010,"Block 1010, Block Group 1, Census Tract 2014.03, Napa County, California",0,0,0
1000000US060552014031011,060552014031011,"Block 1011, Block Group 1, Census Tract 2014.03, Napa County, California",0,0,0
1000000US060552014031012,060552014031012,"Block 1012, Block Group 1, Census Tract 2014.03, Napa County, California",0,0,0
1000000US060552014031013,060552014031013,"Block 1013, Block Group 1, Census Tract 2014.03, Napa County, California",6,6,0
1000000US060552014031014,060552014031014,"Block 1014, Block Group 1, Census Tract 2014.03, Napa County, California",0,0,0
1000000US060552014031015,060552014031015,"Block 1015, Block Group 1, Census Tract 2014.03, Napa County, California",27,19,8
1000000US060552014031016,060552014031016,"Block 1016, Block Group 1, Census Tract 2014.03, Napa County, California",3,1,2
1000000US060552014031017,060552014031017,"Block 1017, Block Group 1, Census Tract 2014.03, Napa County, California",0,0,0
1000000US060552014031018,060552014031018,"Block 1018, Block Group 1, Census Tract 2014.03, Napa County, California",0,0,0
1000000US060552014031019,060552014031019,"Block 1019, Block Group 1, Census Tract 2014.03, Napa County, California",0,0,0
1000000US060552014031020,060552014031020,"Block 1020, Block Group 1, Census Tract 2014.03, Napa County, California",0,0,0
1000000US060552014031021,060552014031021,"Block 1021, Block Group 1, Census Tract 2014.03, Napa County, California",0,0,0
1000000US060552014031022,060552014031022,"Block 1022, Block Group 1, Census Tract 2014.03, Napa County, California",0,0,0
1000000US060552014031023,060552014031023,"Block 1023, Block Group 1, Census Tract 2014.03, Napa County, California",36,29,7
1000000US060552014031024,060552014031024,"Block 1024, Block Group 1, Census Tract 2014.03, Napa County, California",0,0,0
1000000US060552014031025,060552014031025,"Block 1025, Block Group 1, Census Tract 2014.03, Napa County, California",0,0,0
1000000US060552014031026,060552014031026,"Block 1026, Block Group 1, Census Tract 2014.03, Napa County, California",0,0,0
1000000US060552014031027,060552014031027,"Block 1027, Block Group 1, Census Tract 2014.03, Napa County, California",60,54,6
1000000US060552014031028,060552014031028,"Block 1028, Block Group 1, Census Tract 2014.03, Napa County, California",0,0,0
1000000US060552014031029,060552014031029,"Block 1029, Block Group 1, Census Tract 2014.03, Napa County, California",0,0,0
1000000US060552014031030,060552014031030,"Block 1030, Block Group 1, Census Tract 2014.03, Napa County, California",0,0,0
1000000US060552014031031,060552014031031,"Block 1031, Block Group 1, Census Tract 2014.03, Napa County, California",0,0,0
1000000US060552014031032,060552014031032,"Block 1032, Block Group 1, Census Tract 2014.03, Napa County, California",0,0,0
1000000US060552014031033,060552014031033,"Block 1033, Block Group 1, Census Tract 2014.03, Napa County, California",0,0,0
1000000US060552014031034,060552014031034,"Block 1034, Block Group 1, Census Tract 2014.03, Napa County, California",0,0,0
1000000US060552014031035,060552014031035,"Block 1035, Block Group 1, Census Tract 2014.03, Napa County, California",18,14,4
1000000US060552014031036,060552014031036,"Block 1036, Block Group 1, Census Tract 2014.03, Napa County, California",4,4,0
1000000US060552014031037,060552014031037,"Block 1037, Block Group 1, Census Tract 2014.03, Napa County, California",0,0,0
1000000US060552014031038,060552014031038,"Block 1038, Block Group 1, Census Tract 2014.03, Napa County, California",0,0,0
1000000US060552014031039,060552014031039,"Block 1039, Block Group 1, Census Tract 2014.03, Napa County, California",0,0,0
1000000US060552014032000,060552014032000,"Block 2000, Block Group 2, Census Tract 2014.03, Napa County, California",6,5,1
1000000US060552014032001,060552014032001,"Block 2001, Block Group 2, Census Tract 2014.03, Napa County, California",0,0,0
1000000US060552014032002,060552014032002,"Block 2002, Block Group 2, Census Tract 2014.03, Napa County, California",2,0,2
1000000US060552014032003,060552014032003,"Block 2003, Block Group 2, Census Tract 2014.03, Napa County, California",0,0,0
1000000US060552014032004,060552014032004,"Block 2004, Block Group 2, Census Tract 2014.03, Napa County, California",14,12,2
1000000US060552014032005,060552014032005,"Block 2005, Block Group 2, Census Tract 2014.03, Napa County, California",5,2,3
1000000US060552014032006,060552014032006,"Block 2006, Block Group 2, Census Tract 2014.03, Napa County, California",0,0,0
1000000US060552014032007,060552014032007,"Block 2007, Block Group 2, Census Tract 2014.03, Napa County, California",5,4,1
1000000US060552014032008,060552014032008,"Block 2008, Block Group 2, Census Tract 2014.03, Napa County, California",35,24,11
1000000US060552014032009,060552014032009,"Block 2009, Block Group 2, Census Tract 2014.03, Napa County, California",1,1,0
1000000US060552014032010,060552014032010,"Block 2010, Block Group 2, Census Tract 2014.03, Napa County, California",11,11,0
1000000US060552014032011,060552014032011,"Block 2011, Block Group 2, Census Tract 2014.03, Napa County, California",0,0,0
1000000US060552014032012,060552014032012,"Block 2012, Block Group 2, Census Tract 2014.03, Napa County, California",2,2,0
1000000US060552014032013,060552014032013,"Block 2013, Block Group 2, Census Tract 2014.03, Napa County, California",28,22,6
1000000US060552014032014,060552014032014,"Block 2014, Block Group 2, Census Tract 2014.03, Napa County, California",0,0,0
1000000US060552014032015,060552014032015,"Block 2015, Block Group 2, Census Tract 2014.03, Napa County, California",0,0,0
1000000US060552014032016,060552014032016,"Block 2016, Block Group 2, Census Tract 2014.03, Napa County, California",0,0,0
1000000US060552014032017,060552014032017,"Block 2017, Block Group 2, Census Tract 2014.03, Napa County, California",22,20,2
1000000US060552014032018,060552014032018,"Block 2018, Block Group 2, Census Tract 2014.03, Napa County, California",0,0,0
1000000US060552014032019,060552014032019,"Block 2019, Block Group 2, Census Tract 2014.03, Napa County, California",5,5,0
1000000US060552014032020,060552014032020,"Block 2020, Block Group 2, Census Tract 2014.03, Napa County, California",2,2,0
1000000US060552014032021,060552014032021,"Block 2021, Block Group 2, Census Tract 2014.03, Napa County, California",3,3,0
1000000US060552014032022,060552014032022,"Block 2022, Block Group 2, Census Tract 2014.03, Napa County, California",15,15,0
1000000US060552014032023,060552014032023,"Block 2023, Block Group 2, Census Tract 2014.03, Napa County, California",14,11,3
1000000US060552015001000,060552015001000,"Block 1000, Block Group 1, Census Tract 2015, Napa County, California",8,3,5
1000000US060552015001001,060552015001001,"Block 1001, Block Group 1, Census Tract 2015, Napa County, California",12,5,7
1000000US060552015001002,060552015001002,"Block 1002, Block Group 1, Census Tract 2015, Napa County, California",6,4,2
1000000US060552015001003,060552015001003,"Block 1003, Block Group 1, Census Tract 2015, Napa County, California",13,8,5
1000000US060552015001004,060552015001004,"Block 1004, Block Group 1, Census Tract 2015, Napa County, California",11,8,3
1000000US060552015001005,060552015001005,"Block 1005, Block Group 1, Census Tract 2015, Napa County, California",33,26,7
1000000US060552015001006,060552015001006,"Block 1006, Block Group 1, Census Tract 2015, Napa County, California",3,1,2
1000000US060552015001007,060552015001007,"Block 1007, Block Group 1, Census Tract 2015, Napa County, California",30,26,4
1000000US060552015001008,060552015001008,"Block 1008, Block Group 1, Census Tract 2015, Napa County, California",0,0,0
1000000US060552015001009,060552015001009,"Block 1009, Block Group 1, Census Tract 2015, Napa County, California",3,3,0
1000000US060552015001010,060552015001010,"Block 1010, Block Group 1, Census Tract 2015, Napa County, California",0,0,0
1000000US060552015001011,060552015001011,"Block 1011, Block Group 1, Census Tract 2015, Napa County, California",19,14,5
1000000US060552015001012,060552015001012,"Block 1012, Block Group 1, Census Tract 2015, Napa County, California",123,91,32
1000000US060552015001013,060552015001013,"Block 1013, Block Group 1, Census Tract 2015, Napa County, California",0,0,0
1000000US060552015001014,060552015001014,"Block 1014, Block Group 1, Census Tract 2015, Napa County, California",32,19,13
1000000US060552015001015,060552015001015,"Block 1015, Block Group 1, Census Tract 2015, Napa County, California",0,0,0
1000000US060552015001016,060552015001016,"Block 1016, Block Group 1, Census Tract 2015, Napa County, California",0,0,0
1000000US060552015001017,060552015001017,"Block 1017, Block Group 1, Census Tract 2015, Napa County, California",0,0,0
1000000US060552015001018,060552015001018,"Block 1018, Block Group 1, Census Tract 2015, Napa County, California",7,3,4
1000000US060552015001019,060552015001019,"Block 1019, Block Group 1, Census Tract 2015, Napa County, California",11,10,1
1000000US060552015001020,060552015001020,"Block 1020, Block Group 1, Census Tract 2015, Napa County, California",0,0,0
1000000US060552015001021,060552015001021,"Block 1021, Block Group 1, Census Tract 2015, Napa County, California",25,22,3
1000000US060552015001022,060552015001022,"Block 1022, Block Group 1, Census Tract 2015, Napa County, California",2,2,0
1000000US060552015001023,060552015001023,"Block 1023, Block Group 1, Census Tract 2015, Napa County, California",11,7,4
1000000US060552015001024,060552015001024,"Block 1024, Block Group 1, Census Tract 2015, Napa County, California",0,0,0
1000000US060552015001025,060552015001025,"Block 1025, Block Group 1, Census Tract 2015, Napa County, California",61,38,23
1000000US060552015001026,060552015001026,"Block 1026, Block Group 1, Census Tract 2015, Napa County, California",40,24,16
1000000US060552015001027,060552015001027,"Block 1027, Block Group 1, Census Tract 2015, Napa County, California",33,23,10
1000000US060552015001028,060552015001028,"Block 1028, Block Group 1, Census Tract 2015, Napa County, California",13,7,6
1000000US060552015001029,060552015001029,"Block 1029, Block Group 1, Census Tract 2015, Napa County, California",3,3,0
1000000US060552015001030,060552015001030,"Block 1030, Block Group 1, Census Tract 2015, Napa County, California",1,1,0
1000000US060552015001031,060552015001031,"Block 1031, Block Group 1, Census Tract 2015, Napa County, California",11,7,4
1000000US060552015001032,060552015001032,"Block 1032, Block Group 1, Census Tract 2015, Napa County, California",3,3,0
1000000US060552015001033,060552015001033,"Block 1033, Block Group 1, Census Tract 2015, Napa County, California",0,0,0
1000000US060552015001034,060552015001034,"Block 1034, Block Group 1, Census Tract 2015, Napa County, California",0,0,0
1000000US060552015001035,060552015001035,"Block 1035, Block Group 1, Census Tract 2015, Napa County, California",0,0,0
1000000US060552015001036,060552015001036,"Block 1036, Block Group 1, Census Tract 2015, Napa County, California",20,15,5
1000000US060552015001037,060552015001037,"Block 1037, Block Group 1, Census Tract 2015, Napa County, California",14,10,4
1000000US060552015001038,060552015001038,"Block 1038, Block Group 1, Census Tract 2015, Napa County, California",11,7,4
1000000US060552015001039,060552015001039,"Block 1039, Block Group 1, Census Tract 2015, Napa County, California",0,0,0
1000000US060552015001040,060552015001040,"Block 1040, Block Group 1, Census Tract 2015, Napa County, California",9,6,3
1000000US060552015001041,060552015001041,"Block 1041, Block Group 1, Census Tract 2015, Napa County, California",1,1,0
1000000US060552015001042,060552015001042,"Block 1042, Block Group 1, Census Tract 2015, Napa County, California",62,30,32
1000000US060552015001043,060552015001043,"Block 1043, Block Group 1, Census Tract 2015, Napa County, California",4,0,4
1000000US060552015001044,060552015001044,"Block 1044, Block Group 1, Census Tract 2015, Napa County, California",3,2,1
1000000US060552015001045,060552015001045,"Block 1045, Block Group 1, Census Tract 2015, Napa County, California",6,1,5
1000000US060552015001046,060552015001046,"Block 1046, Block Group 1, Census Tract 2015, Napa County, California",5,4,1
1000000US060552015001047,060552015001047,"Block 1047, Block Group 1, Census Tract 2015, Napa County, California",6,0,6
1000000US060552015001048,060552015001048,"Block 1048, Block Group 1, Census Tract 2015, Napa County, California",0,0,0
1000000US060552015001049,060552015001049,"Block 1049, Block Group 1, Census Tract 2015, Napa County, California",5,2,3
1000000US060552015001050,060552015001050,"Block 1050, Block Group 1, Census Tract 2015, Napa County, California",1,1,0
1000000US060552015001051,060552015001051,"Block 1051, Block Group 1, Census Tract 2015, Napa County, California",0,0,0
1000000US060552015001052,060552015001052,"Block 1052, Block Group 1, Census Tract 2015, Napa County, California",3,2,1
1000000US060552015001053,060552015001053,"Block 1053, Block Group 1, Census Tract 2015, Napa County, California",8,6,2
1000000US060552015001054,060552015001054,"Block 1054, Block Group 1, Census Tract 2015, Napa County, California",4,1,3
1000000US060552015001055,060552015001055,"Block 1055, Block Group 1, Census Tract 2015, Napa County, California",9,6,3
1000000US060552015001056,060552015001056,"Block 1056, Block Group 1, Census Tract 2015, Napa County, California",0,0,0
1000000US060552015001057,060552015001057,"Block 1057, Block Group 1, Census Tract 2015, Napa County, California",4,4,0
1000000US060552015001058,060552015001058,"Block 1058, Block Group 1, Census Tract 2015, Napa County, California",0,0,0
1000000US060552015002000,060552015002000,"Block 2000, Block Group 2, Census Tract 2015, Napa County, California",36,22,14
1000000US060552015002001,060552015002001,"Block 2001, Block Group 2, Census Tract 2015, Napa County, California",10,10,0
1000000US060552015002002,060552015002002,"Block 2002, Block Group 2, Census Tract 2015, Napa County, California",0,0,0
1000000US060552015002003,060552015002003,"Block 2003, Block Group 2, Census Tract 2015, Napa County, California",9,9,0
1000000US060552015002004,060552015002004,"Block 2004, Block Group 2, Census Tract 2015, Napa County, California",10,10,0
1000000US060552015002005,060552015002005,"Block 2005, Block Group 2, Census Tract 2015, Napa County, California",11,10,1
1000000US060552015002006,060552015002006,"Block 2006, Block Group 2, Census Tract 2015, Napa County, California",11,10,1
1000000US060552015002007,060552015002007,"Block 2007, Block Group 2, Census Tract 2015, Napa County, California",26,22,4
1000000US060552015002008,060552015002008,"Block 2008, Block Group 2, Census Tract 2015, Napa County, California",0,0,0
1000000US060552015002009,060552015002009,"Block 2009, Block Group 2, Census Tract 2015, Napa County, California",0,0,0
1000000US060552015002010,060552015002010,"Block 2010, Block Group 2, Census Tract 2015, Napa County, California",21,21,0
1000000US060552015002011,060552015002011,"Block 2011, Block Group 2, Census Tract 2015, Napa County, California",60,42,18
1000000US060552015002012,060552015002012,"Block 2012, Block Group 2, Census Tract 2015, Napa County, California",10,10,0
1000000US060552015002013,060552015002013,"Block 2013, Block Group 2, Census Tract 2015, Napa County, California",3,3,0
1000000US060552015002014,060552015002014,"Block 2014, Block Group 2, Census Tract 2015, Napa County, California",0,0,0
1000000US060552015002015,060552015002015,"Block 2015, Block Group 2, Census Tract 2015, Napa County, California",9,7,2
1000000US060552015002016,060552015002016,"Block 2016, Block Group 2, Census Tract 2015, Napa County, California",0,0,0
1000000US060552015002017,060552015002017,"Block 2017, Block Group 2, Census Tract 2015, Napa County, California",11,10,1
1000000US060552015002018,060552015002018,"Block 2018, Block Group 2, Census Tract 2015, Napa County, California",0,0,0
1000000US060552015002019,060552015002019,"Block 2019, Block Group 2, Census Tract 2015, Napa County, California",0,0,0
1000000US060552015002020,060552015002020,"Block 2020, Block Group 2, Census Tract 2015, Napa County, California",33,16,17
1000000US060552015002021,060552015002021,"Block 2021, Block Group 2, Census Tract 2015, Napa County, California",1,1,0
1000000US060552015002022,060552015002022,"Block 2022, Block Group 2, Census Tract 2015, Napa County, California",7,4,3
1000000US060552015002023,060552015002023,"Block 2023, Block Group 2, Census Tract 2015, Napa County, California",6,5,1
1000000US060552015002024,060552015002024,"Block 2024, Block Group 2, Census Tract 2015, Napa County, California",24,20,4
1000000US060552015002025,060552015002025,"Block 2025, Block Group 2, Census Tract 2015, Napa County, California",21,16,5
1000000US060552015002026,060552015002026,"Block 2026, Block Group 2, Census Tract 2015, Napa County, California",0,0,0
1000000US060552015002027,060552015002027,"Block 2027, Block Group 2, Census Tract 2015, Napa County, California",0,0,0
1000000US060552015002028,060552015002028,"Block 2028, Block Group 2, Census Tract 2015, Napa County, California",26,18,8
1000000US060552015002029,060552015002029,"Block 2029, Block Group 2, Census Tract 2015, Napa County, California",53,40,13
1000000US060552015002030,060552015002030,"Block 2030, Block Group 2, Census Tract 2015, Napa County, California",0,0,0
1000000US060552015002031,060552015002031,"Block 2031, Block Group 2, Census Tract 2015, Napa County, California",17,13,4
1000000US060552015002032,060552015002032,"Block 2032, Block Group 2, Census Tract 2015, Napa County, California",2,1,1
1000000US060552015002033,060552015002033,"Block 2033, Block Group 2, Census Tract 2015, Napa County, California",2,0,2
1000000US060552015002034,060552015002034,"Block 2034, Block Group 2, Census Tract 2015, Napa County, California",0,0,0
1000000US060552015002035,060552015002035,"Block 2035, Block Group 2, Census Tract 2015, Napa County, California",16,10,6
1000000US060552015002036,060552015002036,"Block 2036, Block Group 2, Census Tract 2015, Napa County, California",0,0,0
1000000US060552016011000,060552016011000,"Block 1000, Block Group 1, Census Tract 2016.01, Napa County, California",0,0,0
1000000US060552016011001,060552016011001,"Block 1001, Block Group 1, Census Tract 2016.01, Napa County, California",89,85,4
1000000US060552016011002,060552016011002,"Block 1002, Block Group 1, Census Tract 2016.01, Napa County, California",2,1,1
1000000US060552016011003,060552016011003,"Block 1003, Block Group 1, Census Tract 2016.01, Napa County, California",17,16,1
1000000US060552016011004,060552016011004,"Block 1004, Block Group 1, Census Tract 2016.01, Napa County, California",31,24,7
1000000US060552016011005,060552016011005,"Block 1005, Block Group 1, Census Tract 2016.01, Napa County, California",55,47,8
1000000US060552016011006,060552016011006,"Block 1006, Block Group 1, Census Tract 2016.01, Napa County, California",16,12,4
1000000US060552016011007,060552016011007,"Block 1007, Block Group 1, Census Tract 2016.01, Napa County, California",0,0,0
1000000US060552016011008,060552016011008,"Block 1008, Block Group 1, Census Tract 2016.01, Napa County, California",1,0,1
1000000US060552016011009,060552016011009,"Block 1009, Block Group 1, Census Tract 2016.01, Napa County, California",27,22,5
1000000US060552016011010,060552016011010,"Block 1010, Block Group 1, Census Tract 2016.01, Napa County, California",30,28,2
1000000US060552016011011,060552016011011,"Block 1011, Block Group 1, Census Tract 2016.01, Napa County, California",87,78,9
1000000US060552016011012,060552016011012,"Block 1012, Block Group 1, Census Tract 2016.01, Napa County, California",21,20,1
1000000US060552016011013,060552016011013,"Block 1013, Block Group 1, Census Tract 2016.01, Napa County, California",19,18,1
1000000US060552016011014,060552016011014,"Block 1014, Block Group 1, Census Tract 2016.01, Napa County, California",40,37,3
1000000US060552016011015,060552016011015,"Block 1015, Block Group 1, Census Tract 2016.01, Napa County, California",13,10,3
1000000US060552016011016,060552016011016,"Block 1016, Block Group 1, Census Tract 2016.01, Napa County, California",0,0,0
1000000US060552016012000,060552016012000,"Block 2000, Block Group 2, Census Tract 2016.01, Napa County, California",1,1,0
1000000US060552016012001,060552016012001,"Block 2001, Block Group 2, Census Tract 2016.01, Napa County, California",13,10,3
1000000US060552016012002,060552016012002,"Block 2002, Block Group 2, Census Tract 2016.01, Napa County, California",2,2,0
1000000US060552016012003,060552016012003,"Block 2003, Block Group 2, Census Tract 2016.01, Napa County, California",6,4,2
1000000US060552016012004,060552016012004,"Block 2004, Block Group 2, Census Tract 2016.01, Napa County, California",0,0,0
1000000US060552016012005,060552016012005,"Block 2005, Block Group 2, Census Tract 2016.01, Napa County, California",1,1,0
1000000US060552016012006,060552016012006,"Block 2006, Block Group 2, Census Tract 2016.01, Napa County, California",272,224,48
1000000US060552016012007,060552016012007,"Block 2007, Block Group 2, Census Tract 2016.01, Napa County, California",53,41,12
1000000US060552016012008,060552016012008,"Block 2008, Block Group 2, Census Tract 2016.01, Napa County, California",10,7,3
1000000US060552016012009,060552016012009,"Block 2009, Block Group 2, Census Tract 2016.01, Napa County, California",1,0,1
1000000US060552016012010,060552016012010,"Block 2010, Block Group 2, Census Tract 2016.01, Napa County, California",0,0,0
1000000US060552016012011,060552016012011,"Block 2011, Block Group 2, Census Tract 2016.01, Napa County, California",43,35,8
1000000US060552016012012,060552016012012,"Block 2012, Block Group 2, Census Tract 2016.01, Napa County, California",0,0,0
1000000US060552016012013,060552016012013,"Block 2013, Block Group 2, Census Tract 2016.01, Napa County, California",16,14,2
1000000US060552016012014,060552016012014,"Block 2014, Block Group 2, Census Tract 2016.01, Napa County, California",0,0,0
1000000US060552016012015,060552016012015,"Block 2015, Block Group 2, Census Tract 2016.01, Napa County, California",5,5,0
1000000US060552016012016,060552016012016,"Block 2016, Block Group 2, Census Tract 2016.01, Napa County, California",0,0,0
1000000US060552016012017,060552016012017,"Block 2017, Block Group 2, Census Tract 2016.01, Napa County, California",0,0,0
1000000US060552016012018,060552016012018,"Block 2018, Block Group 2, Census Tract 2016.01, Napa County, California",19,18,1
1000000US060552016012019,060552016012019,"Block 2019, Block Group 2, Census Tract 2016.01, Napa County, California",7,5,2
1000000US060552016012020,060552016012020,"Block 2020, Block Group 2, Census Tract 2016.01, Napa County, California",34,30,4
1000000US060552016012021,060552016012021,"Block 2021, Block Group 2, Census Tract 2016.01, Napa County, California",51,49,2
1000000US060552016012022,060552016012022,"Block 2022, Block Group 2, Census Tract 2016.01, Napa County, California",2,2,0
1000000US060552016012023,060552016012023,"Block 2023, Block Group 2, Census Tract 2016.01, Napa County, California",20,17,3
1000000US060552016012024,060552016012024,"Block 2024, Block Group 2, Census Tract 2016.01, Napa County, California",23,20,3
1000000US060552016012025,060552016012025,"Block 2025, Block Group 2, Census Tract 2016.01, Napa County, California",0,0,0
1000000US060552016012026,060552016012026,"Block 2026, Block Group 2, Census Tract 2016.01, Napa County, California",0,0,0
1000000US060552016012027,060552016012027,"Block 2027, Block Group 2, Census Tract 2016.01, Napa County, California",0,0,0
1000000US060552016021000,060552016021000,"Block 1000, Block Group 1, Census Tract 2016.02, Napa County, California",11,11,0
1000000US060552016021001,060552016021001,"Block 1001, Block Group 1, Census Tract 2016.02, Napa County, California",203,179,24
1000000US060552016021002,060552016021002,"Block 1002, Block Group 1, Census Tract 2016.02, Napa County, California",1,1,0
1000000US060552016021003,060552016021003,"Block 1003, Block Group 1, Census Tract 2016.02, Napa County, California",0,0,0
1000000US060552016021004,060552016021004,"Block 1004, Block Group 1, Census Tract 2016.02, Napa County, California",18,15,3
1000000US060552016021005,060552016021005,"Block 1005, Block Group 1, Census Tract 2016.02, Napa County, California",20,16,4
1000000US060552016021006,060552016021006,"Block 1006, Block Group 1, Census Tract 2016.02, Napa County, California",23,20,3
1000000US060552016021007,060552016021007,"Block 1007, Block Group 1, Census Tract 2016.02, Napa County, California",53,50,3
1000000US060552016021008,060552016021008,"Block 1008, Block Group 1, Census Tract 2016.02, Napa County, California",28,21,7
1000000US060552016021009,060552016021009,"Block 1009, Block Group 1, Census Tract 2016.02, Napa County, California",14,11,3
1000000US060552016021010,060552016021010,"Block 1010, Block Group 1, Census Tract 2016.02, Napa County, California",26,20,6
1000000US060552016021011,060552016021011,"Block 1011, Block Group 1, Census Tract 2016.02, Napa County, California",35,31,4
1000000US060552016021012,060552016021012,"Block 1012, Block Group 1, Census Tract 2016.02, Napa County, California",53,51,2
1000000US060552016021013,060552016021013,"Block 1013, Block Group 1, Census Tract 2016.02, Napa County, California",12,12,0
1000000US060552016022000,060552016022000,"Block 2000, Block Group 2, Census Tract 2016.02, Napa County, California",18,14,4
1000000US060552016022001,060552016022001,"Block 2001, Block Group 2, Census Tract 2016.02, Napa County, California",3,3,0
1000000US060552016022002,060552016022002,"Block 2002, Block Group 2, Census Tract 2016.02, Napa County, California",2,1,1
1000000US060552016022003,060552016022003,"Block 2003, Block Group 2, Census Tract 2016.02, Napa County, California",30,26,4
1000000US060552016022004,060552016022004,"Block 2004, Block Group 2, Census Tract 2016.02, Napa County, California",62,59,3
1000000US060552016022005,060552016022005,"Block 2005, Block Group 2, Census Tract 2016.02, Napa County, California",32,31,1
1000000US060552016022006,060552016022006,"Block 2006, Block Group 2, Census Tract 2016.02, Napa County, California",37,34,3
1000000US060552016022007,060552016022007,"Block 2007, Block Group 2, Census Tract 2016.02, Napa County, California",66,55,11
1000000US060552016022008,060552016022008,"Block 2008, Block Group 2, Census Tract 2016.02, Napa County, California",34,28,6
1000000US060552016022009,060552016022009,"Block 2009, Block Group 2, Census Tract 2016.02, Napa County, California",14,14,0
1000000US060552016023000,060552016023000,"Block 3000, Block Group 3, Census Tract 2016.02, Napa County, California",0,0,0
1000000US060552016023001,060552016023001,"Block 3001, Block Group 3, Census Tract 2016.02, Napa County, California",29,19,10
1000000US060552016023002,060552016023002,"Block 3002, Block Group 3, Census Tract 2016.02, Napa County, California",0,0,0
1000000US060552016023003,060552016023003,"Block 3003, Block Group 3, Census Tract 2016.02, Napa County, California",0,0,0
1000000US060552016023004,060552016023004,"Block 3004, Block Group 3, Census Tract 2016.02, Napa County, California",2,2,0
1000000US060552016023005,060552016023005,"Block 3005, Block Group 3, Census Tract 2016.02, Napa County, California",9,8,1
1000000US060552016023006,060552016023006,"Block 3006, Block Group 3, Census Tract 2016.02, Napa County, California",9,9,0
1000000US060552016023007,060552016023007,"Block 3007, Block Group 3, Census Tract 2016.02, Napa County, California",8,6,2
1000000US060552016023008,060552016023008,"Block 3008, Block Group 3, Census Tract 2016.02, Napa County, California",2,1,1
1000000US060552016023009,060552016023009,"Block 3009, Block Group 3, Census Tract 2016.02, Napa County, California",20,17,3
1000000US060552016023010,060552016023010,"Block 3010, Block Group 3, Census Tract 2016.02, Napa County, California",0,0,0
1000000US060552016023011,060552016023011,"Block 3011, Block Group 3, Census Tract 2016.02, Napa County, California",10,8,2
1000000US060552016023012,060552016023012,"Block 3012, Block Group 3, Census Tract 2016.02, Napa County, California",10,9,1
1000000US060552016023013,060552016023013,"Block 3013, Block Group 3, Census Tract 2016.02, Napa County, California",14,13,1
1000000US060552016023014,060552016023014,"Block 3014, Block Group 3, Census Tract 2016.02, Napa County, California",46,37,9
1000000US060552016023015,060552016023015,"Block 3015, Block Group 3, Census Tract 2016.02, Napa County, California",12,12,0
1000000US060552016023016,060552016023016,"Block 3016, Block Group 3, Census Tract 2016.02, Napa County, California",19,15,4
1000000US060552016023017,060552016023017,"Block 3017, Block Group 3, Census Tract 2016.02, Napa County, California",10,7,3
1000000US060552016023018,060552016023018,"Block 3018, Block Group 3, Census Tract 2016.02, Napa County, California",1,1,0
1000000US060552016023019,060552016023019,"Block 3019, Block Group 3, Census Tract 2016.02, Napa County, California",0,0,0
1000000US060552016023020,060552016023020,"Block 3020, Block Group 3, Census Tract 2016.02, Napa County, California",0,0,0
1000000US060552016023021,060552016023021,"Block 3021, Block Group 3, Census Tract 2016.02, Napa County, California",1,1,0
1000000US060552016023022,060552016023022,"Block 3022, Block Group 3, Census Tract 2016.02, Napa County, California",28,23,5
1000000US060552016023023,060552016023023,"Block 3023, Block Group 3, Census Tract 2016.02, Napa County, California",34,23,11
1000000US060552016023024,060552016023024,"Block 3024, Block Group 3, Census Tract 2016.02, Napa County, California",25,18,7
1000000US060552016023025,060552016023025,"Block 3025, Block Group 3, Census Tract 2016.02, Napa County, California",28,23,5
1000000US060552016023026,060552016023026,"Block 3026, Block Group 3, Census Tract 2016.02, Napa County, California",19,18,1
1000000US060552016024000,060552016024000,"Block 4000, Block Group 4, Census Tract 2016.02, Napa County, California",237,211,26
1000000US060552016024001,060552016024001,"Block 4001, Block Group 4, Census Tract 2016.02, Napa County, California",15,15,0
1000000US060552016024002,060552016024002,"Block 4002, Block Group 4, Census Tract 2016.02, Napa County, California",138,129,9
1000000US060552016024003,060552016024003,"Block 4003, Block Group 4, Census Tract 2016.02, Napa County, California",0,0,0
1000000US060552016024004,060552016024004,"Block 4004, Block Group 4, Census Tract 2016.02, Napa County, California",114,93,21
1000000US060552016024005,060552016024005,"Block 4005, Block Group 4, Census Tract 2016.02, Napa County, California",54,42,12
1000000US060552016024006,060552016024006,"Block 4006, Block Group 4, Census Tract 2016.02, Napa County, California",24,24,0
1000000US060552016024007,060552016024007,"Block 4007, Block Group 4, Census Tract 2016.02, Napa County, California",4,4,0
1000000US060552016024008,060552016024008,"Block 4008, Block Group 4, Census Tract 2016.02, Napa County, California",32,27,5
1000000US060552017001000,060552017001000,"Block 1000, Block Group 1, Census Tract 2017, Napa County, California",9,7,2
1000000US060552017001001,060552017001001,"Block 1001, Block Group 1, Census Tract 2017, Napa County, California",0,0,0
1000000US060552017001002,060552017001002,"Block 1002, Block Group 1, Census Tract 2017, Napa County, California",0,0,0
1000000US060552017001003,060552017001003,"Block 1003, Block Group 1, Census Tract 2017, Napa County, California",9,7,2
1000000US060552017001004,060552017001004,"Block 1004, Block Group 1, Census Tract 2017, Napa County, California",105,82,23
1000000US060552017001005,060552017001005,"Block 1005, Block Group 1, Census Tract 2017, Napa County, California",0,0,0
1000000US060552017001006,060552017001006,"Block 1006, Block Group 1, Census Tract 2017, Napa County, California",0,0,0
1000000US060552017001007,060552017001007,"Block 1007, Block Group 1, Census Tract 2017, Napa County, California",8,3,5
1000000US060552017001008,060552017001008,"Block 1008, Block Group 1, Census Tract 2017, Napa County, California",57,31,26
1000000US060552017001009,060552017001009,"Block 1009, Block Group 1, Census Tract 2017, Napa County, California",0,0,0
1000000US060552017001010,060552017001010,"Block 1010, Block Group 1, Census Tract 2017, Napa County, California",0,0,0
1000000US060552017001011,060552017001011,"Block 1011, Block Group 1, Census Tract 2017, Napa County, California",2,2,0
1000000US060552017001012,060552017001012,"Block 1012, Block Group 1, Census Tract 2017, Napa County, California",0,0,0
1000000US060552017001013,060552017001013,"Block 1013, Block Group 1, Census Tract 2017, Napa County, California",27,21,6
1000000US060552017001014,060552017001014,"Block 1014, Block Group 1, Census Tract 2017, Napa County, California",0,0,0
1000000US060552017001015,060552017001015,"Block 1015, Block Group 1, Census Tract 2017, Napa County, California",0,0,0
1000000US060552017001016,060552017001016,"Block 1016, Block Group 1, Census Tract 2017, Napa County, California",45,27,18
1000000US060552017001017,060552017001017,"Block 1017, Block Group 1, Census Tract 2017, Napa County, California",0,0,0
1000000US060552017001018,060552017001018,"Block 1018, Block Group 1, Census Tract 2017, Napa County, California",2,2,0
1000000US060552017001019,060552017001019,"Block 1019, Block Group 1, Census Tract 2017, Napa County, California",1,1,0
1000000US060552017001020,060552017001020,"Block 1020, Block Group 1, Census Tract 2017, Napa County, California",0,0,0
1000000US060552017001021,060552017001021,"Block 1021, Block Group 1, Census Tract 2017, Napa County, California",0,0,0
1000000US060552017001022,060552017001022,"Block 1022, Block Group 1, Census Tract 2017, Napa County, California",0,0,0
1000000US060552017001023,060552017001023,"Block 1023, Block Group 1, Census Tract 2017, Napa County, California",9,5,4
1000000US060552017001024,060552017001024,"Block 1024, Block Group 1, Census Tract 2017, Napa County, California",0,0,0
1000000US060552017001025,060552017001025,"Block 1025, Block Group 1, Census Tract 2017, Napa County, California",28,23,5
1000000US060552017001026,060552017001026,"Block 1026, Block Group 1, Census Tract 2017, Napa County, California",8,8,0
1000000US060552017001027,060552017001027,"Block 1027, Block Group 1, Census Tract 2017, Napa County, California",0,0,0
1000000US060552017001028,060552017001028,"Block 1028, Block Group 1, Census Tract 2017, Napa County, California",0,0,0
1000000US060552017001029,060552017001029,"Block 1029, Block Group 1, Census Tract 2017, Napa County, California",19,14,5
1000000US060552017001030,060552017001030,"Block 1030, Block Group 1, Census Tract 2017, Napa County, California",0,0,0
1000000US060552017001031,060552017001031,"Block 1031, Block Group 1, Census Tract 2017, Napa County, California",0,0,0
1000000US060552017001032,060552017001032,"Block 1032, Block Group 1, Census Tract 2017, Napa County, California",0,0,0
1000000US060552017001033,060552017001033,"Block 1033, Block Group 1, Census Tract 2017, Napa County, California",0,0,0
1000000US060552017002000,060552017002000,"Block 2000, Block Group 2, Census Tract 2017, Napa County, California",114,107,7
1000000US060552017002001,060552017002001,"Block 2001, Block Group 2, Census Tract 2017, Napa County, California",36,35,1
1000000US060552017002002,060552017002002,"Block 2002, Block Group 2, Census Tract 2017, Napa County, California",96,92,4
1000000US060552017002003,060552017002003,"Block 2003, Block Group 2, Census Tract 2017, Napa County, California",2,2,0
1000000US060552017002004,060552017002004,"Block 2004, Block Group 2, Census Tract 2017, Napa County, California",0,0,0
1000000US060552017002005,060552017002005,"Block 2005, Block Group 2, Census Tract 2017, Napa County, California",0,0,0
1000000US060552017002006,060552017002006,"Block 2006, Block Group 2, Census Tract 2017, Napa County, California",4,4,0
1000000US060552017002007,060552017002007,"Block 2007, Block Group 2, Census Tract 2017, Napa County, California",1,1,0
1000000US060552017002008,060552017002008,"Block 2008, Block Group 2, Census Tract 2017, Napa County, California",5,5,0
1000000US060552017002009,060552017002009,"Block 2009, Block Group 2, Census Tract 2017, Napa County, California",47,44,3
1000000US060552017002010,060552017002010,"Block 2010, Block Group 2, Census Tract 2017, Napa County, California",64,53,11
1000000US060552017002011,060552017002011,"Block 2011, Block Group 2, Census Tract 2017, Napa County, California",1,1,0
1000000US060552017002012,060552017002012,"Block 2012, Block Group 2, Census Tract 2017, Napa County, California",11,10,1
1000000US060552017002013,060552017002013,"Block 2013, Block Group 2, Census Tract 2017, Napa County, California",0,0,0
1000000US060552017003000,060552017003000,"Block 3000, Block Group 3, Census Tract 2017, Napa County, California",76,71,5
1000000US060552017003001,060552017003001,"Block 3001, Block Group 3, Census Tract 2017, Napa County, California",0,0,0
1000000US060552017003002,060552017003002,"Block 3002, Block Group 3, Census Tract 2017, Napa County, California",14,11,3
1000000US060552017003003,060552017003003,"Block 3003, Block Group 3, Census Tract 2017, Napa County, California",133,118,15
1000000US060552017003004,060552017003004,"Block 3004, Block Group 3, Census Tract 2017, Napa County, California",0,0,0
1000000US060552017003005,060552017003005,"Block 3005, Block Group 3, Census Tract 2017, Napa County, California",47,40,7
1000000US060552017003006,060552017003006,"Block 3006, Block Group 3, Census Tract 2017, Napa County, California",102,92,10
1000000US060552017003007,060552017003007,"Block 3007, Block Group 3, Census Tract 2017, Napa County, California",0,0,0
1000000US060552017004000,060552017004000,"Block 4000, Block Group 4, Census Tract 2017, Napa County, California",25,23,2
1000000US060552017004001,060552017004001,"Block 4001, Block Group 4, Census Tract 2017, Napa County, California",0,0,0
1000000US060552017004002,060552017004002,"Block 4002, Block Group 4, Census Tract 2017, Napa County, California",0,0,0
1000000US060552017004003,060552017004003,"Block 4003, Block Group 4, Census Tract 2017, Napa County, California",3,3,0
1000000US060552017004004,060552017004004,"Block 4004, Block Group 4, Census Tract 2017, Napa County, California",30,21,9
1000000US060552017004005,060552017004005,"Block 4005, Block Group 4, Census Tract 2017, Napa County, California",11,11,0
1000000US060552017004006,060552017004006,"Block 4006, Block Group 4, Census Tract 2017, Napa County, California",20,16,4
1000000US060552017004007,060552017004007,"Block 4007, Block Group 4, Census Tract 2017, Napa County, California",10,9,1
1000000US060552017004008,060552017004008,"Block 4008, Block Group 4, Census Tract 2017, Napa County, California",0,0,0
1000000US060552017004009,060552017004009,"Block 4009, Block Group 4, Census Tract 2017, Napa County, California",0,0,0
1000000US060552017004010,060552017004010,"Block 4010, Block Group 4, Census Tract 2017, Napa County, California",1,1,0
1000000US060552017004011,060552017004011,"Block 4011, Block Group 4, Census Tract 2017, Napa County, California",0,0,0
1000000US060552017004012,060552017004012,"Block 4012, Block Group 4, Census Tract 2017, Napa County, California",0,0,0
1000000US060552017004013,060552017004013,"Block 4013, Block Group 4, Census Tract 2017, Napa County, California",0,0,0
1000000US060552017004014,060552017004014,"Block 4014, Block Group 4, Census Tract 2017, Napa County, California",29,23,6
1000000US060552017004015,060552017004015,"Block 4015, Block Group 4, Census Tract 2017, Napa County, California",12,0,12
1000000US060552017004016,060552017004016,"Block 4016, Block Group 4, Census Tract 2017, Napa County, California",0,0,0
1000000US060552017004017,060552017004017,"Block 4017, Block Group 4, Census Tract 2017, Napa County, California",6,0,6
1000000US060552017004018,060552017004018,"Block 4018, Block Group 4, Census Tract 2017, Napa County, California",5,0,5
1000000US060552017004019,060552017004019,"Block 4019, Block Group 4, Census Tract 2017, Napa County, California",2,0,2
1000000US060552017004020,060552017004020,"Block 4020, Block Group 4, Census Tract 2017, Napa County, California",0,0,0
1000000US060552017004021,060552017004021,"Block 4021, Block Group 4, Census Tract 2017, Napa County, California",36,28,8
1000000US060552017004022,060552017004022,"Block 4022, Block Group 4, Census Tract 2017, Napa County, California",114,95,19
1000000US060552017004023,060552017004023,"Block 4023, Block Group 4, Census Tract 2017, Napa County, California",25,23,2
1000000US060552017004024,060552017004024,"Block 4024, Block Group 4, Census Tract 2017, Napa County, California",0,0,0
1000000US060552017004025,060552017004025,"Block 4025, Block Group 4, Census Tract 2017, Napa County, California",0,0,0
1000000US060552017004026,060552017004026,"Block 4026, Block Group 4, Census Tract 2017, Napa County, California",0,0,0
1000000US060552017004027,060552017004027,"Block 4027, Block Group 4, Census Tract 2017, Napa County, California",0,0,0
1000000US060552017004028,060552017004028,"Block 4028, Block Group 4, Census Tract 2017, Napa County, California",4,4,0
1000000US060552017004029,060552017004029,"Block 4029, Block Group 4, Census Tract 2017, Napa County, California",1,1,0
1000000US060552017004030,060552017004030,"Block 4030, Block Group 4, Census Tract 2017, Napa County, California",2,2,0
1000000US060552017004031,060552017004031,"Block 4031, Block Group 4, Census Tract 2017, Napa County, California",2,1,1
1000000US060552017004032,060552017004032,"Block 4032, Block Group 4, Census Tract 2017, Napa County, California",0,0,0
1000000US060552017004033,060552017004033,"Block 4033, Block Group 4, Census Tract 2017, Napa County, California",0,0,0
1000000US060552017004034,060552017004034,"Block 4034, Block Group 4, Census Tract 2017, Napa County, California",0,0,0
1000000US060552017004035,060552017004035,"Block 4035, Block Group 4, Census Tract 2017, Napa County, California",10,10,0
1000000US060552017004036,060552017004036,"Block 4036, Block Group 4, Census Tract 2017, Napa County, California",0,0,0
1000000US060552017004037,060552017004037,"Block 4037, Block Group 4, Census Tract 2017, Napa County, California",19,15,4
1000000US060552017004038,060552017004038,"Block 4038, Block Group 4, Census Tract 2017, Napa County, California",0,0,0
1000000US060552017004039,060552017004039,"Block 4039, Block Group 4, Census Tract 2017, Napa County, California",0,0,0
1000000US060552017004040,060552017004040,"Block 4040, Block Group 4, Census Tract 2017, Napa County, California",0,0,0
1000000US060552017004041,060552017004041,"Block 4041, Block Group 4, Census Tract 2017, Napa County, California",32,26,6
1000000US060552017004042,060552017004042,"Block 4042, Block Group 4, Census Tract 2017, Napa County, California",8,5,3
1000000US060552017004043,060552017004043,"Block 4043, Block Group 4, Census Tract 2017, Napa County, California",6,3,3
1000000US060552017004044,060552017004044,"Block 4044, Block Group 4, Census Tract 2017, Napa County, California",34,32,2
1000000US060552017004045,060552017004045,"Block 4045, Block Group 4, Census Tract 2017, Napa County, California",0,0,0
1000000US060552017005000,060552017005000,"Block 5000, Block Group 5, Census Tract 2017, Napa County, California",38,33,5
1000000US060552017005001,060552017005001,"Block 5001, Block Group 5, Census Tract 2017, Napa County, California",14,11,3
1000000US060552017005002,060552017005002,"Block 5002, Block Group 5, Census Tract 2017, Napa County, California",121,98,23
1000000US060552017005003,060552017005003,"Block 5003, Block Group 5, Census Tract 2017, Napa County, California",54,51,3
1000000US060552017005004,060552017005004,"Block 5004, Block Group 5, Census Tract 2017, Napa County, California",0,0,0
1000000US060552017005005,060552017005005,"Block 5005, Block Group 5, Census Tract 2017, Napa County, California",21,15,6
1000000US060552017005006,060552017005006,"Block 5006, Block Group 5, Census Tract 2017, Napa County, California",1,0,1
1000000US060552017005007,060552017005007,"Block 5007, Block Group 5, Census Tract 2017, Napa County, California",0,0,0
1000000US060552017005008,060552017005008,"Block 5008, Block Group 5, Census Tract 2017, Napa County, California",9,8,1
1000000US060552017005009,060552017005009,"Block 5009, Block Group 5, Census Tract 2017, Napa County, California",19,17,2
1000000US060552017005010,060552017005010,"Block 5010, Block Group 5, Census Tract 2017, Napa County, California",19,18,1
1000000US060552017005011,060552017005011,"Block 5011, Block Group 5, Census Tract 2017, Napa County, California",24,21,3
1000000US060552017006000,060552017006000,"Block 6000, Block Group 6, Census Tract 2017, Napa County, California",13,10,3
1000000US060552017006001,060552017006001,"Block 6001, Block Group 6, Census Tract 2017, Napa County, California",29,20,9
1000000US060552017006002,060552017006002,"Block 6002, Block Group 6, Census Tract 2017, Napa County, California",15,12,3
1000000US060552017006003,060552017006003,"Block 6003, Block Group 6, Census Tract 2017, Napa County, California",10,8,2
1000000US060552017006004,060552017006004,"Block 6004, Block Group 6, Census Tract 2017, Napa County, California",14,11,3
1000000US060552017006005,060552017006005,"Block 6005, Block Group 6, Census Tract 2017, Napa County, California",163,130,33
1000000US060552017006006,060552017006006,"Block 6006, Block Group 6, Census Tract 2017, Napa County, California",4,4,0
1000000US060552017006007,060552017006007,"Block 6007, Block Group 6, Census Tract 2017, Napa County, California",11,10,1
1000000US060552017006008,060552017006008,"Block 6008, Block Group 6, Census Tract 2017, Napa County, California",6,2,4
1000000US060552017006009,060552017006009,"Block 6009, Block Group 6, Census Tract 2017, Napa County, California",3,3,0
1000000US060552017006010,060552017006010,"Block 6010, Block Group 6, Census Tract 2017, Napa County, California",20,17,3
1000000US060552017006011,060552017006011,"Block 6011, Block Group 6, Census Tract 2017, Napa County, California",15,13,2
1000000US060552017006012,060552017006012,"Block 6012, Block Group 6, Census Tract 2017, Napa County, California",3,3,0
1000000US060552017006013,060552017006013,"Block 6013, Block Group 6, Census Tract 2017, Napa County, California",6,6,0
1000000US060552017006014,060552017006014,"Block 6014, Block Group 6, Census Tract 2017, Napa County, California",21,17,4
1000000US060552018001000,060552018001000,"Block 1000, Block Group 1, Census Tract 2018, Napa County, California",13,6,7
1000000US060552018001001,060552018001001,"Block 1001, Block Group 1, Census Tract 2018, Napa County, California",0,0,0
1000000US060552018001002,060552018001002,"Block 1002, Block Group 1, Census Tract 2018, Napa County, California",0,0,0
1000000US060552018001003,060552018001003,"Block 1003, Block Group 1, Census Tract 2018, Napa County, California",0,0,0
1000000US060552018001004,060552018001004,"Block 1004, Block Group 1, Census Tract 2018, Napa County, California",1,0,1
1000000US060552018001005,060552018001005,"Block 1005, Block Group 1, Census Tract 2018, Napa County, California",0,0,0
1000000US060552018001006,060552018001006,"Block 1006, Block Group 1, Census Tract 2018, Napa County, California",1,0,1
1000000US060552018001007,060552018001007,"Block 1007, Block Group 1, Census Tract 2018, Napa County, California",0,0,0
1000000US060552018001008,060552018001008,"Block 1008, Block Group 1, Census Tract 2018, Napa County, California",0,0,0
1000000US060552018001009,060552018001009,"Block 1009, Block Group 1, Census Tract 2018, Napa County, California",0,0,0
1000000US060552018001010,060552018001010,"Block 1010, Block Group 1, Census Tract 2018, Napa County, California",0,0,0
1000000US060552018001011,060552018001011,"Block 1011, Block Group 1, Census Tract 2018, Napa County, California",0,0,0
1000000US060552018001012,060552018001012,"Block 1012, Block Group 1, Census Tract 2018, Napa County, California",0,0,0
1000000US060552018001013,060552018001013,"Block 1013, Block Group 1, Census Tract 2018, Napa County, California",0,0,0
1000000US060552018001014,060552018001014,"Block 1014, Block Group 1, Census Tract 2018, Napa County, California",0,0,0
1000000US060552018001015,060552018001015,"Block 1015, Block Group 1, Census Tract 2018, Napa County, California",0,0,0
1000000US060552018001016,060552018001016,"Block 1016, Block Group 1, Census Tract 2018, Napa County, California",0,0,0
1000000US060552018001017,060552018001017,"Block 1017, Block Group 1, Census Tract 2018, Napa County, California",0,0,0
1000000US060552018001018,060552018001018,"Block 1018, Block Group 1, Census Tract 2018, Napa County, California",0,0,0
1000000US060552018001019,060552018001019,"Block 1019, Block Group 1, Census Tract 2018, Napa County, California",0,0,0
1000000US060552018001020,060552018001020,"Block 1020, Block Group 1, Census Tract 2018, Napa County, California",0,0,0
1000000US060552018001021,060552018001021,"Block 1021, Block Group 1, Census Tract 2018, Napa County, California",0,0,0
1000000US060552018001022,060552018001022,"Block 1022, Block Group 1, Census Tract 2018, Napa County, California",2,2,0
1000000US060552018001023,060552018001023,"Block 1023, Block Group 1, Census Tract 2018, Napa County, California",0,0,0
1000000US060552018001024,060552018001024,"Block 1024, Block Group 1, Census Tract 2018, Napa County, California",0,0,0
1000000US060552018001025,060552018001025,"Block 1025, Block Group 1, Census Tract 2018, Napa County, California",0,0,0
1000000US060552018001026,060552018001026,"Block 1026, Block Group 1, Census Tract 2018, Napa County, California",0,0,0
1000000US060552018001027,060552018001027,"Block 1027, Block Group 1, Census Tract 2018, Napa County, California",0,0,0
1000000US060552018001028,060552018001028,"Block 1028, Block Group 1, Census Tract 2018, Napa County, California",0,0,0
1000000US060552018001029,060552018001029,"Block 1029, Block Group 1, Census Tract 2018, Napa County, California",0,0,0
1000000US060552018001030,060552018001030,"Block 1030, Block Group 1, Census Tract 2018, Napa County, California",0,0,0
1000000US060552018001031,060552018001031,"Block 1031, Block Group 1, Census Tract 2018, Napa County, California",0,0,0
1000000US060552018001032,060552018001032,"Block 1032, Block Group 1, Census Tract 2018, Napa County, California",0,0,0
1000000US060552018001033,060552018001033,"Block 1033, Block Group 1, Census Tract 2018, Napa County, California",0,0,0
1000000US060552018001034,060552018001034,"Block 1034, Block Group 1, Census Tract 2018, Napa County, California",0,0,0
1000000US060552018001035,060552018001035,"Block 1035, Block Group 1, Census Tract 2018, Napa County, California",0,0,0
1000000US060552018001036,060552018001036,"Block 1036, Block Group 1, Census Tract 2018, Napa County, California",0,0,0
1000000US060552018001037,060552018001037,"Block 1037, Block Group 1, Census Tract 2018, Napa County, California",0,0,0
1000000US060552018001038,060552018001038,"Block 1038, Block Group 1, Census Tract 2018, Napa County, California",0,0,0
1000000US060552018001039,060552018001039,"Block 1039, Block Group 1, Census Tract 2018, Napa County, California",0,0,0
1000000US060552018001040,060552018001040,"Block 1040, Block Group 1, Census Tract 2018, Napa County, California",0,0,0
1000000US060552018001041,060552018001041,"Block 1041, Block Group 1, Census Tract 2018, Napa County, California",0,0,0
1000000US060552018001042,060552018001042,"Block 1042, Block Group 1, Census Tract 2018, Napa County, California",1,1,0
1000000US060552018001043,060552018001043,"Block 1043, Block Group 1, Census Tract 2018, Napa County, California",0,0,0
1000000US060552018001044,060552018001044,"Block 1044, Block Group 1, Census Tract 2018, Napa County, California",0,0,0
1000000US060552018001045,060552018001045,"Block 1045, Block Group 1, Census Tract 2018, Napa County, California",0,0,0
1000000US060552018001046,060552018001046,"Block 1046, Block Group 1, Census Tract 2018, Napa County, California",0,0,0
1000000US060552018001047,060552018001047,"Block 1047, Block Group 1, Census Tract 2018, Napa County, California",0,0,0
1000000US060552018001048,060552018001048,"Block 1048, Block Group 1, Census Tract 2018, Napa County, California",0,0,0
1000000US060552018001049,060552018001049,"Block 1049, Block Group 1, Census Tract 2018, Napa County, California",0,0,0
1000000US060552018001050,060552018001050,"Block 1050, Block Group 1, Census Tract 2018, Napa County, California",0,0,0
1000000US060552018001051,060552018001051,"Block 1051, Block Group 1, Census Tract 2018, Napa County, California",0,0,0
1000000US060552018001052,060552018001052,"Block 1052, Block Group 1, Census Tract 2018, Napa County, California",0,0,0
1000000US060552018001053,060552018001053,"Block 1053, Block Group 1, Census Tract 2018, Napa County, California",3,1,2
1000000US060552018001054,060552018001054,"Block 1054, Block Group 1, Census Tract 2018, Napa County, California",20,8,12
1000000US060552018001055,060552018001055,"Block 1055, Block Group 1, Census Tract 2018, Napa County, California",6,2,4
1000000US060552018001056,060552018001056,"Block 1056, Block Group 1, Census Tract 2018, Napa County, California",0,0,0
1000000US060552018001057,060552018001057,"Block 1057, Block Group 1, Census Tract 2018, Napa County, California",0,0,0
1000000US060552018001058,060552018001058,"Block 1058, Block Group 1, Census Tract 2018, Napa County, California",0,0,0
1000000US060552018001059,060552018001059,"Block 1059, Block Group 1, Census Tract 2018, Napa County, California",0,0,0
1000000US060552018001060,060552018001060,"Block 1060, Block Group 1, Census Tract 2018, Napa County, California",0,0,0
1000000US060552018001061,060552018001061,"Block 1061, Block Group 1, Census Tract 2018, Napa County, California",59,49,10
1000000US060552018001062,060552018001062,"Block 1062, Block Group 1, Census Tract 2018, Napa County, California",0,0,0
1000000US060552018001063,060552018001063,"Block 1063, Block Group 1, Census Tract 2018, Napa County, California",0,0,0
1000000US060552018001064,060552018001064,"Block 1064, Block Group 1, Census Tract 2018, Napa County, California",17,13,4
1000000US060552018001065,060552018001065,"Block 1065, Block Group 1, Census Tract 2018, Napa County, California",0,0,0
1000000US060552018001066,060552018001066,"Block 1066, Block Group 1, Census Tract 2018, Napa County, California",0,0,0
1000000US060552018001067,060552018001067,"Block 1067, Block Group 1, Census Tract 2018, Napa County, California",0,0,0
1000000US060552018001068,060552018001068,"Block 1068, Block Group 1, Census Tract 2018, Napa County, California",0,0,0
1000000US060552018001069,060552018001069,"Block 1069, Block Group 1, Census Tract 2018, Napa County, California",0,0,0
1000000US060552018001070,060552018001070,"Block 1070, Block Group 1, Census Tract 2018, Napa County, California",0,0,0
1000000US060552018001071,060552018001071,"Block 1071, Block Group 1, Census Tract 2018, Napa County, California",0,0,0
1000000US060552018001072,060552018001072,"Block 1072, Block Group 1, Census Tract 2018, Napa County, California",0,0,0
1000000US060552018001073,060552018001073,"Block 1073, Block Group 1, Census Tract 2018, Napa County, California",0,0,0
1000000US060552018001074,060552018001074,"Block 1074, Block Group 1, Census Tract 2018, Napa County, California",0,0,0
1000000US060552018001075,060552018001075,"Block 1075, Block Group 1, Census Tract 2018, Napa County, California",1,0,1
1000000US060552018001076,060552018001076,"Block 1076, Block Group 1, Census Tract 2018, Napa County, California",5,3,2
1000000US060552018001077,060552018001077,"Block 1077, Block Group 1, Census Tract 2018, Napa County, California",0,0,0
1000000US060552018001078,060552018001078,"Block 1078, Block Group 1, Census Tract 2018, Napa County, California",9,6,3
1000000US060552018001079,060552018001079,"Block 1079, Block Group 1, Census Tract 2018, Napa County, California",2,2,0
1000000US060552018001080,060552018001080,"Block 1080, Block Group 1, Census Tract 2018, Napa County, California",1,1,0
1000000US060552018001081,060552018001081,"Block 1081, Block Group 1, Census Tract 2018, Napa County, California",0,0,0
1000000US060552018001082,060552018001082,"Block 1082, Block Group 1, Census Tract 2018, Napa County, California",0,0,0
1000000US060552018001083,060552018001083,"Block 1083, Block Group 1, Census Tract 2018, Napa County, California",8,5,3
1000000US060552018001084,060552018001084,"Block 1084, Block Group 1, Census Tract 2018, Napa County, California",2,2,0
1000000US060552018001085,060552018001085,"Block 1085, Block Group 1, Census Tract 2018, Napa County, California",0,0,0
1000000US060552018001086,060552018001086,"Block 1086, Block Group 1, Census Tract 2018, Napa County, California",0,0,0
1000000US060552018001087,060552018001087,"Block 1087, Block Group 1, Census Tract 2018, Napa County, California",23,20,3
1000000US060552018001088,060552018001088,"Block 1088, Block Group 1, Census Tract 2018, Napa County, California",0,0,0
1000000US060552018001089,060552018001089,"Block 1089, Block Group 1, Census Tract 2018, Napa County, California",12,3,9
1000000US060552018001090,060552018001090,"Block 1090, Block Group 1, Census Tract 2018, Napa County, California",0,0,0
1000000US060552018001091,060552018001091,"Block 1091, Block Group 1, Census Tract 2018, Napa County, California",0,0,0
1000000US060552018001092,060552018001092,"Block 1092, Block Group 1, Census Tract 2018, Napa County, California",8,3,5
1000000US060552018001093,060552018001093,"Block 1093, Block Group 1, Census Tract 2018, Napa County, California",0,0,0
1000000US060552018001094,060552018001094,"Block 1094, Block Group 1, Census Tract 2018, Napa County, California",0,0,0
1000000US060552018001095,060552018001095,"Block 1095, Block Group 1, Census Tract 2018, Napa County, California",0,0,0
1000000US060552018001096,060552018001096,"Block 1096, Block Group 1, Census Tract 2018, Napa County, California",0,0,0
1000000US060552018001097,060552018001097,"Block 1097, Block Group 1, Census Tract 2018, Napa County, California",0,0,0
1000000US060552018001098,060552018001098,"Block 1098, Block Group 1, Census Tract 2018, Napa County, California",0,0,0
1000000US060552018001099,060552018001099,"Block 1099, Block Group 1, Census Tract 2018, Napa County, California",0,0,0
1000000US060552018001100,060552018001100,"Block 1100, Block Group 1, Census Tract 2018, Napa County, California",0,0,0
1000000US060552018001101,060552018001101,"Block 1101, Block Group 1, Census Tract 2018, Napa County, California",0,0,0
1000000US060552018001102,060552018001102,"Block 1102, Block Group 1, Census Tract 2018, Napa County, California",0,0,0
1000000US060552018001103,060552018001103,"Block 1103, Block Group 1, Census Tract 2018, Napa County, California",0,0,0
1000000US060552018001104,060552018001104,"Block 1104, Block Group 1, Census Tract 2018, Napa County, California",0,0,0
1000000US060552018001105,060552018001105,"Block 1105, Block Group 1, Census Tract 2018, Napa County, California",0,0,0
1000000US060552018001106,060552018001106,"Block 1106, Block Group 1, Census Tract 2018, Napa County, California",0,0,0
1000000US060552018001107,060552018001107,"Block 1107, Block Group 1, Census Tract 2018, Napa County, California",0,0,0
1000000US060552018001108,060552018001108,"Block 1108, Block Group 1, Census Tract 2018, Napa County, California",0,0,0
1000000US060552018001109,060552018001109,"Block 1109, Block Group 1, Census Tract 2018, Napa County, California",0,0,0
1000000US060552018001110,060552018001110,"Block 1110, Block Group 1, Census Tract 2018, Napa County, California",0,0,0
1000000US060552018001111,060552018001111,"Block 1111, Block Group 1, Census Tract 2018, Napa County, California",0,0,0
1000000US060552018001112,060552018001112,"Block 1112, Block Group 1, Census Tract 2018, Napa County, California",0,0,0
1000000US060552018001113,060552018001113,"Block 1113, Block Group 1, Census Tract 2018, Napa County, California",0,0,0
1000000US060552018001114,060552018001114,"Block 1114, Block Group 1, Census Tract 2018, Napa County, California",0,0,0
1000000US060552018001115,060552018001115,"Block 1115, Block Group 1, Census Tract 2018, Napa County, California",0,0,0
1000000US060552018001116,060552018001116,"Block 1116, Block Group 1, Census Tract 2018, Napa County, California",0,0,0
1000000US060552018001117,060552018001117,"Block 1117, Block Group 1, Census Tract 2018, Napa County, California",0,0,0
1000000US060552018001118,060552018001118,"Block 1118, Block Group 1, Census Tract 2018, Napa County, California",0,0,0
1000000US060552018001119,060552018001119,"Block 1119, Block Group 1, Census Tract 2018, Napa County, California",0,0,0
1000000US060552018001120,060552018001120,"Block 1120, Block Group 1, Census Tract 2018, Napa County, California",0,0,0
1000000US060552018001121,060552018001121,"Block 1121, Block Group 1, Census Tract 2018, Napa County, California",0,0,0
1000000US060552018001122,060552018001122,"Block 1122, Block Group 1, Census Tract 2018, Napa County, California",0,0,0
1000000US060552018001123,060552018001123,"Block 1123, Block Group 1, Census Tract 2018, Napa County, California",0,0,0
1000000US060552018001124,060552018001124,"Block 1124, Block Group 1, Census Tract 2018, Napa County, California",0,0,0
1000000US060552018001125,060552018001125,"Block 1125, Block Group 1, Census Tract 2018, Napa County, California",0,0,0
1000000US060552018001126,060552018001126,"Block 1126, Block Group 1, Census Tract 2018, Napa County, California",0,0,0
1000000US060552018001127,060552018001127,"Block 1127, Block Group 1, Census Tract 2018, Napa County, California",0,0,0
1000000US060552018001128,060552018001128,"Block 1128, Block Group 1, Census Tract 2018, Napa County, California",0,0,0
1000000US060552018001129,060552018001129,"Block 1129, Block Group 1, Census Tract 2018, Napa County, California",0,0,0
1000000US060552018001130,060552018001130,"Block 1130, Block Group 1, Census Tract 2018, Napa County, California",0,0,0
1000000US060552018001131,060552018001131,"Block 1131, Block Group 1, Census Tract 2018, Napa County, California",1,1,0
1000000US060552018001132,060552018001132,"Block 1132, Block Group 1, Census Tract 2018, Napa County, California",0,0,0
1000000US060552018001133,060552018001133,"Block 1133, Block Group 1, Census Tract 2018, Napa County, California",6,5,1
1000000US060552018001134,060552018001134,"Block 1134, Block Group 1, Census Tract 2018, Napa County, California",19,18,1
1000000US060552018001135,060552018001135,"Block 1135, Block Group 1, Census Tract 2018, Napa County, California",0,0,0
1000000US060552018001136,060552018001136,"Block 1136, Block Group 1, Census Tract 2018, Napa County, California",12,10,2
1000000US060552018001137,060552018001137,"Block 1137, Block Group 1, Census Tract 2018, Napa County, California",0,0,0
1000000US060552018001138,060552018001138,"Block 1138, Block Group 1, Census Tract 2018, Napa County, California",9,6,3
1000000US060552018001139,060552018001139,"Block 1139, Block Group 1, Census Tract 2018, Napa County, California",0,0,0
1000000US060552018001140,060552018001140,"Block 1140, Block Group 1, Census Tract 2018, Napa County, California",0,0,0
1000000US060552018001141,060552018001141,"Block 1141, Block Group 1, Census Tract 2018, Napa County, California",2,2,0
1000000US060552018001142,060552018001142,"Block 1142, Block Group 1, Census Tract 2018, Napa County, California",0,0,0
1000000US060552018001143,060552018001143,"Block 1143, Block Group 1, Census Tract 2018, Napa County, California",0,0,0
1000000US060552018001144,060552018001144,"Block 1144, Block Group 1, Census Tract 2018, Napa County, California",45,37,8
1000000US060552018001145,060552018001145,"Block 1145, Block Group 1, Census Tract 2018, Napa County, California",30,16,14
1000000US060552018001146,060552018001146,"Block 1146, Block Group 1, Census Tract 2018, Napa County, California",0,0,0
1000000US060552018001147,060552018001147,"Block 1147, Block Group 1, Census Tract 2018, Napa County, California",0,0,0
1000000US060552018001148,060552018001148,"Block 1148, Block Group 1, Census Tract 2018, Napa County, California",0,0,0
1000000US060552018001149,060552018001149,"Block 1149, Block Group 1, Census Tract 2018, Napa County, California",0,0,0
1000000US060552018001150,060552018001150,"Block 1150, Block Group 1, Census Tract 2018, Napa County, California",0,0,0
1000000US060552018001151,060552018001151,"Block 1151, Block Group 1, Census Tract 2018, Napa County, California",0,0,0
1000000US060552018001152,060552018001152,"Block 1152, Block Group 1, Census Tract 2018, Napa County, California",0,0,0
1000000US060552018001153,060552018001153,"Block 1153, Block Group 1, Census Tract 2018, Napa County, California",0,0,0
1000000US060552018001154,060552018001154,"Block 1154, Block Group 1, Census Tract 2018, Napa County, California",0,0,0
1000000US060552018001155,060552018001155,"Block 1155, Block Group 1, Census Tract 2018, Napa County, California",0,0,0
1000000US060552018001156,060552018001156,"Block 1156, Block Group 1, Census Tract 2018, Napa County, California",0,0,0
1000000US060552018001157,060552018001157,"Block 1157, Block Group 1, Census Tract 2018, Napa County, California",0,0,0
1000000US060552018001158,060552018001158,"Block 1158, Block Group 1, Census Tract 2018, Napa County, California",0,0,0
1000000US060552018001159,060552018001159,"Block 1159, Block Group 1, Census Tract 2018, Napa County, California",0,0,0
1000000US060552018001160,060552018001160,"Block 1160, Block Group 1, Census Tract 2018, Napa County, California",0,0,0
1000000US060552018001161,060552018001161,"Block 1161, Block Group 1, Census Tract 2018, Napa County, California",0,0,0
1000000US060552018001162,060552018001162,"Block 1162, Block Group 1, Census Tract 2018, Napa County, California",0,0,0
1000000US060552018001163,060552018001163,"Block 1163, Block Group 1, Census Tract 2018, Napa County, California",0,0,0
1000000US060552018001164,060552018001164,"Block 1164, Block Group 1, Census Tract 2018, Napa County, California",0,0,0
1000000US060552018001165,060552018001165,"Block 1165, Block Group 1, Census Tract 2018, Napa County, California",0,0,0
1000000US060552018001166,060552018001166,"Block 1166, Block Group 1, Census Tract 2018, Napa County, California",0,0,0
1000000US060552018001167,060552018001167,"Block 1167, Block Group 1, Census Tract 2018, Napa County, California",0,0,0
1000000US060552018001168,060552018001168,"Block 1168, Block Group 1, Census Tract 2018, Napa County, California",0,0,0
1000000US060552018001169,060552018001169,"Block 1169, Block Group 1, Census Tract 2018, Napa County, California",0,0,0
1000000US060552018001170,060552018001170,"Block 1170, Block Group 1, Census Tract 2018, Napa County, California",0,0,0
1000000US060552018001171,060552018001171,"Block 1171, Block Group 1, Census Tract 2018, Napa County, California",0,0,0
1000000US060552018001172,060552018001172,"Block 1172, Block Group 1, Census Tract 2018, Napa County, California",0,0,0
1000000US060552018001173,060552018001173,"Block 1173, Block Group 1, Census Tract 2018, Napa County, California",0,0,0
1000000US060552018001174,060552018001174,"Block 1174, Block Group 1, Census Tract 2018, Napa County, California",0,0,0
1000000US060552018001175,060552018001175,"Block 1175, Block Group 1, Census Tract 2018, Napa County, California",0,0,0
1000000US060552018001176,060552018001176,"Block 1176, Block Group 1, Census Tract 2018, Napa County, California",0,0,0
1000000US060552018001177,060552018001177,"Block 1177, Block Group 1, Census Tract 2018, Napa County, California",0,0,0
1000000US060552018001178,060552018001178,"Block 1178, Block Group 1, Census Tract 2018, Napa County, California",0,0,0
1000000US060552018001179,060552018001179,"Block 1179, Block Group 1, Census Tract 2018, Napa County, California",0,0,0
1000000US060552018001180,060552018001180,"Block 1180, Block Group 1, Census Tract 2018, Napa County, California",0,0,0
1000000US060552018001181,060552018001181,"Block 1181, Block Group 1, Census Tract 2018, Napa County, California",0,0,0
1000000US060552018001182,060552018001182,"Block 1182, Block Group 1, Census Tract 2018, Napa County, California",0,0,0
1000000US060552018001183,060552018001183,"Block 1183, Block Group 1, Census Tract 2018, Napa County, California",0,0,0
1000000US060552018001184,060552018001184,"Block 1184, Block Group 1, Census Tract 2018, Napa County, California",0,0,0
1000000US060552018001185,060552018001185,"Block 1185, Block Group 1, Census Tract 2018, Napa County, California",0,0,0
1000000US060552018001186,060552018001186,"Block 1186, Block Group 1, Census Tract 2018, Napa County, California",1,1,0
1000000US060552018001187,060552018001187,"Block 1187, Block Group 1, Census Tract 2018, Napa County, California",0,0,0
1000000US060552018001188,060552018001188,"Block 1188, Block Group 1, Census Tract 2018, Napa County, California",0,0,0
1000000US060552018001189,060552018001189,"Block 1189, Block Group 1, Census Tract 2018, Napa County, California",44,26,18
1000000US060552018001190,060552018001190,"Block 1190, Block Group 1, Census Tract 2018, Napa County, California",0,0,0
1000000US060552018001191,060552018001191,"Block 1191, Block Group 1, Census Tract 2018, Napa County, California",0,0,0
1000000US060552018001192,060552018001192,"Block 1192, Block Group 1, Census Tract 2018, Napa County, California",0,0,0
1000000US060552018001193,060552018001193,"Block 1193, Block Group 1, Census Tract 2018, Napa County, California",0,0,0
1000000US060552018001194,060552018001194,"Block 1194, Block Group 1, Census Tract 2018, Napa County, California",0,0,0
1000000US060552018001195,060552018001195,"Block 1195, Block Group 1, Census Tract 2018, Napa County, California",0,0,0
1000000US060552018001196,060552018001196,"Block 1196, Block Group 1, Census Tract 2018, Napa County, California",0,0,0
1000000US060552018001197,060552018001197,"Block 1197, Block Group 1, Census Tract 2018, Napa County, California",0,0,0
1000000US060552018001198,060552018001198,"Block 1198, Block Group 1, Census Tract 2018, Napa County, California",0,0,0
1000000US060552018001199,060552018001199,"Block 1199, Block Group 1, Census Tract 2018, Napa County, California",0,0,0
1000000US060552018001200,060552018001200,"Block 1200, Block Group 1, Census Tract 2018, Napa County, California",0,0,0
1000000US060552018001201,060552018001201,"Block 1201, Block Group 1, Census Tract 2018, Napa County, California",0,0,0
1000000US060552018001202,060552018001202,"Block 1202, Block Group 1, Census Tract 2018, Napa County, California",0,0,0
1000000US060552018001203,060552018001203,"Block 1203, Block Group 1, Census Tract 2018, Napa County, California",0,0,0
1000000US060552018001204,060552018001204,"Block 1204, Block Group 1, Census Tract 2018, Napa County, California",1,0,1
1000000US060552018001205,060552018001205,"Block 1205, Block Group 1, Census Tract 2018, Napa County, California",0,0,0
1000000US060552018001206,060552018001206,"Block 1206, Block Group 1, Census Tract 2018, Napa County, California",0,0,0
1000000US060552018001207,060552018001207,"Block 1207, Block Group 1, Census Tract 2018, Napa County, California",0,0,0
1000000US060552018001208,060552018001208,"Block 1208, Block Group 1, Census Tract 2018, Napa County, California",0,0,0
1000000US060552018001209,060552018001209,"Block 1209, Block Group 1, Census Tract 2018, Napa County, California",0,0,0
1000000US060552018001210,060552018001210,"Block 1210, Block Group 1, Census Tract 2018, Napa County, California",0,0,0
1000000US060552018001211,060552018001211,"Block 1211, Block Group 1, Census Tract 2018, Napa County, California",0,0,0
1000000US060552018001212,060552018001212,"Block 1212, Block Group 1, Census Tract 2018, Napa County, California",0,0,0
1000000US060552018001213,060552018001213,"Block 1213, Block Group 1, Census Tract 2018, Napa County, California",0,0,0
1000000US060552018001214,060552018001214,"Block 1214, Block Group 1, Census Tract 2018, Napa County, California",0,0,0
1000000US060552018001215,060552018001215,"Block 1215, Block Group 1, Census Tract 2018, Napa County, California",0,0,0
1000000US060552018001216,060552018001216,"Block 1216, Block Group 1, Census Tract 2018, Napa County, California",0,0,0
1000000US060552018001217,060552018001217,"Block 1217, Block Group 1, Census Tract 2018, Napa County, California",11,6,5
1000000US060552018001218,060552018001218,"Block 1218, Block Group 1, Census Tract 2018, Napa County, California",0,0,0
1000000US060552018001219,060552018001219,"Block 1219, Block Group 1, Census Tract 2018, Napa County, California",0,0,0
1000000US060552018001220,060552018001220,"Block 1220, Block Group 1, Census Tract 2018, Napa County, California",0,0,0
1000000US060552018001221,060552018001221,"Block 1221, Block Group 1, Census Tract 2018, Napa County, California",0,0,0
1000000US060552018001222,060552018001222,"Block 1222, Block Group 1, Census Tract 2018, Napa County, California",0,0,0
1000000US060552018001223,060552018001223,"Block 1223, Block Group 1, Census Tract 2018, Napa County, California",0,0,0
1000000US060552018001224,060552018001224,"Block 1224, Block Group 1, Census Tract 2018, Napa County, California",0,0,0
1000000US060552018001225,060552018001225,"Block 1225, Block Group 1, Census Tract 2018, Napa County, California",0,0,0
1000000US060552018001226,060552018001226,"Block 1226, Block Group 1, Census Tract 2018, Napa County, California",0,0,0
1000000US060552018001227,060552018001227,"Block 1227, Block Group 1, Census Tract 2018, Napa County, California",0,0,0
1000000US060552018001228,060552018001228,"Block 1228, Block Group 1, Census Tract 2018, Napa County, California",0,0,0
1000000US060552018001229,060552018001229,"Block 1229, Block Group 1, Census Tract 2018, Napa County, California",0,0,0
1000000US060552018001230,060552018001230,"Block 1230, Block Group 1, Census Tract 2018, Napa County, California",0,0,0
1000000US060552018001231,060552018001231,"Block 1231, Block Group 1, Census Tract 2018, Napa County, California",0,0,0
1000000US060552018001232,060552018001232,"Block 1232, Block Group 1, Census Tract 2018, Napa County, California",0,0,0
1000000US060552018001233,060552018001233,"Block 1233, Block Group 1, Census Tract 2018, Napa County, California",0,0,0
1000000US060552018001234,060552018001234,"Block 1234, Block Group 1, Census Tract 2018, Napa County, California",2,0,2
1000000US060552018001235,060552018001235,"Block 1235, Block Group 1, Census Tract 2018, Napa County, California",0,0,0
1000000US060552018001236,060552018001236,"Block 1236, Block Group 1, Census Tract 2018, Napa County, California",0,0,0
1000000US060552018001237,060552018001237,"Block 1237, Block Group 1, Census Tract 2018, Napa County, California",0,0,0
1000000US060552018001238,060552018001238,"Block 1238, Block Group 1, Census Tract 2018, Napa County, California",9,8,1
1000000US060552018001239,060552018001239,"Block 1239, Block Group 1, Census Tract 2018, Napa County, California",11,9,2
1000000US060552018001240,060552018001240,"Block 1240, Block Group 1, Census Tract 2018, Napa County, California",0,0,0
1000000US060552018001241,060552018001241,"Block 1241, Block Group 1, Census Tract 2018, Napa County, California",1,1,0
1000000US060552018001242,060552018001242,"Block 1242, Block Group 1, Census Tract 2018, Napa County, California",16,14,2
1000000US060552018001243,060552018001243,"Block 1243, Block Group 1, Census Tract 2018, Napa County, California",13,10,3
1000000US060552018001244,060552018001244,"Block 1244, Block Group 1, Census Tract 2018, Napa County, California",7,4,3
1000000US060552018001245,060552018001245,"Block 1245, Block Group 1, Census Tract 2018, Napa County, California",33,21,12
1000000US060552018001246,060552018001246,"Block 1246, Block Group 1, Census Tract 2018, Napa County, California",20,17,3
1000000US060552018001247,060552018001247,"Block 1247, Block Group 1, Census Tract 2018, Napa County, California",9,6,3
1000000US060552018001248,060552018001248,"Block 1248, Block Group 1, Census Tract 2018, Napa County, California",0,0,0
1000000US060552018001249,060552018001249,"Block 1249, Block Group 1, Census Tract 2018, Napa County, California",41,15,26
1000000US060552018001250,060552018001250,"Block 1250, Block Group 1, Census Tract 2018, Napa County, California",0,0,0
1000000US060552018001251,060552018001251,"Block 1251, Block Group 1, Census Tract 2018, Napa County, California",0,0,0
1000000US060552018001252,060552018001252,"Block 1252, Block Group 1, Census Tract 2018, Napa County, California",0,0,0
1000000US060552018001253,060552018001253,"Block 1253, Block Group 1, Census Tract 2018, Napa County, California",0,0,0
1000000US060552018001254,060552018001254,"Block 1254, Block Group 1, Census Tract 2018, Napa County, California",0,0,0
1000000US060552018001255,060552018001255,"Block 1255, Block Group 1, Census Tract 2018, Napa County, California",0,0,0
1000000US060552018001256,060552018001256,"Block 1256, Block Group 1, Census Tract 2018, Napa County, California",0,0,0
1000000US060552018001257,060552018001257,"Block 1257, Block Group 1, Census Tract 2018, Napa County, California",0,0,0
1000000US060552018001258,060552018001258,"Block 1258, Block Group 1, Census Tract 2018, Napa County, California",0,0,0
1000000US060552018001259,060552018001259,"Block 1259, Block Group 1, Census Tract 2018, Napa County, California",0,0,0
1000000US060552018001260,060552018001260,"Block 1260, Block Group 1, Census Tract 2018, Napa County, California",0,0,0
1000000US060552018001261,060552018001261,"Block 1261, Block Group 1, Census Tract 2018, Napa County, California",0,0,0
1000000US060552018001262,060552018001262,"Block 1262, Block Group 1, Census Tract 2018, Napa County, California",0,0,0
1000000US060552018001263,060552018001263,"Block 1263, Block Group 1, Census Tract 2018, Napa County, California",0,0,0
1000000US060552018001264,060552018001264,"Block 1264, Block Group 1, Census Tract 2018, Napa County, California",0,0,0
1000000US060552018001265,060552018001265,"Block 1265, Block Group 1, Census Tract 2018, Napa County, California",0,0,0
1000000US060552018001266,060552018001266,"Block 1266, Block Group 1, Census Tract 2018, Napa County, California",0,0,0
1000000US060552018001267,060552018001267,"Block 1267, Block Group 1, Census Tract 2018, Napa County, California",0,0,0
1000000US060552018001268,060552018001268,"Block 1268, Block Group 1, Census Tract 2018, Napa County, California",14,8,6
1000000US060552018001269,060552018001269,"Block 1269, Block Group 1, Census Tract 2018, Napa County, California",0,0,0
1000000US060552018001270,060552018001270,"Block 1270, Block Group 1, Census Tract 2018, Napa County, California",0,0,0
1000000US060552018001271,060552018001271,"Block 1271, Block Group 1, Census Tract 2018, Napa County, California",0,0,0
1000000US060552018002000,060552018002000,"Block 2000, Block Group 2, Census Tract 2018, Napa County, California",0,0,0
1000000US060552018002001,060552018002001,"Block 2001, Block Group 2, Census Tract 2018, Napa County, California",109,79,30
1000000US060552018002002,060552018002002,"Block 2002, Block Group 2, Census Tract 2018, Napa County, California",18,12,6
1000000US060552018002003,060552018002003,"Block 2003, Block Group 2, Census Tract 2018, Napa County, California",6,3,3
1000000US060552018002004,060552018002004,"Block 2004, Block Group 2, Census Tract 2018, Napa County, California",8,8,0
1000000US060552018002005,060552018002005,"Block 2005, Block Group 2, Census Tract 2018, Napa County, California",0,0,0
1000000US060552018002006,060552018002006,"Block 2006, Block Group 2, Census Tract 2018, Napa County, California",4,3,1
1000000US060552018002007,060552018002007,"Block 2007, Block Group 2, Census Tract 2018, Napa County, California",2,2,0
1000000US060552018002008,060552018002008,"Block 2008, Block Group 2, Census Tract 2018, Napa County, California",95,75,20
1000000US060552018002009,060552018002009,"Block 2009, Block Group 2, Census Tract 2018, Napa County, California",26,19,7
1000000US060552018002010,060552018002010,"Block 2010, Block Group 2, Census Tract 2018, Napa County, California",90,64,26
1000000US060552018002011,060552018002011,"Block 2011, Block Group 2, Census Tract 2018, Napa County, California",0,0,0
1000000US060552018002012,060552018002012,"Block 2012, Block Group 2, Census Tract 2018, Napa County, California",0,0,0
1000000US060552018002013,060552018002013,"Block 2013, Block Group 2, Census Tract 2018, Napa County, California",0,0,0
1000000US060552018002014,060552018002014,"Block 2014, Block Group 2, Census Tract 2018, Napa County, California",0,0,0
1000000US060552018002015,060552018002015,"Block 2015, Block Group 2, Census Tract 2018, Napa County, California",0,0,0
1000000US060552018002016,060552018002016,"Block 2016, Block Group 2, Census Tract 2018, Napa County, California",26,24,2
1000000US060552018002017,060552018002017,"Block 2017, Block Group 2, Census Tract 2018, Napa County, California",5,4,1
1000000US060552018002018,060552018002018,"Block 2018, Block Group 2, Census Tract 2018, Napa County, California",0,0,0
1000000US060552018002019,060552018002019,"Block 2019, Block Group 2, Census Tract 2018, Napa County, California",0,0,0
1000000US060552018002020,060552018002020,"Block 2020, Block Group 2, Census Tract 2018, Napa County, California",0,0,0
1000000US060552018002021,060552018002021,"Block 2021, Block Group 2, Census Tract 2018, Napa County, California",0,0,0
1000000US060552018002022,060552018002022,"Block 2022, Block Group 2, Census Tract 2018, Napa County, California",2,1,1
1000000US060552018002023,060552018002023,"Block 2023, Block Group 2, Census Tract 2018, Napa County, California",0,0,0
1000000US060552018002024,060552018002024,"Block 2024, Block Group 2, Census Tract 2018, Napa County, California",0,0,0
1000000US060552018002025,060552018002025,"Block 2025, Block Group 2, Census Tract 2018, Napa County, California",0,0,0
1000000US060552018002026,060552018002026,"Block 2026, Block Group 2, Census Tract 2018, Napa County, California",0,0,0
1000000US060552018002027,060552018002027,"Block 2027, Block Group 2, Census Tract 2018, Napa County, California",0,0,0
1000000US060552018002028,060552018002028,"Block 2028, Block Group 2, Census Tract 2018, Napa County, California",0,0,0
1000000US060552018002029,060552018002029,"Block 2029, Block Group 2, Census Tract 2018, Napa County, California",0,0,0
1000000US060552018002030,060552018002030,"Block 2030, Block Group 2, Census Tract 2018, Napa County, California",0,0,0
1000000US060552018002031,060552018002031,"Block 2031, Block Group 2, Census Tract 2018, Napa County, California",2,1,1
1000000US060552018002032,060552018002032,"Block 2032, Block Group 2, Census Tract 2018, Napa County, California",0,0,0
1000000US060552018002033,060552018002033,"Block 2033, Block Group 2, Census Tract 2018, Napa County, California",0,0,0
1000000US060552018002034,060552018002034,"Block 2034, Block Group 2, Census Tract 2018, Napa County, California",31,27,4
1000000US060552018002035,060552018002035,"Block 2035, Block Group 2, Census Tract 2018, Napa County, California",4,3,1
1000000US060552018002036,060552018002036,"Block 2036, Block Group 2, Census Tract 2018, Napa County, California",10,9,1
1000000US060552018002037,060552018002037,"Block 2037, Block Group 2, Census Tract 2018, Napa County, California",21,20,1
1000000US060552018002038,060552018002038,"Block 2038, Block Group 2, Census Tract 2018, Napa County, California",0,0,0
1000000US060552018002039,060552018002039,"Block 2039, Block Group 2, Census Tract 2018, Napa County, California",5,3,2
1000000US060552019001000,060552019001000,"Block 1000, Block Group 1, Census Tract 2019, Napa County, California",21,15,6
1000000US060552019001001,060552019001001,"Block 1001, Block Group 1, Census Tract 2019, Napa County, California",0,0,0
1000000US060552019001002,060552019001002,"Block 1002, Block Group 1, Census Tract 2019, Napa County, California",0,0,0
1000000US060552019001003,060552019001003,"Block 1003, Block Group 1, Census Tract 2019, Napa County, California",0,0,0
1000000US060552019001004,060552019001004,"Block 1004, Block Group 1, Census Tract 2019, Napa County, California",0,0,0
1000000US060552019001005,060552019001005,"Block 1005, Block Group 1, Census Tract 2019, Napa County, California",0,0,0
1000000US060552019001006,060552019001006,"Block 1006, Block Group 1, Census Tract 2019, Napa County, California",0,0,0
1000000US060552019001007,060552019001007,"Block 1007, Block Group 1, Census Tract 2019, Napa County, California",0,0,0
1000000US060552019001008,060552019001008,"Block 1008, Block Group 1, Census Tract 2019, Napa County, California",113,82,31
1000000US060552019001009,060552019001009,"Block 1009, Block Group 1, Census Tract 2019, Napa County, California",0,0,0
1000000US060552019001010,060552019001010,"Block 1010, Block Group 1, Census Tract 2019, Napa County, California",0,0,0
1000000US060552019001011,060552019001011,"Block 1011, Block Group 1, Census Tract 2019, Napa County, California",7,5,2
1000000US060552019001012,060552019001012,"Block 1012, Block Group 1, Census Tract 2019, Napa County, California",7,5,2
1000000US060552019001013,060552019001013,"Block 1013, Block Group 1, Census Tract 2019, Napa County, California",2,1,1
1000000US060552019001014,060552019001014,"Block 1014, Block Group 1, Census Tract 2019, Napa County, California",2,1,1
1000000US060552019001015,060552019001015,"Block 1015, Block Group 1, Census Tract 2019, Napa County, California",0,0,0
1000000US060552019001016,060552019001016,"Block 1016, Block Group 1, Census Tract 2019, Napa County, California",0,0,0
1000000US060552019001017,060552019001017,"Block 1017, Block Group 1, Census Tract 2019, Napa County, California",6,5,1
1000000US060552019001018,060552019001018,"Block 1018, Block Group 1, Census Tract 2019, Napa County, California",33,23,10
1000000US060552019001019,060552019001019,"Block 1019, Block Group 1, Census Tract 2019, Napa County, California",5,4,1
1000000US060552019001020,060552019001020,"Block 1020, Block Group 1, Census Tract 2019, Napa County, California",6,3,3
1000000US060552019001021,060552019001021,"Block 1021, Block Group 1, Census Tract 2019, Napa County, California",0,0,0
1000000US060552019001022,060552019001022,"Block 1022, Block Group 1, Census Tract 2019, Napa County, California",0,0,0
1000000US060552019001023,060552019001023,"Block 1023, Block Group 1, Census Tract 2019, Napa County, California",0,0,0
1000000US060552019001024,060552019001024,"Block 1024, Block Group 1, Census Tract 2019, Napa County, California",3,3,0
1000000US060552019001025,060552019001025,"Block 1025, Block Group 1, Census Tract 2019, Napa County, California",73,51,22
1000000US060552019001026,060552019001026,"Block 1026, Block Group 1, Census Tract 2019, Napa County, California",6,3,3
1000000US060552019001027,060552019001027,"Block 1027, Block Group 1, Census Tract 2019, Napa County, California",0,0,0
1000000US060552019001028,060552019001028,"Block 1028, Block Group 1, Census Tract 2019, Napa County, California",0,0,0
1000000US060552019001029,060552019001029,"Block 1029, Block Group 1, Census Tract 2019, Napa County, California",24,20,4
1000000US060552019001030,060552019001030,"Block 1030, Block Group 1, Census Tract 2019, Napa County, California",5,3,2
1000000US060552019001031,060552019001031,"Block 1031, Block Group 1, Census Tract 2019, Napa County, California",6,5,1
1000000US060552019001032,060552019001032,"Block 1032, Block Group 1, Census Tract 2019, Napa County, California",0,0,0
1000000US060552019001033,060552019001033,"Block 1033, Block Group 1, Census Tract 2019, Napa County, California",0,0,0
1000000US060552019001034,060552019001034,"Block 1034, Block Group 1, Census Tract 2019, Napa County, California",0,0,0
1000000US060552019001035,060552019001035,"Block 1035, Block Group 1, Census Tract 2019, Napa County, California",0,0,0
1000000US060552019001036,060552019001036,"Block 1036, Block Group 1, Census Tract 2019, Napa County, California",1,0,1
1000000US060552019001037,060552019001037,"Block 1037, Block Group 1, Census Tract 2019, Napa County, California",6,6,0
1000000US060552019001038,060552019001038,"Block 1038, Block Group 1, Census Tract 2019, Napa County, California",0,0,0
1000000US060552019001039,060552019001039,"Block 1039, Block Group 1, Census Tract 2019, Napa County, California",27,24,3
1000000US060552019001040,060552019001040,"Block 1040, Block Group 1, Census Tract 2019, Napa County, California",0,0,0
1000000US060552019001041,060552019001041,"Block 1041, Block Group 1, Census Tract 2019, Napa County, California",32,22,10
1000000US060552019001042,060552019001042,"Block 1042, Block Group 1, Census Tract 2019, Napa County, California",4,2,2
1000000US060552019001043,060552019001043,"Block 1043, Block Group 1, Census Tract 2019, Napa County, California",0,0,0
1000000US060552019001044,060552019001044,"Block 1044, Block Group 1, Census Tract 2019, Napa County, California",0,0,0
1000000US060552019001045,060552019001045,"Block 1045, Block Group 1, Census Tract 2019, Napa County, California",2,1,1
1000000US060552019001046,060552019001046,"Block 1046, Block Group 1, Census Tract 2019, Napa County, California",1,1,0
1000000US060552019001047,060552019001047,"Block 1047, Block Group 1, Census Tract 2019, Napa County, California",0,0,0
1000000US060552019002000,060552019002000,"Block 2000, Block Group 2, Census Tract 2019, Napa County, California",3,1,2
1000000US060552019002001,060552019002001,"Block 2001, Block Group 2, Census Tract 2019, Napa County, California",27,14,13
1000000US060552019002002,060552019002002,"Block 2002, Block Group 2, Census Tract 2019, Napa County, California",6,6,0
1000000US060552019002003,060552019002003,"Block 2003, Block Group 2, Census Tract 2019, Napa County, California",1,1,0
1000000US060552019002004,060552019002004,"Block 2004, Block Group 2, Census Tract 2019, Napa County, California",4,3,1
1000000US060552019002005,060552019002005,"Block 2005, Block Group 2, Census Tract 2019, Napa County, California",3,3,0
1000000US060552019002006,060552019002006,"Block 2006, Block Group 2, Census Tract 2019, Napa County, California",74,50,24
1000000US060552019002007,060552019002007,"Block 2007, Block Group 2, Census Tract 2019, Napa County, California",13,12,1
1000000US060552019002008,060552019002008,"Block 2008, Block Group 2, Census Tract 2019, Napa County, California",0,0,0
1000000US060552019002009,060552019002009,"Block 2009, Block Group 2, Census Tract 2019, Napa County, California",46,28,18
1000000US060552019002010,060552019002010,"Block 2010, Block Group 2, Census Tract 2019, Napa County, California",0,0,0
1000000US060552019002011,060552019002011,"Block 2011, Block Group 2, Census Tract 2019, Napa County, California",0,0,0
1000000US060552019002012,060552019002012,"Block 2012, Block Group 2, Census Tract 2019, Napa County, California",0,0,0
1000000US060552019002013,060552019002013,"Block 2013, Block Group 2, Census Tract 2019, Napa County, California",26,18,8
1000000US060552019002014,060552019002014,"Block 2014, Block Group 2, Census Tract 2019, Napa County, California",109,85,24
1000000US060552019002015,060552019002015,"Block 2015, Block Group 2, Census Tract 2019, Napa County, California",29,24,5
1000000US060552019002016,060552019002016,"Block 2016, Block Group 2, Census Tract 2019, Napa County, California",12,6,6
1000000US060552019002017,060552019002017,"Block 2017, Block Group 2, Census Tract 2019, Napa County, California",0,0,0
1000000US060552019002018,060552019002018,"Block 2018, Block Group 2, Census Tract 2019, Napa County, California",0,0,0
1000000US060552019002019,060552019002019,"Block 2019, Block Group 2, Census Tract 2019, Napa County, California",4,1,3
1000000US060552019002020,060552019002020,"Block 2020, Block Group 2, Census Tract 2019, Napa County, California",1,0,1
1000000US060552019002021,060552019002021,"Block 2021, Block Group 2, Census Tract 2019, Napa County, California",3,0,3
1000000US060552019002022,060552019002022,"Block 2022, Block Group 2, Census Tract 2019, Napa County, California",8,4,4
1000000US060552019002023,060552019002023,"Block 2023, Block Group 2, Census Tract 2019, Napa County, California",18,11,7
1000000US060552019002024,060552019002024,"Block 2024, Block Group 2, Census Tract 2019, Napa County, California",0,0,0
1000000US060552019002025,060552019002025,"Block 2025, Block Group 2, Census Tract 2019, Napa County, California",0,0,0
1000000US060552019002026,060552019002026,"Block 2026, Block Group 2, Census Tract 2019, Napa County, California",0,0,0
1000000US060552019002027,060552019002027,"Block 2027, Block Group 2, Census Tract 2019, Napa County, California",6,6,0
1000000US060552020001000,060552020001000,"Block 1000, Block Group 1, Census Tract 2020, Napa County, California",3,2,1
1000000US060552020001001,060552020001001,"Block 1001, Block Group 1, Census Tract 2020, Napa County, California",261,235,26
1000000US060552020001002,060552020001002,"Block 1002, Block Group 1, Census Tract 2020, Napa County, California",27,23,4
1000000US060552020001003,060552020001003,"Block 1003, Block Group 1, Census Tract 2020, Napa County, California",23,17,6
1000000US060552020001004,060552020001004,"Block 1004, Block Group 1, Census Tract 2020, Napa County, California",49,38,11
1000000US060552020001005,060552020001005,"Block 1005, Block Group 1, Census Tract 2020, Napa County, California",69,58,11
1000000US060552020001006,060552020001006,"Block 1006, Block Group 1, Census Tract 2020, Napa County, California",75,71,4
1000000US060552020001007,060552020001007,"Block 1007, Block Group 1, Census Tract 2020, Napa County, California",21,20,1
1000000US060552020001008,060552020001008,"Block 1008, Block Group 1, Census Tract 2020, Napa County, California",2,1,1
1000000US060552020001009,060552020001009,"Block 1009, Block Group 1, Census Tract 2020, Napa County, California",39,36,3
1000000US060552020002000,060552020002000,"Block 2000, Block Group 2, Census Tract 2020, Napa County, California",32,29,3
1000000US060552020002001,060552020002001,"Block 2001, Block Group 2, Census Tract 2020, Napa County, California",97,88,9
1000000US060552020002002,060552020002002,"Block 2002, Block Group 2, Census Tract 2020, Napa County, California",30,29,1
1000000US060552020002003,060552020002003,"Block 2003, Block Group 2, Census Tract 2020, Napa County, California",12,12,0
1000000US060552020002004,060552020002004,"Block 2004, Block Group 2, Census Tract 2020, Napa County, California",21,16,5
1000000US060552020002005,060552020002005,"Block 2005, Block Group 2, Census Tract 2020, Napa County, California",35,32,3
1000000US060552020002006,060552020002006,"Block 2006, Block Group 2, Census Tract 2020, Napa County, California",21,17,4
1000000US060552020002007,060552020002007,"Block 2007, Block Group 2, Census Tract 2020, Napa County, California",9,8,1
1000000US060552020002008,060552020002008,"Block 2008, Block Group 2, Census Tract 2020, Napa County, California",50,45,5
1000000US060552020002009,060552020002009,"Block 2009, Block Group 2, Census Tract 2020, Napa County, California",22,19,3
1000000US060552020002010,060552020002010,"Block 2010, Block Group 2, Census Tract 2020, Napa County, California",54,52,2
1000000US060552020002011,060552020002011,"Block 2011, Block Group 2, Census Tract 2020, Napa County, California",17,14,3
1000000US060552020002012,060552020002012,"Block 2012, Block Group 2, Census Tract 2020, Napa County, California",0,0,0
1000000US060552020003000,060552020003000,"Block 3000, Block Group 3, Census Tract 2020, Napa County, California",9,7,2
1000000US060552020003001,060552020003001,"Block 3001, Block Group 3, Census Tract 2020, Napa County, California",57,42,15
1000000US060552020003002,060552020003002,"Block 3002, Block Group 3, Census Tract 2020, Napa County, California",103,91,12
1000000US060552020003003,060552020003003,"Block 3003, Block Group 3, Census Tract 2020, Napa County, California",20,19,1
1000000US060552020003004,060552020003004,"Block 3004, Block Group 3, Census Tract 2020, Napa County, California",12,10,2
1000000US060552020003005,060552020003005,"Block 3005, Block Group 3, Census Tract 2020, Napa County, California",8,7,1
1000000US060552020003006,060552020003006,"Block 3006, Block Group 3, Census Tract 2020, Napa County, California",23,20,3
1000000US060552020003007,060552020003007,"Block 3007, Block Group 3, Census Tract 2020, Napa County, California",22,17,5
1000000US060552020003008,060552020003008,"Block 3008, Block Group 3, Census Tract 2020, Napa County, California",19,16,3
1000000US060552020003009,060552020003009,"Block 3009, Block Group 3, Census Tract 2020, Napa County, California",10,8,2
1000000US060552020003010,060552020003010,"Block 3010, Block Group 3, Census Tract 2020, Napa County, California",15,15,0
1000000US060552020003011,060552020003011,"Block 3011, Block Group 3, Census Tract 2020, Napa County, California",14,11,3
1000000US060552020003012,060552020003012,"Block 3012, Block Group 3, Census Tract 2020, Napa County, California",15,14,1
1000000US060552020003013,060552020003013,"Block 3013, Block Group 3, Census Tract 2020, Napa County, California",41,36,5
1000000US060552020003014,060552020003014,"Block 3014, Block Group 3, Census Tract 2020, Napa County, California",14,13,1
1000000US060552020003015,060552020003015,"Block 3015, Block Group 3, Census Tract 2020, Napa County, California",18,17,1
1000000US060552020003016,060552020003016,"Block 3016, Block Group 3, Census Tract 2020, Napa County, California",3,2,1
1000000US060552020003017,060552020003017,"Block 3017, Block Group 3, Census Tract 2020, Napa County, California",5,4,1
1000000US060552020003018,060552020003018,"Block 3018, Block Group 3, Census Tract 2020, Napa County, California",46,41,5
1000000US060552020003019,060552020003019,"Block 3019, Block Group 3, Census Tract 2020, Napa County, California",46,43,3
1000000US060552020003020,060552020003020,"Block 3020, Block Group 3, Census Tract 2020, Napa County, California",3,3,0
1000000US060552020003021,060552020003021,"Block 3021, Block Group 3, Census Tract 2020, Napa County, California",5,3,2
1000000US060552020003022,060552020003022,"Block 3022, Block Group 3, Census Tract 2020, Napa County, California",0,0,0
1000000US060552020003023,060552020003023,"Block 3023, Block Group 3, Census Tract 2020, Napa County, California",9,6,3
1000000US060552020003024,060552020003024,"Block 3024, Block Group 3, Census Tract 2020, Napa County, California",22,19,3
1000000US060552020003025,060552020003025,"Block 3025, Block Group 3, Census Tract 2020, Napa County, California",10,9,1
1000000US060552020003026,060552020003026,"Block 3026, Block Group 3, Census Tract 2020, Napa County, California",2,2,0
1000000US060552020003027,060552020003027,"Block 3027, Block Group 3, Census Tract 2020, Napa County, California",6,2,4
1000000US060552020003028,060552020003028,"Block 3028, Block Group 3, Census Tract 2020, Napa County, California",18,14,4
1000000US060552020003029,060552020003029,"Block 3029, Block Group 3, Census Tract 2020, Napa County, California",80,72,8
1000000US060552020003030,060552020003030,"Block 3030, Block Group 3, Census Tract 2020, Napa County, California",5,4,1
1000000US060552020004000,060552020004000,"Block 4000, Block Group 4, Census Tract 2020, Napa County, California",170,145,25
1000000US060552020004001,060552020004001,"Block 4001, Block Group 4, Census Tract 2020, Napa County, California",26,20,6
1000000US060552020004002,060552020004002,"Block 4002, Block Group 4, Census Tract 2020, Napa County, California",15,15,0
1000000US060552020004003,060552020004003,"Block 4003, Block Group 4, Census Tract 2020, Napa County, California",16,15,1
1000000US060552020004004,060552020004004,"Block 4004, Block Group 4, Census Tract 2020, Napa County, California",10,10,0
1000000US060552020004005,060552020004005,"Block 4005, Block Group 4, Census Tract 2020, Napa County, California",26,25,1
1000000US060552020004006,060552020004006,"Block 4006, Block Group 4, Census Tract 2020, Napa County, California",16,15,1
1000000US060552020004007,060552020004007,"Block 4007, Block Group 4, Census Tract 2020, Napa County, California",13,13,0
1000000US060552020004008,060552020004008,"Block 4008, Block Group 4, Census Tract 2020, Napa County, California",14,14,0
1000000US060552020004009,060552020004009,"Block 4009, Block Group 4, Census Tract 2020, Napa County, California",26,21,5
1000000US060552020004010,060552020004010,"Block 4010, Block Group 4, Census Tract 2020, Napa County, California",14,12,2
1000000US060552020004011,060552020004011,"Block 4011, Block Group 4, Census Tract 2020, Napa County, California",24,21,3
1000000US060552020004012,060552020004012,"Block 4012, Block Group 4, Census Tract 2020, Napa County, California",14,10,4
1000000US060552020004013,060552020004013,"Block 4013, Block Group 4, Census Tract 2020, Napa County, California",0,0,0
1000000US060552020004014,060552020004014,"Block 4014, Block Group 4, Census Tract 2020, Napa County, California",84,66,18
1000000US060552020004015,060552020004015,"Block 4015, Block Group 4, Census Tract 2020, Napa County, California",0,0,0
1000000US060552020004016,060552020004016,"Block 4016, Block Group 4, Census Tract 2020, Napa County, California",17,12,5
1000000US060552020004017,060552020004017,"Block 4017, Block Group 4, Census Tract 2020, Napa County, California",16,12,4
1000000US060552020004018,060552020004018,"Block 4018, Block Group 4, Census Tract 2020, Napa County, California",28,22,6
1000000US060552020004019,060552020004019,"Block 4019, Block Group 4, Census Tract 2020, Napa County, California",35,33,2
1000000US060552020004020,060552020004020,"Block 4020, Block Group 4, Census Tract 2020, Napa County, California",0,0,0
1000000US060552020004021,060552020004021,"Block 4021, Block Group 4, Census Tract 2020, Napa County, California",13,12,1
1000000US060552020004022,060552020004022,"Block 4022, Block Group 4, Census Tract 2020, Napa County, California",12,11,1
1000000US060552020004023,060552020004023,"Block 4023, Block Group 4, Census Tract 2020, Napa County, California",12,10,2
1000000US060552020004024,060552020004024,"Block 4024, Block Group 4, Census Tract 2020, Napa County, California",11,10,1
1000000US060552020004025,060552020004025,"Block 4025, Block Group 4, Census Tract 2020, Napa County, California",13,7,6
1000000US060552020004026,060552020004026,"Block 4026, Block Group 4, Census Tract 2020, Napa County, California",1,1,0
1000000US060552020004027,060552020004027,"Block 4027, Block Group 4, Census Tract 2020, Napa County, California",35,31,4
1000000US060552020004028,060552020004028,"Block 4028, Block Group 4, Census Tract 2020, Napa County, California",29,27,2
