Id,Id2,Geography,Number,Occupied,Vacant
1000000US060952501031000,060952501031000,"Block 1000, Block Group 1, Census Tract 2501.03, Solano County, California",35,24,11
1000000US060952501031001,060952501031001,"Block 1001, Block Group 1, Census Tract 2501.03, Solano County, California",0,0,0
1000000US060952501031002,060952501031002,"Block 1002, Block Group 1, Census Tract 2501.03, Solano County, California",87,70,17
1000000US060952501031003,060952501031003,"Block 1003, Block Group 1, Census Tract 2501.03, Solano County, California",3,2,1
1000000US060952501031004,060952501031004,"Block 1004, Block Group 1, Census Tract 2501.03, Solano County, California",0,0,0
1000000US060952501031005,060952501031005,"Block 1005, Block Group 1, Census Tract 2501.03, Solano County, California",0,0,0
1000000US060952501031006,060952501031006,"Block 1006, Block Group 1, Census Tract 2501.03, Solano County, California",0,0,0
1000000US060952501031007,060952501031007,"Block 1007, Block Group 1, Census Tract 2501.03, Solano County, California",7,7,0
1000000US060952501031008,060952501031008,"Block 1008, Block Group 1, Census Tract 2501.03, Solano County, California",0,0,0
1000000US060952501031009,060952501031009,"Block 1009, Block Group 1, Census Tract 2501.03, Solano County, California",198,180,18
1000000US060952501031010,060952501031010,"Block 1010, Block Group 1, Census Tract 2501.03, Solano County, California",26,25,1
1000000US060952501031011,060952501031011,"Block 1011, Block Group 1, Census Tract 2501.03, Solano County, California",25,24,1
1000000US060952501031012,060952501031012,"Block 1012, Block Group 1, Census Tract 2501.03, Solano County, California",12,12,0
1000000US060952501031013,060952501031013,"Block 1013, Block Group 1, Census Tract 2501.03, Solano County, California",18,18,0
1000000US060952501031014,060952501031014,"Block 1014, Block Group 1, Census Tract 2501.03, Solano County, California",18,18,0
1000000US060952501031015,060952501031015,"Block 1015, Block Group 1, Census Tract 2501.03, Solano County, California",18,15,3
1000000US060952501031016,060952501031016,"Block 1016, Block Group 1, Census Tract 2501.03, Solano County, California",77,72,5
1000000US060952501031017,060952501031017,"Block 1017, Block Group 1, Census Tract 2501.03, Solano County, California",12,11,1
1000000US060952501031018,060952501031018,"Block 1018, Block Group 1, Census Tract 2501.03, Solano County, California",14,13,1
1000000US060952501031019,060952501031019,"Block 1019, Block Group 1, Census Tract 2501.03, Solano County, California",16,14,2
1000000US060952501031020,060952501031020,"Block 1020, Block Group 1, Census Tract 2501.03, Solano County, California",0,0,0
1000000US060952501032000,060952501032000,"Block 2000, Block Group 2, Census Tract 2501.03, Solano County, California",194,183,11
1000000US060952501032001,060952501032001,"Block 2001, Block Group 2, Census Tract 2501.03, Solano County, California",14,13,1
1000000US060952501032002,060952501032002,"Block 2002, Block Group 2, Census Tract 2501.03, Solano County, California",9,9,0
1000000US060952501032003,060952501032003,"Block 2003, Block Group 2, Census Tract 2501.03, Solano County, California",32,32,0
1000000US060952501032004,060952501032004,"Block 2004, Block Group 2, Census Tract 2501.03, Solano County, California",26,22,4
1000000US060952501032005,060952501032005,"Block 2005, Block Group 2, Census Tract 2501.03, Solano County, California",341,299,42
1000000US060952501032006,060952501032006,"Block 2006, Block Group 2, Census Tract 2501.03, Solano County, California",18,17,1
1000000US060952501032007,060952501032007,"Block 2007, Block Group 2, Census Tract 2501.03, Solano County, California",21,20,1
1000000US060952501033000,060952501033000,"Block 3000, Block Group 3, Census Tract 2501.03, Solano County, California",88,86,2
1000000US060952501033001,060952501033001,"Block 3001, Block Group 3, Census Tract 2501.03, Solano County, California",27,26,1
1000000US060952501033002,060952501033002,"Block 3002, Block Group 3, Census Tract 2501.03, Solano County, California",27,27,0
1000000US060952501033003,060952501033003,"Block 3003, Block Group 3, Census Tract 2501.03, Solano County, California",55,49,6
1000000US060952501033004,060952501033004,"Block 3004, Block Group 3, Census Tract 2501.03, Solano County, California",22,21,1
1000000US060952501033005,060952501033005,"Block 3005, Block Group 3, Census Tract 2501.03, Solano County, California",22,22,0
1000000US060952501033006,060952501033006,"Block 3006, Block Group 3, Census Tract 2501.03, Solano County, California",112,106,6
1000000US060952501033007,060952501033007,"Block 3007, Block Group 3, Census Tract 2501.03, Solano County, California",32,31,1
1000000US060952501033008,060952501033008,"Block 3008, Block Group 3, Census Tract 2501.03, Solano County, California",24,23,1
1000000US060952501033009,060952501033009,"Block 3009, Block Group 3, Census Tract 2501.03, Solano County, California",38,36,2
1000000US060952501041000,060952501041000,"Block 1000, Block Group 1, Census Tract 2501.04, Solano County, California",80,75,5
1000000US060952501041001,060952501041001,"Block 1001, Block Group 1, Census Tract 2501.04, Solano County, California",2,2,0
1000000US060952501041002,060952501041002,"Block 1002, Block Group 1, Census Tract 2501.04, Solano County, California",34,30,4
1000000US060952501041003,060952501041003,"Block 1003, Block Group 1, Census Tract 2501.04, Solano County, California",37,36,1
1000000US060952501041004,060952501041004,"Block 1004, Block Group 1, Census Tract 2501.04, Solano County, California",13,11,2
1000000US060952501041005,060952501041005,"Block 1005, Block Group 1, Census Tract 2501.04, Solano County, California",49,46,3
1000000US060952501041006,060952501041006,"Block 1006, Block Group 1, Census Tract 2501.04, Solano County, California",40,37,3
1000000US060952501041007,060952501041007,"Block 1007, Block Group 1, Census Tract 2501.04, Solano County, California",36,34,2
1000000US060952501041008,060952501041008,"Block 1008, Block Group 1, Census Tract 2501.04, Solano County, California",36,36,0
1000000US060952501041009,060952501041009,"Block 1009, Block Group 1, Census Tract 2501.04, Solano County, California",29,27,2
1000000US060952501042000,060952501042000,"Block 2000, Block Group 2, Census Tract 2501.04, Solano County, California",59,58,1
1000000US060952501042001,060952501042001,"Block 2001, Block Group 2, Census Tract 2501.04, Solano County, California",34,31,3
1000000US060952501042002,060952501042002,"Block 2002, Block Group 2, Census Tract 2501.04, Solano County, California",120,110,10
1000000US060952501042003,060952501042003,"Block 2003, Block Group 2, Census Tract 2501.04, Solano County, California",0,0,0
1000000US060952501042004,060952501042004,"Block 2004, Block Group 2, Census Tract 2501.04, Solano County, California",35,33,2
1000000US060952501042005,060952501042005,"Block 2005, Block Group 2, Census Tract 2501.04, Solano County, California",205,199,6
1000000US060952501042006,060952501042006,"Block 2006, Block Group 2, Census Tract 2501.04, Solano County, California",0,0,0
1000000US060952501042007,060952501042007,"Block 2007, Block Group 2, Census Tract 2501.04, Solano County, California",44,40,4
1000000US060952501042008,060952501042008,"Block 2008, Block Group 2, Census Tract 2501.04, Solano County, California",0,0,0
1000000US060952501051000,060952501051000,"Block 1000, Block Group 1, Census Tract 2501.05, Solano County, California",279,268,11
1000000US060952501051001,060952501051001,"Block 1001, Block Group 1, Census Tract 2501.05, Solano County, California",0,0,0
1000000US060952501051002,060952501051002,"Block 1002, Block Group 1, Census Tract 2501.05, Solano County, California",28,27,1
1000000US060952501051003,060952501051003,"Block 1003, Block Group 1, Census Tract 2501.05, Solano County, California",0,0,0
1000000US060952501051004,060952501051004,"Block 1004, Block Group 1, Census Tract 2501.05, Solano County, California",240,230,10
1000000US060952501051005,060952501051005,"Block 1005, Block Group 1, Census Tract 2501.05, Solano County, California",28,27,1
1000000US060952501051006,060952501051006,"Block 1006, Block Group 1, Census Tract 2501.05, Solano County, California",13,12,1
1000000US060952501051007,060952501051007,"Block 1007, Block Group 1, Census Tract 2501.05, Solano County, California",16,15,1
1000000US060952501051008,060952501051008,"Block 1008, Block Group 1, Census Tract 2501.05, Solano County, California",24,23,1
1000000US060952501051009,060952501051009,"Block 1009, Block Group 1, Census Tract 2501.05, Solano County, California",81,79,2
1000000US060952501051010,060952501051010,"Block 1010, Block Group 1, Census Tract 2501.05, Solano County, California",0,0,0
1000000US060952501051011,060952501051011,"Block 1011, Block Group 1, Census Tract 2501.05, Solano County, California",0,0,0
1000000US060952501051012,060952501051012,"Block 1012, Block Group 1, Census Tract 2501.05, Solano County, California",1,1,0
1000000US060952501051013,060952501051013,"Block 1013, Block Group 1, Census Tract 2501.05, Solano County, California",0,0,0
1000000US060952501051014,060952501051014,"Block 1014, Block Group 1, Census Tract 2501.05, Solano County, California",0,0,0
1000000US060952501051015,060952501051015,"Block 1015, Block Group 1, Census Tract 2501.05, Solano County, California",0,0,0
1000000US060952501052000,060952501052000,"Block 2000, Block Group 2, Census Tract 2501.05, Solano County, California",137,127,10
1000000US060952501052001,060952501052001,"Block 2001, Block Group 2, Census Tract 2501.05, Solano County, California",17,14,3
1000000US060952501052002,060952501052002,"Block 2002, Block Group 2, Census Tract 2501.05, Solano County, California",65,64,1
1000000US060952501052003,060952501052003,"Block 2003, Block Group 2, Census Tract 2501.05, Solano County, California",0,0,0
1000000US060952501052004,060952501052004,"Block 2004, Block Group 2, Census Tract 2501.05, Solano County, California",0,0,0
1000000US060952501052005,060952501052005,"Block 2005, Block Group 2, Census Tract 2501.05, Solano County, California",0,0,0
1000000US060952501052006,060952501052006,"Block 2006, Block Group 2, Census Tract 2501.05, Solano County, California",0,0,0
1000000US060952501052007,060952501052007,"Block 2007, Block Group 2, Census Tract 2501.05, Solano County, California",0,0,0
1000000US060952501052008,060952501052008,"Block 2008, Block Group 2, Census Tract 2501.05, Solano County, California",0,0,0
1000000US060952501052009,060952501052009,"Block 2009, Block Group 2, Census Tract 2501.05, Solano County, California",0,0,0
1000000US060952501052010,060952501052010,"Block 2010, Block Group 2, Census Tract 2501.05, Solano County, California",0,0,0
1000000US060952501052011,060952501052011,"Block 2011, Block Group 2, Census Tract 2501.05, Solano County, California",0,0,0
1000000US060952501052012,060952501052012,"Block 2012, Block Group 2, Census Tract 2501.05, Solano County, California",0,0,0
1000000US060952501052013,060952501052013,"Block 2013, Block Group 2, Census Tract 2501.05, Solano County, California",0,0,0
1000000US060952501052014,060952501052014,"Block 2014, Block Group 2, Census Tract 2501.05, Solano County, California",0,0,0
1000000US060952501052015,060952501052015,"Block 2015, Block Group 2, Census Tract 2501.05, Solano County, California",0,0,0
1000000US060952501052016,060952501052016,"Block 2016, Block Group 2, Census Tract 2501.05, Solano County, California",16,16,0
1000000US060952501052017,060952501052017,"Block 2017, Block Group 2, Census Tract 2501.05, Solano County, California",40,40,0
1000000US060952501052018,060952501052018,"Block 2018, Block Group 2, Census Tract 2501.05, Solano County, California",0,0,0
1000000US060952501052019,060952501052019,"Block 2019, Block Group 2, Census Tract 2501.05, Solano County, California",0,0,0
1000000US060952501052020,060952501052020,"Block 2020, Block Group 2, Census Tract 2501.05, Solano County, California",132,120,12
1000000US060952501052021,060952501052021,"Block 2021, Block Group 2, Census Tract 2501.05, Solano County, California",1,1,0
1000000US060952501052022,060952501052022,"Block 2022, Block Group 2, Census Tract 2501.05, Solano County, California",0,0,0
1000000US060952501052023,060952501052023,"Block 2023, Block Group 2, Census Tract 2501.05, Solano County, California",0,0,0
1000000US060952501052024,060952501052024,"Block 2024, Block Group 2, Census Tract 2501.05, Solano County, California",0,0,0
1000000US060952501052025,060952501052025,"Block 2025, Block Group 2, Census Tract 2501.05, Solano County, California",0,0,0
1000000US060952501052026,060952501052026,"Block 2026, Block Group 2, Census Tract 2501.05, Solano County, California",0,0,0
1000000US060952501052027,060952501052027,"Block 2027, Block Group 2, Census Tract 2501.05, Solano County, California",0,0,0
1000000US060952501052028,060952501052028,"Block 2028, Block Group 2, Census Tract 2501.05, Solano County, California",0,0,0
1000000US060952501052029,060952501052029,"Block 2029, Block Group 2, Census Tract 2501.05, Solano County, California",0,0,0
1000000US060952501052030,060952501052030,"Block 2030, Block Group 2, Census Tract 2501.05, Solano County, California",0,0,0
1000000US060952501052031,060952501052031,"Block 2031, Block Group 2, Census Tract 2501.05, Solano County, California",0,0,0
1000000US060952501052032,060952501052032,"Block 2032, Block Group 2, Census Tract 2501.05, Solano County, California",0,0,0
1000000US060952501052033,060952501052033,"Block 2033, Block Group 2, Census Tract 2501.05, Solano County, California",0,0,0
1000000US060952501052034,060952501052034,"Block 2034, Block Group 2, Census Tract 2501.05, Solano County, California",0,0,0
1000000US060952501052035,060952501052035,"Block 2035, Block Group 2, Census Tract 2501.05, Solano County, California",0,0,0
1000000US060952501052036,060952501052036,"Block 2036, Block Group 2, Census Tract 2501.05, Solano County, California",0,0,0
1000000US060952501052037,060952501052037,"Block 2037, Block Group 2, Census Tract 2501.05, Solano County, California",0,0,0
1000000US060952501052038,060952501052038,"Block 2038, Block Group 2, Census Tract 2501.05, Solano County, California",0,0,0
1000000US060952501052039,060952501052039,"Block 2039, Block Group 2, Census Tract 2501.05, Solano County, California",0,0,0
1000000US060952501052040,060952501052040,"Block 2040, Block Group 2, Census Tract 2501.05, Solano County, California",0,0,0
1000000US060952501052041,060952501052041,"Block 2041, Block Group 2, Census Tract 2501.05, Solano County, California",0,0,0
1000000US060952501052042,060952501052042,"Block 2042, Block Group 2, Census Tract 2501.05, Solano County, California",0,0,0
1000000US060952501052043,060952501052043,"Block 2043, Block Group 2, Census Tract 2501.05, Solano County, California",0,0,0
1000000US060952501052044,060952501052044,"Block 2044, Block Group 2, Census Tract 2501.05, Solano County, California",0,0,0
1000000US060952501052045,060952501052045,"Block 2045, Block Group 2, Census Tract 2501.05, Solano County, California",0,0,0
1000000US060952501052046,060952501052046,"Block 2046, Block Group 2, Census Tract 2501.05, Solano County, California",0,0,0
1000000US060952501052047,060952501052047,"Block 2047, Block Group 2, Census Tract 2501.05, Solano County, California",0,0,0
1000000US060952501052048,060952501052048,"Block 2048, Block Group 2, Census Tract 2501.05, Solano County, California",0,0,0
1000000US060952501052049,060952501052049,"Block 2049, Block Group 2, Census Tract 2501.05, Solano County, California",0,0,0
1000000US060952501052050,060952501052050,"Block 2050, Block Group 2, Census Tract 2501.05, Solano County, California",0,0,0
1000000US060952501052051,060952501052051,"Block 2051, Block Group 2, Census Tract 2501.05, Solano County, California",0,0,0
1000000US060952501052052,060952501052052,"Block 2052, Block Group 2, Census Tract 2501.05, Solano County, California",0,0,0
1000000US060952501052053,060952501052053,"Block 2053, Block Group 2, Census Tract 2501.05, Solano County, California",0,0,0
1000000US060952501052054,060952501052054,"Block 2054, Block Group 2, Census Tract 2501.05, Solano County, California",0,0,0
1000000US060952501052055,060952501052055,"Block 2055, Block Group 2, Census Tract 2501.05, Solano County, California",0,0,0
1000000US060952501052056,060952501052056,"Block 2056, Block Group 2, Census Tract 2501.05, Solano County, California",0,0,0
1000000US060952501052057,060952501052057,"Block 2057, Block Group 2, Census Tract 2501.05, Solano County, California",19,19,0
1000000US060952501052058,060952501052058,"Block 2058, Block Group 2, Census Tract 2501.05, Solano County, California",69,68,1
1000000US060952501052059,060952501052059,"Block 2059, Block Group 2, Census Tract 2501.05, Solano County, California",50,47,3
1000000US060952501052060,060952501052060,"Block 2060, Block Group 2, Census Tract 2501.05, Solano County, California",56,56,0
1000000US060952501052061,060952501052061,"Block 2061, Block Group 2, Census Tract 2501.05, Solano County, California",37,35,2
1000000US060952501052062,060952501052062,"Block 2062, Block Group 2, Census Tract 2501.05, Solano County, California",6,6,0
1000000US060952501052063,060952501052063,"Block 2063, Block Group 2, Census Tract 2501.05, Solano County, California",49,48,1
1000000US060952501052064,060952501052064,"Block 2064, Block Group 2, Census Tract 2501.05, Solano County, California",8,8,0
1000000US060952501053000,060952501053000,"Block 3000, Block Group 3, Census Tract 2501.05, Solano County, California",124,116,8
1000000US060952501053001,060952501053001,"Block 3001, Block Group 3, Census Tract 2501.05, Solano County, California",147,136,11
1000000US060952501053002,060952501053002,"Block 3002, Block Group 3, Census Tract 2501.05, Solano County, California",47,47,0
1000000US060952501053003,060952501053003,"Block 3003, Block Group 3, Census Tract 2501.05, Solano County, California",52,49,3
1000000US060952501053004,060952501053004,"Block 3004, Block Group 3, Census Tract 2501.05, Solano County, California",49,45,4
1000000US060952501053005,060952501053005,"Block 3005, Block Group 3, Census Tract 2501.05, Solano County, California",27,26,1
1000000US060952501053006,060952501053006,"Block 3006, Block Group 3, Census Tract 2501.05, Solano County, California",40,39,1
1000000US060952501053007,060952501053007,"Block 3007, Block Group 3, Census Tract 2501.05, Solano County, California",71,69,2
1000000US060952501053008,060952501053008,"Block 3008, Block Group 3, Census Tract 2501.05, Solano County, California",27,25,2
1000000US060952501053009,060952501053009,"Block 3009, Block Group 3, Census Tract 2501.05, Solano County, California",26,26,0
1000000US060952501053010,060952501053010,"Block 3010, Block Group 3, Census Tract 2501.05, Solano County, California",18,18,0
1000000US060952501053011,060952501053011,"Block 3011, Block Group 3, Census Tract 2501.05, Solano County, California",46,45,1
1000000US060952501053012,060952501053012,"Block 3012, Block Group 3, Census Tract 2501.05, Solano County, California",38,37,1
1000000US060952501053013,060952501053013,"Block 3013, Block Group 3, Census Tract 2501.05, Solano County, California",35,35,0
1000000US060952501053014,060952501053014,"Block 3014, Block Group 3, Census Tract 2501.05, Solano County, California",46,46,0
1000000US060952501053015,060952501053015,"Block 3015, Block Group 3, Census Tract 2501.05, Solano County, California",10,10,0
1000000US060952501053016,060952501053016,"Block 3016, Block Group 3, Census Tract 2501.05, Solano County, California",0,0,0
1000000US060952501053017,060952501053017,"Block 3017, Block Group 3, Census Tract 2501.05, Solano County, California",0,0,0
1000000US060952501053018,060952501053018,"Block 3018, Block Group 3, Census Tract 2501.05, Solano County, California",0,0,0
1000000US060952501053019,060952501053019,"Block 3019, Block Group 3, Census Tract 2501.05, Solano County, California",30,29,1
1000000US060952501053020,060952501053020,"Block 3020, Block Group 3, Census Tract 2501.05, Solano County, California",13,13,0
1000000US060952501053021,060952501053021,"Block 3021, Block Group 3, Census Tract 2501.05, Solano County, California",0,0,0
1000000US060952501053022,060952501053022,"Block 3022, Block Group 3, Census Tract 2501.05, Solano County, California",0,0,0
1000000US060952501053023,060952501053023,"Block 3023, Block Group 3, Census Tract 2501.05, Solano County, California",0,0,0
1000000US060952501061000,060952501061000,"Block 1000, Block Group 1, Census Tract 2501.06, Solano County, California",0,0,0
1000000US060952501061001,060952501061001,"Block 1001, Block Group 1, Census Tract 2501.06, Solano County, California",0,0,0
1000000US060952501061002,060952501061002,"Block 1002, Block Group 1, Census Tract 2501.06, Solano County, California",0,0,0
1000000US060952501061003,060952501061003,"Block 1003, Block Group 1, Census Tract 2501.06, Solano County, California",124,115,9
1000000US060952501061004,060952501061004,"Block 1004, Block Group 1, Census Tract 2501.06, Solano County, California",0,0,0
1000000US060952501061005,060952501061005,"Block 1005, Block Group 1, Census Tract 2501.06, Solano County, California",0,0,0
1000000US060952501061006,060952501061006,"Block 1006, Block Group 1, Census Tract 2501.06, Solano County, California",0,0,0
1000000US060952501061007,060952501061007,"Block 1007, Block Group 1, Census Tract 2501.06, Solano County, California",0,0,0
1000000US060952501061008,060952501061008,"Block 1008, Block Group 1, Census Tract 2501.06, Solano County, California",48,42,6
1000000US060952501061009,060952501061009,"Block 1009, Block Group 1, Census Tract 2501.06, Solano County, California",0,0,0
1000000US060952501061010,060952501061010,"Block 1010, Block Group 1, Census Tract 2501.06, Solano County, California",0,0,0
1000000US060952501061011,060952501061011,"Block 1011, Block Group 1, Census Tract 2501.06, Solano County, California",0,0,0
1000000US060952501061012,060952501061012,"Block 1012, Block Group 1, Census Tract 2501.06, Solano County, California",69,60,9
1000000US060952501061013,060952501061013,"Block 1013, Block Group 1, Census Tract 2501.06, Solano County, California",1,1,0
1000000US060952501061014,060952501061014,"Block 1014, Block Group 1, Census Tract 2501.06, Solano County, California",37,35,2
1000000US060952501061015,060952501061015,"Block 1015, Block Group 1, Census Tract 2501.06, Solano County, California",87,75,12
1000000US060952501061016,060952501061016,"Block 1016, Block Group 1, Census Tract 2501.06, Solano County, California",14,12,2
1000000US060952501061017,060952501061017,"Block 1017, Block Group 1, Census Tract 2501.06, Solano County, California",134,129,5
1000000US060952501061018,060952501061018,"Block 1018, Block Group 1, Census Tract 2501.06, Solano County, California",32,30,2
1000000US060952501061019,060952501061019,"Block 1019, Block Group 1, Census Tract 2501.06, Solano County, California",0,0,0
1000000US060952501061020,060952501061020,"Block 1020, Block Group 1, Census Tract 2501.06, Solano County, California",2,2,0
1000000US060952501061021,060952501061021,"Block 1021, Block Group 1, Census Tract 2501.06, Solano County, California",30,30,0
1000000US060952501061022,060952501061022,"Block 1022, Block Group 1, Census Tract 2501.06, Solano County, California",26,23,3
1000000US060952501061023,060952501061023,"Block 1023, Block Group 1, Census Tract 2501.06, Solano County, California",0,0,0
1000000US060952501061024,060952501061024,"Block 1024, Block Group 1, Census Tract 2501.06, Solano County, California",0,0,0
1000000US060952501061025,060952501061025,"Block 1025, Block Group 1, Census Tract 2501.06, Solano County, California",0,0,0
1000000US060952501061026,060952501061026,"Block 1026, Block Group 1, Census Tract 2501.06, Solano County, California",0,0,0
1000000US060952501061027,060952501061027,"Block 1027, Block Group 1, Census Tract 2501.06, Solano County, California",0,0,0
1000000US060952501061028,060952501061028,"Block 1028, Block Group 1, Census Tract 2501.06, Solano County, California",0,0,0
1000000US060952501061029,060952501061029,"Block 1029, Block Group 1, Census Tract 2501.06, Solano County, California",0,0,0
1000000US060952501061030,060952501061030,"Block 1030, Block Group 1, Census Tract 2501.06, Solano County, California",0,0,0
1000000US060952501061031,060952501061031,"Block 1031, Block Group 1, Census Tract 2501.06, Solano County, California",1,1,0
1000000US060952501061032,060952501061032,"Block 1032, Block Group 1, Census Tract 2501.06, Solano County, California",0,0,0
1000000US060952501061033,060952501061033,"Block 1033, Block Group 1, Census Tract 2501.06, Solano County, California",0,0,0
1000000US060952501061034,060952501061034,"Block 1034, Block Group 1, Census Tract 2501.06, Solano County, California",0,0,0
1000000US060952501061035,060952501061035,"Block 1035, Block Group 1, Census Tract 2501.06, Solano County, California",0,0,0
1000000US060952501061036,060952501061036,"Block 1036, Block Group 1, Census Tract 2501.06, Solano County, California",0,0,0
1000000US060952501061037,060952501061037,"Block 1037, Block Group 1, Census Tract 2501.06, Solano County, California",0,0,0
1000000US060952501061038,060952501061038,"Block 1038, Block Group 1, Census Tract 2501.06, Solano County, California",2,2,0
1000000US060952501061039,060952501061039,"Block 1039, Block Group 1, Census Tract 2501.06, Solano County, California",0,0,0
1000000US060952501061040,060952501061040,"Block 1040, Block Group 1, Census Tract 2501.06, Solano County, California",0,0,0
1000000US060952501061041,060952501061041,"Block 1041, Block Group 1, Census Tract 2501.06, Solano County, California",0,0,0
1000000US060952501061042,060952501061042,"Block 1042, Block Group 1, Census Tract 2501.06, Solano County, California",0,0,0
1000000US060952501061043,060952501061043,"Block 1043, Block Group 1, Census Tract 2501.06, Solano County, California",0,0,0
1000000US060952501061044,060952501061044,"Block 1044, Block Group 1, Census Tract 2501.06, Solano County, California",0,0,0
1000000US060952501062000,060952501062000,"Block 2000, Block Group 2, Census Tract 2501.06, Solano County, California",180,177,3
1000000US060952501062001,060952501062001,"Block 2001, Block Group 2, Census Tract 2501.06, Solano County, California",42,40,2
1000000US060952501062002,060952501062002,"Block 2002, Block Group 2, Census Tract 2501.06, Solano County, California",35,33,2
1000000US060952501062003,060952501062003,"Block 2003, Block Group 2, Census Tract 2501.06, Solano County, California",28,26,2
1000000US060952501062004,060952501062004,"Block 2004, Block Group 2, Census Tract 2501.06, Solano County, California",31,31,0
1000000US060952501062005,060952501062005,"Block 2005, Block Group 2, Census Tract 2501.06, Solano County, California",49,45,4
1000000US060952501062006,060952501062006,"Block 2006, Block Group 2, Census Tract 2501.06, Solano County, California",33,31,2
1000000US060952501062007,060952501062007,"Block 2007, Block Group 2, Census Tract 2501.06, Solano County, California",138,136,2
1000000US060952501062008,060952501062008,"Block 2008, Block Group 2, Census Tract 2501.06, Solano County, California",53,53,0
1000000US060952501062009,060952501062009,"Block 2009, Block Group 2, Census Tract 2501.06, Solano County, California",15,15,0
1000000US060952501062010,060952501062010,"Block 2010, Block Group 2, Census Tract 2501.06, Solano County, California",0,0,0
1000000US060952501062011,060952501062011,"Block 2011, Block Group 2, Census Tract 2501.06, Solano County, California",0,0,0
1000000US060952501062012,060952501062012,"Block 2012, Block Group 2, Census Tract 2501.06, Solano County, California",101,99,2
1000000US060952501062013,060952501062013,"Block 2013, Block Group 2, Census Tract 2501.06, Solano County, California",25,24,1
1000000US060952501062014,060952501062014,"Block 2014, Block Group 2, Census Tract 2501.06, Solano County, California",52,51,1
1000000US060952501062015,060952501062015,"Block 2015, Block Group 2, Census Tract 2501.06, Solano County, California",0,0,0
1000000US060952501062016,060952501062016,"Block 2016, Block Group 2, Census Tract 2501.06, Solano County, California",0,0,0
1000000US060952501062017,060952501062017,"Block 2017, Block Group 2, Census Tract 2501.06, Solano County, California",0,0,0
1000000US060952501062018,060952501062018,"Block 2018, Block Group 2, Census Tract 2501.06, Solano County, California",0,0,0
1000000US060952501062019,060952501062019,"Block 2019, Block Group 2, Census Tract 2501.06, Solano County, California",0,0,0
1000000US060952501062020,060952501062020,"Block 2020, Block Group 2, Census Tract 2501.06, Solano County, California",0,0,0
1000000US060952501062021,060952501062021,"Block 2021, Block Group 2, Census Tract 2501.06, Solano County, California",22,22,0
1000000US060952501062022,060952501062022,"Block 2022, Block Group 2, Census Tract 2501.06, Solano County, California",31,30,1
1000000US060952502001000,060952502001000,"Block 1000, Block Group 1, Census Tract 2502, Solano County, California",90,72,18
1000000US060952502001001,060952502001001,"Block 1001, Block Group 1, Census Tract 2502, Solano County, California",6,3,3
1000000US060952502001002,060952502001002,"Block 1002, Block Group 1, Census Tract 2502, Solano County, California",0,0,0
1000000US060952502001003,060952502001003,"Block 1003, Block Group 1, Census Tract 2502, Solano County, California",235,226,9
1000000US060952502001004,060952502001004,"Block 1004, Block Group 1, Census Tract 2502, Solano County, California",30,29,1
1000000US060952502001005,060952502001005,"Block 1005, Block Group 1, Census Tract 2502, Solano County, California",33,30,3
1000000US060952502001006,060952502001006,"Block 1006, Block Group 1, Census Tract 2502, Solano County, California",33,29,4
1000000US060952502001007,060952502001007,"Block 1007, Block Group 1, Census Tract 2502, Solano County, California",22,21,1
1000000US060952502001008,060952502001008,"Block 1008, Block Group 1, Census Tract 2502, Solano County, California",11,9,2
1000000US060952502001009,060952502001009,"Block 1009, Block Group 1, Census Tract 2502, Solano County, California",12,12,0
1000000US060952502001010,060952502001010,"Block 1010, Block Group 1, Census Tract 2502, Solano County, California",12,12,0
1000000US060952502001011,060952502001011,"Block 1011, Block Group 1, Census Tract 2502, Solano County, California",12,11,1
1000000US060952502001012,060952502001012,"Block 1012, Block Group 1, Census Tract 2502, Solano County, California",20,17,3
1000000US060952502001013,060952502001013,"Block 1013, Block Group 1, Census Tract 2502, Solano County, California",26,24,2
1000000US060952502001014,060952502001014,"Block 1014, Block Group 1, Census Tract 2502, Solano County, California",70,59,11
1000000US060952502001015,060952502001015,"Block 1015, Block Group 1, Census Tract 2502, Solano County, California",1,1,0
1000000US060952502001016,060952502001016,"Block 1016, Block Group 1, Census Tract 2502, Solano County, California",11,11,0
1000000US060952502001017,060952502001017,"Block 1017, Block Group 1, Census Tract 2502, Solano County, California",11,10,1
1000000US060952502001018,060952502001018,"Block 1018, Block Group 1, Census Tract 2502, Solano County, California",0,0,0
1000000US060952502002000,060952502002000,"Block 2000, Block Group 2, Census Tract 2502, Solano County, California",40,38,2
1000000US060952502002001,060952502002001,"Block 2001, Block Group 2, Census Tract 2502, Solano County, California",2,2,0
1000000US060952502002002,060952502002002,"Block 2002, Block Group 2, Census Tract 2502, Solano County, California",14,14,0
1000000US060952502002003,060952502002003,"Block 2003, Block Group 2, Census Tract 2502, Solano County, California",33,32,1
1000000US060952502002004,060952502002004,"Block 2004, Block Group 2, Census Tract 2502, Solano County, California",30,27,3
1000000US060952502002005,060952502002005,"Block 2005, Block Group 2, Census Tract 2502, Solano County, California",31,24,7
1000000US060952502002006,060952502002006,"Block 2006, Block Group 2, Census Tract 2502, Solano County, California",22,20,2
1000000US060952502002007,060952502002007,"Block 2007, Block Group 2, Census Tract 2502, Solano County, California",0,0,0
1000000US060952502002008,060952502002008,"Block 2008, Block Group 2, Census Tract 2502, Solano County, California",0,0,0
1000000US060952502002009,060952502002009,"Block 2009, Block Group 2, Census Tract 2502, Solano County, California",0,0,0
1000000US060952502002010,060952502002010,"Block 2010, Block Group 2, Census Tract 2502, Solano County, California",44,38,6
1000000US060952502002011,060952502002011,"Block 2011, Block Group 2, Census Tract 2502, Solano County, California",36,31,5
1000000US060952502002012,060952502002012,"Block 2012, Block Group 2, Census Tract 2502, Solano County, California",35,32,3
1000000US060952502002013,060952502002013,"Block 2013, Block Group 2, Census Tract 2502, Solano County, California",16,14,2
1000000US060952502002014,060952502002014,"Block 2014, Block Group 2, Census Tract 2502, Solano County, California",28,26,2
1000000US060952502002015,060952502002015,"Block 2015, Block Group 2, Census Tract 2502, Solano County, California",10,10,0
1000000US060952502003000,060952502003000,"Block 3000, Block Group 3, Census Tract 2502, Solano County, California",79,73,6
1000000US060952502003001,060952502003001,"Block 3001, Block Group 3, Census Tract 2502, Solano County, California",24,23,1
1000000US060952502003002,060952502003002,"Block 3002, Block Group 3, Census Tract 2502, Solano County, California",30,28,2
1000000US060952502003003,060952502003003,"Block 3003, Block Group 3, Census Tract 2502, Solano County, California",96,88,8
1000000US060952502003004,060952502003004,"Block 3004, Block Group 3, Census Tract 2502, Solano County, California",0,0,0
1000000US060952502003005,060952502003005,"Block 3005, Block Group 3, Census Tract 2502, Solano County, California",10,8,2
1000000US060952502003006,060952502003006,"Block 3006, Block Group 3, Census Tract 2502, Solano County, California",25,23,2
1000000US060952502003007,060952502003007,"Block 3007, Block Group 3, Census Tract 2502, Solano County, California",15,14,1
1000000US060952502003008,060952502003008,"Block 3008, Block Group 3, Census Tract 2502, Solano County, California",61,57,4
1000000US060952502003009,060952502003009,"Block 3009, Block Group 3, Census Tract 2502, Solano County, California",21,20,1
1000000US060952502003010,060952502003010,"Block 3010, Block Group 3, Census Tract 2502, Solano County, California",21,19,2
1000000US060952502003011,060952502003011,"Block 3011, Block Group 3, Census Tract 2502, Solano County, California",40,36,4
1000000US060952502003012,060952502003012,"Block 3012, Block Group 3, Census Tract 2502, Solano County, California",16,15,1
1000000US060952502003013,060952502003013,"Block 3013, Block Group 3, Census Tract 2502, Solano County, California",26,25,1
1000000US060952502003014,060952502003014,"Block 3014, Block Group 3, Census Tract 2502, Solano County, California",28,27,1
1000000US060952502003015,060952502003015,"Block 3015, Block Group 3, Census Tract 2502, Solano County, California",35,34,1
1000000US060952502003016,060952502003016,"Block 3016, Block Group 3, Census Tract 2502, Solano County, California",41,40,1
1000000US060952503001000,060952503001000,"Block 1000, Block Group 1, Census Tract 2503, Solano County, California",63,58,5
1000000US060952503001001,060952503001001,"Block 1001, Block Group 1, Census Tract 2503, Solano County, California",9,9,0
1000000US060952503001002,060952503001002,"Block 1002, Block Group 1, Census Tract 2503, Solano County, California",48,45,3
1000000US060952503001003,060952503001003,"Block 1003, Block Group 1, Census Tract 2503, Solano County, California",21,20,1
1000000US060952503001004,060952503001004,"Block 1004, Block Group 1, Census Tract 2503, Solano County, California",22,21,1
1000000US060952503001005,060952503001005,"Block 1005, Block Group 1, Census Tract 2503, Solano County, California",21,20,1
1000000US060952503001006,060952503001006,"Block 1006, Block Group 1, Census Tract 2503, Solano County, California",34,34,0
1000000US060952503001007,060952503001007,"Block 1007, Block Group 1, Census Tract 2503, Solano County, California",19,16,3
1000000US060952503001008,060952503001008,"Block 1008, Block Group 1, Census Tract 2503, Solano County, California",0,0,0
1000000US060952503001009,060952503001009,"Block 1009, Block Group 1, Census Tract 2503, Solano County, California",0,0,0
1000000US060952503001010,060952503001010,"Block 1010, Block Group 1, Census Tract 2503, Solano County, California",0,0,0
1000000US060952503001011,060952503001011,"Block 1011, Block Group 1, Census Tract 2503, Solano County, California",16,13,3
1000000US060952503001012,060952503001012,"Block 1012, Block Group 1, Census Tract 2503, Solano County, California",16,15,1
1000000US060952503001013,060952503001013,"Block 1013, Block Group 1, Census Tract 2503, Solano County, California",43,39,4
1000000US060952503001014,060952503001014,"Block 1014, Block Group 1, Census Tract 2503, Solano County, California",10,9,1
1000000US060952503001015,060952503001015,"Block 1015, Block Group 1, Census Tract 2503, Solano County, California",0,0,0
1000000US060952503001016,060952503001016,"Block 1016, Block Group 1, Census Tract 2503, Solano County, California",30,29,1
1000000US060952503001017,060952503001017,"Block 1017, Block Group 1, Census Tract 2503, Solano County, California",11,10,1
1000000US060952503001018,060952503001018,"Block 1018, Block Group 1, Census Tract 2503, Solano County, California",16,13,3
1000000US060952503001019,060952503001019,"Block 1019, Block Group 1, Census Tract 2503, Solano County, California",22,21,1
1000000US060952503001020,060952503001020,"Block 1020, Block Group 1, Census Tract 2503, Solano County, California",38,36,2
1000000US060952503002000,060952503002000,"Block 2000, Block Group 2, Census Tract 2503, Solano County, California",110,105,5
1000000US060952503002001,060952503002001,"Block 2001, Block Group 2, Census Tract 2503, Solano County, California",10,10,0
1000000US060952503002002,060952503002002,"Block 2002, Block Group 2, Census Tract 2503, Solano County, California",15,14,1
1000000US060952503002003,060952503002003,"Block 2003, Block Group 2, Census Tract 2503, Solano County, California",14,11,3
1000000US060952503002004,060952503002004,"Block 2004, Block Group 2, Census Tract 2503, Solano County, California",7,6,1
1000000US060952503002005,060952503002005,"Block 2005, Block Group 2, Census Tract 2503, Solano County, California",12,11,1
1000000US060952503002006,060952503002006,"Block 2006, Block Group 2, Census Tract 2503, Solano County, California",33,32,1
1000000US060952503002007,060952503002007,"Block 2007, Block Group 2, Census Tract 2503, Solano County, California",11,8,3
1000000US060952503002008,060952503002008,"Block 2008, Block Group 2, Census Tract 2503, Solano County, California",13,13,0
1000000US060952503002009,060952503002009,"Block 2009, Block Group 2, Census Tract 2503, Solano County, California",14,14,0
1000000US060952503002010,060952503002010,"Block 2010, Block Group 2, Census Tract 2503, Solano County, California",14,10,4
1000000US060952503002011,060952503002011,"Block 2011, Block Group 2, Census Tract 2503, Solano County, California",4,4,0
1000000US060952503002012,060952503002012,"Block 2012, Block Group 2, Census Tract 2503, Solano County, California",0,0,0
1000000US060952503002013,060952503002013,"Block 2013, Block Group 2, Census Tract 2503, Solano County, California",2,2,0
1000000US060952503002014,060952503002014,"Block 2014, Block Group 2, Census Tract 2503, Solano County, California",8,7,1
1000000US060952503002015,060952503002015,"Block 2015, Block Group 2, Census Tract 2503, Solano County, California",14,10,4
1000000US060952503002016,060952503002016,"Block 2016, Block Group 2, Census Tract 2503, Solano County, California",16,13,3
1000000US060952503002017,060952503002017,"Block 2017, Block Group 2, Census Tract 2503, Solano County, California",16,15,1
1000000US060952503002018,060952503002018,"Block 2018, Block Group 2, Census Tract 2503, Solano County, California",18,15,3
1000000US060952503002019,060952503002019,"Block 2019, Block Group 2, Census Tract 2503, Solano County, California",18,17,1
1000000US060952503002020,060952503002020,"Block 2020, Block Group 2, Census Tract 2503, Solano County, California",16,15,1
1000000US060952503002021,060952503002021,"Block 2021, Block Group 2, Census Tract 2503, Solano County, California",8,7,1
1000000US060952503002022,060952503002022,"Block 2022, Block Group 2, Census Tract 2503, Solano County, California",36,32,4
1000000US060952503002023,060952503002023,"Block 2023, Block Group 2, Census Tract 2503, Solano County, California",13,12,1
1000000US060952503002024,060952503002024,"Block 2024, Block Group 2, Census Tract 2503, Solano County, California",18,18,0
1000000US060952503002025,060952503002025,"Block 2025, Block Group 2, Census Tract 2503, Solano County, California",46,42,4
1000000US060952503002026,060952503002026,"Block 2026, Block Group 2, Census Tract 2503, Solano County, California",0,0,0
1000000US060952503002027,060952503002027,"Block 2027, Block Group 2, Census Tract 2503, Solano County, California",0,0,0
1000000US060952503002028,060952503002028,"Block 2028, Block Group 2, Census Tract 2503, Solano County, California",0,0,0
1000000US060952503003000,060952503003000,"Block 3000, Block Group 3, Census Tract 2503, Solano County, California",135,115,20
1000000US060952503003001,060952503003001,"Block 3001, Block Group 3, Census Tract 2503, Solano County, California",0,0,0
1000000US060952503003002,060952503003002,"Block 3002, Block Group 3, Census Tract 2503, Solano County, California",38,36,2
1000000US060952503003003,060952503003003,"Block 3003, Block Group 3, Census Tract 2503, Solano County, California",45,42,3
1000000US060952503003004,060952503003004,"Block 3004, Block Group 3, Census Tract 2503, Solano County, California",18,17,1
1000000US060952503003005,060952503003005,"Block 3005, Block Group 3, Census Tract 2503, Solano County, California",19,16,3
1000000US060952503003006,060952503003006,"Block 3006, Block Group 3, Census Tract 2503, Solano County, California",2,1,1
1000000US060952503003007,060952503003007,"Block 3007, Block Group 3, Census Tract 2503, Solano County, California",39,34,5
1000000US060952504001000,060952504001000,"Block 1000, Block Group 1, Census Tract 2504, Solano County, California",45,42,3
1000000US060952504001001,060952504001001,"Block 1001, Block Group 1, Census Tract 2504, Solano County, California",22,21,1
1000000US060952504001002,060952504001002,"Block 1002, Block Group 1, Census Tract 2504, Solano County, California",47,43,4
1000000US060952504001003,060952504001003,"Block 1003, Block Group 1, Census Tract 2504, Solano County, California",55,51,4
1000000US060952504001004,060952504001004,"Block 1004, Block Group 1, Census Tract 2504, Solano County, California",43,37,6
1000000US060952504001005,060952504001005,"Block 1005, Block Group 1, Census Tract 2504, Solano County, California",0,0,0
1000000US060952504001006,060952504001006,"Block 1006, Block Group 1, Census Tract 2504, Solano County, California",38,33,5
1000000US060952504001007,060952504001007,"Block 1007, Block Group 1, Census Tract 2504, Solano County, California",21,19,2
1000000US060952504001008,060952504001008,"Block 1008, Block Group 1, Census Tract 2504, Solano County, California",14,14,0
1000000US060952504001009,060952504001009,"Block 1009, Block Group 1, Census Tract 2504, Solano County, California",14,14,0
1000000US060952504001010,060952504001010,"Block 1010, Block Group 1, Census Tract 2504, Solano County, California",22,21,1
1000000US060952504001011,060952504001011,"Block 1011, Block Group 1, Census Tract 2504, Solano County, California",23,21,2
1000000US060952504001012,060952504001012,"Block 1012, Block Group 1, Census Tract 2504, Solano County, California",0,0,0
1000000US060952504002000,060952504002000,"Block 2000, Block Group 2, Census Tract 2504, Solano County, California",0,0,0
1000000US060952504002001,060952504002001,"Block 2001, Block Group 2, Census Tract 2504, Solano County, California",25,22,3
1000000US060952504002002,060952504002002,"Block 2002, Block Group 2, Census Tract 2504, Solano County, California",0,0,0
1000000US060952504002003,060952504002003,"Block 2003, Block Group 2, Census Tract 2504, Solano County, California",14,10,4
1000000US060952504002004,060952504002004,"Block 2004, Block Group 2, Census Tract 2504, Solano County, California",54,51,3
1000000US060952504002005,060952504002005,"Block 2005, Block Group 2, Census Tract 2504, Solano County, California",44,42,2
1000000US060952504002006,060952504002006,"Block 2006, Block Group 2, Census Tract 2504, Solano County, California",47,44,3
1000000US060952504002007,060952504002007,"Block 2007, Block Group 2, Census Tract 2504, Solano County, California",45,41,4
1000000US060952504002008,060952504002008,"Block 2008, Block Group 2, Census Tract 2504, Solano County, California",47,43,4
1000000US060952504002009,060952504002009,"Block 2009, Block Group 2, Census Tract 2504, Solano County, California",92,89,3
1000000US060952504002010,060952504002010,"Block 2010, Block Group 2, Census Tract 2504, Solano County, California",69,63,6
1000000US060952504002011,060952504002011,"Block 2011, Block Group 2, Census Tract 2504, Solano County, California",14,14,0
1000000US060952504002012,060952504002012,"Block 2012, Block Group 2, Census Tract 2504, Solano County, California",5,5,0
1000000US060952504002013,060952504002013,"Block 2013, Block Group 2, Census Tract 2504, Solano County, California",49,48,1
1000000US060952504002014,060952504002014,"Block 2014, Block Group 2, Census Tract 2504, Solano County, California",0,0,0
1000000US060952504002015,060952504002015,"Block 2015, Block Group 2, Census Tract 2504, Solano County, California",12,11,1
1000000US060952504002016,060952504002016,"Block 2016, Block Group 2, Census Tract 2504, Solano County, California",6,4,2
1000000US060952504002017,060952504002017,"Block 2017, Block Group 2, Census Tract 2504, Solano County, California",0,0,0
1000000US060952504002018,060952504002018,"Block 2018, Block Group 2, Census Tract 2504, Solano County, California",0,0,0
1000000US060952504002019,060952504002019,"Block 2019, Block Group 2, Census Tract 2504, Solano County, California",33,27,6
1000000US060952504002020,060952504002020,"Block 2020, Block Group 2, Census Tract 2504, Solano County, California",3,3,0
1000000US060952504003000,060952504003000,"Block 3000, Block Group 3, Census Tract 2504, Solano County, California",45,41,4
1000000US060952504003001,060952504003001,"Block 3001, Block Group 3, Census Tract 2504, Solano County, California",41,34,7
1000000US060952504003002,060952504003002,"Block 3002, Block Group 3, Census Tract 2504, Solano County, California",35,33,2
1000000US060952504003003,060952504003003,"Block 3003, Block Group 3, Census Tract 2504, Solano County, California",5,5,0
1000000US060952504003004,060952504003004,"Block 3004, Block Group 3, Census Tract 2504, Solano County, California",0,0,0
1000000US060952504003005,060952504003005,"Block 3005, Block Group 3, Census Tract 2504, Solano County, California",0,0,0
1000000US060952504003006,060952504003006,"Block 3006, Block Group 3, Census Tract 2504, Solano County, California",0,0,0
1000000US060952504003007,060952504003007,"Block 3007, Block Group 3, Census Tract 2504, Solano County, California",34,28,6
1000000US060952504003008,060952504003008,"Block 3008, Block Group 3, Census Tract 2504, Solano County, California",26,21,5
1000000US060952504003009,060952504003009,"Block 3009, Block Group 3, Census Tract 2504, Solano County, California",36,34,2
1000000US060952504003010,060952504003010,"Block 3010, Block Group 3, Census Tract 2504, Solano County, California",34,27,7
1000000US060952504003011,060952504003011,"Block 3011, Block Group 3, Census Tract 2504, Solano County, California",33,28,5
1000000US060952504003012,060952504003012,"Block 3012, Block Group 3, Census Tract 2504, Solano County, California",29,28,1
1000000US060952504003013,060952504003013,"Block 3013, Block Group 3, Census Tract 2504, Solano County, California",12,12,0
1000000US060952504003014,060952504003014,"Block 3014, Block Group 3, Census Tract 2504, Solano County, California",0,0,0
1000000US060952504003015,060952504003015,"Block 3015, Block Group 3, Census Tract 2504, Solano County, California",0,0,0
1000000US060952504003016,060952504003016,"Block 3016, Block Group 3, Census Tract 2504, Solano County, California",0,0,0
1000000US060952504003017,060952504003017,"Block 3017, Block Group 3, Census Tract 2504, Solano County, California",0,0,0
1000000US060952504003018,060952504003018,"Block 3018, Block Group 3, Census Tract 2504, Solano County, California",0,0,0
1000000US060952504003019,060952504003019,"Block 3019, Block Group 3, Census Tract 2504, Solano County, California",0,0,0
1000000US060952504003020,060952504003020,"Block 3020, Block Group 3, Census Tract 2504, Solano County, California",14,14,0
1000000US060952504003021,060952504003021,"Block 3021, Block Group 3, Census Tract 2504, Solano County, California",31,29,2
1000000US060952504003022,060952504003022,"Block 3022, Block Group 3, Census Tract 2504, Solano County, California",3,3,0
1000000US060952505011000,060952505011000,"Block 1000, Block Group 1, Census Tract 2505.01, Solano County, California",12,11,1
1000000US060952505011001,060952505011001,"Block 1001, Block Group 1, Census Tract 2505.01, Solano County, California",28,27,1
1000000US060952505011002,060952505011002,"Block 1002, Block Group 1, Census Tract 2505.01, Solano County, California",20,18,2
1000000US060952505011003,060952505011003,"Block 1003, Block Group 1, Census Tract 2505.01, Solano County, California",23,20,3
1000000US060952505011004,060952505011004,"Block 1004, Block Group 1, Census Tract 2505.01, Solano County, California",36,31,5
1000000US060952505011005,060952505011005,"Block 1005, Block Group 1, Census Tract 2505.01, Solano County, California",40,36,4
1000000US060952505011006,060952505011006,"Block 1006, Block Group 1, Census Tract 2505.01, Solano County, California",40,40,0
1000000US060952505011007,060952505011007,"Block 1007, Block Group 1, Census Tract 2505.01, Solano County, California",23,22,1
1000000US060952505011008,060952505011008,"Block 1008, Block Group 1, Census Tract 2505.01, Solano County, California",23,23,0
1000000US060952505011009,060952505011009,"Block 1009, Block Group 1, Census Tract 2505.01, Solano County, California",14,12,2
1000000US060952505011010,060952505011010,"Block 1010, Block Group 1, Census Tract 2505.01, Solano County, California",24,24,0
1000000US060952505011011,060952505011011,"Block 1011, Block Group 1, Census Tract 2505.01, Solano County, California",15,13,2
1000000US060952505011012,060952505011012,"Block 1012, Block Group 1, Census Tract 2505.01, Solano County, California",48,47,1
1000000US060952505012000,060952505012000,"Block 2000, Block Group 2, Census Tract 2505.01, Solano County, California",151,137,14
1000000US060952505012001,060952505012001,"Block 2001, Block Group 2, Census Tract 2505.01, Solano County, California",33,29,4
1000000US060952505012002,060952505012002,"Block 2002, Block Group 2, Census Tract 2505.01, Solano County, California",44,39,5
1000000US060952505012003,060952505012003,"Block 2003, Block Group 2, Census Tract 2505.01, Solano County, California",21,17,4
1000000US060952505012004,060952505012004,"Block 2004, Block Group 2, Census Tract 2505.01, Solano County, California",9,8,1
1000000US060952505012005,060952505012005,"Block 2005, Block Group 2, Census Tract 2505.01, Solano County, California",22,21,1
1000000US060952505012006,060952505012006,"Block 2006, Block Group 2, Census Tract 2505.01, Solano County, California",0,0,0
1000000US060952505012007,060952505012007,"Block 2007, Block Group 2, Census Tract 2505.01, Solano County, California",66,42,24
1000000US060952505012008,060952505012008,"Block 2008, Block Group 2, Census Tract 2505.01, Solano County, California",67,62,5
1000000US060952505012009,060952505012009,"Block 2009, Block Group 2, Census Tract 2505.01, Solano County, California",0,0,0
1000000US060952505012010,060952505012010,"Block 2010, Block Group 2, Census Tract 2505.01, Solano County, California",38,37,1
1000000US060952505012011,060952505012011,"Block 2011, Block Group 2, Census Tract 2505.01, Solano County, California",8,6,2
1000000US060952505012012,060952505012012,"Block 2012, Block Group 2, Census Tract 2505.01, Solano County, California",0,0,0
1000000US060952505012013,060952505012013,"Block 2013, Block Group 2, Census Tract 2505.01, Solano County, California",0,0,0
1000000US060952505021000,060952505021000,"Block 1000, Block Group 1, Census Tract 2505.02, Solano County, California",37,35,2
1000000US060952505021001,060952505021001,"Block 1001, Block Group 1, Census Tract 2505.02, Solano County, California",17,16,1
1000000US060952505021002,060952505021002,"Block 1002, Block Group 1, Census Tract 2505.02, Solano County, California",17,16,1
1000000US060952505021003,060952505021003,"Block 1003, Block Group 1, Census Tract 2505.02, Solano County, California",143,134,9
1000000US060952505021004,060952505021004,"Block 1004, Block Group 1, Census Tract 2505.02, Solano County, California",12,12,0
1000000US060952505021005,060952505021005,"Block 1005, Block Group 1, Census Tract 2505.02, Solano County, California",19,16,3
1000000US060952505021006,060952505021006,"Block 1006, Block Group 1, Census Tract 2505.02, Solano County, California",32,30,2
1000000US060952505021007,060952505021007,"Block 1007, Block Group 1, Census Tract 2505.02, Solano County, California",37,35,2
1000000US060952505021008,060952505021008,"Block 1008, Block Group 1, Census Tract 2505.02, Solano County, California",29,27,2
1000000US060952505021009,060952505021009,"Block 1009, Block Group 1, Census Tract 2505.02, Solano County, California",34,34,0
1000000US060952505021010,060952505021010,"Block 1010, Block Group 1, Census Tract 2505.02, Solano County, California",27,25,2
1000000US060952505021011,060952505021011,"Block 1011, Block Group 1, Census Tract 2505.02, Solano County, California",45,41,4
1000000US060952505021012,060952505021012,"Block 1012, Block Group 1, Census Tract 2505.02, Solano County, California",32,31,1
1000000US060952505021013,060952505021013,"Block 1013, Block Group 1, Census Tract 2505.02, Solano County, California",18,17,1
1000000US060952505021014,060952505021014,"Block 1014, Block Group 1, Census Tract 2505.02, Solano County, California",31,30,1
1000000US060952505021015,060952505021015,"Block 1015, Block Group 1, Census Tract 2505.02, Solano County, California",14,13,1
1000000US060952505021016,060952505021016,"Block 1016, Block Group 1, Census Tract 2505.02, Solano County, California",14,14,0
1000000US060952505021017,060952505021017,"Block 1017, Block Group 1, Census Tract 2505.02, Solano County, California",20,19,1
1000000US060952505022000,060952505022000,"Block 2000, Block Group 2, Census Tract 2505.02, Solano County, California",52,50,2
1000000US060952505022001,060952505022001,"Block 2001, Block Group 2, Census Tract 2505.02, Solano County, California",25,24,1
1000000US060952505022002,060952505022002,"Block 2002, Block Group 2, Census Tract 2505.02, Solano County, California",100,99,1
1000000US060952505022003,060952505022003,"Block 2003, Block Group 2, Census Tract 2505.02, Solano County, California",236,222,14
1000000US060952505022004,060952505022004,"Block 2004, Block Group 2, Census Tract 2505.02, Solano County, California",26,25,1
1000000US060952505022005,060952505022005,"Block 2005, Block Group 2, Census Tract 2505.02, Solano County, California",10,10,0
1000000US060952505022006,060952505022006,"Block 2006, Block Group 2, Census Tract 2505.02, Solano County, California",19,19,0
1000000US060952505022007,060952505022007,"Block 2007, Block Group 2, Census Tract 2505.02, Solano County, California",0,0,0
1000000US060952505022008,060952505022008,"Block 2008, Block Group 2, Census Tract 2505.02, Solano County, California",9,9,0
1000000US060952505022009,060952505022009,"Block 2009, Block Group 2, Census Tract 2505.02, Solano County, California",15,15,0
1000000US060952505022010,060952505022010,"Block 2010, Block Group 2, Census Tract 2505.02, Solano County, California",108,100,8
1000000US060952505022011,060952505022011,"Block 2011, Block Group 2, Census Tract 2505.02, Solano County, California",1,1,0
1000000US060952505022012,060952505022012,"Block 2012, Block Group 2, Census Tract 2505.02, Solano County, California",11,11,0
1000000US060952505022013,060952505022013,"Block 2013, Block Group 2, Census Tract 2505.02, Solano County, California",0,0,0
1000000US060952505022014,060952505022014,"Block 2014, Block Group 2, Census Tract 2505.02, Solano County, California",0,0,0
1000000US060952505022015,060952505022015,"Block 2015, Block Group 2, Census Tract 2505.02, Solano County, California",0,0,0
1000000US060952505022016,060952505022016,"Block 2016, Block Group 2, Census Tract 2505.02, Solano County, California",0,0,0
1000000US060952505022017,060952505022017,"Block 2017, Block Group 2, Census Tract 2505.02, Solano County, California",0,0,0
1000000US060952505022018,060952505022018,"Block 2018, Block Group 2, Census Tract 2505.02, Solano County, California",1,1,0
1000000US060952505022019,060952505022019,"Block 2019, Block Group 2, Census Tract 2505.02, Solano County, California",1,0,1
1000000US060952505022020,060952505022020,"Block 2020, Block Group 2, Census Tract 2505.02, Solano County, California",0,0,0
1000000US060952505022021,060952505022021,"Block 2021, Block Group 2, Census Tract 2505.02, Solano County, California",0,0,0
1000000US060952505022022,060952505022022,"Block 2022, Block Group 2, Census Tract 2505.02, Solano County, California",0,0,0
1000000US060952506011000,060952506011000,"Block 1000, Block Group 1, Census Tract 2506.01, Solano County, California",0,0,0
1000000US060952506011001,060952506011001,"Block 1001, Block Group 1, Census Tract 2506.01, Solano County, California",30,25,5
1000000US060952506011002,060952506011002,"Block 1002, Block Group 1, Census Tract 2506.01, Solano County, California",0,0,0
1000000US060952506011003,060952506011003,"Block 1003, Block Group 1, Census Tract 2506.01, Solano County, California",43,40,3
1000000US060952506011004,060952506011004,"Block 1004, Block Group 1, Census Tract 2506.01, Solano County, California",0,0,0
1000000US060952506011005,060952506011005,"Block 1005, Block Group 1, Census Tract 2506.01, Solano County, California",34,32,2
1000000US060952506011006,060952506011006,"Block 1006, Block Group 1, Census Tract 2506.01, Solano County, California",32,27,5
1000000US060952506011007,060952506011007,"Block 1007, Block Group 1, Census Tract 2506.01, Solano County, California",19,17,2
1000000US060952506011008,060952506011008,"Block 1008, Block Group 1, Census Tract 2506.01, Solano County, California",28,25,3
1000000US060952506011009,060952506011009,"Block 1009, Block Group 1, Census Tract 2506.01, Solano County, California",13,11,2
1000000US060952506011010,060952506011010,"Block 1010, Block Group 1, Census Tract 2506.01, Solano County, California",0,0,0
1000000US060952506011011,060952506011011,"Block 1011, Block Group 1, Census Tract 2506.01, Solano County, California",0,0,0
1000000US060952506011012,060952506011012,"Block 1012, Block Group 1, Census Tract 2506.01, Solano County, California",8,7,1
1000000US060952506011013,060952506011013,"Block 1013, Block Group 1, Census Tract 2506.01, Solano County, California",41,38,3
1000000US060952506011014,060952506011014,"Block 1014, Block Group 1, Census Tract 2506.01, Solano County, California",22,19,3
1000000US060952506011015,060952506011015,"Block 1015, Block Group 1, Census Tract 2506.01, Solano County, California",39,36,3
1000000US060952506011016,060952506011016,"Block 1016, Block Group 1, Census Tract 2506.01, Solano County, California",21,15,6
1000000US060952506011017,060952506011017,"Block 1017, Block Group 1, Census Tract 2506.01, Solano County, California",10,8,2
1000000US060952506011018,060952506011018,"Block 1018, Block Group 1, Census Tract 2506.01, Solano County, California",16,13,3
1000000US060952506011019,060952506011019,"Block 1019, Block Group 1, Census Tract 2506.01, Solano County, California",19,19,0
1000000US060952506011020,060952506011020,"Block 1020, Block Group 1, Census Tract 2506.01, Solano County, California",22,21,1
1000000US060952506011021,060952506011021,"Block 1021, Block Group 1, Census Tract 2506.01, Solano County, California",33,29,4
1000000US060952506011022,060952506011022,"Block 1022, Block Group 1, Census Tract 2506.01, Solano County, California",17,15,2
1000000US060952506011023,060952506011023,"Block 1023, Block Group 1, Census Tract 2506.01, Solano County, California",8,7,1
1000000US060952506011024,060952506011024,"Block 1024, Block Group 1, Census Tract 2506.01, Solano County, California",28,25,3
1000000US060952506011025,060952506011025,"Block 1025, Block Group 1, Census Tract 2506.01, Solano County, California",36,30,6
1000000US060952506011026,060952506011026,"Block 1026, Block Group 1, Census Tract 2506.01, Solano County, California",29,28,1
1000000US060952506011027,060952506011027,"Block 1027, Block Group 1, Census Tract 2506.01, Solano County, California",18,16,2
1000000US060952506012000,060952506012000,"Block 2000, Block Group 2, Census Tract 2506.01, Solano County, California",77,75,2
1000000US060952506012001,060952506012001,"Block 2001, Block Group 2, Census Tract 2506.01, Solano County, California",5,5,0
1000000US060952506012002,060952506012002,"Block 2002, Block Group 2, Census Tract 2506.01, Solano County, California",0,0,0
1000000US060952506012003,060952506012003,"Block 2003, Block Group 2, Census Tract 2506.01, Solano County, California",0,0,0
1000000US060952506012004,060952506012004,"Block 2004, Block Group 2, Census Tract 2506.01, Solano County, California",173,161,12
1000000US060952506012005,060952506012005,"Block 2005, Block Group 2, Census Tract 2506.01, Solano County, California",0,0,0
1000000US060952506012006,060952506012006,"Block 2006, Block Group 2, Census Tract 2506.01, Solano County, California",109,101,8
1000000US060952506012007,060952506012007,"Block 2007, Block Group 2, Census Tract 2506.01, Solano County, California",2,2,0
1000000US060952506012008,060952506012008,"Block 2008, Block Group 2, Census Tract 2506.01, Solano County, California",51,49,2
1000000US060952506012009,060952506012009,"Block 2009, Block Group 2, Census Tract 2506.01, Solano County, California",93,89,4
1000000US060952506012010,060952506012010,"Block 2010, Block Group 2, Census Tract 2506.01, Solano County, California",5,5,0
1000000US060952506012011,060952506012011,"Block 2011, Block Group 2, Census Tract 2506.01, Solano County, California",41,37,4
1000000US060952506012012,060952506012012,"Block 2012, Block Group 2, Census Tract 2506.01, Solano County, California",47,43,4
1000000US060952506012013,060952506012013,"Block 2013, Block Group 2, Census Tract 2506.01, Solano County, California",19,19,0
1000000US060952506012014,060952506012014,"Block 2014, Block Group 2, Census Tract 2506.01, Solano County, California",0,0,0
1000000US060952506012015,060952506012015,"Block 2015, Block Group 2, Census Tract 2506.01, Solano County, California",5,5,0
1000000US060952506012016,060952506012016,"Block 2016, Block Group 2, Census Tract 2506.01, Solano County, California",35,33,2
1000000US060952506012017,060952506012017,"Block 2017, Block Group 2, Census Tract 2506.01, Solano County, California",0,0,0
1000000US060952506012018,060952506012018,"Block 2018, Block Group 2, Census Tract 2506.01, Solano County, California",3,3,0
1000000US060952506013000,060952506013000,"Block 3000, Block Group 3, Census Tract 2506.01, Solano County, California",0,0,0
1000000US060952506013001,060952506013001,"Block 3001, Block Group 3, Census Tract 2506.01, Solano County, California",84,74,10
1000000US060952506013002,060952506013002,"Block 3002, Block Group 3, Census Tract 2506.01, Solano County, California",0,0,0
1000000US060952506013003,060952506013003,"Block 3003, Block Group 3, Census Tract 2506.01, Solano County, California",13,13,0
1000000US060952506013004,060952506013004,"Block 3004, Block Group 3, Census Tract 2506.01, Solano County, California",19,17,2
1000000US060952506013005,060952506013005,"Block 3005, Block Group 3, Census Tract 2506.01, Solano County, California",20,19,1
1000000US060952506013006,060952506013006,"Block 3006, Block Group 3, Census Tract 2506.01, Solano County, California",20,18,2
1000000US060952506013007,060952506013007,"Block 3007, Block Group 3, Census Tract 2506.01, Solano County, California",0,0,0
1000000US060952506013008,060952506013008,"Block 3008, Block Group 3, Census Tract 2506.01, Solano County, California",0,0,0
1000000US060952506013009,060952506013009,"Block 3009, Block Group 3, Census Tract 2506.01, Solano County, California",0,0,0
1000000US060952506013010,060952506013010,"Block 3010, Block Group 3, Census Tract 2506.01, Solano County, California",0,0,0
1000000US060952506013011,060952506013011,"Block 3011, Block Group 3, Census Tract 2506.01, Solano County, California",0,0,0
1000000US060952506013012,060952506013012,"Block 3012, Block Group 3, Census Tract 2506.01, Solano County, California",34,33,1
1000000US060952506013013,060952506013013,"Block 3013, Block Group 3, Census Tract 2506.01, Solano County, California",16,16,0
1000000US060952506013014,060952506013014,"Block 3014, Block Group 3, Census Tract 2506.01, Solano County, California",42,41,1
1000000US060952506013015,060952506013015,"Block 3015, Block Group 3, Census Tract 2506.01, Solano County, California",24,23,1
1000000US060952506013016,060952506013016,"Block 3016, Block Group 3, Census Tract 2506.01, Solano County, California",24,23,1
1000000US060952506013017,060952506013017,"Block 3017, Block Group 3, Census Tract 2506.01, Solano County, California",48,44,4
1000000US060952506013018,060952506013018,"Block 3018, Block Group 3, Census Tract 2506.01, Solano County, California",0,0,0
1000000US060952506041000,060952506041000,"Block 1000, Block Group 1, Census Tract 2506.04, Solano County, California",25,24,1
1000000US060952506041001,060952506041001,"Block 1001, Block Group 1, Census Tract 2506.04, Solano County, California",103,100,3
1000000US060952506041002,060952506041002,"Block 1002, Block Group 1, Census Tract 2506.04, Solano County, California",22,22,0
1000000US060952506041003,060952506041003,"Block 1003, Block Group 1, Census Tract 2506.04, Solano County, California",15,15,0
1000000US060952506041004,060952506041004,"Block 1004, Block Group 1, Census Tract 2506.04, Solano County, California",13,13,0
1000000US060952506041005,060952506041005,"Block 1005, Block Group 1, Census Tract 2506.04, Solano County, California",3,2,1
1000000US060952506041006,060952506041006,"Block 1006, Block Group 1, Census Tract 2506.04, Solano County, California",4,3,1
1000000US060952506041007,060952506041007,"Block 1007, Block Group 1, Census Tract 2506.04, Solano County, California",55,52,3
1000000US060952506041008,060952506041008,"Block 1008, Block Group 1, Census Tract 2506.04, Solano County, California",6,5,1
1000000US060952506041009,060952506041009,"Block 1009, Block Group 1, Census Tract 2506.04, Solano County, California",13,10,3
1000000US060952506041010,060952506041010,"Block 1010, Block Group 1, Census Tract 2506.04, Solano County, California",376,341,35
1000000US060952506041011,060952506041011,"Block 1011, Block Group 1, Census Tract 2506.04, Solano County, California",19,19,0
1000000US060952506041012,060952506041012,"Block 1012, Block Group 1, Census Tract 2506.04, Solano County, California",26,24,2
1000000US060952506041013,060952506041013,"Block 1013, Block Group 1, Census Tract 2506.04, Solano County, California",0,0,0
1000000US060952506041014,060952506041014,"Block 1014, Block Group 1, Census Tract 2506.04, Solano County, California",1,1,0
1000000US060952506041015,060952506041015,"Block 1015, Block Group 1, Census Tract 2506.04, Solano County, California",10,9,1
1000000US060952506041016,060952506041016,"Block 1016, Block Group 1, Census Tract 2506.04, Solano County, California",72,62,10
1000000US060952506041017,060952506041017,"Block 1017, Block Group 1, Census Tract 2506.04, Solano County, California",0,0,0
1000000US060952506042000,060952506042000,"Block 2000, Block Group 2, Census Tract 2506.04, Solano County, California",90,82,8
1000000US060952506042001,060952506042001,"Block 2001, Block Group 2, Census Tract 2506.04, Solano County, California",64,57,7
1000000US060952506042002,060952506042002,"Block 2002, Block Group 2, Census Tract 2506.04, Solano County, California",63,59,4
1000000US060952506042003,060952506042003,"Block 2003, Block Group 2, Census Tract 2506.04, Solano County, California",103,99,4
1000000US060952506042004,060952506042004,"Block 2004, Block Group 2, Census Tract 2506.04, Solano County, California",32,31,1
1000000US060952506042005,060952506042005,"Block 2005, Block Group 2, Census Tract 2506.04, Solano County, California",33,32,1
1000000US060952506042006,060952506042006,"Block 2006, Block Group 2, Census Tract 2506.04, Solano County, California",0,0,0
1000000US060952506042007,060952506042007,"Block 2007, Block Group 2, Census Tract 2506.04, Solano County, California",0,0,0
1000000US060952506043000,060952506043000,"Block 3000, Block Group 3, Census Tract 2506.04, Solano County, California",4,3,1
1000000US060952506043001,060952506043001,"Block 3001, Block Group 3, Census Tract 2506.04, Solano County, California",54,52,2
1000000US060952506043002,060952506043002,"Block 3002, Block Group 3, Census Tract 2506.04, Solano County, California",0,0,0
1000000US060952506043003,060952506043003,"Block 3003, Block Group 3, Census Tract 2506.04, Solano County, California",265,253,12
1000000US060952506043004,060952506043004,"Block 3004, Block Group 3, Census Tract 2506.04, Solano County, California",29,29,0
1000000US060952506043005,060952506043005,"Block 3005, Block Group 3, Census Tract 2506.04, Solano County, California",35,35,0
1000000US060952506043006,060952506043006,"Block 3006, Block Group 3, Census Tract 2506.04, Solano County, California",27,22,5
1000000US060952506043007,060952506043007,"Block 3007, Block Group 3, Census Tract 2506.04, Solano County, California",4,2,2
1000000US060952506043008,060952506043008,"Block 3008, Block Group 3, Census Tract 2506.04, Solano County, California",0,0,0
1000000US060952506051000,060952506051000,"Block 1000, Block Group 1, Census Tract 2506.05, Solano County, California",1,1,0
1000000US060952506051001,060952506051001,"Block 1001, Block Group 1, Census Tract 2506.05, Solano County, California",0,0,0
1000000US060952506051002,060952506051002,"Block 1002, Block Group 1, Census Tract 2506.05, Solano County, California",0,0,0
1000000US060952506051003,060952506051003,"Block 1003, Block Group 1, Census Tract 2506.05, Solano County, California",78,77,1
1000000US060952506051004,060952506051004,"Block 1004, Block Group 1, Census Tract 2506.05, Solano County, California",10,10,0
1000000US060952506051005,060952506051005,"Block 1005, Block Group 1, Census Tract 2506.05, Solano County, California",11,11,0
1000000US060952506051006,060952506051006,"Block 1006, Block Group 1, Census Tract 2506.05, Solano County, California",9,8,1
1000000US060952506051007,060952506051007,"Block 1007, Block Group 1, Census Tract 2506.05, Solano County, California",18,18,0
1000000US060952506051008,060952506051008,"Block 1008, Block Group 1, Census Tract 2506.05, Solano County, California",10,10,0
1000000US060952506051009,060952506051009,"Block 1009, Block Group 1, Census Tract 2506.05, Solano County, California",21,18,3
1000000US060952506051010,060952506051010,"Block 1010, Block Group 1, Census Tract 2506.05, Solano County, California",0,0,0
1000000US060952506051011,060952506051011,"Block 1011, Block Group 1, Census Tract 2506.05, Solano County, California",68,66,2
1000000US060952506051012,060952506051012,"Block 1012, Block Group 1, Census Tract 2506.05, Solano County, California",15,15,0
1000000US060952506051013,060952506051013,"Block 1013, Block Group 1, Census Tract 2506.05, Solano County, California",27,26,1
1000000US060952506051014,060952506051014,"Block 1014, Block Group 1, Census Tract 2506.05, Solano County, California",39,38,1
1000000US060952506052000,060952506052000,"Block 2000, Block Group 2, Census Tract 2506.05, Solano County, California",0,0,0
1000000US060952506052001,060952506052001,"Block 2001, Block Group 2, Census Tract 2506.05, Solano County, California",0,0,0
1000000US060952506052002,060952506052002,"Block 2002, Block Group 2, Census Tract 2506.05, Solano County, California",161,156,5
1000000US060952506052003,060952506052003,"Block 2003, Block Group 2, Census Tract 2506.05, Solano County, California",12,12,0
1000000US060952506052004,060952506052004,"Block 2004, Block Group 2, Census Tract 2506.05, Solano County, California",53,53,0
1000000US060952506052005,060952506052005,"Block 2005, Block Group 2, Census Tract 2506.05, Solano County, California",22,21,1
1000000US060952506052006,060952506052006,"Block 2006, Block Group 2, Census Tract 2506.05, Solano County, California",91,88,3
1000000US060952506052007,060952506052007,"Block 2007, Block Group 2, Census Tract 2506.05, Solano County, California",29,28,1
1000000US060952506052008,060952506052008,"Block 2008, Block Group 2, Census Tract 2506.05, Solano County, California",1,1,0
1000000US060952506052009,060952506052009,"Block 2009, Block Group 2, Census Tract 2506.05, Solano County, California",75,71,4
1000000US060952506052010,060952506052010,"Block 2010, Block Group 2, Census Tract 2506.05, Solano County, California",19,19,0
1000000US060952506052011,060952506052011,"Block 2011, Block Group 2, Census Tract 2506.05, Solano County, California",4,4,0
1000000US060952506052012,060952506052012,"Block 2012, Block Group 2, Census Tract 2506.05, Solano County, California",0,0,0
1000000US060952506052013,060952506052013,"Block 2013, Block Group 2, Census Tract 2506.05, Solano County, California",0,0,0
1000000US060952506053000,060952506053000,"Block 3000, Block Group 3, Census Tract 2506.05, Solano County, California",453,413,40
1000000US060952506053001,060952506053001,"Block 3001, Block Group 3, Census Tract 2506.05, Solano County, California",17,17,0
1000000US060952506053002,060952506053002,"Block 3002, Block Group 3, Census Tract 2506.05, Solano County, California",22,21,1
1000000US060952506053003,060952506053003,"Block 3003, Block Group 3, Census Tract 2506.05, Solano County, California",212,201,11
1000000US060952506053004,060952506053004,"Block 3004, Block Group 3, Census Tract 2506.05, Solano County, California",15,15,0
1000000US060952506053005,060952506053005,"Block 3005, Block Group 3, Census Tract 2506.05, Solano County, California",0,0,0
1000000US060952506053006,060952506053006,"Block 3006, Block Group 3, Census Tract 2506.05, Solano County, California",30,29,1
1000000US060952506053007,060952506053007,"Block 3007, Block Group 3, Census Tract 2506.05, Solano County, California",0,0,0
1000000US060952506053008,060952506053008,"Block 3008, Block Group 3, Census Tract 2506.05, Solano County, California",0,0,0
1000000US060952506053009,060952506053009,"Block 3009, Block Group 3, Census Tract 2506.05, Solano County, California",0,0,0
1000000US060952506053010,060952506053010,"Block 3010, Block Group 3, Census Tract 2506.05, Solano County, California",0,0,0
1000000US060952506053011,060952506053011,"Block 3011, Block Group 3, Census Tract 2506.05, Solano County, California",0,0,0
1000000US060952506053012,060952506053012,"Block 3012, Block Group 3, Census Tract 2506.05, Solano County, California",0,0,0
1000000US060952506053013,060952506053013,"Block 3013, Block Group 3, Census Tract 2506.05, Solano County, California",0,0,0
1000000US060952507011000,060952507011000,"Block 1000, Block Group 1, Census Tract 2507.01, Solano County, California",0,0,0
1000000US060952507011001,060952507011001,"Block 1001, Block Group 1, Census Tract 2507.01, Solano County, California",11,8,3
1000000US060952507011002,060952507011002,"Block 1002, Block Group 1, Census Tract 2507.01, Solano County, California",0,0,0
1000000US060952507011003,060952507011003,"Block 1003, Block Group 1, Census Tract 2507.01, Solano County, California",10,9,1
1000000US060952507011004,060952507011004,"Block 1004, Block Group 1, Census Tract 2507.01, Solano County, California",29,15,14
1000000US060952507011005,060952507011005,"Block 1005, Block Group 1, Census Tract 2507.01, Solano County, California",0,0,0
1000000US060952507011006,060952507011006,"Block 1006, Block Group 1, Census Tract 2507.01, Solano County, California",14,11,3
1000000US060952507011007,060952507011007,"Block 1007, Block Group 1, Census Tract 2507.01, Solano County, California",0,0,0
1000000US060952507011008,060952507011008,"Block 1008, Block Group 1, Census Tract 2507.01, Solano County, California",20,16,4
1000000US060952507011009,060952507011009,"Block 1009, Block Group 1, Census Tract 2507.01, Solano County, California",0,0,0
1000000US060952507011010,060952507011010,"Block 1010, Block Group 1, Census Tract 2507.01, Solano County, California",0,0,0
1000000US060952507011011,060952507011011,"Block 1011, Block Group 1, Census Tract 2507.01, Solano County, California",25,25,0
1000000US060952507011012,060952507011012,"Block 1012, Block Group 1, Census Tract 2507.01, Solano County, California",14,10,4
1000000US060952507011013,060952507011013,"Block 1013, Block Group 1, Census Tract 2507.01, Solano County, California",20,14,6
1000000US060952507011014,060952507011014,"Block 1014, Block Group 1, Census Tract 2507.01, Solano County, California",25,14,11
1000000US060952507011015,060952507011015,"Block 1015, Block Group 1, Census Tract 2507.01, Solano County, California",0,0,0
1000000US060952507011016,060952507011016,"Block 1016, Block Group 1, Census Tract 2507.01, Solano County, California",0,0,0
1000000US060952507011017,060952507011017,"Block 1017, Block Group 1, Census Tract 2507.01, Solano County, California",0,0,0
1000000US060952507011018,060952507011018,"Block 1018, Block Group 1, Census Tract 2507.01, Solano County, California",5,5,0
1000000US060952507011019,060952507011019,"Block 1019, Block Group 1, Census Tract 2507.01, Solano County, California",0,0,0
1000000US060952507011020,060952507011020,"Block 1020, Block Group 1, Census Tract 2507.01, Solano County, California",0,0,0
1000000US060952507011021,060952507011021,"Block 1021, Block Group 1, Census Tract 2507.01, Solano County, California",0,0,0
1000000US060952507011022,060952507011022,"Block 1022, Block Group 1, Census Tract 2507.01, Solano County, California",6,6,0
1000000US060952507011023,060952507011023,"Block 1023, Block Group 1, Census Tract 2507.01, Solano County, California",3,1,2
1000000US060952507011024,060952507011024,"Block 1024, Block Group 1, Census Tract 2507.01, Solano County, California",0,0,0
1000000US060952507011025,060952507011025,"Block 1025, Block Group 1, Census Tract 2507.01, Solano County, California",16,14,2
1000000US060952507011026,060952507011026,"Block 1026, Block Group 1, Census Tract 2507.01, Solano County, California",14,13,1
1000000US060952507011027,060952507011027,"Block 1027, Block Group 1, Census Tract 2507.01, Solano County, California",0,0,0
1000000US060952507011028,060952507011028,"Block 1028, Block Group 1, Census Tract 2507.01, Solano County, California",0,0,0
1000000US060952507011029,060952507011029,"Block 1029, Block Group 1, Census Tract 2507.01, Solano County, California",0,0,0
1000000US060952507011030,060952507011030,"Block 1030, Block Group 1, Census Tract 2507.01, Solano County, California",0,0,0
1000000US060952507011031,060952507011031,"Block 1031, Block Group 1, Census Tract 2507.01, Solano County, California",0,0,0
1000000US060952507011032,060952507011032,"Block 1032, Block Group 1, Census Tract 2507.01, Solano County, California",0,0,0
1000000US060952507011033,060952507011033,"Block 1033, Block Group 1, Census Tract 2507.01, Solano County, California",0,0,0
1000000US060952507011034,060952507011034,"Block 1034, Block Group 1, Census Tract 2507.01, Solano County, California",0,0,0
1000000US060952507011035,060952507011035,"Block 1035, Block Group 1, Census Tract 2507.01, Solano County, California",0,0,0
1000000US060952507011036,060952507011036,"Block 1036, Block Group 1, Census Tract 2507.01, Solano County, California",0,0,0
1000000US060952507011037,060952507011037,"Block 1037, Block Group 1, Census Tract 2507.01, Solano County, California",0,0,0
1000000US060952507011038,060952507011038,"Block 1038, Block Group 1, Census Tract 2507.01, Solano County, California",0,0,0
1000000US060952507011039,060952507011039,"Block 1039, Block Group 1, Census Tract 2507.01, Solano County, California",0,0,0
1000000US060952507011040,060952507011040,"Block 1040, Block Group 1, Census Tract 2507.01, Solano County, California",0,0,0
1000000US060952507011041,060952507011041,"Block 1041, Block Group 1, Census Tract 2507.01, Solano County, California",28,26,2
1000000US060952507011042,060952507011042,"Block 1042, Block Group 1, Census Tract 2507.01, Solano County, California",46,44,2
1000000US060952507011043,060952507011043,"Block 1043, Block Group 1, Census Tract 2507.01, Solano County, California",6,5,1
1000000US060952507011044,060952507011044,"Block 1044, Block Group 1, Census Tract 2507.01, Solano County, California",0,0,0
1000000US060952507011045,060952507011045,"Block 1045, Block Group 1, Census Tract 2507.01, Solano County, California",0,0,0
1000000US060952507011046,060952507011046,"Block 1046, Block Group 1, Census Tract 2507.01, Solano County, California",1,1,0
1000000US060952507011047,060952507011047,"Block 1047, Block Group 1, Census Tract 2507.01, Solano County, California",90,86,4
1000000US060952507011048,060952507011048,"Block 1048, Block Group 1, Census Tract 2507.01, Solano County, California",12,11,1
1000000US060952507011049,060952507011049,"Block 1049, Block Group 1, Census Tract 2507.01, Solano County, California",8,8,0
1000000US060952507011050,060952507011050,"Block 1050, Block Group 1, Census Tract 2507.01, Solano County, California",12,12,0
1000000US060952507011051,060952507011051,"Block 1051, Block Group 1, Census Tract 2507.01, Solano County, California",27,25,2
1000000US060952507011052,060952507011052,"Block 1052, Block Group 1, Census Tract 2507.01, Solano County, California",38,23,15
1000000US060952507011053,060952507011053,"Block 1053, Block Group 1, Census Tract 2507.01, Solano County, California",0,0,0
1000000US060952507011054,060952507011054,"Block 1054, Block Group 1, Census Tract 2507.01, Solano County, California",21,13,8
1000000US060952507011055,060952507011055,"Block 1055, Block Group 1, Census Tract 2507.01, Solano County, California",33,17,16
1000000US060952507011056,060952507011056,"Block 1056, Block Group 1, Census Tract 2507.01, Solano County, California",11,11,0
1000000US060952507011057,060952507011057,"Block 1057, Block Group 1, Census Tract 2507.01, Solano County, California",98,88,10
1000000US060952507011058,060952507011058,"Block 1058, Block Group 1, Census Tract 2507.01, Solano County, California",0,0,0
1000000US060952507011059,060952507011059,"Block 1059, Block Group 1, Census Tract 2507.01, Solano County, California",0,0,0
1000000US060952507011060,060952507011060,"Block 1060, Block Group 1, Census Tract 2507.01, Solano County, California",0,0,0
1000000US060952507011061,060952507011061,"Block 1061, Block Group 1, Census Tract 2507.01, Solano County, California",1,1,0
1000000US060952507011062,060952507011062,"Block 1062, Block Group 1, Census Tract 2507.01, Solano County, California",6,6,0
1000000US060952507011063,060952507011063,"Block 1063, Block Group 1, Census Tract 2507.01, Solano County, California",0,0,0
1000000US060952507011064,060952507011064,"Block 1064, Block Group 1, Census Tract 2507.01, Solano County, California",0,0,0
1000000US060952507011065,060952507011065,"Block 1065, Block Group 1, Census Tract 2507.01, Solano County, California",22,21,1
1000000US060952507011066,060952507011066,"Block 1066, Block Group 1, Census Tract 2507.01, Solano County, California",0,0,0
1000000US060952507011067,060952507011067,"Block 1067, Block Group 1, Census Tract 2507.01, Solano County, California",0,0,0
1000000US060952507012000,060952507012000,"Block 2000, Block Group 2, Census Tract 2507.01, Solano County, California",28,21,7
1000000US060952507012001,060952507012001,"Block 2001, Block Group 2, Census Tract 2507.01, Solano County, California",26,15,11
1000000US060952507012002,060952507012002,"Block 2002, Block Group 2, Census Tract 2507.01, Solano County, California",26,22,4
1000000US060952507012003,060952507012003,"Block 2003, Block Group 2, Census Tract 2507.01, Solano County, California",23,19,4
1000000US060952507012004,060952507012004,"Block 2004, Block Group 2, Census Tract 2507.01, Solano County, California",17,16,1
1000000US060952507012005,060952507012005,"Block 2005, Block Group 2, Census Tract 2507.01, Solano County, California",25,18,7
1000000US060952507012006,060952507012006,"Block 2006, Block Group 2, Census Tract 2507.01, Solano County, California",0,0,0
1000000US060952507012007,060952507012007,"Block 2007, Block Group 2, Census Tract 2507.01, Solano County, California",24,20,4
1000000US060952507012008,060952507012008,"Block 2008, Block Group 2, Census Tract 2507.01, Solano County, California",38,37,1
1000000US060952507012009,060952507012009,"Block 2009, Block Group 2, Census Tract 2507.01, Solano County, California",50,41,9
1000000US060952507012010,060952507012010,"Block 2010, Block Group 2, Census Tract 2507.01, Solano County, California",42,39,3
1000000US060952507012011,060952507012011,"Block 2011, Block Group 2, Census Tract 2507.01, Solano County, California",40,39,1
1000000US060952507012012,060952507012012,"Block 2012, Block Group 2, Census Tract 2507.01, Solano County, California",43,42,1
1000000US060952507012013,060952507012013,"Block 2013, Block Group 2, Census Tract 2507.01, Solano County, California",25,20,5
1000000US060952507012014,060952507012014,"Block 2014, Block Group 2, Census Tract 2507.01, Solano County, California",28,25,3
1000000US060952507012015,060952507012015,"Block 2015, Block Group 2, Census Tract 2507.01, Solano County, California",21,17,4
1000000US060952507012016,060952507012016,"Block 2016, Block Group 2, Census Tract 2507.01, Solano County, California",0,0,0
1000000US060952507012017,060952507012017,"Block 2017, Block Group 2, Census Tract 2507.01, Solano County, California",55,48,7
1000000US060952507012018,060952507012018,"Block 2018, Block Group 2, Census Tract 2507.01, Solano County, California",8,7,1
1000000US060952507012019,060952507012019,"Block 2019, Block Group 2, Census Tract 2507.01, Solano County, California",0,0,0
1000000US060952507012020,060952507012020,"Block 2020, Block Group 2, Census Tract 2507.01, Solano County, California",3,3,0
1000000US060952507012021,060952507012021,"Block 2021, Block Group 2, Census Tract 2507.01, Solano County, California",3,3,0
1000000US060952507012022,060952507012022,"Block 2022, Block Group 2, Census Tract 2507.01, Solano County, California",0,0,0
1000000US060952507012023,060952507012023,"Block 2023, Block Group 2, Census Tract 2507.01, Solano County, California",0,0,0
1000000US060952507012024,060952507012024,"Block 2024, Block Group 2, Census Tract 2507.01, Solano County, California",0,0,0
1000000US060952507012025,060952507012025,"Block 2025, Block Group 2, Census Tract 2507.01, Solano County, California",1,0,1
1000000US060952508011000,060952508011000,"Block 1000, Block Group 1, Census Tract 2508.01, Solano County, California",0,0,0
1000000US060952508011001,060952508011001,"Block 1001, Block Group 1, Census Tract 2508.01, Solano County, California",0,0,0
1000000US060952508011002,060952508011002,"Block 1002, Block Group 1, Census Tract 2508.01, Solano County, California",0,0,0
1000000US060952508011003,060952508011003,"Block 1003, Block Group 1, Census Tract 2508.01, Solano County, California",0,0,0
1000000US060952508011004,060952508011004,"Block 1004, Block Group 1, Census Tract 2508.01, Solano County, California",0,0,0
1000000US060952508011005,060952508011005,"Block 1005, Block Group 1, Census Tract 2508.01, Solano County, California",0,0,0
1000000US060952508011006,060952508011006,"Block 1006, Block Group 1, Census Tract 2508.01, Solano County, California",0,0,0
1000000US060952508011007,060952508011007,"Block 1007, Block Group 1, Census Tract 2508.01, Solano County, California",0,0,0
1000000US060952508011008,060952508011008,"Block 1008, Block Group 1, Census Tract 2508.01, Solano County, California",0,0,0
1000000US060952508011009,060952508011009,"Block 1009, Block Group 1, Census Tract 2508.01, Solano County, California",0,0,0
1000000US060952508011010,060952508011010,"Block 1010, Block Group 1, Census Tract 2508.01, Solano County, California",0,0,0
1000000US060952508011011,060952508011011,"Block 1011, Block Group 1, Census Tract 2508.01, Solano County, California",0,0,0
1000000US060952508011012,060952508011012,"Block 1012, Block Group 1, Census Tract 2508.01, Solano County, California",0,0,0
1000000US060952508011013,060952508011013,"Block 1013, Block Group 1, Census Tract 2508.01, Solano County, California",0,0,0
1000000US060952508011014,060952508011014,"Block 1014, Block Group 1, Census Tract 2508.01, Solano County, California",0,0,0
1000000US060952508011015,060952508011015,"Block 1015, Block Group 1, Census Tract 2508.01, Solano County, California",0,0,0
1000000US060952508011016,060952508011016,"Block 1016, Block Group 1, Census Tract 2508.01, Solano County, California",0,0,0
1000000US060952508011017,060952508011017,"Block 1017, Block Group 1, Census Tract 2508.01, Solano County, California",0,0,0
1000000US060952508011018,060952508011018,"Block 1018, Block Group 1, Census Tract 2508.01, Solano County, California",0,0,0
1000000US060952508011019,060952508011019,"Block 1019, Block Group 1, Census Tract 2508.01, Solano County, California",0,0,0
1000000US060952508011020,060952508011020,"Block 1020, Block Group 1, Census Tract 2508.01, Solano County, California",0,0,0
1000000US060952508011021,060952508011021,"Block 1021, Block Group 1, Census Tract 2508.01, Solano County, California",0,0,0
1000000US060952508011022,060952508011022,"Block 1022, Block Group 1, Census Tract 2508.01, Solano County, California",0,0,0
1000000US060952508011023,060952508011023,"Block 1023, Block Group 1, Census Tract 2508.01, Solano County, California",0,0,0
1000000US060952508011024,060952508011024,"Block 1024, Block Group 1, Census Tract 2508.01, Solano County, California",0,0,0
1000000US060952508011025,060952508011025,"Block 1025, Block Group 1, Census Tract 2508.01, Solano County, California",0,0,0
1000000US060952508011026,060952508011026,"Block 1026, Block Group 1, Census Tract 2508.01, Solano County, California",0,0,0
1000000US060952508011027,060952508011027,"Block 1027, Block Group 1, Census Tract 2508.01, Solano County, California",0,0,0
1000000US060952508011028,060952508011028,"Block 1028, Block Group 1, Census Tract 2508.01, Solano County, California",0,0,0
1000000US060952508011029,060952508011029,"Block 1029, Block Group 1, Census Tract 2508.01, Solano County, California",0,0,0
1000000US060952508011030,060952508011030,"Block 1030, Block Group 1, Census Tract 2508.01, Solano County, California",0,0,0
1000000US060952508011031,060952508011031,"Block 1031, Block Group 1, Census Tract 2508.01, Solano County, California",0,0,0
1000000US060952508011032,060952508011032,"Block 1032, Block Group 1, Census Tract 2508.01, Solano County, California",0,0,0
1000000US060952508011033,060952508011033,"Block 1033, Block Group 1, Census Tract 2508.01, Solano County, California",0,0,0
1000000US060952508011034,060952508011034,"Block 1034, Block Group 1, Census Tract 2508.01, Solano County, California",0,0,0
1000000US060952508011035,060952508011035,"Block 1035, Block Group 1, Census Tract 2508.01, Solano County, California",0,0,0
1000000US060952508011036,060952508011036,"Block 1036, Block Group 1, Census Tract 2508.01, Solano County, California",0,0,0
1000000US060952508011037,060952508011037,"Block 1037, Block Group 1, Census Tract 2508.01, Solano County, California",0,0,0
1000000US060952508011038,060952508011038,"Block 1038, Block Group 1, Census Tract 2508.01, Solano County, California",0,0,0
1000000US060952508011039,060952508011039,"Block 1039, Block Group 1, Census Tract 2508.01, Solano County, California",0,0,0
1000000US060952508011040,060952508011040,"Block 1040, Block Group 1, Census Tract 2508.01, Solano County, California",0,0,0
1000000US060952508011041,060952508011041,"Block 1041, Block Group 1, Census Tract 2508.01, Solano County, California",0,0,0
1000000US060952508011042,060952508011042,"Block 1042, Block Group 1, Census Tract 2508.01, Solano County, California",0,0,0
1000000US060952508011043,060952508011043,"Block 1043, Block Group 1, Census Tract 2508.01, Solano County, California",0,0,0
1000000US060952508011044,060952508011044,"Block 1044, Block Group 1, Census Tract 2508.01, Solano County, California",0,0,0
1000000US060952508011045,060952508011045,"Block 1045, Block Group 1, Census Tract 2508.01, Solano County, California",0,0,0
1000000US060952508011046,060952508011046,"Block 1046, Block Group 1, Census Tract 2508.01, Solano County, California",0,0,0
1000000US060952508011047,060952508011047,"Block 1047, Block Group 1, Census Tract 2508.01, Solano County, California",0,0,0
1000000US060952508011048,060952508011048,"Block 1048, Block Group 1, Census Tract 2508.01, Solano County, California",0,0,0
1000000US060952508011049,060952508011049,"Block 1049, Block Group 1, Census Tract 2508.01, Solano County, California",0,0,0
1000000US060952508011050,060952508011050,"Block 1050, Block Group 1, Census Tract 2508.01, Solano County, California",0,0,0
1000000US060952508011051,060952508011051,"Block 1051, Block Group 1, Census Tract 2508.01, Solano County, California",0,0,0
1000000US060952508011052,060952508011052,"Block 1052, Block Group 1, Census Tract 2508.01, Solano County, California",0,0,0
1000000US060952508011053,060952508011053,"Block 1053, Block Group 1, Census Tract 2508.01, Solano County, California",0,0,0
1000000US060952508011054,060952508011054,"Block 1054, Block Group 1, Census Tract 2508.01, Solano County, California",0,0,0
1000000US060952508011055,060952508011055,"Block 1055, Block Group 1, Census Tract 2508.01, Solano County, California",0,0,0
1000000US060952508011056,060952508011056,"Block 1056, Block Group 1, Census Tract 2508.01, Solano County, California",0,0,0
1000000US060952508011057,060952508011057,"Block 1057, Block Group 1, Census Tract 2508.01, Solano County, California",0,0,0
1000000US060952508011058,060952508011058,"Block 1058, Block Group 1, Census Tract 2508.01, Solano County, California",0,0,0
1000000US060952508011059,060952508011059,"Block 1059, Block Group 1, Census Tract 2508.01, Solano County, California",0,0,0
1000000US060952508011060,060952508011060,"Block 1060, Block Group 1, Census Tract 2508.01, Solano County, California",0,0,0
1000000US060952508011061,060952508011061,"Block 1061, Block Group 1, Census Tract 2508.01, Solano County, California",0,0,0
1000000US060952508011062,060952508011062,"Block 1062, Block Group 1, Census Tract 2508.01, Solano County, California",0,0,0
1000000US060952508011063,060952508011063,"Block 1063, Block Group 1, Census Tract 2508.01, Solano County, California",0,0,0
1000000US060952508011064,060952508011064,"Block 1064, Block Group 1, Census Tract 2508.01, Solano County, California",0,0,0
1000000US060952508011065,060952508011065,"Block 1065, Block Group 1, Census Tract 2508.01, Solano County, California",0,0,0
1000000US060952508011066,060952508011066,"Block 1066, Block Group 1, Census Tract 2508.01, Solano County, California",0,0,0
1000000US060952508011067,060952508011067,"Block 1067, Block Group 1, Census Tract 2508.01, Solano County, California",0,0,0
1000000US060952508011068,060952508011068,"Block 1068, Block Group 1, Census Tract 2508.01, Solano County, California",0,0,0
1000000US060952508011069,060952508011069,"Block 1069, Block Group 1, Census Tract 2508.01, Solano County, California",0,0,0
1000000US060952508011070,060952508011070,"Block 1070, Block Group 1, Census Tract 2508.01, Solano County, California",0,0,0
1000000US060952508011071,060952508011071,"Block 1071, Block Group 1, Census Tract 2508.01, Solano County, California",0,0,0
1000000US060952508011072,060952508011072,"Block 1072, Block Group 1, Census Tract 2508.01, Solano County, California",0,0,0
1000000US060952508011073,060952508011073,"Block 1073, Block Group 1, Census Tract 2508.01, Solano County, California",0,0,0
1000000US060952508011074,060952508011074,"Block 1074, Block Group 1, Census Tract 2508.01, Solano County, California",0,0,0
1000000US060952508011075,060952508011075,"Block 1075, Block Group 1, Census Tract 2508.01, Solano County, California",0,0,0
1000000US060952508011076,060952508011076,"Block 1076, Block Group 1, Census Tract 2508.01, Solano County, California",0,0,0
1000000US060952508011077,060952508011077,"Block 1077, Block Group 1, Census Tract 2508.01, Solano County, California",0,0,0
1000000US060952508011078,060952508011078,"Block 1078, Block Group 1, Census Tract 2508.01, Solano County, California",39,33,6
1000000US060952508011079,060952508011079,"Block 1079, Block Group 1, Census Tract 2508.01, Solano County, California",0,0,0
1000000US060952508011080,060952508011080,"Block 1080, Block Group 1, Census Tract 2508.01, Solano County, California",0,0,0
1000000US060952508011081,060952508011081,"Block 1081, Block Group 1, Census Tract 2508.01, Solano County, California",0,0,0
1000000US060952508011082,060952508011082,"Block 1082, Block Group 1, Census Tract 2508.01, Solano County, California",0,0,0
1000000US060952508011083,060952508011083,"Block 1083, Block Group 1, Census Tract 2508.01, Solano County, California",0,0,0
1000000US060952508011084,060952508011084,"Block 1084, Block Group 1, Census Tract 2508.01, Solano County, California",0,0,0
1000000US060952508011085,060952508011085,"Block 1085, Block Group 1, Census Tract 2508.01, Solano County, California",0,0,0
1000000US060952508011086,060952508011086,"Block 1086, Block Group 1, Census Tract 2508.01, Solano County, California",0,0,0
1000000US060952508011087,060952508011087,"Block 1087, Block Group 1, Census Tract 2508.01, Solano County, California",0,0,0
1000000US060952508011088,060952508011088,"Block 1088, Block Group 1, Census Tract 2508.01, Solano County, California",0,0,0
1000000US060952508011089,060952508011089,"Block 1089, Block Group 1, Census Tract 2508.01, Solano County, California",0,0,0
1000000US060952508011090,060952508011090,"Block 1090, Block Group 1, Census Tract 2508.01, Solano County, California",0,0,0
1000000US060952508011091,060952508011091,"Block 1091, Block Group 1, Census Tract 2508.01, Solano County, California",0,0,0
1000000US060952508011092,060952508011092,"Block 1092, Block Group 1, Census Tract 2508.01, Solano County, California",0,0,0
1000000US060952508011093,060952508011093,"Block 1093, Block Group 1, Census Tract 2508.01, Solano County, California",0,0,0
1000000US060952508011094,060952508011094,"Block 1094, Block Group 1, Census Tract 2508.01, Solano County, California",0,0,0
1000000US060952508011095,060952508011095,"Block 1095, Block Group 1, Census Tract 2508.01, Solano County, California",0,0,0
1000000US060952508011096,060952508011096,"Block 1096, Block Group 1, Census Tract 2508.01, Solano County, California",17,9,8
1000000US060952508011097,060952508011097,"Block 1097, Block Group 1, Census Tract 2508.01, Solano County, California",0,0,0
1000000US060952508011098,060952508011098,"Block 1098, Block Group 1, Census Tract 2508.01, Solano County, California",4,0,4
1000000US060952508011099,060952508011099,"Block 1099, Block Group 1, Census Tract 2508.01, Solano County, California",0,0,0
1000000US060952508011100,060952508011100,"Block 1100, Block Group 1, Census Tract 2508.01, Solano County, California",0,0,0
1000000US060952508011101,060952508011101,"Block 1101, Block Group 1, Census Tract 2508.01, Solano County, California",0,0,0
1000000US060952508011102,060952508011102,"Block 1102, Block Group 1, Census Tract 2508.01, Solano County, California",0,0,0
1000000US060952508011103,060952508011103,"Block 1103, Block Group 1, Census Tract 2508.01, Solano County, California",0,0,0
1000000US060952508011104,060952508011104,"Block 1104, Block Group 1, Census Tract 2508.01, Solano County, California",0,0,0
1000000US060952508011105,060952508011105,"Block 1105, Block Group 1, Census Tract 2508.01, Solano County, California",0,0,0
1000000US060952508011106,060952508011106,"Block 1106, Block Group 1, Census Tract 2508.01, Solano County, California",0,0,0
1000000US060952508011107,060952508011107,"Block 1107, Block Group 1, Census Tract 2508.01, Solano County, California",0,0,0
1000000US060952508011108,060952508011108,"Block 1108, Block Group 1, Census Tract 2508.01, Solano County, California",0,0,0
1000000US060952508011109,060952508011109,"Block 1109, Block Group 1, Census Tract 2508.01, Solano County, California",0,0,0
1000000US060952508011110,060952508011110,"Block 1110, Block Group 1, Census Tract 2508.01, Solano County, California",0,0,0
1000000US060952508011111,060952508011111,"Block 1111, Block Group 1, Census Tract 2508.01, Solano County, California",0,0,0
1000000US060952508011112,060952508011112,"Block 1112, Block Group 1, Census Tract 2508.01, Solano County, California",0,0,0
1000000US060952508011113,060952508011113,"Block 1113, Block Group 1, Census Tract 2508.01, Solano County, California",0,0,0
1000000US060952508011114,060952508011114,"Block 1114, Block Group 1, Census Tract 2508.01, Solano County, California",0,0,0
1000000US060952508011115,060952508011115,"Block 1115, Block Group 1, Census Tract 2508.01, Solano County, California",0,0,0
1000000US060952508011116,060952508011116,"Block 1116, Block Group 1, Census Tract 2508.01, Solano County, California",0,0,0
1000000US060952508011117,060952508011117,"Block 1117, Block Group 1, Census Tract 2508.01, Solano County, California",0,0,0
1000000US060952508011118,060952508011118,"Block 1118, Block Group 1, Census Tract 2508.01, Solano County, California",0,0,0
1000000US060952508011119,060952508011119,"Block 1119, Block Group 1, Census Tract 2508.01, Solano County, California",0,0,0
1000000US060952508011120,060952508011120,"Block 1120, Block Group 1, Census Tract 2508.01, Solano County, California",0,0,0
1000000US060952508011121,060952508011121,"Block 1121, Block Group 1, Census Tract 2508.01, Solano County, California",0,0,0
1000000US060952508011122,060952508011122,"Block 1122, Block Group 1, Census Tract 2508.01, Solano County, California",0,0,0
1000000US060952508011123,060952508011123,"Block 1123, Block Group 1, Census Tract 2508.01, Solano County, California",0,0,0
1000000US060952508011124,060952508011124,"Block 1124, Block Group 1, Census Tract 2508.01, Solano County, California",0,0,0
1000000US060952508011125,060952508011125,"Block 1125, Block Group 1, Census Tract 2508.01, Solano County, California",0,0,0
1000000US060952508011126,060952508011126,"Block 1126, Block Group 1, Census Tract 2508.01, Solano County, California",0,0,0
1000000US060952508011127,060952508011127,"Block 1127, Block Group 1, Census Tract 2508.01, Solano County, California",0,0,0
1000000US060952508011128,060952508011128,"Block 1128, Block Group 1, Census Tract 2508.01, Solano County, California",0,0,0
1000000US060952508011129,060952508011129,"Block 1129, Block Group 1, Census Tract 2508.01, Solano County, California",0,0,0
1000000US060952508011130,060952508011130,"Block 1130, Block Group 1, Census Tract 2508.01, Solano County, California",0,0,0
1000000US060952508011131,060952508011131,"Block 1131, Block Group 1, Census Tract 2508.01, Solano County, California",0,0,0
1000000US060952508011132,060952508011132,"Block 1132, Block Group 1, Census Tract 2508.01, Solano County, California",0,0,0
1000000US060952508011133,060952508011133,"Block 1133, Block Group 1, Census Tract 2508.01, Solano County, California",0,0,0
1000000US060952508011134,060952508011134,"Block 1134, Block Group 1, Census Tract 2508.01, Solano County, California",0,0,0
1000000US060952508011135,060952508011135,"Block 1135, Block Group 1, Census Tract 2508.01, Solano County, California",0,0,0
1000000US060952508011136,060952508011136,"Block 1136, Block Group 1, Census Tract 2508.01, Solano County, California",0,0,0
1000000US060952508011137,060952508011137,"Block 1137, Block Group 1, Census Tract 2508.01, Solano County, California",0,0,0
1000000US060952508011138,060952508011138,"Block 1138, Block Group 1, Census Tract 2508.01, Solano County, California",0,0,0
1000000US060952508011139,060952508011139,"Block 1139, Block Group 1, Census Tract 2508.01, Solano County, California",0,0,0
1000000US060952508011140,060952508011140,"Block 1140, Block Group 1, Census Tract 2508.01, Solano County, California",0,0,0
1000000US060952508011141,060952508011141,"Block 1141, Block Group 1, Census Tract 2508.01, Solano County, California",0,0,0
1000000US060952508011142,060952508011142,"Block 1142, Block Group 1, Census Tract 2508.01, Solano County, California",0,0,0
1000000US060952508011143,060952508011143,"Block 1143, Block Group 1, Census Tract 2508.01, Solano County, California",0,0,0
1000000US060952508011144,060952508011144,"Block 1144, Block Group 1, Census Tract 2508.01, Solano County, California",0,0,0
1000000US060952508011145,060952508011145,"Block 1145, Block Group 1, Census Tract 2508.01, Solano County, California",0,0,0
1000000US060952508011146,060952508011146,"Block 1146, Block Group 1, Census Tract 2508.01, Solano County, California",0,0,0
1000000US060952508011147,060952508011147,"Block 1147, Block Group 1, Census Tract 2508.01, Solano County, California",0,0,0
1000000US060952508011148,060952508011148,"Block 1148, Block Group 1, Census Tract 2508.01, Solano County, California",0,0,0
1000000US060952508011149,060952508011149,"Block 1149, Block Group 1, Census Tract 2508.01, Solano County, California",0,0,0
1000000US060952508011150,060952508011150,"Block 1150, Block Group 1, Census Tract 2508.01, Solano County, California",0,0,0
1000000US060952508011151,060952508011151,"Block 1151, Block Group 1, Census Tract 2508.01, Solano County, California",0,0,0
1000000US060952508011152,060952508011152,"Block 1152, Block Group 1, Census Tract 2508.01, Solano County, California",0,0,0
1000000US060952508011153,060952508011153,"Block 1153, Block Group 1, Census Tract 2508.01, Solano County, California",0,0,0
1000000US060952508011154,060952508011154,"Block 1154, Block Group 1, Census Tract 2508.01, Solano County, California",31,25,6
1000000US060952508011155,060952508011155,"Block 1155, Block Group 1, Census Tract 2508.01, Solano County, California",0,0,0
1000000US060952508011156,060952508011156,"Block 1156, Block Group 1, Census Tract 2508.01, Solano County, California",90,84,6
1000000US060952508011157,060952508011157,"Block 1157, Block Group 1, Census Tract 2508.01, Solano County, California",11,10,1
1000000US060952508011158,060952508011158,"Block 1158, Block Group 1, Census Tract 2508.01, Solano County, California",18,15,3
1000000US060952508011159,060952508011159,"Block 1159, Block Group 1, Census Tract 2508.01, Solano County, California",64,51,13
1000000US060952508011160,060952508011160,"Block 1160, Block Group 1, Census Tract 2508.01, Solano County, California",6,6,0
1000000US060952508011161,060952508011161,"Block 1161, Block Group 1, Census Tract 2508.01, Solano County, California",0,0,0
1000000US060952508011162,060952508011162,"Block 1162, Block Group 1, Census Tract 2508.01, Solano County, California",0,0,0
1000000US060952508011163,060952508011163,"Block 1163, Block Group 1, Census Tract 2508.01, Solano County, California",0,0,0
1000000US060952508011164,060952508011164,"Block 1164, Block Group 1, Census Tract 2508.01, Solano County, California",27,26,1
1000000US060952508011165,060952508011165,"Block 1165, Block Group 1, Census Tract 2508.01, Solano County, California",31,27,4
1000000US060952508011166,060952508011166,"Block 1166, Block Group 1, Census Tract 2508.01, Solano County, California",0,0,0
1000000US060952508011167,060952508011167,"Block 1167, Block Group 1, Census Tract 2508.01, Solano County, California",0,0,0
1000000US060952508011168,060952508011168,"Block 1168, Block Group 1, Census Tract 2508.01, Solano County, California",28,27,1
1000000US060952508011169,060952508011169,"Block 1169, Block Group 1, Census Tract 2508.01, Solano County, California",0,0,0
1000000US060952508011170,060952508011170,"Block 1170, Block Group 1, Census Tract 2508.01, Solano County, California",0,0,0
1000000US060952508011171,060952508011171,"Block 1171, Block Group 1, Census Tract 2508.01, Solano County, California",0,0,0
1000000US060952508011172,060952508011172,"Block 1172, Block Group 1, Census Tract 2508.01, Solano County, California",0,0,0
1000000US060952508011173,060952508011173,"Block 1173, Block Group 1, Census Tract 2508.01, Solano County, California",0,0,0
1000000US060952508011174,060952508011174,"Block 1174, Block Group 1, Census Tract 2508.01, Solano County, California",0,0,0
1000000US060952508011175,060952508011175,"Block 1175, Block Group 1, Census Tract 2508.01, Solano County, California",2,0,2
1000000US060952508011176,060952508011176,"Block 1176, Block Group 1, Census Tract 2508.01, Solano County, California",0,0,0
1000000US060952508011177,060952508011177,"Block 1177, Block Group 1, Census Tract 2508.01, Solano County, California",0,0,0
1000000US060952508011178,060952508011178,"Block 1178, Block Group 1, Census Tract 2508.01, Solano County, California",0,0,0
1000000US060952508011179,060952508011179,"Block 1179, Block Group 1, Census Tract 2508.01, Solano County, California",0,0,0
1000000US060952508011180,060952508011180,"Block 1180, Block Group 1, Census Tract 2508.01, Solano County, California",0,0,0
1000000US060952508011181,060952508011181,"Block 1181, Block Group 1, Census Tract 2508.01, Solano County, California",0,0,0
1000000US060952508011182,060952508011182,"Block 1182, Block Group 1, Census Tract 2508.01, Solano County, California",0,0,0
1000000US060952508011183,060952508011183,"Block 1183, Block Group 1, Census Tract 2508.01, Solano County, California",0,0,0
1000000US060952508011184,060952508011184,"Block 1184, Block Group 1, Census Tract 2508.01, Solano County, California",0,0,0
1000000US060952508011185,060952508011185,"Block 1185, Block Group 1, Census Tract 2508.01, Solano County, California",0,0,0
1000000US060952508011186,060952508011186,"Block 1186, Block Group 1, Census Tract 2508.01, Solano County, California",0,0,0
1000000US060952508011187,060952508011187,"Block 1187, Block Group 1, Census Tract 2508.01, Solano County, California",0,0,0
1000000US060952508011188,060952508011188,"Block 1188, Block Group 1, Census Tract 2508.01, Solano County, California",0,0,0
1000000US060952508011189,060952508011189,"Block 1189, Block Group 1, Census Tract 2508.01, Solano County, California",0,0,0
1000000US060952508011190,060952508011190,"Block 1190, Block Group 1, Census Tract 2508.01, Solano County, California",0,0,0
1000000US060952508011191,060952508011191,"Block 1191, Block Group 1, Census Tract 2508.01, Solano County, California",0,0,0
1000000US060952508011192,060952508011192,"Block 1192, Block Group 1, Census Tract 2508.01, Solano County, California",0,0,0
1000000US060952508011193,060952508011193,"Block 1193, Block Group 1, Census Tract 2508.01, Solano County, California",0,0,0
1000000US060952508011194,060952508011194,"Block 1194, Block Group 1, Census Tract 2508.01, Solano County, California",0,0,0
1000000US060952508011195,060952508011195,"Block 1195, Block Group 1, Census Tract 2508.01, Solano County, California",0,0,0
1000000US060952508011196,060952508011196,"Block 1196, Block Group 1, Census Tract 2508.01, Solano County, California",0,0,0
1000000US060952508011197,060952508011197,"Block 1197, Block Group 1, Census Tract 2508.01, Solano County, California",0,0,0
1000000US060952508011198,060952508011198,"Block 1198, Block Group 1, Census Tract 2508.01, Solano County, California",0,0,0
1000000US060952508011199,060952508011199,"Block 1199, Block Group 1, Census Tract 2508.01, Solano County, California",0,0,0
1000000US060952508011200,060952508011200,"Block 1200, Block Group 1, Census Tract 2508.01, Solano County, California",0,0,0
1000000US060952508011201,060952508011201,"Block 1201, Block Group 1, Census Tract 2508.01, Solano County, California",0,0,0
1000000US060952508011202,060952508011202,"Block 1202, Block Group 1, Census Tract 2508.01, Solano County, California",5,5,0
1000000US060952508011203,060952508011203,"Block 1203, Block Group 1, Census Tract 2508.01, Solano County, California",18,18,0
1000000US060952508011204,060952508011204,"Block 1204, Block Group 1, Census Tract 2508.01, Solano County, California",14,11,3
1000000US060952508011205,060952508011205,"Block 1205, Block Group 1, Census Tract 2508.01, Solano County, California",0,0,0
1000000US060952508011206,060952508011206,"Block 1206, Block Group 1, Census Tract 2508.01, Solano County, California",0,0,0
1000000US060952508011207,060952508011207,"Block 1207, Block Group 1, Census Tract 2508.01, Solano County, California",13,13,0
1000000US060952508011208,060952508011208,"Block 1208, Block Group 1, Census Tract 2508.01, Solano County, California",19,18,1
1000000US060952508011209,060952508011209,"Block 1209, Block Group 1, Census Tract 2508.01, Solano County, California",2,2,0
1000000US060952508011210,060952508011210,"Block 1210, Block Group 1, Census Tract 2508.01, Solano County, California",0,0,0
1000000US060952508011211,060952508011211,"Block 1211, Block Group 1, Census Tract 2508.01, Solano County, California",0,0,0
1000000US060952508011212,060952508011212,"Block 1212, Block Group 1, Census Tract 2508.01, Solano County, California",0,0,0
1000000US060952508011213,060952508011213,"Block 1213, Block Group 1, Census Tract 2508.01, Solano County, California",0,0,0
1000000US060952508011214,060952508011214,"Block 1214, Block Group 1, Census Tract 2508.01, Solano County, California",0,0,0
1000000US060952508011215,060952508011215,"Block 1215, Block Group 1, Census Tract 2508.01, Solano County, California",0,0,0
1000000US060952508011216,060952508011216,"Block 1216, Block Group 1, Census Tract 2508.01, Solano County, California",0,0,0
1000000US060952508011217,060952508011217,"Block 1217, Block Group 1, Census Tract 2508.01, Solano County, California",1,1,0
1000000US060952508011218,060952508011218,"Block 1218, Block Group 1, Census Tract 2508.01, Solano County, California",0,0,0
1000000US060952508011219,060952508011219,"Block 1219, Block Group 1, Census Tract 2508.01, Solano County, California",2,2,0
1000000US060952508011220,060952508011220,"Block 1220, Block Group 1, Census Tract 2508.01, Solano County, California",5,5,0
1000000US060952508011221,060952508011221,"Block 1221, Block Group 1, Census Tract 2508.01, Solano County, California",7,7,0
1000000US060952508011222,060952508011222,"Block 1222, Block Group 1, Census Tract 2508.01, Solano County, California",0,0,0
1000000US060952508011223,060952508011223,"Block 1223, Block Group 1, Census Tract 2508.01, Solano County, California",5,4,1
1000000US060952508011224,060952508011224,"Block 1224, Block Group 1, Census Tract 2508.01, Solano County, California",0,0,0
1000000US060952508011225,060952508011225,"Block 1225, Block Group 1, Census Tract 2508.01, Solano County, California",8,0,8
1000000US060952508011226,060952508011226,"Block 1226, Block Group 1, Census Tract 2508.01, Solano County, California",3,0,3
1000000US060952508011227,060952508011227,"Block 1227, Block Group 1, Census Tract 2508.01, Solano County, California",0,0,0
1000000US060952508011228,060952508011228,"Block 1228, Block Group 1, Census Tract 2508.01, Solano County, California",16,0,16
1000000US060952508011229,060952508011229,"Block 1229, Block Group 1, Census Tract 2508.01, Solano County, California",2,1,1
1000000US060952508011230,060952508011230,"Block 1230, Block Group 1, Census Tract 2508.01, Solano County, California",0,0,0
1000000US060952508011231,060952508011231,"Block 1231, Block Group 1, Census Tract 2508.01, Solano County, California",0,0,0
1000000US060952508011232,060952508011232,"Block 1232, Block Group 1, Census Tract 2508.01, Solano County, California",0,0,0
1000000US060952508011233,060952508011233,"Block 1233, Block Group 1, Census Tract 2508.01, Solano County, California",5,3,2
1000000US060952508011234,060952508011234,"Block 1234, Block Group 1, Census Tract 2508.01, Solano County, California",32,31,1
1000000US060952508011235,060952508011235,"Block 1235, Block Group 1, Census Tract 2508.01, Solano County, California",9,9,0
1000000US060952508011236,060952508011236,"Block 1236, Block Group 1, Census Tract 2508.01, Solano County, California",3,1,2
1000000US060952508011237,060952508011237,"Block 1237, Block Group 1, Census Tract 2508.01, Solano County, California",0,0,0
1000000US060952508011238,060952508011238,"Block 1238, Block Group 1, Census Tract 2508.01, Solano County, California",30,27,3
1000000US060952508011239,060952508011239,"Block 1239, Block Group 1, Census Tract 2508.01, Solano County, California",24,21,3
1000000US060952508011240,060952508011240,"Block 1240, Block Group 1, Census Tract 2508.01, Solano County, California",6,5,1
1000000US060952508011241,060952508011241,"Block 1241, Block Group 1, Census Tract 2508.01, Solano County, California",22,18,4
1000000US060952508011242,060952508011242,"Block 1242, Block Group 1, Census Tract 2508.01, Solano County, California",6,6,0
1000000US060952508011243,060952508011243,"Block 1243, Block Group 1, Census Tract 2508.01, Solano County, California",0,0,0
1000000US060952508011244,060952508011244,"Block 1244, Block Group 1, Census Tract 2508.01, Solano County, California",0,0,0
1000000US060952508011245,060952508011245,"Block 1245, Block Group 1, Census Tract 2508.01, Solano County, California",0,0,0
1000000US060952508011246,060952508011246,"Block 1246, Block Group 1, Census Tract 2508.01, Solano County, California",0,0,0
1000000US060952508011247,060952508011247,"Block 1247, Block Group 1, Census Tract 2508.01, Solano County, California",0,0,0
1000000US060952508011248,060952508011248,"Block 1248, Block Group 1, Census Tract 2508.01, Solano County, California",0,0,0
1000000US060952508011249,060952508011249,"Block 1249, Block Group 1, Census Tract 2508.01, Solano County, California",0,0,0
1000000US060952508011250,060952508011250,"Block 1250, Block Group 1, Census Tract 2508.01, Solano County, California",0,0,0
1000000US060952508011251,060952508011251,"Block 1251, Block Group 1, Census Tract 2508.01, Solano County, California",0,0,0
1000000US060952508011252,060952508011252,"Block 1252, Block Group 1, Census Tract 2508.01, Solano County, California",0,0,0
1000000US060952508011253,060952508011253,"Block 1253, Block Group 1, Census Tract 2508.01, Solano County, California",0,0,0
1000000US060952508011254,060952508011254,"Block 1254, Block Group 1, Census Tract 2508.01, Solano County, California",0,0,0
1000000US060952508011255,060952508011255,"Block 1255, Block Group 1, Census Tract 2508.01, Solano County, California",0,0,0
1000000US060952508011256,060952508011256,"Block 1256, Block Group 1, Census Tract 2508.01, Solano County, California",0,0,0
1000000US060952508011257,060952508011257,"Block 1257, Block Group 1, Census Tract 2508.01, Solano County, California",0,0,0
1000000US060952508011258,060952508011258,"Block 1258, Block Group 1, Census Tract 2508.01, Solano County, California",0,0,0
1000000US060952508011259,060952508011259,"Block 1259, Block Group 1, Census Tract 2508.01, Solano County, California",0,0,0
1000000US060952508011260,060952508011260,"Block 1260, Block Group 1, Census Tract 2508.01, Solano County, California",0,0,0
1000000US060952508011261,060952508011261,"Block 1261, Block Group 1, Census Tract 2508.01, Solano County, California",0,0,0
1000000US060952508011262,060952508011262,"Block 1262, Block Group 1, Census Tract 2508.01, Solano County, California",0,0,0
1000000US060952508011263,060952508011263,"Block 1263, Block Group 1, Census Tract 2508.01, Solano County, California",10,10,0
1000000US060952508011264,060952508011264,"Block 1264, Block Group 1, Census Tract 2508.01, Solano County, California",0,0,0
1000000US060952508011265,060952508011265,"Block 1265, Block Group 1, Census Tract 2508.01, Solano County, California",0,0,0
1000000US060952508011266,060952508011266,"Block 1266, Block Group 1, Census Tract 2508.01, Solano County, California",0,0,0
1000000US060952508011267,060952508011267,"Block 1267, Block Group 1, Census Tract 2508.01, Solano County, California",0,0,0
1000000US060952508012000,060952508012000,"Block 2000, Block Group 2, Census Tract 2508.01, Solano County, California",30,27,3
1000000US060952508012001,060952508012001,"Block 2001, Block Group 2, Census Tract 2508.01, Solano County, California",20,15,5
1000000US060952508012002,060952508012002,"Block 2002, Block Group 2, Census Tract 2508.01, Solano County, California",46,45,1
1000000US060952508012003,060952508012003,"Block 2003, Block Group 2, Census Tract 2508.01, Solano County, California",100,95,5
1000000US060952508012004,060952508012004,"Block 2004, Block Group 2, Census Tract 2508.01, Solano County, California",88,86,2
1000000US060952508012005,060952508012005,"Block 2005, Block Group 2, Census Tract 2508.01, Solano County, California",0,0,0
1000000US060952508012006,060952508012006,"Block 2006, Block Group 2, Census Tract 2508.01, Solano County, California",0,0,0
1000000US060952508012007,060952508012007,"Block 2007, Block Group 2, Census Tract 2508.01, Solano County, California",0,0,0
1000000US060952508012008,060952508012008,"Block 2008, Block Group 2, Census Tract 2508.01, Solano County, California",74,69,5
1000000US060952508012009,060952508012009,"Block 2009, Block Group 2, Census Tract 2508.01, Solano County, California",18,17,1
1000000US060952508012010,060952508012010,"Block 2010, Block Group 2, Census Tract 2508.01, Solano County, California",43,41,2
1000000US060952508012011,060952508012011,"Block 2011, Block Group 2, Census Tract 2508.01, Solano County, California",14,14,0
1000000US060952508012012,060952508012012,"Block 2012, Block Group 2, Census Tract 2508.01, Solano County, California",0,0,0
1000000US060952508012013,060952508012013,"Block 2013, Block Group 2, Census Tract 2508.01, Solano County, California",44,44,0
1000000US060952508012014,060952508012014,"Block 2014, Block Group 2, Census Tract 2508.01, Solano County, California",0,0,0
1000000US060952508012015,060952508012015,"Block 2015, Block Group 2, Census Tract 2508.01, Solano County, California",0,0,0
1000000US060952508012016,060952508012016,"Block 2016, Block Group 2, Census Tract 2508.01, Solano County, California",7,7,0
1000000US060952508012017,060952508012017,"Block 2017, Block Group 2, Census Tract 2508.01, Solano County, California",26,24,2
1000000US060952508013000,060952508013000,"Block 3000, Block Group 3, Census Tract 2508.01, Solano County, California",26,23,3
1000000US060952508013001,060952508013001,"Block 3001, Block Group 3, Census Tract 2508.01, Solano County, California",221,210,11
1000000US060952508013002,060952508013002,"Block 3002, Block Group 3, Census Tract 2508.01, Solano County, California",177,140,37
1000000US060952508013003,060952508013003,"Block 3003, Block Group 3, Census Tract 2508.01, Solano County, California",32,31,1
1000000US060952508013004,060952508013004,"Block 3004, Block Group 3, Census Tract 2508.01, Solano County, California",36,32,4
1000000US060952508013005,060952508013005,"Block 3005, Block Group 3, Census Tract 2508.01, Solano County, California",0,0,0
1000000US060952509001000,060952509001000,"Block 1000, Block Group 1, Census Tract 2509, Solano County, California",24,19,5
1000000US060952509001001,060952509001001,"Block 1001, Block Group 1, Census Tract 2509, Solano County, California",9,9,0
1000000US060952509001002,060952509001002,"Block 1002, Block Group 1, Census Tract 2509, Solano County, California",9,8,1
1000000US060952509001003,060952509001003,"Block 1003, Block Group 1, Census Tract 2509, Solano County, California",7,7,0
1000000US060952509001004,060952509001004,"Block 1004, Block Group 1, Census Tract 2509, Solano County, California",13,9,4
1000000US060952509001005,060952509001005,"Block 1005, Block Group 1, Census Tract 2509, Solano County, California",20,18,2
1000000US060952509001006,060952509001006,"Block 1006, Block Group 1, Census Tract 2509, Solano County, California",76,74,2
1000000US060952509001007,060952509001007,"Block 1007, Block Group 1, Census Tract 2509, Solano County, California",0,0,0
1000000US060952509001008,060952509001008,"Block 1008, Block Group 1, Census Tract 2509, Solano County, California",18,16,2
1000000US060952509001009,060952509001009,"Block 1009, Block Group 1, Census Tract 2509, Solano County, California",152,140,12
1000000US060952509001010,060952509001010,"Block 1010, Block Group 1, Census Tract 2509, Solano County, California",0,0,0
1000000US060952509001011,060952509001011,"Block 1011, Block Group 1, Census Tract 2509, Solano County, California",2,2,0
1000000US060952509001012,060952509001012,"Block 1012, Block Group 1, Census Tract 2509, Solano County, California",0,0,0
1000000US060952509001013,060952509001013,"Block 1013, Block Group 1, Census Tract 2509, Solano County, California",0,0,0
1000000US060952509001014,060952509001014,"Block 1014, Block Group 1, Census Tract 2509, Solano County, California",19,16,3
1000000US060952509001015,060952509001015,"Block 1015, Block Group 1, Census Tract 2509, Solano County, California",10,10,0
1000000US060952509001016,060952509001016,"Block 1016, Block Group 1, Census Tract 2509, Solano County, California",15,15,0
1000000US060952509001017,060952509001017,"Block 1017, Block Group 1, Census Tract 2509, Solano County, California",0,0,0
1000000US060952509001018,060952509001018,"Block 1018, Block Group 1, Census Tract 2509, Solano County, California",14,12,2
1000000US060952509001019,060952509001019,"Block 1019, Block Group 1, Census Tract 2509, Solano County, California",8,5,3
1000000US060952509001020,060952509001020,"Block 1020, Block Group 1, Census Tract 2509, Solano County, California",15,14,1
1000000US060952509001021,060952509001021,"Block 1021, Block Group 1, Census Tract 2509, Solano County, California",14,14,0
1000000US060952509001022,060952509001022,"Block 1022, Block Group 1, Census Tract 2509, Solano County, California",21,20,1
1000000US060952509001023,060952509001023,"Block 1023, Block Group 1, Census Tract 2509, Solano County, California",20,17,3
1000000US060952509001024,060952509001024,"Block 1024, Block Group 1, Census Tract 2509, Solano County, California",12,10,2
1000000US060952509001025,060952509001025,"Block 1025, Block Group 1, Census Tract 2509, Solano County, California",22,17,5
1000000US060952509001026,060952509001026,"Block 1026, Block Group 1, Census Tract 2509, Solano County, California",0,0,0
1000000US060952509001027,060952509001027,"Block 1027, Block Group 1, Census Tract 2509, Solano County, California",0,0,0
1000000US060952509001028,060952509001028,"Block 1028, Block Group 1, Census Tract 2509, Solano County, California",30,18,12
1000000US060952509002000,060952509002000,"Block 2000, Block Group 2, Census Tract 2509, Solano County, California",22,22,0
1000000US060952509002001,060952509002001,"Block 2001, Block Group 2, Census Tract 2509, Solano County, California",0,0,0
1000000US060952509002002,060952509002002,"Block 2002, Block Group 2, Census Tract 2509, Solano County, California",12,10,2
1000000US060952509002003,060952509002003,"Block 2003, Block Group 2, Census Tract 2509, Solano County, California",0,0,0
1000000US060952509002004,060952509002004,"Block 2004, Block Group 2, Census Tract 2509, Solano County, California",212,208,4
1000000US060952509002005,060952509002005,"Block 2005, Block Group 2, Census Tract 2509, Solano County, California",17,16,1
1000000US060952509002006,060952509002006,"Block 2006, Block Group 2, Census Tract 2509, Solano County, California",0,0,0
1000000US060952509002007,060952509002007,"Block 2007, Block Group 2, Census Tract 2509, Solano County, California",19,18,1
1000000US060952509002008,060952509002008,"Block 2008, Block Group 2, Census Tract 2509, Solano County, California",23,12,11
1000000US060952509002009,060952509002009,"Block 2009, Block Group 2, Census Tract 2509, Solano County, California",18,13,5
1000000US060952509002010,060952509002010,"Block 2010, Block Group 2, Census Tract 2509, Solano County, California",0,0,0
1000000US060952509002011,060952509002011,"Block 2011, Block Group 2, Census Tract 2509, Solano County, California",11,9,2
1000000US060952509002012,060952509002012,"Block 2012, Block Group 2, Census Tract 2509, Solano County, California",28,21,7
1000000US060952509002013,060952509002013,"Block 2013, Block Group 2, Census Tract 2509, Solano County, California",49,43,6
1000000US060952509002014,060952509002014,"Block 2014, Block Group 2, Census Tract 2509, Solano County, California",39,25,14
1000000US060952509002015,060952509002015,"Block 2015, Block Group 2, Census Tract 2509, Solano County, California",40,19,21
1000000US060952509002016,060952509002016,"Block 2016, Block Group 2, Census Tract 2509, Solano County, California",13,6,7
1000000US060952509002017,060952509002017,"Block 2017, Block Group 2, Census Tract 2509, Solano County, California",0,0,0
1000000US060952509002018,060952509002018,"Block 2018, Block Group 2, Census Tract 2509, Solano County, California",0,0,0
1000000US060952509002019,060952509002019,"Block 2019, Block Group 2, Census Tract 2509, Solano County, California",0,0,0
1000000US060952509002020,060952509002020,"Block 2020, Block Group 2, Census Tract 2509, Solano County, California",36,22,14
1000000US060952509002021,060952509002021,"Block 2021, Block Group 2, Census Tract 2509, Solano County, California",16,15,1
1000000US060952509002022,060952509002022,"Block 2022, Block Group 2, Census Tract 2509, Solano County, California",2,2,0
1000000US060952509002023,060952509002023,"Block 2023, Block Group 2, Census Tract 2509, Solano County, California",0,0,0
1000000US060952509002024,060952509002024,"Block 2024, Block Group 2, Census Tract 2509, Solano County, California",231,203,28
1000000US060952509002025,060952509002025,"Block 2025, Block Group 2, Census Tract 2509, Solano County, California",92,87,5
1000000US060952509002026,060952509002026,"Block 2026, Block Group 2, Census Tract 2509, Solano County, California",0,0,0
1000000US060952509002027,060952509002027,"Block 2027, Block Group 2, Census Tract 2509, Solano County, California",0,0,0
1000000US060952509002028,060952509002028,"Block 2028, Block Group 2, Census Tract 2509, Solano County, California",1,1,0
1000000US060952509002029,060952509002029,"Block 2029, Block Group 2, Census Tract 2509, Solano County, California",0,0,0
1000000US060952509002030,060952509002030,"Block 2030, Block Group 2, Census Tract 2509, Solano County, California",0,0,0
1000000US060952509002031,060952509002031,"Block 2031, Block Group 2, Census Tract 2509, Solano County, California",20,17,3
1000000US060952509002032,060952509002032,"Block 2032, Block Group 2, Census Tract 2509, Solano County, California",0,0,0
1000000US060952509002033,060952509002033,"Block 2033, Block Group 2, Census Tract 2509, Solano County, California",0,0,0
1000000US060952509002034,060952509002034,"Block 2034, Block Group 2, Census Tract 2509, Solano County, California",8,2,6
1000000US060952509002035,060952509002035,"Block 2035, Block Group 2, Census Tract 2509, Solano County, California",0,0,0
1000000US060952509002036,060952509002036,"Block 2036, Block Group 2, Census Tract 2509, Solano County, California",0,0,0
1000000US060952509002037,060952509002037,"Block 2037, Block Group 2, Census Tract 2509, Solano County, California",12,12,0
1000000US060952509002038,060952509002038,"Block 2038, Block Group 2, Census Tract 2509, Solano County, California",7,7,0
1000000US060952510001000,060952510001000,"Block 1000, Block Group 1, Census Tract 2510, Solano County, California",0,0,0
1000000US060952510001001,060952510001001,"Block 1001, Block Group 1, Census Tract 2510, Solano County, California",21,18,3
1000000US060952510001002,060952510001002,"Block 1002, Block Group 1, Census Tract 2510, Solano County, California",19,18,1
1000000US060952510001003,060952510001003,"Block 1003, Block Group 1, Census Tract 2510, Solano County, California",16,16,0
1000000US060952510001004,060952510001004,"Block 1004, Block Group 1, Census Tract 2510, Solano County, California",19,18,1
1000000US060952510001005,060952510001005,"Block 1005, Block Group 1, Census Tract 2510, Solano County, California",7,6,1
1000000US060952510001006,060952510001006,"Block 1006, Block Group 1, Census Tract 2510, Solano County, California",17,13,4
1000000US060952510001007,060952510001007,"Block 1007, Block Group 1, Census Tract 2510, Solano County, California",19,18,1
1000000US060952510001008,060952510001008,"Block 1008, Block Group 1, Census Tract 2510, Solano County, California",23,18,5
1000000US060952510001009,060952510001009,"Block 1009, Block Group 1, Census Tract 2510, Solano County, California",18,16,2
1000000US060952510001010,060952510001010,"Block 1010, Block Group 1, Census Tract 2510, Solano County, California",15,13,2
1000000US060952510001011,060952510001011,"Block 1011, Block Group 1, Census Tract 2510, Solano County, California",10,9,1
1000000US060952510001012,060952510001012,"Block 1012, Block Group 1, Census Tract 2510, Solano County, California",14,12,2
1000000US060952510001013,060952510001013,"Block 1013, Block Group 1, Census Tract 2510, Solano County, California",18,15,3
1000000US060952510001014,060952510001014,"Block 1014, Block Group 1, Census Tract 2510, Solano County, California",0,0,0
1000000US060952510001015,060952510001015,"Block 1015, Block Group 1, Census Tract 2510, Solano County, California",12,12,0
1000000US060952510001016,060952510001016,"Block 1016, Block Group 1, Census Tract 2510, Solano County, California",21,20,1
1000000US060952510001017,060952510001017,"Block 1017, Block Group 1, Census Tract 2510, Solano County, California",16,15,1
1000000US060952510001018,060952510001018,"Block 1018, Block Group 1, Census Tract 2510, Solano County, California",14,10,4
1000000US060952510001019,060952510001019,"Block 1019, Block Group 1, Census Tract 2510, Solano County, California",7,7,0
1000000US060952510001020,060952510001020,"Block 1020, Block Group 1, Census Tract 2510, Solano County, California",11,10,1
1000000US060952510001021,060952510001021,"Block 1021, Block Group 1, Census Tract 2510, Solano County, California",10,7,3
1000000US060952510001022,060952510001022,"Block 1022, Block Group 1, Census Tract 2510, Solano County, California",22,19,3
1000000US060952510001023,060952510001023,"Block 1023, Block Group 1, Census Tract 2510, Solano County, California",0,0,0
1000000US060952510001024,060952510001024,"Block 1024, Block Group 1, Census Tract 2510, Solano County, California",8,8,0
1000000US060952510001025,060952510001025,"Block 1025, Block Group 1, Census Tract 2510, Solano County, California",13,12,1
1000000US060952510002000,060952510002000,"Block 2000, Block Group 2, Census Tract 2510, Solano County, California",16,12,4
1000000US060952510002001,060952510002001,"Block 2001, Block Group 2, Census Tract 2510, Solano County, California",16,14,2
1000000US060952510002002,060952510002002,"Block 2002, Block Group 2, Census Tract 2510, Solano County, California",28,24,4
1000000US060952510002003,060952510002003,"Block 2003, Block Group 2, Census Tract 2510, Solano County, California",19,19,0
1000000US060952510002004,060952510002004,"Block 2004, Block Group 2, Census Tract 2510, Solano County, California",17,13,4
1000000US060952510002005,060952510002005,"Block 2005, Block Group 2, Census Tract 2510, Solano County, California",22,15,7
1000000US060952510002006,060952510002006,"Block 2006, Block Group 2, Census Tract 2510, Solano County, California",22,17,5
1000000US060952510002007,060952510002007,"Block 2007, Block Group 2, Census Tract 2510, Solano County, California",22,17,5
1000000US060952510002008,060952510002008,"Block 2008, Block Group 2, Census Tract 2510, Solano County, California",20,19,1
1000000US060952510002009,060952510002009,"Block 2009, Block Group 2, Census Tract 2510, Solano County, California",25,19,6
1000000US060952510002010,060952510002010,"Block 2010, Block Group 2, Census Tract 2510, Solano County, California",20,13,7
1000000US060952510002011,060952510002011,"Block 2011, Block Group 2, Census Tract 2510, Solano County, California",27,20,7
1000000US060952510002012,060952510002012,"Block 2012, Block Group 2, Census Tract 2510, Solano County, California",10,9,1
1000000US060952510002013,060952510002013,"Block 2013, Block Group 2, Census Tract 2510, Solano County, California",12,11,1
1000000US060952510002014,060952510002014,"Block 2014, Block Group 2, Census Tract 2510, Solano County, California",40,38,2
1000000US060952510002015,060952510002015,"Block 2015, Block Group 2, Census Tract 2510, Solano County, California",15,13,2
1000000US060952510002016,060952510002016,"Block 2016, Block Group 2, Census Tract 2510, Solano County, California",26,21,5
1000000US060952510002017,060952510002017,"Block 2017, Block Group 2, Census Tract 2510, Solano County, California",15,12,3
1000000US060952510002018,060952510002018,"Block 2018, Block Group 2, Census Tract 2510, Solano County, California",18,16,2
1000000US060952510002019,060952510002019,"Block 2019, Block Group 2, Census Tract 2510, Solano County, California",19,16,3
1000000US060952510002020,060952510002020,"Block 2020, Block Group 2, Census Tract 2510, Solano County, California",21,11,10
1000000US060952510002021,060952510002021,"Block 2021, Block Group 2, Census Tract 2510, Solano County, California",25,17,8
1000000US060952510002022,060952510002022,"Block 2022, Block Group 2, Census Tract 2510, Solano County, California",16,16,0
1000000US060952510002023,060952510002023,"Block 2023, Block Group 2, Census Tract 2510, Solano County, California",23,18,5
1000000US060952510002024,060952510002024,"Block 2024, Block Group 2, Census Tract 2510, Solano County, California",29,21,8
1000000US060952510002025,060952510002025,"Block 2025, Block Group 2, Census Tract 2510, Solano County, California",16,15,1
1000000US060952510003000,060952510003000,"Block 3000, Block Group 3, Census Tract 2510, Solano County, California",10,9,1
1000000US060952510003001,060952510003001,"Block 3001, Block Group 3, Census Tract 2510, Solano County, California",37,34,3
1000000US060952510003002,060952510003002,"Block 3002, Block Group 3, Census Tract 2510, Solano County, California",11,10,1
1000000US060952510003003,060952510003003,"Block 3003, Block Group 3, Census Tract 2510, Solano County, California",9,5,4
1000000US060952510003004,060952510003004,"Block 3004, Block Group 3, Census Tract 2510, Solano County, California",18,17,1
1000000US060952510003005,060952510003005,"Block 3005, Block Group 3, Census Tract 2510, Solano County, California",20,16,4
1000000US060952510003006,060952510003006,"Block 3006, Block Group 3, Census Tract 2510, Solano County, California",15,14,1
1000000US060952510003007,060952510003007,"Block 3007, Block Group 3, Census Tract 2510, Solano County, California",19,12,7
1000000US060952510003008,060952510003008,"Block 3008, Block Group 3, Census Tract 2510, Solano County, California",25,19,6
1000000US060952510003009,060952510003009,"Block 3009, Block Group 3, Census Tract 2510, Solano County, California",11,9,2
1000000US060952510003010,060952510003010,"Block 3010, Block Group 3, Census Tract 2510, Solano County, California",8,8,0
1000000US060952510003011,060952510003011,"Block 3011, Block Group 3, Census Tract 2510, Solano County, California",8,8,0
1000000US060952510003012,060952510003012,"Block 3012, Block Group 3, Census Tract 2510, Solano County, California",20,17,3
1000000US060952510003013,060952510003013,"Block 3013, Block Group 3, Census Tract 2510, Solano County, California",26,22,4
1000000US060952510003014,060952510003014,"Block 3014, Block Group 3, Census Tract 2510, Solano County, California",18,15,3
1000000US060952510003015,060952510003015,"Block 3015, Block Group 3, Census Tract 2510, Solano County, California",1,1,0
1000000US060952510003016,060952510003016,"Block 3016, Block Group 3, Census Tract 2510, Solano County, California",20,13,7
1000000US060952510003017,060952510003017,"Block 3017, Block Group 3, Census Tract 2510, Solano County, California",14,13,1
1000000US060952510003018,060952510003018,"Block 3018, Block Group 3, Census Tract 2510, Solano County, California",16,14,2
1000000US060952510003019,060952510003019,"Block 3019, Block Group 3, Census Tract 2510, Solano County, California",0,0,0
1000000US060952510003020,060952510003020,"Block 3020, Block Group 3, Census Tract 2510, Solano County, California",0,0,0
1000000US060952510003021,060952510003021,"Block 3021, Block Group 3, Census Tract 2510, Solano County, California",24,21,3
1000000US060952510003022,060952510003022,"Block 3022, Block Group 3, Census Tract 2510, Solano County, California",14,11,3
1000000US060952510003023,060952510003023,"Block 3023, Block Group 3, Census Tract 2510, Solano County, California",12,8,4
1000000US060952510003024,060952510003024,"Block 3024, Block Group 3, Census Tract 2510, Solano County, California",0,0,0
1000000US060952510003025,060952510003025,"Block 3025, Block Group 3, Census Tract 2510, Solano County, California",0,0,0
1000000US060952510003026,060952510003026,"Block 3026, Block Group 3, Census Tract 2510, Solano County, California",0,0,0
1000000US060952510003027,060952510003027,"Block 3027, Block Group 3, Census Tract 2510, Solano County, California",18,18,0
1000000US060952510003028,060952510003028,"Block 3028, Block Group 3, Census Tract 2510, Solano County, California",23,16,7
1000000US060952510003029,060952510003029,"Block 3029, Block Group 3, Census Tract 2510, Solano County, California",0,0,0
1000000US060952510003030,060952510003030,"Block 3030, Block Group 3, Census Tract 2510, Solano County, California",0,0,0
1000000US060952511001000,060952511001000,"Block 1000, Block Group 1, Census Tract 2511, Solano County, California",0,0,0
1000000US060952511001001,060952511001001,"Block 1001, Block Group 1, Census Tract 2511, Solano County, California",0,0,0
1000000US060952511001002,060952511001002,"Block 1002, Block Group 1, Census Tract 2511, Solano County, California",0,0,0
1000000US060952511001003,060952511001003,"Block 1003, Block Group 1, Census Tract 2511, Solano County, California",11,11,0
1000000US060952511001004,060952511001004,"Block 1004, Block Group 1, Census Tract 2511, Solano County, California",20,16,4
1000000US060952511001005,060952511001005,"Block 1005, Block Group 1, Census Tract 2511, Solano County, California",21,18,3
1000000US060952511001006,060952511001006,"Block 1006, Block Group 1, Census Tract 2511, Solano County, California",24,21,3
1000000US060952511001007,060952511001007,"Block 1007, Block Group 1, Census Tract 2511, Solano County, California",23,22,1
1000000US060952511001008,060952511001008,"Block 1008, Block Group 1, Census Tract 2511, Solano County, California",28,26,2
1000000US060952511001009,060952511001009,"Block 1009, Block Group 1, Census Tract 2511, Solano County, California",36,36,0
1000000US060952511001010,060952511001010,"Block 1010, Block Group 1, Census Tract 2511, Solano County, California",37,35,2
1000000US060952511001011,060952511001011,"Block 1011, Block Group 1, Census Tract 2511, Solano County, California",23,23,0
1000000US060952511001012,060952511001012,"Block 1012, Block Group 1, Census Tract 2511, Solano County, California",0,0,0
1000000US060952511001013,060952511001013,"Block 1013, Block Group 1, Census Tract 2511, Solano County, California",25,22,3
1000000US060952511001014,060952511001014,"Block 1014, Block Group 1, Census Tract 2511, Solano County, California",31,27,4
1000000US060952511001015,060952511001015,"Block 1015, Block Group 1, Census Tract 2511, Solano County, California",29,28,1
1000000US060952511001016,060952511001016,"Block 1016, Block Group 1, Census Tract 2511, Solano County, California",27,24,3
1000000US060952511001017,060952511001017,"Block 1017, Block Group 1, Census Tract 2511, Solano County, California",26,25,1
1000000US060952511001018,060952511001018,"Block 1018, Block Group 1, Census Tract 2511, Solano County, California",8,8,0
1000000US060952511001019,060952511001019,"Block 1019, Block Group 1, Census Tract 2511, Solano County, California",15,6,9
1000000US060952511001020,060952511001020,"Block 1020, Block Group 1, Census Tract 2511, Solano County, California",19,16,3
1000000US060952511001021,060952511001021,"Block 1021, Block Group 1, Census Tract 2511, Solano County, California",17,16,1
1000000US060952511001022,060952511001022,"Block 1022, Block Group 1, Census Tract 2511, Solano County, California",28,24,4
1000000US060952511001023,060952511001023,"Block 1023, Block Group 1, Census Tract 2511, Solano County, California",15,9,6
1000000US060952511001024,060952511001024,"Block 1024, Block Group 1, Census Tract 2511, Solano County, California",22,17,5
1000000US060952511001025,060952511001025,"Block 1025, Block Group 1, Census Tract 2511, Solano County, California",13,11,2
1000000US060952511001026,060952511001026,"Block 1026, Block Group 1, Census Tract 2511, Solano County, California",17,14,3
1000000US060952511001027,060952511001027,"Block 1027, Block Group 1, Census Tract 2511, Solano County, California",36,30,6
1000000US060952511001028,060952511001028,"Block 1028, Block Group 1, Census Tract 2511, Solano County, California",28,16,12
1000000US060952511001029,060952511001029,"Block 1029, Block Group 1, Census Tract 2511, Solano County, California",10,5,5
1000000US060952511001030,060952511001030,"Block 1030, Block Group 1, Census Tract 2511, Solano County, California",8,8,0
1000000US060952511001031,060952511001031,"Block 1031, Block Group 1, Census Tract 2511, Solano County, California",0,0,0
1000000US060952511001032,060952511001032,"Block 1032, Block Group 1, Census Tract 2511, Solano County, California",0,0,0
1000000US060952511001033,060952511001033,"Block 1033, Block Group 1, Census Tract 2511, Solano County, California",0,0,0
1000000US060952511001034,060952511001034,"Block 1034, Block Group 1, Census Tract 2511, Solano County, California",0,0,0
1000000US060952511001035,060952511001035,"Block 1035, Block Group 1, Census Tract 2511, Solano County, California",0,0,0
1000000US060952511001036,060952511001036,"Block 1036, Block Group 1, Census Tract 2511, Solano County, California",0,0,0
1000000US060952511001037,060952511001037,"Block 1037, Block Group 1, Census Tract 2511, Solano County, California",24,18,6
1000000US060952511001038,060952511001038,"Block 1038, Block Group 1, Census Tract 2511, Solano County, California",36,31,5
1000000US060952511001039,060952511001039,"Block 1039, Block Group 1, Census Tract 2511, Solano County, California",37,34,3
1000000US060952511001040,060952511001040,"Block 1040, Block Group 1, Census Tract 2511, Solano County, California",0,0,0
1000000US060952511001041,060952511001041,"Block 1041, Block Group 1, Census Tract 2511, Solano County, California",0,0,0
1000000US060952511001042,060952511001042,"Block 1042, Block Group 1, Census Tract 2511, Solano County, California",0,0,0
1000000US060952511001043,060952511001043,"Block 1043, Block Group 1, Census Tract 2511, Solano County, California",2,2,0
1000000US060952511001044,060952511001044,"Block 1044, Block Group 1, Census Tract 2511, Solano County, California",8,7,1
1000000US060952511001045,060952511001045,"Block 1045, Block Group 1, Census Tract 2511, Solano County, California",14,9,5
1000000US060952511001046,060952511001046,"Block 1046, Block Group 1, Census Tract 2511, Solano County, California",21,21,0
1000000US060952511001047,060952511001047,"Block 1047, Block Group 1, Census Tract 2511, Solano County, California",19,19,0
1000000US060952511001048,060952511001048,"Block 1048, Block Group 1, Census Tract 2511, Solano County, California",12,11,1
1000000US060952511001049,060952511001049,"Block 1049, Block Group 1, Census Tract 2511, Solano County, California",38,35,3
1000000US060952511001050,060952511001050,"Block 1050, Block Group 1, Census Tract 2511, Solano County, California",9,9,0
1000000US060952511001051,060952511001051,"Block 1051, Block Group 1, Census Tract 2511, Solano County, California",5,5,0
1000000US060952511001052,060952511001052,"Block 1052, Block Group 1, Census Tract 2511, Solano County, California",0,0,0
1000000US060952511001053,060952511001053,"Block 1053, Block Group 1, Census Tract 2511, Solano County, California",30,28,2
1000000US060952511001054,060952511001054,"Block 1054, Block Group 1, Census Tract 2511, Solano County, California",0,0,0
1000000US060952511001055,060952511001055,"Block 1055, Block Group 1, Census Tract 2511, Solano County, California",0,0,0
1000000US060952511001056,060952511001056,"Block 1056, Block Group 1, Census Tract 2511, Solano County, California",26,24,2
1000000US060952511002000,060952511002000,"Block 2000, Block Group 2, Census Tract 2511, Solano County, California",14,11,3
1000000US060952511002001,060952511002001,"Block 2001, Block Group 2, Census Tract 2511, Solano County, California",0,0,0
1000000US060952511002002,060952511002002,"Block 2002, Block Group 2, Census Tract 2511, Solano County, California",8,8,0
1000000US060952511002003,060952511002003,"Block 2003, Block Group 2, Census Tract 2511, Solano County, California",1,1,0
1000000US060952511002004,060952511002004,"Block 2004, Block Group 2, Census Tract 2511, Solano County, California",0,0,0
1000000US060952511002005,060952511002005,"Block 2005, Block Group 2, Census Tract 2511, Solano County, California",28,25,3
1000000US060952511002006,060952511002006,"Block 2006, Block Group 2, Census Tract 2511, Solano County, California",6,3,3
1000000US060952511002007,060952511002007,"Block 2007, Block Group 2, Census Tract 2511, Solano County, California",17,14,3
1000000US060952511002008,060952511002008,"Block 2008, Block Group 2, Census Tract 2511, Solano County, California",12,9,3
1000000US060952511002009,060952511002009,"Block 2009, Block Group 2, Census Tract 2511, Solano County, California",24,22,2
1000000US060952511002010,060952511002010,"Block 2010, Block Group 2, Census Tract 2511, Solano County, California",21,17,4
1000000US060952511002011,060952511002011,"Block 2011, Block Group 2, Census Tract 2511, Solano County, California",21,19,2
1000000US060952511002012,060952511002012,"Block 2012, Block Group 2, Census Tract 2511, Solano County, California",23,20,3
1000000US060952511002013,060952511002013,"Block 2013, Block Group 2, Census Tract 2511, Solano County, California",22,17,5
1000000US060952511002014,060952511002014,"Block 2014, Block Group 2, Census Tract 2511, Solano County, California",15,14,1
1000000US060952511002015,060952511002015,"Block 2015, Block Group 2, Census Tract 2511, Solano County, California",16,13,3
1000000US060952511002016,060952511002016,"Block 2016, Block Group 2, Census Tract 2511, Solano County, California",0,0,0
1000000US060952511002017,060952511002017,"Block 2017, Block Group 2, Census Tract 2511, Solano County, California",19,19,0
1000000US060952511002018,060952511002018,"Block 2018, Block Group 2, Census Tract 2511, Solano County, California",24,23,1
1000000US060952511002019,060952511002019,"Block 2019, Block Group 2, Census Tract 2511, Solano County, California",22,22,0
1000000US060952511002020,060952511002020,"Block 2020, Block Group 2, Census Tract 2511, Solano County, California",5,4,1
1000000US060952511002021,060952511002021,"Block 2021, Block Group 2, Census Tract 2511, Solano County, California",1,0,1
1000000US060952511002022,060952511002022,"Block 2022, Block Group 2, Census Tract 2511, Solano County, California",7,7,0
1000000US060952511002023,060952511002023,"Block 2023, Block Group 2, Census Tract 2511, Solano County, California",18,18,0
1000000US060952511002024,060952511002024,"Block 2024, Block Group 2, Census Tract 2511, Solano County, California",19,19,0
1000000US060952512001000,060952512001000,"Block 1000, Block Group 1, Census Tract 2512, Solano County, California",17,13,4
1000000US060952512001001,060952512001001,"Block 1001, Block Group 1, Census Tract 2512, Solano County, California",19,15,4
1000000US060952512001002,060952512001002,"Block 1002, Block Group 1, Census Tract 2512, Solano County, California",16,16,0
1000000US060952512001003,060952512001003,"Block 1003, Block Group 1, Census Tract 2512, Solano County, California",9,8,1
1000000US060952512001004,060952512001004,"Block 1004, Block Group 1, Census Tract 2512, Solano County, California",14,14,0
1000000US060952512001005,060952512001005,"Block 1005, Block Group 1, Census Tract 2512, Solano County, California",15,13,2
1000000US060952512001006,060952512001006,"Block 1006, Block Group 1, Census Tract 2512, Solano County, California",30,27,3
1000000US060952512001007,060952512001007,"Block 1007, Block Group 1, Census Tract 2512, Solano County, California",9,8,1
1000000US060952512001008,060952512001008,"Block 1008, Block Group 1, Census Tract 2512, Solano County, California",10,9,1
1000000US060952512001009,060952512001009,"Block 1009, Block Group 1, Census Tract 2512, Solano County, California",11,8,3
1000000US060952512001010,060952512001010,"Block 1010, Block Group 1, Census Tract 2512, Solano County, California",11,10,1
1000000US060952512001011,060952512001011,"Block 1011, Block Group 1, Census Tract 2512, Solano County, California",12,12,0
1000000US060952512001012,060952512001012,"Block 1012, Block Group 1, Census Tract 2512, Solano County, California",9,7,2
1000000US060952512001013,060952512001013,"Block 1013, Block Group 1, Census Tract 2512, Solano County, California",6,5,1
1000000US060952512001014,060952512001014,"Block 1014, Block Group 1, Census Tract 2512, Solano County, California",27,27,0
1000000US060952512001015,060952512001015,"Block 1015, Block Group 1, Census Tract 2512, Solano County, California",19,18,1
1000000US060952512001016,060952512001016,"Block 1016, Block Group 1, Census Tract 2512, Solano County, California",31,29,2
1000000US060952512001017,060952512001017,"Block 1017, Block Group 1, Census Tract 2512, Solano County, California",25,25,0
1000000US060952512001018,060952512001018,"Block 1018, Block Group 1, Census Tract 2512, Solano County, California",8,8,0
1000000US060952512001019,060952512001019,"Block 1019, Block Group 1, Census Tract 2512, Solano County, California",8,6,2
1000000US060952512001020,060952512001020,"Block 1020, Block Group 1, Census Tract 2512, Solano County, California",15,13,2
1000000US060952512001021,060952512001021,"Block 1021, Block Group 1, Census Tract 2512, Solano County, California",10,9,1
1000000US060952512001022,060952512001022,"Block 1022, Block Group 1, Census Tract 2512, Solano County, California",9,9,0
1000000US060952512001023,060952512001023,"Block 1023, Block Group 1, Census Tract 2512, Solano County, California",11,9,2
1000000US060952512001024,060952512001024,"Block 1024, Block Group 1, Census Tract 2512, Solano County, California",11,10,1
1000000US060952512001025,060952512001025,"Block 1025, Block Group 1, Census Tract 2512, Solano County, California",13,11,2
1000000US060952512001026,060952512001026,"Block 1026, Block Group 1, Census Tract 2512, Solano County, California",11,8,3
1000000US060952512001027,060952512001027,"Block 1027, Block Group 1, Census Tract 2512, Solano County, California",42,36,6
1000000US060952512001028,060952512001028,"Block 1028, Block Group 1, Census Tract 2512, Solano County, California",27,24,3
1000000US060952512001029,060952512001029,"Block 1029, Block Group 1, Census Tract 2512, Solano County, California",11,9,2
1000000US060952512001030,060952512001030,"Block 1030, Block Group 1, Census Tract 2512, Solano County, California",14,11,3
1000000US060952512001031,060952512001031,"Block 1031, Block Group 1, Census Tract 2512, Solano County, California",14,12,2
1000000US060952512001032,060952512001032,"Block 1032, Block Group 1, Census Tract 2512, Solano County, California",16,14,2
1000000US060952512002000,060952512002000,"Block 2000, Block Group 2, Census Tract 2512, Solano County, California",0,0,0
1000000US060952512002001,060952512002001,"Block 2001, Block Group 2, Census Tract 2512, Solano County, California",49,45,4
1000000US060952512002002,060952512002002,"Block 2002, Block Group 2, Census Tract 2512, Solano County, California",0,0,0
1000000US060952512002003,060952512002003,"Block 2003, Block Group 2, Census Tract 2512, Solano County, California",3,3,0
1000000US060952512002004,060952512002004,"Block 2004, Block Group 2, Census Tract 2512, Solano County, California",5,2,3
1000000US060952512002005,060952512002005,"Block 2005, Block Group 2, Census Tract 2512, Solano County, California",10,10,0
1000000US060952512002006,060952512002006,"Block 2006, Block Group 2, Census Tract 2512, Solano County, California",6,5,1
1000000US060952512002007,060952512002007,"Block 2007, Block Group 2, Census Tract 2512, Solano County, California",9,8,1
1000000US060952512002008,060952512002008,"Block 2008, Block Group 2, Census Tract 2512, Solano County, California",19,18,1
1000000US060952512002009,060952512002009,"Block 2009, Block Group 2, Census Tract 2512, Solano County, California",18,18,0
1000000US060952512002010,060952512002010,"Block 2010, Block Group 2, Census Tract 2512, Solano County, California",19,16,3
1000000US060952512002011,060952512002011,"Block 2011, Block Group 2, Census Tract 2512, Solano County, California",24,21,3
1000000US060952512002012,060952512002012,"Block 2012, Block Group 2, Census Tract 2512, Solano County, California",14,13,1
1000000US060952512002013,060952512002013,"Block 2013, Block Group 2, Census Tract 2512, Solano County, California",11,10,1
1000000US060952512002014,060952512002014,"Block 2014, Block Group 2, Census Tract 2512, Solano County, California",48,44,4
1000000US060952512002015,060952512002015,"Block 2015, Block Group 2, Census Tract 2512, Solano County, California",8,7,1
1000000US060952512002016,060952512002016,"Block 2016, Block Group 2, Census Tract 2512, Solano County, California",20,18,2
1000000US060952512002017,060952512002017,"Block 2017, Block Group 2, Census Tract 2512, Solano County, California",17,13,4
1000000US060952512002018,060952512002018,"Block 2018, Block Group 2, Census Tract 2512, Solano County, California",26,17,9
1000000US060952512002019,060952512002019,"Block 2019, Block Group 2, Census Tract 2512, Solano County, California",0,0,0
1000000US060952512002020,060952512002020,"Block 2020, Block Group 2, Census Tract 2512, Solano County, California",13,12,1
1000000US060952512002021,060952512002021,"Block 2021, Block Group 2, Census Tract 2512, Solano County, California",7,7,0
1000000US060952512002022,060952512002022,"Block 2022, Block Group 2, Census Tract 2512, Solano County, California",12,11,1
1000000US060952512002023,060952512002023,"Block 2023, Block Group 2, Census Tract 2512, Solano County, California",5,4,1
1000000US060952512002024,060952512002024,"Block 2024, Block Group 2, Census Tract 2512, Solano County, California",4,4,0
1000000US060952512002025,060952512002025,"Block 2025, Block Group 2, Census Tract 2512, Solano County, California",6,4,2
1000000US060952512002026,060952512002026,"Block 2026, Block Group 2, Census Tract 2512, Solano County, California",19,17,2
1000000US060952512002027,060952512002027,"Block 2027, Block Group 2, Census Tract 2512, Solano County, California",0,0,0
1000000US060952512002028,060952512002028,"Block 2028, Block Group 2, Census Tract 2512, Solano County, California",24,23,1
1000000US060952512002029,060952512002029,"Block 2029, Block Group 2, Census Tract 2512, Solano County, California",16,16,0
1000000US060952512003000,060952512003000,"Block 3000, Block Group 3, Census Tract 2512, Solano County, California",0,0,0
1000000US060952512003001,060952512003001,"Block 3001, Block Group 3, Census Tract 2512, Solano County, California",26,26,0
1000000US060952512003002,060952512003002,"Block 3002, Block Group 3, Census Tract 2512, Solano County, California",22,22,0
1000000US060952512003003,060952512003003,"Block 3003, Block Group 3, Census Tract 2512, Solano County, California",0,0,0
1000000US060952512003004,060952512003004,"Block 3004, Block Group 3, Census Tract 2512, Solano County, California",0,0,0
1000000US060952512003005,060952512003005,"Block 3005, Block Group 3, Census Tract 2512, Solano County, California",0,0,0
1000000US060952512003006,060952512003006,"Block 3006, Block Group 3, Census Tract 2512, Solano County, California",0,0,0
1000000US060952512003007,060952512003007,"Block 3007, Block Group 3, Census Tract 2512, Solano County, California",11,11,0
1000000US060952512003008,060952512003008,"Block 3008, Block Group 3, Census Tract 2512, Solano County, California",14,9,5
1000000US060952512003009,060952512003009,"Block 3009, Block Group 3, Census Tract 2512, Solano County, California",12,11,1
1000000US060952512003010,060952512003010,"Block 3010, Block Group 3, Census Tract 2512, Solano County, California",12,11,1
1000000US060952512003011,060952512003011,"Block 3011, Block Group 3, Census Tract 2512, Solano County, California",18,12,6
1000000US060952512003012,060952512003012,"Block 3012, Block Group 3, Census Tract 2512, Solano County, California",17,14,3
1000000US060952512003013,060952512003013,"Block 3013, Block Group 3, Census Tract 2512, Solano County, California",18,15,3
1000000US060952512003014,060952512003014,"Block 3014, Block Group 3, Census Tract 2512, Solano County, California",24,21,3
1000000US060952512003015,060952512003015,"Block 3015, Block Group 3, Census Tract 2512, Solano County, California",15,13,2
1000000US060952512003016,060952512003016,"Block 3016, Block Group 3, Census Tract 2512, Solano County, California",16,13,3
1000000US060952512003017,060952512003017,"Block 3017, Block Group 3, Census Tract 2512, Solano County, California",21,21,0
1000000US060952512003018,060952512003018,"Block 3018, Block Group 3, Census Tract 2512, Solano County, California",19,18,1
1000000US060952512003019,060952512003019,"Block 3019, Block Group 3, Census Tract 2512, Solano County, California",18,14,4
1000000US060952512003020,060952512003020,"Block 3020, Block Group 3, Census Tract 2512, Solano County, California",0,0,0
1000000US060952512003021,060952512003021,"Block 3021, Block Group 3, Census Tract 2512, Solano County, California",4,4,0
1000000US060952512003022,060952512003022,"Block 3022, Block Group 3, Census Tract 2512, Solano County, California",0,0,0
1000000US060952512003023,060952512003023,"Block 3023, Block Group 3, Census Tract 2512, Solano County, California",8,6,2
1000000US060952512003024,060952512003024,"Block 3024, Block Group 3, Census Tract 2512, Solano County, California",8,7,1
1000000US060952512003025,060952512003025,"Block 3025, Block Group 3, Census Tract 2512, Solano County, California",13,9,4
1000000US060952512003026,060952512003026,"Block 3026, Block Group 3, Census Tract 2512, Solano County, California",8,6,2
1000000US060952513001000,060952513001000,"Block 1000, Block Group 1, Census Tract 2513, Solano County, California",14,12,2
1000000US060952513001001,060952513001001,"Block 1001, Block Group 1, Census Tract 2513, Solano County, California",16,15,1
1000000US060952513001002,060952513001002,"Block 1002, Block Group 1, Census Tract 2513, Solano County, California",16,16,0
1000000US060952513001003,060952513001003,"Block 1003, Block Group 1, Census Tract 2513, Solano County, California",16,15,1
1000000US060952513001004,060952513001004,"Block 1004, Block Group 1, Census Tract 2513, Solano County, California",8,7,1
1000000US060952513001005,060952513001005,"Block 1005, Block Group 1, Census Tract 2513, Solano County, California",28,28,0
1000000US060952513001006,060952513001006,"Block 1006, Block Group 1, Census Tract 2513, Solano County, California",18,18,0
1000000US060952513001007,060952513001007,"Block 1007, Block Group 1, Census Tract 2513, Solano County, California",21,21,0
1000000US060952513001008,060952513001008,"Block 1008, Block Group 1, Census Tract 2513, Solano County, California",19,17,2
1000000US060952513001009,060952513001009,"Block 1009, Block Group 1, Census Tract 2513, Solano County, California",20,20,0
1000000US060952513001010,060952513001010,"Block 1010, Block Group 1, Census Tract 2513, Solano County, California",14,12,2
1000000US060952513001011,060952513001011,"Block 1011, Block Group 1, Census Tract 2513, Solano County, California",19,17,2
1000000US060952513001012,060952513001012,"Block 1012, Block Group 1, Census Tract 2513, Solano County, California",19,18,1
1000000US060952513001013,060952513001013,"Block 1013, Block Group 1, Census Tract 2513, Solano County, California",18,17,1
1000000US060952513001014,060952513001014,"Block 1014, Block Group 1, Census Tract 2513, Solano County, California",20,15,5
1000000US060952513001015,060952513001015,"Block 1015, Block Group 1, Census Tract 2513, Solano County, California",18,15,3
1000000US060952513001016,060952513001016,"Block 1016, Block Group 1, Census Tract 2513, Solano County, California",1,1,0
1000000US060952513001017,060952513001017,"Block 1017, Block Group 1, Census Tract 2513, Solano County, California",16,15,1
1000000US060952513001018,060952513001018,"Block 1018, Block Group 1, Census Tract 2513, Solano County, California",17,17,0
1000000US060952513001019,060952513001019,"Block 1019, Block Group 1, Census Tract 2513, Solano County, California",16,14,2
1000000US060952513002000,060952513002000,"Block 2000, Block Group 2, Census Tract 2513, Solano County, California",0,0,0
1000000US060952513002001,060952513002001,"Block 2001, Block Group 2, Census Tract 2513, Solano County, California",44,42,2
1000000US060952513002002,060952513002002,"Block 2002, Block Group 2, Census Tract 2513, Solano County, California",0,0,0
1000000US060952513002003,060952513002003,"Block 2003, Block Group 2, Census Tract 2513, Solano County, California",25,23,2
1000000US060952513002004,060952513002004,"Block 2004, Block Group 2, Census Tract 2513, Solano County, California",40,35,5
1000000US060952513002005,060952513002005,"Block 2005, Block Group 2, Census Tract 2513, Solano County, California",12,12,0
1000000US060952513002006,060952513002006,"Block 2006, Block Group 2, Census Tract 2513, Solano County, California",0,0,0
1000000US060952513002007,060952513002007,"Block 2007, Block Group 2, Census Tract 2513, Solano County, California",24,23,1
1000000US060952513002008,060952513002008,"Block 2008, Block Group 2, Census Tract 2513, Solano County, California",18,17,1
1000000US060952513002009,060952513002009,"Block 2009, Block Group 2, Census Tract 2513, Solano County, California",55,54,1
1000000US060952513002010,060952513002010,"Block 2010, Block Group 2, Census Tract 2513, Solano County, California",5,5,0
1000000US060952513002011,060952513002011,"Block 2011, Block Group 2, Census Tract 2513, Solano County, California",5,5,0
1000000US060952513002012,060952513002012,"Block 2012, Block Group 2, Census Tract 2513, Solano County, California",17,15,2
1000000US060952513002013,060952513002013,"Block 2013, Block Group 2, Census Tract 2513, Solano County, California",27,25,2
1000000US060952513002014,060952513002014,"Block 2014, Block Group 2, Census Tract 2513, Solano County, California",14,13,1
1000000US060952513002015,060952513002015,"Block 2015, Block Group 2, Census Tract 2513, Solano County, California",21,20,1
1000000US060952513002016,060952513002016,"Block 2016, Block Group 2, Census Tract 2513, Solano County, California",6,6,0
1000000US060952513002017,060952513002017,"Block 2017, Block Group 2, Census Tract 2513, Solano County, California",11,11,0
1000000US060952513002018,060952513002018,"Block 2018, Block Group 2, Census Tract 2513, Solano County, California",12,10,2
1000000US060952513002019,060952513002019,"Block 2019, Block Group 2, Census Tract 2513, Solano County, California",11,11,0
1000000US060952513002020,060952513002020,"Block 2020, Block Group 2, Census Tract 2513, Solano County, California",30,28,2
1000000US060952513002021,060952513002021,"Block 2021, Block Group 2, Census Tract 2513, Solano County, California",36,33,3
1000000US060952513002022,060952513002022,"Block 2022, Block Group 2, Census Tract 2513, Solano County, California",26,25,1
1000000US060952513002023,060952513002023,"Block 2023, Block Group 2, Census Tract 2513, Solano County, California",25,24,1
1000000US060952513002024,060952513002024,"Block 2024, Block Group 2, Census Tract 2513, Solano County, California",26,25,1
1000000US060952513003000,060952513003000,"Block 3000, Block Group 3, Census Tract 2513, Solano County, California",0,0,0
1000000US060952513003001,060952513003001,"Block 3001, Block Group 3, Census Tract 2513, Solano County, California",0,0,0
1000000US060952513003002,060952513003002,"Block 3002, Block Group 3, Census Tract 2513, Solano County, California",57,57,0
1000000US060952513003003,060952513003003,"Block 3003, Block Group 3, Census Tract 2513, Solano County, California",10,10,0
1000000US060952513003004,060952513003004,"Block 3004, Block Group 3, Census Tract 2513, Solano County, California",9,8,1
1000000US060952513003005,060952513003005,"Block 3005, Block Group 3, Census Tract 2513, Solano County, California",10,9,1
1000000US060952513003006,060952513003006,"Block 3006, Block Group 3, Census Tract 2513, Solano County, California",22,22,0
1000000US060952513003007,060952513003007,"Block 3007, Block Group 3, Census Tract 2513, Solano County, California",38,32,6
1000000US060952513003008,060952513003008,"Block 3008, Block Group 3, Census Tract 2513, Solano County, California",46,41,5
1000000US060952513003009,060952513003009,"Block 3009, Block Group 3, Census Tract 2513, Solano County, California",61,55,6
1000000US060952513003010,060952513003010,"Block 3010, Block Group 3, Census Tract 2513, Solano County, California",59,54,5
1000000US060952513003011,060952513003011,"Block 3011, Block Group 3, Census Tract 2513, Solano County, California",25,25,0
1000000US060952513003012,060952513003012,"Block 3012, Block Group 3, Census Tract 2513, Solano County, California",31,27,4
1000000US060952513003013,060952513003013,"Block 3013, Block Group 3, Census Tract 2513, Solano County, California",16,16,0
1000000US060952513003014,060952513003014,"Block 3014, Block Group 3, Census Tract 2513, Solano County, California",24,23,1
1000000US060952513003015,060952513003015,"Block 3015, Block Group 3, Census Tract 2513, Solano County, California",15,13,2
1000000US060952513003016,060952513003016,"Block 3016, Block Group 3, Census Tract 2513, Solano County, California",19,19,0
1000000US060952514001000,060952514001000,"Block 1000, Block Group 1, Census Tract 2514, Solano County, California",9,9,0
1000000US060952514001001,060952514001001,"Block 1001, Block Group 1, Census Tract 2514, Solano County, California",7,7,0
1000000US060952514001002,060952514001002,"Block 1002, Block Group 1, Census Tract 2514, Solano County, California",0,0,0
1000000US060952514001003,060952514001003,"Block 1003, Block Group 1, Census Tract 2514, Solano County, California",42,38,4
1000000US060952514001004,060952514001004,"Block 1004, Block Group 1, Census Tract 2514, Solano County, California",88,72,16
1000000US060952514001005,060952514001005,"Block 1005, Block Group 1, Census Tract 2514, Solano County, California",8,7,1
1000000US060952514001006,060952514001006,"Block 1006, Block Group 1, Census Tract 2514, Solano County, California",0,0,0
1000000US060952514001007,060952514001007,"Block 1007, Block Group 1, Census Tract 2514, Solano County, California",0,0,0
1000000US060952514001008,060952514001008,"Block 1008, Block Group 1, Census Tract 2514, Solano County, California",206,162,44
1000000US060952514001009,060952514001009,"Block 1009, Block Group 1, Census Tract 2514, Solano County, California",16,13,3
1000000US060952514001010,060952514001010,"Block 1010, Block Group 1, Census Tract 2514, Solano County, California",155,134,21
1000000US060952514001011,060952514001011,"Block 1011, Block Group 1, Census Tract 2514, Solano County, California",0,0,0
1000000US060952514001012,060952514001012,"Block 1012, Block Group 1, Census Tract 2514, Solano County, California",13,13,0
1000000US060952514001013,060952514001013,"Block 1013, Block Group 1, Census Tract 2514, Solano County, California",22,22,0
1000000US060952514001014,060952514001014,"Block 1014, Block Group 1, Census Tract 2514, Solano County, California",39,35,4
1000000US060952514001015,060952514001015,"Block 1015, Block Group 1, Census Tract 2514, Solano County, California",39,34,5
1000000US060952514001016,060952514001016,"Block 1016, Block Group 1, Census Tract 2514, Solano County, California",20,19,1
1000000US060952514001017,060952514001017,"Block 1017, Block Group 1, Census Tract 2514, Solano County, California",17,15,2
1000000US060952514001018,060952514001018,"Block 1018, Block Group 1, Census Tract 2514, Solano County, California",14,13,1
1000000US060952514001019,060952514001019,"Block 1019, Block Group 1, Census Tract 2514, Solano County, California",21,20,1
1000000US060952514001020,060952514001020,"Block 1020, Block Group 1, Census Tract 2514, Solano County, California",21,20,1
1000000US060952514001021,060952514001021,"Block 1021, Block Group 1, Census Tract 2514, Solano County, California",138,124,14
1000000US060952514001022,060952514001022,"Block 1022, Block Group 1, Census Tract 2514, Solano County, California",0,0,0
1000000US060952514001023,060952514001023,"Block 1023, Block Group 1, Census Tract 2514, Solano County, California",14,12,2
1000000US060952514001024,060952514001024,"Block 1024, Block Group 1, Census Tract 2514, Solano County, California",24,24,0
1000000US060952514001025,060952514001025,"Block 1025, Block Group 1, Census Tract 2514, Solano County, California",22,20,2
1000000US060952514001026,060952514001026,"Block 1026, Block Group 1, Census Tract 2514, Solano County, California",0,0,0
1000000US060952514002000,060952514002000,"Block 2000, Block Group 2, Census Tract 2514, Solano County, California",24,24,0
1000000US060952514002001,060952514002001,"Block 2001, Block Group 2, Census Tract 2514, Solano County, California",56,50,6
1000000US060952514002002,060952514002002,"Block 2002, Block Group 2, Census Tract 2514, Solano County, California",46,45,1
1000000US060952514002003,060952514002003,"Block 2003, Block Group 2, Census Tract 2514, Solano County, California",101,87,14
1000000US060952514002004,060952514002004,"Block 2004, Block Group 2, Census Tract 2514, Solano County, California",54,47,7
1000000US060952514002005,060952514002005,"Block 2005, Block Group 2, Census Tract 2514, Solano County, California",20,19,1
1000000US060952514002006,060952514002006,"Block 2006, Block Group 2, Census Tract 2514, Solano County, California",0,0,0
1000000US060952514002007,060952514002007,"Block 2007, Block Group 2, Census Tract 2514, Solano County, California",0,0,0
1000000US060952514002008,060952514002008,"Block 2008, Block Group 2, Census Tract 2514, Solano County, California",22,20,2
1000000US060952514002009,060952514002009,"Block 2009, Block Group 2, Census Tract 2514, Solano County, California",0,0,0
1000000US060952514002010,060952514002010,"Block 2010, Block Group 2, Census Tract 2514, Solano County, California",14,14,0
1000000US060952514002011,060952514002011,"Block 2011, Block Group 2, Census Tract 2514, Solano County, California",7,7,0
1000000US060952514002012,060952514002012,"Block 2012, Block Group 2, Census Tract 2514, Solano County, California",41,40,1
1000000US060952514002013,060952514002013,"Block 2013, Block Group 2, Census Tract 2514, Solano County, California",35,32,3
1000000US060952514002014,060952514002014,"Block 2014, Block Group 2, Census Tract 2514, Solano County, California",40,35,5
1000000US060952514002015,060952514002015,"Block 2015, Block Group 2, Census Tract 2514, Solano County, California",14,13,1
1000000US060952514002016,060952514002016,"Block 2016, Block Group 2, Census Tract 2514, Solano County, California",31,30,1
1000000US060952514002017,060952514002017,"Block 2017, Block Group 2, Census Tract 2514, Solano County, California",47,46,1
1000000US060952514002018,060952514002018,"Block 2018, Block Group 2, Census Tract 2514, Solano County, California",22,21,1
1000000US060952514002019,060952514002019,"Block 2019, Block Group 2, Census Tract 2514, Solano County, California",10,8,2
1000000US060952514002020,060952514002020,"Block 2020, Block Group 2, Census Tract 2514, Solano County, California",18,16,2
1000000US060952514003000,060952514003000,"Block 3000, Block Group 3, Census Tract 2514, Solano County, California",7,6,1
1000000US060952514003001,060952514003001,"Block 3001, Block Group 3, Census Tract 2514, Solano County, California",18,17,1
1000000US060952514003002,060952514003002,"Block 3002, Block Group 3, Census Tract 2514, Solano County, California",23,21,2
1000000US060952514003003,060952514003003,"Block 3003, Block Group 3, Census Tract 2514, Solano County, California",40,38,2
1000000US060952514003004,060952514003004,"Block 3004, Block Group 3, Census Tract 2514, Solano County, California",93,77,16
1000000US060952514003005,060952514003005,"Block 3005, Block Group 3, Census Tract 2514, Solano County, California",1,1,0
1000000US060952514003006,060952514003006,"Block 3006, Block Group 3, Census Tract 2514, Solano County, California",0,0,0
1000000US060952514003007,060952514003007,"Block 3007, Block Group 3, Census Tract 2514, Solano County, California",150,142,8
1000000US060952514003008,060952514003008,"Block 3008, Block Group 3, Census Tract 2514, Solano County, California",19,19,0
1000000US060952514003009,060952514003009,"Block 3009, Block Group 3, Census Tract 2514, Solano County, California",13,12,1
1000000US060952514003010,060952514003010,"Block 3010, Block Group 3, Census Tract 2514, Solano County, California",50,46,4
1000000US060952514003011,060952514003011,"Block 3011, Block Group 3, Census Tract 2514, Solano County, California",27,27,0
1000000US060952514003012,060952514003012,"Block 3012, Block Group 3, Census Tract 2514, Solano County, California",28,27,1
1000000US060952514003013,060952514003013,"Block 3013, Block Group 3, Census Tract 2514, Solano County, California",20,19,1
1000000US060952514003014,060952514003014,"Block 3014, Block Group 3, Census Tract 2514, Solano County, California",38,37,1
1000000US060952514003015,060952514003015,"Block 3015, Block Group 3, Census Tract 2514, Solano County, California",34,30,4
1000000US060952514003016,060952514003016,"Block 3016, Block Group 3, Census Tract 2514, Solano County, California",8,8,0
1000000US060952514003017,060952514003017,"Block 3017, Block Group 3, Census Tract 2514, Solano County, California",36,35,1
1000000US060952514003018,060952514003018,"Block 3018, Block Group 3, Census Tract 2514, Solano County, California",21,21,0
1000000US060952514003019,060952514003019,"Block 3019, Block Group 3, Census Tract 2514, Solano County, California",29,27,2
1000000US060952514003020,060952514003020,"Block 3020, Block Group 3, Census Tract 2514, Solano County, California",14,10,4
1000000US060952514003021,060952514003021,"Block 3021, Block Group 3, Census Tract 2514, Solano County, California",21,21,0
1000000US060952514003022,060952514003022,"Block 3022, Block Group 3, Census Tract 2514, Solano County, California",13,11,2
1000000US060952514003023,060952514003023,"Block 3023, Block Group 3, Census Tract 2514, Solano County, California",19,17,2
1000000US060952514003024,060952514003024,"Block 3024, Block Group 3, Census Tract 2514, Solano County, California",10,9,1
1000000US060952514003025,060952514003025,"Block 3025, Block Group 3, Census Tract 2514, Solano County, California",11,10,1
1000000US060952514003026,060952514003026,"Block 3026, Block Group 3, Census Tract 2514, Solano County, California",12,12,0
1000000US060952514003027,060952514003027,"Block 3027, Block Group 3, Census Tract 2514, Solano County, California",18,16,2
1000000US060952514003028,060952514003028,"Block 3028, Block Group 3, Census Tract 2514, Solano County, California",17,17,0
1000000US060952514003029,060952514003029,"Block 3029, Block Group 3, Census Tract 2514, Solano County, California",0,0,0
1000000US060952515001000,060952515001000,"Block 1000, Block Group 1, Census Tract 2515, Solano County, California",2,2,0
1000000US060952515001001,060952515001001,"Block 1001, Block Group 1, Census Tract 2515, Solano County, California",0,0,0
1000000US060952515001002,060952515001002,"Block 1002, Block Group 1, Census Tract 2515, Solano County, California",2,2,0
1000000US060952515001003,060952515001003,"Block 1003, Block Group 1, Census Tract 2515, Solano County, California",31,22,9
1000000US060952515001004,060952515001004,"Block 1004, Block Group 1, Census Tract 2515, Solano County, California",0,0,0
1000000US060952515001005,060952515001005,"Block 1005, Block Group 1, Census Tract 2515, Solano County, California",14,13,1
1000000US060952515001006,060952515001006,"Block 1006, Block Group 1, Census Tract 2515, Solano County, California",0,0,0
1000000US060952515001007,060952515001007,"Block 1007, Block Group 1, Census Tract 2515, Solano County, California",0,0,0
1000000US060952515001008,060952515001008,"Block 1008, Block Group 1, Census Tract 2515, Solano County, California",0,0,0
1000000US060952515001009,060952515001009,"Block 1009, Block Group 1, Census Tract 2515, Solano County, California",0,0,0
1000000US060952515001010,060952515001010,"Block 1010, Block Group 1, Census Tract 2515, Solano County, California",15,9,6
1000000US060952515001011,060952515001011,"Block 1011, Block Group 1, Census Tract 2515, Solano County, California",25,19,6
1000000US060952515001012,060952515001012,"Block 1012, Block Group 1, Census Tract 2515, Solano County, California",22,21,1
1000000US060952515001013,060952515001013,"Block 1013, Block Group 1, Census Tract 2515, Solano County, California",16,16,0
1000000US060952515001014,060952515001014,"Block 1014, Block Group 1, Census Tract 2515, Solano County, California",21,16,5
1000000US060952515001015,060952515001015,"Block 1015, Block Group 1, Census Tract 2515, Solano County, California",9,8,1
1000000US060952515001016,060952515001016,"Block 1016, Block Group 1, Census Tract 2515, Solano County, California",15,15,0
1000000US060952515001017,060952515001017,"Block 1017, Block Group 1, Census Tract 2515, Solano County, California",24,21,3
1000000US060952515001018,060952515001018,"Block 1018, Block Group 1, Census Tract 2515, Solano County, California",11,8,3
1000000US060952515001019,060952515001019,"Block 1019, Block Group 1, Census Tract 2515, Solano County, California",0,0,0
1000000US060952515001020,060952515001020,"Block 1020, Block Group 1, Census Tract 2515, Solano County, California",6,3,3
1000000US060952515001021,060952515001021,"Block 1021, Block Group 1, Census Tract 2515, Solano County, California",15,11,4
1000000US060952515001022,060952515001022,"Block 1022, Block Group 1, Census Tract 2515, Solano County, California",28,26,2
1000000US060952515001023,060952515001023,"Block 1023, Block Group 1, Census Tract 2515, Solano County, California",13,10,3
1000000US060952515001024,060952515001024,"Block 1024, Block Group 1, Census Tract 2515, Solano County, California",0,0,0
1000000US060952515001025,060952515001025,"Block 1025, Block Group 1, Census Tract 2515, Solano County, California",6,6,0
1000000US060952515001026,060952515001026,"Block 1026, Block Group 1, Census Tract 2515, Solano County, California",7,5,2
1000000US060952515001027,060952515001027,"Block 1027, Block Group 1, Census Tract 2515, Solano County, California",18,18,0
1000000US060952515001028,060952515001028,"Block 1028, Block Group 1, Census Tract 2515, Solano County, California",14,14,0
1000000US060952515001029,060952515001029,"Block 1029, Block Group 1, Census Tract 2515, Solano County, California",21,19,2
1000000US060952515001030,060952515001030,"Block 1030, Block Group 1, Census Tract 2515, Solano County, California",10,8,2
1000000US060952515002000,060952515002000,"Block 2000, Block Group 2, Census Tract 2515, Solano County, California",35,34,1
1000000US060952515002001,060952515002001,"Block 2001, Block Group 2, Census Tract 2515, Solano County, California",8,8,0
1000000US060952515002002,060952515002002,"Block 2002, Block Group 2, Census Tract 2515, Solano County, California",12,11,1
1000000US060952515002003,060952515002003,"Block 2003, Block Group 2, Census Tract 2515, Solano County, California",17,15,2
1000000US060952515002004,060952515002004,"Block 2004, Block Group 2, Census Tract 2515, Solano County, California",13,10,3
1000000US060952515002005,060952515002005,"Block 2005, Block Group 2, Census Tract 2515, Solano County, California",0,0,0
1000000US060952515002006,060952515002006,"Block 2006, Block Group 2, Census Tract 2515, Solano County, California",27,25,2
1000000US060952515002007,060952515002007,"Block 2007, Block Group 2, Census Tract 2515, Solano County, California",33,30,3
1000000US060952515002008,060952515002008,"Block 2008, Block Group 2, Census Tract 2515, Solano County, California",40,38,2
1000000US060952515002009,060952515002009,"Block 2009, Block Group 2, Census Tract 2515, Solano County, California",14,14,0
1000000US060952515002010,060952515002010,"Block 2010, Block Group 2, Census Tract 2515, Solano County, California",14,13,1
1000000US060952515002011,060952515002011,"Block 2011, Block Group 2, Census Tract 2515, Solano County, California",11,9,2
1000000US060952515002012,060952515002012,"Block 2012, Block Group 2, Census Tract 2515, Solano County, California",17,16,1
1000000US060952515002013,060952515002013,"Block 2013, Block Group 2, Census Tract 2515, Solano County, California",6,6,0
1000000US060952515002014,060952515002014,"Block 2014, Block Group 2, Census Tract 2515, Solano County, California",13,10,3
1000000US060952515002015,060952515002015,"Block 2015, Block Group 2, Census Tract 2515, Solano County, California",0,0,0
1000000US060952515002016,060952515002016,"Block 2016, Block Group 2, Census Tract 2515, Solano County, California",0,0,0
1000000US060952515002017,060952515002017,"Block 2017, Block Group 2, Census Tract 2515, Solano County, California",7,7,0
1000000US060952515002018,060952515002018,"Block 2018, Block Group 2, Census Tract 2515, Solano County, California",0,0,0
1000000US060952515002019,060952515002019,"Block 2019, Block Group 2, Census Tract 2515, Solano County, California",3,3,0
1000000US060952515002020,060952515002020,"Block 2020, Block Group 2, Census Tract 2515, Solano County, California",11,11,0
1000000US060952515002021,060952515002021,"Block 2021, Block Group 2, Census Tract 2515, Solano County, California",16,12,4
1000000US060952515002022,060952515002022,"Block 2022, Block Group 2, Census Tract 2515, Solano County, California",12,7,5
1000000US060952515002023,060952515002023,"Block 2023, Block Group 2, Census Tract 2515, Solano County, California",18,16,2
1000000US060952515002024,060952515002024,"Block 2024, Block Group 2, Census Tract 2515, Solano County, California",16,15,1
1000000US060952515002025,060952515002025,"Block 2025, Block Group 2, Census Tract 2515, Solano County, California",4,4,0
1000000US060952515002026,060952515002026,"Block 2026, Block Group 2, Census Tract 2515, Solano County, California",7,6,1
1000000US060952515002027,060952515002027,"Block 2027, Block Group 2, Census Tract 2515, Solano County, California",2,2,0
1000000US060952515002028,060952515002028,"Block 2028, Block Group 2, Census Tract 2515, Solano County, California",1,0,1
1000000US060952515002029,060952515002029,"Block 2029, Block Group 2, Census Tract 2515, Solano County, California",0,0,0
1000000US060952515002030,060952515002030,"Block 2030, Block Group 2, Census Tract 2515, Solano County, California",16,16,0
1000000US060952515002031,060952515002031,"Block 2031, Block Group 2, Census Tract 2515, Solano County, California",28,21,7
1000000US060952515002032,060952515002032,"Block 2032, Block Group 2, Census Tract 2515, Solano County, California",0,0,0
1000000US060952515002033,060952515002033,"Block 2033, Block Group 2, Census Tract 2515, Solano County, California",5,4,1
1000000US060952515002034,060952515002034,"Block 2034, Block Group 2, Census Tract 2515, Solano County, California",3,3,0
1000000US060952515002035,060952515002035,"Block 2035, Block Group 2, Census Tract 2515, Solano County, California",21,16,5
1000000US060952515002036,060952515002036,"Block 2036, Block Group 2, Census Tract 2515, Solano County, California",0,0,0
1000000US060952515002037,060952515002037,"Block 2037, Block Group 2, Census Tract 2515, Solano County, California",1,1,0
1000000US060952515002038,060952515002038,"Block 2038, Block Group 2, Census Tract 2515, Solano County, California",6,5,1
1000000US060952515002039,060952515002039,"Block 2039, Block Group 2, Census Tract 2515, Solano County, California",11,10,1
1000000US060952515002040,060952515002040,"Block 2040, Block Group 2, Census Tract 2515, Solano County, California",17,14,3
1000000US060952515002041,060952515002041,"Block 2041, Block Group 2, Census Tract 2515, Solano County, California",14,12,2
1000000US060952515002042,060952515002042,"Block 2042, Block Group 2, Census Tract 2515, Solano County, California",18,15,3
1000000US060952515002043,060952515002043,"Block 2043, Block Group 2, Census Tract 2515, Solano County, California",6,6,0
1000000US060952515003000,060952515003000,"Block 3000, Block Group 3, Census Tract 2515, Solano County, California",20,19,1
1000000US060952515003001,060952515003001,"Block 3001, Block Group 3, Census Tract 2515, Solano County, California",15,13,2
1000000US060952515003002,060952515003002,"Block 3002, Block Group 3, Census Tract 2515, Solano County, California",11,9,2
1000000US060952515003003,060952515003003,"Block 3003, Block Group 3, Census Tract 2515, Solano County, California",11,9,2
1000000US060952515003004,060952515003004,"Block 3004, Block Group 3, Census Tract 2515, Solano County, California",10,9,1
1000000US060952515003005,060952515003005,"Block 3005, Block Group 3, Census Tract 2515, Solano County, California",3,3,0
1000000US060952515003006,060952515003006,"Block 3006, Block Group 3, Census Tract 2515, Solano County, California",23,22,1
1000000US060952515003007,060952515003007,"Block 3007, Block Group 3, Census Tract 2515, Solano County, California",12,8,4
1000000US060952515003008,060952515003008,"Block 3008, Block Group 3, Census Tract 2515, Solano County, California",45,41,4
1000000US060952515003009,060952515003009,"Block 3009, Block Group 3, Census Tract 2515, Solano County, California",17,16,1
1000000US060952515003010,060952515003010,"Block 3010, Block Group 3, Census Tract 2515, Solano County, California",10,10,0
1000000US060952515003011,060952515003011,"Block 3011, Block Group 3, Census Tract 2515, Solano County, California",30,26,4
1000000US060952515003012,060952515003012,"Block 3012, Block Group 3, Census Tract 2515, Solano County, California",9,8,1
1000000US060952515003013,060952515003013,"Block 3013, Block Group 3, Census Tract 2515, Solano County, California",8,7,1
1000000US060952515003014,060952515003014,"Block 3014, Block Group 3, Census Tract 2515, Solano County, California",16,16,0
1000000US060952515003015,060952515003015,"Block 3015, Block Group 3, Census Tract 2515, Solano County, California",36,31,5
1000000US060952515003016,060952515003016,"Block 3016, Block Group 3, Census Tract 2515, Solano County, California",11,9,2
1000000US060952515003017,060952515003017,"Block 3017, Block Group 3, Census Tract 2515, Solano County, California",14,10,4
1000000US060952515003018,060952515003018,"Block 3018, Block Group 3, Census Tract 2515, Solano County, California",10,10,0
1000000US060952515003019,060952515003019,"Block 3019, Block Group 3, Census Tract 2515, Solano County, California",22,17,5
1000000US060952515003020,060952515003020,"Block 3020, Block Group 3, Census Tract 2515, Solano County, California",16,16,0
1000000US060952515003021,060952515003021,"Block 3021, Block Group 3, Census Tract 2515, Solano County, California",12,11,1
1000000US060952515003022,060952515003022,"Block 3022, Block Group 3, Census Tract 2515, Solano County, California",25,16,9
1000000US060952515003023,060952515003023,"Block 3023, Block Group 3, Census Tract 2515, Solano County, California",15,14,1
1000000US060952515003024,060952515003024,"Block 3024, Block Group 3, Census Tract 2515, Solano County, California",15,12,3
1000000US060952515003025,060952515003025,"Block 3025, Block Group 3, Census Tract 2515, Solano County, California",9,8,1
1000000US060952515003026,060952515003026,"Block 3026, Block Group 3, Census Tract 2515, Solano County, California",15,14,1
1000000US060952515003027,060952515003027,"Block 3027, Block Group 3, Census Tract 2515, Solano County, California",13,12,1
1000000US060952515003028,060952515003028,"Block 3028, Block Group 3, Census Tract 2515, Solano County, California",16,13,3
1000000US060952515003029,060952515003029,"Block 3029, Block Group 3, Census Tract 2515, Solano County, California",13,12,1
1000000US060952515003030,060952515003030,"Block 3030, Block Group 3, Census Tract 2515, Solano County, California",13,12,1
1000000US060952515003031,060952515003031,"Block 3031, Block Group 3, Census Tract 2515, Solano County, California",30,25,5
1000000US060952515003032,060952515003032,"Block 3032, Block Group 3, Census Tract 2515, Solano County, California",17,14,3
1000000US060952515003033,060952515003033,"Block 3033, Block Group 3, Census Tract 2515, Solano County, California",11,9,2
1000000US060952515003034,060952515003034,"Block 3034, Block Group 3, Census Tract 2515, Solano County, California",14,11,3
1000000US060952515003035,060952515003035,"Block 3035, Block Group 3, Census Tract 2515, Solano County, California",23,21,2
1000000US060952515003036,060952515003036,"Block 3036, Block Group 3, Census Tract 2515, Solano County, California",16,15,1
1000000US060952515003037,060952515003037,"Block 3037, Block Group 3, Census Tract 2515, Solano County, California",19,17,2
1000000US060952515003038,060952515003038,"Block 3038, Block Group 3, Census Tract 2515, Solano County, California",15,10,5
1000000US060952515003039,060952515003039,"Block 3039, Block Group 3, Census Tract 2515, Solano County, California",9,8,1
1000000US060952515003040,060952515003040,"Block 3040, Block Group 3, Census Tract 2515, Solano County, California",12,12,0
1000000US060952516001000,060952516001000,"Block 1000, Block Group 1, Census Tract 2516, Solano County, California",0,0,0
1000000US060952516001001,060952516001001,"Block 1001, Block Group 1, Census Tract 2516, Solano County, California",5,5,0
1000000US060952516001002,060952516001002,"Block 1002, Block Group 1, Census Tract 2516, Solano County, California",20,17,3
1000000US060952516001003,060952516001003,"Block 1003, Block Group 1, Census Tract 2516, Solano County, California",15,11,4
1000000US060952516001004,060952516001004,"Block 1004, Block Group 1, Census Tract 2516, Solano County, California",19,14,5
1000000US060952516001005,060952516001005,"Block 1005, Block Group 1, Census Tract 2516, Solano County, California",19,13,6
1000000US060952516001006,060952516001006,"Block 1006, Block Group 1, Census Tract 2516, Solano County, California",53,49,4
1000000US060952516001007,060952516001007,"Block 1007, Block Group 1, Census Tract 2516, Solano County, California",14,13,1
1000000US060952516001008,060952516001008,"Block 1008, Block Group 1, Census Tract 2516, Solano County, California",14,12,2
1000000US060952516001009,060952516001009,"Block 1009, Block Group 1, Census Tract 2516, Solano County, California",15,14,1
1000000US060952516001010,060952516001010,"Block 1010, Block Group 1, Census Tract 2516, Solano County, California",10,9,1
1000000US060952516001011,060952516001011,"Block 1011, Block Group 1, Census Tract 2516, Solano County, California",14,12,2
1000000US060952516001012,060952516001012,"Block 1012, Block Group 1, Census Tract 2516, Solano County, California",13,13,0
1000000US060952516001013,060952516001013,"Block 1013, Block Group 1, Census Tract 2516, Solano County, California",16,13,3
1000000US060952516001014,060952516001014,"Block 1014, Block Group 1, Census Tract 2516, Solano County, California",7,6,1
1000000US060952516001015,060952516001015,"Block 1015, Block Group 1, Census Tract 2516, Solano County, California",5,4,1
1000000US060952516001016,060952516001016,"Block 1016, Block Group 1, Census Tract 2516, Solano County, California",0,0,0
1000000US060952516001017,060952516001017,"Block 1017, Block Group 1, Census Tract 2516, Solano County, California",19,15,4
1000000US060952516001018,060952516001018,"Block 1018, Block Group 1, Census Tract 2516, Solano County, California",6,5,1
1000000US060952516001019,060952516001019,"Block 1019, Block Group 1, Census Tract 2516, Solano County, California",0,0,0
1000000US060952516001020,060952516001020,"Block 1020, Block Group 1, Census Tract 2516, Solano County, California",7,7,0
1000000US060952516001021,060952516001021,"Block 1021, Block Group 1, Census Tract 2516, Solano County, California",1,1,0
1000000US060952516001022,060952516001022,"Block 1022, Block Group 1, Census Tract 2516, Solano County, California",18,15,3
1000000US060952516001023,060952516001023,"Block 1023, Block Group 1, Census Tract 2516, Solano County, California",13,12,1
1000000US060952516001024,060952516001024,"Block 1024, Block Group 1, Census Tract 2516, Solano County, California",19,16,3
1000000US060952516001025,060952516001025,"Block 1025, Block Group 1, Census Tract 2516, Solano County, California",8,7,1
1000000US060952516001026,060952516001026,"Block 1026, Block Group 1, Census Tract 2516, Solano County, California",9,7,2
1000000US060952516001027,060952516001027,"Block 1027, Block Group 1, Census Tract 2516, Solano County, California",0,0,0
1000000US060952516001028,060952516001028,"Block 1028, Block Group 1, Census Tract 2516, Solano County, California",3,3,0
1000000US060952516001029,060952516001029,"Block 1029, Block Group 1, Census Tract 2516, Solano County, California",17,15,2
1000000US060952516002000,060952516002000,"Block 2000, Block Group 2, Census Tract 2516, Solano County, California",15,12,3
1000000US060952516002001,060952516002001,"Block 2001, Block Group 2, Census Tract 2516, Solano County, California",0,0,0
1000000US060952516002002,060952516002002,"Block 2002, Block Group 2, Census Tract 2516, Solano County, California",20,18,2
1000000US060952516002003,060952516002003,"Block 2003, Block Group 2, Census Tract 2516, Solano County, California",18,16,2
1000000US060952516002004,060952516002004,"Block 2004, Block Group 2, Census Tract 2516, Solano County, California",17,16,1
1000000US060952516002005,060952516002005,"Block 2005, Block Group 2, Census Tract 2516, Solano County, California",28,23,5
1000000US060952516002006,060952516002006,"Block 2006, Block Group 2, Census Tract 2516, Solano County, California",0,0,0
1000000US060952516002007,060952516002007,"Block 2007, Block Group 2, Census Tract 2516, Solano County, California",0,0,0
1000000US060952516002008,060952516002008,"Block 2008, Block Group 2, Census Tract 2516, Solano County, California",0,0,0
1000000US060952516002009,060952516002009,"Block 2009, Block Group 2, Census Tract 2516, Solano County, California",0,0,0
1000000US060952516002010,060952516002010,"Block 2010, Block Group 2, Census Tract 2516, Solano County, California",0,0,0
1000000US060952516002011,060952516002011,"Block 2011, Block Group 2, Census Tract 2516, Solano County, California",0,0,0
1000000US060952516002012,060952516002012,"Block 2012, Block Group 2, Census Tract 2516, Solano County, California",10,10,0
1000000US060952516002013,060952516002013,"Block 2013, Block Group 2, Census Tract 2516, Solano County, California",0,0,0
1000000US060952516002014,060952516002014,"Block 2014, Block Group 2, Census Tract 2516, Solano County, California",0,0,0
1000000US060952516002015,060952516002015,"Block 2015, Block Group 2, Census Tract 2516, Solano County, California",0,0,0
1000000US060952516002016,060952516002016,"Block 2016, Block Group 2, Census Tract 2516, Solano County, California",0,0,0
1000000US060952516002017,060952516002017,"Block 2017, Block Group 2, Census Tract 2516, Solano County, California",0,0,0
1000000US060952516002018,060952516002018,"Block 2018, Block Group 2, Census Tract 2516, Solano County, California",18,13,5
1000000US060952516002019,060952516002019,"Block 2019, Block Group 2, Census Tract 2516, Solano County, California",13,12,1
1000000US060952516002020,060952516002020,"Block 2020, Block Group 2, Census Tract 2516, Solano County, California",13,9,4
1000000US060952516002021,060952516002021,"Block 2021, Block Group 2, Census Tract 2516, Solano County, California",20,18,2
1000000US060952516002022,060952516002022,"Block 2022, Block Group 2, Census Tract 2516, Solano County, California",22,21,1
1000000US060952516002023,060952516002023,"Block 2023, Block Group 2, Census Tract 2516, Solano County, California",17,14,3
1000000US060952516002024,060952516002024,"Block 2024, Block Group 2, Census Tract 2516, Solano County, California",26,21,5
1000000US060952516002025,060952516002025,"Block 2025, Block Group 2, Census Tract 2516, Solano County, California",17,15,2
1000000US060952516002026,060952516002026,"Block 2026, Block Group 2, Census Tract 2516, Solano County, California",22,21,1
1000000US060952516002027,060952516002027,"Block 2027, Block Group 2, Census Tract 2516, Solano County, California",19,18,1
1000000US060952516002028,060952516002028,"Block 2028, Block Group 2, Census Tract 2516, Solano County, California",17,10,7
1000000US060952516002029,060952516002029,"Block 2029, Block Group 2, Census Tract 2516, Solano County, California",0,0,0
1000000US060952516002030,060952516002030,"Block 2030, Block Group 2, Census Tract 2516, Solano County, California",15,7,8
1000000US060952516002031,060952516002031,"Block 2031, Block Group 2, Census Tract 2516, Solano County, California",5,4,1
1000000US060952516002032,060952516002032,"Block 2032, Block Group 2, Census Tract 2516, Solano County, California",17,16,1
1000000US060952516002033,060952516002033,"Block 2033, Block Group 2, Census Tract 2516, Solano County, California",20,19,1
1000000US060952516002034,060952516002034,"Block 2034, Block Group 2, Census Tract 2516, Solano County, California",13,10,3
1000000US060952516002035,060952516002035,"Block 2035, Block Group 2, Census Tract 2516, Solano County, California",7,7,0
1000000US060952516002036,060952516002036,"Block 2036, Block Group 2, Census Tract 2516, Solano County, California",9,5,4
1000000US060952516002037,060952516002037,"Block 2037, Block Group 2, Census Tract 2516, Solano County, California",16,15,1
1000000US060952516002038,060952516002038,"Block 2038, Block Group 2, Census Tract 2516, Solano County, California",16,16,0
1000000US060952516002039,060952516002039,"Block 2039, Block Group 2, Census Tract 2516, Solano County, California",19,19,0
1000000US060952516002040,060952516002040,"Block 2040, Block Group 2, Census Tract 2516, Solano County, California",11,11,0
1000000US060952516002041,060952516002041,"Block 2041, Block Group 2, Census Tract 2516, Solano County, California",21,18,3
1000000US060952516002042,060952516002042,"Block 2042, Block Group 2, Census Tract 2516, Solano County, California",17,16,1
1000000US060952516002043,060952516002043,"Block 2043, Block Group 2, Census Tract 2516, Solano County, California",14,12,2
1000000US060952516002044,060952516002044,"Block 2044, Block Group 2, Census Tract 2516, Solano County, California",21,16,5
1000000US060952516002045,060952516002045,"Block 2045, Block Group 2, Census Tract 2516, Solano County, California",24,21,3
1000000US060952516002046,060952516002046,"Block 2046, Block Group 2, Census Tract 2516, Solano County, California",19,14,5
1000000US060952516002047,060952516002047,"Block 2047, Block Group 2, Census Tract 2516, Solano County, California",20,17,3
1000000US060952516002048,060952516002048,"Block 2048, Block Group 2, Census Tract 2516, Solano County, California",15,10,5
1000000US060952516002049,060952516002049,"Block 2049, Block Group 2, Census Tract 2516, Solano County, California",16,12,4
1000000US060952516002050,060952516002050,"Block 2050, Block Group 2, Census Tract 2516, Solano County, California",19,18,1
1000000US060952516002051,060952516002051,"Block 2051, Block Group 2, Census Tract 2516, Solano County, California",25,18,7
1000000US060952516002052,060952516002052,"Block 2052, Block Group 2, Census Tract 2516, Solano County, California",15,13,2
1000000US060952516002053,060952516002053,"Block 2053, Block Group 2, Census Tract 2516, Solano County, California",1,1,0
1000000US060952516002054,060952516002054,"Block 2054, Block Group 2, Census Tract 2516, Solano County, California",15,12,3
1000000US060952516002055,060952516002055,"Block 2055, Block Group 2, Census Tract 2516, Solano County, California",17,12,5
1000000US060952516002056,060952516002056,"Block 2056, Block Group 2, Census Tract 2516, Solano County, California",25,21,4
1000000US060952516002057,060952516002057,"Block 2057, Block Group 2, Census Tract 2516, Solano County, California",20,19,1
1000000US060952516002058,060952516002058,"Block 2058, Block Group 2, Census Tract 2516, Solano County, California",23,22,1
1000000US060952516002059,060952516002059,"Block 2059, Block Group 2, Census Tract 2516, Solano County, California",24,20,4
1000000US060952517011000,060952517011000,"Block 1000, Block Group 1, Census Tract 2517.01, Solano County, California",46,42,4
1000000US060952517011001,060952517011001,"Block 1001, Block Group 1, Census Tract 2517.01, Solano County, California",25,22,3
1000000US060952517011002,060952517011002,"Block 1002, Block Group 1, Census Tract 2517.01, Solano County, California",108,100,8
1000000US060952517011003,060952517011003,"Block 1003, Block Group 1, Census Tract 2517.01, Solano County, California",14,14,0
1000000US060952517011004,060952517011004,"Block 1004, Block Group 1, Census Tract 2517.01, Solano County, California",24,22,2
1000000US060952517011005,060952517011005,"Block 1005, Block Group 1, Census Tract 2517.01, Solano County, California",39,31,8
1000000US060952517011006,060952517011006,"Block 1006, Block Group 1, Census Tract 2517.01, Solano County, California",42,38,4
1000000US060952517011007,060952517011007,"Block 1007, Block Group 1, Census Tract 2517.01, Solano County, California",38,34,4
1000000US060952517011008,060952517011008,"Block 1008, Block Group 1, Census Tract 2517.01, Solano County, California",12,12,0
1000000US060952517011009,060952517011009,"Block 1009, Block Group 1, Census Tract 2517.01, Solano County, California",17,15,2
1000000US060952517011010,060952517011010,"Block 1010, Block Group 1, Census Tract 2517.01, Solano County, California",35,30,5
1000000US060952517011011,060952517011011,"Block 1011, Block Group 1, Census Tract 2517.01, Solano County, California",45,35,10
1000000US060952517011012,060952517011012,"Block 1012, Block Group 1, Census Tract 2517.01, Solano County, California",16,10,6
1000000US060952517011013,060952517011013,"Block 1013, Block Group 1, Census Tract 2517.01, Solano County, California",21,20,1
1000000US060952517011014,060952517011014,"Block 1014, Block Group 1, Census Tract 2517.01, Solano County, California",0,0,0
1000000US060952517011015,060952517011015,"Block 1015, Block Group 1, Census Tract 2517.01, Solano County, California",6,6,0
1000000US060952517011016,060952517011016,"Block 1016, Block Group 1, Census Tract 2517.01, Solano County, California",23,21,2
1000000US060952517011017,060952517011017,"Block 1017, Block Group 1, Census Tract 2517.01, Solano County, California",120,105,15
1000000US060952517011018,060952517011018,"Block 1018, Block Group 1, Census Tract 2517.01, Solano County, California",0,0,0
1000000US060952517011019,060952517011019,"Block 1019, Block Group 1, Census Tract 2517.01, Solano County, California",0,0,0
1000000US060952517011020,060952517011020,"Block 1020, Block Group 1, Census Tract 2517.01, Solano County, California",40,31,9
1000000US060952517011021,060952517011021,"Block 1021, Block Group 1, Census Tract 2517.01, Solano County, California",3,3,0
1000000US060952517011022,060952517011022,"Block 1022, Block Group 1, Census Tract 2517.01, Solano County, California",9,8,1
1000000US060952517011023,060952517011023,"Block 1023, Block Group 1, Census Tract 2517.01, Solano County, California",26,23,3
1000000US060952517011024,060952517011024,"Block 1024, Block Group 1, Census Tract 2517.01, Solano County, California",0,0,0
1000000US060952517011025,060952517011025,"Block 1025, Block Group 1, Census Tract 2517.01, Solano County, California",0,0,0
1000000US060952517011026,060952517011026,"Block 1026, Block Group 1, Census Tract 2517.01, Solano County, California",0,0,0
1000000US060952517012000,060952517012000,"Block 2000, Block Group 2, Census Tract 2517.01, Solano County, California",206,175,31
1000000US060952517012001,060952517012001,"Block 2001, Block Group 2, Census Tract 2517.01, Solano County, California",0,0,0
1000000US060952517012002,060952517012002,"Block 2002, Block Group 2, Census Tract 2517.01, Solano County, California",0,0,0
1000000US060952517012003,060952517012003,"Block 2003, Block Group 2, Census Tract 2517.01, Solano County, California",0,0,0
1000000US060952517012004,060952517012004,"Block 2004, Block Group 2, Census Tract 2517.01, Solano County, California",0,0,0
1000000US060952517012005,060952517012005,"Block 2005, Block Group 2, Census Tract 2517.01, Solano County, California",0,0,0
1000000US060952517012006,060952517012006,"Block 2006, Block Group 2, Census Tract 2517.01, Solano County, California",0,0,0
1000000US060952517012007,060952517012007,"Block 2007, Block Group 2, Census Tract 2517.01, Solano County, California",0,0,0
1000000US060952517012008,060952517012008,"Block 2008, Block Group 2, Census Tract 2517.01, Solano County, California",16,15,1
1000000US060952517012009,060952517012009,"Block 2009, Block Group 2, Census Tract 2517.01, Solano County, California",13,12,1
1000000US060952517012010,060952517012010,"Block 2010, Block Group 2, Census Tract 2517.01, Solano County, California",26,24,2
1000000US060952517012011,060952517012011,"Block 2011, Block Group 2, Census Tract 2517.01, Solano County, California",25,24,1
1000000US060952517012012,060952517012012,"Block 2012, Block Group 2, Census Tract 2517.01, Solano County, California",33,30,3
1000000US060952517012013,060952517012013,"Block 2013, Block Group 2, Census Tract 2517.01, Solano County, California",56,48,8
1000000US060952517012014,060952517012014,"Block 2014, Block Group 2, Census Tract 2517.01, Solano County, California",64,51,13
1000000US060952517012015,060952517012015,"Block 2015, Block Group 2, Census Tract 2517.01, Solano County, California",0,0,0
1000000US060952517012016,060952517012016,"Block 2016, Block Group 2, Census Tract 2517.01, Solano County, California",0,0,0
1000000US060952517012017,060952517012017,"Block 2017, Block Group 2, Census Tract 2517.01, Solano County, California",4,4,0
1000000US060952517012018,060952517012018,"Block 2018, Block Group 2, Census Tract 2517.01, Solano County, California",0,0,0
1000000US060952517012019,060952517012019,"Block 2019, Block Group 2, Census Tract 2517.01, Solano County, California",0,0,0
1000000US060952517012020,060952517012020,"Block 2020, Block Group 2, Census Tract 2517.01, Solano County, California",0,0,0
1000000US060952517012021,060952517012021,"Block 2021, Block Group 2, Census Tract 2517.01, Solano County, California",0,0,0
1000000US060952517012022,060952517012022,"Block 2022, Block Group 2, Census Tract 2517.01, Solano County, California",1,1,0
1000000US060952517012023,060952517012023,"Block 2023, Block Group 2, Census Tract 2517.01, Solano County, California",112,99,13
1000000US060952517012024,060952517012024,"Block 2024, Block Group 2, Census Tract 2517.01, Solano County, California",29,24,5
1000000US060952517012025,060952517012025,"Block 2025, Block Group 2, Census Tract 2517.01, Solano County, California",19,14,5
1000000US060952517012026,060952517012026,"Block 2026, Block Group 2, Census Tract 2517.01, Solano County, California",0,0,0
1000000US060952517012027,060952517012027,"Block 2027, Block Group 2, Census Tract 2517.01, Solano County, California",0,0,0
1000000US060952517012028,060952517012028,"Block 2028, Block Group 2, Census Tract 2517.01, Solano County, California",61,60,1
1000000US060952517012029,060952517012029,"Block 2029, Block Group 2, Census Tract 2517.01, Solano County, California",114,97,17
1000000US060952517012030,060952517012030,"Block 2030, Block Group 2, Census Tract 2517.01, Solano County, California",55,48,7
1000000US060952517012031,060952517012031,"Block 2031, Block Group 2, Census Tract 2517.01, Solano County, California",27,26,1
1000000US060952517021000,060952517021000,"Block 1000, Block Group 1, Census Tract 2517.02, Solano County, California",38,32,6
1000000US060952517021001,060952517021001,"Block 1001, Block Group 1, Census Tract 2517.02, Solano County, California",106,99,7
1000000US060952517021002,060952517021002,"Block 1002, Block Group 1, Census Tract 2517.02, Solano County, California",0,0,0
1000000US060952517021003,060952517021003,"Block 1003, Block Group 1, Census Tract 2517.02, Solano County, California",81,73,8
1000000US060952517021004,060952517021004,"Block 1004, Block Group 1, Census Tract 2517.02, Solano County, California",46,41,5
1000000US060952517021005,060952517021005,"Block 1005, Block Group 1, Census Tract 2517.02, Solano County, California",40,39,1
1000000US060952517021006,060952517021006,"Block 1006, Block Group 1, Census Tract 2517.02, Solano County, California",32,29,3
1000000US060952517021007,060952517021007,"Block 1007, Block Group 1, Census Tract 2517.02, Solano County, California",7,6,1
1000000US060952517021008,060952517021008,"Block 1008, Block Group 1, Census Tract 2517.02, Solano County, California",0,0,0
1000000US060952517021009,060952517021009,"Block 1009, Block Group 1, Census Tract 2517.02, Solano County, California",65,52,13
1000000US060952517021010,060952517021010,"Block 1010, Block Group 1, Census Tract 2517.02, Solano County, California",26,25,1
1000000US060952517021011,060952517021011,"Block 1011, Block Group 1, Census Tract 2517.02, Solano County, California",16,13,3
1000000US060952517022000,060952517022000,"Block 2000, Block Group 2, Census Tract 2517.02, Solano County, California",0,0,0
1000000US060952517022001,060952517022001,"Block 2001, Block Group 2, Census Tract 2517.02, Solano County, California",0,0,0
1000000US060952517022002,060952517022002,"Block 2002, Block Group 2, Census Tract 2517.02, Solano County, California",25,24,1
1000000US060952517022003,060952517022003,"Block 2003, Block Group 2, Census Tract 2517.02, Solano County, California",66,62,4
1000000US060952517022004,060952517022004,"Block 2004, Block Group 2, Census Tract 2517.02, Solano County, California",21,16,5
1000000US060952517022005,060952517022005,"Block 2005, Block Group 2, Census Tract 2517.02, Solano County, California",0,0,0
1000000US060952517022006,060952517022006,"Block 2006, Block Group 2, Census Tract 2517.02, Solano County, California",91,86,5
1000000US060952517022007,060952517022007,"Block 2007, Block Group 2, Census Tract 2517.02, Solano County, California",0,0,0
1000000US060952517022008,060952517022008,"Block 2008, Block Group 2, Census Tract 2517.02, Solano County, California",75,67,8
1000000US060952517022009,060952517022009,"Block 2009, Block Group 2, Census Tract 2517.02, Solano County, California",69,62,7
1000000US060952517022010,060952517022010,"Block 2010, Block Group 2, Census Tract 2517.02, Solano County, California",50,43,7
1000000US060952517022011,060952517022011,"Block 2011, Block Group 2, Census Tract 2517.02, Solano County, California",32,24,8
1000000US060952517022012,060952517022012,"Block 2012, Block Group 2, Census Tract 2517.02, Solano County, California",0,0,0
1000000US060952517022013,060952517022013,"Block 2013, Block Group 2, Census Tract 2517.02, Solano County, California",0,0,0
1000000US060952517022014,060952517022014,"Block 2014, Block Group 2, Census Tract 2517.02, Solano County, California",20,20,0
1000000US060952517022015,060952517022015,"Block 2015, Block Group 2, Census Tract 2517.02, Solano County, California",2,2,0
1000000US060952517022016,060952517022016,"Block 2016, Block Group 2, Census Tract 2517.02, Solano County, California",42,35,7
1000000US060952517022017,060952517022017,"Block 2017, Block Group 2, Census Tract 2517.02, Solano County, California",60,51,9
1000000US060952517022018,060952517022018,"Block 2018, Block Group 2, Census Tract 2517.02, Solano County, California",28,22,6
1000000US060952518021000,060952518021000,"Block 1000, Block Group 1, Census Tract 2518.02, Solano County, California",29,27,2
1000000US060952518021001,060952518021001,"Block 1001, Block Group 1, Census Tract 2518.02, Solano County, California",0,0,0
1000000US060952518021002,060952518021002,"Block 1002, Block Group 1, Census Tract 2518.02, Solano County, California",0,0,0
1000000US060952518021003,060952518021003,"Block 1003, Block Group 1, Census Tract 2518.02, Solano County, California",1,1,0
1000000US060952518021004,060952518021004,"Block 1004, Block Group 1, Census Tract 2518.02, Solano County, California",22,22,0
1000000US060952518021005,060952518021005,"Block 1005, Block Group 1, Census Tract 2518.02, Solano County, California",50,47,3
1000000US060952518021006,060952518021006,"Block 1006, Block Group 1, Census Tract 2518.02, Solano County, California",19,16,3
1000000US060952518021007,060952518021007,"Block 1007, Block Group 1, Census Tract 2518.02, Solano County, California",17,16,1
1000000US060952518021008,060952518021008,"Block 1008, Block Group 1, Census Tract 2518.02, Solano County, California",0,0,0
1000000US060952518021009,060952518021009,"Block 1009, Block Group 1, Census Tract 2518.02, Solano County, California",0,0,0
1000000US060952518021010,060952518021010,"Block 1010, Block Group 1, Census Tract 2518.02, Solano County, California",0,0,0
1000000US060952518021011,060952518021011,"Block 1011, Block Group 1, Census Tract 2518.02, Solano County, California",0,0,0
1000000US060952518021012,060952518021012,"Block 1012, Block Group 1, Census Tract 2518.02, Solano County, California",0,0,0
1000000US060952518021013,060952518021013,"Block 1013, Block Group 1, Census Tract 2518.02, Solano County, California",2,2,0
1000000US060952518021014,060952518021014,"Block 1014, Block Group 1, Census Tract 2518.02, Solano County, California",89,85,4
1000000US060952518021015,060952518021015,"Block 1015, Block Group 1, Census Tract 2518.02, Solano County, California",14,14,0
1000000US060952518021016,060952518021016,"Block 1016, Block Group 1, Census Tract 2518.02, Solano County, California",18,17,1
1000000US060952518021017,060952518021017,"Block 1017, Block Group 1, Census Tract 2518.02, Solano County, California",18,16,2
1000000US060952518021018,060952518021018,"Block 1018, Block Group 1, Census Tract 2518.02, Solano County, California",22,18,4
1000000US060952518021019,060952518021019,"Block 1019, Block Group 1, Census Tract 2518.02, Solano County, California",15,15,0
1000000US060952518021020,060952518021020,"Block 1020, Block Group 1, Census Tract 2518.02, Solano County, California",16,16,0
1000000US060952518021021,060952518021021,"Block 1021, Block Group 1, Census Tract 2518.02, Solano County, California",31,29,2
1000000US060952518021022,060952518021022,"Block 1022, Block Group 1, Census Tract 2518.02, Solano County, California",0,0,0
1000000US060952518021023,060952518021023,"Block 1023, Block Group 1, Census Tract 2518.02, Solano County, California",0,0,0
1000000US060952518021024,060952518021024,"Block 1024, Block Group 1, Census Tract 2518.02, Solano County, California",0,0,0
1000000US060952518021025,060952518021025,"Block 1025, Block Group 1, Census Tract 2518.02, Solano County, California",0,0,0
1000000US060952518021026,060952518021026,"Block 1026, Block Group 1, Census Tract 2518.02, Solano County, California",0,0,0
1000000US060952518021027,060952518021027,"Block 1027, Block Group 1, Census Tract 2518.02, Solano County, California",121,119,2
1000000US060952518021028,060952518021028,"Block 1028, Block Group 1, Census Tract 2518.02, Solano County, California",3,3,0
1000000US060952518021029,060952518021029,"Block 1029, Block Group 1, Census Tract 2518.02, Solano County, California",0,0,0
1000000US060952518021030,060952518021030,"Block 1030, Block Group 1, Census Tract 2518.02, Solano County, California",0,0,0
1000000US060952518021031,060952518021031,"Block 1031, Block Group 1, Census Tract 2518.02, Solano County, California",0,0,0
1000000US060952518021032,060952518021032,"Block 1032, Block Group 1, Census Tract 2518.02, Solano County, California",0,0,0
1000000US060952518021033,060952518021033,"Block 1033, Block Group 1, Census Tract 2518.02, Solano County, California",0,0,0
1000000US060952518021034,060952518021034,"Block 1034, Block Group 1, Census Tract 2518.02, Solano County, California",0,0,0
1000000US060952518021035,060952518021035,"Block 1035, Block Group 1, Census Tract 2518.02, Solano County, California",0,0,0
1000000US060952518021036,060952518021036,"Block 1036, Block Group 1, Census Tract 2518.02, Solano County, California",0,0,0
1000000US060952518021037,060952518021037,"Block 1037, Block Group 1, Census Tract 2518.02, Solano County, California",130,123,7
1000000US060952518021038,060952518021038,"Block 1038, Block Group 1, Census Tract 2518.02, Solano County, California",0,0,0
1000000US060952518021039,060952518021039,"Block 1039, Block Group 1, Census Tract 2518.02, Solano County, California",0,0,0
1000000US060952518021040,060952518021040,"Block 1040, Block Group 1, Census Tract 2518.02, Solano County, California",0,0,0
1000000US060952518021041,060952518021041,"Block 1041, Block Group 1, Census Tract 2518.02, Solano County, California",0,0,0
1000000US060952518021042,060952518021042,"Block 1042, Block Group 1, Census Tract 2518.02, Solano County, California",0,0,0
1000000US060952518021043,060952518021043,"Block 1043, Block Group 1, Census Tract 2518.02, Solano County, California",0,0,0
1000000US060952518021044,060952518021044,"Block 1044, Block Group 1, Census Tract 2518.02, Solano County, California",0,0,0
1000000US060952518021045,060952518021045,"Block 1045, Block Group 1, Census Tract 2518.02, Solano County, California",0,0,0
1000000US060952518021046,060952518021046,"Block 1046, Block Group 1, Census Tract 2518.02, Solano County, California",0,0,0
1000000US060952518021047,060952518021047,"Block 1047, Block Group 1, Census Tract 2518.02, Solano County, California",0,0,0
1000000US060952518021048,060952518021048,"Block 1048, Block Group 1, Census Tract 2518.02, Solano County, California",0,0,0
1000000US060952518021049,060952518021049,"Block 1049, Block Group 1, Census Tract 2518.02, Solano County, California",0,0,0
1000000US060952518021050,060952518021050,"Block 1050, Block Group 1, Census Tract 2518.02, Solano County, California",8,8,0
1000000US060952518021051,060952518021051,"Block 1051, Block Group 1, Census Tract 2518.02, Solano County, California",0,0,0
1000000US060952518021052,060952518021052,"Block 1052, Block Group 1, Census Tract 2518.02, Solano County, California",0,0,0
1000000US060952518021053,060952518021053,"Block 1053, Block Group 1, Census Tract 2518.02, Solano County, California",16,13,3
1000000US060952518021054,060952518021054,"Block 1054, Block Group 1, Census Tract 2518.02, Solano County, California",0,0,0
1000000US060952518021055,060952518021055,"Block 1055, Block Group 1, Census Tract 2518.02, Solano County, California",4,4,0
1000000US060952518021056,060952518021056,"Block 1056, Block Group 1, Census Tract 2518.02, Solano County, California",0,0,0
1000000US060952518021057,060952518021057,"Block 1057, Block Group 1, Census Tract 2518.02, Solano County, California",0,0,0
1000000US060952518021058,060952518021058,"Block 1058, Block Group 1, Census Tract 2518.02, Solano County, California",0,0,0
1000000US060952518021059,060952518021059,"Block 1059, Block Group 1, Census Tract 2518.02, Solano County, California",0,0,0
1000000US060952518021060,060952518021060,"Block 1060, Block Group 1, Census Tract 2518.02, Solano County, California",0,0,0
1000000US060952518021061,060952518021061,"Block 1061, Block Group 1, Census Tract 2518.02, Solano County, California",1,1,0
1000000US060952518021062,060952518021062,"Block 1062, Block Group 1, Census Tract 2518.02, Solano County, California",0,0,0
1000000US060952518021063,060952518021063,"Block 1063, Block Group 1, Census Tract 2518.02, Solano County, California",492,449,43
1000000US060952518021064,060952518021064,"Block 1064, Block Group 1, Census Tract 2518.02, Solano County, California",0,0,0
1000000US060952518021065,060952518021065,"Block 1065, Block Group 1, Census Tract 2518.02, Solano County, California",23,20,3
1000000US060952518021066,060952518021066,"Block 1066, Block Group 1, Census Tract 2518.02, Solano County, California",10,9,1
1000000US060952518021067,060952518021067,"Block 1067, Block Group 1, Census Tract 2518.02, Solano County, California",5,5,0
1000000US060952518021068,060952518021068,"Block 1068, Block Group 1, Census Tract 2518.02, Solano County, California",28,27,1
1000000US060952518021069,060952518021069,"Block 1069, Block Group 1, Census Tract 2518.02, Solano County, California",15,14,1
1000000US060952518021070,060952518021070,"Block 1070, Block Group 1, Census Tract 2518.02, Solano County, California",0,0,0
1000000US060952518021071,060952518021071,"Block 1071, Block Group 1, Census Tract 2518.02, Solano County, California",8,8,0
1000000US060952518021072,060952518021072,"Block 1072, Block Group 1, Census Tract 2518.02, Solano County, California",16,16,0
1000000US060952518021073,060952518021073,"Block 1073, Block Group 1, Census Tract 2518.02, Solano County, California",0,0,0
1000000US060952518021074,060952518021074,"Block 1074, Block Group 1, Census Tract 2518.02, Solano County, California",0,0,0
1000000US060952518021075,060952518021075,"Block 1075, Block Group 1, Census Tract 2518.02, Solano County, California",15,14,1
1000000US060952518021076,060952518021076,"Block 1076, Block Group 1, Census Tract 2518.02, Solano County, California",0,0,0
1000000US060952518021077,060952518021077,"Block 1077, Block Group 1, Census Tract 2518.02, Solano County, California",50,49,1
1000000US060952518031000,060952518031000,"Block 1000, Block Group 1, Census Tract 2518.03, Solano County, California",0,0,0
1000000US060952518031001,060952518031001,"Block 1001, Block Group 1, Census Tract 2518.03, Solano County, California",0,0,0
1000000US060952518031002,060952518031002,"Block 1002, Block Group 1, Census Tract 2518.03, Solano County, California",0,0,0
1000000US060952518031003,060952518031003,"Block 1003, Block Group 1, Census Tract 2518.03, Solano County, California",0,0,0
1000000US060952518031004,060952518031004,"Block 1004, Block Group 1, Census Tract 2518.03, Solano County, California",0,0,0
1000000US060952518031005,060952518031005,"Block 1005, Block Group 1, Census Tract 2518.03, Solano County, California",0,0,0
1000000US060952518031006,060952518031006,"Block 1006, Block Group 1, Census Tract 2518.03, Solano County, California",0,0,0
1000000US060952518031007,060952518031007,"Block 1007, Block Group 1, Census Tract 2518.03, Solano County, California",2,2,0
1000000US060952518031008,060952518031008,"Block 1008, Block Group 1, Census Tract 2518.03, Solano County, California",0,0,0
1000000US060952518031009,060952518031009,"Block 1009, Block Group 1, Census Tract 2518.03, Solano County, California",0,0,0
1000000US060952518031010,060952518031010,"Block 1010, Block Group 1, Census Tract 2518.03, Solano County, California",0,0,0
1000000US060952518031011,060952518031011,"Block 1011, Block Group 1, Census Tract 2518.03, Solano County, California",0,0,0
1000000US060952518031012,060952518031012,"Block 1012, Block Group 1, Census Tract 2518.03, Solano County, California",0,0,0
1000000US060952518031013,060952518031013,"Block 1013, Block Group 1, Census Tract 2518.03, Solano County, California",0,0,0
1000000US060952518031014,060952518031014,"Block 1014, Block Group 1, Census Tract 2518.03, Solano County, California",96,91,5
1000000US060952518031015,060952518031015,"Block 1015, Block Group 1, Census Tract 2518.03, Solano County, California",0,0,0
1000000US060952518031016,060952518031016,"Block 1016, Block Group 1, Census Tract 2518.03, Solano County, California",17,17,0
1000000US060952518031017,060952518031017,"Block 1017, Block Group 1, Census Tract 2518.03, Solano County, California",0,0,0
1000000US060952518031018,060952518031018,"Block 1018, Block Group 1, Census Tract 2518.03, Solano County, California",22,19,3
1000000US060952518031019,060952518031019,"Block 1019, Block Group 1, Census Tract 2518.03, Solano County, California",0,0,0
1000000US060952518031020,060952518031020,"Block 1020, Block Group 1, Census Tract 2518.03, Solano County, California",31,29,2
1000000US060952518031021,060952518031021,"Block 1021, Block Group 1, Census Tract 2518.03, Solano County, California",45,42,3
1000000US060952518031022,060952518031022,"Block 1022, Block Group 1, Census Tract 2518.03, Solano County, California",0,0,0
1000000US060952518031023,060952518031023,"Block 1023, Block Group 1, Census Tract 2518.03, Solano County, California",0,0,0
1000000US060952518031024,060952518031024,"Block 1024, Block Group 1, Census Tract 2518.03, Solano County, California",0,0,0
1000000US060952518031025,060952518031025,"Block 1025, Block Group 1, Census Tract 2518.03, Solano County, California",0,0,0
1000000US060952518031026,060952518031026,"Block 1026, Block Group 1, Census Tract 2518.03, Solano County, California",0,0,0
1000000US060952518031027,060952518031027,"Block 1027, Block Group 1, Census Tract 2518.03, Solano County, California",0,0,0
1000000US060952518031028,060952518031028,"Block 1028, Block Group 1, Census Tract 2518.03, Solano County, California",0,0,0
1000000US060952518031029,060952518031029,"Block 1029, Block Group 1, Census Tract 2518.03, Solano County, California",0,0,0
1000000US060952518031030,060952518031030,"Block 1030, Block Group 1, Census Tract 2518.03, Solano County, California",0,0,0
1000000US060952518031031,060952518031031,"Block 1031, Block Group 1, Census Tract 2518.03, Solano County, California",0,0,0
1000000US060952518031032,060952518031032,"Block 1032, Block Group 1, Census Tract 2518.03, Solano County, California",0,0,0
1000000US060952518031033,060952518031033,"Block 1033, Block Group 1, Census Tract 2518.03, Solano County, California",0,0,0
1000000US060952518031034,060952518031034,"Block 1034, Block Group 1, Census Tract 2518.03, Solano County, California",0,0,0
1000000US060952518031035,060952518031035,"Block 1035, Block Group 1, Census Tract 2518.03, Solano County, California",0,0,0
1000000US060952518031036,060952518031036,"Block 1036, Block Group 1, Census Tract 2518.03, Solano County, California",0,0,0
1000000US060952518031037,060952518031037,"Block 1037, Block Group 1, Census Tract 2518.03, Solano County, California",0,0,0
1000000US060952518031038,060952518031038,"Block 1038, Block Group 1, Census Tract 2518.03, Solano County, California",0,0,0
1000000US060952518031039,060952518031039,"Block 1039, Block Group 1, Census Tract 2518.03, Solano County, California",0,0,0
1000000US060952518031040,060952518031040,"Block 1040, Block Group 1, Census Tract 2518.03, Solano County, California",0,0,0
1000000US060952518031041,060952518031041,"Block 1041, Block Group 1, Census Tract 2518.03, Solano County, California",0,0,0
1000000US060952518031042,060952518031042,"Block 1042, Block Group 1, Census Tract 2518.03, Solano County, California",0,0,0
1000000US060952518031043,060952518031043,"Block 1043, Block Group 1, Census Tract 2518.03, Solano County, California",0,0,0
1000000US060952518031044,060952518031044,"Block 1044, Block Group 1, Census Tract 2518.03, Solano County, California",0,0,0
1000000US060952518031045,060952518031045,"Block 1045, Block Group 1, Census Tract 2518.03, Solano County, California",25,24,1
1000000US060952518031046,060952518031046,"Block 1046, Block Group 1, Census Tract 2518.03, Solano County, California",25,22,3
1000000US060952518032000,060952518032000,"Block 2000, Block Group 2, Census Tract 2518.03, Solano County, California",0,0,0
1000000US060952518032001,060952518032001,"Block 2001, Block Group 2, Census Tract 2518.03, Solano County, California",13,13,0
1000000US060952518032002,060952518032002,"Block 2002, Block Group 2, Census Tract 2518.03, Solano County, California",26,25,1
1000000US060952518032003,060952518032003,"Block 2003, Block Group 2, Census Tract 2518.03, Solano County, California",23,22,1
1000000US060952518032004,060952518032004,"Block 2004, Block Group 2, Census Tract 2518.03, Solano County, California",20,19,1
1000000US060952518032005,060952518032005,"Block 2005, Block Group 2, Census Tract 2518.03, Solano County, California",17,16,1
1000000US060952518032006,060952518032006,"Block 2006, Block Group 2, Census Tract 2518.03, Solano County, California",24,23,1
1000000US060952518032007,060952518032007,"Block 2007, Block Group 2, Census Tract 2518.03, Solano County, California",20,18,2
1000000US060952518032008,060952518032008,"Block 2008, Block Group 2, Census Tract 2518.03, Solano County, California",26,25,1
1000000US060952518032009,060952518032009,"Block 2009, Block Group 2, Census Tract 2518.03, Solano County, California",63,58,5
1000000US060952518032010,060952518032010,"Block 2010, Block Group 2, Census Tract 2518.03, Solano County, California",23,21,2
1000000US060952518032011,060952518032011,"Block 2011, Block Group 2, Census Tract 2518.03, Solano County, California",22,21,1
1000000US060952518032012,060952518032012,"Block 2012, Block Group 2, Census Tract 2518.03, Solano County, California",28,22,6
1000000US060952518032013,060952518032013,"Block 2013, Block Group 2, Census Tract 2518.03, Solano County, California",17,17,0
1000000US060952518032014,060952518032014,"Block 2014, Block Group 2, Census Tract 2518.03, Solano County, California",51,47,4
1000000US060952518032015,060952518032015,"Block 2015, Block Group 2, Census Tract 2518.03, Solano County, California",9,8,1
1000000US060952518032016,060952518032016,"Block 2016, Block Group 2, Census Tract 2518.03, Solano County, California",25,21,4
1000000US060952518032017,060952518032017,"Block 2017, Block Group 2, Census Tract 2518.03, Solano County, California",48,45,3
1000000US060952518033000,060952518033000,"Block 3000, Block Group 3, Census Tract 2518.03, Solano County, California",10,9,1
1000000US060952518033001,060952518033001,"Block 3001, Block Group 3, Census Tract 2518.03, Solano County, California",20,19,1
1000000US060952518033002,060952518033002,"Block 3002, Block Group 3, Census Tract 2518.03, Solano County, California",29,28,1
1000000US060952518033003,060952518033003,"Block 3003, Block Group 3, Census Tract 2518.03, Solano County, California",30,27,3
1000000US060952518033004,060952518033004,"Block 3004, Block Group 3, Census Tract 2518.03, Solano County, California",19,18,1
1000000US060952518033005,060952518033005,"Block 3005, Block Group 3, Census Tract 2518.03, Solano County, California",39,38,1
1000000US060952518033006,060952518033006,"Block 3006, Block Group 3, Census Tract 2518.03, Solano County, California",46,40,6
1000000US060952518033007,060952518033007,"Block 3007, Block Group 3, Census Tract 2518.03, Solano County, California",34,29,5
1000000US060952518033008,060952518033008,"Block 3008, Block Group 3, Census Tract 2518.03, Solano County, California",13,12,1
1000000US060952518033009,060952518033009,"Block 3009, Block Group 3, Census Tract 2518.03, Solano County, California",26,25,1
1000000US060952518033010,060952518033010,"Block 3010, Block Group 3, Census Tract 2518.03, Solano County, California",76,73,3
1000000US060952518033011,060952518033011,"Block 3011, Block Group 3, Census Tract 2518.03, Solano County, California",16,16,0
1000000US060952518034000,060952518034000,"Block 4000, Block Group 4, Census Tract 2518.03, Solano County, California",16,15,1
1000000US060952518034001,060952518034001,"Block 4001, Block Group 4, Census Tract 2518.03, Solano County, California",30,27,3
1000000US060952518034002,060952518034002,"Block 4002, Block Group 4, Census Tract 2518.03, Solano County, California",88,82,6
1000000US060952518034003,060952518034003,"Block 4003, Block Group 4, Census Tract 2518.03, Solano County, California",31,29,2
1000000US060952518034004,060952518034004,"Block 4004, Block Group 4, Census Tract 2518.03, Solano County, California",115,106,9
1000000US060952518034005,060952518034005,"Block 4005, Block Group 4, Census Tract 2518.03, Solano County, California",14,13,1
1000000US060952518034006,060952518034006,"Block 4006, Block Group 4, Census Tract 2518.03, Solano County, California",21,21,0
1000000US060952518034007,060952518034007,"Block 4007, Block Group 4, Census Tract 2518.03, Solano County, California",55,50,5
1000000US060952518034008,060952518034008,"Block 4008, Block Group 4, Census Tract 2518.03, Solano County, California",10,9,1
1000000US060952518034009,060952518034009,"Block 4009, Block Group 4, Census Tract 2518.03, Solano County, California",17,16,1
1000000US060952518041000,060952518041000,"Block 1000, Block Group 1, Census Tract 2518.04, Solano County, California",25,21,4
1000000US060952518041001,060952518041001,"Block 1001, Block Group 1, Census Tract 2518.04, Solano County, California",0,0,0
1000000US060952518041002,060952518041002,"Block 1002, Block Group 1, Census Tract 2518.04, Solano County, California",10,10,0
1000000US060952518041003,060952518041003,"Block 1003, Block Group 1, Census Tract 2518.04, Solano County, California",22,22,0
1000000US060952518041004,060952518041004,"Block 1004, Block Group 1, Census Tract 2518.04, Solano County, California",104,100,4
1000000US060952518041005,060952518041005,"Block 1005, Block Group 1, Census Tract 2518.04, Solano County, California",11,11,0
1000000US060952518041006,060952518041006,"Block 1006, Block Group 1, Census Tract 2518.04, Solano County, California",14,13,1
1000000US060952518041007,060952518041007,"Block 1007, Block Group 1, Census Tract 2518.04, Solano County, California",0,0,0
1000000US060952518041008,060952518041008,"Block 1008, Block Group 1, Census Tract 2518.04, Solano County, California",0,0,0
1000000US060952518041009,060952518041009,"Block 1009, Block Group 1, Census Tract 2518.04, Solano County, California",13,12,1
1000000US060952518041010,060952518041010,"Block 1010, Block Group 1, Census Tract 2518.04, Solano County, California",30,28,2
1000000US060952518041011,060952518041011,"Block 1011, Block Group 1, Census Tract 2518.04, Solano County, California",82,76,6
1000000US060952518041012,060952518041012,"Block 1012, Block Group 1, Census Tract 2518.04, Solano County, California",14,14,0
1000000US060952518041013,060952518041013,"Block 1013, Block Group 1, Census Tract 2518.04, Solano County, California",15,14,1
1000000US060952518041014,060952518041014,"Block 1014, Block Group 1, Census Tract 2518.04, Solano County, California",8,7,1
1000000US060952518042000,060952518042000,"Block 2000, Block Group 2, Census Tract 2518.04, Solano County, California",83,80,3
1000000US060952518042001,060952518042001,"Block 2001, Block Group 2, Census Tract 2518.04, Solano County, California",0,0,0
1000000US060952518042002,060952518042002,"Block 2002, Block Group 2, Census Tract 2518.04, Solano County, California",87,82,5
1000000US060952518042003,060952518042003,"Block 2003, Block Group 2, Census Tract 2518.04, Solano County, California",11,11,0
1000000US060952518042004,060952518042004,"Block 2004, Block Group 2, Census Tract 2518.04, Solano County, California",13,12,1
1000000US060952518042005,060952518042005,"Block 2005, Block Group 2, Census Tract 2518.04, Solano County, California",7,6,1
1000000US060952518042006,060952518042006,"Block 2006, Block Group 2, Census Tract 2518.04, Solano County, California",47,42,5
1000000US060952518042007,060952518042007,"Block 2007, Block Group 2, Census Tract 2518.04, Solano County, California",23,19,4
1000000US060952518042008,060952518042008,"Block 2008, Block Group 2, Census Tract 2518.04, Solano County, California",18,17,1
1000000US060952518042009,060952518042009,"Block 2009, Block Group 2, Census Tract 2518.04, Solano County, California",21,18,3
1000000US060952518042010,060952518042010,"Block 2010, Block Group 2, Census Tract 2518.04, Solano County, California",22,22,0
1000000US060952518043000,060952518043000,"Block 3000, Block Group 3, Census Tract 2518.04, Solano County, California",113,106,7
1000000US060952518043001,060952518043001,"Block 3001, Block Group 3, Census Tract 2518.04, Solano County, California",39,38,1
1000000US060952518043002,060952518043002,"Block 3002, Block Group 3, Census Tract 2518.04, Solano County, California",66,57,9
1000000US060952518043003,060952518043003,"Block 3003, Block Group 3, Census Tract 2518.04, Solano County, California",0,0,0
1000000US060952518043004,060952518043004,"Block 3004, Block Group 3, Census Tract 2518.04, Solano County, California",91,86,5
1000000US060952518043005,060952518043005,"Block 3005, Block Group 3, Census Tract 2518.04, Solano County, California",12,12,0
1000000US060952518043006,060952518043006,"Block 3006, Block Group 3, Census Tract 2518.04, Solano County, California",47,42,5
1000000US060952518043007,060952518043007,"Block 3007, Block Group 3, Census Tract 2518.04, Solano County, California",0,0,0
1000000US060952518043008,060952518043008,"Block 3008, Block Group 3, Census Tract 2518.04, Solano County, California",0,0,0
1000000US060952518043009,060952518043009,"Block 3009, Block Group 3, Census Tract 2518.04, Solano County, California",0,0,0
1000000US060952518043010,060952518043010,"Block 3010, Block Group 3, Census Tract 2518.04, Solano County, California",0,0,0
1000000US060952519011000,060952519011000,"Block 1000, Block Group 1, Census Tract 2519.01, Solano County, California",0,0,0
1000000US060952519011001,060952519011001,"Block 1001, Block Group 1, Census Tract 2519.01, Solano County, California",0,0,0
1000000US060952519011002,060952519011002,"Block 1002, Block Group 1, Census Tract 2519.01, Solano County, California",0,0,0
1000000US060952519011003,060952519011003,"Block 1003, Block Group 1, Census Tract 2519.01, Solano County, California",0,0,0
1000000US060952519011004,060952519011004,"Block 1004, Block Group 1, Census Tract 2519.01, Solano County, California",0,0,0
1000000US060952519011005,060952519011005,"Block 1005, Block Group 1, Census Tract 2519.01, Solano County, California",0,0,0
1000000US060952519011006,060952519011006,"Block 1006, Block Group 1, Census Tract 2519.01, Solano County, California",0,0,0
1000000US060952519011007,060952519011007,"Block 1007, Block Group 1, Census Tract 2519.01, Solano County, California",0,0,0
1000000US060952519011008,060952519011008,"Block 1008, Block Group 1, Census Tract 2519.01, Solano County, California",0,0,0
1000000US060952519011009,060952519011009,"Block 1009, Block Group 1, Census Tract 2519.01, Solano County, California",0,0,0
1000000US060952519011010,060952519011010,"Block 1010, Block Group 1, Census Tract 2519.01, Solano County, California",0,0,0
1000000US060952519011011,060952519011011,"Block 1011, Block Group 1, Census Tract 2519.01, Solano County, California",0,0,0
1000000US060952519011012,060952519011012,"Block 1012, Block Group 1, Census Tract 2519.01, Solano County, California",351,322,29
1000000US060952519011013,060952519011013,"Block 1013, Block Group 1, Census Tract 2519.01, Solano County, California",0,0,0
1000000US060952519011014,060952519011014,"Block 1014, Block Group 1, Census Tract 2519.01, Solano County, California",0,0,0
1000000US060952519011015,060952519011015,"Block 1015, Block Group 1, Census Tract 2519.01, Solano County, California",0,0,0
1000000US060952519011016,060952519011016,"Block 1016, Block Group 1, Census Tract 2519.01, Solano County, California",0,0,0
1000000US060952519011017,060952519011017,"Block 1017, Block Group 1, Census Tract 2519.01, Solano County, California",130,113,17
1000000US060952519011018,060952519011018,"Block 1018, Block Group 1, Census Tract 2519.01, Solano County, California",25,23,2
1000000US060952519011019,060952519011019,"Block 1019, Block Group 1, Census Tract 2519.01, Solano County, California",51,49,2
1000000US060952519011020,060952519011020,"Block 1020, Block Group 1, Census Tract 2519.01, Solano County, California",11,10,1
1000000US060952519011021,060952519011021,"Block 1021, Block Group 1, Census Tract 2519.01, Solano County, California",14,12,2
1000000US060952519011022,060952519011022,"Block 1022, Block Group 1, Census Tract 2519.01, Solano County, California",0,0,0
1000000US060952519011023,060952519011023,"Block 1023, Block Group 1, Census Tract 2519.01, Solano County, California",27,26,1
1000000US060952519011024,060952519011024,"Block 1024, Block Group 1, Census Tract 2519.01, Solano County, California",0,0,0
1000000US060952519011025,060952519011025,"Block 1025, Block Group 1, Census Tract 2519.01, Solano County, California",19,19,0
1000000US060952519011026,060952519011026,"Block 1026, Block Group 1, Census Tract 2519.01, Solano County, California",15,13,2
1000000US060952519011027,060952519011027,"Block 1027, Block Group 1, Census Tract 2519.01, Solano County, California",20,17,3
1000000US060952519011028,060952519011028,"Block 1028, Block Group 1, Census Tract 2519.01, Solano County, California",37,30,7
1000000US060952519011029,060952519011029,"Block 1029, Block Group 1, Census Tract 2519.01, Solano County, California",37,33,4
1000000US060952519011030,060952519011030,"Block 1030, Block Group 1, Census Tract 2519.01, Solano County, California",0,0,0
1000000US060952519011031,060952519011031,"Block 1031, Block Group 1, Census Tract 2519.01, Solano County, California",0,0,0
1000000US060952519011032,060952519011032,"Block 1032, Block Group 1, Census Tract 2519.01, Solano County, California",0,0,0
1000000US060952519011033,060952519011033,"Block 1033, Block Group 1, Census Tract 2519.01, Solano County, California",0,0,0
1000000US060952519011034,060952519011034,"Block 1034, Block Group 1, Census Tract 2519.01, Solano County, California",0,0,0
1000000US060952519011035,060952519011035,"Block 1035, Block Group 1, Census Tract 2519.01, Solano County, California",6,6,0
1000000US060952519011036,060952519011036,"Block 1036, Block Group 1, Census Tract 2519.01, Solano County, California",0,0,0
1000000US060952519011037,060952519011037,"Block 1037, Block Group 1, Census Tract 2519.01, Solano County, California",0,0,0
1000000US060952519011038,060952519011038,"Block 1038, Block Group 1, Census Tract 2519.01, Solano County, California",0,0,0
1000000US060952519011039,060952519011039,"Block 1039, Block Group 1, Census Tract 2519.01, Solano County, California",0,0,0
1000000US060952519011040,060952519011040,"Block 1040, Block Group 1, Census Tract 2519.01, Solano County, California",0,0,0
1000000US060952519011041,060952519011041,"Block 1041, Block Group 1, Census Tract 2519.01, Solano County, California",0,0,0
1000000US060952519011042,060952519011042,"Block 1042, Block Group 1, Census Tract 2519.01, Solano County, California",0,0,0
1000000US060952519012000,060952519012000,"Block 2000, Block Group 2, Census Tract 2519.01, Solano County, California",0,0,0
1000000US060952519012001,060952519012001,"Block 2001, Block Group 2, Census Tract 2519.01, Solano County, California",65,62,3
1000000US060952519012002,060952519012002,"Block 2002, Block Group 2, Census Tract 2519.01, Solano County, California",0,0,0
1000000US060952519012003,060952519012003,"Block 2003, Block Group 2, Census Tract 2519.01, Solano County, California",17,16,1
1000000US060952519012004,060952519012004,"Block 2004, Block Group 2, Census Tract 2519.01, Solano County, California",0,0,0
1000000US060952519012005,060952519012005,"Block 2005, Block Group 2, Census Tract 2519.01, Solano County, California",9,9,0
1000000US060952519012006,060952519012006,"Block 2006, Block Group 2, Census Tract 2519.01, Solano County, California",0,0,0
1000000US060952519012007,060952519012007,"Block 2007, Block Group 2, Census Tract 2519.01, Solano County, California",23,21,2
1000000US060952519012008,060952519012008,"Block 2008, Block Group 2, Census Tract 2519.01, Solano County, California",0,0,0
1000000US060952519012009,060952519012009,"Block 2009, Block Group 2, Census Tract 2519.01, Solano County, California",0,0,0
1000000US060952519012010,060952519012010,"Block 2010, Block Group 2, Census Tract 2519.01, Solano County, California",92,85,7
1000000US060952519012011,060952519012011,"Block 2011, Block Group 2, Census Tract 2519.01, Solano County, California",153,136,17
1000000US060952519012012,060952519012012,"Block 2012, Block Group 2, Census Tract 2519.01, Solano County, California",10,8,2
1000000US060952519013000,060952519013000,"Block 3000, Block Group 3, Census Tract 2519.01, Solano County, California",59,58,1
1000000US060952519013001,060952519013001,"Block 3001, Block Group 3, Census Tract 2519.01, Solano County, California",22,21,1
1000000US060952519013002,060952519013002,"Block 3002, Block Group 3, Census Tract 2519.01, Solano County, California",29,27,2
1000000US060952519013003,060952519013003,"Block 3003, Block Group 3, Census Tract 2519.01, Solano County, California",153,135,18
1000000US060952519013004,060952519013004,"Block 3004, Block Group 3, Census Tract 2519.01, Solano County, California",21,19,2
1000000US060952519013005,060952519013005,"Block 3005, Block Group 3, Census Tract 2519.01, Solano County, California",144,131,13
1000000US060952519013006,060952519013006,"Block 3006, Block Group 3, Census Tract 2519.01, Solano County, California",13,12,1
1000000US060952519013007,060952519013007,"Block 3007, Block Group 3, Census Tract 2519.01, Solano County, California",44,38,6
1000000US060952519013008,060952519013008,"Block 3008, Block Group 3, Census Tract 2519.01, Solano County, California",26,24,2
1000000US060952519013009,060952519013009,"Block 3009, Block Group 3, Census Tract 2519.01, Solano County, California",23,22,1
1000000US060952519013010,060952519013010,"Block 3010, Block Group 3, Census Tract 2519.01, Solano County, California",40,38,2
1000000US060952519013011,060952519013011,"Block 3011, Block Group 3, Census Tract 2519.01, Solano County, California",189,151,38
1000000US060952519013012,060952519013012,"Block 3012, Block Group 3, Census Tract 2519.01, Solano County, California",16,16,0
1000000US060952519013013,060952519013013,"Block 3013, Block Group 3, Census Tract 2519.01, Solano County, California",18,18,0
1000000US060952519021000,060952519021000,"Block 1000, Block Group 1, Census Tract 2519.02, Solano County, California",25,24,1
1000000US060952519021001,060952519021001,"Block 1001, Block Group 1, Census Tract 2519.02, Solano County, California",16,14,2
1000000US060952519021002,060952519021002,"Block 1002, Block Group 1, Census Tract 2519.02, Solano County, California",148,136,12
1000000US060952519021003,060952519021003,"Block 1003, Block Group 1, Census Tract 2519.02, Solano County, California",16,16,0
1000000US060952519021004,060952519021004,"Block 1004, Block Group 1, Census Tract 2519.02, Solano County, California",10,10,0
1000000US060952519021005,060952519021005,"Block 1005, Block Group 1, Census Tract 2519.02, Solano County, California",13,13,0
1000000US060952519021006,060952519021006,"Block 1006, Block Group 1, Census Tract 2519.02, Solano County, California",0,0,0
1000000US060952519021007,060952519021007,"Block 1007, Block Group 1, Census Tract 2519.02, Solano County, California",33,30,3
1000000US060952519021008,060952519021008,"Block 1008, Block Group 1, Census Tract 2519.02, Solano County, California",27,25,2
1000000US060952519021009,060952519021009,"Block 1009, Block Group 1, Census Tract 2519.02, Solano County, California",14,13,1
1000000US060952519021010,060952519021010,"Block 1010, Block Group 1, Census Tract 2519.02, Solano County, California",48,45,3
1000000US060952519022000,060952519022000,"Block 2000, Block Group 2, Census Tract 2519.02, Solano County, California",51,46,5
1000000US060952519022001,060952519022001,"Block 2001, Block Group 2, Census Tract 2519.02, Solano County, California",47,43,4
1000000US060952519022002,060952519022002,"Block 2002, Block Group 2, Census Tract 2519.02, Solano County, California",31,28,3
1000000US060952519022003,060952519022003,"Block 2003, Block Group 2, Census Tract 2519.02, Solano County, California",23,22,1
1000000US060952519022004,060952519022004,"Block 2004, Block Group 2, Census Tract 2519.02, Solano County, California",70,66,4
1000000US060952519022005,060952519022005,"Block 2005, Block Group 2, Census Tract 2519.02, Solano County, California",32,31,1
1000000US060952519022006,060952519022006,"Block 2006, Block Group 2, Census Tract 2519.02, Solano County, California",59,55,4
1000000US060952519022007,060952519022007,"Block 2007, Block Group 2, Census Tract 2519.02, Solano County, California",26,25,1
1000000US060952519022008,060952519022008,"Block 2008, Block Group 2, Census Tract 2519.02, Solano County, California",1,1,0
1000000US060952519022009,060952519022009,"Block 2009, Block Group 2, Census Tract 2519.02, Solano County, California",112,98,14
1000000US060952519022010,060952519022010,"Block 2010, Block Group 2, Census Tract 2519.02, Solano County, California",30,28,2
1000000US060952519022011,060952519022011,"Block 2011, Block Group 2, Census Tract 2519.02, Solano County, California",37,35,2
1000000US060952519022012,060952519022012,"Block 2012, Block Group 2, Census Tract 2519.02, Solano County, California",27,26,1
1000000US060952519022013,060952519022013,"Block 2013, Block Group 2, Census Tract 2519.02, Solano County, California",0,0,0
1000000US060952519023000,060952519023000,"Block 3000, Block Group 3, Census Tract 2519.02, Solano County, California",0,0,0
1000000US060952519023001,060952519023001,"Block 3001, Block Group 3, Census Tract 2519.02, Solano County, California",0,0,0
1000000US060952519023002,060952519023002,"Block 3002, Block Group 3, Census Tract 2519.02, Solano County, California",46,43,3
1000000US060952519023003,060952519023003,"Block 3003, Block Group 3, Census Tract 2519.02, Solano County, California",1,1,0
1000000US060952519023004,060952519023004,"Block 3004, Block Group 3, Census Tract 2519.02, Solano County, California",0,0,0
1000000US060952519023005,060952519023005,"Block 3005, Block Group 3, Census Tract 2519.02, Solano County, California",0,0,0
1000000US060952519023006,060952519023006,"Block 3006, Block Group 3, Census Tract 2519.02, Solano County, California",16,16,0
1000000US060952519023007,060952519023007,"Block 3007, Block Group 3, Census Tract 2519.02, Solano County, California",11,9,2
1000000US060952519023008,060952519023008,"Block 3008, Block Group 3, Census Tract 2519.02, Solano County, California",31,31,0
1000000US060952519023009,060952519023009,"Block 3009, Block Group 3, Census Tract 2519.02, Solano County, California",36,33,3
1000000US060952519023010,060952519023010,"Block 3010, Block Group 3, Census Tract 2519.02, Solano County, California",47,45,2
1000000US060952519023011,060952519023011,"Block 3011, Block Group 3, Census Tract 2519.02, Solano County, California",36,33,3
1000000US060952519023012,060952519023012,"Block 3012, Block Group 3, Census Tract 2519.02, Solano County, California",26,21,5
1000000US060952519024000,060952519024000,"Block 4000, Block Group 4, Census Tract 2519.02, Solano County, California",98,90,8
1000000US060952519024001,060952519024001,"Block 4001, Block Group 4, Census Tract 2519.02, Solano County, California",44,42,2
1000000US060952519024002,060952519024002,"Block 4002, Block Group 4, Census Tract 2519.02, Solano County, California",30,29,1
1000000US060952519024003,060952519024003,"Block 4003, Block Group 4, Census Tract 2519.02, Solano County, California",22,19,3
1000000US060952519024004,060952519024004,"Block 4004, Block Group 4, Census Tract 2519.02, Solano County, California",48,42,6
1000000US060952519024005,060952519024005,"Block 4005, Block Group 4, Census Tract 2519.02, Solano County, California",18,16,2
1000000US060952519024006,060952519024006,"Block 4006, Block Group 4, Census Tract 2519.02, Solano County, California",51,45,6
1000000US060952519024007,060952519024007,"Block 4007, Block Group 4, Census Tract 2519.02, Solano County, California",37,35,2
1000000US060952519024008,060952519024008,"Block 4008, Block Group 4, Census Tract 2519.02, Solano County, California",37,35,2
1000000US060952519024009,060952519024009,"Block 4009, Block Group 4, Census Tract 2519.02, Solano County, California",26,23,3
1000000US060952519024010,060952519024010,"Block 4010, Block Group 4, Census Tract 2519.02, Solano County, California",15,15,0
1000000US060952519024011,060952519024011,"Block 4011, Block Group 4, Census Tract 2519.02, Solano County, California",18,15,3
1000000US060952519024012,060952519024012,"Block 4012, Block Group 4, Census Tract 2519.02, Solano County, California",26,25,1
1000000US060952519024013,060952519024013,"Block 4013, Block Group 4, Census Tract 2519.02, Solano County, California",21,20,1
1000000US060952519024014,060952519024014,"Block 4014, Block Group 4, Census Tract 2519.02, Solano County, California",24,21,3
1000000US060952519024015,060952519024015,"Block 4015, Block Group 4, Census Tract 2519.02, Solano County, California",31,29,2
1000000US060952519024016,060952519024016,"Block 4016, Block Group 4, Census Tract 2519.02, Solano County, California",0,0,0
1000000US060952519024017,060952519024017,"Block 4017, Block Group 4, Census Tract 2519.02, Solano County, California",0,0,0
1000000US060952519024018,060952519024018,"Block 4018, Block Group 4, Census Tract 2519.02, Solano County, California",17,17,0
1000000US060952519031000,060952519031000,"Block 1000, Block Group 1, Census Tract 2519.03, Solano County, California",0,0,0
1000000US060952519031001,060952519031001,"Block 1001, Block Group 1, Census Tract 2519.03, Solano County, California",0,0,0
1000000US060952519031002,060952519031002,"Block 1002, Block Group 1, Census Tract 2519.03, Solano County, California",0,0,0
1000000US060952519031003,060952519031003,"Block 1003, Block Group 1, Census Tract 2519.03, Solano County, California",179,173,6
1000000US060952519031004,060952519031004,"Block 1004, Block Group 1, Census Tract 2519.03, Solano County, California",0,0,0
1000000US060952519031005,060952519031005,"Block 1005, Block Group 1, Census Tract 2519.03, Solano County, California",11,11,0
1000000US060952519031006,060952519031006,"Block 1006, Block Group 1, Census Tract 2519.03, Solano County, California",14,14,0
1000000US060952519031007,060952519031007,"Block 1007, Block Group 1, Census Tract 2519.03, Solano County, California",0,0,0
1000000US060952519031008,060952519031008,"Block 1008, Block Group 1, Census Tract 2519.03, Solano County, California",5,4,1
1000000US060952519031009,060952519031009,"Block 1009, Block Group 1, Census Tract 2519.03, Solano County, California",18,18,0
1000000US060952519031010,060952519031010,"Block 1010, Block Group 1, Census Tract 2519.03, Solano County, California",2,2,0
1000000US060952519031011,060952519031011,"Block 1011, Block Group 1, Census Tract 2519.03, Solano County, California",15,15,0
1000000US060952519031012,060952519031012,"Block 1012, Block Group 1, Census Tract 2519.03, Solano County, California",34,31,3
1000000US060952519031013,060952519031013,"Block 1013, Block Group 1, Census Tract 2519.03, Solano County, California",26,25,1
1000000US060952519031014,060952519031014,"Block 1014, Block Group 1, Census Tract 2519.03, Solano County, California",44,42,2
1000000US060952519031015,060952519031015,"Block 1015, Block Group 1, Census Tract 2519.03, Solano County, California",0,0,0
1000000US060952519032000,060952519032000,"Block 2000, Block Group 2, Census Tract 2519.03, Solano County, California",115,91,24
1000000US060952519032001,060952519032001,"Block 2001, Block Group 2, Census Tract 2519.03, Solano County, California",14,13,1
1000000US060952519032002,060952519032002,"Block 2002, Block Group 2, Census Tract 2519.03, Solano County, California",27,25,2
1000000US060952519032003,060952519032003,"Block 2003, Block Group 2, Census Tract 2519.03, Solano County, California",33,30,3
1000000US060952519032004,060952519032004,"Block 2004, Block Group 2, Census Tract 2519.03, Solano County, California",18,17,1
1000000US060952519032005,060952519032005,"Block 2005, Block Group 2, Census Tract 2519.03, Solano County, California",22,17,5
1000000US060952519032006,060952519032006,"Block 2006, Block Group 2, Census Tract 2519.03, Solano County, California",21,18,3
1000000US060952519032007,060952519032007,"Block 2007, Block Group 2, Census Tract 2519.03, Solano County, California",37,35,2
1000000US060952519032008,060952519032008,"Block 2008, Block Group 2, Census Tract 2519.03, Solano County, California",11,9,2
1000000US060952519032009,060952519032009,"Block 2009, Block Group 2, Census Tract 2519.03, Solano County, California",46,46,0
1000000US060952519032010,060952519032010,"Block 2010, Block Group 2, Census Tract 2519.03, Solano County, California",47,43,4
1000000US060952519032011,060952519032011,"Block 2011, Block Group 2, Census Tract 2519.03, Solano County, California",42,40,2
1000000US060952519032012,060952519032012,"Block 2012, Block Group 2, Census Tract 2519.03, Solano County, California",23,20,3
1000000US060952519032013,060952519032013,"Block 2013, Block Group 2, Census Tract 2519.03, Solano County, California",13,13,0
1000000US060952519032014,060952519032014,"Block 2014, Block Group 2, Census Tract 2519.03, Solano County, California",24,24,0
1000000US060952519032015,060952519032015,"Block 2015, Block Group 2, Census Tract 2519.03, Solano County, California",16,16,0
1000000US060952519032016,060952519032016,"Block 2016, Block Group 2, Census Tract 2519.03, Solano County, California",0,0,0
1000000US060952519032017,060952519032017,"Block 2017, Block Group 2, Census Tract 2519.03, Solano County, California",9,9,0
1000000US060952519032018,060952519032018,"Block 2018, Block Group 2, Census Tract 2519.03, Solano County, California",15,14,1
1000000US060952519032019,060952519032019,"Block 2019, Block Group 2, Census Tract 2519.03, Solano County, California",15,13,2
1000000US060952519032020,060952519032020,"Block 2020, Block Group 2, Census Tract 2519.03, Solano County, California",28,24,4
1000000US060952519032021,060952519032021,"Block 2021, Block Group 2, Census Tract 2519.03, Solano County, California",23,17,6
1000000US060952519032022,060952519032022,"Block 2022, Block Group 2, Census Tract 2519.03, Solano County, California",22,19,3
1000000US060952519033000,060952519033000,"Block 3000, Block Group 3, Census Tract 2519.03, Solano County, California",63,57,6
1000000US060952519033001,060952519033001,"Block 3001, Block Group 3, Census Tract 2519.03, Solano County, California",79,75,4
1000000US060952519033002,060952519033002,"Block 3002, Block Group 3, Census Tract 2519.03, Solano County, California",19,19,0
1000000US060952519033003,060952519033003,"Block 3003, Block Group 3, Census Tract 2519.03, Solano County, California",23,22,1
1000000US060952519033004,060952519033004,"Block 3004, Block Group 3, Census Tract 2519.03, Solano County, California",67,63,4
1000000US060952519033005,060952519033005,"Block 3005, Block Group 3, Census Tract 2519.03, Solano County, California",56,49,7
1000000US060952519033006,060952519033006,"Block 3006, Block Group 3, Census Tract 2519.03, Solano County, California",40,36,4
1000000US060952519033007,060952519033007,"Block 3007, Block Group 3, Census Tract 2519.03, Solano County, California",40,39,1
1000000US060952519033008,060952519033008,"Block 3008, Block Group 3, Census Tract 2519.03, Solano County, California",40,36,4
1000000US060952519033009,060952519033009,"Block 3009, Block Group 3, Census Tract 2519.03, Solano County, California",40,36,4
1000000US060952519033010,060952519033010,"Block 3010, Block Group 3, Census Tract 2519.03, Solano County, California",27,25,2
1000000US060952519033011,060952519033011,"Block 3011, Block Group 3, Census Tract 2519.03, Solano County, California",20,16,4
1000000US060952519033012,060952519033012,"Block 3012, Block Group 3, Census Tract 2519.03, Solano County, California",0,0,0
1000000US060952519033013,060952519033013,"Block 3013, Block Group 3, Census Tract 2519.03, Solano County, California",12,12,0
1000000US060952519033014,060952519033014,"Block 3014, Block Group 3, Census Tract 2519.03, Solano County, California",30,30,0
1000000US060952519033015,060952519033015,"Block 3015, Block Group 3, Census Tract 2519.03, Solano County, California",9,9,0
1000000US060952519033016,060952519033016,"Block 3016, Block Group 3, Census Tract 2519.03, Solano County, California",14,14,0
1000000US060952519033017,060952519033017,"Block 3017, Block Group 3, Census Tract 2519.03, Solano County, California",27,27,0
1000000US060952519033018,060952519033018,"Block 3018, Block Group 3, Census Tract 2519.03, Solano County, California",1,1,0
1000000US060952519033019,060952519033019,"Block 3019, Block Group 3, Census Tract 2519.03, Solano County, California",14,13,1
1000000US060952519033020,060952519033020,"Block 3020, Block Group 3, Census Tract 2519.03, Solano County, California",15,14,1
1000000US060952519033021,060952519033021,"Block 3021, Block Group 3, Census Tract 2519.03, Solano County, California",14,12,2
1000000US060952519033022,060952519033022,"Block 3022, Block Group 3, Census Tract 2519.03, Solano County, California",14,14,0
1000000US060952519033023,060952519033023,"Block 3023, Block Group 3, Census Tract 2519.03, Solano County, California",14,12,2
1000000US060952519033024,060952519033024,"Block 3024, Block Group 3, Census Tract 2519.03, Solano County, California",17,17,0
1000000US060952519033025,060952519033025,"Block 3025, Block Group 3, Census Tract 2519.03, Solano County, California",0,0,0
1000000US060952519033026,060952519033026,"Block 3026, Block Group 3, Census Tract 2519.03, Solano County, California",0,0,0
1000000US060952519033027,060952519033027,"Block 3027, Block Group 3, Census Tract 2519.03, Solano County, California",0,0,0
1000000US060952520001000,060952520001000,"Block 1000, Block Group 1, Census Tract 2520, Solano County, California",38,36,2
1000000US060952520001001,060952520001001,"Block 1001, Block Group 1, Census Tract 2520, Solano County, California",49,42,7
1000000US060952520001002,060952520001002,"Block 1002, Block Group 1, Census Tract 2520, Solano County, California",25,23,2
1000000US060952520001003,060952520001003,"Block 1003, Block Group 1, Census Tract 2520, Solano County, California",92,89,3
1000000US060952520001004,060952520001004,"Block 1004, Block Group 1, Census Tract 2520, Solano County, California",7,7,0
1000000US060952520001005,060952520001005,"Block 1005, Block Group 1, Census Tract 2520, Solano County, California",13,13,0
1000000US060952520001006,060952520001006,"Block 1006, Block Group 1, Census Tract 2520, Solano County, California",12,12,0
1000000US060952520001007,060952520001007,"Block 1007, Block Group 1, Census Tract 2520, Solano County, California",18,17,1
1000000US060952520001008,060952520001008,"Block 1008, Block Group 1, Census Tract 2520, Solano County, California",83,76,7
1000000US060952520001009,060952520001009,"Block 1009, Block Group 1, Census Tract 2520, Solano County, California",11,11,0
1000000US060952520001010,060952520001010,"Block 1010, Block Group 1, Census Tract 2520, Solano County, California",23,23,0
1000000US060952520001011,060952520001011,"Block 1011, Block Group 1, Census Tract 2520, Solano County, California",21,19,2
1000000US060952520001012,060952520001012,"Block 1012, Block Group 1, Census Tract 2520, Solano County, California",21,19,2
1000000US060952520001013,060952520001013,"Block 1013, Block Group 1, Census Tract 2520, Solano County, California",21,21,0
1000000US060952520001014,060952520001014,"Block 1014, Block Group 1, Census Tract 2520, Solano County, California",21,20,1
1000000US060952520001015,060952520001015,"Block 1015, Block Group 1, Census Tract 2520, Solano County, California",22,20,2
1000000US060952520001016,060952520001016,"Block 1016, Block Group 1, Census Tract 2520, Solano County, California",13,12,1
1000000US060952520001017,060952520001017,"Block 1017, Block Group 1, Census Tract 2520, Solano County, California",38,33,5
1000000US060952520001018,060952520001018,"Block 1018, Block Group 1, Census Tract 2520, Solano County, California",168,147,21
1000000US060952520001019,060952520001019,"Block 1019, Block Group 1, Census Tract 2520, Solano County, California",0,0,0
1000000US060952520001020,060952520001020,"Block 1020, Block Group 1, Census Tract 2520, Solano County, California",0,0,0
1000000US060952520001021,060952520001021,"Block 1021, Block Group 1, Census Tract 2520, Solano County, California",0,0,0
1000000US060952520001022,060952520001022,"Block 1022, Block Group 1, Census Tract 2520, Solano County, California",0,0,0
1000000US060952520001023,060952520001023,"Block 1023, Block Group 1, Census Tract 2520, Solano County, California",0,0,0
1000000US060952520001024,060952520001024,"Block 1024, Block Group 1, Census Tract 2520, Solano County, California",0,0,0
1000000US060952520001025,060952520001025,"Block 1025, Block Group 1, Census Tract 2520, Solano County, California",31,29,2
1000000US060952520001026,060952520001026,"Block 1026, Block Group 1, Census Tract 2520, Solano County, California",16,15,1
1000000US060952520001027,060952520001027,"Block 1027, Block Group 1, Census Tract 2520, Solano County, California",5,5,0
1000000US060952520002000,060952520002000,"Block 2000, Block Group 2, Census Tract 2520, Solano County, California",0,0,0
1000000US060952520002001,060952520002001,"Block 2001, Block Group 2, Census Tract 2520, Solano County, California",0,0,0
1000000US060952520002002,060952520002002,"Block 2002, Block Group 2, Census Tract 2520, Solano County, California",35,34,1
1000000US060952520002003,060952520002003,"Block 2003, Block Group 2, Census Tract 2520, Solano County, California",15,14,1
1000000US060952520002004,060952520002004,"Block 2004, Block Group 2, Census Tract 2520, Solano County, California",24,22,2
1000000US060952520002005,060952520002005,"Block 2005, Block Group 2, Census Tract 2520, Solano County, California",48,41,7
1000000US060952520002006,060952520002006,"Block 2006, Block Group 2, Census Tract 2520, Solano County, California",28,19,9
1000000US060952520002007,060952520002007,"Block 2007, Block Group 2, Census Tract 2520, Solano County, California",34,33,1
1000000US060952520002008,060952520002008,"Block 2008, Block Group 2, Census Tract 2520, Solano County, California",34,33,1
1000000US060952520002009,060952520002009,"Block 2009, Block Group 2, Census Tract 2520, Solano County, California",26,26,0
1000000US060952520002010,060952520002010,"Block 2010, Block Group 2, Census Tract 2520, Solano County, California",46,40,6
1000000US060952520002011,060952520002011,"Block 2011, Block Group 2, Census Tract 2520, Solano County, California",36,35,1
1000000US060952520002012,060952520002012,"Block 2012, Block Group 2, Census Tract 2520, Solano County, California",16,16,0
1000000US060952520002013,060952520002013,"Block 2013, Block Group 2, Census Tract 2520, Solano County, California",33,23,10
1000000US060952520002014,060952520002014,"Block 2014, Block Group 2, Census Tract 2520, Solano County, California",0,0,0
1000000US060952520002015,060952520002015,"Block 2015, Block Group 2, Census Tract 2520, Solano County, California",2,2,0
1000000US060952520002016,060952520002016,"Block 2016, Block Group 2, Census Tract 2520, Solano County, California",0,0,0
1000000US060952520002017,060952520002017,"Block 2017, Block Group 2, Census Tract 2520, Solano County, California",55,46,9
1000000US060952520002018,060952520002018,"Block 2018, Block Group 2, Census Tract 2520, Solano County, California",6,6,0
1000000US060952520002019,060952520002019,"Block 2019, Block Group 2, Census Tract 2520, Solano County, California",13,9,4
1000000US060952520002020,060952520002020,"Block 2020, Block Group 2, Census Tract 2520, Solano County, California",40,25,15
1000000US060952520003000,060952520003000,"Block 3000, Block Group 3, Census Tract 2520, Solano County, California",0,0,0
1000000US060952520003001,060952520003001,"Block 3001, Block Group 3, Census Tract 2520, Solano County, California",14,11,3
1000000US060952520003002,060952520003002,"Block 3002, Block Group 3, Census Tract 2520, Solano County, California",10,10,0
1000000US060952520003003,060952520003003,"Block 3003, Block Group 3, Census Tract 2520, Solano County, California",18,18,0
1000000US060952520003004,060952520003004,"Block 3004, Block Group 3, Census Tract 2520, Solano County, California",11,9,2
1000000US060952520003005,060952520003005,"Block 3005, Block Group 3, Census Tract 2520, Solano County, California",32,27,5
1000000US060952520003006,060952520003006,"Block 3006, Block Group 3, Census Tract 2520, Solano County, California",13,8,5
1000000US060952520003007,060952520003007,"Block 3007, Block Group 3, Census Tract 2520, Solano County, California",16,9,7
1000000US060952520003008,060952520003008,"Block 3008, Block Group 3, Census Tract 2520, Solano County, California",12,10,2
1000000US060952520003009,060952520003009,"Block 3009, Block Group 3, Census Tract 2520, Solano County, California",12,12,0
1000000US060952520003010,060952520003010,"Block 3010, Block Group 3, Census Tract 2520, Solano County, California",13,12,1
1000000US060952520003011,060952520003011,"Block 3011, Block Group 3, Census Tract 2520, Solano County, California",14,14,0
1000000US060952520003012,060952520003012,"Block 3012, Block Group 3, Census Tract 2520, Solano County, California",21,19,2
1000000US060952520003013,060952520003013,"Block 3013, Block Group 3, Census Tract 2520, Solano County, California",11,9,2
1000000US060952520003014,060952520003014,"Block 3014, Block Group 3, Census Tract 2520, Solano County, California",24,21,3
1000000US060952520003015,060952520003015,"Block 3015, Block Group 3, Census Tract 2520, Solano County, California",12,10,2
1000000US060952520003016,060952520003016,"Block 3016, Block Group 3, Census Tract 2520, Solano County, California",14,13,1
1000000US060952520003017,060952520003017,"Block 3017, Block Group 3, Census Tract 2520, Solano County, California",10,10,0
1000000US060952520003018,060952520003018,"Block 3018, Block Group 3, Census Tract 2520, Solano County, California",18,18,0
1000000US060952520003019,060952520003019,"Block 3019, Block Group 3, Census Tract 2520, Solano County, California",24,21,3
1000000US060952520003020,060952520003020,"Block 3020, Block Group 3, Census Tract 2520, Solano County, California",9,8,1
1000000US060952520003021,060952520003021,"Block 3021, Block Group 3, Census Tract 2520, Solano County, California",13,13,0
1000000US060952520003022,060952520003022,"Block 3022, Block Group 3, Census Tract 2520, Solano County, California",0,0,0
1000000US060952520003023,060952520003023,"Block 3023, Block Group 3, Census Tract 2520, Solano County, California",39,38,1
1000000US060952520003024,060952520003024,"Block 3024, Block Group 3, Census Tract 2520, Solano County, California",0,0,0
1000000US060952520003025,060952520003025,"Block 3025, Block Group 3, Census Tract 2520, Solano County, California",58,54,4
1000000US060952520003026,060952520003026,"Block 3026, Block Group 3, Census Tract 2520, Solano County, California",2,2,0
1000000US060952520003027,060952520003027,"Block 3027, Block Group 3, Census Tract 2520, Solano County, California",24,21,3
1000000US060952520003028,060952520003028,"Block 3028, Block Group 3, Census Tract 2520, Solano County, California",25,23,2
1000000US060952520004000,060952520004000,"Block 4000, Block Group 4, Census Tract 2520, Solano County, California",0,0,0
1000000US060952520004001,060952520004001,"Block 4001, Block Group 4, Census Tract 2520, Solano County, California",0,0,0
1000000US060952520004002,060952520004002,"Block 4002, Block Group 4, Census Tract 2520, Solano County, California",39,36,3
1000000US060952520004003,060952520004003,"Block 4003, Block Group 4, Census Tract 2520, Solano County, California",24,23,1
1000000US060952520004004,060952520004004,"Block 4004, Block Group 4, Census Tract 2520, Solano County, California",65,65,0
1000000US060952520004005,060952520004005,"Block 4005, Block Group 4, Census Tract 2520, Solano County, California",10,10,0
1000000US060952520004006,060952520004006,"Block 4006, Block Group 4, Census Tract 2520, Solano County, California",22,20,2
1000000US060952520004007,060952520004007,"Block 4007, Block Group 4, Census Tract 2520, Solano County, California",96,85,11
1000000US060952520004008,060952520004008,"Block 4008, Block Group 4, Census Tract 2520, Solano County, California",19,18,1
1000000US060952520004009,060952520004009,"Block 4009, Block Group 4, Census Tract 2520, Solano County, California",10,7,3
1000000US060952520004010,060952520004010,"Block 4010, Block Group 4, Census Tract 2520, Solano County, California",18,18,0
1000000US060952520004011,060952520004011,"Block 4011, Block Group 4, Census Tract 2520, Solano County, California",34,32,2
1000000US060952520004012,060952520004012,"Block 4012, Block Group 4, Census Tract 2520, Solano County, California",11,11,0
1000000US060952520004013,060952520004013,"Block 4013, Block Group 4, Census Tract 2520, Solano County, California",11,10,1
1000000US060952520004014,060952520004014,"Block 4014, Block Group 4, Census Tract 2520, Solano County, California",12,12,0
1000000US060952520004015,060952520004015,"Block 4015, Block Group 4, Census Tract 2520, Solano County, California",11,11,0
1000000US060952520004016,060952520004016,"Block 4016, Block Group 4, Census Tract 2520, Solano County, California",0,0,0
1000000US060952520004017,060952520004017,"Block 4017, Block Group 4, Census Tract 2520, Solano County, California",16,13,3
1000000US060952520004018,060952520004018,"Block 4018, Block Group 4, Census Tract 2520, Solano County, California",17,16,1
1000000US060952520004019,060952520004019,"Block 4019, Block Group 4, Census Tract 2520, Solano County, California",18,15,3
1000000US060952520004020,060952520004020,"Block 4020, Block Group 4, Census Tract 2520, Solano County, California",35,35,0
1000000US060952520004021,060952520004021,"Block 4021, Block Group 4, Census Tract 2520, Solano County, California",13,13,0
1000000US060952520004022,060952520004022,"Block 4022, Block Group 4, Census Tract 2520, Solano County, California",11,11,0
1000000US060952520004023,060952520004023,"Block 4023, Block Group 4, Census Tract 2520, Solano County, California",36,34,2
1000000US060952520004024,060952520004024,"Block 4024, Block Group 4, Census Tract 2520, Solano County, California",0,0,0
1000000US060952520004025,060952520004025,"Block 4025, Block Group 4, Census Tract 2520, Solano County, California",0,0,0
1000000US060952520004026,060952520004026,"Block 4026, Block Group 4, Census Tract 2520, Solano County, California",0,0,0
1000000US060952520004027,060952520004027,"Block 4027, Block Group 4, Census Tract 2520, Solano County, California",0,0,0
1000000US060952520004028,060952520004028,"Block 4028, Block Group 4, Census Tract 2520, Solano County, California",0,0,0
1000000US060952520004029,060952520004029,"Block 4029, Block Group 4, Census Tract 2520, Solano County, California",15,15,0
1000000US060952520004030,060952520004030,"Block 4030, Block Group 4, Census Tract 2520, Solano County, California",0,0,0
1000000US060952521021000,060952521021000,"Block 1000, Block Group 1, Census Tract 2521.02, Solano County, California",0,0,0
1000000US060952521021001,060952521021001,"Block 1001, Block Group 1, Census Tract 2521.02, Solano County, California",0,0,0
1000000US060952521021002,060952521021002,"Block 1002, Block Group 1, Census Tract 2521.02, Solano County, California",0,0,0
1000000US060952521021003,060952521021003,"Block 1003, Block Group 1, Census Tract 2521.02, Solano County, California",0,0,0
1000000US060952521021004,060952521021004,"Block 1004, Block Group 1, Census Tract 2521.02, Solano County, California",0,0,0
1000000US060952521021005,060952521021005,"Block 1005, Block Group 1, Census Tract 2521.02, Solano County, California",0,0,0
1000000US060952521021006,060952521021006,"Block 1006, Block Group 1, Census Tract 2521.02, Solano County, California",0,0,0
1000000US060952521021007,060952521021007,"Block 1007, Block Group 1, Census Tract 2521.02, Solano County, California",0,0,0
1000000US060952521021008,060952521021008,"Block 1008, Block Group 1, Census Tract 2521.02, Solano County, California",0,0,0
1000000US060952521021009,060952521021009,"Block 1009, Block Group 1, Census Tract 2521.02, Solano County, California",0,0,0
1000000US060952521021010,060952521021010,"Block 1010, Block Group 1, Census Tract 2521.02, Solano County, California",0,0,0
1000000US060952521021011,060952521021011,"Block 1011, Block Group 1, Census Tract 2521.02, Solano County, California",0,0,0
1000000US060952521021012,060952521021012,"Block 1012, Block Group 1, Census Tract 2521.02, Solano County, California",0,0,0
1000000US060952521021013,060952521021013,"Block 1013, Block Group 1, Census Tract 2521.02, Solano County, California",0,0,0
1000000US060952521021014,060952521021014,"Block 1014, Block Group 1, Census Tract 2521.02, Solano County, California",0,0,0
1000000US060952521021015,060952521021015,"Block 1015, Block Group 1, Census Tract 2521.02, Solano County, California",0,0,0
1000000US060952521021016,060952521021016,"Block 1016, Block Group 1, Census Tract 2521.02, Solano County, California",0,0,0
1000000US060952521021017,060952521021017,"Block 1017, Block Group 1, Census Tract 2521.02, Solano County, California",1,1,0
1000000US060952521021018,060952521021018,"Block 1018, Block Group 1, Census Tract 2521.02, Solano County, California",0,0,0
1000000US060952521021019,060952521021019,"Block 1019, Block Group 1, Census Tract 2521.02, Solano County, California",0,0,0
1000000US060952521021020,060952521021020,"Block 1020, Block Group 1, Census Tract 2521.02, Solano County, California",4,4,0
1000000US060952521021021,060952521021021,"Block 1021, Block Group 1, Census Tract 2521.02, Solano County, California",1,1,0
1000000US060952521021022,060952521021022,"Block 1022, Block Group 1, Census Tract 2521.02, Solano County, California",0,0,0
1000000US060952521021023,060952521021023,"Block 1023, Block Group 1, Census Tract 2521.02, Solano County, California",0,0,0
1000000US060952521021024,060952521021024,"Block 1024, Block Group 1, Census Tract 2521.02, Solano County, California",0,0,0
1000000US060952521021025,060952521021025,"Block 1025, Block Group 1, Census Tract 2521.02, Solano County, California",0,0,0
1000000US060952521021026,060952521021026,"Block 1026, Block Group 1, Census Tract 2521.02, Solano County, California",0,0,0
1000000US060952521021027,060952521021027,"Block 1027, Block Group 1, Census Tract 2521.02, Solano County, California",0,0,0
1000000US060952521021028,060952521021028,"Block 1028, Block Group 1, Census Tract 2521.02, Solano County, California",0,0,0
1000000US060952521021029,060952521021029,"Block 1029, Block Group 1, Census Tract 2521.02, Solano County, California",0,0,0
1000000US060952521021030,060952521021030,"Block 1030, Block Group 1, Census Tract 2521.02, Solano County, California",0,0,0
1000000US060952521021031,060952521021031,"Block 1031, Block Group 1, Census Tract 2521.02, Solano County, California",0,0,0
1000000US060952521021032,060952521021032,"Block 1032, Block Group 1, Census Tract 2521.02, Solano County, California",0,0,0
1000000US060952521021033,060952521021033,"Block 1033, Block Group 1, Census Tract 2521.02, Solano County, California",0,0,0
1000000US060952521021034,060952521021034,"Block 1034, Block Group 1, Census Tract 2521.02, Solano County, California",0,0,0
1000000US060952521021035,060952521021035,"Block 1035, Block Group 1, Census Tract 2521.02, Solano County, California",0,0,0
1000000US060952521021036,060952521021036,"Block 1036, Block Group 1, Census Tract 2521.02, Solano County, California",0,0,0
1000000US060952521021037,060952521021037,"Block 1037, Block Group 1, Census Tract 2521.02, Solano County, California",0,0,0
1000000US060952521021038,060952521021038,"Block 1038, Block Group 1, Census Tract 2521.02, Solano County, California",0,0,0
1000000US060952521021039,060952521021039,"Block 1039, Block Group 1, Census Tract 2521.02, Solano County, California",0,0,0
1000000US060952521021040,060952521021040,"Block 1040, Block Group 1, Census Tract 2521.02, Solano County, California",0,0,0
1000000US060952521021041,060952521021041,"Block 1041, Block Group 1, Census Tract 2521.02, Solano County, California",0,0,0
1000000US060952521021042,060952521021042,"Block 1042, Block Group 1, Census Tract 2521.02, Solano County, California",0,0,0
1000000US060952521021043,060952521021043,"Block 1043, Block Group 1, Census Tract 2521.02, Solano County, California",0,0,0
1000000US060952521021044,060952521021044,"Block 1044, Block Group 1, Census Tract 2521.02, Solano County, California",0,0,0
1000000US060952521021045,060952521021045,"Block 1045, Block Group 1, Census Tract 2521.02, Solano County, California",0,0,0
1000000US060952521021046,060952521021046,"Block 1046, Block Group 1, Census Tract 2521.02, Solano County, California",0,0,0
1000000US060952521021047,060952521021047,"Block 1047, Block Group 1, Census Tract 2521.02, Solano County, California",0,0,0
1000000US060952521021048,060952521021048,"Block 1048, Block Group 1, Census Tract 2521.02, Solano County, California",0,0,0
1000000US060952521021049,060952521021049,"Block 1049, Block Group 1, Census Tract 2521.02, Solano County, California",0,0,0
1000000US060952521021050,060952521021050,"Block 1050, Block Group 1, Census Tract 2521.02, Solano County, California",0,0,0
1000000US060952521021051,060952521021051,"Block 1051, Block Group 1, Census Tract 2521.02, Solano County, California",0,0,0
1000000US060952521021052,060952521021052,"Block 1052, Block Group 1, Census Tract 2521.02, Solano County, California",0,0,0
1000000US060952521021053,060952521021053,"Block 1053, Block Group 1, Census Tract 2521.02, Solano County, California",0,0,0
1000000US060952521021054,060952521021054,"Block 1054, Block Group 1, Census Tract 2521.02, Solano County, California",0,0,0
1000000US060952521021055,060952521021055,"Block 1055, Block Group 1, Census Tract 2521.02, Solano County, California",0,0,0
1000000US060952521021056,060952521021056,"Block 1056, Block Group 1, Census Tract 2521.02, Solano County, California",0,0,0
1000000US060952521021057,060952521021057,"Block 1057, Block Group 1, Census Tract 2521.02, Solano County, California",0,0,0
1000000US060952521021058,060952521021058,"Block 1058, Block Group 1, Census Tract 2521.02, Solano County, California",0,0,0
1000000US060952521021059,060952521021059,"Block 1059, Block Group 1, Census Tract 2521.02, Solano County, California",0,0,0
1000000US060952521021060,060952521021060,"Block 1060, Block Group 1, Census Tract 2521.02, Solano County, California",0,0,0
1000000US060952521021061,060952521021061,"Block 1061, Block Group 1, Census Tract 2521.02, Solano County, California",0,0,0
1000000US060952521021062,060952521021062,"Block 1062, Block Group 1, Census Tract 2521.02, Solano County, California",0,0,0
1000000US060952521021063,060952521021063,"Block 1063, Block Group 1, Census Tract 2521.02, Solano County, California",0,0,0
1000000US060952521021064,060952521021064,"Block 1064, Block Group 1, Census Tract 2521.02, Solano County, California",0,0,0
1000000US060952521021065,060952521021065,"Block 1065, Block Group 1, Census Tract 2521.02, Solano County, California",0,0,0
1000000US060952521021066,060952521021066,"Block 1066, Block Group 1, Census Tract 2521.02, Solano County, California",0,0,0
1000000US060952521021067,060952521021067,"Block 1067, Block Group 1, Census Tract 2521.02, Solano County, California",0,0,0
1000000US060952521021068,060952521021068,"Block 1068, Block Group 1, Census Tract 2521.02, Solano County, California",0,0,0
1000000US060952521021069,060952521021069,"Block 1069, Block Group 1, Census Tract 2521.02, Solano County, California",0,0,0
1000000US060952521021070,060952521021070,"Block 1070, Block Group 1, Census Tract 2521.02, Solano County, California",0,0,0
1000000US060952521021071,060952521021071,"Block 1071, Block Group 1, Census Tract 2521.02, Solano County, California",0,0,0
1000000US060952521021072,060952521021072,"Block 1072, Block Group 1, Census Tract 2521.02, Solano County, California",0,0,0
1000000US060952521021073,060952521021073,"Block 1073, Block Group 1, Census Tract 2521.02, Solano County, California",0,0,0
1000000US060952521021074,060952521021074,"Block 1074, Block Group 1, Census Tract 2521.02, Solano County, California",0,0,0
1000000US060952521021075,060952521021075,"Block 1075, Block Group 1, Census Tract 2521.02, Solano County, California",0,0,0
1000000US060952521021076,060952521021076,"Block 1076, Block Group 1, Census Tract 2521.02, Solano County, California",0,0,0
1000000US060952521021077,060952521021077,"Block 1077, Block Group 1, Census Tract 2521.02, Solano County, California",0,0,0
1000000US060952521021078,060952521021078,"Block 1078, Block Group 1, Census Tract 2521.02, Solano County, California",0,0,0
1000000US060952521021079,060952521021079,"Block 1079, Block Group 1, Census Tract 2521.02, Solano County, California",0,0,0
1000000US060952521021080,060952521021080,"Block 1080, Block Group 1, Census Tract 2521.02, Solano County, California",0,0,0
1000000US060952521021081,060952521021081,"Block 1081, Block Group 1, Census Tract 2521.02, Solano County, California",0,0,0
1000000US060952521021082,060952521021082,"Block 1082, Block Group 1, Census Tract 2521.02, Solano County, California",0,0,0
1000000US060952521021083,060952521021083,"Block 1083, Block Group 1, Census Tract 2521.02, Solano County, California",0,0,0
1000000US060952521021084,060952521021084,"Block 1084, Block Group 1, Census Tract 2521.02, Solano County, California",0,0,0
1000000US060952521021085,060952521021085,"Block 1085, Block Group 1, Census Tract 2521.02, Solano County, California",0,0,0
1000000US060952521021086,060952521021086,"Block 1086, Block Group 1, Census Tract 2521.02, Solano County, California",1,1,0
1000000US060952521021087,060952521021087,"Block 1087, Block Group 1, Census Tract 2521.02, Solano County, California",0,0,0
1000000US060952521021088,060952521021088,"Block 1088, Block Group 1, Census Tract 2521.02, Solano County, California",0,0,0
1000000US060952521021089,060952521021089,"Block 1089, Block Group 1, Census Tract 2521.02, Solano County, California",0,0,0
1000000US060952521021090,060952521021090,"Block 1090, Block Group 1, Census Tract 2521.02, Solano County, California",0,0,0
1000000US060952521021091,060952521021091,"Block 1091, Block Group 1, Census Tract 2521.02, Solano County, California",0,0,0
1000000US060952521021092,060952521021092,"Block 1092, Block Group 1, Census Tract 2521.02, Solano County, California",0,0,0
1000000US060952521021093,060952521021093,"Block 1093, Block Group 1, Census Tract 2521.02, Solano County, California",0,0,0
1000000US060952521021094,060952521021094,"Block 1094, Block Group 1, Census Tract 2521.02, Solano County, California",0,0,0
1000000US060952521021095,060952521021095,"Block 1095, Block Group 1, Census Tract 2521.02, Solano County, California",0,0,0
1000000US060952521021096,060952521021096,"Block 1096, Block Group 1, Census Tract 2521.02, Solano County, California",0,0,0
1000000US060952521021097,060952521021097,"Block 1097, Block Group 1, Census Tract 2521.02, Solano County, California",0,0,0
1000000US060952521021098,060952521021098,"Block 1098, Block Group 1, Census Tract 2521.02, Solano County, California",0,0,0
1000000US060952521021099,060952521021099,"Block 1099, Block Group 1, Census Tract 2521.02, Solano County, California",0,0,0
1000000US060952521021100,060952521021100,"Block 1100, Block Group 1, Census Tract 2521.02, Solano County, California",62,60,2
1000000US060952521021101,060952521021101,"Block 1101, Block Group 1, Census Tract 2521.02, Solano County, California",82,75,7
1000000US060952521021102,060952521021102,"Block 1102, Block Group 1, Census Tract 2521.02, Solano County, California",35,33,2
1000000US060952521021103,060952521021103,"Block 1103, Block Group 1, Census Tract 2521.02, Solano County, California",8,7,1
1000000US060952521021104,060952521021104,"Block 1104, Block Group 1, Census Tract 2521.02, Solano County, California",94,89,5
1000000US060952521021105,060952521021105,"Block 1105, Block Group 1, Census Tract 2521.02, Solano County, California",25,19,6
1000000US060952521021106,060952521021106,"Block 1106, Block Group 1, Census Tract 2521.02, Solano County, California",0,0,0
1000000US060952521021107,060952521021107,"Block 1107, Block Group 1, Census Tract 2521.02, Solano County, California",0,0,0
1000000US060952521021108,060952521021108,"Block 1108, Block Group 1, Census Tract 2521.02, Solano County, California",0,0,0
1000000US060952521021109,060952521021109,"Block 1109, Block Group 1, Census Tract 2521.02, Solano County, California",36,35,1
1000000US060952521021110,060952521021110,"Block 1110, Block Group 1, Census Tract 2521.02, Solano County, California",0,0,0
1000000US060952521021111,060952521021111,"Block 1111, Block Group 1, Census Tract 2521.02, Solano County, California",123,113,10
1000000US060952521021112,060952521021112,"Block 1112, Block Group 1, Census Tract 2521.02, Solano County, California",0,0,0
1000000US060952521021113,060952521021113,"Block 1113, Block Group 1, Census Tract 2521.02, Solano County, California",1,1,0
1000000US060952521021114,060952521021114,"Block 1114, Block Group 1, Census Tract 2521.02, Solano County, California",0,0,0
1000000US060952521021115,060952521021115,"Block 1115, Block Group 1, Census Tract 2521.02, Solano County, California",12,11,1
1000000US060952521021116,060952521021116,"Block 1116, Block Group 1, Census Tract 2521.02, Solano County, California",11,10,1
1000000US060952521021117,060952521021117,"Block 1117, Block Group 1, Census Tract 2521.02, Solano County, California",7,7,0
1000000US060952521021118,060952521021118,"Block 1118, Block Group 1, Census Tract 2521.02, Solano County, California",0,0,0
1000000US060952521021119,060952521021119,"Block 1119, Block Group 1, Census Tract 2521.02, Solano County, California",20,20,0
1000000US060952521021120,060952521021120,"Block 1120, Block Group 1, Census Tract 2521.02, Solano County, California",12,10,2
1000000US060952521021121,060952521021121,"Block 1121, Block Group 1, Census Tract 2521.02, Solano County, California",21,18,3
1000000US060952521021122,060952521021122,"Block 1122, Block Group 1, Census Tract 2521.02, Solano County, California",2,1,1
1000000US060952521021123,060952521021123,"Block 1123, Block Group 1, Census Tract 2521.02, Solano County, California",29,25,4
1000000US060952521021124,060952521021124,"Block 1124, Block Group 1, Census Tract 2521.02, Solano County, California",0,0,0
1000000US060952521021125,060952521021125,"Block 1125, Block Group 1, Census Tract 2521.02, Solano County, California",6,6,0
1000000US060952521021126,060952521021126,"Block 1126, Block Group 1, Census Tract 2521.02, Solano County, California",0,0,0
1000000US060952521021127,060952521021127,"Block 1127, Block Group 1, Census Tract 2521.02, Solano County, California",47,43,4
1000000US060952521021128,060952521021128,"Block 1128, Block Group 1, Census Tract 2521.02, Solano County, California",24,19,5
1000000US060952521021129,060952521021129,"Block 1129, Block Group 1, Census Tract 2521.02, Solano County, California",9,9,0
1000000US060952521021130,060952521021130,"Block 1130, Block Group 1, Census Tract 2521.02, Solano County, California",12,12,0
1000000US060952521021131,060952521021131,"Block 1131, Block Group 1, Census Tract 2521.02, Solano County, California",41,38,3
1000000US060952521021132,060952521021132,"Block 1132, Block Group 1, Census Tract 2521.02, Solano County, California",13,13,0
1000000US060952521021133,060952521021133,"Block 1133, Block Group 1, Census Tract 2521.02, Solano County, California",13,11,2
1000000US060952521021134,060952521021134,"Block 1134, Block Group 1, Census Tract 2521.02, Solano County, California",13,13,0
1000000US060952521021135,060952521021135,"Block 1135, Block Group 1, Census Tract 2521.02, Solano County, California",6,6,0
1000000US060952521021136,060952521021136,"Block 1136, Block Group 1, Census Tract 2521.02, Solano County, California",42,32,10
1000000US060952521021137,060952521021137,"Block 1137, Block Group 1, Census Tract 2521.02, Solano County, California",10,10,0
1000000US060952521021138,060952521021138,"Block 1138, Block Group 1, Census Tract 2521.02, Solano County, California",14,14,0
1000000US060952521021139,060952521021139,"Block 1139, Block Group 1, Census Tract 2521.02, Solano County, California",12,12,0
1000000US060952521021140,060952521021140,"Block 1140, Block Group 1, Census Tract 2521.02, Solano County, California",29,28,1
1000000US060952521021141,060952521021141,"Block 1141, Block Group 1, Census Tract 2521.02, Solano County, California",28,24,4
1000000US060952521021142,060952521021142,"Block 1142, Block Group 1, Census Tract 2521.02, Solano County, California",17,16,1
1000000US060952521021143,060952521021143,"Block 1143, Block Group 1, Census Tract 2521.02, Solano County, California",12,11,1
1000000US060952521021144,060952521021144,"Block 1144, Block Group 1, Census Tract 2521.02, Solano County, California",27,26,1
1000000US060952521021145,060952521021145,"Block 1145, Block Group 1, Census Tract 2521.02, Solano County, California",0,0,0
1000000US060952521021146,060952521021146,"Block 1146, Block Group 1, Census Tract 2521.02, Solano County, California",0,0,0
1000000US060952521021147,060952521021147,"Block 1147, Block Group 1, Census Tract 2521.02, Solano County, California",0,0,0
1000000US060952521021148,060952521021148,"Block 1148, Block Group 1, Census Tract 2521.02, Solano County, California",0,0,0
1000000US060952521021149,060952521021149,"Block 1149, Block Group 1, Census Tract 2521.02, Solano County, California",0,0,0
1000000US060952521021150,060952521021150,"Block 1150, Block Group 1, Census Tract 2521.02, Solano County, California",0,0,0
1000000US060952521021151,060952521021151,"Block 1151, Block Group 1, Census Tract 2521.02, Solano County, California",0,0,0
1000000US060952521021152,060952521021152,"Block 1152, Block Group 1, Census Tract 2521.02, Solano County, California",0,0,0
1000000US060952521021153,060952521021153,"Block 1153, Block Group 1, Census Tract 2521.02, Solano County, California",0,0,0
1000000US060952521021154,060952521021154,"Block 1154, Block Group 1, Census Tract 2521.02, Solano County, California",0,0,0
1000000US060952521021155,060952521021155,"Block 1155, Block Group 1, Census Tract 2521.02, Solano County, California",0,0,0
1000000US060952521021156,060952521021156,"Block 1156, Block Group 1, Census Tract 2521.02, Solano County, California",0,0,0
1000000US060952521021157,060952521021157,"Block 1157, Block Group 1, Census Tract 2521.02, Solano County, California",0,0,0
1000000US060952521021158,060952521021158,"Block 1158, Block Group 1, Census Tract 2521.02, Solano County, California",15,13,2
1000000US060952521021159,060952521021159,"Block 1159, Block Group 1, Census Tract 2521.02, Solano County, California",12,11,1
1000000US060952521021160,060952521021160,"Block 1160, Block Group 1, Census Tract 2521.02, Solano County, California",9,7,2
1000000US060952521021161,060952521021161,"Block 1161, Block Group 1, Census Tract 2521.02, Solano County, California",0,0,0
1000000US060952521022000,060952521022000,"Block 2000, Block Group 2, Census Tract 2521.02, Solano County, California",0,0,0
1000000US060952521022001,060952521022001,"Block 2001, Block Group 2, Census Tract 2521.02, Solano County, California",0,0,0
1000000US060952521022002,060952521022002,"Block 2002, Block Group 2, Census Tract 2521.02, Solano County, California",2,2,0
1000000US060952521022003,060952521022003,"Block 2003, Block Group 2, Census Tract 2521.02, Solano County, California",11,10,1
1000000US060952521022004,060952521022004,"Block 2004, Block Group 2, Census Tract 2521.02, Solano County, California",0,0,0
1000000US060952521022005,060952521022005,"Block 2005, Block Group 2, Census Tract 2521.02, Solano County, California",0,0,0
1000000US060952521022006,060952521022006,"Block 2006, Block Group 2, Census Tract 2521.02, Solano County, California",0,0,0
1000000US060952521022007,060952521022007,"Block 2007, Block Group 2, Census Tract 2521.02, Solano County, California",0,0,0
1000000US060952521022008,060952521022008,"Block 2008, Block Group 2, Census Tract 2521.02, Solano County, California",0,0,0
1000000US060952521022009,060952521022009,"Block 2009, Block Group 2, Census Tract 2521.02, Solano County, California",0,0,0
1000000US060952521022010,060952521022010,"Block 2010, Block Group 2, Census Tract 2521.02, Solano County, California",0,0,0
1000000US060952521022011,060952521022011,"Block 2011, Block Group 2, Census Tract 2521.02, Solano County, California",0,0,0
1000000US060952521022012,060952521022012,"Block 2012, Block Group 2, Census Tract 2521.02, Solano County, California",0,0,0
1000000US060952521022013,060952521022013,"Block 2013, Block Group 2, Census Tract 2521.02, Solano County, California",0,0,0
1000000US060952521022014,060952521022014,"Block 2014, Block Group 2, Census Tract 2521.02, Solano County, California",0,0,0
1000000US060952521022015,060952521022015,"Block 2015, Block Group 2, Census Tract 2521.02, Solano County, California",0,0,0
1000000US060952521022016,060952521022016,"Block 2016, Block Group 2, Census Tract 2521.02, Solano County, California",0,0,0
1000000US060952521022017,060952521022017,"Block 2017, Block Group 2, Census Tract 2521.02, Solano County, California",0,0,0
1000000US060952521022018,060952521022018,"Block 2018, Block Group 2, Census Tract 2521.02, Solano County, California",0,0,0
1000000US060952521022019,060952521022019,"Block 2019, Block Group 2, Census Tract 2521.02, Solano County, California",0,0,0
1000000US060952521022020,060952521022020,"Block 2020, Block Group 2, Census Tract 2521.02, Solano County, California",0,0,0
1000000US060952521022021,060952521022021,"Block 2021, Block Group 2, Census Tract 2521.02, Solano County, California",0,0,0
1000000US060952521022022,060952521022022,"Block 2022, Block Group 2, Census Tract 2521.02, Solano County, California",0,0,0
1000000US060952521022023,060952521022023,"Block 2023, Block Group 2, Census Tract 2521.02, Solano County, California",0,0,0
1000000US060952521022024,060952521022024,"Block 2024, Block Group 2, Census Tract 2521.02, Solano County, California",0,0,0
1000000US060952521022025,060952521022025,"Block 2025, Block Group 2, Census Tract 2521.02, Solano County, California",0,0,0
1000000US060952521022026,060952521022026,"Block 2026, Block Group 2, Census Tract 2521.02, Solano County, California",0,0,0
1000000US060952521022027,060952521022027,"Block 2027, Block Group 2, Census Tract 2521.02, Solano County, California",0,0,0
1000000US060952521022028,060952521022028,"Block 2028, Block Group 2, Census Tract 2521.02, Solano County, California",0,0,0
1000000US060952521022029,060952521022029,"Block 2029, Block Group 2, Census Tract 2521.02, Solano County, California",0,0,0
1000000US060952521022030,060952521022030,"Block 2030, Block Group 2, Census Tract 2521.02, Solano County, California",0,0,0
1000000US060952521022031,060952521022031,"Block 2031, Block Group 2, Census Tract 2521.02, Solano County, California",0,0,0
1000000US060952521022032,060952521022032,"Block 2032, Block Group 2, Census Tract 2521.02, Solano County, California",0,0,0
1000000US060952521022033,060952521022033,"Block 2033, Block Group 2, Census Tract 2521.02, Solano County, California",0,0,0
1000000US060952521022034,060952521022034,"Block 2034, Block Group 2, Census Tract 2521.02, Solano County, California",0,0,0
1000000US060952521022035,060952521022035,"Block 2035, Block Group 2, Census Tract 2521.02, Solano County, California",0,0,0
1000000US060952521022036,060952521022036,"Block 2036, Block Group 2, Census Tract 2521.02, Solano County, California",0,0,0
1000000US060952521022037,060952521022037,"Block 2037, Block Group 2, Census Tract 2521.02, Solano County, California",0,0,0
1000000US060952521022038,060952521022038,"Block 2038, Block Group 2, Census Tract 2521.02, Solano County, California",0,0,0
1000000US060952521022039,060952521022039,"Block 2039, Block Group 2, Census Tract 2521.02, Solano County, California",0,0,0
1000000US060952521022040,060952521022040,"Block 2040, Block Group 2, Census Tract 2521.02, Solano County, California",0,0,0
1000000US060952521022041,060952521022041,"Block 2041, Block Group 2, Census Tract 2521.02, Solano County, California",0,0,0
1000000US060952521022042,060952521022042,"Block 2042, Block Group 2, Census Tract 2521.02, Solano County, California",0,0,0
1000000US060952521022043,060952521022043,"Block 2043, Block Group 2, Census Tract 2521.02, Solano County, California",0,0,0
1000000US060952521022044,060952521022044,"Block 2044, Block Group 2, Census Tract 2521.02, Solano County, California",0,0,0
1000000US060952521022045,060952521022045,"Block 2045, Block Group 2, Census Tract 2521.02, Solano County, California",0,0,0
1000000US060952521022046,060952521022046,"Block 2046, Block Group 2, Census Tract 2521.02, Solano County, California",0,0,0
1000000US060952521022047,060952521022047,"Block 2047, Block Group 2, Census Tract 2521.02, Solano County, California",0,0,0
1000000US060952521022048,060952521022048,"Block 2048, Block Group 2, Census Tract 2521.02, Solano County, California",0,0,0
1000000US060952521022049,060952521022049,"Block 2049, Block Group 2, Census Tract 2521.02, Solano County, California",0,0,0
1000000US060952521022050,060952521022050,"Block 2050, Block Group 2, Census Tract 2521.02, Solano County, California",0,0,0
1000000US060952521022051,060952521022051,"Block 2051, Block Group 2, Census Tract 2521.02, Solano County, California",0,0,0
1000000US060952521022052,060952521022052,"Block 2052, Block Group 2, Census Tract 2521.02, Solano County, California",0,0,0
1000000US060952521022053,060952521022053,"Block 2053, Block Group 2, Census Tract 2521.02, Solano County, California",0,0,0
1000000US060952521022054,060952521022054,"Block 2054, Block Group 2, Census Tract 2521.02, Solano County, California",0,0,0
1000000US060952521022055,060952521022055,"Block 2055, Block Group 2, Census Tract 2521.02, Solano County, California",0,0,0
1000000US060952521022056,060952521022056,"Block 2056, Block Group 2, Census Tract 2521.02, Solano County, California",182,168,14
1000000US060952521022057,060952521022057,"Block 2057, Block Group 2, Census Tract 2521.02, Solano County, California",71,69,2
1000000US060952521022058,060952521022058,"Block 2058, Block Group 2, Census Tract 2521.02, Solano County, California",46,44,2
1000000US060952521022059,060952521022059,"Block 2059, Block Group 2, Census Tract 2521.02, Solano County, California",0,0,0
1000000US060952521022060,060952521022060,"Block 2060, Block Group 2, Census Tract 2521.02, Solano County, California",30,30,0
1000000US060952521022061,060952521022061,"Block 2061, Block Group 2, Census Tract 2521.02, Solano County, California",13,13,0
1000000US060952521022062,060952521022062,"Block 2062, Block Group 2, Census Tract 2521.02, Solano County, California",28,28,0
1000000US060952521022063,060952521022063,"Block 2063, Block Group 2, Census Tract 2521.02, Solano County, California",27,26,1
1000000US060952521022064,060952521022064,"Block 2064, Block Group 2, Census Tract 2521.02, Solano County, California",0,0,0
1000000US060952521022065,060952521022065,"Block 2065, Block Group 2, Census Tract 2521.02, Solano County, California",24,22,2
1000000US060952521022066,060952521022066,"Block 2066, Block Group 2, Census Tract 2521.02, Solano County, California",29,29,0
1000000US060952521022067,060952521022067,"Block 2067, Block Group 2, Census Tract 2521.02, Solano County, California",8,8,0
1000000US060952521022068,060952521022068,"Block 2068, Block Group 2, Census Tract 2521.02, Solano County, California",0,0,0
1000000US060952521022069,060952521022069,"Block 2069, Block Group 2, Census Tract 2521.02, Solano County, California",0,0,0
1000000US060952521022070,060952521022070,"Block 2070, Block Group 2, Census Tract 2521.02, Solano County, California",0,0,0
1000000US060952521022071,060952521022071,"Block 2071, Block Group 2, Census Tract 2521.02, Solano County, California",0,0,0
1000000US060952521022072,060952521022072,"Block 2072, Block Group 2, Census Tract 2521.02, Solano County, California",0,0,0
1000000US060952521022073,060952521022073,"Block 2073, Block Group 2, Census Tract 2521.02, Solano County, California",0,0,0
1000000US060952521022074,060952521022074,"Block 2074, Block Group 2, Census Tract 2521.02, Solano County, California",0,0,0
1000000US060952521022075,060952521022075,"Block 2075, Block Group 2, Census Tract 2521.02, Solano County, California",0,0,0
1000000US060952521022076,060952521022076,"Block 2076, Block Group 2, Census Tract 2521.02, Solano County, California",0,0,0
1000000US060952521022077,060952521022077,"Block 2077, Block Group 2, Census Tract 2521.02, Solano County, California",0,0,0
1000000US060952521022078,060952521022078,"Block 2078, Block Group 2, Census Tract 2521.02, Solano County, California",1,1,0
1000000US060952521022079,060952521022079,"Block 2079, Block Group 2, Census Tract 2521.02, Solano County, California",0,0,0
1000000US060952521022080,060952521022080,"Block 2080, Block Group 2, Census Tract 2521.02, Solano County, California",0,0,0
1000000US060952521022081,060952521022081,"Block 2081, Block Group 2, Census Tract 2521.02, Solano County, California",0,0,0
1000000US060952521022082,060952521022082,"Block 2082, Block Group 2, Census Tract 2521.02, Solano County, California",0,0,0
1000000US060952521022083,060952521022083,"Block 2083, Block Group 2, Census Tract 2521.02, Solano County, California",0,0,0
1000000US060952521022084,060952521022084,"Block 2084, Block Group 2, Census Tract 2521.02, Solano County, California",9,8,1
1000000US060952521022085,060952521022085,"Block 2085, Block Group 2, Census Tract 2521.02, Solano County, California",0,0,0
1000000US060952521022086,060952521022086,"Block 2086, Block Group 2, Census Tract 2521.02, Solano County, California",0,0,0
1000000US060952521022087,060952521022087,"Block 2087, Block Group 2, Census Tract 2521.02, Solano County, California",0,0,0
1000000US060952521022088,060952521022088,"Block 2088, Block Group 2, Census Tract 2521.02, Solano County, California",0,0,0
1000000US060952521022089,060952521022089,"Block 2089, Block Group 2, Census Tract 2521.02, Solano County, California",73,70,3
1000000US060952521022090,060952521022090,"Block 2090, Block Group 2, Census Tract 2521.02, Solano County, California",22,20,2
1000000US060952521022091,060952521022091,"Block 2091, Block Group 2, Census Tract 2521.02, Solano County, California",18,16,2
1000000US060952521022092,060952521022092,"Block 2092, Block Group 2, Census Tract 2521.02, Solano County, California",0,0,0
1000000US060952521022093,060952521022093,"Block 2093, Block Group 2, Census Tract 2521.02, Solano County, California",53,51,2
1000000US060952521022094,060952521022094,"Block 2094, Block Group 2, Census Tract 2521.02, Solano County, California",6,6,0
1000000US060952521022095,060952521022095,"Block 2095, Block Group 2, Census Tract 2521.02, Solano County, California",0,0,0
1000000US060952521022096,060952521022096,"Block 2096, Block Group 2, Census Tract 2521.02, Solano County, California",0,0,0
1000000US060952521022097,060952521022097,"Block 2097, Block Group 2, Census Tract 2521.02, Solano County, California",0,0,0
1000000US060952521022098,060952521022098,"Block 2098, Block Group 2, Census Tract 2521.02, Solano County, California",0,0,0
1000000US060952521022099,060952521022099,"Block 2099, Block Group 2, Census Tract 2521.02, Solano County, California",0,0,0
1000000US060952521022100,060952521022100,"Block 2100, Block Group 2, Census Tract 2521.02, Solano County, California",0,0,0
1000000US060952521022101,060952521022101,"Block 2101, Block Group 2, Census Tract 2521.02, Solano County, California",0,0,0
1000000US060952521022102,060952521022102,"Block 2102, Block Group 2, Census Tract 2521.02, Solano County, California",0,0,0
1000000US060952521022103,060952521022103,"Block 2103, Block Group 2, Census Tract 2521.02, Solano County, California",26,26,0
1000000US060952521031000,060952521031000,"Block 1000, Block Group 1, Census Tract 2521.03, Solano County, California",56,56,0
1000000US060952521031001,060952521031001,"Block 1001, Block Group 1, Census Tract 2521.03, Solano County, California",0,0,0
1000000US060952521031002,060952521031002,"Block 1002, Block Group 1, Census Tract 2521.03, Solano County, California",0,0,0
1000000US060952521031003,060952521031003,"Block 1003, Block Group 1, Census Tract 2521.03, Solano County, California",224,223,1
1000000US060952521031004,060952521031004,"Block 1004, Block Group 1, Census Tract 2521.03, Solano County, California",0,0,0
1000000US060952521031005,060952521031005,"Block 1005, Block Group 1, Census Tract 2521.03, Solano County, California",111,108,3
1000000US060952521031006,060952521031006,"Block 1006, Block Group 1, Census Tract 2521.03, Solano County, California",121,118,3
1000000US060952521031007,060952521031007,"Block 1007, Block Group 1, Census Tract 2521.03, Solano County, California",0,0,0
1000000US060952521032000,060952521032000,"Block 2000, Block Group 2, Census Tract 2521.03, Solano County, California",26,26,0
1000000US060952521032001,060952521032001,"Block 2001, Block Group 2, Census Tract 2521.03, Solano County, California",26,25,1
1000000US060952521032002,060952521032002,"Block 2002, Block Group 2, Census Tract 2521.03, Solano County, California",40,39,1
1000000US060952521032003,060952521032003,"Block 2003, Block Group 2, Census Tract 2521.03, Solano County, California",12,11,1
1000000US060952521032004,060952521032004,"Block 2004, Block Group 2, Census Tract 2521.03, Solano County, California",28,28,0
1000000US060952521032005,060952521032005,"Block 2005, Block Group 2, Census Tract 2521.03, Solano County, California",49,49,0
1000000US060952521032006,060952521032006,"Block 2006, Block Group 2, Census Tract 2521.03, Solano County, California",0,0,0
1000000US060952521032007,060952521032007,"Block 2007, Block Group 2, Census Tract 2521.03, Solano County, California",12,12,0
1000000US060952521032008,060952521032008,"Block 2008, Block Group 2, Census Tract 2521.03, Solano County, California",42,41,1
1000000US060952521032009,060952521032009,"Block 2009, Block Group 2, Census Tract 2521.03, Solano County, California",25,24,1
1000000US060952521032010,060952521032010,"Block 2010, Block Group 2, Census Tract 2521.03, Solano County, California",7,7,0
1000000US060952521032011,060952521032011,"Block 2011, Block Group 2, Census Tract 2521.03, Solano County, California",29,28,1
1000000US060952521032012,060952521032012,"Block 2012, Block Group 2, Census Tract 2521.03, Solano County, California",18,17,1
1000000US060952521032013,060952521032013,"Block 2013, Block Group 2, Census Tract 2521.03, Solano County, California",0,0,0
1000000US060952521032014,060952521032014,"Block 2014, Block Group 2, Census Tract 2521.03, Solano County, California",12,12,0
1000000US060952521032015,060952521032015,"Block 2015, Block Group 2, Census Tract 2521.03, Solano County, California",9,9,0
1000000US060952521032016,060952521032016,"Block 2016, Block Group 2, Census Tract 2521.03, Solano County, California",13,13,0
1000000US060952521032017,060952521032017,"Block 2017, Block Group 2, Census Tract 2521.03, Solano County, California",35,34,1
1000000US060952521032018,060952521032018,"Block 2018, Block Group 2, Census Tract 2521.03, Solano County, California",10,9,1
1000000US060952521032019,060952521032019,"Block 2019, Block Group 2, Census Tract 2521.03, Solano County, California",10,8,2
1000000US060952521032020,060952521032020,"Block 2020, Block Group 2, Census Tract 2521.03, Solano County, California",31,30,1
1000000US060952521032021,060952521032021,"Block 2021, Block Group 2, Census Tract 2521.03, Solano County, California",24,24,0
1000000US060952521032022,060952521032022,"Block 2022, Block Group 2, Census Tract 2521.03, Solano County, California",16,14,2
1000000US060952521032023,060952521032023,"Block 2023, Block Group 2, Census Tract 2521.03, Solano County, California",52,49,3
1000000US060952521032024,060952521032024,"Block 2024, Block Group 2, Census Tract 2521.03, Solano County, California",29,29,0
1000000US060952521032025,060952521032025,"Block 2025, Block Group 2, Census Tract 2521.03, Solano County, California",17,16,1
1000000US060952521032026,060952521032026,"Block 2026, Block Group 2, Census Tract 2521.03, Solano County, California",55,53,2
1000000US060952521032027,060952521032027,"Block 2027, Block Group 2, Census Tract 2521.03, Solano County, California",43,36,7
1000000US060952521032028,060952521032028,"Block 2028, Block Group 2, Census Tract 2521.03, Solano County, California",12,12,0
1000000US060952521032029,060952521032029,"Block 2029, Block Group 2, Census Tract 2521.03, Solano County, California",11,11,0
1000000US060952521032030,060952521032030,"Block 2030, Block Group 2, Census Tract 2521.03, Solano County, California",20,19,1
1000000US060952521032031,060952521032031,"Block 2031, Block Group 2, Census Tract 2521.03, Solano County, California",50,47,3
1000000US060952521032032,060952521032032,"Block 2032, Block Group 2, Census Tract 2521.03, Solano County, California",32,30,2
1000000US060952521032033,060952521032033,"Block 2033, Block Group 2, Census Tract 2521.03, Solano County, California",21,20,1
1000000US060952521032034,060952521032034,"Block 2034, Block Group 2, Census Tract 2521.03, Solano County, California",27,27,0
1000000US060952521033000,060952521033000,"Block 3000, Block Group 3, Census Tract 2521.03, Solano County, California",234,201,33
1000000US060952521033001,060952521033001,"Block 3001, Block Group 3, Census Tract 2521.03, Solano County, California",11,11,0
1000000US060952521033002,060952521033002,"Block 3002, Block Group 3, Census Tract 2521.03, Solano County, California",10,10,0
1000000US060952521033003,060952521033003,"Block 3003, Block Group 3, Census Tract 2521.03, Solano County, California",83,79,4
1000000US060952521033004,060952521033004,"Block 3004, Block Group 3, Census Tract 2521.03, Solano County, California",16,14,2
1000000US060952521033005,060952521033005,"Block 3005, Block Group 3, Census Tract 2521.03, Solano County, California",139,126,13
1000000US060952521033006,060952521033006,"Block 3006, Block Group 3, Census Tract 2521.03, Solano County, California",51,50,1
1000000US060952521033007,060952521033007,"Block 3007, Block Group 3, Census Tract 2521.03, Solano County, California",13,13,0
1000000US060952521033008,060952521033008,"Block 3008, Block Group 3, Census Tract 2521.03, Solano County, California",22,20,2
1000000US060952521033009,060952521033009,"Block 3009, Block Group 3, Census Tract 2521.03, Solano County, California",44,38,6
1000000US060952521033010,060952521033010,"Block 3010, Block Group 3, Census Tract 2521.03, Solano County, California",12,12,0
1000000US060952521033011,060952521033011,"Block 3011, Block Group 3, Census Tract 2521.03, Solano County, California",14,14,0
1000000US060952521041000,060952521041000,"Block 1000, Block Group 1, Census Tract 2521.04, Solano County, California",0,0,0
1000000US060952521041001,060952521041001,"Block 1001, Block Group 1, Census Tract 2521.04, Solano County, California",0,0,0
1000000US060952521041002,060952521041002,"Block 1002, Block Group 1, Census Tract 2521.04, Solano County, California",40,39,1
1000000US060952521041003,060952521041003,"Block 1003, Block Group 1, Census Tract 2521.04, Solano County, California",103,101,2
1000000US060952521041004,060952521041004,"Block 1004, Block Group 1, Census Tract 2521.04, Solano County, California",3,3,0
1000000US060952521041005,060952521041005,"Block 1005, Block Group 1, Census Tract 2521.04, Solano County, California",10,10,0
1000000US060952521041006,060952521041006,"Block 1006, Block Group 1, Census Tract 2521.04, Solano County, California",9,9,0
1000000US060952521041007,060952521041007,"Block 1007, Block Group 1, Census Tract 2521.04, Solano County, California",1,1,0
1000000US060952521041008,060952521041008,"Block 1008, Block Group 1, Census Tract 2521.04, Solano County, California",0,0,0
1000000US060952521041009,060952521041009,"Block 1009, Block Group 1, Census Tract 2521.04, Solano County, California",0,0,0
1000000US060952521041010,060952521041010,"Block 1010, Block Group 1, Census Tract 2521.04, Solano County, California",20,20,0
1000000US060952521041011,060952521041011,"Block 1011, Block Group 1, Census Tract 2521.04, Solano County, California",3,1,2
1000000US060952521041012,060952521041012,"Block 1012, Block Group 1, Census Tract 2521.04, Solano County, California",0,0,0
1000000US060952521041013,060952521041013,"Block 1013, Block Group 1, Census Tract 2521.04, Solano County, California",0,0,0
1000000US060952521041014,060952521041014,"Block 1014, Block Group 1, Census Tract 2521.04, Solano County, California",12,12,0
1000000US060952521041015,060952521041015,"Block 1015, Block Group 1, Census Tract 2521.04, Solano County, California",17,16,1
1000000US060952521041016,060952521041016,"Block 1016, Block Group 1, Census Tract 2521.04, Solano County, California",193,188,5
1000000US060952521041017,060952521041017,"Block 1017, Block Group 1, Census Tract 2521.04, Solano County, California",33,33,0
1000000US060952521041018,060952521041018,"Block 1018, Block Group 1, Census Tract 2521.04, Solano County, California",44,41,3
1000000US060952521041019,060952521041019,"Block 1019, Block Group 1, Census Tract 2521.04, Solano County, California",32,32,0
1000000US060952521041020,060952521041020,"Block 1020, Block Group 1, Census Tract 2521.04, Solano County, California",47,47,0
1000000US060952521041021,060952521041021,"Block 1021, Block Group 1, Census Tract 2521.04, Solano County, California",54,54,0
1000000US060952521041022,060952521041022,"Block 1022, Block Group 1, Census Tract 2521.04, Solano County, California",9,9,0
1000000US060952521041023,060952521041023,"Block 1023, Block Group 1, Census Tract 2521.04, Solano County, California",0,0,0
1000000US060952521041024,060952521041024,"Block 1024, Block Group 1, Census Tract 2521.04, Solano County, California",0,0,0
1000000US060952521041025,060952521041025,"Block 1025, Block Group 1, Census Tract 2521.04, Solano County, California",0,0,0
1000000US060952521041026,060952521041026,"Block 1026, Block Group 1, Census Tract 2521.04, Solano County, California",2,1,1
1000000US060952521041027,060952521041027,"Block 1027, Block Group 1, Census Tract 2521.04, Solano County, California",3,3,0
1000000US060952521041028,060952521041028,"Block 1028, Block Group 1, Census Tract 2521.04, Solano County, California",0,0,0
1000000US060952521041029,060952521041029,"Block 1029, Block Group 1, Census Tract 2521.04, Solano County, California",26,26,0
1000000US060952521041030,060952521041030,"Block 1030, Block Group 1, Census Tract 2521.04, Solano County, California",0,0,0
1000000US060952521041031,060952521041031,"Block 1031, Block Group 1, Census Tract 2521.04, Solano County, California",83,81,2
1000000US060952521042000,060952521042000,"Block 2000, Block Group 2, Census Tract 2521.04, Solano County, California",164,163,1
1000000US060952521042001,060952521042001,"Block 2001, Block Group 2, Census Tract 2521.04, Solano County, California",0,0,0
1000000US060952521042002,060952521042002,"Block 2002, Block Group 2, Census Tract 2521.04, Solano County, California",38,38,0
1000000US060952521042003,060952521042003,"Block 2003, Block Group 2, Census Tract 2521.04, Solano County, California",21,20,1
1000000US060952521042004,060952521042004,"Block 2004, Block Group 2, Census Tract 2521.04, Solano County, California",5,5,0
1000000US060952521042005,060952521042005,"Block 2005, Block Group 2, Census Tract 2521.04, Solano County, California",2,2,0
1000000US060952521042006,060952521042006,"Block 2006, Block Group 2, Census Tract 2521.04, Solano County, California",0,0,0
1000000US060952521042007,060952521042007,"Block 2007, Block Group 2, Census Tract 2521.04, Solano County, California",27,27,0
1000000US060952521042008,060952521042008,"Block 2008, Block Group 2, Census Tract 2521.04, Solano County, California",37,36,1
1000000US060952521042009,060952521042009,"Block 2009, Block Group 2, Census Tract 2521.04, Solano County, California",77,77,0
1000000US060952521042010,060952521042010,"Block 2010, Block Group 2, Census Tract 2521.04, Solano County, California",3,3,0
1000000US060952521042011,060952521042011,"Block 2011, Block Group 2, Census Tract 2521.04, Solano County, California",1,1,0
1000000US060952521042012,060952521042012,"Block 2012, Block Group 2, Census Tract 2521.04, Solano County, California",21,21,0
1000000US060952521042013,060952521042013,"Block 2013, Block Group 2, Census Tract 2521.04, Solano County, California",71,70,1
1000000US060952521042014,060952521042014,"Block 2014, Block Group 2, Census Tract 2521.04, Solano County, California",22,22,0
1000000US060952521043000,060952521043000,"Block 3000, Block Group 3, Census Tract 2521.04, Solano County, California",0,0,0
1000000US060952521043001,060952521043001,"Block 3001, Block Group 3, Census Tract 2521.04, Solano County, California",72,69,3
1000000US060952521043002,060952521043002,"Block 3002, Block Group 3, Census Tract 2521.04, Solano County, California",44,44,0
1000000US060952521043003,060952521043003,"Block 3003, Block Group 3, Census Tract 2521.04, Solano County, California",49,48,1
1000000US060952521043004,060952521043004,"Block 3004, Block Group 3, Census Tract 2521.04, Solano County, California",0,0,0
1000000US060952521043005,060952521043005,"Block 3005, Block Group 3, Census Tract 2521.04, Solano County, California",150,148,2
1000000US060952521043006,060952521043006,"Block 3006, Block Group 3, Census Tract 2521.04, Solano County, California",23,21,2
1000000US060952521043007,060952521043007,"Block 3007, Block Group 3, Census Tract 2521.04, Solano County, California",34,34,0
1000000US060952521043008,060952521043008,"Block 3008, Block Group 3, Census Tract 2521.04, Solano County, California",67,65,2
1000000US060952521043009,060952521043009,"Block 3009, Block Group 3, Census Tract 2521.04, Solano County, California",32,31,1
1000000US060952521043010,060952521043010,"Block 3010, Block Group 3, Census Tract 2521.04, Solano County, California",39,38,1
1000000US060952521043011,060952521043011,"Block 3011, Block Group 3, Census Tract 2521.04, Solano County, California",13,13,0
1000000US060952521043012,060952521043012,"Block 3012, Block Group 3, Census Tract 2521.04, Solano County, California",16,12,4
1000000US060952521043013,060952521043013,"Block 3013, Block Group 3, Census Tract 2521.04, Solano County, California",12,12,0
1000000US060952521043014,060952521043014,"Block 3014, Block Group 3, Census Tract 2521.04, Solano County, California",0,0,0
1000000US060952521043015,060952521043015,"Block 3015, Block Group 3, Census Tract 2521.04, Solano County, California",0,0,0
1000000US060952521043016,060952521043016,"Block 3016, Block Group 3, Census Tract 2521.04, Solano County, California",0,0,0
1000000US060952521043017,060952521043017,"Block 3017, Block Group 3, Census Tract 2521.04, Solano County, California",0,0,0
1000000US060952521051000,060952521051000,"Block 1000, Block Group 1, Census Tract 2521.05, Solano County, California",380,366,14
1000000US060952521051001,060952521051001,"Block 1001, Block Group 1, Census Tract 2521.05, Solano County, California",18,18,0
1000000US060952521051002,060952521051002,"Block 1002, Block Group 1, Census Tract 2521.05, Solano County, California",12,12,0
1000000US060952521051003,060952521051003,"Block 1003, Block Group 1, Census Tract 2521.05, Solano County, California",32,31,1
1000000US060952521051004,060952521051004,"Block 1004, Block Group 1, Census Tract 2521.05, Solano County, California",17,17,0
1000000US060952521051005,060952521051005,"Block 1005, Block Group 1, Census Tract 2521.05, Solano County, California",43,41,2
1000000US060952521051006,060952521051006,"Block 1006, Block Group 1, Census Tract 2521.05, Solano County, California",33,28,5
1000000US060952521051007,060952521051007,"Block 1007, Block Group 1, Census Tract 2521.05, Solano County, California",60,58,2
1000000US060952521051008,060952521051008,"Block 1008, Block Group 1, Census Tract 2521.05, Solano County, California",50,50,0
1000000US060952521051009,060952521051009,"Block 1009, Block Group 1, Census Tract 2521.05, Solano County, California",7,7,0
1000000US060952521051010,060952521051010,"Block 1010, Block Group 1, Census Tract 2521.05, Solano County, California",64,63,1
1000000US060952521052000,060952521052000,"Block 2000, Block Group 2, Census Tract 2521.05, Solano County, California",73,72,1
1000000US060952521052001,060952521052001,"Block 2001, Block Group 2, Census Tract 2521.05, Solano County, California",63,58,5
1000000US060952521052002,060952521052002,"Block 2002, Block Group 2, Census Tract 2521.05, Solano County, California",354,327,27
1000000US060952521052003,060952521052003,"Block 2003, Block Group 2, Census Tract 2521.05, Solano County, California",0,0,0
1000000US060952521052004,060952521052004,"Block 2004, Block Group 2, Census Tract 2521.05, Solano County, California",56,51,5
1000000US060952521052005,060952521052005,"Block 2005, Block Group 2, Census Tract 2521.05, Solano County, California",40,39,1
1000000US060952521052006,060952521052006,"Block 2006, Block Group 2, Census Tract 2521.05, Solano County, California",0,0,0
1000000US060952521052007,060952521052007,"Block 2007, Block Group 2, Census Tract 2521.05, Solano County, California",0,0,0
1000000US060952521052008,060952521052008,"Block 2008, Block Group 2, Census Tract 2521.05, Solano County, California",0,0,0
1000000US060952521052009,060952521052009,"Block 2009, Block Group 2, Census Tract 2521.05, Solano County, California",0,0,0
1000000US060952521052010,060952521052010,"Block 2010, Block Group 2, Census Tract 2521.05, Solano County, California",31,30,1
1000000US060952521052011,060952521052011,"Block 2011, Block Group 2, Census Tract 2521.05, Solano County, California",8,8,0
1000000US060952521052012,060952521052012,"Block 2012, Block Group 2, Census Tract 2521.05, Solano County, California",0,0,0
1000000US060952521061000,060952521061000,"Block 1000, Block Group 1, Census Tract 2521.06, Solano County, California",329,321,8
1000000US060952521061001,060952521061001,"Block 1001, Block Group 1, Census Tract 2521.06, Solano County, California",18,18,0
1000000US060952521061002,060952521061002,"Block 1002, Block Group 1, Census Tract 2521.06, Solano County, California",49,48,1
1000000US060952521061003,060952521061003,"Block 1003, Block Group 1, Census Tract 2521.06, Solano County, California",102,98,4
1000000US060952521061004,060952521061004,"Block 1004, Block Group 1, Census Tract 2521.06, Solano County, California",15,15,0
1000000US060952521061005,060952521061005,"Block 1005, Block Group 1, Census Tract 2521.06, Solano County, California",20,20,0
1000000US060952521061006,060952521061006,"Block 1006, Block Group 1, Census Tract 2521.06, Solano County, California",17,16,1
1000000US060952521062000,060952521062000,"Block 2000, Block Group 2, Census Tract 2521.06, Solano County, California",130,125,5
1000000US060952521062001,060952521062001,"Block 2001, Block Group 2, Census Tract 2521.06, Solano County, California",12,12,0
1000000US060952521062002,060952521062002,"Block 2002, Block Group 2, Census Tract 2521.06, Solano County, California",34,34,0
1000000US060952521062003,060952521062003,"Block 2003, Block Group 2, Census Tract 2521.06, Solano County, California",39,38,1
1000000US060952521062004,060952521062004,"Block 2004, Block Group 2, Census Tract 2521.06, Solano County, California",32,30,2
1000000US060952521062005,060952521062005,"Block 2005, Block Group 2, Census Tract 2521.06, Solano County, California",48,48,0
1000000US060952521062006,060952521062006,"Block 2006, Block Group 2, Census Tract 2521.06, Solano County, California",70,67,3
1000000US060952521062007,060952521062007,"Block 2007, Block Group 2, Census Tract 2521.06, Solano County, California",54,54,0
1000000US060952521062008,060952521062008,"Block 2008, Block Group 2, Census Tract 2521.06, Solano County, California",47,46,1
1000000US060952521062009,060952521062009,"Block 2009, Block Group 2, Census Tract 2521.06, Solano County, California",0,0,0
1000000US060952521063000,060952521063000,"Block 3000, Block Group 3, Census Tract 2521.06, Solano County, California",187,180,7
1000000US060952521063001,060952521063001,"Block 3001, Block Group 3, Census Tract 2521.06, Solano County, California",13,13,0
1000000US060952521063002,060952521063002,"Block 3002, Block Group 3, Census Tract 2521.06, Solano County, California",401,364,37
1000000US060952521063003,060952521063003,"Block 3003, Block Group 3, Census Tract 2521.06, Solano County, California",0,0,0
1000000US060952521063004,060952521063004,"Block 3004, Block Group 3, Census Tract 2521.06, Solano County, California",0,0,0
1000000US060952521063005,060952521063005,"Block 3005, Block Group 3, Census Tract 2521.06, Solano County, California",31,31,0
1000000US060952521063006,060952521063006,"Block 3006, Block Group 3, Census Tract 2521.06, Solano County, California",0,0,0
1000000US060952521063007,060952521063007,"Block 3007, Block Group 3, Census Tract 2521.06, Solano County, California",32,28,4
1000000US060952521063008,060952521063008,"Block 3008, Block Group 3, Census Tract 2521.06, Solano County, California",0,0,0
1000000US060952521063009,060952521063009,"Block 3009, Block Group 3, Census Tract 2521.06, Solano County, California",7,6,1
1000000US060952521063010,060952521063010,"Block 3010, Block Group 3, Census Tract 2521.06, Solano County, California",32,32,0
1000000US060952521063011,060952521063011,"Block 3011, Block Group 3, Census Tract 2521.06, Solano County, California",0,0,0
1000000US060952521063012,060952521063012,"Block 3012, Block Group 3, Census Tract 2521.06, Solano County, California",0,0,0
1000000US060952521063013,060952521063013,"Block 3013, Block Group 3, Census Tract 2521.06, Solano County, California",0,0,0
1000000US060952521063014,060952521063014,"Block 3014, Block Group 3, Census Tract 2521.06, Solano County, California",5,5,0
1000000US060952521071000,060952521071000,"Block 1000, Block Group 1, Census Tract 2521.07, Solano County, California",342,328,14
1000000US060952521071001,060952521071001,"Block 1001, Block Group 1, Census Tract 2521.07, Solano County, California",18,18,0
1000000US060952521071002,060952521071002,"Block 1002, Block Group 1, Census Tract 2521.07, Solano County, California",24,24,0
1000000US060952521071003,060952521071003,"Block 1003, Block Group 1, Census Tract 2521.07, Solano County, California",28,28,0
1000000US060952521071004,060952521071004,"Block 1004, Block Group 1, Census Tract 2521.07, Solano County, California",164,147,17
1000000US060952521071005,060952521071005,"Block 1005, Block Group 1, Census Tract 2521.07, Solano County, California",11,11,0
1000000US060952521071006,060952521071006,"Block 1006, Block Group 1, Census Tract 2521.07, Solano County, California",256,238,18
1000000US060952521071007,060952521071007,"Block 1007, Block Group 1, Census Tract 2521.07, Solano County, California",2,2,0
1000000US060952521071008,060952521071008,"Block 1008, Block Group 1, Census Tract 2521.07, Solano County, California",66,62,4
1000000US060952521071009,060952521071009,"Block 1009, Block Group 1, Census Tract 2521.07, Solano County, California",1,1,0
1000000US060952521071010,060952521071010,"Block 1010, Block Group 1, Census Tract 2521.07, Solano County, California",8,7,1
1000000US060952521071011,060952521071011,"Block 1011, Block Group 1, Census Tract 2521.07, Solano County, California",0,0,0
1000000US060952521071012,060952521071012,"Block 1012, Block Group 1, Census Tract 2521.07, Solano County, California",0,0,0
1000000US060952521071013,060952521071013,"Block 1013, Block Group 1, Census Tract 2521.07, Solano County, California",0,0,0
1000000US060952521071014,060952521071014,"Block 1014, Block Group 1, Census Tract 2521.07, Solano County, California",0,0,0
1000000US060952521071015,060952521071015,"Block 1015, Block Group 1, Census Tract 2521.07, Solano County, California",19,19,0
1000000US060952521071016,060952521071016,"Block 1016, Block Group 1, Census Tract 2521.07, Solano County, California",20,19,1
1000000US060952521072000,060952521072000,"Block 2000, Block Group 2, Census Tract 2521.07, Solano County, California",66,64,2
1000000US060952521072001,060952521072001,"Block 2001, Block Group 2, Census Tract 2521.07, Solano County, California",58,56,2
1000000US060952521072002,060952521072002,"Block 2002, Block Group 2, Census Tract 2521.07, Solano County, California",44,43,1
1000000US060952521072003,060952521072003,"Block 2003, Block Group 2, Census Tract 2521.07, Solano County, California",43,43,0
1000000US060952521072004,060952521072004,"Block 2004, Block Group 2, Census Tract 2521.07, Solano County, California",34,34,0
1000000US060952521072005,060952521072005,"Block 2005, Block Group 2, Census Tract 2521.07, Solano County, California",47,45,2
1000000US060952521072006,060952521072006,"Block 2006, Block Group 2, Census Tract 2521.07, Solano County, California",43,43,0
1000000US060952521072007,060952521072007,"Block 2007, Block Group 2, Census Tract 2521.07, Solano County, California",31,31,0
1000000US060952521072008,060952521072008,"Block 2008, Block Group 2, Census Tract 2521.07, Solano County, California",35,33,2
1000000US060952521072009,060952521072009,"Block 2009, Block Group 2, Census Tract 2521.07, Solano County, California",63,63,0
1000000US060952521072010,060952521072010,"Block 2010, Block Group 2, Census Tract 2521.07, Solano County, California",35,32,3
1000000US060952521072011,060952521072011,"Block 2011, Block Group 2, Census Tract 2521.07, Solano County, California",12,12,0
1000000US060952521081000,060952521081000,"Block 1000, Block Group 1, Census Tract 2521.08, Solano County, California",0,0,0
1000000US060952521081001,060952521081001,"Block 1001, Block Group 1, Census Tract 2521.08, Solano County, California",93,91,2
1000000US060952521081002,060952521081002,"Block 1002, Block Group 1, Census Tract 2521.08, Solano County, California",8,8,0
1000000US060952521081003,060952521081003,"Block 1003, Block Group 1, Census Tract 2521.08, Solano County, California",0,0,0
1000000US060952521081004,060952521081004,"Block 1004, Block Group 1, Census Tract 2521.08, Solano County, California",10,9,1
1000000US060952521081005,060952521081005,"Block 1005, Block Group 1, Census Tract 2521.08, Solano County, California",0,0,0
1000000US060952521081006,060952521081006,"Block 1006, Block Group 1, Census Tract 2521.08, Solano County, California",3,2,1
1000000US060952521081007,060952521081007,"Block 1007, Block Group 1, Census Tract 2521.08, Solano County, California",0,0,0
1000000US060952521081008,060952521081008,"Block 1008, Block Group 1, Census Tract 2521.08, Solano County, California",8,8,0
1000000US060952521081009,060952521081009,"Block 1009, Block Group 1, Census Tract 2521.08, Solano County, California",62,59,3
1000000US060952521081010,060952521081010,"Block 1010, Block Group 1, Census Tract 2521.08, Solano County, California",10,9,1
1000000US060952521081011,060952521081011,"Block 1011, Block Group 1, Census Tract 2521.08, Solano County, California",8,8,0
1000000US060952521081012,060952521081012,"Block 1012, Block Group 1, Census Tract 2521.08, Solano County, California",160,153,7
1000000US060952521081013,060952521081013,"Block 1013, Block Group 1, Census Tract 2521.08, Solano County, California",32,30,2
1000000US060952521081014,060952521081014,"Block 1014, Block Group 1, Census Tract 2521.08, Solano County, California",13,13,0
1000000US060952521081015,060952521081015,"Block 1015, Block Group 1, Census Tract 2521.08, Solano County, California",38,38,0
1000000US060952521081016,060952521081016,"Block 1016, Block Group 1, Census Tract 2521.08, Solano County, California",20,20,0
1000000US060952521081017,060952521081017,"Block 1017, Block Group 1, Census Tract 2521.08, Solano County, California",8,8,0
1000000US060952521081018,060952521081018,"Block 1018, Block Group 1, Census Tract 2521.08, Solano County, California",9,9,0
1000000US060952521081019,060952521081019,"Block 1019, Block Group 1, Census Tract 2521.08, Solano County, California",12,11,1
1000000US060952521081020,060952521081020,"Block 1020, Block Group 1, Census Tract 2521.08, Solano County, California",17,16,1
1000000US060952521081021,060952521081021,"Block 1021, Block Group 1, Census Tract 2521.08, Solano County, California",32,31,1
1000000US060952521081022,060952521081022,"Block 1022, Block Group 1, Census Tract 2521.08, Solano County, California",9,9,0
1000000US060952521081023,060952521081023,"Block 1023, Block Group 1, Census Tract 2521.08, Solano County, California",0,0,0
1000000US060952521081024,060952521081024,"Block 1024, Block Group 1, Census Tract 2521.08, Solano County, California",8,7,1
1000000US060952521081025,060952521081025,"Block 1025, Block Group 1, Census Tract 2521.08, Solano County, California",0,0,0
1000000US060952521081026,060952521081026,"Block 1026, Block Group 1, Census Tract 2521.08, Solano County, California",0,0,0
1000000US060952521081027,060952521081027,"Block 1027, Block Group 1, Census Tract 2521.08, Solano County, California",13,12,1
1000000US060952521081028,060952521081028,"Block 1028, Block Group 1, Census Tract 2521.08, Solano County, California",0,0,0
1000000US060952521081029,060952521081029,"Block 1029, Block Group 1, Census Tract 2521.08, Solano County, California",0,0,0
1000000US060952521082000,060952521082000,"Block 2000, Block Group 2, Census Tract 2521.08, Solano County, California",410,388,22
1000000US060952521082001,060952521082001,"Block 2001, Block Group 2, Census Tract 2521.08, Solano County, California",44,43,1
1000000US060952521082002,060952521082002,"Block 2002, Block Group 2, Census Tract 2521.08, Solano County, California",38,37,1
1000000US060952521082003,060952521082003,"Block 2003, Block Group 2, Census Tract 2521.08, Solano County, California",38,35,3
1000000US060952521082004,060952521082004,"Block 2004, Block Group 2, Census Tract 2521.08, Solano County, California",50,46,4
1000000US060952521082005,060952521082005,"Block 2005, Block Group 2, Census Tract 2521.08, Solano County, California",23,21,2
1000000US060952521082006,060952521082006,"Block 2006, Block Group 2, Census Tract 2521.08, Solano County, California",0,0,0
1000000US060952521082007,060952521082007,"Block 2007, Block Group 2, Census Tract 2521.08, Solano County, California",66,65,1
1000000US060952521082008,060952521082008,"Block 2008, Block Group 2, Census Tract 2521.08, Solano County, California",10,9,1
1000000US060952521082009,060952521082009,"Block 2009, Block Group 2, Census Tract 2521.08, Solano County, California",18,15,3
1000000US060952521082010,060952521082010,"Block 2010, Block Group 2, Census Tract 2521.08, Solano County, California",31,31,0
1000000US060952522011000,060952522011000,"Block 1000, Block Group 1, Census Tract 2522.01, Solano County, California",4,4,0
1000000US060952522011001,060952522011001,"Block 1001, Block Group 1, Census Tract 2522.01, Solano County, California",1,1,0
1000000US060952522011002,060952522011002,"Block 1002, Block Group 1, Census Tract 2522.01, Solano County, California",0,0,0
1000000US060952522011003,060952522011003,"Block 1003, Block Group 1, Census Tract 2522.01, Solano County, California",0,0,0
1000000US060952522011004,060952522011004,"Block 1004, Block Group 1, Census Tract 2522.01, Solano County, California",2,2,0
1000000US060952522011005,060952522011005,"Block 1005, Block Group 1, Census Tract 2522.01, Solano County, California",0,0,0
1000000US060952522011006,060952522011006,"Block 1006, Block Group 1, Census Tract 2522.01, Solano County, California",4,3,1
1000000US060952522011007,060952522011007,"Block 1007, Block Group 1, Census Tract 2522.01, Solano County, California",2,1,1
1000000US060952522011008,060952522011008,"Block 1008, Block Group 1, Census Tract 2522.01, Solano County, California",0,0,0
1000000US060952522011009,060952522011009,"Block 1009, Block Group 1, Census Tract 2522.01, Solano County, California",0,0,0
1000000US060952522011010,060952522011010,"Block 1010, Block Group 1, Census Tract 2522.01, Solano County, California",0,0,0
1000000US060952522011011,060952522011011,"Block 1011, Block Group 1, Census Tract 2522.01, Solano County, California",2,2,0
1000000US060952522011012,060952522011012,"Block 1012, Block Group 1, Census Tract 2522.01, Solano County, California",0,0,0
1000000US060952522011013,060952522011013,"Block 1013, Block Group 1, Census Tract 2522.01, Solano County, California",1,0,1
1000000US060952522011014,060952522011014,"Block 1014, Block Group 1, Census Tract 2522.01, Solano County, California",0,0,0
1000000US060952522011015,060952522011015,"Block 1015, Block Group 1, Census Tract 2522.01, Solano County, California",38,32,6
1000000US060952522011016,060952522011016,"Block 1016, Block Group 1, Census Tract 2522.01, Solano County, California",0,0,0
1000000US060952522011017,060952522011017,"Block 1017, Block Group 1, Census Tract 2522.01, Solano County, California",2,2,0
1000000US060952522011018,060952522011018,"Block 1018, Block Group 1, Census Tract 2522.01, Solano County, California",0,0,0
1000000US060952522011019,060952522011019,"Block 1019, Block Group 1, Census Tract 2522.01, Solano County, California",0,0,0
1000000US060952522011020,060952522011020,"Block 1020, Block Group 1, Census Tract 2522.01, Solano County, California",0,0,0
1000000US060952522011021,060952522011021,"Block 1021, Block Group 1, Census Tract 2522.01, Solano County, California",0,0,0
1000000US060952522011022,060952522011022,"Block 1022, Block Group 1, Census Tract 2522.01, Solano County, California",0,0,0
1000000US060952522011023,060952522011023,"Block 1023, Block Group 1, Census Tract 2522.01, Solano County, California",1,1,0
1000000US060952522011024,060952522011024,"Block 1024, Block Group 1, Census Tract 2522.01, Solano County, California",1,1,0
1000000US060952522011025,060952522011025,"Block 1025, Block Group 1, Census Tract 2522.01, Solano County, California",0,0,0
1000000US060952522011026,060952522011026,"Block 1026, Block Group 1, Census Tract 2522.01, Solano County, California",3,0,3
1000000US060952522011027,060952522011027,"Block 1027, Block Group 1, Census Tract 2522.01, Solano County, California",56,51,5
1000000US060952522011028,060952522011028,"Block 1028, Block Group 1, Census Tract 2522.01, Solano County, California",0,0,0
1000000US060952522011029,060952522011029,"Block 1029, Block Group 1, Census Tract 2522.01, Solano County, California",6,6,0
1000000US060952522011030,060952522011030,"Block 1030, Block Group 1, Census Tract 2522.01, Solano County, California",2,2,0
1000000US060952522011031,060952522011031,"Block 1031, Block Group 1, Census Tract 2522.01, Solano County, California",1,1,0
1000000US060952522011032,060952522011032,"Block 1032, Block Group 1, Census Tract 2522.01, Solano County, California",11,10,1
1000000US060952522011033,060952522011033,"Block 1033, Block Group 1, Census Tract 2522.01, Solano County, California",0,0,0
1000000US060952522011034,060952522011034,"Block 1034, Block Group 1, Census Tract 2522.01, Solano County, California",8,7,1
1000000US060952522011035,060952522011035,"Block 1035, Block Group 1, Census Tract 2522.01, Solano County, California",3,2,1
1000000US060952522011036,060952522011036,"Block 1036, Block Group 1, Census Tract 2522.01, Solano County, California",1,0,1
1000000US060952522011037,060952522011037,"Block 1037, Block Group 1, Census Tract 2522.01, Solano County, California",5,4,1
1000000US060952522011038,060952522011038,"Block 1038, Block Group 1, Census Tract 2522.01, Solano County, California",3,3,0
1000000US060952522011039,060952522011039,"Block 1039, Block Group 1, Census Tract 2522.01, Solano County, California",162,150,12
1000000US060952522011040,060952522011040,"Block 1040, Block Group 1, Census Tract 2522.01, Solano County, California",30,28,2
1000000US060952522011041,060952522011041,"Block 1041, Block Group 1, Census Tract 2522.01, Solano County, California",6,6,0
1000000US060952522011042,060952522011042,"Block 1042, Block Group 1, Census Tract 2522.01, Solano County, California",16,15,1
1000000US060952522011043,060952522011043,"Block 1043, Block Group 1, Census Tract 2522.01, Solano County, California",1,1,0
1000000US060952522011044,060952522011044,"Block 1044, Block Group 1, Census Tract 2522.01, Solano County, California",18,14,4
1000000US060952522011045,060952522011045,"Block 1045, Block Group 1, Census Tract 2522.01, Solano County, California",0,0,0
1000000US060952522011046,060952522011046,"Block 1046, Block Group 1, Census Tract 2522.01, Solano County, California",0,0,0
1000000US060952522011047,060952522011047,"Block 1047, Block Group 1, Census Tract 2522.01, Solano County, California",26,21,5
1000000US060952522011048,060952522011048,"Block 1048, Block Group 1, Census Tract 2522.01, Solano County, California",1,1,0
1000000US060952522011049,060952522011049,"Block 1049, Block Group 1, Census Tract 2522.01, Solano County, California",0,0,0
1000000US060952522011050,060952522011050,"Block 1050, Block Group 1, Census Tract 2522.01, Solano County, California",144,113,31
1000000US060952522011051,060952522011051,"Block 1051, Block Group 1, Census Tract 2522.01, Solano County, California",0,0,0
1000000US060952522011052,060952522011052,"Block 1052, Block Group 1, Census Tract 2522.01, Solano County, California",33,30,3
1000000US060952522011053,060952522011053,"Block 1053, Block Group 1, Census Tract 2522.01, Solano County, California",14,12,2
1000000US060952522011054,060952522011054,"Block 1054, Block Group 1, Census Tract 2522.01, Solano County, California",28,25,3
1000000US060952522011055,060952522011055,"Block 1055, Block Group 1, Census Tract 2522.01, Solano County, California",0,0,0
1000000US060952522011056,060952522011056,"Block 1056, Block Group 1, Census Tract 2522.01, Solano County, California",0,0,0
1000000US060952522011057,060952522011057,"Block 1057, Block Group 1, Census Tract 2522.01, Solano County, California",0,0,0
1000000US060952522011058,060952522011058,"Block 1058, Block Group 1, Census Tract 2522.01, Solano County, California",0,0,0
1000000US060952522011059,060952522011059,"Block 1059, Block Group 1, Census Tract 2522.01, Solano County, California",0,0,0
1000000US060952522011060,060952522011060,"Block 1060, Block Group 1, Census Tract 2522.01, Solano County, California",0,0,0
1000000US060952522011061,060952522011061,"Block 1061, Block Group 1, Census Tract 2522.01, Solano County, California",19,18,1
1000000US060952522011062,060952522011062,"Block 1062, Block Group 1, Census Tract 2522.01, Solano County, California",0,0,0
1000000US060952522011063,060952522011063,"Block 1063, Block Group 1, Census Tract 2522.01, Solano County, California",0,0,0
1000000US060952522011064,060952522011064,"Block 1064, Block Group 1, Census Tract 2522.01, Solano County, California",0,0,0
1000000US060952522011065,060952522011065,"Block 1065, Block Group 1, Census Tract 2522.01, Solano County, California",0,0,0
1000000US060952522011066,060952522011066,"Block 1066, Block Group 1, Census Tract 2522.01, Solano County, California",0,0,0
1000000US060952522011067,060952522011067,"Block 1067, Block Group 1, Census Tract 2522.01, Solano County, California",0,0,0
1000000US060952522011068,060952522011068,"Block 1068, Block Group 1, Census Tract 2522.01, Solano County, California",0,0,0
1000000US060952522011069,060952522011069,"Block 1069, Block Group 1, Census Tract 2522.01, Solano County, California",0,0,0
1000000US060952522011070,060952522011070,"Block 1070, Block Group 1, Census Tract 2522.01, Solano County, California",0,0,0
1000000US060952522011071,060952522011071,"Block 1071, Block Group 1, Census Tract 2522.01, Solano County, California",2,2,0
1000000US060952522011072,060952522011072,"Block 1072, Block Group 1, Census Tract 2522.01, Solano County, California",0,0,0
1000000US060952522011073,060952522011073,"Block 1073, Block Group 1, Census Tract 2522.01, Solano County, California",0,0,0
1000000US060952522011074,060952522011074,"Block 1074, Block Group 1, Census Tract 2522.01, Solano County, California",99,97,2
1000000US060952522011075,060952522011075,"Block 1075, Block Group 1, Census Tract 2522.01, Solano County, California",13,12,1
1000000US060952522011076,060952522011076,"Block 1076, Block Group 1, Census Tract 2522.01, Solano County, California",25,23,2
1000000US060952522011077,060952522011077,"Block 1077, Block Group 1, Census Tract 2522.01, Solano County, California",14,13,1
1000000US060952522011078,060952522011078,"Block 1078, Block Group 1, Census Tract 2522.01, Solano County, California",89,85,4
1000000US060952522011079,060952522011079,"Block 1079, Block Group 1, Census Tract 2522.01, Solano County, California",41,39,2
1000000US060952522011080,060952522011080,"Block 1080, Block Group 1, Census Tract 2522.01, Solano County, California",16,16,0
1000000US060952522011081,060952522011081,"Block 1081, Block Group 1, Census Tract 2522.01, Solano County, California",123,122,1
1000000US060952522011082,060952522011082,"Block 1082, Block Group 1, Census Tract 2522.01, Solano County, California",3,3,0
1000000US060952522011083,060952522011083,"Block 1083, Block Group 1, Census Tract 2522.01, Solano County, California",0,0,0
1000000US060952522011084,060952522011084,"Block 1084, Block Group 1, Census Tract 2522.01, Solano County, California",0,0,0
1000000US060952522011085,060952522011085,"Block 1085, Block Group 1, Census Tract 2522.01, Solano County, California",0,0,0
1000000US060952522011086,060952522011086,"Block 1086, Block Group 1, Census Tract 2522.01, Solano County, California",0,0,0
1000000US060952522011087,060952522011087,"Block 1087, Block Group 1, Census Tract 2522.01, Solano County, California",94,81,13
1000000US060952522011088,060952522011088,"Block 1088, Block Group 1, Census Tract 2522.01, Solano County, California",54,51,3
1000000US060952522011089,060952522011089,"Block 1089, Block Group 1, Census Tract 2522.01, Solano County, California",0,0,0
1000000US060952522011090,060952522011090,"Block 1090, Block Group 1, Census Tract 2522.01, Solano County, California",0,0,0
1000000US060952522011091,060952522011091,"Block 1091, Block Group 1, Census Tract 2522.01, Solano County, California",0,0,0
1000000US060952522011092,060952522011092,"Block 1092, Block Group 1, Census Tract 2522.01, Solano County, California",0,0,0
1000000US060952522011093,060952522011093,"Block 1093, Block Group 1, Census Tract 2522.01, Solano County, California",0,0,0
1000000US060952522011094,060952522011094,"Block 1094, Block Group 1, Census Tract 2522.01, Solano County, California",0,0,0
1000000US060952522011095,060952522011095,"Block 1095, Block Group 1, Census Tract 2522.01, Solano County, California",0,0,0
1000000US060952522011096,060952522011096,"Block 1096, Block Group 1, Census Tract 2522.01, Solano County, California",0,0,0
1000000US060952522011097,060952522011097,"Block 1097, Block Group 1, Census Tract 2522.01, Solano County, California",0,0,0
1000000US060952522011098,060952522011098,"Block 1098, Block Group 1, Census Tract 2522.01, Solano County, California",0,0,0
1000000US060952522011099,060952522011099,"Block 1099, Block Group 1, Census Tract 2522.01, Solano County, California",0,0,0
1000000US060952522011100,060952522011100,"Block 1100, Block Group 1, Census Tract 2522.01, Solano County, California",0,0,0
1000000US060952522011101,060952522011101,"Block 1101, Block Group 1, Census Tract 2522.01, Solano County, California",0,0,0
1000000US060952522011102,060952522011102,"Block 1102, Block Group 1, Census Tract 2522.01, Solano County, California",38,37,1
1000000US060952522011103,060952522011103,"Block 1103, Block Group 1, Census Tract 2522.01, Solano County, California",38,31,7
1000000US060952522011104,060952522011104,"Block 1104, Block Group 1, Census Tract 2522.01, Solano County, California",3,3,0
1000000US060952522012000,060952522012000,"Block 2000, Block Group 2, Census Tract 2522.01, Solano County, California",11,11,0
1000000US060952522012001,060952522012001,"Block 2001, Block Group 2, Census Tract 2522.01, Solano County, California",0,0,0
1000000US060952522012002,060952522012002,"Block 2002, Block Group 2, Census Tract 2522.01, Solano County, California",0,0,0
1000000US060952522012003,060952522012003,"Block 2003, Block Group 2, Census Tract 2522.01, Solano County, California",0,0,0
1000000US060952522012004,060952522012004,"Block 2004, Block Group 2, Census Tract 2522.01, Solano County, California",18,18,0
1000000US060952522012005,060952522012005,"Block 2005, Block Group 2, Census Tract 2522.01, Solano County, California",0,0,0
1000000US060952522012006,060952522012006,"Block 2006, Block Group 2, Census Tract 2522.01, Solano County, California",0,0,0
1000000US060952522012007,060952522012007,"Block 2007, Block Group 2, Census Tract 2522.01, Solano County, California",5,4,1
1000000US060952522012008,060952522012008,"Block 2008, Block Group 2, Census Tract 2522.01, Solano County, California",0,0,0
1000000US060952522012009,060952522012009,"Block 2009, Block Group 2, Census Tract 2522.01, Solano County, California",1,1,0
1000000US060952522012010,060952522012010,"Block 2010, Block Group 2, Census Tract 2522.01, Solano County, California",1,1,0
1000000US060952522012011,060952522012011,"Block 2011, Block Group 2, Census Tract 2522.01, Solano County, California",5,5,0
1000000US060952522012012,060952522012012,"Block 2012, Block Group 2, Census Tract 2522.01, Solano County, California",0,0,0
1000000US060952522012013,060952522012013,"Block 2013, Block Group 2, Census Tract 2522.01, Solano County, California",0,0,0
1000000US060952522012014,060952522012014,"Block 2014, Block Group 2, Census Tract 2522.01, Solano County, California",21,20,1
1000000US060952522012015,060952522012015,"Block 2015, Block Group 2, Census Tract 2522.01, Solano County, California",2,2,0
1000000US060952522012016,060952522012016,"Block 2016, Block Group 2, Census Tract 2522.01, Solano County, California",0,0,0
1000000US060952522012017,060952522012017,"Block 2017, Block Group 2, Census Tract 2522.01, Solano County, California",0,0,0
1000000US060952522012018,060952522012018,"Block 2018, Block Group 2, Census Tract 2522.01, Solano County, California",0,0,0
1000000US060952522012019,060952522012019,"Block 2019, Block Group 2, Census Tract 2522.01, Solano County, California",0,0,0
1000000US060952522012020,060952522012020,"Block 2020, Block Group 2, Census Tract 2522.01, Solano County, California",1,1,0
1000000US060952522012021,060952522012021,"Block 2021, Block Group 2, Census Tract 2522.01, Solano County, California",20,20,0
1000000US060952522012022,060952522012022,"Block 2022, Block Group 2, Census Tract 2522.01, Solano County, California",10,9,1
1000000US060952522012023,060952522012023,"Block 2023, Block Group 2, Census Tract 2522.01, Solano County, California",36,33,3
1000000US060952522012024,060952522012024,"Block 2024, Block Group 2, Census Tract 2522.01, Solano County, California",0,0,0
1000000US060952522012025,060952522012025,"Block 2025, Block Group 2, Census Tract 2522.01, Solano County, California",1,1,0
1000000US060952522012026,060952522012026,"Block 2026, Block Group 2, Census Tract 2522.01, Solano County, California",0,0,0
1000000US060952522012027,060952522012027,"Block 2027, Block Group 2, Census Tract 2522.01, Solano County, California",0,0,0
1000000US060952522012028,060952522012028,"Block 2028, Block Group 2, Census Tract 2522.01, Solano County, California",3,3,0
1000000US060952522012029,060952522012029,"Block 2029, Block Group 2, Census Tract 2522.01, Solano County, California",2,1,1
1000000US060952522012030,060952522012030,"Block 2030, Block Group 2, Census Tract 2522.01, Solano County, California",15,15,0
1000000US060952522012031,060952522012031,"Block 2031, Block Group 2, Census Tract 2522.01, Solano County, California",4,2,2
1000000US060952522012032,060952522012032,"Block 2032, Block Group 2, Census Tract 2522.01, Solano County, California",27,27,0
1000000US060952522012033,060952522012033,"Block 2033, Block Group 2, Census Tract 2522.01, Solano County, California",5,4,1
1000000US060952522012034,060952522012034,"Block 2034, Block Group 2, Census Tract 2522.01, Solano County, California",6,6,0
1000000US060952522012035,060952522012035,"Block 2035, Block Group 2, Census Tract 2522.01, Solano County, California",28,27,1
1000000US060952522012036,060952522012036,"Block 2036, Block Group 2, Census Tract 2522.01, Solano County, California",14,14,0
1000000US060952522012037,060952522012037,"Block 2037, Block Group 2, Census Tract 2522.01, Solano County, California",15,14,1
1000000US060952522012038,060952522012038,"Block 2038, Block Group 2, Census Tract 2522.01, Solano County, California",0,0,0
1000000US060952522012039,060952522012039,"Block 2039, Block Group 2, Census Tract 2522.01, Solano County, California",3,3,0
1000000US060952522012040,060952522012040,"Block 2040, Block Group 2, Census Tract 2522.01, Solano County, California",11,11,0
1000000US060952522012041,060952522012041,"Block 2041, Block Group 2, Census Tract 2522.01, Solano County, California",17,14,3
1000000US060952522012042,060952522012042,"Block 2042, Block Group 2, Census Tract 2522.01, Solano County, California",6,6,0
1000000US060952522012043,060952522012043,"Block 2043, Block Group 2, Census Tract 2522.01, Solano County, California",0,0,0
1000000US060952522013000,060952522013000,"Block 3000, Block Group 3, Census Tract 2522.01, Solano County, California",0,0,0
1000000US060952522013001,060952522013001,"Block 3001, Block Group 3, Census Tract 2522.01, Solano County, California",0,0,0
1000000US060952522013002,060952522013002,"Block 3002, Block Group 3, Census Tract 2522.01, Solano County, California",0,0,0
1000000US060952522013003,060952522013003,"Block 3003, Block Group 3, Census Tract 2522.01, Solano County, California",0,0,0
1000000US060952522013004,060952522013004,"Block 3004, Block Group 3, Census Tract 2522.01, Solano County, California",0,0,0
1000000US060952522013005,060952522013005,"Block 3005, Block Group 3, Census Tract 2522.01, Solano County, California",0,0,0
1000000US060952522013006,060952522013006,"Block 3006, Block Group 3, Census Tract 2522.01, Solano County, California",0,0,0
1000000US060952522013007,060952522013007,"Block 3007, Block Group 3, Census Tract 2522.01, Solano County, California",0,0,0
1000000US060952522013008,060952522013008,"Block 3008, Block Group 3, Census Tract 2522.01, Solano County, California",0,0,0
1000000US060952522013009,060952522013009,"Block 3009, Block Group 3, Census Tract 2522.01, Solano County, California",0,0,0
1000000US060952522013010,060952522013010,"Block 3010, Block Group 3, Census Tract 2522.01, Solano County, California",0,0,0
1000000US060952522013011,060952522013011,"Block 3011, Block Group 3, Census Tract 2522.01, Solano County, California",0,0,0
1000000US060952522013012,060952522013012,"Block 3012, Block Group 3, Census Tract 2522.01, Solano County, California",0,0,0
1000000US060952522013013,060952522013013,"Block 3013, Block Group 3, Census Tract 2522.01, Solano County, California",0,0,0
1000000US060952522013014,060952522013014,"Block 3014, Block Group 3, Census Tract 2522.01, Solano County, California",0,0,0
1000000US060952522013015,060952522013015,"Block 3015, Block Group 3, Census Tract 2522.01, Solano County, California",76,68,8
1000000US060952522013016,060952522013016,"Block 3016, Block Group 3, Census Tract 2522.01, Solano County, California",3,3,0
1000000US060952522013017,060952522013017,"Block 3017, Block Group 3, Census Tract 2522.01, Solano County, California",9,9,0
1000000US060952522013018,060952522013018,"Block 3018, Block Group 3, Census Tract 2522.01, Solano County, California",0,0,0
1000000US060952522013019,060952522013019,"Block 3019, Block Group 3, Census Tract 2522.01, Solano County, California",70,64,6
1000000US060952522013020,060952522013020,"Block 3020, Block Group 3, Census Tract 2522.01, Solano County, California",6,5,1
1000000US060952522013021,060952522013021,"Block 3021, Block Group 3, Census Tract 2522.01, Solano County, California",7,6,1
1000000US060952522013022,060952522013022,"Block 3022, Block Group 3, Census Tract 2522.01, Solano County, California",3,3,0
1000000US060952522013023,060952522013023,"Block 3023, Block Group 3, Census Tract 2522.01, Solano County, California",1,1,0
1000000US060952522013024,060952522013024,"Block 3024, Block Group 3, Census Tract 2522.01, Solano County, California",0,0,0
1000000US060952522013025,060952522013025,"Block 3025, Block Group 3, Census Tract 2522.01, Solano County, California",0,0,0
1000000US060952522013026,060952522013026,"Block 3026, Block Group 3, Census Tract 2522.01, Solano County, California",0,0,0
1000000US060952522013027,060952522013027,"Block 3027, Block Group 3, Census Tract 2522.01, Solano County, California",0,0,0
1000000US060952522013028,060952522013028,"Block 3028, Block Group 3, Census Tract 2522.01, Solano County, California",0,0,0
1000000US060952522013029,060952522013029,"Block 3029, Block Group 3, Census Tract 2522.01, Solano County, California",0,0,0
1000000US060952522013030,060952522013030,"Block 3030, Block Group 3, Census Tract 2522.01, Solano County, California",0,0,0
1000000US060952522013031,060952522013031,"Block 3031, Block Group 3, Census Tract 2522.01, Solano County, California",5,5,0
1000000US060952522013032,060952522013032,"Block 3032, Block Group 3, Census Tract 2522.01, Solano County, California",1,1,0
1000000US060952522013033,060952522013033,"Block 3033, Block Group 3, Census Tract 2522.01, Solano County, California",0,0,0
1000000US060952522013034,060952522013034,"Block 3034, Block Group 3, Census Tract 2522.01, Solano County, California",0,0,0
1000000US060952522013035,060952522013035,"Block 3035, Block Group 3, Census Tract 2522.01, Solano County, California",104,98,6
1000000US060952522013036,060952522013036,"Block 3036, Block Group 3, Census Tract 2522.01, Solano County, California",10,8,2
1000000US060952522013037,060952522013037,"Block 3037, Block Group 3, Census Tract 2522.01, Solano County, California",10,10,0
1000000US060952522014000,060952522014000,"Block 4000, Block Group 4, Census Tract 2522.01, Solano County, California",3,3,0
1000000US060952522014001,060952522014001,"Block 4001, Block Group 4, Census Tract 2522.01, Solano County, California",101,96,5
1000000US060952522014002,060952522014002,"Block 4002, Block Group 4, Census Tract 2522.01, Solano County, California",32,32,0
1000000US060952522014003,060952522014003,"Block 4003, Block Group 4, Census Tract 2522.01, Solano County, California",11,10,1
1000000US060952522014004,060952522014004,"Block 4004, Block Group 4, Census Tract 2522.01, Solano County, California",10,10,0
1000000US060952522014005,060952522014005,"Block 4005, Block Group 4, Census Tract 2522.01, Solano County, California",3,2,1
1000000US060952522014006,060952522014006,"Block 4006, Block Group 4, Census Tract 2522.01, Solano County, California",1,1,0
1000000US060952522014007,060952522014007,"Block 4007, Block Group 4, Census Tract 2522.01, Solano County, California",0,0,0
1000000US060952522014008,060952522014008,"Block 4008, Block Group 4, Census Tract 2522.01, Solano County, California",13,13,0
1000000US060952522014009,060952522014009,"Block 4009, Block Group 4, Census Tract 2522.01, Solano County, California",11,10,1
1000000US060952522014010,060952522014010,"Block 4010, Block Group 4, Census Tract 2522.01, Solano County, California",79,74,5
1000000US060952522014011,060952522014011,"Block 4011, Block Group 4, Census Tract 2522.01, Solano County, California",35,33,2
1000000US060952522014012,060952522014012,"Block 4012, Block Group 4, Census Tract 2522.01, Solano County, California",0,0,0
1000000US060952522014013,060952522014013,"Block 4013, Block Group 4, Census Tract 2522.01, Solano County, California",0,0,0
1000000US060952522014014,060952522014014,"Block 4014, Block Group 4, Census Tract 2522.01, Solano County, California",6,5,1
1000000US060952522014015,060952522014015,"Block 4015, Block Group 4, Census Tract 2522.01, Solano County, California",2,2,0
1000000US060952522014016,060952522014016,"Block 4016, Block Group 4, Census Tract 2522.01, Solano County, California",0,0,0
1000000US060952522014017,060952522014017,"Block 4017, Block Group 4, Census Tract 2522.01, Solano County, California",1,1,0
1000000US060952522014018,060952522014018,"Block 4018, Block Group 4, Census Tract 2522.01, Solano County, California",0,0,0
1000000US060952522014019,060952522014019,"Block 4019, Block Group 4, Census Tract 2522.01, Solano County, California",1,1,0
1000000US060952522014020,060952522014020,"Block 4020, Block Group 4, Census Tract 2522.01, Solano County, California",0,0,0
1000000US060952522014021,060952522014021,"Block 4021, Block Group 4, Census Tract 2522.01, Solano County, California",1,1,0
1000000US060952522014022,060952522014022,"Block 4022, Block Group 4, Census Tract 2522.01, Solano County, California",0,0,0
1000000US060952522014023,060952522014023,"Block 4023, Block Group 4, Census Tract 2522.01, Solano County, California",0,0,0
1000000US060952522014024,060952522014024,"Block 4024, Block Group 4, Census Tract 2522.01, Solano County, California",48,40,8
1000000US060952522014025,060952522014025,"Block 4025, Block Group 4, Census Tract 2522.01, Solano County, California",0,0,0
1000000US060952522014026,060952522014026,"Block 4026, Block Group 4, Census Tract 2522.01, Solano County, California",1,1,0
1000000US060952522014027,060952522014027,"Block 4027, Block Group 4, Census Tract 2522.01, Solano County, California",0,0,0
1000000US060952522014028,060952522014028,"Block 4028, Block Group 4, Census Tract 2522.01, Solano County, California",0,0,0
1000000US060952522014029,060952522014029,"Block 4029, Block Group 4, Census Tract 2522.01, Solano County, California",7,6,1
1000000US060952522014030,060952522014030,"Block 4030, Block Group 4, Census Tract 2522.01, Solano County, California",92,92,0
1000000US060952522014031,060952522014031,"Block 4031, Block Group 4, Census Tract 2522.01, Solano County, California",34,34,0
1000000US060952522014032,060952522014032,"Block 4032, Block Group 4, Census Tract 2522.01, Solano County, California",2,1,1
1000000US060952522014033,060952522014033,"Block 4033, Block Group 4, Census Tract 2522.01, Solano County, California",0,0,0
1000000US060952522014034,060952522014034,"Block 4034, Block Group 4, Census Tract 2522.01, Solano County, California",0,0,0
1000000US060952522014035,060952522014035,"Block 4035, Block Group 4, Census Tract 2522.01, Solano County, California",115,102,13
1000000US060952522014036,060952522014036,"Block 4036, Block Group 4, Census Tract 2522.01, Solano County, California",0,0,0
1000000US060952522014037,060952522014037,"Block 4037, Block Group 4, Census Tract 2522.01, Solano County, California",0,0,0
1000000US060952522014038,060952522014038,"Block 4038, Block Group 4, Census Tract 2522.01, Solano County, California",0,0,0
1000000US060952522014039,060952522014039,"Block 4039, Block Group 4, Census Tract 2522.01, Solano County, California",0,0,0
1000000US060952522014040,060952522014040,"Block 4040, Block Group 4, Census Tract 2522.01, Solano County, California",0,0,0
1000000US060952522014041,060952522014041,"Block 4041, Block Group 4, Census Tract 2522.01, Solano County, California",0,0,0
1000000US060952522014042,060952522014042,"Block 4042, Block Group 4, Census Tract 2522.01, Solano County, California",34,32,2
1000000US060952522014043,060952522014043,"Block 4043, Block Group 4, Census Tract 2522.01, Solano County, California",0,0,0
1000000US060952522014044,060952522014044,"Block 4044, Block Group 4, Census Tract 2522.01, Solano County, California",1,1,0
1000000US060952522014045,060952522014045,"Block 4045, Block Group 4, Census Tract 2522.01, Solano County, California",0,0,0
1000000US060952522014046,060952522014046,"Block 4046, Block Group 4, Census Tract 2522.01, Solano County, California",0,0,0
1000000US060952522014047,060952522014047,"Block 4047, Block Group 4, Census Tract 2522.01, Solano County, California",11,10,1
1000000US060952522014048,060952522014048,"Block 4048, Block Group 4, Census Tract 2522.01, Solano County, California",24,22,2
1000000US060952522014049,060952522014049,"Block 4049, Block Group 4, Census Tract 2522.01, Solano County, California",0,0,0
1000000US060952522014050,060952522014050,"Block 4050, Block Group 4, Census Tract 2522.01, Solano County, California",0,0,0
1000000US060952522014051,060952522014051,"Block 4051, Block Group 4, Census Tract 2522.01, Solano County, California",0,0,0
1000000US060952522014052,060952522014052,"Block 4052, Block Group 4, Census Tract 2522.01, Solano County, California",32,26,6
1000000US060952522014053,060952522014053,"Block 4053, Block Group 4, Census Tract 2522.01, Solano County, California",14,14,0
1000000US060952522014054,060952522014054,"Block 4054, Block Group 4, Census Tract 2522.01, Solano County, California",0,0,0
1000000US060952522014055,060952522014055,"Block 4055, Block Group 4, Census Tract 2522.01, Solano County, California",67,62,5
1000000US060952522014056,060952522014056,"Block 4056, Block Group 4, Census Tract 2522.01, Solano County, California",28,28,0
1000000US060952522014057,060952522014057,"Block 4057, Block Group 4, Census Tract 2522.01, Solano County, California",13,12,1
1000000US060952522014058,060952522014058,"Block 4058, Block Group 4, Census Tract 2522.01, Solano County, California",17,17,0
1000000US060952522014059,060952522014059,"Block 4059, Block Group 4, Census Tract 2522.01, Solano County, California",35,35,0
1000000US060952522014060,060952522014060,"Block 4060, Block Group 4, Census Tract 2522.01, Solano County, California",12,12,0
1000000US060952522014061,060952522014061,"Block 4061, Block Group 4, Census Tract 2522.01, Solano County, California",61,60,1
1000000US060952522014062,060952522014062,"Block 4062, Block Group 4, Census Tract 2522.01, Solano County, California",55,52,3
1000000US060952522014063,060952522014063,"Block 4063, Block Group 4, Census Tract 2522.01, Solano County, California",0,0,0
1000000US060952522014064,060952522014064,"Block 4064, Block Group 4, Census Tract 2522.01, Solano County, California",4,4,0
1000000US060952522014065,060952522014065,"Block 4065, Block Group 4, Census Tract 2522.01, Solano County, California",45,44,1
1000000US060952522014066,060952522014066,"Block 4066, Block Group 4, Census Tract 2522.01, Solano County, California",59,55,4
1000000US060952522014067,060952522014067,"Block 4067, Block Group 4, Census Tract 2522.01, Solano County, California",1,1,0
1000000US060952522014068,060952522014068,"Block 4068, Block Group 4, Census Tract 2522.01, Solano County, California",45,44,1
1000000US060952522014069,060952522014069,"Block 4069, Block Group 4, Census Tract 2522.01, Solano County, California",9,8,1
1000000US060952522014070,060952522014070,"Block 4070, Block Group 4, Census Tract 2522.01, Solano County, California",1,1,0
1000000US060952522014071,060952522014071,"Block 4071, Block Group 4, Census Tract 2522.01, Solano County, California",13,12,1
1000000US060952522014072,060952522014072,"Block 4072, Block Group 4, Census Tract 2522.01, Solano County, California",25,25,0
1000000US060952522014073,060952522014073,"Block 4073, Block Group 4, Census Tract 2522.01, Solano County, California",0,0,0
1000000US060952522014074,060952522014074,"Block 4074, Block Group 4, Census Tract 2522.01, Solano County, California",0,0,0
1000000US060952522014075,060952522014075,"Block 4075, Block Group 4, Census Tract 2522.01, Solano County, California",0,0,0
1000000US060952522014076,060952522014076,"Block 4076, Block Group 4, Census Tract 2522.01, Solano County, California",0,0,0
1000000US060952522014077,060952522014077,"Block 4077, Block Group 4, Census Tract 2522.01, Solano County, California",0,0,0
1000000US060952522014078,060952522014078,"Block 4078, Block Group 4, Census Tract 2522.01, Solano County, California",51,47,4
1000000US060952522014079,060952522014079,"Block 4079, Block Group 4, Census Tract 2522.01, Solano County, California",15,15,0
1000000US060952522014080,060952522014080,"Block 4080, Block Group 4, Census Tract 2522.01, Solano County, California",0,0,0
1000000US060952522014081,060952522014081,"Block 4081, Block Group 4, Census Tract 2522.01, Solano County, California",0,0,0
1000000US060952522014082,060952522014082,"Block 4082, Block Group 4, Census Tract 2522.01, Solano County, California",1,1,0
1000000US060952522014083,060952522014083,"Block 4083, Block Group 4, Census Tract 2522.01, Solano County, California",0,0,0
1000000US060952522014084,060952522014084,"Block 4084, Block Group 4, Census Tract 2522.01, Solano County, California",2,2,0
1000000US060952522014085,060952522014085,"Block 4085, Block Group 4, Census Tract 2522.01, Solano County, California",0,0,0
1000000US060952522014086,060952522014086,"Block 4086, Block Group 4, Census Tract 2522.01, Solano County, California",10,10,0
1000000US060952522014087,060952522014087,"Block 4087, Block Group 4, Census Tract 2522.01, Solano County, California",0,0,0
1000000US060952522014088,060952522014088,"Block 4088, Block Group 4, Census Tract 2522.01, Solano County, California",6,6,0
1000000US060952522014089,060952522014089,"Block 4089, Block Group 4, Census Tract 2522.01, Solano County, California",4,4,0
1000000US060952522014090,060952522014090,"Block 4090, Block Group 4, Census Tract 2522.01, Solano County, California",0,0,0
1000000US060952522014091,060952522014091,"Block 4091, Block Group 4, Census Tract 2522.01, Solano County, California",1,1,0
1000000US060952522014092,060952522014092,"Block 4092, Block Group 4, Census Tract 2522.01, Solano County, California",47,43,4
1000000US060952522014093,060952522014093,"Block 4093, Block Group 4, Census Tract 2522.01, Solano County, California",0,0,0
1000000US060952522014094,060952522014094,"Block 4094, Block Group 4, Census Tract 2522.01, Solano County, California",0,0,0
1000000US060952522014095,060952522014095,"Block 4095, Block Group 4, Census Tract 2522.01, Solano County, California",1,1,0
1000000US060952522014096,060952522014096,"Block 4096, Block Group 4, Census Tract 2522.01, Solano County, California",0,0,0
1000000US060952522014097,060952522014097,"Block 4097, Block Group 4, Census Tract 2522.01, Solano County, California",0,0,0
1000000US060952522014098,060952522014098,"Block 4098, Block Group 4, Census Tract 2522.01, Solano County, California",0,0,0
1000000US060952522014099,060952522014099,"Block 4099, Block Group 4, Census Tract 2522.01, Solano County, California",0,0,0
1000000US060952522014100,060952522014100,"Block 4100, Block Group 4, Census Tract 2522.01, Solano County, California",0,0,0
1000000US060952522014101,060952522014101,"Block 4101, Block Group 4, Census Tract 2522.01, Solano County, California",0,0,0
1000000US060952522014102,060952522014102,"Block 4102, Block Group 4, Census Tract 2522.01, Solano County, California",0,0,0
1000000US060952522014103,060952522014103,"Block 4103, Block Group 4, Census Tract 2522.01, Solano County, California",0,0,0
1000000US060952522014104,060952522014104,"Block 4104, Block Group 4, Census Tract 2522.01, Solano County, California",0,0,0
1000000US060952522014105,060952522014105,"Block 4105, Block Group 4, Census Tract 2522.01, Solano County, California",0,0,0
1000000US060952522014106,060952522014106,"Block 4106, Block Group 4, Census Tract 2522.01, Solano County, California",0,0,0
1000000US060952522014107,060952522014107,"Block 4107, Block Group 4, Census Tract 2522.01, Solano County, California",0,0,0
1000000US060952522014108,060952522014108,"Block 4108, Block Group 4, Census Tract 2522.01, Solano County, California",1,1,0
1000000US060952522014109,060952522014109,"Block 4109, Block Group 4, Census Tract 2522.01, Solano County, California",1,1,0
1000000US060952522014110,060952522014110,"Block 4110, Block Group 4, Census Tract 2522.01, Solano County, California",0,0,0
1000000US060952522014111,060952522014111,"Block 4111, Block Group 4, Census Tract 2522.01, Solano County, California",0,0,0
1000000US060952522014112,060952522014112,"Block 4112, Block Group 4, Census Tract 2522.01, Solano County, California",0,0,0
1000000US060952522014113,060952522014113,"Block 4113, Block Group 4, Census Tract 2522.01, Solano County, California",0,0,0
1000000US060952522014114,060952522014114,"Block 4114, Block Group 4, Census Tract 2522.01, Solano County, California",0,0,0
1000000US060952522014115,060952522014115,"Block 4115, Block Group 4, Census Tract 2522.01, Solano County, California",0,0,0
1000000US060952522014116,060952522014116,"Block 4116, Block Group 4, Census Tract 2522.01, Solano County, California",0,0,0
1000000US060952522021000,060952522021000,"Block 1000, Block Group 1, Census Tract 2522.02, Solano County, California",0,0,0
1000000US060952522021001,060952522021001,"Block 1001, Block Group 1, Census Tract 2522.02, Solano County, California",0,0,0
1000000US060952522021002,060952522021002,"Block 1002, Block Group 1, Census Tract 2522.02, Solano County, California",0,0,0
1000000US060952522021003,060952522021003,"Block 1003, Block Group 1, Census Tract 2522.02, Solano County, California",0,0,0
1000000US060952522021004,060952522021004,"Block 1004, Block Group 1, Census Tract 2522.02, Solano County, California",0,0,0
1000000US060952522021005,060952522021005,"Block 1005, Block Group 1, Census Tract 2522.02, Solano County, California",0,0,0
1000000US060952522021006,060952522021006,"Block 1006, Block Group 1, Census Tract 2522.02, Solano County, California",0,0,0
1000000US060952522021007,060952522021007,"Block 1007, Block Group 1, Census Tract 2522.02, Solano County, California",0,0,0
1000000US060952522021008,060952522021008,"Block 1008, Block Group 1, Census Tract 2522.02, Solano County, California",0,0,0
1000000US060952522021009,060952522021009,"Block 1009, Block Group 1, Census Tract 2522.02, Solano County, California",0,0,0
1000000US060952522021010,060952522021010,"Block 1010, Block Group 1, Census Tract 2522.02, Solano County, California",0,0,0
1000000US060952522021011,060952522021011,"Block 1011, Block Group 1, Census Tract 2522.02, Solano County, California",233,221,12
1000000US060952522021012,060952522021012,"Block 1012, Block Group 1, Census Tract 2522.02, Solano County, California",98,92,6
1000000US060952522021013,060952522021013,"Block 1013, Block Group 1, Census Tract 2522.02, Solano County, California",102,93,9
1000000US060952522021014,060952522021014,"Block 1014, Block Group 1, Census Tract 2522.02, Solano County, California",19,19,0
1000000US060952522021015,060952522021015,"Block 1015, Block Group 1, Census Tract 2522.02, Solano County, California",23,22,1
1000000US060952522021016,060952522021016,"Block 1016, Block Group 1, Census Tract 2522.02, Solano County, California",0,0,0
1000000US060952522021017,060952522021017,"Block 1017, Block Group 1, Census Tract 2522.02, Solano County, California",0,0,0
1000000US060952522021018,060952522021018,"Block 1018, Block Group 1, Census Tract 2522.02, Solano County, California",0,0,0
1000000US060952522021019,060952522021019,"Block 1019, Block Group 1, Census Tract 2522.02, Solano County, California",0,0,0
1000000US060952522021020,060952522021020,"Block 1020, Block Group 1, Census Tract 2522.02, Solano County, California",0,0,0
1000000US060952522021021,060952522021021,"Block 1021, Block Group 1, Census Tract 2522.02, Solano County, California",0,0,0
1000000US060952522021022,060952522021022,"Block 1022, Block Group 1, Census Tract 2522.02, Solano County, California",0,0,0
1000000US060952522021023,060952522021023,"Block 1023, Block Group 1, Census Tract 2522.02, Solano County, California",0,0,0
1000000US060952522021024,060952522021024,"Block 1024, Block Group 1, Census Tract 2522.02, Solano County, California",0,0,0
1000000US060952522021025,060952522021025,"Block 1025, Block Group 1, Census Tract 2522.02, Solano County, California",0,0,0
1000000US060952522021026,060952522021026,"Block 1026, Block Group 1, Census Tract 2522.02, Solano County, California",0,0,0
1000000US060952522021027,060952522021027,"Block 1027, Block Group 1, Census Tract 2522.02, Solano County, California",0,0,0
1000000US060952522021028,060952522021028,"Block 1028, Block Group 1, Census Tract 2522.02, Solano County, California",0,0,0
1000000US060952522021029,060952522021029,"Block 1029, Block Group 1, Census Tract 2522.02, Solano County, California",0,0,0
1000000US060952522021030,060952522021030,"Block 1030, Block Group 1, Census Tract 2522.02, Solano County, California",0,0,0
1000000US060952522021031,060952522021031,"Block 1031, Block Group 1, Census Tract 2522.02, Solano County, California",0,0,0
1000000US060952522021032,060952522021032,"Block 1032, Block Group 1, Census Tract 2522.02, Solano County, California",25,24,1
1000000US060952522021033,060952522021033,"Block 1033, Block Group 1, Census Tract 2522.02, Solano County, California",0,0,0
1000000US060952522021034,060952522021034,"Block 1034, Block Group 1, Census Tract 2522.02, Solano County, California",0,0,0
1000000US060952522022000,060952522022000,"Block 2000, Block Group 2, Census Tract 2522.02, Solano County, California",0,0,0
1000000US060952522022001,060952522022001,"Block 2001, Block Group 2, Census Tract 2522.02, Solano County, California",0,0,0
1000000US060952522022002,060952522022002,"Block 2002, Block Group 2, Census Tract 2522.02, Solano County, California",0,0,0
1000000US060952522022003,060952522022003,"Block 2003, Block Group 2, Census Tract 2522.02, Solano County, California",0,0,0
1000000US060952522022004,060952522022004,"Block 2004, Block Group 2, Census Tract 2522.02, Solano County, California",0,0,0
1000000US060952522022005,060952522022005,"Block 2005, Block Group 2, Census Tract 2522.02, Solano County, California",0,0,0
1000000US060952522022006,060952522022006,"Block 2006, Block Group 2, Census Tract 2522.02, Solano County, California",0,0,0
1000000US060952522022007,060952522022007,"Block 2007, Block Group 2, Census Tract 2522.02, Solano County, California",0,0,0
1000000US060952522022008,060952522022008,"Block 2008, Block Group 2, Census Tract 2522.02, Solano County, California",0,0,0
1000000US060952522022009,060952522022009,"Block 2009, Block Group 2, Census Tract 2522.02, Solano County, California",0,0,0
1000000US060952522022010,060952522022010,"Block 2010, Block Group 2, Census Tract 2522.02, Solano County, California",0,0,0
1000000US060952522022011,060952522022011,"Block 2011, Block Group 2, Census Tract 2522.02, Solano County, California",0,0,0
1000000US060952522022012,060952522022012,"Block 2012, Block Group 2, Census Tract 2522.02, Solano County, California",0,0,0
1000000US060952522022013,060952522022013,"Block 2013, Block Group 2, Census Tract 2522.02, Solano County, California",0,0,0
1000000US060952522022014,060952522022014,"Block 2014, Block Group 2, Census Tract 2522.02, Solano County, California",0,0,0
1000000US060952522022015,060952522022015,"Block 2015, Block Group 2, Census Tract 2522.02, Solano County, California",0,0,0
1000000US060952522022016,060952522022016,"Block 2016, Block Group 2, Census Tract 2522.02, Solano County, California",154,145,9
1000000US060952522022017,060952522022017,"Block 2017, Block Group 2, Census Tract 2522.02, Solano County, California",0,0,0
1000000US060952522022018,060952522022018,"Block 2018, Block Group 2, Census Tract 2522.02, Solano County, California",0,0,0
1000000US060952522022019,060952522022019,"Block 2019, Block Group 2, Census Tract 2522.02, Solano County, California",14,11,3
1000000US060952522022020,060952522022020,"Block 2020, Block Group 2, Census Tract 2522.02, Solano County, California",13,13,0
1000000US060952522022021,060952522022021,"Block 2021, Block Group 2, Census Tract 2522.02, Solano County, California",53,53,0
1000000US060952522022022,060952522022022,"Block 2022, Block Group 2, Census Tract 2522.02, Solano County, California",47,46,1
1000000US060952522022023,060952522022023,"Block 2023, Block Group 2, Census Tract 2522.02, Solano County, California",0,0,0
1000000US060952522022024,060952522022024,"Block 2024, Block Group 2, Census Tract 2522.02, Solano County, California",0,0,0
1000000US060952522022025,060952522022025,"Block 2025, Block Group 2, Census Tract 2522.02, Solano County, California",51,48,3
1000000US060952522022026,060952522022026,"Block 2026, Block Group 2, Census Tract 2522.02, Solano County, California",0,0,0
1000000US060952522022027,060952522022027,"Block 2027, Block Group 2, Census Tract 2522.02, Solano County, California",0,0,0
1000000US060952522022028,060952522022028,"Block 2028, Block Group 2, Census Tract 2522.02, Solano County, California",0,0,0
1000000US060952522022029,060952522022029,"Block 2029, Block Group 2, Census Tract 2522.02, Solano County, California",0,0,0
1000000US060952522022030,060952522022030,"Block 2030, Block Group 2, Census Tract 2522.02, Solano County, California",0,0,0
1000000US060952522022031,060952522022031,"Block 2031, Block Group 2, Census Tract 2522.02, Solano County, California",0,0,0
1000000US060952522022032,060952522022032,"Block 2032, Block Group 2, Census Tract 2522.02, Solano County, California",0,0,0
1000000US060952522022033,060952522022033,"Block 2033, Block Group 2, Census Tract 2522.02, Solano County, California",0,0,0
1000000US060952522022034,060952522022034,"Block 2034, Block Group 2, Census Tract 2522.02, Solano County, California",0,0,0
1000000US060952522022035,060952522022035,"Block 2035, Block Group 2, Census Tract 2522.02, Solano County, California",30,28,2
1000000US060952522022036,060952522022036,"Block 2036, Block Group 2, Census Tract 2522.02, Solano County, California",29,29,0
1000000US060952522022037,060952522022037,"Block 2037, Block Group 2, Census Tract 2522.02, Solano County, California",0,0,0
1000000US060952522022038,060952522022038,"Block 2038, Block Group 2, Census Tract 2522.02, Solano County, California",0,0,0
1000000US060952522022039,060952522022039,"Block 2039, Block Group 2, Census Tract 2522.02, Solano County, California",0,0,0
1000000US060952522022040,060952522022040,"Block 2040, Block Group 2, Census Tract 2522.02, Solano County, California",0,0,0
1000000US060952522022041,060952522022041,"Block 2041, Block Group 2, Census Tract 2522.02, Solano County, California",0,0,0
1000000US060952522022042,060952522022042,"Block 2042, Block Group 2, Census Tract 2522.02, Solano County, California",0,0,0
1000000US060952522022043,060952522022043,"Block 2043, Block Group 2, Census Tract 2522.02, Solano County, California",14,13,1
1000000US060952522022044,060952522022044,"Block 2044, Block Group 2, Census Tract 2522.02, Solano County, California",0,0,0
1000000US060952522022045,060952522022045,"Block 2045, Block Group 2, Census Tract 2522.02, Solano County, California",0,0,0
1000000US060952522022046,060952522022046,"Block 2046, Block Group 2, Census Tract 2522.02, Solano County, California",69,66,3
1000000US060952522022047,060952522022047,"Block 2047, Block Group 2, Census Tract 2522.02, Solano County, California",25,24,1
1000000US060952522022048,060952522022048,"Block 2048, Block Group 2, Census Tract 2522.02, Solano County, California",35,35,0
1000000US060952522022049,060952522022049,"Block 2049, Block Group 2, Census Tract 2522.02, Solano County, California",28,26,2
1000000US060952522022050,060952522022050,"Block 2050, Block Group 2, Census Tract 2522.02, Solano County, California",67,65,2
1000000US060952522022051,060952522022051,"Block 2051, Block Group 2, Census Tract 2522.02, Solano County, California",0,0,0
1000000US060952522022052,060952522022052,"Block 2052, Block Group 2, Census Tract 2522.02, Solano County, California",0,0,0
1000000US060952522022053,060952522022053,"Block 2053, Block Group 2, Census Tract 2522.02, Solano County, California",0,0,0
1000000US060952522022054,060952522022054,"Block 2054, Block Group 2, Census Tract 2522.02, Solano County, California",0,0,0
1000000US060952522022055,060952522022055,"Block 2055, Block Group 2, Census Tract 2522.02, Solano County, California",0,0,0
1000000US060952522022056,060952522022056,"Block 2056, Block Group 2, Census Tract 2522.02, Solano County, California",0,0,0
1000000US060952522022057,060952522022057,"Block 2057, Block Group 2, Census Tract 2522.02, Solano County, California",0,0,0
1000000US060952522022058,060952522022058,"Block 2058, Block Group 2, Census Tract 2522.02, Solano County, California",15,15,0
1000000US060952522022059,060952522022059,"Block 2059, Block Group 2, Census Tract 2522.02, Solano County, California",9,9,0
1000000US060952522022060,060952522022060,"Block 2060, Block Group 2, Census Tract 2522.02, Solano County, California",29,27,2
1000000US060952522022061,060952522022061,"Block 2061, Block Group 2, Census Tract 2522.02, Solano County, California",21,20,1
1000000US060952522022062,060952522022062,"Block 2062, Block Group 2, Census Tract 2522.02, Solano County, California",27,25,2
1000000US060952522022063,060952522022063,"Block 2063, Block Group 2, Census Tract 2522.02, Solano County, California",47,47,0
1000000US060952522022064,060952522022064,"Block 2064, Block Group 2, Census Tract 2522.02, Solano County, California",3,3,0
1000000US060952522022065,060952522022065,"Block 2065, Block Group 2, Census Tract 2522.02, Solano County, California",3,3,0
1000000US060952522022066,060952522022066,"Block 2066, Block Group 2, Census Tract 2522.02, Solano County, California",0,0,0
1000000US060952522022067,060952522022067,"Block 2067, Block Group 2, Census Tract 2522.02, Solano County, California",0,0,0
1000000US060952522022068,060952522022068,"Block 2068, Block Group 2, Census Tract 2522.02, Solano County, California",16,16,0
1000000US060952522022069,060952522022069,"Block 2069, Block Group 2, Census Tract 2522.02, Solano County, California",0,0,0
1000000US060952522022070,060952522022070,"Block 2070, Block Group 2, Census Tract 2522.02, Solano County, California",0,0,0
1000000US060952522022071,060952522022071,"Block 2071, Block Group 2, Census Tract 2522.02, Solano County, California",0,0,0
1000000US060952522022072,060952522022072,"Block 2072, Block Group 2, Census Tract 2522.02, Solano County, California",0,0,0
1000000US060952522022073,060952522022073,"Block 2073, Block Group 2, Census Tract 2522.02, Solano County, California",0,0,0
1000000US060952522022074,060952522022074,"Block 2074, Block Group 2, Census Tract 2522.02, Solano County, California",0,0,0
1000000US060952522022075,060952522022075,"Block 2075, Block Group 2, Census Tract 2522.02, Solano County, California",0,0,0
1000000US060952522022076,060952522022076,"Block 2076, Block Group 2, Census Tract 2522.02, Solano County, California",0,0,0
1000000US060952522022077,060952522022077,"Block 2077, Block Group 2, Census Tract 2522.02, Solano County, California",0,0,0
1000000US060952522023000,060952522023000,"Block 3000, Block Group 3, Census Tract 2522.02, Solano County, California",0,0,0
1000000US060952522023001,060952522023001,"Block 3001, Block Group 3, Census Tract 2522.02, Solano County, California",0,0,0
1000000US060952522023002,060952522023002,"Block 3002, Block Group 3, Census Tract 2522.02, Solano County, California",0,0,0
1000000US060952522023003,060952522023003,"Block 3003, Block Group 3, Census Tract 2522.02, Solano County, California",0,0,0
1000000US060952522023004,060952522023004,"Block 3004, Block Group 3, Census Tract 2522.02, Solano County, California",0,0,0
1000000US060952522023005,060952522023005,"Block 3005, Block Group 3, Census Tract 2522.02, Solano County, California",0,0,0
1000000US060952522023006,060952522023006,"Block 3006, Block Group 3, Census Tract 2522.02, Solano County, California",0,0,0
1000000US060952522023007,060952522023007,"Block 3007, Block Group 3, Census Tract 2522.02, Solano County, California",0,0,0
1000000US060952522023008,060952522023008,"Block 3008, Block Group 3, Census Tract 2522.02, Solano County, California",1,1,0
1000000US060952522023009,060952522023009,"Block 3009, Block Group 3, Census Tract 2522.02, Solano County, California",0,0,0
1000000US060952522023010,060952522023010,"Block 3010, Block Group 3, Census Tract 2522.02, Solano County, California",0,0,0
1000000US060952522023011,060952522023011,"Block 3011, Block Group 3, Census Tract 2522.02, Solano County, California",0,0,0
1000000US060952522023012,060952522023012,"Block 3012, Block Group 3, Census Tract 2522.02, Solano County, California",0,0,0
1000000US060952522023013,060952522023013,"Block 3013, Block Group 3, Census Tract 2522.02, Solano County, California",1,1,0
1000000US060952522023014,060952522023014,"Block 3014, Block Group 3, Census Tract 2522.02, Solano County, California",9,8,1
1000000US060952522023015,060952522023015,"Block 3015, Block Group 3, Census Tract 2522.02, Solano County, California",0,0,0
1000000US060952522023016,060952522023016,"Block 3016, Block Group 3, Census Tract 2522.02, Solano County, California",0,0,0
1000000US060952522023017,060952522023017,"Block 3017, Block Group 3, Census Tract 2522.02, Solano County, California",0,0,0
1000000US060952522023018,060952522023018,"Block 3018, Block Group 3, Census Tract 2522.02, Solano County, California",0,0,0
1000000US060952522023019,060952522023019,"Block 3019, Block Group 3, Census Tract 2522.02, Solano County, California",0,0,0
1000000US060952522023020,060952522023020,"Block 3020, Block Group 3, Census Tract 2522.02, Solano County, California",0,0,0
1000000US060952522023021,060952522023021,"Block 3021, Block Group 3, Census Tract 2522.02, Solano County, California",26,25,1
1000000US060952522023022,060952522023022,"Block 3022, Block Group 3, Census Tract 2522.02, Solano County, California",0,0,0
1000000US060952522023023,060952522023023,"Block 3023, Block Group 3, Census Tract 2522.02, Solano County, California",0,0,0
1000000US060952522023024,060952522023024,"Block 3024, Block Group 3, Census Tract 2522.02, Solano County, California",3,3,0
1000000US060952522023025,060952522023025,"Block 3025, Block Group 3, Census Tract 2522.02, Solano County, California",0,0,0
1000000US060952522023026,060952522023026,"Block 3026, Block Group 3, Census Tract 2522.02, Solano County, California",0,0,0
1000000US060952522023027,060952522023027,"Block 3027, Block Group 3, Census Tract 2522.02, Solano County, California",5,5,0
1000000US060952522023028,060952522023028,"Block 3028, Block Group 3, Census Tract 2522.02, Solano County, California",3,3,0
1000000US060952522023029,060952522023029,"Block 3029, Block Group 3, Census Tract 2522.02, Solano County, California",0,0,0
1000000US060952522023030,060952522023030,"Block 3030, Block Group 3, Census Tract 2522.02, Solano County, California",0,0,0
1000000US060952522023031,060952522023031,"Block 3031, Block Group 3, Census Tract 2522.02, Solano County, California",0,0,0
1000000US060952522023032,060952522023032,"Block 3032, Block Group 3, Census Tract 2522.02, Solano County, California",0,0,0
1000000US060952522023033,060952522023033,"Block 3033, Block Group 3, Census Tract 2522.02, Solano County, California",0,0,0
1000000US060952522023034,060952522023034,"Block 3034, Block Group 3, Census Tract 2522.02, Solano County, California",0,0,0
1000000US060952522023035,060952522023035,"Block 3035, Block Group 3, Census Tract 2522.02, Solano County, California",0,0,0
1000000US060952522023036,060952522023036,"Block 3036, Block Group 3, Census Tract 2522.02, Solano County, California",0,0,0
1000000US060952522023037,060952522023037,"Block 3037, Block Group 3, Census Tract 2522.02, Solano County, California",14,12,2
1000000US060952522023038,060952522023038,"Block 3038, Block Group 3, Census Tract 2522.02, Solano County, California",0,0,0
1000000US060952522023039,060952522023039,"Block 3039, Block Group 3, Census Tract 2522.02, Solano County, California",0,0,0
1000000US060952522023040,060952522023040,"Block 3040, Block Group 3, Census Tract 2522.02, Solano County, California",0,0,0
1000000US060952522023041,060952522023041,"Block 3041, Block Group 3, Census Tract 2522.02, Solano County, California",0,0,0
1000000US060952522023042,060952522023042,"Block 3042, Block Group 3, Census Tract 2522.02, Solano County, California",0,0,0
1000000US060952522023043,060952522023043,"Block 3043, Block Group 3, Census Tract 2522.02, Solano County, California",2,2,0
1000000US060952522023044,060952522023044,"Block 3044, Block Group 3, Census Tract 2522.02, Solano County, California",0,0,0
1000000US060952522023045,060952522023045,"Block 3045, Block Group 3, Census Tract 2522.02, Solano County, California",0,0,0
1000000US060952522023046,060952522023046,"Block 3046, Block Group 3, Census Tract 2522.02, Solano County, California",2,2,0
1000000US060952522023047,060952522023047,"Block 3047, Block Group 3, Census Tract 2522.02, Solano County, California",0,0,0
1000000US060952522023048,060952522023048,"Block 3048, Block Group 3, Census Tract 2522.02, Solano County, California",0,0,0
1000000US060952522023049,060952522023049,"Block 3049, Block Group 3, Census Tract 2522.02, Solano County, California",0,0,0
1000000US060952522023050,060952522023050,"Block 3050, Block Group 3, Census Tract 2522.02, Solano County, California",0,0,0
1000000US060952522023051,060952522023051,"Block 3051, Block Group 3, Census Tract 2522.02, Solano County, California",0,0,0
1000000US060952522023052,060952522023052,"Block 3052, Block Group 3, Census Tract 2522.02, Solano County, California",0,0,0
1000000US060952522023053,060952522023053,"Block 3053, Block Group 3, Census Tract 2522.02, Solano County, California",0,0,0
1000000US060952522023054,060952522023054,"Block 3054, Block Group 3, Census Tract 2522.02, Solano County, California",0,0,0
1000000US060952522023055,060952522023055,"Block 3055, Block Group 3, Census Tract 2522.02, Solano County, California",0,0,0
1000000US060952522023056,060952522023056,"Block 3056, Block Group 3, Census Tract 2522.02, Solano County, California",0,0,0
1000000US060952522023057,060952522023057,"Block 3057, Block Group 3, Census Tract 2522.02, Solano County, California",0,0,0
1000000US060952522023058,060952522023058,"Block 3058, Block Group 3, Census Tract 2522.02, Solano County, California",0,0,0
1000000US060952522023059,060952522023059,"Block 3059, Block Group 3, Census Tract 2522.02, Solano County, California",0,0,0
1000000US060952522023060,060952522023060,"Block 3060, Block Group 3, Census Tract 2522.02, Solano County, California",39,39,0
1000000US060952522023061,060952522023061,"Block 3061, Block Group 3, Census Tract 2522.02, Solano County, California",25,24,1
1000000US060952522023062,060952522023062,"Block 3062, Block Group 3, Census Tract 2522.02, Solano County, California",0,0,0
1000000US060952522023063,060952522023063,"Block 3063, Block Group 3, Census Tract 2522.02, Solano County, California",14,14,0
1000000US060952522023064,060952522023064,"Block 3064, Block Group 3, Census Tract 2522.02, Solano County, California",0,0,0
1000000US060952522023065,060952522023065,"Block 3065, Block Group 3, Census Tract 2522.02, Solano County, California",0,0,0
1000000US060952522023066,060952522023066,"Block 3066, Block Group 3, Census Tract 2522.02, Solano County, California",0,0,0
1000000US060952522023067,060952522023067,"Block 3067, Block Group 3, Census Tract 2522.02, Solano County, California",0,0,0
1000000US060952522023068,060952522023068,"Block 3068, Block Group 3, Census Tract 2522.02, Solano County, California",0,0,0
1000000US060952522023069,060952522023069,"Block 3069, Block Group 3, Census Tract 2522.02, Solano County, California",0,0,0
1000000US060952522023070,060952522023070,"Block 3070, Block Group 3, Census Tract 2522.02, Solano County, California",59,59,0
1000000US060952522023071,060952522023071,"Block 3071, Block Group 3, Census Tract 2522.02, Solano County, California",108,105,3
1000000US060952522023072,060952522023072,"Block 3072, Block Group 3, Census Tract 2522.02, Solano County, California",43,41,2
1000000US060952522023073,060952522023073,"Block 3073, Block Group 3, Census Tract 2522.02, Solano County, California",32,32,0
1000000US060952522023074,060952522023074,"Block 3074, Block Group 3, Census Tract 2522.02, Solano County, California",58,57,1
1000000US060952522023075,060952522023075,"Block 3075, Block Group 3, Census Tract 2522.02, Solano County, California",28,28,0
1000000US060952522023076,060952522023076,"Block 3076, Block Group 3, Census Tract 2522.02, Solano County, California",120,117,3
1000000US060952522023077,060952522023077,"Block 3077, Block Group 3, Census Tract 2522.02, Solano County, California",41,41,0
1000000US060952522023078,060952522023078,"Block 3078, Block Group 3, Census Tract 2522.02, Solano County, California",6,5,1
1000000US060952522023079,060952522023079,"Block 3079, Block Group 3, Census Tract 2522.02, Solano County, California",27,27,0
1000000US060952522024000,060952522024000,"Block 4000, Block Group 4, Census Tract 2522.02, Solano County, California",52,51,1
1000000US060952522024001,060952522024001,"Block 4001, Block Group 4, Census Tract 2522.02, Solano County, California",21,19,2
1000000US060952522024002,060952522024002,"Block 4002, Block Group 4, Census Tract 2522.02, Solano County, California",11,11,0
1000000US060952522024003,060952522024003,"Block 4003, Block Group 4, Census Tract 2522.02, Solano County, California",62,59,3
1000000US060952522024004,060952522024004,"Block 4004, Block Group 4, Census Tract 2522.02, Solano County, California",13,13,0
1000000US060952522024005,060952522024005,"Block 4005, Block Group 4, Census Tract 2522.02, Solano County, California",11,10,1
1000000US060952522024006,060952522024006,"Block 4006, Block Group 4, Census Tract 2522.02, Solano County, California",18,18,0
1000000US060952522024007,060952522024007,"Block 4007, Block Group 4, Census Tract 2522.02, Solano County, California",12,11,1
1000000US060952522024008,060952522024008,"Block 4008, Block Group 4, Census Tract 2522.02, Solano County, California",15,14,1
1000000US060952522024009,060952522024009,"Block 4009, Block Group 4, Census Tract 2522.02, Solano County, California",56,55,1
1000000US060952522024010,060952522024010,"Block 4010, Block Group 4, Census Tract 2522.02, Solano County, California",249,230,19
1000000US060952522024011,060952522024011,"Block 4011, Block Group 4, Census Tract 2522.02, Solano County, California",49,47,2
1000000US060952522024012,060952522024012,"Block 4012, Block Group 4, Census Tract 2522.02, Solano County, California",27,26,1
1000000US060952522024013,060952522024013,"Block 4013, Block Group 4, Census Tract 2522.02, Solano County, California",0,0,0
1000000US060952522024014,060952522024014,"Block 4014, Block Group 4, Census Tract 2522.02, Solano County, California",28,26,2
1000000US060952522024015,060952522024015,"Block 4015, Block Group 4, Census Tract 2522.02, Solano County, California",16,15,1
1000000US060952522024016,060952522024016,"Block 4016, Block Group 4, Census Tract 2522.02, Solano County, California",23,22,1
1000000US060952522024017,060952522024017,"Block 4017, Block Group 4, Census Tract 2522.02, Solano County, California",28,27,1
1000000US060952522024018,060952522024018,"Block 4018, Block Group 4, Census Tract 2522.02, Solano County, California",0,0,0
1000000US060952522024019,060952522024019,"Block 4019, Block Group 4, Census Tract 2522.02, Solano County, California",30,27,3
1000000US060952522024020,060952522024020,"Block 4020, Block Group 4, Census Tract 2522.02, Solano County, California",0,0,0
1000000US060952522024021,060952522024021,"Block 4021, Block Group 4, Census Tract 2522.02, Solano County, California",10,10,0
1000000US060952522024022,060952522024022,"Block 4022, Block Group 4, Census Tract 2522.02, Solano County, California",86,84,2
1000000US060952522024023,060952522024023,"Block 4023, Block Group 4, Census Tract 2522.02, Solano County, California",0,0,0
1000000US060952522024024,060952522024024,"Block 4024, Block Group 4, Census Tract 2522.02, Solano County, California",0,0,0
1000000US060952522024025,060952522024025,"Block 4025, Block Group 4, Census Tract 2522.02, Solano County, California",1,1,0
1000000US060952522024026,060952522024026,"Block 4026, Block Group 4, Census Tract 2522.02, Solano County, California",0,0,0
1000000US060952522024027,060952522024027,"Block 4027, Block Group 4, Census Tract 2522.02, Solano County, California",0,0,0
1000000US060952522024028,060952522024028,"Block 4028, Block Group 4, Census Tract 2522.02, Solano County, California",0,0,0
1000000US060952522024029,060952522024029,"Block 4029, Block Group 4, Census Tract 2522.02, Solano County, California",0,0,0
1000000US060952522024030,060952522024030,"Block 4030, Block Group 4, Census Tract 2522.02, Solano County, California",0,0,0
1000000US060952522024031,060952522024031,"Block 4031, Block Group 4, Census Tract 2522.02, Solano County, California",0,0,0
1000000US060952522024032,060952522024032,"Block 4032, Block Group 4, Census Tract 2522.02, Solano County, California",0,0,0
1000000US060952522024033,060952522024033,"Block 4033, Block Group 4, Census Tract 2522.02, Solano County, California",0,0,0
1000000US060952522024034,060952522024034,"Block 4034, Block Group 4, Census Tract 2522.02, Solano County, California",0,0,0
1000000US060952522024035,060952522024035,"Block 4035, Block Group 4, Census Tract 2522.02, Solano County, California",0,0,0
1000000US060952522024036,060952522024036,"Block 4036, Block Group 4, Census Tract 2522.02, Solano County, California",0,0,0
1000000US060952522024037,060952522024037,"Block 4037, Block Group 4, Census Tract 2522.02, Solano County, California",0,0,0
1000000US060952522024038,060952522024038,"Block 4038, Block Group 4, Census Tract 2522.02, Solano County, California",0,0,0
1000000US060952522024039,060952522024039,"Block 4039, Block Group 4, Census Tract 2522.02, Solano County, California",0,0,0
1000000US060952522024040,060952522024040,"Block 4040, Block Group 4, Census Tract 2522.02, Solano County, California",0,0,0
1000000US060952522024041,060952522024041,"Block 4041, Block Group 4, Census Tract 2522.02, Solano County, California",0,0,0
1000000US060952522024042,060952522024042,"Block 4042, Block Group 4, Census Tract 2522.02, Solano County, California",0,0,0
1000000US060952522024043,060952522024043,"Block 4043, Block Group 4, Census Tract 2522.02, Solano County, California",0,0,0
1000000US060952522024044,060952522024044,"Block 4044, Block Group 4, Census Tract 2522.02, Solano County, California",0,0,0
1000000US060952522024045,060952522024045,"Block 4045, Block Group 4, Census Tract 2522.02, Solano County, California",0,0,0
1000000US060952522024046,060952522024046,"Block 4046, Block Group 4, Census Tract 2522.02, Solano County, California",0,0,0
1000000US060952522024047,060952522024047,"Block 4047, Block Group 4, Census Tract 2522.02, Solano County, California",0,0,0
1000000US060952522024048,060952522024048,"Block 4048, Block Group 4, Census Tract 2522.02, Solano County, California",0,0,0
1000000US060952522024049,060952522024049,"Block 4049, Block Group 4, Census Tract 2522.02, Solano County, California",0,0,0
1000000US060952522024050,060952522024050,"Block 4050, Block Group 4, Census Tract 2522.02, Solano County, California",0,0,0
1000000US060952522024051,060952522024051,"Block 4051, Block Group 4, Census Tract 2522.02, Solano County, California",0,0,0
1000000US060952522024052,060952522024052,"Block 4052, Block Group 4, Census Tract 2522.02, Solano County, California",0,0,0
1000000US060952522024053,060952522024053,"Block 4053, Block Group 4, Census Tract 2522.02, Solano County, California",2,2,0
1000000US060952522024054,060952522024054,"Block 4054, Block Group 4, Census Tract 2522.02, Solano County, California",0,0,0
1000000US060952522024055,060952522024055,"Block 4055, Block Group 4, Census Tract 2522.02, Solano County, California",0,0,0
1000000US060952522024056,060952522024056,"Block 4056, Block Group 4, Census Tract 2522.02, Solano County, California",0,0,0
1000000US060952522024057,060952522024057,"Block 4057, Block Group 4, Census Tract 2522.02, Solano County, California",27,24,3
1000000US060952522024058,060952522024058,"Block 4058, Block Group 4, Census Tract 2522.02, Solano County, California",70,63,7
1000000US060952522024059,060952522024059,"Block 4059, Block Group 4, Census Tract 2522.02, Solano County, California",18,17,1
1000000US060952522024060,060952522024060,"Block 4060, Block Group 4, Census Tract 2522.02, Solano County, California",24,23,1
1000000US060952522024061,060952522024061,"Block 4061, Block Group 4, Census Tract 2522.02, Solano County, California",16,16,0
1000000US060952522024062,060952522024062,"Block 4062, Block Group 4, Census Tract 2522.02, Solano County, California",23,23,0
1000000US060952522024063,060952522024063,"Block 4063, Block Group 4, Census Tract 2522.02, Solano County, California",41,38,3
1000000US060952522024064,060952522024064,"Block 4064, Block Group 4, Census Tract 2522.02, Solano County, California",15,13,2
1000000US060952522024065,060952522024065,"Block 4065, Block Group 4, Census Tract 2522.02, Solano County, California",54,54,0
1000000US060952522024066,060952522024066,"Block 4066, Block Group 4, Census Tract 2522.02, Solano County, California",5,5,0
1000000US060952522024067,060952522024067,"Block 4067, Block Group 4, Census Tract 2522.02, Solano County, California",19,19,0
1000000US060952522024068,060952522024068,"Block 4068, Block Group 4, Census Tract 2522.02, Solano County, California",0,0,0
1000000US060952522024069,060952522024069,"Block 4069, Block Group 4, Census Tract 2522.02, Solano County, California",7,7,0
1000000US060952522024070,060952522024070,"Block 4070, Block Group 4, Census Tract 2522.02, Solano County, California",2,2,0
1000000US060952522024071,060952522024071,"Block 4071, Block Group 4, Census Tract 2522.02, Solano County, California",8,8,0
1000000US060952522024072,060952522024072,"Block 4072, Block Group 4, Census Tract 2522.02, Solano County, California",7,7,0
1000000US060952522024073,060952522024073,"Block 4073, Block Group 4, Census Tract 2522.02, Solano County, California",51,48,3
1000000US060952522024074,060952522024074,"Block 4074, Block Group 4, Census Tract 2522.02, Solano County, California",0,0,0
1000000US060952523051000,060952523051000,"Block 1000, Block Group 1, Census Tract 2523.05, Solano County, California",0,0,0
1000000US060952523051001,060952523051001,"Block 1001, Block Group 1, Census Tract 2523.05, Solano County, California",6,5,1
1000000US060952523051002,060952523051002,"Block 1002, Block Group 1, Census Tract 2523.05, Solano County, California",19,19,0
1000000US060952523051003,060952523051003,"Block 1003, Block Group 1, Census Tract 2523.05, Solano County, California",5,4,1
1000000US060952523051004,060952523051004,"Block 1004, Block Group 1, Census Tract 2523.05, Solano County, California",0,0,0
1000000US060952523051005,060952523051005,"Block 1005, Block Group 1, Census Tract 2523.05, Solano County, California",0,0,0
1000000US060952523051006,060952523051006,"Block 1006, Block Group 1, Census Tract 2523.05, Solano County, California",0,0,0
1000000US060952523051007,060952523051007,"Block 1007, Block Group 1, Census Tract 2523.05, Solano County, California",38,27,11
1000000US060952523051008,060952523051008,"Block 1008, Block Group 1, Census Tract 2523.05, Solano County, California",0,0,0
1000000US060952523051009,060952523051009,"Block 1009, Block Group 1, Census Tract 2523.05, Solano County, California",9,9,0
1000000US060952523051010,060952523051010,"Block 1010, Block Group 1, Census Tract 2523.05, Solano County, California",1,1,0
1000000US060952523051011,060952523051011,"Block 1011, Block Group 1, Census Tract 2523.05, Solano County, California",14,12,2
1000000US060952523051012,060952523051012,"Block 1012, Block Group 1, Census Tract 2523.05, Solano County, California",0,0,0
1000000US060952523051013,060952523051013,"Block 1013, Block Group 1, Census Tract 2523.05, Solano County, California",0,0,0
1000000US060952523051014,060952523051014,"Block 1014, Block Group 1, Census Tract 2523.05, Solano County, California",1,0,1
1000000US060952523051015,060952523051015,"Block 1015, Block Group 1, Census Tract 2523.05, Solano County, California",1,1,0
1000000US060952523051016,060952523051016,"Block 1016, Block Group 1, Census Tract 2523.05, Solano County, California",0,0,0
1000000US060952523051017,060952523051017,"Block 1017, Block Group 1, Census Tract 2523.05, Solano County, California",0,0,0
1000000US060952523051018,060952523051018,"Block 1018, Block Group 1, Census Tract 2523.05, Solano County, California",0,0,0
1000000US060952523051019,060952523051019,"Block 1019, Block Group 1, Census Tract 2523.05, Solano County, California",0,0,0
1000000US060952523051020,060952523051020,"Block 1020, Block Group 1, Census Tract 2523.05, Solano County, California",0,0,0
1000000US060952523051021,060952523051021,"Block 1021, Block Group 1, Census Tract 2523.05, Solano County, California",0,0,0
1000000US060952523051022,060952523051022,"Block 1022, Block Group 1, Census Tract 2523.05, Solano County, California",0,0,0
1000000US060952523051023,060952523051023,"Block 1023, Block Group 1, Census Tract 2523.05, Solano County, California",0,0,0
1000000US060952523051024,060952523051024,"Block 1024, Block Group 1, Census Tract 2523.05, Solano County, California",0,0,0
1000000US060952523051025,060952523051025,"Block 1025, Block Group 1, Census Tract 2523.05, Solano County, California",0,0,0
1000000US060952523051026,060952523051026,"Block 1026, Block Group 1, Census Tract 2523.05, Solano County, California",49,45,4
1000000US060952523051027,060952523051027,"Block 1027, Block Group 1, Census Tract 2523.05, Solano County, California",9,7,2
1000000US060952523051028,060952523051028,"Block 1028, Block Group 1, Census Tract 2523.05, Solano County, California",10,8,2
1000000US060952523051029,060952523051029,"Block 1029, Block Group 1, Census Tract 2523.05, Solano County, California",0,0,0
1000000US060952523051030,060952523051030,"Block 1030, Block Group 1, Census Tract 2523.05, Solano County, California",0,0,0
1000000US060952523051031,060952523051031,"Block 1031, Block Group 1, Census Tract 2523.05, Solano County, California",0,0,0
1000000US060952523051032,060952523051032,"Block 1032, Block Group 1, Census Tract 2523.05, Solano County, California",0,0,0
1000000US060952523051033,060952523051033,"Block 1033, Block Group 1, Census Tract 2523.05, Solano County, California",17,15,2
1000000US060952523051034,060952523051034,"Block 1034, Block Group 1, Census Tract 2523.05, Solano County, California",0,0,0
1000000US060952523051035,060952523051035,"Block 1035, Block Group 1, Census Tract 2523.05, Solano County, California",0,0,0
1000000US060952523051036,060952523051036,"Block 1036, Block Group 1, Census Tract 2523.05, Solano County, California",0,0,0
1000000US060952523051037,060952523051037,"Block 1037, Block Group 1, Census Tract 2523.05, Solano County, California",0,0,0
1000000US060952523051038,060952523051038,"Block 1038, Block Group 1, Census Tract 2523.05, Solano County, California",0,0,0
1000000US060952523051039,060952523051039,"Block 1039, Block Group 1, Census Tract 2523.05, Solano County, California",0,0,0
1000000US060952523051040,060952523051040,"Block 1040, Block Group 1, Census Tract 2523.05, Solano County, California",0,0,0
1000000US060952523051041,060952523051041,"Block 1041, Block Group 1, Census Tract 2523.05, Solano County, California",0,0,0
1000000US060952523051042,060952523051042,"Block 1042, Block Group 1, Census Tract 2523.05, Solano County, California",0,0,0
1000000US060952523051043,060952523051043,"Block 1043, Block Group 1, Census Tract 2523.05, Solano County, California",0,0,0
1000000US060952523051044,060952523051044,"Block 1044, Block Group 1, Census Tract 2523.05, Solano County, California",0,0,0
1000000US060952523051045,060952523051045,"Block 1045, Block Group 1, Census Tract 2523.05, Solano County, California",0,0,0
1000000US060952523051046,060952523051046,"Block 1046, Block Group 1, Census Tract 2523.05, Solano County, California",0,0,0
1000000US060952523051047,060952523051047,"Block 1047, Block Group 1, Census Tract 2523.05, Solano County, California",0,0,0
1000000US060952523051048,060952523051048,"Block 1048, Block Group 1, Census Tract 2523.05, Solano County, California",0,0,0
1000000US060952523051049,060952523051049,"Block 1049, Block Group 1, Census Tract 2523.05, Solano County, California",0,0,0
1000000US060952523051050,060952523051050,"Block 1050, Block Group 1, Census Tract 2523.05, Solano County, California",0,0,0
1000000US060952523051051,060952523051051,"Block 1051, Block Group 1, Census Tract 2523.05, Solano County, California",0,0,0
1000000US060952523051052,060952523051052,"Block 1052, Block Group 1, Census Tract 2523.05, Solano County, California",0,0,0
1000000US060952523051053,060952523051053,"Block 1053, Block Group 1, Census Tract 2523.05, Solano County, California",0,0,0
1000000US060952523051054,060952523051054,"Block 1054, Block Group 1, Census Tract 2523.05, Solano County, California",0,0,0
1000000US060952523051055,060952523051055,"Block 1055, Block Group 1, Census Tract 2523.05, Solano County, California",0,0,0
1000000US060952523051056,060952523051056,"Block 1056, Block Group 1, Census Tract 2523.05, Solano County, California",0,0,0
1000000US060952523051057,060952523051057,"Block 1057, Block Group 1, Census Tract 2523.05, Solano County, California",0,0,0
1000000US060952523051058,060952523051058,"Block 1058, Block Group 1, Census Tract 2523.05, Solano County, California",3,3,0
1000000US060952523051059,060952523051059,"Block 1059, Block Group 1, Census Tract 2523.05, Solano County, California",0,0,0
1000000US060952523051060,060952523051060,"Block 1060, Block Group 1, Census Tract 2523.05, Solano County, California",3,3,0
1000000US060952523051061,060952523051061,"Block 1061, Block Group 1, Census Tract 2523.05, Solano County, California",0,0,0
1000000US060952523051062,060952523051062,"Block 1062, Block Group 1, Census Tract 2523.05, Solano County, California",0,0,0
1000000US060952523051063,060952523051063,"Block 1063, Block Group 1, Census Tract 2523.05, Solano County, California",0,0,0
1000000US060952523051064,060952523051064,"Block 1064, Block Group 1, Census Tract 2523.05, Solano County, California",0,0,0
1000000US060952523051065,060952523051065,"Block 1065, Block Group 1, Census Tract 2523.05, Solano County, California",0,0,0
1000000US060952523051066,060952523051066,"Block 1066, Block Group 1, Census Tract 2523.05, Solano County, California",1,1,0
1000000US060952523051067,060952523051067,"Block 1067, Block Group 1, Census Tract 2523.05, Solano County, California",0,0,0
1000000US060952523051068,060952523051068,"Block 1068, Block Group 1, Census Tract 2523.05, Solano County, California",0,0,0
1000000US060952523051069,060952523051069,"Block 1069, Block Group 1, Census Tract 2523.05, Solano County, California",2,2,0
1000000US060952523051070,060952523051070,"Block 1070, Block Group 1, Census Tract 2523.05, Solano County, California",3,2,1
1000000US060952523051071,060952523051071,"Block 1071, Block Group 1, Census Tract 2523.05, Solano County, California",0,0,0
1000000US060952523051072,060952523051072,"Block 1072, Block Group 1, Census Tract 2523.05, Solano County, California",0,0,0
1000000US060952523051073,060952523051073,"Block 1073, Block Group 1, Census Tract 2523.05, Solano County, California",5,5,0
1000000US060952523051074,060952523051074,"Block 1074, Block Group 1, Census Tract 2523.05, Solano County, California",0,0,0
1000000US060952523051075,060952523051075,"Block 1075, Block Group 1, Census Tract 2523.05, Solano County, California",5,5,0
1000000US060952523051076,060952523051076,"Block 1076, Block Group 1, Census Tract 2523.05, Solano County, California",10,10,0
1000000US060952523051077,060952523051077,"Block 1077, Block Group 1, Census Tract 2523.05, Solano County, California",5,5,0
1000000US060952523051078,060952523051078,"Block 1078, Block Group 1, Census Tract 2523.05, Solano County, California",74,69,5
1000000US060952523051079,060952523051079,"Block 1079, Block Group 1, Census Tract 2523.05, Solano County, California",52,50,2
1000000US060952523051080,060952523051080,"Block 1080, Block Group 1, Census Tract 2523.05, Solano County, California",244,225,19
1000000US060952523051081,060952523051081,"Block 1081, Block Group 1, Census Tract 2523.05, Solano County, California",14,13,1
1000000US060952523051082,060952523051082,"Block 1082, Block Group 1, Census Tract 2523.05, Solano County, California",13,13,0
1000000US060952523051083,060952523051083,"Block 1083, Block Group 1, Census Tract 2523.05, Solano County, California",72,62,10
1000000US060952523051084,060952523051084,"Block 1084, Block Group 1, Census Tract 2523.05, Solano County, California",12,12,0
1000000US060952523051085,060952523051085,"Block 1085, Block Group 1, Census Tract 2523.05, Solano County, California",38,36,2
1000000US060952523051086,060952523051086,"Block 1086, Block Group 1, Census Tract 2523.05, Solano County, California",17,17,0
1000000US060952523051087,060952523051087,"Block 1087, Block Group 1, Census Tract 2523.05, Solano County, California",3,3,0
1000000US060952523051088,060952523051088,"Block 1088, Block Group 1, Census Tract 2523.05, Solano County, California",0,0,0
1000000US060952523051089,060952523051089,"Block 1089, Block Group 1, Census Tract 2523.05, Solano County, California",8,7,1
1000000US060952523051090,060952523051090,"Block 1090, Block Group 1, Census Tract 2523.05, Solano County, California",1,1,0
1000000US060952523051091,060952523051091,"Block 1091, Block Group 1, Census Tract 2523.05, Solano County, California",0,0,0
1000000US060952523051092,060952523051092,"Block 1092, Block Group 1, Census Tract 2523.05, Solano County, California",0,0,0
1000000US060952523051093,060952523051093,"Block 1093, Block Group 1, Census Tract 2523.05, Solano County, California",0,0,0
1000000US060952523051094,060952523051094,"Block 1094, Block Group 1, Census Tract 2523.05, Solano County, California",0,0,0
1000000US060952523051095,060952523051095,"Block 1095, Block Group 1, Census Tract 2523.05, Solano County, California",0,0,0
1000000US060952523051096,060952523051096,"Block 1096, Block Group 1, Census Tract 2523.05, Solano County, California",0,0,0
1000000US060952523051097,060952523051097,"Block 1097, Block Group 1, Census Tract 2523.05, Solano County, California",0,0,0
1000000US060952523051098,060952523051098,"Block 1098, Block Group 1, Census Tract 2523.05, Solano County, California",1,1,0
1000000US060952523051099,060952523051099,"Block 1099, Block Group 1, Census Tract 2523.05, Solano County, California",0,0,0
1000000US060952523051100,060952523051100,"Block 1100, Block Group 1, Census Tract 2523.05, Solano County, California",0,0,0
1000000US060952523051101,060952523051101,"Block 1101, Block Group 1, Census Tract 2523.05, Solano County, California",0,0,0
1000000US060952523051102,060952523051102,"Block 1102, Block Group 1, Census Tract 2523.05, Solano County, California",0,0,0
1000000US060952523051103,060952523051103,"Block 1103, Block Group 1, Census Tract 2523.05, Solano County, California",0,0,0
1000000US060952523051104,060952523051104,"Block 1104, Block Group 1, Census Tract 2523.05, Solano County, California",0,0,0
1000000US060952523051105,060952523051105,"Block 1105, Block Group 1, Census Tract 2523.05, Solano County, California",0,0,0
1000000US060952523051106,060952523051106,"Block 1106, Block Group 1, Census Tract 2523.05, Solano County, California",0,0,0
1000000US060952523051107,060952523051107,"Block 1107, Block Group 1, Census Tract 2523.05, Solano County, California",0,0,0
1000000US060952523051108,060952523051108,"Block 1108, Block Group 1, Census Tract 2523.05, Solano County, California",0,0,0
1000000US060952523051109,060952523051109,"Block 1109, Block Group 1, Census Tract 2523.05, Solano County, California",0,0,0
1000000US060952523051110,060952523051110,"Block 1110, Block Group 1, Census Tract 2523.05, Solano County, California",0,0,0
1000000US060952523051111,060952523051111,"Block 1111, Block Group 1, Census Tract 2523.05, Solano County, California",0,0,0
1000000US060952523051112,060952523051112,"Block 1112, Block Group 1, Census Tract 2523.05, Solano County, California",0,0,0
1000000US060952523051113,060952523051113,"Block 1113, Block Group 1, Census Tract 2523.05, Solano County, California",0,0,0
1000000US060952523051114,060952523051114,"Block 1114, Block Group 1, Census Tract 2523.05, Solano County, California",0,0,0
1000000US060952523051115,060952523051115,"Block 1115, Block Group 1, Census Tract 2523.05, Solano County, California",0,0,0
1000000US060952523051116,060952523051116,"Block 1116, Block Group 1, Census Tract 2523.05, Solano County, California",0,0,0
1000000US060952523051117,060952523051117,"Block 1117, Block Group 1, Census Tract 2523.05, Solano County, California",0,0,0
1000000US060952523051118,060952523051118,"Block 1118, Block Group 1, Census Tract 2523.05, Solano County, California",0,0,0
1000000US060952523051119,060952523051119,"Block 1119, Block Group 1, Census Tract 2523.05, Solano County, California",0,0,0
1000000US060952523051120,060952523051120,"Block 1120, Block Group 1, Census Tract 2523.05, Solano County, California",0,0,0
1000000US060952523051121,060952523051121,"Block 1121, Block Group 1, Census Tract 2523.05, Solano County, California",0,0,0
1000000US060952523051122,060952523051122,"Block 1122, Block Group 1, Census Tract 2523.05, Solano County, California",0,0,0
1000000US060952523051123,060952523051123,"Block 1123, Block Group 1, Census Tract 2523.05, Solano County, California",0,0,0
1000000US060952523051124,060952523051124,"Block 1124, Block Group 1, Census Tract 2523.05, Solano County, California",0,0,0
1000000US060952523051125,060952523051125,"Block 1125, Block Group 1, Census Tract 2523.05, Solano County, California",0,0,0
1000000US060952523051126,060952523051126,"Block 1126, Block Group 1, Census Tract 2523.05, Solano County, California",0,0,0
1000000US060952523051127,060952523051127,"Block 1127, Block Group 1, Census Tract 2523.05, Solano County, California",0,0,0
1000000US060952523051128,060952523051128,"Block 1128, Block Group 1, Census Tract 2523.05, Solano County, California",0,0,0
1000000US060952523051129,060952523051129,"Block 1129, Block Group 1, Census Tract 2523.05, Solano County, California",0,0,0
1000000US060952523051130,060952523051130,"Block 1130, Block Group 1, Census Tract 2523.05, Solano County, California",0,0,0
1000000US060952523051131,060952523051131,"Block 1131, Block Group 1, Census Tract 2523.05, Solano County, California",0,0,0
1000000US060952523051132,060952523051132,"Block 1132, Block Group 1, Census Tract 2523.05, Solano County, California",0,0,0
1000000US060952523051133,060952523051133,"Block 1133, Block Group 1, Census Tract 2523.05, Solano County, California",0,0,0
1000000US060952523051134,060952523051134,"Block 1134, Block Group 1, Census Tract 2523.05, Solano County, California",0,0,0
1000000US060952523051135,060952523051135,"Block 1135, Block Group 1, Census Tract 2523.05, Solano County, California",0,0,0
1000000US060952523051136,060952523051136,"Block 1136, Block Group 1, Census Tract 2523.05, Solano County, California",0,0,0
1000000US060952523051137,060952523051137,"Block 1137, Block Group 1, Census Tract 2523.05, Solano County, California",0,0,0
1000000US060952523051138,060952523051138,"Block 1138, Block Group 1, Census Tract 2523.05, Solano County, California",0,0,0
1000000US060952523051139,060952523051139,"Block 1139, Block Group 1, Census Tract 2523.05, Solano County, California",0,0,0
1000000US060952523051140,060952523051140,"Block 1140, Block Group 1, Census Tract 2523.05, Solano County, California",0,0,0
1000000US060952523051141,060952523051141,"Block 1141, Block Group 1, Census Tract 2523.05, Solano County, California",0,0,0
1000000US060952523051142,060952523051142,"Block 1142, Block Group 1, Census Tract 2523.05, Solano County, California",0,0,0
1000000US060952523051143,060952523051143,"Block 1143, Block Group 1, Census Tract 2523.05, Solano County, California",0,0,0
1000000US060952523051144,060952523051144,"Block 1144, Block Group 1, Census Tract 2523.05, Solano County, California",0,0,0
1000000US060952523051145,060952523051145,"Block 1145, Block Group 1, Census Tract 2523.05, Solano County, California",0,0,0
1000000US060952523051146,060952523051146,"Block 1146, Block Group 1, Census Tract 2523.05, Solano County, California",0,0,0
1000000US060952523051147,060952523051147,"Block 1147, Block Group 1, Census Tract 2523.05, Solano County, California",0,0,0
1000000US060952523051148,060952523051148,"Block 1148, Block Group 1, Census Tract 2523.05, Solano County, California",0,0,0
1000000US060952523051149,060952523051149,"Block 1149, Block Group 1, Census Tract 2523.05, Solano County, California",0,0,0
1000000US060952523051150,060952523051150,"Block 1150, Block Group 1, Census Tract 2523.05, Solano County, California",0,0,0
1000000US060952523051151,060952523051151,"Block 1151, Block Group 1, Census Tract 2523.05, Solano County, California",0,0,0
1000000US060952523051152,060952523051152,"Block 1152, Block Group 1, Census Tract 2523.05, Solano County, California",0,0,0
1000000US060952523051153,060952523051153,"Block 1153, Block Group 1, Census Tract 2523.05, Solano County, California",0,0,0
1000000US060952523051154,060952523051154,"Block 1154, Block Group 1, Census Tract 2523.05, Solano County, California",0,0,0
1000000US060952523051155,060952523051155,"Block 1155, Block Group 1, Census Tract 2523.05, Solano County, California",0,0,0
1000000US060952523051156,060952523051156,"Block 1156, Block Group 1, Census Tract 2523.05, Solano County, California",0,0,0
1000000US060952523051157,060952523051157,"Block 1157, Block Group 1, Census Tract 2523.05, Solano County, California",0,0,0
1000000US060952523051158,060952523051158,"Block 1158, Block Group 1, Census Tract 2523.05, Solano County, California",0,0,0
1000000US060952523051159,060952523051159,"Block 1159, Block Group 1, Census Tract 2523.05, Solano County, California",0,0,0
1000000US060952523051160,060952523051160,"Block 1160, Block Group 1, Census Tract 2523.05, Solano County, California",0,0,0
1000000US060952523051161,060952523051161,"Block 1161, Block Group 1, Census Tract 2523.05, Solano County, California",0,0,0
1000000US060952523051162,060952523051162,"Block 1162, Block Group 1, Census Tract 2523.05, Solano County, California",0,0,0
1000000US060952523051163,060952523051163,"Block 1163, Block Group 1, Census Tract 2523.05, Solano County, California",0,0,0
1000000US060952523051164,060952523051164,"Block 1164, Block Group 1, Census Tract 2523.05, Solano County, California",0,0,0
1000000US060952523051165,060952523051165,"Block 1165, Block Group 1, Census Tract 2523.05, Solano County, California",0,0,0
1000000US060952523051166,060952523051166,"Block 1166, Block Group 1, Census Tract 2523.05, Solano County, California",0,0,0
1000000US060952523051167,060952523051167,"Block 1167, Block Group 1, Census Tract 2523.05, Solano County, California",0,0,0
1000000US060952523051168,060952523051168,"Block 1168, Block Group 1, Census Tract 2523.05, Solano County, California",0,0,0
1000000US060952523051169,060952523051169,"Block 1169, Block Group 1, Census Tract 2523.05, Solano County, California",0,0,0
1000000US060952523051170,060952523051170,"Block 1170, Block Group 1, Census Tract 2523.05, Solano County, California",0,0,0
1000000US060952523051171,060952523051171,"Block 1171, Block Group 1, Census Tract 2523.05, Solano County, California",0,0,0
1000000US060952523051172,060952523051172,"Block 1172, Block Group 1, Census Tract 2523.05, Solano County, California",0,0,0
1000000US060952523051173,060952523051173,"Block 1173, Block Group 1, Census Tract 2523.05, Solano County, California",0,0,0
1000000US060952523051174,060952523051174,"Block 1174, Block Group 1, Census Tract 2523.05, Solano County, California",0,0,0
1000000US060952523051175,060952523051175,"Block 1175, Block Group 1, Census Tract 2523.05, Solano County, California",0,0,0
1000000US060952523051176,060952523051176,"Block 1176, Block Group 1, Census Tract 2523.05, Solano County, California",0,0,0
1000000US060952523052000,060952523052000,"Block 2000, Block Group 2, Census Tract 2523.05, Solano County, California",14,13,1
1000000US060952523052001,060952523052001,"Block 2001, Block Group 2, Census Tract 2523.05, Solano County, California",0,0,0
1000000US060952523052002,060952523052002,"Block 2002, Block Group 2, Census Tract 2523.05, Solano County, California",77,76,1
1000000US060952523052003,060952523052003,"Block 2003, Block Group 2, Census Tract 2523.05, Solano County, California",23,23,0
1000000US060952523052004,060952523052004,"Block 2004, Block Group 2, Census Tract 2523.05, Solano County, California",0,0,0
1000000US060952523052005,060952523052005,"Block 2005, Block Group 2, Census Tract 2523.05, Solano County, California",0,0,0
1000000US060952523052006,060952523052006,"Block 2006, Block Group 2, Census Tract 2523.05, Solano County, California",0,0,0
1000000US060952523052007,060952523052007,"Block 2007, Block Group 2, Census Tract 2523.05, Solano County, California",0,0,0
1000000US060952523052008,060952523052008,"Block 2008, Block Group 2, Census Tract 2523.05, Solano County, California",0,0,0
1000000US060952523052009,060952523052009,"Block 2009, Block Group 2, Census Tract 2523.05, Solano County, California",0,0,0
1000000US060952523052010,060952523052010,"Block 2010, Block Group 2, Census Tract 2523.05, Solano County, California",0,0,0
1000000US060952523052011,060952523052011,"Block 2011, Block Group 2, Census Tract 2523.05, Solano County, California",0,0,0
1000000US060952523052012,060952523052012,"Block 2012, Block Group 2, Census Tract 2523.05, Solano County, California",0,0,0
1000000US060952523052013,060952523052013,"Block 2013, Block Group 2, Census Tract 2523.05, Solano County, California",0,0,0
1000000US060952523052014,060952523052014,"Block 2014, Block Group 2, Census Tract 2523.05, Solano County, California",32,31,1
1000000US060952523052015,060952523052015,"Block 2015, Block Group 2, Census Tract 2523.05, Solano County, California",13,13,0
1000000US060952523052016,060952523052016,"Block 2016, Block Group 2, Census Tract 2523.05, Solano County, California",40,40,0
1000000US060952523052017,060952523052017,"Block 2017, Block Group 2, Census Tract 2523.05, Solano County, California",0,0,0
1000000US060952523052018,060952523052018,"Block 2018, Block Group 2, Census Tract 2523.05, Solano County, California",0,0,0
1000000US060952523052019,060952523052019,"Block 2019, Block Group 2, Census Tract 2523.05, Solano County, California",7,7,0
1000000US060952523052020,060952523052020,"Block 2020, Block Group 2, Census Tract 2523.05, Solano County, California",23,21,2
1000000US060952523052021,060952523052021,"Block 2021, Block Group 2, Census Tract 2523.05, Solano County, California",43,39,4
1000000US060952523052022,060952523052022,"Block 2022, Block Group 2, Census Tract 2523.05, Solano County, California",5,5,0
1000000US060952523052023,060952523052023,"Block 2023, Block Group 2, Census Tract 2523.05, Solano County, California",25,22,3
1000000US060952523052024,060952523052024,"Block 2024, Block Group 2, Census Tract 2523.05, Solano County, California",0,0,0
1000000US060952523052025,060952523052025,"Block 2025, Block Group 2, Census Tract 2523.05, Solano County, California",0,0,0
1000000US060952523052026,060952523052026,"Block 2026, Block Group 2, Census Tract 2523.05, Solano County, California",0,0,0
1000000US060952523053000,060952523053000,"Block 3000, Block Group 3, Census Tract 2523.05, Solano County, California",45,44,1
1000000US060952523053001,060952523053001,"Block 3001, Block Group 3, Census Tract 2523.05, Solano County, California",50,49,1
1000000US060952523053002,060952523053002,"Block 3002, Block Group 3, Census Tract 2523.05, Solano County, California",2,2,0
1000000US060952523053003,060952523053003,"Block 3003, Block Group 3, Census Tract 2523.05, Solano County, California",1,1,0
1000000US060952523053004,060952523053004,"Block 3004, Block Group 3, Census Tract 2523.05, Solano County, California",0,0,0
1000000US060952523053005,060952523053005,"Block 3005, Block Group 3, Census Tract 2523.05, Solano County, California",0,0,0
1000000US060952523053006,060952523053006,"Block 3006, Block Group 3, Census Tract 2523.05, Solano County, California",18,18,0
1000000US060952523053007,060952523053007,"Block 3007, Block Group 3, Census Tract 2523.05, Solano County, California",49,45,4
1000000US060952523053008,060952523053008,"Block 3008, Block Group 3, Census Tract 2523.05, Solano County, California",43,43,0
1000000US060952523053009,060952523053009,"Block 3009, Block Group 3, Census Tract 2523.05, Solano County, California",0,0,0
1000000US060952523053010,060952523053010,"Block 3010, Block Group 3, Census Tract 2523.05, Solano County, California",98,95,3
1000000US060952523053011,060952523053011,"Block 3011, Block Group 3, Census Tract 2523.05, Solano County, California",38,38,0
1000000US060952523053012,060952523053012,"Block 3012, Block Group 3, Census Tract 2523.05, Solano County, California",27,27,0
1000000US060952523053013,060952523053013,"Block 3013, Block Group 3, Census Tract 2523.05, Solano County, California",24,23,1
1000000US060952523053014,060952523053014,"Block 3014, Block Group 3, Census Tract 2523.05, Solano County, California",39,38,1
1000000US060952523053015,060952523053015,"Block 3015, Block Group 3, Census Tract 2523.05, Solano County, California",21,20,1
1000000US060952523053016,060952523053016,"Block 3016, Block Group 3, Census Tract 2523.05, Solano County, California",18,17,1
1000000US060952523053017,060952523053017,"Block 3017, Block Group 3, Census Tract 2523.05, Solano County, California",48,48,0
1000000US060952523053018,060952523053018,"Block 3018, Block Group 3, Census Tract 2523.05, Solano County, California",32,32,0
1000000US060952523053019,060952523053019,"Block 3019, Block Group 3, Census Tract 2523.05, Solano County, California",53,51,2
1000000US060952523053020,060952523053020,"Block 3020, Block Group 3, Census Tract 2523.05, Solano County, California",25,25,0
1000000US060952523053021,060952523053021,"Block 3021, Block Group 3, Census Tract 2523.05, Solano County, California",32,32,0
1000000US060952523053022,060952523053022,"Block 3022, Block Group 3, Census Tract 2523.05, Solano County, California",0,0,0
1000000US060952523053023,060952523053023,"Block 3023, Block Group 3, Census Tract 2523.05, Solano County, California",0,0,0
1000000US060952523061000,060952523061000,"Block 1000, Block Group 1, Census Tract 2523.06, Solano County, California",160,159,1
1000000US060952523061001,060952523061001,"Block 1001, Block Group 1, Census Tract 2523.06, Solano County, California",3,3,0
1000000US060952523061002,060952523061002,"Block 1002, Block Group 1, Census Tract 2523.06, Solano County, California",0,0,0
1000000US060952523061003,060952523061003,"Block 1003, Block Group 1, Census Tract 2523.06, Solano County, California",22,21,1
1000000US060952523061004,060952523061004,"Block 1004, Block Group 1, Census Tract 2523.06, Solano County, California",15,14,1
1000000US060952523061005,060952523061005,"Block 1005, Block Group 1, Census Tract 2523.06, Solano County, California",38,37,1
1000000US060952523061006,060952523061006,"Block 1006, Block Group 1, Census Tract 2523.06, Solano County, California",43,37,6
1000000US060952523061007,060952523061007,"Block 1007, Block Group 1, Census Tract 2523.06, Solano County, California",45,45,0
1000000US060952523061008,060952523061008,"Block 1008, Block Group 1, Census Tract 2523.06, Solano County, California",44,43,1
1000000US060952523061009,060952523061009,"Block 1009, Block Group 1, Census Tract 2523.06, Solano County, California",50,46,4
1000000US060952523061010,060952523061010,"Block 1010, Block Group 1, Census Tract 2523.06, Solano County, California",50,49,1
1000000US060952523061011,060952523061011,"Block 1011, Block Group 1, Census Tract 2523.06, Solano County, California",26,24,2
1000000US060952523062000,060952523062000,"Block 2000, Block Group 2, Census Tract 2523.06, Solano County, California",0,0,0
1000000US060952523062001,060952523062001,"Block 2001, Block Group 2, Census Tract 2523.06, Solano County, California",0,0,0
1000000US060952523062002,060952523062002,"Block 2002, Block Group 2, Census Tract 2523.06, Solano County, California",0,0,0
1000000US060952523062003,060952523062003,"Block 2003, Block Group 2, Census Tract 2523.06, Solano County, California",43,43,0
1000000US060952523062004,060952523062004,"Block 2004, Block Group 2, Census Tract 2523.06, Solano County, California",28,28,0
1000000US060952523062005,060952523062005,"Block 2005, Block Group 2, Census Tract 2523.06, Solano County, California",0,0,0
1000000US060952523062006,060952523062006,"Block 2006, Block Group 2, Census Tract 2523.06, Solano County, California",22,19,3
1000000US060952523062007,060952523062007,"Block 2007, Block Group 2, Census Tract 2523.06, Solano County, California",39,37,2
1000000US060952523062008,060952523062008,"Block 2008, Block Group 2, Census Tract 2523.06, Solano County, California",39,37,2
1000000US060952523062009,060952523062009,"Block 2009, Block Group 2, Census Tract 2523.06, Solano County, California",0,0,0
1000000US060952523062010,060952523062010,"Block 2010, Block Group 2, Census Tract 2523.06, Solano County, California",38,37,1
1000000US060952523062011,060952523062011,"Block 2011, Block Group 2, Census Tract 2523.06, Solano County, California",22,19,3
1000000US060952523062012,060952523062012,"Block 2012, Block Group 2, Census Tract 2523.06, Solano County, California",9,9,0
1000000US060952523062013,060952523062013,"Block 2013, Block Group 2, Census Tract 2523.06, Solano County, California",40,38,2
1000000US060952523062014,060952523062014,"Block 2014, Block Group 2, Census Tract 2523.06, Solano County, California",73,69,4
1000000US060952523062015,060952523062015,"Block 2015, Block Group 2, Census Tract 2523.06, Solano County, California",11,10,1
1000000US060952523062016,060952523062016,"Block 2016, Block Group 2, Census Tract 2523.06, Solano County, California",8,7,1
1000000US060952523062017,060952523062017,"Block 2017, Block Group 2, Census Tract 2523.06, Solano County, California",0,0,0
1000000US060952523062018,060952523062018,"Block 2018, Block Group 2, Census Tract 2523.06, Solano County, California",42,40,2
1000000US060952523062019,060952523062019,"Block 2019, Block Group 2, Census Tract 2523.06, Solano County, California",25,25,0
1000000US060952523062020,060952523062020,"Block 2020, Block Group 2, Census Tract 2523.06, Solano County, California",135,134,1
1000000US060952523062021,060952523062021,"Block 2021, Block Group 2, Census Tract 2523.06, Solano County, California",11,11,0
1000000US060952523062022,060952523062022,"Block 2022, Block Group 2, Census Tract 2523.06, Solano County, California",38,36,2
1000000US060952523062023,060952523062023,"Block 2023, Block Group 2, Census Tract 2523.06, Solano County, California",10,10,0
1000000US060952523062024,060952523062024,"Block 2024, Block Group 2, Census Tract 2523.06, Solano County, California",29,28,1
1000000US060952523062025,060952523062025,"Block 2025, Block Group 2, Census Tract 2523.06, Solano County, California",41,40,1
1000000US060952523062026,060952523062026,"Block 2026, Block Group 2, Census Tract 2523.06, Solano County, California",9,9,0
1000000US060952523062027,060952523062027,"Block 2027, Block Group 2, Census Tract 2523.06, Solano County, California",10,10,0
1000000US060952523062028,060952523062028,"Block 2028, Block Group 2, Census Tract 2523.06, Solano County, California",28,28,0
1000000US060952523062029,060952523062029,"Block 2029, Block Group 2, Census Tract 2523.06, Solano County, California",50,50,0
1000000US060952523062030,060952523062030,"Block 2030, Block Group 2, Census Tract 2523.06, Solano County, California",0,0,0
1000000US060952523101000,060952523101000,"Block 1000, Block Group 1, Census Tract 2523.10, Solano County, California",9,9,0
1000000US060952523101001,060952523101001,"Block 1001, Block Group 1, Census Tract 2523.10, Solano County, California",11,10,1
1000000US060952523101002,060952523101002,"Block 1002, Block Group 1, Census Tract 2523.10, Solano County, California",10,10,0
1000000US060952523101003,060952523101003,"Block 1003, Block Group 1, Census Tract 2523.10, Solano County, California",12,12,0
1000000US060952523101004,060952523101004,"Block 1004, Block Group 1, Census Tract 2523.10, Solano County, California",49,48,1
1000000US060952523101005,060952523101005,"Block 1005, Block Group 1, Census Tract 2523.10, Solano County, California",124,123,1
1000000US060952523101006,060952523101006,"Block 1006, Block Group 1, Census Tract 2523.10, Solano County, California",14,14,0
1000000US060952523101007,060952523101007,"Block 1007, Block Group 1, Census Tract 2523.10, Solano County, California",41,36,5
1000000US060952523101008,060952523101008,"Block 1008, Block Group 1, Census Tract 2523.10, Solano County, California",25,23,2
1000000US060952523101009,060952523101009,"Block 1009, Block Group 1, Census Tract 2523.10, Solano County, California",24,23,1
1000000US060952523101010,060952523101010,"Block 1010, Block Group 1, Census Tract 2523.10, Solano County, California",86,85,1
1000000US060952523101011,060952523101011,"Block 1011, Block Group 1, Census Tract 2523.10, Solano County, California",0,0,0
1000000US060952523101012,060952523101012,"Block 1012, Block Group 1, Census Tract 2523.10, Solano County, California",0,0,0
1000000US060952523101013,060952523101013,"Block 1013, Block Group 1, Census Tract 2523.10, Solano County, California",12,12,0
1000000US060952523101014,060952523101014,"Block 1014, Block Group 1, Census Tract 2523.10, Solano County, California",0,0,0
1000000US060952523101015,060952523101015,"Block 1015, Block Group 1, Census Tract 2523.10, Solano County, California",14,14,0
1000000US060952523101016,060952523101016,"Block 1016, Block Group 1, Census Tract 2523.10, Solano County, California",0,0,0
1000000US060952523101017,060952523101017,"Block 1017, Block Group 1, Census Tract 2523.10, Solano County, California",0,0,0
1000000US060952523101018,060952523101018,"Block 1018, Block Group 1, Census Tract 2523.10, Solano County, California",21,21,0
1000000US060952523101019,060952523101019,"Block 1019, Block Group 1, Census Tract 2523.10, Solano County, California",43,42,1
1000000US060952523101020,060952523101020,"Block 1020, Block Group 1, Census Tract 2523.10, Solano County, California",14,14,0
1000000US060952523101021,060952523101021,"Block 1021, Block Group 1, Census Tract 2523.10, Solano County, California",4,3,1
1000000US060952523101022,060952523101022,"Block 1022, Block Group 1, Census Tract 2523.10, Solano County, California",91,90,1
1000000US060952523101023,060952523101023,"Block 1023, Block Group 1, Census Tract 2523.10, Solano County, California",8,8,0
1000000US060952523101024,060952523101024,"Block 1024, Block Group 1, Census Tract 2523.10, Solano County, California",8,8,0
1000000US060952523101025,060952523101025,"Block 1025, Block Group 1, Census Tract 2523.10, Solano County, California",37,35,2
1000000US060952523101026,060952523101026,"Block 1026, Block Group 1, Census Tract 2523.10, Solano County, California",0,0,0
1000000US060952523101027,060952523101027,"Block 1027, Block Group 1, Census Tract 2523.10, Solano County, California",0,0,0
1000000US060952523101028,060952523101028,"Block 1028, Block Group 1, Census Tract 2523.10, Solano County, California",18,18,0
1000000US060952523101029,060952523101029,"Block 1029, Block Group 1, Census Tract 2523.10, Solano County, California",0,0,0
1000000US060952523101030,060952523101030,"Block 1030, Block Group 1, Census Tract 2523.10, Solano County, California",0,0,0
1000000US060952523101031,060952523101031,"Block 1031, Block Group 1, Census Tract 2523.10, Solano County, California",5,4,1
1000000US060952523101032,060952523101032,"Block 1032, Block Group 1, Census Tract 2523.10, Solano County, California",0,0,0
1000000US060952523101033,060952523101033,"Block 1033, Block Group 1, Census Tract 2523.10, Solano County, California",0,0,0
1000000US060952523101034,060952523101034,"Block 1034, Block Group 1, Census Tract 2523.10, Solano County, California",0,0,0
1000000US060952523101035,060952523101035,"Block 1035, Block Group 1, Census Tract 2523.10, Solano County, California",0,0,0
1000000US060952523101036,060952523101036,"Block 1036, Block Group 1, Census Tract 2523.10, Solano County, California",0,0,0
1000000US060952523101037,060952523101037,"Block 1037, Block Group 1, Census Tract 2523.10, Solano County, California",172,134,38
1000000US060952523101038,060952523101038,"Block 1038, Block Group 1, Census Tract 2523.10, Solano County, California",0,0,0
1000000US060952523101039,060952523101039,"Block 1039, Block Group 1, Census Tract 2523.10, Solano County, California",0,0,0
1000000US060952523101040,060952523101040,"Block 1040, Block Group 1, Census Tract 2523.10, Solano County, California",0,0,0
1000000US060952523101041,060952523101041,"Block 1041, Block Group 1, Census Tract 2523.10, Solano County, California",0,0,0
1000000US060952523101042,060952523101042,"Block 1042, Block Group 1, Census Tract 2523.10, Solano County, California",0,0,0
1000000US060952523101043,060952523101043,"Block 1043, Block Group 1, Census Tract 2523.10, Solano County, California",9,8,1
1000000US060952523101044,060952523101044,"Block 1044, Block Group 1, Census Tract 2523.10, Solano County, California",0,0,0
1000000US060952523101045,060952523101045,"Block 1045, Block Group 1, Census Tract 2523.10, Solano County, California",5,5,0
1000000US060952523101046,060952523101046,"Block 1046, Block Group 1, Census Tract 2523.10, Solano County, California",28,28,0
1000000US060952523101047,060952523101047,"Block 1047, Block Group 1, Census Tract 2523.10, Solano County, California",0,0,0
1000000US060952523101048,060952523101048,"Block 1048, Block Group 1, Census Tract 2523.10, Solano County, California",5,5,0
1000000US060952523101049,060952523101049,"Block 1049, Block Group 1, Census Tract 2523.10, Solano County, California",0,0,0
1000000US060952523101050,060952523101050,"Block 1050, Block Group 1, Census Tract 2523.10, Solano County, California",0,0,0
1000000US060952523101051,060952523101051,"Block 1051, Block Group 1, Census Tract 2523.10, Solano County, California",0,0,0
1000000US060952523101052,060952523101052,"Block 1052, Block Group 1, Census Tract 2523.10, Solano County, California",0,0,0
1000000US060952523101053,060952523101053,"Block 1053, Block Group 1, Census Tract 2523.10, Solano County, California",10,10,0
1000000US060952523101054,060952523101054,"Block 1054, Block Group 1, Census Tract 2523.10, Solano County, California",1,1,0
1000000US060952523102000,060952523102000,"Block 2000, Block Group 2, Census Tract 2523.10, Solano County, California",13,11,2
1000000US060952523102001,060952523102001,"Block 2001, Block Group 2, Census Tract 2523.10, Solano County, California",159,144,15
1000000US060952523102002,060952523102002,"Block 2002, Block Group 2, Census Tract 2523.10, Solano County, California",37,35,2
1000000US060952523102003,060952523102003,"Block 2003, Block Group 2, Census Tract 2523.10, Solano County, California",0,0,0
1000000US060952523102004,060952523102004,"Block 2004, Block Group 2, Census Tract 2523.10, Solano County, California",33,33,0
1000000US060952523102005,060952523102005,"Block 2005, Block Group 2, Census Tract 2523.10, Solano County, California",2,2,0
1000000US060952523102006,060952523102006,"Block 2006, Block Group 2, Census Tract 2523.10, Solano County, California",0,0,0
1000000US060952523102007,060952523102007,"Block 2007, Block Group 2, Census Tract 2523.10, Solano County, California",1,1,0
1000000US060952523102008,060952523102008,"Block 2008, Block Group 2, Census Tract 2523.10, Solano County, California",1,1,0
1000000US060952523102009,060952523102009,"Block 2009, Block Group 2, Census Tract 2523.10, Solano County, California",1,1,0
1000000US060952523102010,060952523102010,"Block 2010, Block Group 2, Census Tract 2523.10, Solano County, California",0,0,0
1000000US060952523102011,060952523102011,"Block 2011, Block Group 2, Census Tract 2523.10, Solano County, California",5,4,1
1000000US060952523102012,060952523102012,"Block 2012, Block Group 2, Census Tract 2523.10, Solano County, California",3,3,0
1000000US060952523102013,060952523102013,"Block 2013, Block Group 2, Census Tract 2523.10, Solano County, California",0,0,0
1000000US060952523102014,060952523102014,"Block 2014, Block Group 2, Census Tract 2523.10, Solano County, California",13,13,0
1000000US060952523102015,060952523102015,"Block 2015, Block Group 2, Census Tract 2523.10, Solano County, California",0,0,0
1000000US060952523102016,060952523102016,"Block 2016, Block Group 2, Census Tract 2523.10, Solano County, California",2,1,1
1000000US060952523102017,060952523102017,"Block 2017, Block Group 2, Census Tract 2523.10, Solano County, California",0,0,0
1000000US060952523102018,060952523102018,"Block 2018, Block Group 2, Census Tract 2523.10, Solano County, California",10,10,0
1000000US060952523102019,060952523102019,"Block 2019, Block Group 2, Census Tract 2523.10, Solano County, California",5,4,1
1000000US060952523102020,060952523102020,"Block 2020, Block Group 2, Census Tract 2523.10, Solano County, California",2,2,0
1000000US060952523102021,060952523102021,"Block 2021, Block Group 2, Census Tract 2523.10, Solano County, California",2,2,0
1000000US060952523102022,060952523102022,"Block 2022, Block Group 2, Census Tract 2523.10, Solano County, California",1,1,0
1000000US060952523102023,060952523102023,"Block 2023, Block Group 2, Census Tract 2523.10, Solano County, California",0,0,0
1000000US060952523102024,060952523102024,"Block 2024, Block Group 2, Census Tract 2523.10, Solano County, California",0,0,0
1000000US060952523102025,060952523102025,"Block 2025, Block Group 2, Census Tract 2523.10, Solano County, California",0,0,0
1000000US060952523102026,060952523102026,"Block 2026, Block Group 2, Census Tract 2523.10, Solano County, California",15,12,3
1000000US060952523102027,060952523102027,"Block 2027, Block Group 2, Census Tract 2523.10, Solano County, California",5,5,0
1000000US060952523102028,060952523102028,"Block 2028, Block Group 2, Census Tract 2523.10, Solano County, California",1,1,0
1000000US060952523102029,060952523102029,"Block 2029, Block Group 2, Census Tract 2523.10, Solano County, California",3,3,0
1000000US060952523102030,060952523102030,"Block 2030, Block Group 2, Census Tract 2523.10, Solano County, California",2,2,0
1000000US060952523102031,060952523102031,"Block 2031, Block Group 2, Census Tract 2523.10, Solano County, California",5,5,0
1000000US060952523102032,060952523102032,"Block 2032, Block Group 2, Census Tract 2523.10, Solano County, California",1,1,0
1000000US060952523102033,060952523102033,"Block 2033, Block Group 2, Census Tract 2523.10, Solano County, California",1,1,0
1000000US060952523102034,060952523102034,"Block 2034, Block Group 2, Census Tract 2523.10, Solano County, California",0,0,0
1000000US060952523102035,060952523102035,"Block 2035, Block Group 2, Census Tract 2523.10, Solano County, California",1,1,0
1000000US060952523102036,060952523102036,"Block 2036, Block Group 2, Census Tract 2523.10, Solano County, California",1,1,0
1000000US060952523102037,060952523102037,"Block 2037, Block Group 2, Census Tract 2523.10, Solano County, California",0,0,0
1000000US060952523102038,060952523102038,"Block 2038, Block Group 2, Census Tract 2523.10, Solano County, California",1,1,0
1000000US060952523102039,060952523102039,"Block 2039, Block Group 2, Census Tract 2523.10, Solano County, California",2,2,0
1000000US060952523102040,060952523102040,"Block 2040, Block Group 2, Census Tract 2523.10, Solano County, California",1,1,0
1000000US060952523102041,060952523102041,"Block 2041, Block Group 2, Census Tract 2523.10, Solano County, California",0,0,0
1000000US060952523102042,060952523102042,"Block 2042, Block Group 2, Census Tract 2523.10, Solano County, California",0,0,0
1000000US060952523102043,060952523102043,"Block 2043, Block Group 2, Census Tract 2523.10, Solano County, California",0,0,0
1000000US060952523102044,060952523102044,"Block 2044, Block Group 2, Census Tract 2523.10, Solano County, California",1,1,0
1000000US060952523102045,060952523102045,"Block 2045, Block Group 2, Census Tract 2523.10, Solano County, California",44,44,0
1000000US060952523102046,060952523102046,"Block 2046, Block Group 2, Census Tract 2523.10, Solano County, California",0,0,0
1000000US060952523102047,060952523102047,"Block 2047, Block Group 2, Census Tract 2523.10, Solano County, California",0,0,0
1000000US060952523102048,060952523102048,"Block 2048, Block Group 2, Census Tract 2523.10, Solano County, California",0,0,0
1000000US060952523102049,060952523102049,"Block 2049, Block Group 2, Census Tract 2523.10, Solano County, California",0,0,0
1000000US060952523102050,060952523102050,"Block 2050, Block Group 2, Census Tract 2523.10, Solano County, California",0,0,0
1000000US060952523102051,060952523102051,"Block 2051, Block Group 2, Census Tract 2523.10, Solano County, California",5,5,0
1000000US060952523102052,060952523102052,"Block 2052, Block Group 2, Census Tract 2523.10, Solano County, California",0,0,0
1000000US060952523102053,060952523102053,"Block 2053, Block Group 2, Census Tract 2523.10, Solano County, California",0,0,0
1000000US060952523102054,060952523102054,"Block 2054, Block Group 2, Census Tract 2523.10, Solano County, California",0,0,0
1000000US060952523102055,060952523102055,"Block 2055, Block Group 2, Census Tract 2523.10, Solano County, California",4,4,0
1000000US060952523102056,060952523102056,"Block 2056, Block Group 2, Census Tract 2523.10, Solano County, California",2,1,1
1000000US060952523102057,060952523102057,"Block 2057, Block Group 2, Census Tract 2523.10, Solano County, California",6,6,0
1000000US060952523111000,060952523111000,"Block 1000, Block Group 1, Census Tract 2523.11, Solano County, California",49,48,1
1000000US060952523111001,060952523111001,"Block 1001, Block Group 1, Census Tract 2523.11, Solano County, California",182,173,9
1000000US060952523111002,060952523111002,"Block 1002, Block Group 1, Census Tract 2523.11, Solano County, California",26,25,1
1000000US060952523111003,060952523111003,"Block 1003, Block Group 1, Census Tract 2523.11, Solano County, California",22,22,0
1000000US060952523111004,060952523111004,"Block 1004, Block Group 1, Census Tract 2523.11, Solano County, California",24,24,0
1000000US060952523111005,060952523111005,"Block 1005, Block Group 1, Census Tract 2523.11, Solano County, California",3,3,0
1000000US060952523111006,060952523111006,"Block 1006, Block Group 1, Census Tract 2523.11, Solano County, California",0,0,0
1000000US060952523111007,060952523111007,"Block 1007, Block Group 1, Census Tract 2523.11, Solano County, California",13,13,0
1000000US060952523111008,060952523111008,"Block 1008, Block Group 1, Census Tract 2523.11, Solano County, California",22,21,1
1000000US060952523111009,060952523111009,"Block 1009, Block Group 1, Census Tract 2523.11, Solano County, California",19,18,1
1000000US060952523111010,060952523111010,"Block 1010, Block Group 1, Census Tract 2523.11, Solano County, California",10,10,0
1000000US060952523111011,060952523111011,"Block 1011, Block Group 1, Census Tract 2523.11, Solano County, California",74,74,0
1000000US060952523111012,060952523111012,"Block 1012, Block Group 1, Census Tract 2523.11, Solano County, California",21,21,0
1000000US060952523111013,060952523111013,"Block 1013, Block Group 1, Census Tract 2523.11, Solano County, California",28,27,1
1000000US060952523111014,060952523111014,"Block 1014, Block Group 1, Census Tract 2523.11, Solano County, California",0,0,0
1000000US060952523112000,060952523112000,"Block 2000, Block Group 2, Census Tract 2523.11, Solano County, California",0,0,0
1000000US060952523112001,060952523112001,"Block 2001, Block Group 2, Census Tract 2523.11, Solano County, California",0,0,0
1000000US060952523112002,060952523112002,"Block 2002, Block Group 2, Census Tract 2523.11, Solano County, California",0,0,0
1000000US060952523112003,060952523112003,"Block 2003, Block Group 2, Census Tract 2523.11, Solano County, California",0,0,0
1000000US060952523112004,060952523112004,"Block 2004, Block Group 2, Census Tract 2523.11, Solano County, California",0,0,0
1000000US060952523112005,060952523112005,"Block 2005, Block Group 2, Census Tract 2523.11, Solano County, California",0,0,0
1000000US060952523112006,060952523112006,"Block 2006, Block Group 2, Census Tract 2523.11, Solano County, California",86,85,1
1000000US060952523112007,060952523112007,"Block 2007, Block Group 2, Census Tract 2523.11, Solano County, California",0,0,0
1000000US060952523112008,060952523112008,"Block 2008, Block Group 2, Census Tract 2523.11, Solano County, California",32,32,0
1000000US060952523112009,060952523112009,"Block 2009, Block Group 2, Census Tract 2523.11, Solano County, California",172,160,12
1000000US060952523112010,060952523112010,"Block 2010, Block Group 2, Census Tract 2523.11, Solano County, California",0,0,0
1000000US060952523112011,060952523112011,"Block 2011, Block Group 2, Census Tract 2523.11, Solano County, California",0,0,0
1000000US060952523112012,060952523112012,"Block 2012, Block Group 2, Census Tract 2523.11, Solano County, California",202,197,5
1000000US060952523112013,060952523112013,"Block 2013, Block Group 2, Census Tract 2523.11, Solano County, California",14,13,1
1000000US060952523112014,060952523112014,"Block 2014, Block Group 2, Census Tract 2523.11, Solano County, California",22,22,0
1000000US060952523112015,060952523112015,"Block 2015, Block Group 2, Census Tract 2523.11, Solano County, California",18,17,1
1000000US060952523112016,060952523112016,"Block 2016, Block Group 2, Census Tract 2523.11, Solano County, California",25,25,0
1000000US060952523112017,060952523112017,"Block 2017, Block Group 2, Census Tract 2523.11, Solano County, California",15,15,0
1000000US060952523112018,060952523112018,"Block 2018, Block Group 2, Census Tract 2523.11, Solano County, California",24,22,2
1000000US060952523112019,060952523112019,"Block 2019, Block Group 2, Census Tract 2523.11, Solano County, California",0,0,0
1000000US060952523112020,060952523112020,"Block 2020, Block Group 2, Census Tract 2523.11, Solano County, California",10,10,0
1000000US060952523112021,060952523112021,"Block 2021, Block Group 2, Census Tract 2523.11, Solano County, California",21,21,0
1000000US060952523112022,060952523112022,"Block 2022, Block Group 2, Census Tract 2523.11, Solano County, California",17,17,0
1000000US060952523112023,060952523112023,"Block 2023, Block Group 2, Census Tract 2523.11, Solano County, California",10,10,0
1000000US060952523112024,060952523112024,"Block 2024, Block Group 2, Census Tract 2523.11, Solano County, California",12,12,0
1000000US060952523112025,060952523112025,"Block 2025, Block Group 2, Census Tract 2523.11, Solano County, California",0,0,0
1000000US060952523112026,060952523112026,"Block 2026, Block Group 2, Census Tract 2523.11, Solano County, California",24,24,0
1000000US060952523112027,060952523112027,"Block 2027, Block Group 2, Census Tract 2523.11, Solano County, California",16,16,0
1000000US060952523112028,060952523112028,"Block 2028, Block Group 2, Census Tract 2523.11, Solano County, California",10,10,0
1000000US060952523112029,060952523112029,"Block 2029, Block Group 2, Census Tract 2523.11, Solano County, California",18,17,1
1000000US060952523112030,060952523112030,"Block 2030, Block Group 2, Census Tract 2523.11, Solano County, California",0,0,0
1000000US060952523112031,060952523112031,"Block 2031, Block Group 2, Census Tract 2523.11, Solano County, California",0,0,0
1000000US060952523112032,060952523112032,"Block 2032, Block Group 2, Census Tract 2523.11, Solano County, California",0,0,0
1000000US060952523112033,060952523112033,"Block 2033, Block Group 2, Census Tract 2523.11, Solano County, California",26,25,1
1000000US060952523112034,060952523112034,"Block 2034, Block Group 2, Census Tract 2523.11, Solano County, California",11,11,0
1000000US060952523113000,060952523113000,"Block 3000, Block Group 3, Census Tract 2523.11, Solano County, California",0,0,0
1000000US060952523113001,060952523113001,"Block 3001, Block Group 3, Census Tract 2523.11, Solano County, California",0,0,0
1000000US060952523113002,060952523113002,"Block 3002, Block Group 3, Census Tract 2523.11, Solano County, California",103,101,2
1000000US060952523113003,060952523113003,"Block 3003, Block Group 3, Census Tract 2523.11, Solano County, California",14,14,0
1000000US060952523113004,060952523113004,"Block 3004, Block Group 3, Census Tract 2523.11, Solano County, California",9,9,0
1000000US060952523113005,060952523113005,"Block 3005, Block Group 3, Census Tract 2523.11, Solano County, California",19,19,0
1000000US060952523113006,060952523113006,"Block 3006, Block Group 3, Census Tract 2523.11, Solano County, California",0,0,0
1000000US060952523113007,060952523113007,"Block 3007, Block Group 3, Census Tract 2523.11, Solano County, California",15,15,0
1000000US060952523113008,060952523113008,"Block 3008, Block Group 3, Census Tract 2523.11, Solano County, California",20,19,1
1000000US060952523113009,060952523113009,"Block 3009, Block Group 3, Census Tract 2523.11, Solano County, California",15,15,0
1000000US060952523113010,060952523113010,"Block 3010, Block Group 3, Census Tract 2523.11, Solano County, California",0,0,0
1000000US060952523113011,060952523113011,"Block 3011, Block Group 3, Census Tract 2523.11, Solano County, California",0,0,0
1000000US060952523113012,060952523113012,"Block 3012, Block Group 3, Census Tract 2523.11, Solano County, California",0,0,0
1000000US060952523113013,060952523113013,"Block 3013, Block Group 3, Census Tract 2523.11, Solano County, California",0,0,0
1000000US060952523113014,060952523113014,"Block 3014, Block Group 3, Census Tract 2523.11, Solano County, California",0,0,0
1000000US060952523113015,060952523113015,"Block 3015, Block Group 3, Census Tract 2523.11, Solano County, California",0,0,0
1000000US060952523113016,060952523113016,"Block 3016, Block Group 3, Census Tract 2523.11, Solano County, California",0,0,0
1000000US060952523113017,060952523113017,"Block 3017, Block Group 3, Census Tract 2523.11, Solano County, California",11,11,0
1000000US060952523113018,060952523113018,"Block 3018, Block Group 3, Census Tract 2523.11, Solano County, California",40,39,1
1000000US060952523113019,060952523113019,"Block 3019, Block Group 3, Census Tract 2523.11, Solano County, California",0,0,0
1000000US060952523113020,060952523113020,"Block 3020, Block Group 3, Census Tract 2523.11, Solano County, California",9,9,0
1000000US060952523113021,060952523113021,"Block 3021, Block Group 3, Census Tract 2523.11, Solano County, California",24,24,0
1000000US060952523113022,060952523113022,"Block 3022, Block Group 3, Census Tract 2523.11, Solano County, California",10,9,1
1000000US060952523113023,060952523113023,"Block 3023, Block Group 3, Census Tract 2523.11, Solano County, California",17,16,1
1000000US060952523113024,060952523113024,"Block 3024, Block Group 3, Census Tract 2523.11, Solano County, California",7,7,0
1000000US060952523121000,060952523121000,"Block 1000, Block Group 1, Census Tract 2523.12, Solano County, California",0,0,0
1000000US060952523121001,060952523121001,"Block 1001, Block Group 1, Census Tract 2523.12, Solano County, California",116,110,6
1000000US060952523121002,060952523121002,"Block 1002, Block Group 1, Census Tract 2523.12, Solano County, California",30,29,1
1000000US060952523121003,060952523121003,"Block 1003, Block Group 1, Census Tract 2523.12, Solano County, California",15,15,0
1000000US060952523121004,060952523121004,"Block 1004, Block Group 1, Census Tract 2523.12, Solano County, California",111,101,10
1000000US060952523121005,060952523121005,"Block 1005, Block Group 1, Census Tract 2523.12, Solano County, California",0,0,0
1000000US060952523121006,060952523121006,"Block 1006, Block Group 1, Census Tract 2523.12, Solano County, California",10,10,0
1000000US060952523121007,060952523121007,"Block 1007, Block Group 1, Census Tract 2523.12, Solano County, California",15,15,0
1000000US060952523121008,060952523121008,"Block 1008, Block Group 1, Census Tract 2523.12, Solano County, California",25,25,0
1000000US060952523121009,060952523121009,"Block 1009, Block Group 1, Census Tract 2523.12, Solano County, California",56,55,1
1000000US060952523121010,060952523121010,"Block 1010, Block Group 1, Census Tract 2523.12, Solano County, California",0,0,0
1000000US060952523121011,060952523121011,"Block 1011, Block Group 1, Census Tract 2523.12, Solano County, California",10,9,1
1000000US060952523121012,060952523121012,"Block 1012, Block Group 1, Census Tract 2523.12, Solano County, California",36,35,1
1000000US060952523121013,060952523121013,"Block 1013, Block Group 1, Census Tract 2523.12, Solano County, California",23,22,1
1000000US060952523121014,060952523121014,"Block 1014, Block Group 1, Census Tract 2523.12, Solano County, California",13,13,0
1000000US060952523121015,060952523121015,"Block 1015, Block Group 1, Census Tract 2523.12, Solano County, California",46,38,8
1000000US060952523121016,060952523121016,"Block 1016, Block Group 1, Census Tract 2523.12, Solano County, California",41,40,1
1000000US060952523121017,060952523121017,"Block 1017, Block Group 1, Census Tract 2523.12, Solano County, California",17,16,1
1000000US060952523121018,060952523121018,"Block 1018, Block Group 1, Census Tract 2523.12, Solano County, California",0,0,0
1000000US060952523121019,060952523121019,"Block 1019, Block Group 1, Census Tract 2523.12, Solano County, California",5,4,1
1000000US060952523121020,060952523121020,"Block 1020, Block Group 1, Census Tract 2523.12, Solano County, California",16,15,1
1000000US060952523121021,060952523121021,"Block 1021, Block Group 1, Census Tract 2523.12, Solano County, California",19,19,0
1000000US060952523121022,060952523121022,"Block 1022, Block Group 1, Census Tract 2523.12, Solano County, California",16,16,0
1000000US060952523121023,060952523121023,"Block 1023, Block Group 1, Census Tract 2523.12, Solano County, California",12,12,0
1000000US060952523122000,060952523122000,"Block 2000, Block Group 2, Census Tract 2523.12, Solano County, California",0,0,0
1000000US060952523122001,060952523122001,"Block 2001, Block Group 2, Census Tract 2523.12, Solano County, California",25,23,2
1000000US060952523122002,060952523122002,"Block 2002, Block Group 2, Census Tract 2523.12, Solano County, California",0,0,0
1000000US060952523122003,060952523122003,"Block 2003, Block Group 2, Census Tract 2523.12, Solano County, California",0,0,0
1000000US060952523122004,060952523122004,"Block 2004, Block Group 2, Census Tract 2523.12, Solano County, California",214,207,7
1000000US060952523122005,060952523122005,"Block 2005, Block Group 2, Census Tract 2523.12, Solano County, California",5,5,0
1000000US060952523122006,060952523122006,"Block 2006, Block Group 2, Census Tract 2523.12, Solano County, California",145,137,8
1000000US060952523122007,060952523122007,"Block 2007, Block Group 2, Census Tract 2523.12, Solano County, California",40,38,2
1000000US060952523122008,060952523122008,"Block 2008, Block Group 2, Census Tract 2523.12, Solano County, California",25,24,1
1000000US060952523122009,060952523122009,"Block 2009, Block Group 2, Census Tract 2523.12, Solano County, California",23,22,1
1000000US060952523122010,060952523122010,"Block 2010, Block Group 2, Census Tract 2523.12, Solano County, California",8,8,0
1000000US060952523122011,060952523122011,"Block 2011, Block Group 2, Census Tract 2523.12, Solano County, California",248,237,11
1000000US060952523122012,060952523122012,"Block 2012, Block Group 2, Census Tract 2523.12, Solano County, California",26,22,4
1000000US060952523122013,060952523122013,"Block 2013, Block Group 2, Census Tract 2523.12, Solano County, California",38,36,2
1000000US060952523122014,060952523122014,"Block 2014, Block Group 2, Census Tract 2523.12, Solano County, California",10,8,2
1000000US060952523122015,060952523122015,"Block 2015, Block Group 2, Census Tract 2523.12, Solano County, California",0,0,0
1000000US060952523122016,060952523122016,"Block 2016, Block Group 2, Census Tract 2523.12, Solano County, California",31,29,2
1000000US060952523122017,060952523122017,"Block 2017, Block Group 2, Census Tract 2523.12, Solano County, California",0,0,0
1000000US060952523122018,060952523122018,"Block 2018, Block Group 2, Census Tract 2523.12, Solano County, California",0,0,0
1000000US060952523131000,060952523131000,"Block 1000, Block Group 1, Census Tract 2523.13, Solano County, California",0,0,0
1000000US060952523131001,060952523131001,"Block 1001, Block Group 1, Census Tract 2523.13, Solano County, California",200,183,17
1000000US060952523131002,060952523131002,"Block 1002, Block Group 1, Census Tract 2523.13, Solano County, California",0,0,0
1000000US060952523131003,060952523131003,"Block 1003, Block Group 1, Census Tract 2523.13, Solano County, California",126,122,4
1000000US060952523131004,060952523131004,"Block 1004, Block Group 1, Census Tract 2523.13, Solano County, California",44,44,0
1000000US060952523131005,060952523131005,"Block 1005, Block Group 1, Census Tract 2523.13, Solano County, California",183,162,21
1000000US060952523131006,060952523131006,"Block 1006, Block Group 1, Census Tract 2523.13, Solano County, California",2,1,1
1000000US060952523131007,060952523131007,"Block 1007, Block Group 1, Census Tract 2523.13, Solano County, California",1,1,0
1000000US060952523131008,060952523131008,"Block 1008, Block Group 1, Census Tract 2523.13, Solano County, California",23,22,1
1000000US060952523131009,060952523131009,"Block 1009, Block Group 1, Census Tract 2523.13, Solano County, California",18,16,2
1000000US060952523132000,060952523132000,"Block 2000, Block Group 2, Census Tract 2523.13, Solano County, California",0,0,0
1000000US060952523132001,060952523132001,"Block 2001, Block Group 2, Census Tract 2523.13, Solano County, California",0,0,0
1000000US060952523132002,060952523132002,"Block 2002, Block Group 2, Census Tract 2523.13, Solano County, California",0,0,0
1000000US060952523132003,060952523132003,"Block 2003, Block Group 2, Census Tract 2523.13, Solano County, California",0,0,0
1000000US060952523132004,060952523132004,"Block 2004, Block Group 2, Census Tract 2523.13, Solano County, California",0,0,0
1000000US060952523132005,060952523132005,"Block 2005, Block Group 2, Census Tract 2523.13, Solano County, California",0,0,0
1000000US060952523132006,060952523132006,"Block 2006, Block Group 2, Census Tract 2523.13, Solano County, California",0,0,0
1000000US060952523132007,060952523132007,"Block 2007, Block Group 2, Census Tract 2523.13, Solano County, California",0,0,0
1000000US060952523132008,060952523132008,"Block 2008, Block Group 2, Census Tract 2523.13, Solano County, California",0,0,0
1000000US060952523132009,060952523132009,"Block 2009, Block Group 2, Census Tract 2523.13, Solano County, California",24,23,1
1000000US060952523132010,060952523132010,"Block 2010, Block Group 2, Census Tract 2523.13, Solano County, California",20,20,0
1000000US060952523132011,060952523132011,"Block 2011, Block Group 2, Census Tract 2523.13, Solano County, California",0,0,0
1000000US060952523132012,060952523132012,"Block 2012, Block Group 2, Census Tract 2523.13, Solano County, California",0,0,0
1000000US060952523132013,060952523132013,"Block 2013, Block Group 2, Census Tract 2523.13, Solano County, California",0,0,0
1000000US060952523132014,060952523132014,"Block 2014, Block Group 2, Census Tract 2523.13, Solano County, California",23,23,0
1000000US060952523132015,060952523132015,"Block 2015, Block Group 2, Census Tract 2523.13, Solano County, California",9,9,0
1000000US060952523132016,060952523132016,"Block 2016, Block Group 2, Census Tract 2523.13, Solano County, California",39,39,0
1000000US060952523132017,060952523132017,"Block 2017, Block Group 2, Census Tract 2523.13, Solano County, California",97,95,2
1000000US060952523132018,060952523132018,"Block 2018, Block Group 2, Census Tract 2523.13, Solano County, California",0,0,0
1000000US060952523132019,060952523132019,"Block 2019, Block Group 2, Census Tract 2523.13, Solano County, California",86,84,2
1000000US060952523132020,060952523132020,"Block 2020, Block Group 2, Census Tract 2523.13, Solano County, California",31,31,0
1000000US060952523132021,060952523132021,"Block 2021, Block Group 2, Census Tract 2523.13, Solano County, California",19,18,1
1000000US060952523132022,060952523132022,"Block 2022, Block Group 2, Census Tract 2523.13, Solano County, California",7,7,0
1000000US060952523132023,060952523132023,"Block 2023, Block Group 2, Census Tract 2523.13, Solano County, California",30,29,1
1000000US060952523132024,060952523132024,"Block 2024, Block Group 2, Census Tract 2523.13, Solano County, California",22,22,0
1000000US060952523132025,060952523132025,"Block 2025, Block Group 2, Census Tract 2523.13, Solano County, California",14,13,1
1000000US060952523132026,060952523132026,"Block 2026, Block Group 2, Census Tract 2523.13, Solano County, California",222,220,2
1000000US060952523132027,060952523132027,"Block 2027, Block Group 2, Census Tract 2523.13, Solano County, California",10,10,0
1000000US060952523132028,060952523132028,"Block 2028, Block Group 2, Census Tract 2523.13, Solano County, California",17,16,1
1000000US060952523132029,060952523132029,"Block 2029, Block Group 2, Census Tract 2523.13, Solano County, California",6,6,0
1000000US060952523133000,060952523133000,"Block 3000, Block Group 3, Census Tract 2523.13, Solano County, California",0,0,0
1000000US060952523133001,060952523133001,"Block 3001, Block Group 3, Census Tract 2523.13, Solano County, California",0,0,0
1000000US060952523133002,060952523133002,"Block 3002, Block Group 3, Census Tract 2523.13, Solano County, California",0,0,0
1000000US060952523133003,060952523133003,"Block 3003, Block Group 3, Census Tract 2523.13, Solano County, California",0,0,0
1000000US060952523133004,060952523133004,"Block 3004, Block Group 3, Census Tract 2523.13, Solano County, California",0,0,0
1000000US060952523133005,060952523133005,"Block 3005, Block Group 3, Census Tract 2523.13, Solano County, California",0,0,0
1000000US060952523133006,060952523133006,"Block 3006, Block Group 3, Census Tract 2523.13, Solano County, California",0,0,0
1000000US060952523133007,060952523133007,"Block 3007, Block Group 3, Census Tract 2523.13, Solano County, California",0,0,0
1000000US060952523133008,060952523133008,"Block 3008, Block Group 3, Census Tract 2523.13, Solano County, California",0,0,0
1000000US060952523133009,060952523133009,"Block 3009, Block Group 3, Census Tract 2523.13, Solano County, California",0,0,0
1000000US060952523133010,060952523133010,"Block 3010, Block Group 3, Census Tract 2523.13, Solano County, California",0,0,0
1000000US060952523133011,060952523133011,"Block 3011, Block Group 3, Census Tract 2523.13, Solano County, California",0,0,0
1000000US060952523133012,060952523133012,"Block 3012, Block Group 3, Census Tract 2523.13, Solano County, California",0,0,0
1000000US060952523133013,060952523133013,"Block 3013, Block Group 3, Census Tract 2523.13, Solano County, California",0,0,0
1000000US060952523133014,060952523133014,"Block 3014, Block Group 3, Census Tract 2523.13, Solano County, California",581,523,58
1000000US060952523133015,060952523133015,"Block 3015, Block Group 3, Census Tract 2523.13, Solano County, California",19,18,1
1000000US060952523133016,060952523133016,"Block 3016, Block Group 3, Census Tract 2523.13, Solano County, California",10,10,0
1000000US060952523133017,060952523133017,"Block 3017, Block Group 3, Census Tract 2523.13, Solano County, California",0,0,0
1000000US060952523133018,060952523133018,"Block 3018, Block Group 3, Census Tract 2523.13, Solano County, California",27,19,8
1000000US060952523133019,060952523133019,"Block 3019, Block Group 3, Census Tract 2523.13, Solano County, California",13,12,1
1000000US060952523133020,060952523133020,"Block 3020, Block Group 3, Census Tract 2523.13, Solano County, California",24,22,2
1000000US060952523133021,060952523133021,"Block 3021, Block Group 3, Census Tract 2523.13, Solano County, California",0,0,0
1000000US060952523133022,060952523133022,"Block 3022, Block Group 3, Census Tract 2523.13, Solano County, California",23,21,2
1000000US060952523133023,060952523133023,"Block 3023, Block Group 3, Census Tract 2523.13, Solano County, California",0,0,0
1000000US060952523133024,060952523133024,"Block 3024, Block Group 3, Census Tract 2523.13, Solano County, California",21,21,0
1000000US060952523133025,060952523133025,"Block 3025, Block Group 3, Census Tract 2523.13, Solano County, California",49,48,1
1000000US060952523133026,060952523133026,"Block 3026, Block Group 3, Census Tract 2523.13, Solano County, California",0,0,0
1000000US060952523133027,060952523133027,"Block 3027, Block Group 3, Census Tract 2523.13, Solano County, California",0,0,0
1000000US060952523133028,060952523133028,"Block 3028, Block Group 3, Census Tract 2523.13, Solano County, California",24,23,1
1000000US060952523133029,060952523133029,"Block 3029, Block Group 3, Census Tract 2523.13, Solano County, California",20,20,0
1000000US060952523133030,060952523133030,"Block 3030, Block Group 3, Census Tract 2523.13, Solano County, California",46,46,0
1000000US060952523133031,060952523133031,"Block 3031, Block Group 3, Census Tract 2523.13, Solano County, California",15,11,4
1000000US060952523133032,060952523133032,"Block 3032, Block Group 3, Census Tract 2523.13, Solano County, California",22,21,1
1000000US060952523133033,060952523133033,"Block 3033, Block Group 3, Census Tract 2523.13, Solano County, California",104,100,4
1000000US060952523133034,060952523133034,"Block 3034, Block Group 3, Census Tract 2523.13, Solano County, California",0,0,0
1000000US060952523133035,060952523133035,"Block 3035, Block Group 3, Census Tract 2523.13, Solano County, California",0,0,0
1000000US060952523133036,060952523133036,"Block 3036, Block Group 3, Census Tract 2523.13, Solano County, California",11,10,1
1000000US060952523133037,060952523133037,"Block 3037, Block Group 3, Census Tract 2523.13, Solano County, California",0,0,0
1000000US060952523133038,060952523133038,"Block 3038, Block Group 3, Census Tract 2523.13, Solano County, California",0,0,0
1000000US060952523133039,060952523133039,"Block 3039, Block Group 3, Census Tract 2523.13, Solano County, California",15,14,1
1000000US060952523133040,060952523133040,"Block 3040, Block Group 3, Census Tract 2523.13, Solano County, California",37,32,5
1000000US060952523133041,060952523133041,"Block 3041, Block Group 3, Census Tract 2523.13, Solano County, California",0,0,0
1000000US060952523133042,060952523133042,"Block 3042, Block Group 3, Census Tract 2523.13, Solano County, California",0,0,0
1000000US060952523133043,060952523133043,"Block 3043, Block Group 3, Census Tract 2523.13, Solano County, California",15,13,2
1000000US060952523141000,060952523141000,"Block 1000, Block Group 1, Census Tract 2523.14, Solano County, California",104,97,7
1000000US060952523141001,060952523141001,"Block 1001, Block Group 1, Census Tract 2523.14, Solano County, California",27,24,3
1000000US060952523141002,060952523141002,"Block 1002, Block Group 1, Census Tract 2523.14, Solano County, California",46,46,0
1000000US060952523141003,060952523141003,"Block 1003, Block Group 1, Census Tract 2523.14, Solano County, California",13,13,0
1000000US060952523141004,060952523141004,"Block 1004, Block Group 1, Census Tract 2523.14, Solano County, California",31,31,0
1000000US060952523141005,060952523141005,"Block 1005, Block Group 1, Census Tract 2523.14, Solano County, California",75,74,1
1000000US060952523141006,060952523141006,"Block 1006, Block Group 1, Census Tract 2523.14, Solano County, California",19,19,0
1000000US060952523141007,060952523141007,"Block 1007, Block Group 1, Census Tract 2523.14, Solano County, California",27,27,0
1000000US060952523141008,060952523141008,"Block 1008, Block Group 1, Census Tract 2523.14, Solano County, California",0,0,0
1000000US060952523141009,060952523141009,"Block 1009, Block Group 1, Census Tract 2523.14, Solano County, California",0,0,0
1000000US060952523141010,060952523141010,"Block 1010, Block Group 1, Census Tract 2523.14, Solano County, California",31,29,2
1000000US060952523141011,060952523141011,"Block 1011, Block Group 1, Census Tract 2523.14, Solano County, California",35,34,1
1000000US060952523142000,060952523142000,"Block 2000, Block Group 2, Census Tract 2523.14, Solano County, California",20,20,0
1000000US060952523142001,060952523142001,"Block 2001, Block Group 2, Census Tract 2523.14, Solano County, California",39,37,2
1000000US060952523142002,060952523142002,"Block 2002, Block Group 2, Census Tract 2523.14, Solano County, California",87,83,4
1000000US060952523142003,060952523142003,"Block 2003, Block Group 2, Census Tract 2523.14, Solano County, California",6,5,1
1000000US060952523142004,060952523142004,"Block 2004, Block Group 2, Census Tract 2523.14, Solano County, California",59,47,12
1000000US060952523142005,060952523142005,"Block 2005, Block Group 2, Census Tract 2523.14, Solano County, California",34,33,1
1000000US060952523142006,060952523142006,"Block 2006, Block Group 2, Census Tract 2523.14, Solano County, California",16,14,2
1000000US060952523142007,060952523142007,"Block 2007, Block Group 2, Census Tract 2523.14, Solano County, California",0,0,0
1000000US060952523142008,060952523142008,"Block 2008, Block Group 2, Census Tract 2523.14, Solano County, California",21,19,2
1000000US060952523142009,060952523142009,"Block 2009, Block Group 2, Census Tract 2523.14, Solano County, California",35,31,4
1000000US060952523142010,060952523142010,"Block 2010, Block Group 2, Census Tract 2523.14, Solano County, California",18,14,4
1000000US060952523142011,060952523142011,"Block 2011, Block Group 2, Census Tract 2523.14, Solano County, California",43,42,1
1000000US060952523142012,060952523142012,"Block 2012, Block Group 2, Census Tract 2523.14, Solano County, California",24,24,0
1000000US060952523142013,060952523142013,"Block 2013, Block Group 2, Census Tract 2523.14, Solano County, California",39,39,0
1000000US060952523142014,060952523142014,"Block 2014, Block Group 2, Census Tract 2523.14, Solano County, California",31,31,0
1000000US060952523142015,060952523142015,"Block 2015, Block Group 2, Census Tract 2523.14, Solano County, California",31,27,4
1000000US060952523142016,060952523142016,"Block 2016, Block Group 2, Census Tract 2523.14, Solano County, California",0,0,0
1000000US060952523142017,060952523142017,"Block 2017, Block Group 2, Census Tract 2523.14, Solano County, California",0,0,0
1000000US060952523142018,060952523142018,"Block 2018, Block Group 2, Census Tract 2523.14, Solano County, California",0,0,0
1000000US060952523143000,060952523143000,"Block 3000, Block Group 3, Census Tract 2523.14, Solano County, California",25,24,1
1000000US060952523143001,060952523143001,"Block 3001, Block Group 3, Census Tract 2523.14, Solano County, California",36,34,2
1000000US060952523143002,060952523143002,"Block 3002, Block Group 3, Census Tract 2523.14, Solano County, California",131,126,5
1000000US060952523143003,060952523143003,"Block 3003, Block Group 3, Census Tract 2523.14, Solano County, California",14,14,0
1000000US060952523143004,060952523143004,"Block 3004, Block Group 3, Census Tract 2523.14, Solano County, California",44,43,1
1000000US060952523143005,060952523143005,"Block 3005, Block Group 3, Census Tract 2523.14, Solano County, California",8,8,0
1000000US060952523143006,060952523143006,"Block 3006, Block Group 3, Census Tract 2523.14, Solano County, California",23,22,1
1000000US060952523143007,060952523143007,"Block 3007, Block Group 3, Census Tract 2523.14, Solano County, California",17,16,1
1000000US060952523143008,060952523143008,"Block 3008, Block Group 3, Census Tract 2523.14, Solano County, California",23,21,2
1000000US060952523143009,060952523143009,"Block 3009, Block Group 3, Census Tract 2523.14, Solano County, California",18,18,0
1000000US060952523143010,060952523143010,"Block 3010, Block Group 3, Census Tract 2523.14, Solano County, California",16,15,1
1000000US060952523143011,060952523143011,"Block 3011, Block Group 3, Census Tract 2523.14, Solano County, California",25,22,3
1000000US060952523143012,060952523143012,"Block 3012, Block Group 3, Census Tract 2523.14, Solano County, California",26,25,1
1000000US060952523143013,060952523143013,"Block 3013, Block Group 3, Census Tract 2523.14, Solano County, California",0,0,0
1000000US060952523143014,060952523143014,"Block 3014, Block Group 3, Census Tract 2523.14, Solano County, California",0,0,0
1000000US060952523143015,060952523143015,"Block 3015, Block Group 3, Census Tract 2523.14, Solano County, California",0,0,0
1000000US060952523143016,060952523143016,"Block 3016, Block Group 3, Census Tract 2523.14, Solano County, California",38,37,1
1000000US060952523143017,060952523143017,"Block 3017, Block Group 3, Census Tract 2523.14, Solano County, California",23,21,2
1000000US060952523143018,060952523143018,"Block 3018, Block Group 3, Census Tract 2523.14, Solano County, California",34,32,2
1000000US060952523143019,060952523143019,"Block 3019, Block Group 3, Census Tract 2523.14, Solano County, California",26,25,1
1000000US060952523143020,060952523143020,"Block 3020, Block Group 3, Census Tract 2523.14, Solano County, California",20,18,2
1000000US060952523143021,060952523143021,"Block 3021, Block Group 3, Census Tract 2523.14, Solano County, California",10,10,0
1000000US060952523143022,060952523143022,"Block 3022, Block Group 3, Census Tract 2523.14, Solano County, California",7,7,0
1000000US060952523143023,060952523143023,"Block 3023, Block Group 3, Census Tract 2523.14, Solano County, California",0,0,0
1000000US060952523143024,060952523143024,"Block 3024, Block Group 3, Census Tract 2523.14, Solano County, California",0,0,0
1000000US060952523143025,060952523143025,"Block 3025, Block Group 3, Census Tract 2523.14, Solano County, California",0,0,0
1000000US060952523151000,060952523151000,"Block 1000, Block Group 1, Census Tract 2523.15, Solano County, California",0,0,0
1000000US060952523151001,060952523151001,"Block 1001, Block Group 1, Census Tract 2523.15, Solano County, California",0,0,0
1000000US060952523151002,060952523151002,"Block 1002, Block Group 1, Census Tract 2523.15, Solano County, California",15,15,0
1000000US060952523151003,060952523151003,"Block 1003, Block Group 1, Census Tract 2523.15, Solano County, California",18,18,0
1000000US060952523151004,060952523151004,"Block 1004, Block Group 1, Census Tract 2523.15, Solano County, California",20,19,1
1000000US060952523151005,060952523151005,"Block 1005, Block Group 1, Census Tract 2523.15, Solano County, California",63,61,2
1000000US060952523151006,060952523151006,"Block 1006, Block Group 1, Census Tract 2523.15, Solano County, California",17,15,2
1000000US060952523151007,060952523151007,"Block 1007, Block Group 1, Census Tract 2523.15, Solano County, California",47,47,0
1000000US060952523151008,060952523151008,"Block 1008, Block Group 1, Census Tract 2523.15, Solano County, California",56,52,4
1000000US060952523151009,060952523151009,"Block 1009, Block Group 1, Census Tract 2523.15, Solano County, California",12,11,1
1000000US060952523151010,060952523151010,"Block 1010, Block Group 1, Census Tract 2523.15, Solano County, California",12,12,0
1000000US060952523151011,060952523151011,"Block 1011, Block Group 1, Census Tract 2523.15, Solano County, California",19,18,1
1000000US060952523151012,060952523151012,"Block 1012, Block Group 1, Census Tract 2523.15, Solano County, California",8,8,0
1000000US060952523151013,060952523151013,"Block 1013, Block Group 1, Census Tract 2523.15, Solano County, California",29,27,2
1000000US060952523151014,060952523151014,"Block 1014, Block Group 1, Census Tract 2523.15, Solano County, California",10,9,1
1000000US060952523151015,060952523151015,"Block 1015, Block Group 1, Census Tract 2523.15, Solano County, California",64,62,2
1000000US060952523151016,060952523151016,"Block 1016, Block Group 1, Census Tract 2523.15, Solano County, California",16,16,0
1000000US060952523151017,060952523151017,"Block 1017, Block Group 1, Census Tract 2523.15, Solano County, California",18,17,1
1000000US060952523151018,060952523151018,"Block 1018, Block Group 1, Census Tract 2523.15, Solano County, California",24,23,1
1000000US060952523152000,060952523152000,"Block 2000, Block Group 2, Census Tract 2523.15, Solano County, California",44,44,0
1000000US060952523152001,060952523152001,"Block 2001, Block Group 2, Census Tract 2523.15, Solano County, California",26,25,1
1000000US060952523152002,060952523152002,"Block 2002, Block Group 2, Census Tract 2523.15, Solano County, California",25,22,3
1000000US060952523152003,060952523152003,"Block 2003, Block Group 2, Census Tract 2523.15, Solano County, California",91,88,3
1000000US060952523152004,060952523152004,"Block 2004, Block Group 2, Census Tract 2523.15, Solano County, California",15,14,1
1000000US060952523152005,060952523152005,"Block 2005, Block Group 2, Census Tract 2523.15, Solano County, California",26,25,1
1000000US060952523152006,060952523152006,"Block 2006, Block Group 2, Census Tract 2523.15, Solano County, California",43,42,1
1000000US060952523152007,060952523152007,"Block 2007, Block Group 2, Census Tract 2523.15, Solano County, California",14,14,0
1000000US060952523152008,060952523152008,"Block 2008, Block Group 2, Census Tract 2523.15, Solano County, California",18,17,1
1000000US060952523152009,060952523152009,"Block 2009, Block Group 2, Census Tract 2523.15, Solano County, California",16,15,1
1000000US060952523152010,060952523152010,"Block 2010, Block Group 2, Census Tract 2523.15, Solano County, California",76,74,2
1000000US060952523152011,060952523152011,"Block 2011, Block Group 2, Census Tract 2523.15, Solano County, California",3,3,0
1000000US060952523152012,060952523152012,"Block 2012, Block Group 2, Census Tract 2523.15, Solano County, California",0,0,0
1000000US060952523152013,060952523152013,"Block 2013, Block Group 2, Census Tract 2523.15, Solano County, California",84,83,1
1000000US060952523153000,060952523153000,"Block 3000, Block Group 3, Census Tract 2523.15, Solano County, California",60,58,2
1000000US060952523153001,060952523153001,"Block 3001, Block Group 3, Census Tract 2523.15, Solano County, California",0,0,0
1000000US060952523153002,060952523153002,"Block 3002, Block Group 3, Census Tract 2523.15, Solano County, California",0,0,0
1000000US060952523153003,060952523153003,"Block 3003, Block Group 3, Census Tract 2523.15, Solano County, California",0,0,0
1000000US060952523153004,060952523153004,"Block 3004, Block Group 3, Census Tract 2523.15, Solano County, California",26,26,0
1000000US060952523153005,060952523153005,"Block 3005, Block Group 3, Census Tract 2523.15, Solano County, California",19,19,0
1000000US060952523153006,060952523153006,"Block 3006, Block Group 3, Census Tract 2523.15, Solano County, California",47,47,0
1000000US060952523153007,060952523153007,"Block 3007, Block Group 3, Census Tract 2523.15, Solano County, California",15,15,0
1000000US060952523153008,060952523153008,"Block 3008, Block Group 3, Census Tract 2523.15, Solano County, California",16,15,1
1000000US060952523153009,060952523153009,"Block 3009, Block Group 3, Census Tract 2523.15, Solano County, California",9,8,1
1000000US060952523153010,060952523153010,"Block 3010, Block Group 3, Census Tract 2523.15, Solano County, California",27,27,0
1000000US060952523153011,060952523153011,"Block 3011, Block Group 3, Census Tract 2523.15, Solano County, California",18,18,0
1000000US060952523153012,060952523153012,"Block 3012, Block Group 3, Census Tract 2523.15, Solano County, California",46,45,1
1000000US060952523153013,060952523153013,"Block 3013, Block Group 3, Census Tract 2523.15, Solano County, California",59,58,1
1000000US060952523153014,060952523153014,"Block 3014, Block Group 3, Census Tract 2523.15, Solano County, California",41,41,0
1000000US060952523153015,060952523153015,"Block 3015, Block Group 3, Census Tract 2523.15, Solano County, California",60,53,7
1000000US060952523153016,060952523153016,"Block 3016, Block Group 3, Census Tract 2523.15, Solano County, California",19,19,0
1000000US060952523153017,060952523153017,"Block 3017, Block Group 3, Census Tract 2523.15, Solano County, California",48,47,1
1000000US060952523161000,060952523161000,"Block 1000, Block Group 1, Census Tract 2523.16, Solano County, California",25,25,0
1000000US060952523161001,060952523161001,"Block 1001, Block Group 1, Census Tract 2523.16, Solano County, California",13,11,2
1000000US060952523161002,060952523161002,"Block 1002, Block Group 1, Census Tract 2523.16, Solano County, California",59,58,1
1000000US060952523161003,060952523161003,"Block 1003, Block Group 1, Census Tract 2523.16, Solano County, California",106,102,4
1000000US060952523161004,060952523161004,"Block 1004, Block Group 1, Census Tract 2523.16, Solano County, California",12,12,0
1000000US060952523161005,060952523161005,"Block 1005, Block Group 1, Census Tract 2523.16, Solano County, California",30,29,1
1000000US060952523161006,060952523161006,"Block 1006, Block Group 1, Census Tract 2523.16, Solano County, California",85,79,6
1000000US060952523161007,060952523161007,"Block 1007, Block Group 1, Census Tract 2523.16, Solano County, California",16,16,0
1000000US060952523161008,060952523161008,"Block 1008, Block Group 1, Census Tract 2523.16, Solano County, California",31,31,0
1000000US060952523161009,060952523161009,"Block 1009, Block Group 1, Census Tract 2523.16, Solano County, California",33,31,2
1000000US060952523161010,060952523161010,"Block 1010, Block Group 1, Census Tract 2523.16, Solano County, California",34,33,1
1000000US060952523161011,060952523161011,"Block 1011, Block Group 1, Census Tract 2523.16, Solano County, California",41,39,2
1000000US060952523161012,060952523161012,"Block 1012, Block Group 1, Census Tract 2523.16, Solano County, California",29,28,1
1000000US060952523161013,060952523161013,"Block 1013, Block Group 1, Census Tract 2523.16, Solano County, California",54,54,0
1000000US060952523161014,060952523161014,"Block 1014, Block Group 1, Census Tract 2523.16, Solano County, California",0,0,0
1000000US060952523161015,060952523161015,"Block 1015, Block Group 1, Census Tract 2523.16, Solano County, California",1,1,0
1000000US060952523161016,060952523161016,"Block 1016, Block Group 1, Census Tract 2523.16, Solano County, California",0,0,0
1000000US060952523161017,060952523161017,"Block 1017, Block Group 1, Census Tract 2523.16, Solano County, California",0,0,0
1000000US060952523161018,060952523161018,"Block 1018, Block Group 1, Census Tract 2523.16, Solano County, California",0,0,0
1000000US060952523161019,060952523161019,"Block 1019, Block Group 1, Census Tract 2523.16, Solano County, California",0,0,0
1000000US060952523161020,060952523161020,"Block 1020, Block Group 1, Census Tract 2523.16, Solano County, California",0,0,0
1000000US060952523161021,060952523161021,"Block 1021, Block Group 1, Census Tract 2523.16, Solano County, California",0,0,0
1000000US060952523161022,060952523161022,"Block 1022, Block Group 1, Census Tract 2523.16, Solano County, California",7,7,0
1000000US060952523161023,060952523161023,"Block 1023, Block Group 1, Census Tract 2523.16, Solano County, California",27,26,1
1000000US060952523161024,060952523161024,"Block 1024, Block Group 1, Census Tract 2523.16, Solano County, California",0,0,0
1000000US060952523161025,060952523161025,"Block 1025, Block Group 1, Census Tract 2523.16, Solano County, California",0,0,0
1000000US060952523162000,060952523162000,"Block 2000, Block Group 2, Census Tract 2523.16, Solano County, California",15,12,3
1000000US060952523162001,060952523162001,"Block 2001, Block Group 2, Census Tract 2523.16, Solano County, California",63,60,3
1000000US060952523162002,060952523162002,"Block 2002, Block Group 2, Census Tract 2523.16, Solano County, California",115,105,10
1000000US060952523162003,060952523162003,"Block 2003, Block Group 2, Census Tract 2523.16, Solano County, California",21,21,0
1000000US060952523162004,060952523162004,"Block 2004, Block Group 2, Census Tract 2523.16, Solano County, California",21,20,1
1000000US060952523162005,060952523162005,"Block 2005, Block Group 2, Census Tract 2523.16, Solano County, California",134,127,7
1000000US060952523162006,060952523162006,"Block 2006, Block Group 2, Census Tract 2523.16, Solano County, California",28,26,2
1000000US060952523162007,060952523162007,"Block 2007, Block Group 2, Census Tract 2523.16, Solano County, California",28,25,3
1000000US060952523162008,060952523162008,"Block 2008, Block Group 2, Census Tract 2523.16, Solano County, California",27,27,0
1000000US060952523162009,060952523162009,"Block 2009, Block Group 2, Census Tract 2523.16, Solano County, California",35,31,4
1000000US060952523162010,060952523162010,"Block 2010, Block Group 2, Census Tract 2523.16, Solano County, California",30,27,3
1000000US060952523162011,060952523162011,"Block 2011, Block Group 2, Census Tract 2523.16, Solano County, California",0,0,0
1000000US060952523162012,060952523162012,"Block 2012, Block Group 2, Census Tract 2523.16, Solano County, California",0,0,0
1000000US060952523162013,060952523162013,"Block 2013, Block Group 2, Census Tract 2523.16, Solano County, California",0,0,0
1000000US060952523162014,060952523162014,"Block 2014, Block Group 2, Census Tract 2523.16, Solano County, California",47,44,3
1000000US060952523162015,060952523162015,"Block 2015, Block Group 2, Census Tract 2523.16, Solano County, California",12,10,2
1000000US060952523171000,060952523171000,"Block 1000, Block Group 1, Census Tract 2523.17, Solano County, California",4,4,0
1000000US060952523171001,060952523171001,"Block 1001, Block Group 1, Census Tract 2523.17, Solano County, California",0,0,0
1000000US060952523171002,060952523171002,"Block 1002, Block Group 1, Census Tract 2523.17, Solano County, California",0,0,0
1000000US060952523171003,060952523171003,"Block 1003, Block Group 1, Census Tract 2523.17, Solano County, California",1,1,0
1000000US060952523171004,060952523171004,"Block 1004, Block Group 1, Census Tract 2523.17, Solano County, California",0,0,0
1000000US060952523171005,060952523171005,"Block 1005, Block Group 1, Census Tract 2523.17, Solano County, California",1,1,0
1000000US060952523171006,060952523171006,"Block 1006, Block Group 1, Census Tract 2523.17, Solano County, California",4,3,1
1000000US060952523171007,060952523171007,"Block 1007, Block Group 1, Census Tract 2523.17, Solano County, California",0,0,0
1000000US060952523171008,060952523171008,"Block 1008, Block Group 1, Census Tract 2523.17, Solano County, California",0,0,0
1000000US060952523171009,060952523171009,"Block 1009, Block Group 1, Census Tract 2523.17, Solano County, California",0,0,0
1000000US060952523171010,060952523171010,"Block 1010, Block Group 1, Census Tract 2523.17, Solano County, California",0,0,0
1000000US060952523171011,060952523171011,"Block 1011, Block Group 1, Census Tract 2523.17, Solano County, California",0,0,0
1000000US060952523171012,060952523171012,"Block 1012, Block Group 1, Census Tract 2523.17, Solano County, California",0,0,0
1000000US060952523171013,060952523171013,"Block 1013, Block Group 1, Census Tract 2523.17, Solano County, California",0,0,0
1000000US060952523171014,060952523171014,"Block 1014, Block Group 1, Census Tract 2523.17, Solano County, California",0,0,0
1000000US060952523171015,060952523171015,"Block 1015, Block Group 1, Census Tract 2523.17, Solano County, California",0,0,0
1000000US060952523171016,060952523171016,"Block 1016, Block Group 1, Census Tract 2523.17, Solano County, California",0,0,0
1000000US060952523171017,060952523171017,"Block 1017, Block Group 1, Census Tract 2523.17, Solano County, California",0,0,0
1000000US060952523171018,060952523171018,"Block 1018, Block Group 1, Census Tract 2523.17, Solano County, California",0,0,0
1000000US060952523171019,060952523171019,"Block 1019, Block Group 1, Census Tract 2523.17, Solano County, California",0,0,0
1000000US060952523171020,060952523171020,"Block 1020, Block Group 1, Census Tract 2523.17, Solano County, California",0,0,0
1000000US060952523171021,060952523171021,"Block 1021, Block Group 1, Census Tract 2523.17, Solano County, California",0,0,0
1000000US060952523171022,060952523171022,"Block 1022, Block Group 1, Census Tract 2523.17, Solano County, California",0,0,0
1000000US060952523171023,060952523171023,"Block 1023, Block Group 1, Census Tract 2523.17, Solano County, California",0,0,0
1000000US060952523171024,060952523171024,"Block 1024, Block Group 1, Census Tract 2523.17, Solano County, California",0,0,0
1000000US060952523171025,060952523171025,"Block 1025, Block Group 1, Census Tract 2523.17, Solano County, California",0,0,0
1000000US060952523171026,060952523171026,"Block 1026, Block Group 1, Census Tract 2523.17, Solano County, California",0,0,0
1000000US060952523171027,060952523171027,"Block 1027, Block Group 1, Census Tract 2523.17, Solano County, California",0,0,0
1000000US060952523171028,060952523171028,"Block 1028, Block Group 1, Census Tract 2523.17, Solano County, California",0,0,0
1000000US060952523171029,060952523171029,"Block 1029, Block Group 1, Census Tract 2523.17, Solano County, California",0,0,0
1000000US060952523171030,060952523171030,"Block 1030, Block Group 1, Census Tract 2523.17, Solano County, California",227,203,24
1000000US060952523171031,060952523171031,"Block 1031, Block Group 1, Census Tract 2523.17, Solano County, California",52,49,3
1000000US060952523171032,060952523171032,"Block 1032, Block Group 1, Census Tract 2523.17, Solano County, California",2,2,0
1000000US060952523171033,060952523171033,"Block 1033, Block Group 1, Census Tract 2523.17, Solano County, California",0,0,0
1000000US060952523171034,060952523171034,"Block 1034, Block Group 1, Census Tract 2523.17, Solano County, California",0,0,0
1000000US060952523171035,060952523171035,"Block 1035, Block Group 1, Census Tract 2523.17, Solano County, California",0,0,0
1000000US060952523171036,060952523171036,"Block 1036, Block Group 1, Census Tract 2523.17, Solano County, California",0,0,0
1000000US060952523171037,060952523171037,"Block 1037, Block Group 1, Census Tract 2523.17, Solano County, California",0,0,0
1000000US060952523171038,060952523171038,"Block 1038, Block Group 1, Census Tract 2523.17, Solano County, California",0,0,0
1000000US060952523171039,060952523171039,"Block 1039, Block Group 1, Census Tract 2523.17, Solano County, California",14,13,1
1000000US060952523171040,060952523171040,"Block 1040, Block Group 1, Census Tract 2523.17, Solano County, California",20,20,0
1000000US060952523171041,060952523171041,"Block 1041, Block Group 1, Census Tract 2523.17, Solano County, California",14,13,1
1000000US060952523171042,060952523171042,"Block 1042, Block Group 1, Census Tract 2523.17, Solano County, California",15,10,5
1000000US060952523171043,060952523171043,"Block 1043, Block Group 1, Census Tract 2523.17, Solano County, California",22,21,1
1000000US060952523171044,060952523171044,"Block 1044, Block Group 1, Census Tract 2523.17, Solano County, California",53,52,1
1000000US060952523171045,060952523171045,"Block 1045, Block Group 1, Census Tract 2523.17, Solano County, California",12,11,1
1000000US060952523171046,060952523171046,"Block 1046, Block Group 1, Census Tract 2523.17, Solano County, California",0,0,0
1000000US060952523171047,060952523171047,"Block 1047, Block Group 1, Census Tract 2523.17, Solano County, California",0,0,0
1000000US060952523171048,060952523171048,"Block 1048, Block Group 1, Census Tract 2523.17, Solano County, California",0,0,0
1000000US060952523171049,060952523171049,"Block 1049, Block Group 1, Census Tract 2523.17, Solano County, California",0,0,0
1000000US060952523171050,060952523171050,"Block 1050, Block Group 1, Census Tract 2523.17, Solano County, California",97,95,2
1000000US060952523171051,060952523171051,"Block 1051, Block Group 1, Census Tract 2523.17, Solano County, California",38,35,3
1000000US060952523171052,060952523171052,"Block 1052, Block Group 1, Census Tract 2523.17, Solano County, California",12,10,2
1000000US060952523171053,060952523171053,"Block 1053, Block Group 1, Census Tract 2523.17, Solano County, California",11,10,1
1000000US060952523171054,060952523171054,"Block 1054, Block Group 1, Census Tract 2523.17, Solano County, California",13,13,0
1000000US060952523171055,060952523171055,"Block 1055, Block Group 1, Census Tract 2523.17, Solano County, California",11,11,0
1000000US060952523171056,060952523171056,"Block 1056, Block Group 1, Census Tract 2523.17, Solano County, California",17,17,0
1000000US060952523171057,060952523171057,"Block 1057, Block Group 1, Census Tract 2523.17, Solano County, California",16,16,0
1000000US060952523171058,060952523171058,"Block 1058, Block Group 1, Census Tract 2523.17, Solano County, California",0,0,0
1000000US060952523171059,060952523171059,"Block 1059, Block Group 1, Census Tract 2523.17, Solano County, California",0,0,0
1000000US060952523171060,060952523171060,"Block 1060, Block Group 1, Census Tract 2523.17, Solano County, California",0,0,0
1000000US060952523171061,060952523171061,"Block 1061, Block Group 1, Census Tract 2523.17, Solano County, California",0,0,0
1000000US060952523171062,060952523171062,"Block 1062, Block Group 1, Census Tract 2523.17, Solano County, California",2,1,1
1000000US060952523171063,060952523171063,"Block 1063, Block Group 1, Census Tract 2523.17, Solano County, California",0,0,0
1000000US060952523171064,060952523171064,"Block 1064, Block Group 1, Census Tract 2523.17, Solano County, California",0,0,0
1000000US060952523171065,060952523171065,"Block 1065, Block Group 1, Census Tract 2523.17, Solano County, California",0,0,0
1000000US060952523172000,060952523172000,"Block 2000, Block Group 2, Census Tract 2523.17, Solano County, California",0,0,0
1000000US060952523172001,060952523172001,"Block 2001, Block Group 2, Census Tract 2523.17, Solano County, California",4,4,0
1000000US060952523172002,060952523172002,"Block 2002, Block Group 2, Census Tract 2523.17, Solano County, California",1,1,0
1000000US060952523172003,060952523172003,"Block 2003, Block Group 2, Census Tract 2523.17, Solano County, California",0,0,0
1000000US060952523172004,060952523172004,"Block 2004, Block Group 2, Census Tract 2523.17, Solano County, California",0,0,0
1000000US060952523172005,060952523172005,"Block 2005, Block Group 2, Census Tract 2523.17, Solano County, California",0,0,0
1000000US060952523172006,060952523172006,"Block 2006, Block Group 2, Census Tract 2523.17, Solano County, California",0,0,0
1000000US060952523172007,060952523172007,"Block 2007, Block Group 2, Census Tract 2523.17, Solano County, California",0,0,0
1000000US060952523172008,060952523172008,"Block 2008, Block Group 2, Census Tract 2523.17, Solano County, California",1,1,0
1000000US060952523172009,060952523172009,"Block 2009, Block Group 2, Census Tract 2523.17, Solano County, California",0,0,0
1000000US060952523172010,060952523172010,"Block 2010, Block Group 2, Census Tract 2523.17, Solano County, California",0,0,0
1000000US060952523172011,060952523172011,"Block 2011, Block Group 2, Census Tract 2523.17, Solano County, California",0,0,0
1000000US060952523172012,060952523172012,"Block 2012, Block Group 2, Census Tract 2523.17, Solano County, California",0,0,0
1000000US060952523172013,060952523172013,"Block 2013, Block Group 2, Census Tract 2523.17, Solano County, California",0,0,0
1000000US060952523172014,060952523172014,"Block 2014, Block Group 2, Census Tract 2523.17, Solano County, California",0,0,0
1000000US060952523172015,060952523172015,"Block 2015, Block Group 2, Census Tract 2523.17, Solano County, California",0,0,0
1000000US060952523172016,060952523172016,"Block 2016, Block Group 2, Census Tract 2523.17, Solano County, California",0,0,0
1000000US060952523172017,060952523172017,"Block 2017, Block Group 2, Census Tract 2523.17, Solano County, California",0,0,0
1000000US060952523172018,060952523172018,"Block 2018, Block Group 2, Census Tract 2523.17, Solano County, California",0,0,0
1000000US060952523172019,060952523172019,"Block 2019, Block Group 2, Census Tract 2523.17, Solano County, California",3,3,0
1000000US060952523172020,060952523172020,"Block 2020, Block Group 2, Census Tract 2523.17, Solano County, California",0,0,0
1000000US060952523172021,060952523172021,"Block 2021, Block Group 2, Census Tract 2523.17, Solano County, California",0,0,0
1000000US060952523172022,060952523172022,"Block 2022, Block Group 2, Census Tract 2523.17, Solano County, California",0,0,0
1000000US060952523172023,060952523172023,"Block 2023, Block Group 2, Census Tract 2523.17, Solano County, California",0,0,0
1000000US060952523172024,060952523172024,"Block 2024, Block Group 2, Census Tract 2523.17, Solano County, California",332,318,14
1000000US060952523172025,060952523172025,"Block 2025, Block Group 2, Census Tract 2523.17, Solano County, California",0,0,0
1000000US060952523172026,060952523172026,"Block 2026, Block Group 2, Census Tract 2523.17, Solano County, California",0,0,0
1000000US060952523172027,060952523172027,"Block 2027, Block Group 2, Census Tract 2523.17, Solano County, California",32,29,3
1000000US060952523172028,060952523172028,"Block 2028, Block Group 2, Census Tract 2523.17, Solano County, California",31,30,1
1000000US060952523172029,060952523172029,"Block 2029, Block Group 2, Census Tract 2523.17, Solano County, California",40,37,3
1000000US060952523172030,060952523172030,"Block 2030, Block Group 2, Census Tract 2523.17, Solano County, California",25,22,3
1000000US060952523172031,060952523172031,"Block 2031, Block Group 2, Census Tract 2523.17, Solano County, California",58,54,4
1000000US060952523172032,060952523172032,"Block 2032, Block Group 2, Census Tract 2523.17, Solano County, California",31,29,2
1000000US060952523172033,060952523172033,"Block 2033, Block Group 2, Census Tract 2523.17, Solano County, California",82,77,5
1000000US060952523172034,060952523172034,"Block 2034, Block Group 2, Census Tract 2523.17, Solano County, California",0,0,0
1000000US060952523172035,060952523172035,"Block 2035, Block Group 2, Census Tract 2523.17, Solano County, California",0,0,0
1000000US060952523172036,060952523172036,"Block 2036, Block Group 2, Census Tract 2523.17, Solano County, California",116,109,7
1000000US060952523172037,060952523172037,"Block 2037, Block Group 2, Census Tract 2523.17, Solano County, California",74,70,4
1000000US060952523172038,060952523172038,"Block 2038, Block Group 2, Census Tract 2523.17, Solano County, California",0,0,0
1000000US060952523172039,060952523172039,"Block 2039, Block Group 2, Census Tract 2523.17, Solano County, California",0,0,0
1000000US060952523172040,060952523172040,"Block 2040, Block Group 2, Census Tract 2523.17, Solano County, California",47,34,13
1000000US060952523172041,060952523172041,"Block 2041, Block Group 2, Census Tract 2523.17, Solano County, California",0,0,0
1000000US060952523172042,060952523172042,"Block 2042, Block Group 2, Census Tract 2523.17, Solano County, California",0,0,0
1000000US060952523172043,060952523172043,"Block 2043, Block Group 2, Census Tract 2523.17, Solano County, California",0,0,0
1000000US060952523172044,060952523172044,"Block 2044, Block Group 2, Census Tract 2523.17, Solano County, California",0,0,0
1000000US060952523172045,060952523172045,"Block 2045, Block Group 2, Census Tract 2523.17, Solano County, California",0,0,0
1000000US060952523172046,060952523172046,"Block 2046, Block Group 2, Census Tract 2523.17, Solano County, California",0,0,0
1000000US060952523172047,060952523172047,"Block 2047, Block Group 2, Census Tract 2523.17, Solano County, California",0,0,0
1000000US060952523172048,060952523172048,"Block 2048, Block Group 2, Census Tract 2523.17, Solano County, California",0,0,0
1000000US060952523172049,060952523172049,"Block 2049, Block Group 2, Census Tract 2523.17, Solano County, California",0,0,0
1000000US060952523172050,060952523172050,"Block 2050, Block Group 2, Census Tract 2523.17, Solano County, California",0,0,0
1000000US060952523172051,060952523172051,"Block 2051, Block Group 2, Census Tract 2523.17, Solano County, California",0,0,0
1000000US060952523172052,060952523172052,"Block 2052, Block Group 2, Census Tract 2523.17, Solano County, California",0,0,0
1000000US060952523172053,060952523172053,"Block 2053, Block Group 2, Census Tract 2523.17, Solano County, California",2,1,1
1000000US060952523172054,060952523172054,"Block 2054, Block Group 2, Census Tract 2523.17, Solano County, California",0,0,0
1000000US060952523172055,060952523172055,"Block 2055, Block Group 2, Census Tract 2523.17, Solano County, California",6,4,2
1000000US060952523172056,060952523172056,"Block 2056, Block Group 2, Census Tract 2523.17, Solano County, California",0,0,0
1000000US060952523172057,060952523172057,"Block 2057, Block Group 2, Census Tract 2523.17, Solano County, California",0,0,0
1000000US060952523172058,060952523172058,"Block 2058, Block Group 2, Census Tract 2523.17, Solano County, California",0,0,0
1000000US060952523172059,060952523172059,"Block 2059, Block Group 2, Census Tract 2523.17, Solano County, California",0,0,0
1000000US060952523172060,060952523172060,"Block 2060, Block Group 2, Census Tract 2523.17, Solano County, California",0,0,0
1000000US060952523172061,060952523172061,"Block 2061, Block Group 2, Census Tract 2523.17, Solano County, California",0,0,0
1000000US060952523172062,060952523172062,"Block 2062, Block Group 2, Census Tract 2523.17, Solano County, California",0,0,0
1000000US060952523172063,060952523172063,"Block 2063, Block Group 2, Census Tract 2523.17, Solano County, California",0,0,0
1000000US060952523172064,060952523172064,"Block 2064, Block Group 2, Census Tract 2523.17, Solano County, California",0,0,0
1000000US060952523172065,060952523172065,"Block 2065, Block Group 2, Census Tract 2523.17, Solano County, California",1,1,0
1000000US060952523172066,060952523172066,"Block 2066, Block Group 2, Census Tract 2523.17, Solano County, California",0,0,0
1000000US060952523172067,060952523172067,"Block 2067, Block Group 2, Census Tract 2523.17, Solano County, California",0,0,0
1000000US060952523172068,060952523172068,"Block 2068, Block Group 2, Census Tract 2523.17, Solano County, California",0,0,0
1000000US060952523172069,060952523172069,"Block 2069, Block Group 2, Census Tract 2523.17, Solano County, California",0,0,0
1000000US060952523172070,060952523172070,"Block 2070, Block Group 2, Census Tract 2523.17, Solano County, California",0,0,0
1000000US060952523172071,060952523172071,"Block 2071, Block Group 2, Census Tract 2523.17, Solano County, California",0,0,0
1000000US060952523172072,060952523172072,"Block 2072, Block Group 2, Census Tract 2523.17, Solano County, California",4,4,0
1000000US060952523172073,060952523172073,"Block 2073, Block Group 2, Census Tract 2523.17, Solano County, California",0,0,0
1000000US060952523172074,060952523172074,"Block 2074, Block Group 2, Census Tract 2523.17, Solano County, California",0,0,0
1000000US060952523172075,060952523172075,"Block 2075, Block Group 2, Census Tract 2523.17, Solano County, California",127,121,6
1000000US060952523172076,060952523172076,"Block 2076, Block Group 2, Census Tract 2523.17, Solano County, California",205,184,21
1000000US060952523172077,060952523172077,"Block 2077, Block Group 2, Census Tract 2523.17, Solano County, California",44,40,4
1000000US060952523172078,060952523172078,"Block 2078, Block Group 2, Census Tract 2523.17, Solano County, California",38,35,3
1000000US060952523172079,060952523172079,"Block 2079, Block Group 2, Census Tract 2523.17, Solano County, California",0,0,0
1000000US060952523172080,060952523172080,"Block 2080, Block Group 2, Census Tract 2523.17, Solano County, California",0,0,0
1000000US060952523172081,060952523172081,"Block 2081, Block Group 2, Census Tract 2523.17, Solano County, California",20,17,3
1000000US060952523172082,060952523172082,"Block 2082, Block Group 2, Census Tract 2523.17, Solano County, California",0,0,0
1000000US060952523172083,060952523172083,"Block 2083, Block Group 2, Census Tract 2523.17, Solano County, California",0,0,0
1000000US060952523172084,060952523172084,"Block 2084, Block Group 2, Census Tract 2523.17, Solano County, California",0,0,0
1000000US060952523172085,060952523172085,"Block 2085, Block Group 2, Census Tract 2523.17, Solano County, California",0,0,0
1000000US060952523172086,060952523172086,"Block 2086, Block Group 2, Census Tract 2523.17, Solano County, California",0,0,0
1000000US060952523172087,060952523172087,"Block 2087, Block Group 2, Census Tract 2523.17, Solano County, California",0,0,0
1000000US060952523172088,060952523172088,"Block 2088, Block Group 2, Census Tract 2523.17, Solano County, California",0,0,0
1000000US060952523172089,060952523172089,"Block 2089, Block Group 2, Census Tract 2523.17, Solano County, California",0,0,0
1000000US060952523172090,060952523172090,"Block 2090, Block Group 2, Census Tract 2523.17, Solano County, California",0,0,0
1000000US060952523172091,060952523172091,"Block 2091, Block Group 2, Census Tract 2523.17, Solano County, California",0,0,0
1000000US060952523172092,060952523172092,"Block 2092, Block Group 2, Census Tract 2523.17, Solano County, California",0,0,0
1000000US060952523172093,060952523172093,"Block 2093, Block Group 2, Census Tract 2523.17, Solano County, California",0,0,0
1000000US060952523172094,060952523172094,"Block 2094, Block Group 2, Census Tract 2523.17, Solano County, California",3,3,0
1000000US060952523172095,060952523172095,"Block 2095, Block Group 2, Census Tract 2523.17, Solano County, California",0,0,0
1000000US060952523172096,060952523172096,"Block 2096, Block Group 2, Census Tract 2523.17, Solano County, California",1,1,0
1000000US060952523172097,060952523172097,"Block 2097, Block Group 2, Census Tract 2523.17, Solano County, California",0,0,0
1000000US060952523172098,060952523172098,"Block 2098, Block Group 2, Census Tract 2523.17, Solano County, California",41,35,6
1000000US060952523172099,060952523172099,"Block 2099, Block Group 2, Census Tract 2523.17, Solano County, California",0,0,0
1000000US060952523172100,060952523172100,"Block 2100, Block Group 2, Census Tract 2523.17, Solano County, California",0,0,0
1000000US060952523172101,060952523172101,"Block 2101, Block Group 2, Census Tract 2523.17, Solano County, California",0,0,0
1000000US060952523172102,060952523172102,"Block 2102, Block Group 2, Census Tract 2523.17, Solano County, California",0,0,0
1000000US060952523172103,060952523172103,"Block 2103, Block Group 2, Census Tract 2523.17, Solano County, California",13,12,1
1000000US060952523172104,060952523172104,"Block 2104, Block Group 2, Census Tract 2523.17, Solano County, California",15,13,2
1000000US060952523172105,060952523172105,"Block 2105, Block Group 2, Census Tract 2523.17, Solano County, California",0,0,0
1000000US060952523172106,060952523172106,"Block 2106, Block Group 2, Census Tract 2523.17, Solano County, California",0,0,0
1000000US060952523172107,060952523172107,"Block 2107, Block Group 2, Census Tract 2523.17, Solano County, California",0,0,0
1000000US060952523172108,060952523172108,"Block 2108, Block Group 2, Census Tract 2523.17, Solano County, California",0,0,0
1000000US060952523172109,060952523172109,"Block 2109, Block Group 2, Census Tract 2523.17, Solano County, California",0,0,0
1000000US060952523172110,060952523172110,"Block 2110, Block Group 2, Census Tract 2523.17, Solano County, California",0,0,0
1000000US060952523172111,060952523172111,"Block 2111, Block Group 2, Census Tract 2523.17, Solano County, California",0,0,0
1000000US060952523172112,060952523172112,"Block 2112, Block Group 2, Census Tract 2523.17, Solano County, California",13,13,0
1000000US060952523172113,060952523172113,"Block 2113, Block Group 2, Census Tract 2523.17, Solano County, California",23,16,7
1000000US060952523172114,060952523172114,"Block 2114, Block Group 2, Census Tract 2523.17, Solano County, California",0,0,0
1000000US060952523172115,060952523172115,"Block 2115, Block Group 2, Census Tract 2523.17, Solano County, California",28,25,3
1000000US060952523172116,060952523172116,"Block 2116, Block Group 2, Census Tract 2523.17, Solano County, California",24,22,2
1000000US060952523172117,060952523172117,"Block 2117, Block Group 2, Census Tract 2523.17, Solano County, California",23,20,3
1000000US060952524011000,060952524011000,"Block 1000, Block Group 1, Census Tract 2524.01, Solano County, California",0,0,0
1000000US060952524011001,060952524011001,"Block 1001, Block Group 1, Census Tract 2524.01, Solano County, California",13,13,0
1000000US060952524011002,060952524011002,"Block 1002, Block Group 1, Census Tract 2524.01, Solano County, California",0,0,0
1000000US060952524011003,060952524011003,"Block 1003, Block Group 1, Census Tract 2524.01, Solano County, California",0,0,0
1000000US060952524011004,060952524011004,"Block 1004, Block Group 1, Census Tract 2524.01, Solano County, California",32,31,1
1000000US060952524011005,060952524011005,"Block 1005, Block Group 1, Census Tract 2524.01, Solano County, California",30,29,1
1000000US060952524011006,060952524011006,"Block 1006, Block Group 1, Census Tract 2524.01, Solano County, California",31,30,1
1000000US060952524011007,060952524011007,"Block 1007, Block Group 1, Census Tract 2524.01, Solano County, California",18,16,2
1000000US060952524011008,060952524011008,"Block 1008, Block Group 1, Census Tract 2524.01, Solano County, California",22,19,3
1000000US060952524011009,060952524011009,"Block 1009, Block Group 1, Census Tract 2524.01, Solano County, California",16,15,1
1000000US060952524011010,060952524011010,"Block 1010, Block Group 1, Census Tract 2524.01, Solano County, California",25,24,1
1000000US060952524011011,060952524011011,"Block 1011, Block Group 1, Census Tract 2524.01, Solano County, California",34,33,1
1000000US060952524011012,060952524011012,"Block 1012, Block Group 1, Census Tract 2524.01, Solano County, California",33,32,1
1000000US060952524011013,060952524011013,"Block 1013, Block Group 1, Census Tract 2524.01, Solano County, California",34,31,3
1000000US060952524011014,060952524011014,"Block 1014, Block Group 1, Census Tract 2524.01, Solano County, California",34,33,1
1000000US060952524011015,060952524011015,"Block 1015, Block Group 1, Census Tract 2524.01, Solano County, California",0,0,0
1000000US060952524011016,060952524011016,"Block 1016, Block Group 1, Census Tract 2524.01, Solano County, California",15,14,1
1000000US060952524012000,060952524012000,"Block 2000, Block Group 2, Census Tract 2524.01, Solano County, California",0,0,0
1000000US060952524012001,060952524012001,"Block 2001, Block Group 2, Census Tract 2524.01, Solano County, California",0,0,0
1000000US060952524012002,060952524012002,"Block 2002, Block Group 2, Census Tract 2524.01, Solano County, California",30,27,3
1000000US060952524012003,060952524012003,"Block 2003, Block Group 2, Census Tract 2524.01, Solano County, California",21,17,4
1000000US060952524012004,060952524012004,"Block 2004, Block Group 2, Census Tract 2524.01, Solano County, California",21,21,0
1000000US060952524012005,060952524012005,"Block 2005, Block Group 2, Census Tract 2524.01, Solano County, California",32,30,2
1000000US060952524012006,060952524012006,"Block 2006, Block Group 2, Census Tract 2524.01, Solano County, California",32,31,1
1000000US060952524012007,060952524012007,"Block 2007, Block Group 2, Census Tract 2524.01, Solano County, California",20,19,1
1000000US060952524012008,060952524012008,"Block 2008, Block Group 2, Census Tract 2524.01, Solano County, California",20,20,0
1000000US060952524012009,060952524012009,"Block 2009, Block Group 2, Census Tract 2524.01, Solano County, California",47,42,5
1000000US060952524012010,060952524012010,"Block 2010, Block Group 2, Census Tract 2524.01, Solano County, California",20,19,1
1000000US060952524012011,060952524012011,"Block 2011, Block Group 2, Census Tract 2524.01, Solano County, California",10,9,1
1000000US060952524012012,060952524012012,"Block 2012, Block Group 2, Census Tract 2524.01, Solano County, California",0,0,0
1000000US060952524012013,060952524012013,"Block 2013, Block Group 2, Census Tract 2524.01, Solano County, California",0,0,0
1000000US060952524012014,060952524012014,"Block 2014, Block Group 2, Census Tract 2524.01, Solano County, California",0,0,0
1000000US060952524012015,060952524012015,"Block 2015, Block Group 2, Census Tract 2524.01, Solano County, California",0,0,0
1000000US060952524012016,060952524012016,"Block 2016, Block Group 2, Census Tract 2524.01, Solano County, California",0,0,0
1000000US060952524012017,060952524012017,"Block 2017, Block Group 2, Census Tract 2524.01, Solano County, California",21,20,1
1000000US060952524012018,060952524012018,"Block 2018, Block Group 2, Census Tract 2524.01, Solano County, California",24,22,2
1000000US060952524012019,060952524012019,"Block 2019, Block Group 2, Census Tract 2524.01, Solano County, California",11,9,2
1000000US060952524013000,060952524013000,"Block 3000, Block Group 3, Census Tract 2524.01, Solano County, California",0,0,0
1000000US060952524013001,060952524013001,"Block 3001, Block Group 3, Census Tract 2524.01, Solano County, California",0,0,0
1000000US060952524013002,060952524013002,"Block 3002, Block Group 3, Census Tract 2524.01, Solano County, California",0,0,0
1000000US060952524013003,060952524013003,"Block 3003, Block Group 3, Census Tract 2524.01, Solano County, California",73,69,4
1000000US060952524013004,060952524013004,"Block 3004, Block Group 3, Census Tract 2524.01, Solano County, California",28,26,2
1000000US060952524013005,060952524013005,"Block 3005, Block Group 3, Census Tract 2524.01, Solano County, California",24,23,1
1000000US060952524013006,060952524013006,"Block 3006, Block Group 3, Census Tract 2524.01, Solano County, California",35,34,1
1000000US060952524013007,060952524013007,"Block 3007, Block Group 3, Census Tract 2524.01, Solano County, California",34,33,1
1000000US060952524013008,060952524013008,"Block 3008, Block Group 3, Census Tract 2524.01, Solano County, California",9,8,1
1000000US060952524013009,060952524013009,"Block 3009, Block Group 3, Census Tract 2524.01, Solano County, California",29,28,1
1000000US060952524013010,060952524013010,"Block 3010, Block Group 3, Census Tract 2524.01, Solano County, California",11,10,1
1000000US060952524013011,060952524013011,"Block 3011, Block Group 3, Census Tract 2524.01, Solano County, California",28,24,4
1000000US060952524013012,060952524013012,"Block 3012, Block Group 3, Census Tract 2524.01, Solano County, California",16,15,1
1000000US060952524013013,060952524013013,"Block 3013, Block Group 3, Census Tract 2524.01, Solano County, California",19,18,1
1000000US060952524013014,060952524013014,"Block 3014, Block Group 3, Census Tract 2524.01, Solano County, California",12,12,0
1000000US060952524013015,060952524013015,"Block 3015, Block Group 3, Census Tract 2524.01, Solano County, California",21,21,0
1000000US060952524013016,060952524013016,"Block 3016, Block Group 3, Census Tract 2524.01, Solano County, California",28,25,3
1000000US060952524013017,060952524013017,"Block 3017, Block Group 3, Census Tract 2524.01, Solano County, California",12,12,0
1000000US060952524013018,060952524013018,"Block 3018, Block Group 3, Census Tract 2524.01, Solano County, California",1,1,0
1000000US060952524014000,060952524014000,"Block 4000, Block Group 4, Census Tract 2524.01, Solano County, California",30,28,2
1000000US060952524014001,060952524014001,"Block 4001, Block Group 4, Census Tract 2524.01, Solano County, California",39,38,1
1000000US060952524014002,060952524014002,"Block 4002, Block Group 4, Census Tract 2524.01, Solano County, California",10,9,1
1000000US060952524014003,060952524014003,"Block 4003, Block Group 4, Census Tract 2524.01, Solano County, California",11,10,1
1000000US060952524014004,060952524014004,"Block 4004, Block Group 4, Census Tract 2524.01, Solano County, California",26,23,3
1000000US060952524014005,060952524014005,"Block 4005, Block Group 4, Census Tract 2524.01, Solano County, California",34,32,2
1000000US060952524014006,060952524014006,"Block 4006, Block Group 4, Census Tract 2524.01, Solano County, California",0,0,0
1000000US060952524014007,060952524014007,"Block 4007, Block Group 4, Census Tract 2524.01, Solano County, California",0,0,0
1000000US060952524014008,060952524014008,"Block 4008, Block Group 4, Census Tract 2524.01, Solano County, California",18,18,0
1000000US060952524014009,060952524014009,"Block 4009, Block Group 4, Census Tract 2524.01, Solano County, California",18,18,0
1000000US060952524014010,060952524014010,"Block 4010, Block Group 4, Census Tract 2524.01, Solano County, California",17,15,2
1000000US060952524014011,060952524014011,"Block 4011, Block Group 4, Census Tract 2524.01, Solano County, California",19,18,1
1000000US060952524014012,060952524014012,"Block 4012, Block Group 4, Census Tract 2524.01, Solano County, California",200,176,24
1000000US060952524014013,060952524014013,"Block 4013, Block Group 4, Census Tract 2524.01, Solano County, California",0,0,0
1000000US060952524014014,060952524014014,"Block 4014, Block Group 4, Census Tract 2524.01, Solano County, California",0,0,0
1000000US060952524014015,060952524014015,"Block 4015, Block Group 4, Census Tract 2524.01, Solano County, California",0,0,0
1000000US060952524014016,060952524014016,"Block 4016, Block Group 4, Census Tract 2524.01, Solano County, California",18,16,2
1000000US060952524021000,060952524021000,"Block 1000, Block Group 1, Census Tract 2524.02, Solano County, California",37,37,0
1000000US060952524021001,060952524021001,"Block 1001, Block Group 1, Census Tract 2524.02, Solano County, California",130,113,17
1000000US060952524021002,060952524021002,"Block 1002, Block Group 1, Census Tract 2524.02, Solano County, California",28,27,1
1000000US060952524021003,060952524021003,"Block 1003, Block Group 1, Census Tract 2524.02, Solano County, California",33,31,2
1000000US060952524021004,060952524021004,"Block 1004, Block Group 1, Census Tract 2524.02, Solano County, California",24,23,1
1000000US060952524021005,060952524021005,"Block 1005, Block Group 1, Census Tract 2524.02, Solano County, California",35,35,0
1000000US060952524021006,060952524021006,"Block 1006, Block Group 1, Census Tract 2524.02, Solano County, California",7,4,3
1000000US060952524021007,060952524021007,"Block 1007, Block Group 1, Census Tract 2524.02, Solano County, California",20,19,1
1000000US060952524021008,060952524021008,"Block 1008, Block Group 1, Census Tract 2524.02, Solano County, California",88,82,6
1000000US060952524021009,060952524021009,"Block 1009, Block Group 1, Census Tract 2524.02, Solano County, California",0,0,0
1000000US060952524021010,060952524021010,"Block 1010, Block Group 1, Census Tract 2524.02, Solano County, California",18,16,2
1000000US060952524022000,060952524022000,"Block 2000, Block Group 2, Census Tract 2524.02, Solano County, California",0,0,0
1000000US060952524022001,060952524022001,"Block 2001, Block Group 2, Census Tract 2524.02, Solano County, California",0,0,0
1000000US060952524022002,060952524022002,"Block 2002, Block Group 2, Census Tract 2524.02, Solano County, California",0,0,0
1000000US060952524022003,060952524022003,"Block 2003, Block Group 2, Census Tract 2524.02, Solano County, California",0,0,0
1000000US060952524022004,060952524022004,"Block 2004, Block Group 2, Census Tract 2524.02, Solano County, California",0,0,0
1000000US060952524022005,060952524022005,"Block 2005, Block Group 2, Census Tract 2524.02, Solano County, California",0,0,0
1000000US060952524022006,060952524022006,"Block 2006, Block Group 2, Census Tract 2524.02, Solano County, California",0,0,0
1000000US060952524022007,060952524022007,"Block 2007, Block Group 2, Census Tract 2524.02, Solano County, California",0,0,0
1000000US060952524022008,060952524022008,"Block 2008, Block Group 2, Census Tract 2524.02, Solano County, California",0,0,0
1000000US060952524022009,060952524022009,"Block 2009, Block Group 2, Census Tract 2524.02, Solano County, California",0,0,0
1000000US060952524022010,060952524022010,"Block 2010, Block Group 2, Census Tract 2524.02, Solano County, California",0,0,0
1000000US060952524022011,060952524022011,"Block 2011, Block Group 2, Census Tract 2524.02, Solano County, California",0,0,0
1000000US060952524022012,060952524022012,"Block 2012, Block Group 2, Census Tract 2524.02, Solano County, California",0,0,0
1000000US060952524022013,060952524022013,"Block 2013, Block Group 2, Census Tract 2524.02, Solano County, California",0,0,0
1000000US060952524022014,060952524022014,"Block 2014, Block Group 2, Census Tract 2524.02, Solano County, California",0,0,0
1000000US060952524022015,060952524022015,"Block 2015, Block Group 2, Census Tract 2524.02, Solano County, California",0,0,0
1000000US060952524022016,060952524022016,"Block 2016, Block Group 2, Census Tract 2524.02, Solano County, California",0,0,0
1000000US060952524022017,060952524022017,"Block 2017, Block Group 2, Census Tract 2524.02, Solano County, California",0,0,0
1000000US060952524022018,060952524022018,"Block 2018, Block Group 2, Census Tract 2524.02, Solano County, California",0,0,0
1000000US060952524022019,060952524022019,"Block 2019, Block Group 2, Census Tract 2524.02, Solano County, California",0,0,0
1000000US060952524022020,060952524022020,"Block 2020, Block Group 2, Census Tract 2524.02, Solano County, California",0,0,0
1000000US060952524022021,060952524022021,"Block 2021, Block Group 2, Census Tract 2524.02, Solano County, California",0,0,0
1000000US060952524022022,060952524022022,"Block 2022, Block Group 2, Census Tract 2524.02, Solano County, California",0,0,0
1000000US060952524022023,060952524022023,"Block 2023, Block Group 2, Census Tract 2524.02, Solano County, California",0,0,0
1000000US060952524022024,060952524022024,"Block 2024, Block Group 2, Census Tract 2524.02, Solano County, California",0,0,0
1000000US060952524022025,060952524022025,"Block 2025, Block Group 2, Census Tract 2524.02, Solano County, California",0,0,0
1000000US060952524022026,060952524022026,"Block 2026, Block Group 2, Census Tract 2524.02, Solano County, California",0,0,0
1000000US060952524022027,060952524022027,"Block 2027, Block Group 2, Census Tract 2524.02, Solano County, California",46,43,3
1000000US060952524022028,060952524022028,"Block 2028, Block Group 2, Census Tract 2524.02, Solano County, California",26,26,0
1000000US060952524022029,060952524022029,"Block 2029, Block Group 2, Census Tract 2524.02, Solano County, California",17,16,1
1000000US060952524022030,060952524022030,"Block 2030, Block Group 2, Census Tract 2524.02, Solano County, California",43,41,2
1000000US060952524022031,060952524022031,"Block 2031, Block Group 2, Census Tract 2524.02, Solano County, California",0,0,0
1000000US060952524022032,060952524022032,"Block 2032, Block Group 2, Census Tract 2524.02, Solano County, California",2,2,0
1000000US060952524022033,060952524022033,"Block 2033, Block Group 2, Census Tract 2524.02, Solano County, California",265,256,9
1000000US060952524022034,060952524022034,"Block 2034, Block Group 2, Census Tract 2524.02, Solano County, California",4,4,0
1000000US060952524022035,060952524022035,"Block 2035, Block Group 2, Census Tract 2524.02, Solano County, California",33,32,1
1000000US060952524022036,060952524022036,"Block 2036, Block Group 2, Census Tract 2524.02, Solano County, California",4,4,0
1000000US060952524022037,060952524022037,"Block 2037, Block Group 2, Census Tract 2524.02, Solano County, California",31,30,1
1000000US060952524022038,060952524022038,"Block 2038, Block Group 2, Census Tract 2524.02, Solano County, California",2,2,0
1000000US060952524022039,060952524022039,"Block 2039, Block Group 2, Census Tract 2524.02, Solano County, California",48,46,2
1000000US060952524022040,060952524022040,"Block 2040, Block Group 2, Census Tract 2524.02, Solano County, California",21,20,1
1000000US060952524022041,060952524022041,"Block 2041, Block Group 2, Census Tract 2524.02, Solano County, California",79,78,1
1000000US060952524022042,060952524022042,"Block 2042, Block Group 2, Census Tract 2524.02, Solano County, California",18,16,2
1000000US060952524022043,060952524022043,"Block 2043, Block Group 2, Census Tract 2524.02, Solano County, California",66,65,1
1000000US060952524022044,060952524022044,"Block 2044, Block Group 2, Census Tract 2524.02, Solano County, California",15,14,1
1000000US060952524022045,060952524022045,"Block 2045, Block Group 2, Census Tract 2524.02, Solano County, California",0,0,0
1000000US060952524022046,060952524022046,"Block 2046, Block Group 2, Census Tract 2524.02, Solano County, California",0,0,0
1000000US060952524022047,060952524022047,"Block 2047, Block Group 2, Census Tract 2524.02, Solano County, California",0,0,0
1000000US060952524022048,060952524022048,"Block 2048, Block Group 2, Census Tract 2524.02, Solano County, California",0,0,0
1000000US060952524022049,060952524022049,"Block 2049, Block Group 2, Census Tract 2524.02, Solano County, California",0,0,0
1000000US060952524022050,060952524022050,"Block 2050, Block Group 2, Census Tract 2524.02, Solano County, California",0,0,0
1000000US060952524022051,060952524022051,"Block 2051, Block Group 2, Census Tract 2524.02, Solano County, California",0,0,0
1000000US060952524022052,060952524022052,"Block 2052, Block Group 2, Census Tract 2524.02, Solano County, California",0,0,0
1000000US060952524022053,060952524022053,"Block 2053, Block Group 2, Census Tract 2524.02, Solano County, California",0,0,0
1000000US060952524022054,060952524022054,"Block 2054, Block Group 2, Census Tract 2524.02, Solano County, California",0,0,0
1000000US060952524022055,060952524022055,"Block 2055, Block Group 2, Census Tract 2524.02, Solano County, California",0,0,0
1000000US060952524022056,060952524022056,"Block 2056, Block Group 2, Census Tract 2524.02, Solano County, California",0,0,0
1000000US060952524022057,060952524022057,"Block 2057, Block Group 2, Census Tract 2524.02, Solano County, California",0,0,0
1000000US060952524022058,060952524022058,"Block 2058, Block Group 2, Census Tract 2524.02, Solano County, California",0,0,0
1000000US060952524022059,060952524022059,"Block 2059, Block Group 2, Census Tract 2524.02, Solano County, California",0,0,0
1000000US060952524022060,060952524022060,"Block 2060, Block Group 2, Census Tract 2524.02, Solano County, California",0,0,0
1000000US060952524022061,060952524022061,"Block 2061, Block Group 2, Census Tract 2524.02, Solano County, California",0,0,0
1000000US060952524022062,060952524022062,"Block 2062, Block Group 2, Census Tract 2524.02, Solano County, California",0,0,0
1000000US060952524022063,060952524022063,"Block 2063, Block Group 2, Census Tract 2524.02, Solano County, California",0,0,0
1000000US060952524022064,060952524022064,"Block 2064, Block Group 2, Census Tract 2524.02, Solano County, California",0,0,0
1000000US060952524022065,060952524022065,"Block 2065, Block Group 2, Census Tract 2524.02, Solano County, California",0,0,0
1000000US060952524022066,060952524022066,"Block 2066, Block Group 2, Census Tract 2524.02, Solano County, California",0,0,0
1000000US060952524022067,060952524022067,"Block 2067, Block Group 2, Census Tract 2524.02, Solano County, California",0,0,0
1000000US060952524022068,060952524022068,"Block 2068, Block Group 2, Census Tract 2524.02, Solano County, California",0,0,0
1000000US060952524022069,060952524022069,"Block 2069, Block Group 2, Census Tract 2524.02, Solano County, California",0,0,0
1000000US060952524022070,060952524022070,"Block 2070, Block Group 2, Census Tract 2524.02, Solano County, California",0,0,0
1000000US060952524022071,060952524022071,"Block 2071, Block Group 2, Census Tract 2524.02, Solano County, California",0,0,0
1000000US060952524022072,060952524022072,"Block 2072, Block Group 2, Census Tract 2524.02, Solano County, California",0,0,0
1000000US060952524022073,060952524022073,"Block 2073, Block Group 2, Census Tract 2524.02, Solano County, California",0,0,0
1000000US060952524022074,060952524022074,"Block 2074, Block Group 2, Census Tract 2524.02, Solano County, California",0,0,0
1000000US060952524022075,060952524022075,"Block 2075, Block Group 2, Census Tract 2524.02, Solano County, California",0,0,0
1000000US060952524022076,060952524022076,"Block 2076, Block Group 2, Census Tract 2524.02, Solano County, California",0,0,0
1000000US060952524022077,060952524022077,"Block 2077, Block Group 2, Census Tract 2524.02, Solano County, California",0,0,0
1000000US060952524022078,060952524022078,"Block 2078, Block Group 2, Census Tract 2524.02, Solano County, California",0,0,0
1000000US060952524022079,060952524022079,"Block 2079, Block Group 2, Census Tract 2524.02, Solano County, California",0,0,0
1000000US060952524022080,060952524022080,"Block 2080, Block Group 2, Census Tract 2524.02, Solano County, California",0,0,0
1000000US060952524022081,060952524022081,"Block 2081, Block Group 2, Census Tract 2524.02, Solano County, California",0,0,0
1000000US060952524022082,060952524022082,"Block 2082, Block Group 2, Census Tract 2524.02, Solano County, California",0,0,0
1000000US060952524022083,060952524022083,"Block 2083, Block Group 2, Census Tract 2524.02, Solano County, California",0,0,0
1000000US060952524022084,060952524022084,"Block 2084, Block Group 2, Census Tract 2524.02, Solano County, California",0,0,0
1000000US060952524022085,060952524022085,"Block 2085, Block Group 2, Census Tract 2524.02, Solano County, California",0,0,0
1000000US060952524022086,060952524022086,"Block 2086, Block Group 2, Census Tract 2524.02, Solano County, California",0,0,0
1000000US060952524022087,060952524022087,"Block 2087, Block Group 2, Census Tract 2524.02, Solano County, California",0,0,0
1000000US060952524022088,060952524022088,"Block 2088, Block Group 2, Census Tract 2524.02, Solano County, California",0,0,0
1000000US060952524022089,060952524022089,"Block 2089, Block Group 2, Census Tract 2524.02, Solano County, California",0,0,0
1000000US060952524022090,060952524022090,"Block 2090, Block Group 2, Census Tract 2524.02, Solano County, California",0,0,0
1000000US060952524022091,060952524022091,"Block 2091, Block Group 2, Census Tract 2524.02, Solano County, California",0,0,0
1000000US060952524022092,060952524022092,"Block 2092, Block Group 2, Census Tract 2524.02, Solano County, California",0,0,0
1000000US060952524022093,060952524022093,"Block 2093, Block Group 2, Census Tract 2524.02, Solano County, California",0,0,0
1000000US060952524022094,060952524022094,"Block 2094, Block Group 2, Census Tract 2524.02, Solano County, California",0,0,0
1000000US060952524022095,060952524022095,"Block 2095, Block Group 2, Census Tract 2524.02, Solano County, California",0,0,0
1000000US060952524022096,060952524022096,"Block 2096, Block Group 2, Census Tract 2524.02, Solano County, California",0,0,0
1000000US060952524022097,060952524022097,"Block 2097, Block Group 2, Census Tract 2524.02, Solano County, California",1,1,0
1000000US060952524022098,060952524022098,"Block 2098, Block Group 2, Census Tract 2524.02, Solano County, California",0,0,0
1000000US060952524022099,060952524022099,"Block 2099, Block Group 2, Census Tract 2524.02, Solano County, California",0,0,0
1000000US060952524022100,060952524022100,"Block 2100, Block Group 2, Census Tract 2524.02, Solano County, California",0,0,0
1000000US060952524022101,060952524022101,"Block 2101, Block Group 2, Census Tract 2524.02, Solano County, California",0,0,0
1000000US060952524022102,060952524022102,"Block 2102, Block Group 2, Census Tract 2524.02, Solano County, California",0,0,0
1000000US060952524022103,060952524022103,"Block 2103, Block Group 2, Census Tract 2524.02, Solano County, California",0,0,0
1000000US060952524022104,060952524022104,"Block 2104, Block Group 2, Census Tract 2524.02, Solano County, California",0,0,0
1000000US060952524022105,060952524022105,"Block 2105, Block Group 2, Census Tract 2524.02, Solano County, California",0,0,0
1000000US060952524022106,060952524022106,"Block 2106, Block Group 2, Census Tract 2524.02, Solano County, California",0,0,0
1000000US060952524022107,060952524022107,"Block 2107, Block Group 2, Census Tract 2524.02, Solano County, California",0,0,0
1000000US060952524022108,060952524022108,"Block 2108, Block Group 2, Census Tract 2524.02, Solano County, California",0,0,0
1000000US060952524023000,060952524023000,"Block 3000, Block Group 3, Census Tract 2524.02, Solano County, California",0,0,0
1000000US060952524023001,060952524023001,"Block 3001, Block Group 3, Census Tract 2524.02, Solano County, California",0,0,0
1000000US060952524023002,060952524023002,"Block 3002, Block Group 3, Census Tract 2524.02, Solano County, California",357,322,35
1000000US060952524023003,060952524023003,"Block 3003, Block Group 3, Census Tract 2524.02, Solano County, California",2,2,0
1000000US060952524023004,060952524023004,"Block 3004, Block Group 3, Census Tract 2524.02, Solano County, California",301,280,21
1000000US060952524023005,060952524023005,"Block 3005, Block Group 3, Census Tract 2524.02, Solano County, California",0,0,0
1000000US060952524023006,060952524023006,"Block 3006, Block Group 3, Census Tract 2524.02, Solano County, California",0,0,0
1000000US060952524023007,060952524023007,"Block 3007, Block Group 3, Census Tract 2524.02, Solano County, California",0,0,0
1000000US060952525011000,060952525011000,"Block 1000, Block Group 1, Census Tract 2525.01, Solano County, California",0,0,0
1000000US060952525011001,060952525011001,"Block 1001, Block Group 1, Census Tract 2525.01, Solano County, California",23,22,1
1000000US060952525011002,060952525011002,"Block 1002, Block Group 1, Census Tract 2525.01, Solano County, California",28,27,1
1000000US060952525011003,060952525011003,"Block 1003, Block Group 1, Census Tract 2525.01, Solano County, California",30,28,2
1000000US060952525011004,060952525011004,"Block 1004, Block Group 1, Census Tract 2525.01, Solano County, California",41,40,1
1000000US060952525011005,060952525011005,"Block 1005, Block Group 1, Census Tract 2525.01, Solano County, California",23,22,1
1000000US060952525011006,060952525011006,"Block 1006, Block Group 1, Census Tract 2525.01, Solano County, California",10,9,1
1000000US060952525011007,060952525011007,"Block 1007, Block Group 1, Census Tract 2525.01, Solano County, California",30,30,0
1000000US060952525011008,060952525011008,"Block 1008, Block Group 1, Census Tract 2525.01, Solano County, California",14,14,0
1000000US060952525011009,060952525011009,"Block 1009, Block Group 1, Census Tract 2525.01, Solano County, California",16,14,2
1000000US060952525011010,060952525011010,"Block 1010, Block Group 1, Census Tract 2525.01, Solano County, California",0,0,0
1000000US060952525011011,060952525011011,"Block 1011, Block Group 1, Census Tract 2525.01, Solano County, California",0,0,0
1000000US060952525012000,060952525012000,"Block 2000, Block Group 2, Census Tract 2525.01, Solano County, California",62,53,9
1000000US060952525012001,060952525012001,"Block 2001, Block Group 2, Census Tract 2525.01, Solano County, California",170,148,22
1000000US060952525012002,060952525012002,"Block 2002, Block Group 2, Census Tract 2525.01, Solano County, California",40,38,2
1000000US060952525012003,060952525012003,"Block 2003, Block Group 2, Census Tract 2525.01, Solano County, California",27,25,2
1000000US060952525012004,060952525012004,"Block 2004, Block Group 2, Census Tract 2525.01, Solano County, California",28,27,1
1000000US060952525012005,060952525012005,"Block 2005, Block Group 2, Census Tract 2525.01, Solano County, California",18,16,2
1000000US060952525012006,060952525012006,"Block 2006, Block Group 2, Census Tract 2525.01, Solano County, California",28,27,1
1000000US060952525012007,060952525012007,"Block 2007, Block Group 2, Census Tract 2525.01, Solano County, California",19,19,0
1000000US060952525012008,060952525012008,"Block 2008, Block Group 2, Census Tract 2525.01, Solano County, California",0,0,0
1000000US060952525012009,060952525012009,"Block 2009, Block Group 2, Census Tract 2525.01, Solano County, California",16,16,0
1000000US060952525012010,060952525012010,"Block 2010, Block Group 2, Census Tract 2525.01, Solano County, California",27,26,1
1000000US060952525012011,060952525012011,"Block 2011, Block Group 2, Census Tract 2525.01, Solano County, California",0,0,0
1000000US060952525012012,060952525012012,"Block 2012, Block Group 2, Census Tract 2525.01, Solano County, California",14,14,0
1000000US060952525012013,060952525012013,"Block 2013, Block Group 2, Census Tract 2525.01, Solano County, California",23,22,1
1000000US060952525012014,060952525012014,"Block 2014, Block Group 2, Census Tract 2525.01, Solano County, California",21,19,2
1000000US060952525012015,060952525012015,"Block 2015, Block Group 2, Census Tract 2525.01, Solano County, California",15,11,4
1000000US060952525012016,060952525012016,"Block 2016, Block Group 2, Census Tract 2525.01, Solano County, California",13,12,1
1000000US060952525012017,060952525012017,"Block 2017, Block Group 2, Census Tract 2525.01, Solano County, California",41,35,6
1000000US060952525012018,060952525012018,"Block 2018, Block Group 2, Census Tract 2525.01, Solano County, California",94,93,1
1000000US060952525012019,060952525012019,"Block 2019, Block Group 2, Census Tract 2525.01, Solano County, California",20,15,5
1000000US060952525012020,060952525012020,"Block 2020, Block Group 2, Census Tract 2525.01, Solano County, California",26,24,2
1000000US060952525012021,060952525012021,"Block 2021, Block Group 2, Census Tract 2525.01, Solano County, California",15,15,0
1000000US060952525012022,060952525012022,"Block 2022, Block Group 2, Census Tract 2525.01, Solano County, California",32,28,4
1000000US060952525012023,060952525012023,"Block 2023, Block Group 2, Census Tract 2525.01, Solano County, California",13,11,2
1000000US060952525012024,060952525012024,"Block 2024, Block Group 2, Census Tract 2525.01, Solano County, California",0,0,0
1000000US060952525021000,060952525021000,"Block 1000, Block Group 1, Census Tract 2525.02, Solano County, California",15,12,3
1000000US060952525021001,060952525021001,"Block 1001, Block Group 1, Census Tract 2525.02, Solano County, California",0,0,0
1000000US060952525021002,060952525021002,"Block 1002, Block Group 1, Census Tract 2525.02, Solano County, California",3,2,1
1000000US060952525021003,060952525021003,"Block 1003, Block Group 1, Census Tract 2525.02, Solano County, California",5,5,0
1000000US060952525021004,060952525021004,"Block 1004, Block Group 1, Census Tract 2525.02, Solano County, California",14,14,0
1000000US060952525021005,060952525021005,"Block 1005, Block Group 1, Census Tract 2525.02, Solano County, California",22,12,10
1000000US060952525021006,060952525021006,"Block 1006, Block Group 1, Census Tract 2525.02, Solano County, California",12,8,4
1000000US060952525021007,060952525021007,"Block 1007, Block Group 1, Census Tract 2525.02, Solano County, California",0,0,0
1000000US060952525021008,060952525021008,"Block 1008, Block Group 1, Census Tract 2525.02, Solano County, California",3,3,0
1000000US060952525021009,060952525021009,"Block 1009, Block Group 1, Census Tract 2525.02, Solano County, California",0,0,0
1000000US060952525021010,060952525021010,"Block 1010, Block Group 1, Census Tract 2525.02, Solano County, California",9,8,1
1000000US060952525021011,060952525021011,"Block 1011, Block Group 1, Census Tract 2525.02, Solano County, California",4,4,0
1000000US060952525021012,060952525021012,"Block 1012, Block Group 1, Census Tract 2525.02, Solano County, California",2,2,0
1000000US060952525021013,060952525021013,"Block 1013, Block Group 1, Census Tract 2525.02, Solano County, California",0,0,0
1000000US060952525021014,060952525021014,"Block 1014, Block Group 1, Census Tract 2525.02, Solano County, California",0,0,0
1000000US060952525021015,060952525021015,"Block 1015, Block Group 1, Census Tract 2525.02, Solano County, California",0,0,0
1000000US060952525021016,060952525021016,"Block 1016, Block Group 1, Census Tract 2525.02, Solano County, California",0,0,0
1000000US060952525021017,060952525021017,"Block 1017, Block Group 1, Census Tract 2525.02, Solano County, California",0,0,0
1000000US060952525021018,060952525021018,"Block 1018, Block Group 1, Census Tract 2525.02, Solano County, California",11,9,2
1000000US060952525021019,060952525021019,"Block 1019, Block Group 1, Census Tract 2525.02, Solano County, California",0,0,0
1000000US060952525021020,060952525021020,"Block 1020, Block Group 1, Census Tract 2525.02, Solano County, California",0,0,0
1000000US060952525021021,060952525021021,"Block 1021, Block Group 1, Census Tract 2525.02, Solano County, California",0,0,0
1000000US060952525021022,060952525021022,"Block 1022, Block Group 1, Census Tract 2525.02, Solano County, California",0,0,0
1000000US060952525021023,060952525021023,"Block 1023, Block Group 1, Census Tract 2525.02, Solano County, California",0,0,0
1000000US060952525021024,060952525021024,"Block 1024, Block Group 1, Census Tract 2525.02, Solano County, California",0,0,0
1000000US060952525021025,060952525021025,"Block 1025, Block Group 1, Census Tract 2525.02, Solano County, California",0,0,0
1000000US060952525021026,060952525021026,"Block 1026, Block Group 1, Census Tract 2525.02, Solano County, California",1,1,0
1000000US060952525021027,060952525021027,"Block 1027, Block Group 1, Census Tract 2525.02, Solano County, California",5,2,3
1000000US060952525021028,060952525021028,"Block 1028, Block Group 1, Census Tract 2525.02, Solano County, California",0,0,0
1000000US060952525021029,060952525021029,"Block 1029, Block Group 1, Census Tract 2525.02, Solano County, California",4,1,3
1000000US060952525021030,060952525021030,"Block 1030, Block Group 1, Census Tract 2525.02, Solano County, California",1,1,0
1000000US060952525021031,060952525021031,"Block 1031, Block Group 1, Census Tract 2525.02, Solano County, California",1,1,0
1000000US060952525021032,060952525021032,"Block 1032, Block Group 1, Census Tract 2525.02, Solano County, California",24,22,2
1000000US060952525021033,060952525021033,"Block 1033, Block Group 1, Census Tract 2525.02, Solano County, California",21,19,2
1000000US060952525021034,060952525021034,"Block 1034, Block Group 1, Census Tract 2525.02, Solano County, California",19,15,4
1000000US060952525021035,060952525021035,"Block 1035, Block Group 1, Census Tract 2525.02, Solano County, California",4,4,0
1000000US060952525021036,060952525021036,"Block 1036, Block Group 1, Census Tract 2525.02, Solano County, California",18,18,0
1000000US060952525021037,060952525021037,"Block 1037, Block Group 1, Census Tract 2525.02, Solano County, California",3,3,0
1000000US060952525021038,060952525021038,"Block 1038, Block Group 1, Census Tract 2525.02, Solano County, California",5,5,0
1000000US060952525021039,060952525021039,"Block 1039, Block Group 1, Census Tract 2525.02, Solano County, California",8,7,1
1000000US060952525021040,060952525021040,"Block 1040, Block Group 1, Census Tract 2525.02, Solano County, California",0,0,0
1000000US060952525021041,060952525021041,"Block 1041, Block Group 1, Census Tract 2525.02, Solano County, California",6,6,0
1000000US060952525021042,060952525021042,"Block 1042, Block Group 1, Census Tract 2525.02, Solano County, California",13,11,2
1000000US060952525021043,060952525021043,"Block 1043, Block Group 1, Census Tract 2525.02, Solano County, California",0,0,0
1000000US060952525021044,060952525021044,"Block 1044, Block Group 1, Census Tract 2525.02, Solano County, California",21,18,3
1000000US060952525021045,060952525021045,"Block 1045, Block Group 1, Census Tract 2525.02, Solano County, California",8,7,1
1000000US060952525021046,060952525021046,"Block 1046, Block Group 1, Census Tract 2525.02, Solano County, California",5,4,1
1000000US060952525021047,060952525021047,"Block 1047, Block Group 1, Census Tract 2525.02, Solano County, California",15,14,1
1000000US060952525021048,060952525021048,"Block 1048, Block Group 1, Census Tract 2525.02, Solano County, California",15,15,0
1000000US060952525021049,060952525021049,"Block 1049, Block Group 1, Census Tract 2525.02, Solano County, California",0,0,0
1000000US060952525021050,060952525021050,"Block 1050, Block Group 1, Census Tract 2525.02, Solano County, California",16,15,1
1000000US060952525021051,060952525021051,"Block 1051, Block Group 1, Census Tract 2525.02, Solano County, California",4,2,2
1000000US060952525021052,060952525021052,"Block 1052, Block Group 1, Census Tract 2525.02, Solano County, California",6,5,1
1000000US060952525021053,060952525021053,"Block 1053, Block Group 1, Census Tract 2525.02, Solano County, California",3,3,0
1000000US060952525021054,060952525021054,"Block 1054, Block Group 1, Census Tract 2525.02, Solano County, California",9,6,3
1000000US060952525021055,060952525021055,"Block 1055, Block Group 1, Census Tract 2525.02, Solano County, California",21,15,6
1000000US060952525022000,060952525022000,"Block 2000, Block Group 2, Census Tract 2525.02, Solano County, California",0,0,0
1000000US060952525022001,060952525022001,"Block 2001, Block Group 2, Census Tract 2525.02, Solano County, California",0,0,0
1000000US060952525022002,060952525022002,"Block 2002, Block Group 2, Census Tract 2525.02, Solano County, California",0,0,0
1000000US060952525022003,060952525022003,"Block 2003, Block Group 2, Census Tract 2525.02, Solano County, California",0,0,0
1000000US060952525022004,060952525022004,"Block 2004, Block Group 2, Census Tract 2525.02, Solano County, California",0,0,0
1000000US060952525022005,060952525022005,"Block 2005, Block Group 2, Census Tract 2525.02, Solano County, California",9,8,1
1000000US060952525022006,060952525022006,"Block 2006, Block Group 2, Census Tract 2525.02, Solano County, California",19,17,2
1000000US060952525022007,060952525022007,"Block 2007, Block Group 2, Census Tract 2525.02, Solano County, California",16,15,1
1000000US060952525022008,060952525022008,"Block 2008, Block Group 2, Census Tract 2525.02, Solano County, California",36,34,2
1000000US060952525022009,060952525022009,"Block 2009, Block Group 2, Census Tract 2525.02, Solano County, California",15,15,0
1000000US060952525022010,060952525022010,"Block 2010, Block Group 2, Census Tract 2525.02, Solano County, California",18,18,0
1000000US060952525022011,060952525022011,"Block 2011, Block Group 2, Census Tract 2525.02, Solano County, California",12,11,1
1000000US060952525022012,060952525022012,"Block 2012, Block Group 2, Census Tract 2525.02, Solano County, California",9,8,1
1000000US060952525022013,060952525022013,"Block 2013, Block Group 2, Census Tract 2525.02, Solano County, California",13,12,1
1000000US060952525022014,060952525022014,"Block 2014, Block Group 2, Census Tract 2525.02, Solano County, California",18,17,1
1000000US060952525022015,060952525022015,"Block 2015, Block Group 2, Census Tract 2525.02, Solano County, California",20,18,2
1000000US060952525022016,060952525022016,"Block 2016, Block Group 2, Census Tract 2525.02, Solano County, California",23,22,1
1000000US060952525022017,060952525022017,"Block 2017, Block Group 2, Census Tract 2525.02, Solano County, California",32,29,3
1000000US060952525022018,060952525022018,"Block 2018, Block Group 2, Census Tract 2525.02, Solano County, California",2,2,0
1000000US060952525022019,060952525022019,"Block 2019, Block Group 2, Census Tract 2525.02, Solano County, California",0,0,0
1000000US060952525022020,060952525022020,"Block 2020, Block Group 2, Census Tract 2525.02, Solano County, California",0,0,0
1000000US060952525022021,060952525022021,"Block 2021, Block Group 2, Census Tract 2525.02, Solano County, California",0,0,0
1000000US060952525022022,060952525022022,"Block 2022, Block Group 2, Census Tract 2525.02, Solano County, California",0,0,0
1000000US060952525022023,060952525022023,"Block 2023, Block Group 2, Census Tract 2525.02, Solano County, California",0,0,0
1000000US060952525022024,060952525022024,"Block 2024, Block Group 2, Census Tract 2525.02, Solano County, California",0,0,0
1000000US060952525022025,060952525022025,"Block 2025, Block Group 2, Census Tract 2525.02, Solano County, California",0,0,0
1000000US060952525022026,060952525022026,"Block 2026, Block Group 2, Census Tract 2525.02, Solano County, California",21,18,3
1000000US060952525022027,060952525022027,"Block 2027, Block Group 2, Census Tract 2525.02, Solano County, California",17,17,0
1000000US060952525022028,060952525022028,"Block 2028, Block Group 2, Census Tract 2525.02, Solano County, California",14,13,1
1000000US060952525022029,060952525022029,"Block 2029, Block Group 2, Census Tract 2525.02, Solano County, California",0,0,0
1000000US060952525022030,060952525022030,"Block 2030, Block Group 2, Census Tract 2525.02, Solano County, California",0,0,0
1000000US060952525022031,060952525022031,"Block 2031, Block Group 2, Census Tract 2525.02, Solano County, California",0,0,0
1000000US060952526041000,060952526041000,"Block 1000, Block Group 1, Census Tract 2526.04, Solano County, California",0,0,0
1000000US060952526041001,060952526041001,"Block 1001, Block Group 1, Census Tract 2526.04, Solano County, California",119,112,7
1000000US060952526041002,060952526041002,"Block 1002, Block Group 1, Census Tract 2526.04, Solano County, California",25,20,5
1000000US060952526041003,060952526041003,"Block 1003, Block Group 1, Census Tract 2526.04, Solano County, California",0,0,0
1000000US060952526041004,060952526041004,"Block 1004, Block Group 1, Census Tract 2526.04, Solano County, California",83,79,4
1000000US060952526041005,060952526041005,"Block 1005, Block Group 1, Census Tract 2526.04, Solano County, California",21,20,1
1000000US060952526041006,060952526041006,"Block 1006, Block Group 1, Census Tract 2526.04, Solano County, California",0,0,0
1000000US060952526041007,060952526041007,"Block 1007, Block Group 1, Census Tract 2526.04, Solano County, California",39,36,3
1000000US060952526041008,060952526041008,"Block 1008, Block Group 1, Census Tract 2526.04, Solano County, California",27,27,0
1000000US060952526041009,060952526041009,"Block 1009, Block Group 1, Census Tract 2526.04, Solano County, California",0,0,0
1000000US060952526041010,060952526041010,"Block 1010, Block Group 1, Census Tract 2526.04, Solano County, California",0,0,0
1000000US060952526041011,060952526041011,"Block 1011, Block Group 1, Census Tract 2526.04, Solano County, California",29,26,3
1000000US060952526041012,060952526041012,"Block 1012, Block Group 1, Census Tract 2526.04, Solano County, California",0,0,0
1000000US060952526041013,060952526041013,"Block 1013, Block Group 1, Census Tract 2526.04, Solano County, California",0,0,0
1000000US060952526041014,060952526041014,"Block 1014, Block Group 1, Census Tract 2526.04, Solano County, California",0,0,0
1000000US060952526041015,060952526041015,"Block 1015, Block Group 1, Census Tract 2526.04, Solano County, California",0,0,0
1000000US060952526041016,060952526041016,"Block 1016, Block Group 1, Census Tract 2526.04, Solano County, California",0,0,0
1000000US060952526041017,060952526041017,"Block 1017, Block Group 1, Census Tract 2526.04, Solano County, California",0,0,0
1000000US060952526041018,060952526041018,"Block 1018, Block Group 1, Census Tract 2526.04, Solano County, California",0,0,0
1000000US060952526041019,060952526041019,"Block 1019, Block Group 1, Census Tract 2526.04, Solano County, California",0,0,0
1000000US060952526041020,060952526041020,"Block 1020, Block Group 1, Census Tract 2526.04, Solano County, California",0,0,0
1000000US060952526041021,060952526041021,"Block 1021, Block Group 1, Census Tract 2526.04, Solano County, California",0,0,0
1000000US060952526041022,060952526041022,"Block 1022, Block Group 1, Census Tract 2526.04, Solano County, California",0,0,0
1000000US060952526041023,060952526041023,"Block 1023, Block Group 1, Census Tract 2526.04, Solano County, California",0,0,0
1000000US060952526041024,060952526041024,"Block 1024, Block Group 1, Census Tract 2526.04, Solano County, California",0,0,0
1000000US060952526041025,060952526041025,"Block 1025, Block Group 1, Census Tract 2526.04, Solano County, California",0,0,0
1000000US060952526041026,060952526041026,"Block 1026, Block Group 1, Census Tract 2526.04, Solano County, California",0,0,0
1000000US060952526041027,060952526041027,"Block 1027, Block Group 1, Census Tract 2526.04, Solano County, California",0,0,0
1000000US060952526041028,060952526041028,"Block 1028, Block Group 1, Census Tract 2526.04, Solano County, California",0,0,0
1000000US060952526041029,060952526041029,"Block 1029, Block Group 1, Census Tract 2526.04, Solano County, California",0,0,0
1000000US060952526041030,060952526041030,"Block 1030, Block Group 1, Census Tract 2526.04, Solano County, California",0,0,0
1000000US060952526041031,060952526041031,"Block 1031, Block Group 1, Census Tract 2526.04, Solano County, California",0,0,0
1000000US060952526041032,060952526041032,"Block 1032, Block Group 1, Census Tract 2526.04, Solano County, California",0,0,0
1000000US060952526041033,060952526041033,"Block 1033, Block Group 1, Census Tract 2526.04, Solano County, California",0,0,0
1000000US060952526042000,060952526042000,"Block 2000, Block Group 2, Census Tract 2526.04, Solano County, California",265,247,18
1000000US060952526042001,060952526042001,"Block 2001, Block Group 2, Census Tract 2526.04, Solano County, California",30,28,2
1000000US060952526042002,060952526042002,"Block 2002, Block Group 2, Census Tract 2526.04, Solano County, California",25,22,3
1000000US060952526042003,060952526042003,"Block 2003, Block Group 2, Census Tract 2526.04, Solano County, California",32,29,3
1000000US060952526042004,060952526042004,"Block 2004, Block Group 2, Census Tract 2526.04, Solano County, California",1,1,0
1000000US060952526042005,060952526042005,"Block 2005, Block Group 2, Census Tract 2526.04, Solano County, California",0,0,0
1000000US060952526042006,060952526042006,"Block 2006, Block Group 2, Census Tract 2526.04, Solano County, California",89,74,15
1000000US060952526042007,060952526042007,"Block 2007, Block Group 2, Census Tract 2526.04, Solano County, California",38,25,13
1000000US060952526042008,060952526042008,"Block 2008, Block Group 2, Census Tract 2526.04, Solano County, California",34,33,1
1000000US060952526042009,060952526042009,"Block 2009, Block Group 2, Census Tract 2526.04, Solano County, California",29,23,6
1000000US060952526042010,060952526042010,"Block 2010, Block Group 2, Census Tract 2526.04, Solano County, California",30,30,0
1000000US060952526043000,060952526043000,"Block 3000, Block Group 3, Census Tract 2526.04, Solano County, California",12,12,0
1000000US060952526043001,060952526043001,"Block 3001, Block Group 3, Census Tract 2526.04, Solano County, California",14,13,1
1000000US060952526043002,060952526043002,"Block 3002, Block Group 3, Census Tract 2526.04, Solano County, California",33,33,0
1000000US060952526043003,060952526043003,"Block 3003, Block Group 3, Census Tract 2526.04, Solano County, California",46,27,19
1000000US060952526043004,060952526043004,"Block 3004, Block Group 3, Census Tract 2526.04, Solano County, California",38,33,5
1000000US060952526043005,060952526043005,"Block 3005, Block Group 3, Census Tract 2526.04, Solano County, California",10,10,0
1000000US060952526043006,060952526043006,"Block 3006, Block Group 3, Census Tract 2526.04, Solano County, California",0,0,0
1000000US060952526043007,060952526043007,"Block 3007, Block Group 3, Census Tract 2526.04, Solano County, California",0,0,0
1000000US060952526043008,060952526043008,"Block 3008, Block Group 3, Census Tract 2526.04, Solano County, California",14,14,0
1000000US060952526043009,060952526043009,"Block 3009, Block Group 3, Census Tract 2526.04, Solano County, California",84,81,3
1000000US060952526043010,060952526043010,"Block 3010, Block Group 3, Census Tract 2526.04, Solano County, California",75,67,8
1000000US060952526043011,060952526043011,"Block 3011, Block Group 3, Census Tract 2526.04, Solano County, California",26,25,1
1000000US060952526043012,060952526043012,"Block 3012, Block Group 3, Census Tract 2526.04, Solano County, California",6,6,0
1000000US060952526051000,060952526051000,"Block 1000, Block Group 1, Census Tract 2526.05, Solano County, California",0,0,0
1000000US060952526051001,060952526051001,"Block 1001, Block Group 1, Census Tract 2526.05, Solano County, California",0,0,0
1000000US060952526051002,060952526051002,"Block 1002, Block Group 1, Census Tract 2526.05, Solano County, California",110,108,2
1000000US060952526051003,060952526051003,"Block 1003, Block Group 1, Census Tract 2526.05, Solano County, California",0,0,0
1000000US060952526051004,060952526051004,"Block 1004, Block Group 1, Census Tract 2526.05, Solano County, California",67,57,10
1000000US060952526051005,060952526051005,"Block 1005, Block Group 1, Census Tract 2526.05, Solano County, California",0,0,0
1000000US060952526051006,060952526051006,"Block 1006, Block Group 1, Census Tract 2526.05, Solano County, California",107,98,9
1000000US060952526051007,060952526051007,"Block 1007, Block Group 1, Census Tract 2526.05, Solano County, California",104,95,9
1000000US060952526051008,060952526051008,"Block 1008, Block Group 1, Census Tract 2526.05, Solano County, California",246,229,17
1000000US060952526051009,060952526051009,"Block 1009, Block Group 1, Census Tract 2526.05, Solano County, California",76,74,2
1000000US060952526051010,060952526051010,"Block 1010, Block Group 1, Census Tract 2526.05, Solano County, California",0,0,0
1000000US060952526051011,060952526051011,"Block 1011, Block Group 1, Census Tract 2526.05, Solano County, California",116,104,12
1000000US060952526051012,060952526051012,"Block 1012, Block Group 1, Census Tract 2526.05, Solano County, California",46,44,2
1000000US060952526051013,060952526051013,"Block 1013, Block Group 1, Census Tract 2526.05, Solano County, California",43,42,1
1000000US060952526051014,060952526051014,"Block 1014, Block Group 1, Census Tract 2526.05, Solano County, California",20,20,0
1000000US060952526051015,060952526051015,"Block 1015, Block Group 1, Census Tract 2526.05, Solano County, California",56,53,3
1000000US060952526052000,060952526052000,"Block 2000, Block Group 2, Census Tract 2526.05, Solano County, California",160,130,30
1000000US060952526052001,060952526052001,"Block 2001, Block Group 2, Census Tract 2526.05, Solano County, California",105,98,7
1000000US060952526052002,060952526052002,"Block 2002, Block Group 2, Census Tract 2526.05, Solano County, California",21,19,2
1000000US060952526052003,060952526052003,"Block 2003, Block Group 2, Census Tract 2526.05, Solano County, California",20,19,1
1000000US060952526052004,060952526052004,"Block 2004, Block Group 2, Census Tract 2526.05, Solano County, California",38,34,4
1000000US060952526052005,060952526052005,"Block 2005, Block Group 2, Census Tract 2526.05, Solano County, California",76,69,7
1000000US060952526052006,060952526052006,"Block 2006, Block Group 2, Census Tract 2526.05, Solano County, California",20,18,2
1000000US060952526052007,060952526052007,"Block 2007, Block Group 2, Census Tract 2526.05, Solano County, California",28,24,4
1000000US060952526052008,060952526052008,"Block 2008, Block Group 2, Census Tract 2526.05, Solano County, California",103,99,4
1000000US060952526052009,060952526052009,"Block 2009, Block Group 2, Census Tract 2526.05, Solano County, California",0,0,0
1000000US060952526052010,060952526052010,"Block 2010, Block Group 2, Census Tract 2526.05, Solano County, California",0,0,0
1000000US060952526052011,060952526052011,"Block 2011, Block Group 2, Census Tract 2526.05, Solano County, California",0,0,0
1000000US060952526052012,060952526052012,"Block 2012, Block Group 2, Census Tract 2526.05, Solano County, California",0,0,0
1000000US060952526053000,060952526053000,"Block 3000, Block Group 3, Census Tract 2526.05, Solano County, California",17,15,2
1000000US060952526053001,060952526053001,"Block 3001, Block Group 3, Census Tract 2526.05, Solano County, California",9,9,0
1000000US060952526053002,060952526053002,"Block 3002, Block Group 3, Census Tract 2526.05, Solano County, California",27,24,3
1000000US060952526053003,060952526053003,"Block 3003, Block Group 3, Census Tract 2526.05, Solano County, California",63,60,3
1000000US060952526053004,060952526053004,"Block 3004, Block Group 3, Census Tract 2526.05, Solano County, California",31,31,0
1000000US060952526053005,060952526053005,"Block 3005, Block Group 3, Census Tract 2526.05, Solano County, California",45,40,5
1000000US060952526053006,060952526053006,"Block 3006, Block Group 3, Census Tract 2526.05, Solano County, California",53,47,6
1000000US060952526053007,060952526053007,"Block 3007, Block Group 3, Census Tract 2526.05, Solano County, California",23,22,1
1000000US060952526053008,060952526053008,"Block 3008, Block Group 3, Census Tract 2526.05, Solano County, California",14,14,0
1000000US060952526053009,060952526053009,"Block 3009, Block Group 3, Census Tract 2526.05, Solano County, California",70,69,1
1000000US060952526053010,060952526053010,"Block 3010, Block Group 3, Census Tract 2526.05, Solano County, California",0,0,0
1000000US060952526053011,060952526053011,"Block 3011, Block Group 3, Census Tract 2526.05, Solano County, California",0,0,0
1000000US060952526053012,060952526053012,"Block 3012, Block Group 3, Census Tract 2526.05, Solano County, California",0,0,0
1000000US060952526053013,060952526053013,"Block 3013, Block Group 3, Census Tract 2526.05, Solano County, California",0,0,0
1000000US060952526053014,060952526053014,"Block 3014, Block Group 3, Census Tract 2526.05, Solano County, California",0,0,0
1000000US060952526053015,060952526053015,"Block 3015, Block Group 3, Census Tract 2526.05, Solano County, California",0,0,0
1000000US060952526053016,060952526053016,"Block 3016, Block Group 3, Census Tract 2526.05, Solano County, California",0,0,0
1000000US060952526053017,060952526053017,"Block 3017, Block Group 3, Census Tract 2526.05, Solano County, California",64,60,4
1000000US060952526053018,060952526053018,"Block 3018, Block Group 3, Census Tract 2526.05, Solano County, California",0,0,0
1000000US060952526061000,060952526061000,"Block 1000, Block Group 1, Census Tract 2526.06, Solano County, California",28,26,2
1000000US060952526061001,060952526061001,"Block 1001, Block Group 1, Census Tract 2526.06, Solano County, California",21,20,1
1000000US060952526061002,060952526061002,"Block 1002, Block Group 1, Census Tract 2526.06, Solano County, California",0,0,0
1000000US060952526061003,060952526061003,"Block 1003, Block Group 1, Census Tract 2526.06, Solano County, California",140,127,13
1000000US060952526061004,060952526061004,"Block 1004, Block Group 1, Census Tract 2526.06, Solano County, California",52,48,4
1000000US060952526061005,060952526061005,"Block 1005, Block Group 1, Census Tract 2526.06, Solano County, California",19,15,4
1000000US060952526061006,060952526061006,"Block 1006, Block Group 1, Census Tract 2526.06, Solano County, California",45,41,4
1000000US060952526061007,060952526061007,"Block 1007, Block Group 1, Census Tract 2526.06, Solano County, California",276,270,6
1000000US060952526061008,060952526061008,"Block 1008, Block Group 1, Census Tract 2526.06, Solano County, California",120,109,11
1000000US060952526061009,060952526061009,"Block 1009, Block Group 1, Census Tract 2526.06, Solano County, California",16,15,1
1000000US060952526061010,060952526061010,"Block 1010, Block Group 1, Census Tract 2526.06, Solano County, California",14,12,2
1000000US060952526061011,060952526061011,"Block 1011, Block Group 1, Census Tract 2526.06, Solano County, California",22,22,0
1000000US060952526061012,060952526061012,"Block 1012, Block Group 1, Census Tract 2526.06, Solano County, California",17,14,3
1000000US060952526062000,060952526062000,"Block 2000, Block Group 2, Census Tract 2526.06, Solano County, California",459,392,67
1000000US060952526062001,060952526062001,"Block 2001, Block Group 2, Census Tract 2526.06, Solano County, California",3,3,0
1000000US060952526062002,060952526062002,"Block 2002, Block Group 2, Census Tract 2526.06, Solano County, California",62,54,8
1000000US060952526062003,060952526062003,"Block 2003, Block Group 2, Census Tract 2526.06, Solano County, California",0,0,0
1000000US060952526062004,060952526062004,"Block 2004, Block Group 2, Census Tract 2526.06, Solano County, California",0,0,0
1000000US060952526062005,060952526062005,"Block 2005, Block Group 2, Census Tract 2526.06, Solano County, California",0,0,0
1000000US060952526063000,060952526063000,"Block 3000, Block Group 3, Census Tract 2526.06, Solano County, California",116,113,3
1000000US060952526063001,060952526063001,"Block 3001, Block Group 3, Census Tract 2526.06, Solano County, California",24,22,2
1000000US060952526063002,060952526063002,"Block 3002, Block Group 3, Census Tract 2526.06, Solano County, California",24,24,0
1000000US060952526063003,060952526063003,"Block 3003, Block Group 3, Census Tract 2526.06, Solano County, California",22,19,3
1000000US060952526063004,060952526063004,"Block 3004, Block Group 3, Census Tract 2526.06, Solano County, California",109,99,10
1000000US060952526063005,060952526063005,"Block 3005, Block Group 3, Census Tract 2526.06, Solano County, California",19,14,5
1000000US060952526063006,060952526063006,"Block 3006, Block Group 3, Census Tract 2526.06, Solano County, California",39,38,1
1000000US060952526063007,060952526063007,"Block 3007, Block Group 3, Census Tract 2526.06, Solano County, California",36,34,2
1000000US060952526063008,060952526063008,"Block 3008, Block Group 3, Census Tract 2526.06, Solano County, California",67,56,11
1000000US060952526063009,060952526063009,"Block 3009, Block Group 3, Census Tract 2526.06, Solano County, California",0,0,0
1000000US060952526063010,060952526063010,"Block 3010, Block Group 3, Census Tract 2526.06, Solano County, California",30,29,1
1000000US060952526063011,060952526063011,"Block 3011, Block Group 3, Census Tract 2526.06, Solano County, California",21,21,0
1000000US060952526063012,060952526063012,"Block 3012, Block Group 3, Census Tract 2526.06, Solano County, California",21,19,2
1000000US060952526063013,060952526063013,"Block 3013, Block Group 3, Census Tract 2526.06, Solano County, California",0,0,0
1000000US060952526071000,060952526071000,"Block 1000, Block Group 1, Census Tract 2526.07, Solano County, California",146,136,10
1000000US060952526071001,060952526071001,"Block 1001, Block Group 1, Census Tract 2526.07, Solano County, California",27,25,2
1000000US060952526071002,060952526071002,"Block 1002, Block Group 1, Census Tract 2526.07, Solano County, California",33,32,1
1000000US060952526071003,060952526071003,"Block 1003, Block Group 1, Census Tract 2526.07, Solano County, California",25,22,3
1000000US060952526071004,060952526071004,"Block 1004, Block Group 1, Census Tract 2526.07, Solano County, California",38,34,4
1000000US060952526071005,060952526071005,"Block 1005, Block Group 1, Census Tract 2526.07, Solano County, California",40,40,0
1000000US060952526071006,060952526071006,"Block 1006, Block Group 1, Census Tract 2526.07, Solano County, California",12,12,0
1000000US060952526071007,060952526071007,"Block 1007, Block Group 1, Census Tract 2526.07, Solano County, California",26,24,2
1000000US060952526071008,060952526071008,"Block 1008, Block Group 1, Census Tract 2526.07, Solano County, California",36,34,2
1000000US060952526071009,060952526071009,"Block 1009, Block Group 1, Census Tract 2526.07, Solano County, California",31,30,1
1000000US060952526071010,060952526071010,"Block 1010, Block Group 1, Census Tract 2526.07, Solano County, California",18,17,1
1000000US060952526072000,060952526072000,"Block 2000, Block Group 2, Census Tract 2526.07, Solano County, California",500,458,42
1000000US060952526072001,060952526072001,"Block 2001, Block Group 2, Census Tract 2526.07, Solano County, California",23,22,1
1000000US060952526072002,060952526072002,"Block 2002, Block Group 2, Census Tract 2526.07, Solano County, California",0,0,0
1000000US060952526072003,060952526072003,"Block 2003, Block Group 2, Census Tract 2526.07, Solano County, California",23,21,2
1000000US060952526072004,060952526072004,"Block 2004, Block Group 2, Census Tract 2526.07, Solano County, California",17,15,2
1000000US060952526072005,060952526072005,"Block 2005, Block Group 2, Census Tract 2526.07, Solano County, California",7,6,1
1000000US060952526072006,060952526072006,"Block 2006, Block Group 2, Census Tract 2526.07, Solano County, California",100,92,8
1000000US060952526072007,060952526072007,"Block 2007, Block Group 2, Census Tract 2526.07, Solano County, California",1,1,0
1000000US060952526072008,060952526072008,"Block 2008, Block Group 2, Census Tract 2526.07, Solano County, California",49,46,3
1000000US060952526072009,060952526072009,"Block 2009, Block Group 2, Census Tract 2526.07, Solano County, California",12,12,0
1000000US060952526072010,060952526072010,"Block 2010, Block Group 2, Census Tract 2526.07, Solano County, California",12,12,0
1000000US060952526072011,060952526072011,"Block 2011, Block Group 2, Census Tract 2526.07, Solano County, California",13,11,2
1000000US060952526072012,060952526072012,"Block 2012, Block Group 2, Census Tract 2526.07, Solano County, California",13,10,3
1000000US060952526072013,060952526072013,"Block 2013, Block Group 2, Census Tract 2526.07, Solano County, California",13,13,0
1000000US060952526072014,060952526072014,"Block 2014, Block Group 2, Census Tract 2526.07, Solano County, California",0,0,0
1000000US060952526072015,060952526072015,"Block 2015, Block Group 2, Census Tract 2526.07, Solano County, California",0,0,0
1000000US060952526072016,060952526072016,"Block 2016, Block Group 2, Census Tract 2526.07, Solano County, California",0,0,0
1000000US060952526072017,060952526072017,"Block 2017, Block Group 2, Census Tract 2526.07, Solano County, California",0,0,0
1000000US060952526072018,060952526072018,"Block 2018, Block Group 2, Census Tract 2526.07, Solano County, California",0,0,0
1000000US060952526081000,060952526081000,"Block 1000, Block Group 1, Census Tract 2526.08, Solano County, California",43,41,2
1000000US060952526081001,060952526081001,"Block 1001, Block Group 1, Census Tract 2526.08, Solano County, California",34,30,4
1000000US060952526081002,060952526081002,"Block 1002, Block Group 1, Census Tract 2526.08, Solano County, California",42,32,10
1000000US060952526081003,060952526081003,"Block 1003, Block Group 1, Census Tract 2526.08, Solano County, California",24,23,1
1000000US060952526081004,060952526081004,"Block 1004, Block Group 1, Census Tract 2526.08, Solano County, California",24,18,6
1000000US060952526081005,060952526081005,"Block 1005, Block Group 1, Census Tract 2526.08, Solano County, California",54,49,5
1000000US060952526081006,060952526081006,"Block 1006, Block Group 1, Census Tract 2526.08, Solano County, California",8,8,0
1000000US060952526081007,060952526081007,"Block 1007, Block Group 1, Census Tract 2526.08, Solano County, California",38,32,6
1000000US060952526081008,060952526081008,"Block 1008, Block Group 1, Census Tract 2526.08, Solano County, California",16,10,6
1000000US060952526081009,060952526081009,"Block 1009, Block Group 1, Census Tract 2526.08, Solano County, California",51,49,2
1000000US060952526081010,060952526081010,"Block 1010, Block Group 1, Census Tract 2526.08, Solano County, California",22,21,1
1000000US060952526081011,060952526081011,"Block 1011, Block Group 1, Census Tract 2526.08, Solano County, California",68,59,9
1000000US060952526082000,060952526082000,"Block 2000, Block Group 2, Census Tract 2526.08, Solano County, California",39,37,2
1000000US060952526082001,060952526082001,"Block 2001, Block Group 2, Census Tract 2526.08, Solano County, California",38,37,1
1000000US060952526082002,060952526082002,"Block 2002, Block Group 2, Census Tract 2526.08, Solano County, California",37,35,2
1000000US060952526082003,060952526082003,"Block 2003, Block Group 2, Census Tract 2526.08, Solano County, California",32,29,3
1000000US060952526082004,060952526082004,"Block 2004, Block Group 2, Census Tract 2526.08, Solano County, California",28,28,0
1000000US060952526082005,060952526082005,"Block 2005, Block Group 2, Census Tract 2526.08, Solano County, California",32,30,2
1000000US060952526082006,060952526082006,"Block 2006, Block Group 2, Census Tract 2526.08, Solano County, California",17,15,2
1000000US060952526082007,060952526082007,"Block 2007, Block Group 2, Census Tract 2526.08, Solano County, California",58,47,11
1000000US060952526082008,060952526082008,"Block 2008, Block Group 2, Census Tract 2526.08, Solano County, California",32,30,2
1000000US060952526082009,060952526082009,"Block 2009, Block Group 2, Census Tract 2526.08, Solano County, California",28,25,3
1000000US060952526082010,060952526082010,"Block 2010, Block Group 2, Census Tract 2526.08, Solano County, California",37,33,4
1000000US060952526082011,060952526082011,"Block 2011, Block Group 2, Census Tract 2526.08, Solano County, California",111,94,17
1000000US060952526082012,060952526082012,"Block 2012, Block Group 2, Census Tract 2526.08, Solano County, California",26,25,1
1000000US060952526082013,060952526082013,"Block 2013, Block Group 2, Census Tract 2526.08, Solano County, California",347,316,31
1000000US060952526082014,060952526082014,"Block 2014, Block Group 2, Census Tract 2526.08, Solano County, California",7,7,0
1000000US060952526082015,060952526082015,"Block 2015, Block Group 2, Census Tract 2526.08, Solano County, California",0,0,0
1000000US060952526082016,060952526082016,"Block 2016, Block Group 2, Census Tract 2526.08, Solano County, California",39,36,3
1000000US060952526082017,060952526082017,"Block 2017, Block Group 2, Census Tract 2526.08, Solano County, California",0,0,0
1000000US060952526101000,060952526101000,"Block 1000, Block Group 1, Census Tract 2526.10, Solano County, California",102,96,6
1000000US060952526101001,060952526101001,"Block 1001, Block Group 1, Census Tract 2526.10, Solano County, California",13,13,0
1000000US060952526101002,060952526101002,"Block 1002, Block Group 1, Census Tract 2526.10, Solano County, California",56,55,1
1000000US060952526101003,060952526101003,"Block 1003, Block Group 1, Census Tract 2526.10, Solano County, California",15,14,1
1000000US060952526101004,060952526101004,"Block 1004, Block Group 1, Census Tract 2526.10, Solano County, California",23,23,0
1000000US060952526101005,060952526101005,"Block 1005, Block Group 1, Census Tract 2526.10, Solano County, California",33,32,1
1000000US060952526101006,060952526101006,"Block 1006, Block Group 1, Census Tract 2526.10, Solano County, California",78,74,4
1000000US060952526101007,060952526101007,"Block 1007, Block Group 1, Census Tract 2526.10, Solano County, California",23,22,1
1000000US060952526101008,060952526101008,"Block 1008, Block Group 1, Census Tract 2526.10, Solano County, California",118,115,3
1000000US060952526101009,060952526101009,"Block 1009, Block Group 1, Census Tract 2526.10, Solano County, California",34,32,2
1000000US060952526101010,060952526101010,"Block 1010, Block Group 1, Census Tract 2526.10, Solano County, California",15,14,1
1000000US060952526101011,060952526101011,"Block 1011, Block Group 1, Census Tract 2526.10, Solano County, California",28,28,0
1000000US060952526102000,060952526102000,"Block 2000, Block Group 2, Census Tract 2526.10, Solano County, California",76,73,3
1000000US060952526102001,060952526102001,"Block 2001, Block Group 2, Census Tract 2526.10, Solano County, California",40,38,2
1000000US060952526102002,060952526102002,"Block 2002, Block Group 2, Census Tract 2526.10, Solano County, California",11,11,0
1000000US060952526102003,060952526102003,"Block 2003, Block Group 2, Census Tract 2526.10, Solano County, California",51,47,4
1000000US060952526102004,060952526102004,"Block 2004, Block Group 2, Census Tract 2526.10, Solano County, California",43,41,2
1000000US060952526102005,060952526102005,"Block 2005, Block Group 2, Census Tract 2526.10, Solano County, California",41,39,2
1000000US060952526102006,060952526102006,"Block 2006, Block Group 2, Census Tract 2526.10, Solano County, California",17,17,0
1000000US060952526102007,060952526102007,"Block 2007, Block Group 2, Census Tract 2526.10, Solano County, California",33,32,1
1000000US060952526102008,060952526102008,"Block 2008, Block Group 2, Census Tract 2526.10, Solano County, California",59,56,3
1000000US060952526102009,060952526102009,"Block 2009, Block Group 2, Census Tract 2526.10, Solano County, California",27,27,0
1000000US060952526102010,060952526102010,"Block 2010, Block Group 2, Census Tract 2526.10, Solano County, California",22,21,1
1000000US060952526102011,060952526102011,"Block 2011, Block Group 2, Census Tract 2526.10, Solano County, California",27,24,3
1000000US060952526102012,060952526102012,"Block 2012, Block Group 2, Census Tract 2526.10, Solano County, California",30,28,2
1000000US060952526102013,060952526102013,"Block 2013, Block Group 2, Census Tract 2526.10, Solano County, California",31,28,3
1000000US060952526102014,060952526102014,"Block 2014, Block Group 2, Census Tract 2526.10, Solano County, California",32,31,1
1000000US060952526111000,060952526111000,"Block 1000, Block Group 1, Census Tract 2526.11, Solano County, California",128,117,11
1000000US060952526111001,060952526111001,"Block 1001, Block Group 1, Census Tract 2526.11, Solano County, California",152,140,12
1000000US060952526111002,060952526111002,"Block 1002, Block Group 1, Census Tract 2526.11, Solano County, California",12,10,2
1000000US060952526111003,060952526111003,"Block 1003, Block Group 1, Census Tract 2526.11, Solano County, California",43,42,1
1000000US060952526111004,060952526111004,"Block 1004, Block Group 1, Census Tract 2526.11, Solano County, California",69,66,3
1000000US060952526111005,060952526111005,"Block 1005, Block Group 1, Census Tract 2526.11, Solano County, California",27,25,2
1000000US060952526111006,060952526111006,"Block 1006, Block Group 1, Census Tract 2526.11, Solano County, California",16,16,0
1000000US060952526112000,060952526112000,"Block 2000, Block Group 2, Census Tract 2526.11, Solano County, California",88,77,11
1000000US060952526112001,060952526112001,"Block 2001, Block Group 2, Census Tract 2526.11, Solano County, California",70,67,3
1000000US060952526112002,060952526112002,"Block 2002, Block Group 2, Census Tract 2526.11, Solano County, California",15,13,2
1000000US060952526112003,060952526112003,"Block 2003, Block Group 2, Census Tract 2526.11, Solano County, California",0,0,0
1000000US060952526112004,060952526112004,"Block 2004, Block Group 2, Census Tract 2526.11, Solano County, California",27,25,2
1000000US060952526112005,060952526112005,"Block 2005, Block Group 2, Census Tract 2526.11, Solano County, California",26,25,1
1000000US060952526112006,060952526112006,"Block 2006, Block Group 2, Census Tract 2526.11, Solano County, California",0,0,0
1000000US060952526112007,060952526112007,"Block 2007, Block Group 2, Census Tract 2526.11, Solano County, California",0,0,0
1000000US060952526112008,060952526112008,"Block 2008, Block Group 2, Census Tract 2526.11, Solano County, California",0,0,0
1000000US060952526112009,060952526112009,"Block 2009, Block Group 2, Census Tract 2526.11, Solano County, California",0,0,0
1000000US060952526112010,060952526112010,"Block 2010, Block Group 2, Census Tract 2526.11, Solano County, California",40,39,1
1000000US060952526112011,060952526112011,"Block 2011, Block Group 2, Census Tract 2526.11, Solano County, California",23,22,1
1000000US060952526112012,060952526112012,"Block 2012, Block Group 2, Census Tract 2526.11, Solano County, California",3,3,0
1000000US060952526112013,060952526112013,"Block 2013, Block Group 2, Census Tract 2526.11, Solano County, California",0,0,0
1000000US060952526113000,060952526113000,"Block 3000, Block Group 3, Census Tract 2526.11, Solano County, California",0,0,0
1000000US060952526113001,060952526113001,"Block 3001, Block Group 3, Census Tract 2526.11, Solano County, California",291,264,27
1000000US060952526113002,060952526113002,"Block 3002, Block Group 3, Census Tract 2526.11, Solano County, California",163,136,27
1000000US060952527021000,060952527021000,"Block 1000, Block Group 1, Census Tract 2527.02, Solano County, California",7,7,0
1000000US060952527021001,060952527021001,"Block 1001, Block Group 1, Census Tract 2527.02, Solano County, California",7,5,2
1000000US060952527021002,060952527021002,"Block 1002, Block Group 1, Census Tract 2527.02, Solano County, California",7,6,1
1000000US060952527021003,060952527021003,"Block 1003, Block Group 1, Census Tract 2527.02, Solano County, California",22,19,3
1000000US060952527021004,060952527021004,"Block 1004, Block Group 1, Census Tract 2527.02, Solano County, California",19,12,7
1000000US060952527021005,060952527021005,"Block 1005, Block Group 1, Census Tract 2527.02, Solano County, California",3,3,0
1000000US060952527021006,060952527021006,"Block 1006, Block Group 1, Census Tract 2527.02, Solano County, California",0,0,0
1000000US060952527021007,060952527021007,"Block 1007, Block Group 1, Census Tract 2527.02, Solano County, California",1,1,0
1000000US060952527021008,060952527021008,"Block 1008, Block Group 1, Census Tract 2527.02, Solano County, California",17,17,0
1000000US060952527021009,060952527021009,"Block 1009, Block Group 1, Census Tract 2527.02, Solano County, California",18,17,1
1000000US060952527021010,060952527021010,"Block 1010, Block Group 1, Census Tract 2527.02, Solano County, California",9,8,1
1000000US060952527021011,060952527021011,"Block 1011, Block Group 1, Census Tract 2527.02, Solano County, California",15,12,3
1000000US060952527021012,060952527021012,"Block 1012, Block Group 1, Census Tract 2527.02, Solano County, California",1,1,0
1000000US060952527021013,060952527021013,"Block 1013, Block Group 1, Census Tract 2527.02, Solano County, California",8,6,2
1000000US060952527021014,060952527021014,"Block 1014, Block Group 1, Census Tract 2527.02, Solano County, California",16,16,0
1000000US060952527021015,060952527021015,"Block 1015, Block Group 1, Census Tract 2527.02, Solano County, California",9,5,4
1000000US060952527021016,060952527021016,"Block 1016, Block Group 1, Census Tract 2527.02, Solano County, California",22,22,0
1000000US060952527021017,060952527021017,"Block 1017, Block Group 1, Census Tract 2527.02, Solano County, California",54,42,12
1000000US060952527021018,060952527021018,"Block 1018, Block Group 1, Census Tract 2527.02, Solano County, California",75,72,3
1000000US060952527021019,060952527021019,"Block 1019, Block Group 1, Census Tract 2527.02, Solano County, California",24,23,1
1000000US060952527021020,060952527021020,"Block 1020, Block Group 1, Census Tract 2527.02, Solano County, California",22,18,4
1000000US060952527021021,060952527021021,"Block 1021, Block Group 1, Census Tract 2527.02, Solano County, California",24,23,1
1000000US060952527021022,060952527021022,"Block 1022, Block Group 1, Census Tract 2527.02, Solano County, California",37,37,0
1000000US060952527021023,060952527021023,"Block 1023, Block Group 1, Census Tract 2527.02, Solano County, California",9,7,2
1000000US060952527021024,060952527021024,"Block 1024, Block Group 1, Census Tract 2527.02, Solano County, California",7,6,1
1000000US060952527021025,060952527021025,"Block 1025, Block Group 1, Census Tract 2527.02, Solano County, California",6,5,1
1000000US060952527021026,060952527021026,"Block 1026, Block Group 1, Census Tract 2527.02, Solano County, California",13,12,1
1000000US060952527021027,060952527021027,"Block 1027, Block Group 1, Census Tract 2527.02, Solano County, California",14,11,3
1000000US060952527021028,060952527021028,"Block 1028, Block Group 1, Census Tract 2527.02, Solano County, California",23,23,0
1000000US060952527021029,060952527021029,"Block 1029, Block Group 1, Census Tract 2527.02, Solano County, California",18,18,0
1000000US060952527021030,060952527021030,"Block 1030, Block Group 1, Census Tract 2527.02, Solano County, California",39,34,5
1000000US060952527021031,060952527021031,"Block 1031, Block Group 1, Census Tract 2527.02, Solano County, California",0,0,0
1000000US060952527021032,060952527021032,"Block 1032, Block Group 1, Census Tract 2527.02, Solano County, California",0,0,0
1000000US060952527021033,060952527021033,"Block 1033, Block Group 1, Census Tract 2527.02, Solano County, California",0,0,0
1000000US060952527021034,060952527021034,"Block 1034, Block Group 1, Census Tract 2527.02, Solano County, California",0,0,0
1000000US060952527022000,060952527022000,"Block 2000, Block Group 2, Census Tract 2527.02, Solano County, California",0,0,0
1000000US060952527022001,060952527022001,"Block 2001, Block Group 2, Census Tract 2527.02, Solano County, California",0,0,0
1000000US060952527022002,060952527022002,"Block 2002, Block Group 2, Census Tract 2527.02, Solano County, California",0,0,0
1000000US060952527022003,060952527022003,"Block 2003, Block Group 2, Census Tract 2527.02, Solano County, California",15,15,0
1000000US060952527022004,060952527022004,"Block 2004, Block Group 2, Census Tract 2527.02, Solano County, California",0,0,0
1000000US060952527022005,060952527022005,"Block 2005, Block Group 2, Census Tract 2527.02, Solano County, California",17,16,1
1000000US060952527022006,060952527022006,"Block 2006, Block Group 2, Census Tract 2527.02, Solano County, California",13,10,3
1000000US060952527022007,060952527022007,"Block 2007, Block Group 2, Census Tract 2527.02, Solano County, California",9,9,0
1000000US060952527022008,060952527022008,"Block 2008, Block Group 2, Census Tract 2527.02, Solano County, California",0,0,0
1000000US060952527022009,060952527022009,"Block 2009, Block Group 2, Census Tract 2527.02, Solano County, California",0,0,0
1000000US060952527022010,060952527022010,"Block 2010, Block Group 2, Census Tract 2527.02, Solano County, California",0,0,0
1000000US060952527022011,060952527022011,"Block 2011, Block Group 2, Census Tract 2527.02, Solano County, California",6,6,0
1000000US060952527022012,060952527022012,"Block 2012, Block Group 2, Census Tract 2527.02, Solano County, California",9,8,1
1000000US060952527022013,060952527022013,"Block 2013, Block Group 2, Census Tract 2527.02, Solano County, California",0,0,0
1000000US060952527022014,060952527022014,"Block 2014, Block Group 2, Census Tract 2527.02, Solano County, California",0,0,0
1000000US060952527022015,060952527022015,"Block 2015, Block Group 2, Census Tract 2527.02, Solano County, California",0,0,0
1000000US060952527022016,060952527022016,"Block 2016, Block Group 2, Census Tract 2527.02, Solano County, California",0,0,0
1000000US060952527022017,060952527022017,"Block 2017, Block Group 2, Census Tract 2527.02, Solano County, California",21,20,1
1000000US060952527022018,060952527022018,"Block 2018, Block Group 2, Census Tract 2527.02, Solano County, California",11,11,0
1000000US060952527022019,060952527022019,"Block 2019, Block Group 2, Census Tract 2527.02, Solano County, California",17,15,2
1000000US060952527022020,060952527022020,"Block 2020, Block Group 2, Census Tract 2527.02, Solano County, California",11,11,0
1000000US060952527022021,060952527022021,"Block 2021, Block Group 2, Census Tract 2527.02, Solano County, California",28,26,2
1000000US060952527022022,060952527022022,"Block 2022, Block Group 2, Census Tract 2527.02, Solano County, California",17,16,1
1000000US060952527022023,060952527022023,"Block 2023, Block Group 2, Census Tract 2527.02, Solano County, California",0,0,0
1000000US060952527022024,060952527022024,"Block 2024, Block Group 2, Census Tract 2527.02, Solano County, California",9,9,0
1000000US060952527022025,060952527022025,"Block 2025, Block Group 2, Census Tract 2527.02, Solano County, California",18,17,1
1000000US060952527022026,060952527022026,"Block 2026, Block Group 2, Census Tract 2527.02, Solano County, California",0,0,0
1000000US060952527022027,060952527022027,"Block 2027, Block Group 2, Census Tract 2527.02, Solano County, California",18,18,0
1000000US060952527022028,060952527022028,"Block 2028, Block Group 2, Census Tract 2527.02, Solano County, California",90,86,4
1000000US060952527022029,060952527022029,"Block 2029, Block Group 2, Census Tract 2527.02, Solano County, California",16,14,2
1000000US060952527022030,060952527022030,"Block 2030, Block Group 2, Census Tract 2527.02, Solano County, California",0,0,0
1000000US060952527022031,060952527022031,"Block 2031, Block Group 2, Census Tract 2527.02, Solano County, California",0,0,0
1000000US060952527022032,060952527022032,"Block 2032, Block Group 2, Census Tract 2527.02, Solano County, California",0,0,0
1000000US060952527022033,060952527022033,"Block 2033, Block Group 2, Census Tract 2527.02, Solano County, California",9,8,1
1000000US060952527022034,060952527022034,"Block 2034, Block Group 2, Census Tract 2527.02, Solano County, California",0,0,0
1000000US060952527023000,060952527023000,"Block 3000, Block Group 3, Census Tract 2527.02, Solano County, California",0,0,0
1000000US060952527023001,060952527023001,"Block 3001, Block Group 3, Census Tract 2527.02, Solano County, California",0,0,0
1000000US060952527023002,060952527023002,"Block 3002, Block Group 3, Census Tract 2527.02, Solano County, California",0,0,0
1000000US060952527023003,060952527023003,"Block 3003, Block Group 3, Census Tract 2527.02, Solano County, California",0,0,0
1000000US060952527023004,060952527023004,"Block 3004, Block Group 3, Census Tract 2527.02, Solano County, California",0,0,0
1000000US060952527023005,060952527023005,"Block 3005, Block Group 3, Census Tract 2527.02, Solano County, California",0,0,0
1000000US060952527023006,060952527023006,"Block 3006, Block Group 3, Census Tract 2527.02, Solano County, California",0,0,0
1000000US060952527023007,060952527023007,"Block 3007, Block Group 3, Census Tract 2527.02, Solano County, California",0,0,0
1000000US060952527023008,060952527023008,"Block 3008, Block Group 3, Census Tract 2527.02, Solano County, California",0,0,0
1000000US060952527023009,060952527023009,"Block 3009, Block Group 3, Census Tract 2527.02, Solano County, California",0,0,0
1000000US060952527023010,060952527023010,"Block 3010, Block Group 3, Census Tract 2527.02, Solano County, California",124,120,4
1000000US060952527023011,060952527023011,"Block 3011, Block Group 3, Census Tract 2527.02, Solano County, California",13,12,1
1000000US060952527023012,060952527023012,"Block 3012, Block Group 3, Census Tract 2527.02, Solano County, California",10,9,1
1000000US060952527023013,060952527023013,"Block 3013, Block Group 3, Census Tract 2527.02, Solano County, California",13,13,0
1000000US060952527023014,060952527023014,"Block 3014, Block Group 3, Census Tract 2527.02, Solano County, California",24,23,1
1000000US060952527023015,060952527023015,"Block 3015, Block Group 3, Census Tract 2527.02, Solano County, California",0,0,0
1000000US060952527023016,060952527023016,"Block 3016, Block Group 3, Census Tract 2527.02, Solano County, California",0,0,0
1000000US060952527023017,060952527023017,"Block 3017, Block Group 3, Census Tract 2527.02, Solano County, California",5,5,0
1000000US060952527023018,060952527023018,"Block 3018, Block Group 3, Census Tract 2527.02, Solano County, California",0,0,0
1000000US060952527023019,060952527023019,"Block 3019, Block Group 3, Census Tract 2527.02, Solano County, California",0,0,0
1000000US060952527023020,060952527023020,"Block 3020, Block Group 3, Census Tract 2527.02, Solano County, California",0,0,0
1000000US060952527023021,060952527023021,"Block 3021, Block Group 3, Census Tract 2527.02, Solano County, California",5,5,0
1000000US060952527023022,060952527023022,"Block 3022, Block Group 3, Census Tract 2527.02, Solano County, California",0,0,0
1000000US060952527023023,060952527023023,"Block 3023, Block Group 3, Census Tract 2527.02, Solano County, California",28,28,0
1000000US060952527023024,060952527023024,"Block 3024, Block Group 3, Census Tract 2527.02, Solano County, California",29,26,3
1000000US060952527023025,060952527023025,"Block 3025, Block Group 3, Census Tract 2527.02, Solano County, California",4,4,0
1000000US060952527023026,060952527023026,"Block 3026, Block Group 3, Census Tract 2527.02, Solano County, California",4,4,0
1000000US060952527023027,060952527023027,"Block 3027, Block Group 3, Census Tract 2527.02, Solano County, California",24,24,0
1000000US060952527023028,060952527023028,"Block 3028, Block Group 3, Census Tract 2527.02, Solano County, California",21,18,3
1000000US060952527023029,060952527023029,"Block 3029, Block Group 3, Census Tract 2527.02, Solano County, California",0,0,0
1000000US060952527023030,060952527023030,"Block 3030, Block Group 3, Census Tract 2527.02, Solano County, California",0,0,0
1000000US060952527023031,060952527023031,"Block 3031, Block Group 3, Census Tract 2527.02, Solano County, California",0,0,0
1000000US060952527023032,060952527023032,"Block 3032, Block Group 3, Census Tract 2527.02, Solano County, California",0,0,0
1000000US060952527023033,060952527023033,"Block 3033, Block Group 3, Census Tract 2527.02, Solano County, California",0,0,0
1000000US060952527024000,060952527024000,"Block 4000, Block Group 4, Census Tract 2527.02, Solano County, California",0,0,0
1000000US060952527024001,060952527024001,"Block 4001, Block Group 4, Census Tract 2527.02, Solano County, California",0,0,0
1000000US060952527024002,060952527024002,"Block 4002, Block Group 4, Census Tract 2527.02, Solano County, California",0,0,0
1000000US060952527024003,060952527024003,"Block 4003, Block Group 4, Census Tract 2527.02, Solano County, California",10,10,0
1000000US060952527024004,060952527024004,"Block 4004, Block Group 4, Census Tract 2527.02, Solano County, California",11,10,1
1000000US060952527024005,060952527024005,"Block 4005, Block Group 4, Census Tract 2527.02, Solano County, California",63,57,6
1000000US060952527024006,060952527024006,"Block 4006, Block Group 4, Census Tract 2527.02, Solano County, California",20,19,1
1000000US060952527024007,060952527024007,"Block 4007, Block Group 4, Census Tract 2527.02, Solano County, California",213,206,7
1000000US060952527024008,060952527024008,"Block 4008, Block Group 4, Census Tract 2527.02, Solano County, California",49,47,2
1000000US060952527024009,060952527024009,"Block 4009, Block Group 4, Census Tract 2527.02, Solano County, California",135,126,9
1000000US060952527024010,060952527024010,"Block 4010, Block Group 4, Census Tract 2527.02, Solano County, California",38,36,2
1000000US060952527024011,060952527024011,"Block 4011, Block Group 4, Census Tract 2527.02, Solano County, California",17,12,5
1000000US060952527024012,060952527024012,"Block 4012, Block Group 4, Census Tract 2527.02, Solano County, California",0,0,0
1000000US060952527024013,060952527024013,"Block 4013, Block Group 4, Census Tract 2527.02, Solano County, California",0,0,0
1000000US060952527025000,060952527025000,"Block 5000, Block Group 5, Census Tract 2527.02, Solano County, California",0,0,0
1000000US060952527025001,060952527025001,"Block 5001, Block Group 5, Census Tract 2527.02, Solano County, California",0,0,0
1000000US060952527025002,060952527025002,"Block 5002, Block Group 5, Census Tract 2527.02, Solano County, California",0,0,0
1000000US060952527025003,060952527025003,"Block 5003, Block Group 5, Census Tract 2527.02, Solano County, California",0,0,0
1000000US060952527025004,060952527025004,"Block 5004, Block Group 5, Census Tract 2527.02, Solano County, California",43,41,2
1000000US060952527025005,060952527025005,"Block 5005, Block Group 5, Census Tract 2527.02, Solano County, California",32,29,3
1000000US060952527025006,060952527025006,"Block 5006, Block Group 5, Census Tract 2527.02, Solano County, California",26,26,0
1000000US060952527025007,060952527025007,"Block 5007, Block Group 5, Census Tract 2527.02, Solano County, California",13,13,0
1000000US060952527025008,060952527025008,"Block 5008, Block Group 5, Census Tract 2527.02, Solano County, California",54,52,2
1000000US060952527025009,060952527025009,"Block 5009, Block Group 5, Census Tract 2527.02, Solano County, California",64,60,4
1000000US060952527025010,060952527025010,"Block 5010, Block Group 5, Census Tract 2527.02, Solano County, California",107,99,8
1000000US060952527025011,060952527025011,"Block 5011, Block Group 5, Census Tract 2527.02, Solano County, California",44,43,1
1000000US060952527025012,060952527025012,"Block 5012, Block Group 5, Census Tract 2527.02, Solano County, California",0,0,0
1000000US060952527026000,060952527026000,"Block 6000, Block Group 6, Census Tract 2527.02, Solano County, California",1,1,0
1000000US060952527026001,060952527026001,"Block 6001, Block Group 6, Census Tract 2527.02, Solano County, California",1,1,0
1000000US060952527026002,060952527026002,"Block 6002, Block Group 6, Census Tract 2527.02, Solano County, California",5,4,1
1000000US060952527026003,060952527026003,"Block 6003, Block Group 6, Census Tract 2527.02, Solano County, California",1,1,0
1000000US060952527026004,060952527026004,"Block 6004, Block Group 6, Census Tract 2527.02, Solano County, California",0,0,0
1000000US060952527026005,060952527026005,"Block 6005, Block Group 6, Census Tract 2527.02, Solano County, California",0,0,0
1000000US060952527026006,060952527026006,"Block 6006, Block Group 6, Census Tract 2527.02, Solano County, California",0,0,0
1000000US060952527026007,060952527026007,"Block 6007, Block Group 6, Census Tract 2527.02, Solano County, California",0,0,0
1000000US060952527026008,060952527026008,"Block 6008, Block Group 6, Census Tract 2527.02, Solano County, California",0,0,0
1000000US060952527026009,060952527026009,"Block 6009, Block Group 6, Census Tract 2527.02, Solano County, California",7,6,1
1000000US060952527026010,060952527026010,"Block 6010, Block Group 6, Census Tract 2527.02, Solano County, California",0,0,0
1000000US060952527026011,060952527026011,"Block 6011, Block Group 6, Census Tract 2527.02, Solano County, California",4,4,0
1000000US060952527026012,060952527026012,"Block 6012, Block Group 6, Census Tract 2527.02, Solano County, California",0,0,0
1000000US060952527026013,060952527026013,"Block 6013, Block Group 6, Census Tract 2527.02, Solano County, California",0,0,0
1000000US060952527026014,060952527026014,"Block 6014, Block Group 6, Census Tract 2527.02, Solano County, California",0,0,0
1000000US060952527026015,060952527026015,"Block 6015, Block Group 6, Census Tract 2527.02, Solano County, California",0,0,0
1000000US060952527026016,060952527026016,"Block 6016, Block Group 6, Census Tract 2527.02, Solano County, California",0,0,0
1000000US060952527026017,060952527026017,"Block 6017, Block Group 6, Census Tract 2527.02, Solano County, California",0,0,0
1000000US060952527026018,060952527026018,"Block 6018, Block Group 6, Census Tract 2527.02, Solano County, California",0,0,0
1000000US060952527026019,060952527026019,"Block 6019, Block Group 6, Census Tract 2527.02, Solano County, California",0,0,0
1000000US060952527026020,060952527026020,"Block 6020, Block Group 6, Census Tract 2527.02, Solano County, California",0,0,0
1000000US060952527026021,060952527026021,"Block 6021, Block Group 6, Census Tract 2527.02, Solano County, California",0,0,0
1000000US060952527026022,060952527026022,"Block 6022, Block Group 6, Census Tract 2527.02, Solano County, California",0,0,0
1000000US060952527026023,060952527026023,"Block 6023, Block Group 6, Census Tract 2527.02, Solano County, California",10,7,3
1000000US060952527026024,060952527026024,"Block 6024, Block Group 6, Census Tract 2527.02, Solano County, California",15,14,1
1000000US060952527026025,060952527026025,"Block 6025, Block Group 6, Census Tract 2527.02, Solano County, California",130,125,5
1000000US060952527026026,060952527026026,"Block 6026, Block Group 6, Census Tract 2527.02, Solano County, California",25,23,2
1000000US060952527026027,060952527026027,"Block 6027, Block Group 6, Census Tract 2527.02, Solano County, California",23,21,2
1000000US060952527026028,060952527026028,"Block 6028, Block Group 6, Census Tract 2527.02, Solano County, California",0,0,0
1000000US060952527026029,060952527026029,"Block 6029, Block Group 6, Census Tract 2527.02, Solano County, California",0,0,0
1000000US060952527026030,060952527026030,"Block 6030, Block Group 6, Census Tract 2527.02, Solano County, California",0,0,0
1000000US060952527026031,060952527026031,"Block 6031, Block Group 6, Census Tract 2527.02, Solano County, California",0,0,0
1000000US060952527026032,060952527026032,"Block 6032, Block Group 6, Census Tract 2527.02, Solano County, California",42,40,2
1000000US060952527026033,060952527026033,"Block 6033, Block Group 6, Census Tract 2527.02, Solano County, California",28,26,2
1000000US060952527026034,060952527026034,"Block 6034, Block Group 6, Census Tract 2527.02, Solano County, California",0,0,0
1000000US060952527026035,060952527026035,"Block 6035, Block Group 6, Census Tract 2527.02, Solano County, California",1,1,0
1000000US060952527026036,060952527026036,"Block 6036, Block Group 6, Census Tract 2527.02, Solano County, California",0,0,0
1000000US060952527026037,060952527026037,"Block 6037, Block Group 6, Census Tract 2527.02, Solano County, California",0,0,0
1000000US060952527026038,060952527026038,"Block 6038, Block Group 6, Census Tract 2527.02, Solano County, California",2,2,0
1000000US060952527026039,060952527026039,"Block 6039, Block Group 6, Census Tract 2527.02, Solano County, California",4,4,0
1000000US060952527026040,060952527026040,"Block 6040, Block Group 6, Census Tract 2527.02, Solano County, California",11,11,0
1000000US060952527026041,060952527026041,"Block 6041, Block Group 6, Census Tract 2527.02, Solano County, California",0,0,0
1000000US060952527026042,060952527026042,"Block 6042, Block Group 6, Census Tract 2527.02, Solano County, California",0,0,0
1000000US060952527026043,060952527026043,"Block 6043, Block Group 6, Census Tract 2527.02, Solano County, California",0,0,0
1000000US060952527026044,060952527026044,"Block 6044, Block Group 6, Census Tract 2527.02, Solano County, California",0,0,0
1000000US060952527026045,060952527026045,"Block 6045, Block Group 6, Census Tract 2527.02, Solano County, California",0,0,0
1000000US060952527026046,060952527026046,"Block 6046, Block Group 6, Census Tract 2527.02, Solano County, California",0,0,0
1000000US060952527026047,060952527026047,"Block 6047, Block Group 6, Census Tract 2527.02, Solano County, California",0,0,0
1000000US060952527026048,060952527026048,"Block 6048, Block Group 6, Census Tract 2527.02, Solano County, California",0,0,0
1000000US060952527026049,060952527026049,"Block 6049, Block Group 6, Census Tract 2527.02, Solano County, California",0,0,0
1000000US060952527026050,060952527026050,"Block 6050, Block Group 6, Census Tract 2527.02, Solano County, California",0,0,0
1000000US060952527026051,060952527026051,"Block 6051, Block Group 6, Census Tract 2527.02, Solano County, California",0,0,0
1000000US060952527026052,060952527026052,"Block 6052, Block Group 6, Census Tract 2527.02, Solano County, California",0,0,0
1000000US060952527026053,060952527026053,"Block 6053, Block Group 6, Census Tract 2527.02, Solano County, California",2,2,0
1000000US060952527026054,060952527026054,"Block 6054, Block Group 6, Census Tract 2527.02, Solano County, California",0,0,0
1000000US060952527026055,060952527026055,"Block 6055, Block Group 6, Census Tract 2527.02, Solano County, California",0,0,0
1000000US060952527026056,060952527026056,"Block 6056, Block Group 6, Census Tract 2527.02, Solano County, California",0,0,0
1000000US060952527026057,060952527026057,"Block 6057, Block Group 6, Census Tract 2527.02, Solano County, California",0,0,0
1000000US060952527026058,060952527026058,"Block 6058, Block Group 6, Census Tract 2527.02, Solano County, California",0,0,0
1000000US060952527026059,060952527026059,"Block 6059, Block Group 6, Census Tract 2527.02, Solano County, California",0,0,0
1000000US060952527026060,060952527026060,"Block 6060, Block Group 6, Census Tract 2527.02, Solano County, California",1,0,1
1000000US060952527026061,060952527026061,"Block 6061, Block Group 6, Census Tract 2527.02, Solano County, California",0,0,0
1000000US060952527026062,060952527026062,"Block 6062, Block Group 6, Census Tract 2527.02, Solano County, California",0,0,0
1000000US060952527026063,060952527026063,"Block 6063, Block Group 6, Census Tract 2527.02, Solano County, California",0,0,0
1000000US060952527026064,060952527026064,"Block 6064, Block Group 6, Census Tract 2527.02, Solano County, California",0,0,0
1000000US060952527026065,060952527026065,"Block 6065, Block Group 6, Census Tract 2527.02, Solano County, California",0,0,0
1000000US060952527026066,060952527026066,"Block 6066, Block Group 6, Census Tract 2527.02, Solano County, California",0,0,0
1000000US060952527026067,060952527026067,"Block 6067, Block Group 6, Census Tract 2527.02, Solano County, California",0,0,0
1000000US060952527026068,060952527026068,"Block 6068, Block Group 6, Census Tract 2527.02, Solano County, California",0,0,0
1000000US060952527026069,060952527026069,"Block 6069, Block Group 6, Census Tract 2527.02, Solano County, California",0,0,0
1000000US060952527026070,060952527026070,"Block 6070, Block Group 6, Census Tract 2527.02, Solano County, California",0,0,0
1000000US060952527026071,060952527026071,"Block 6071, Block Group 6, Census Tract 2527.02, Solano County, California",0,0,0
1000000US060952527026072,060952527026072,"Block 6072, Block Group 6, Census Tract 2527.02, Solano County, California",0,0,0
1000000US060952527026073,060952527026073,"Block 6073, Block Group 6, Census Tract 2527.02, Solano County, California",0,0,0
1000000US060952527026074,060952527026074,"Block 6074, Block Group 6, Census Tract 2527.02, Solano County, California",0,0,0
1000000US060952527026075,060952527026075,"Block 6075, Block Group 6, Census Tract 2527.02, Solano County, California",0,0,0
1000000US060952527026076,060952527026076,"Block 6076, Block Group 6, Census Tract 2527.02, Solano County, California",0,0,0
1000000US060952527026077,060952527026077,"Block 6077, Block Group 6, Census Tract 2527.02, Solano County, California",0,0,0
1000000US060952527026078,060952527026078,"Block 6078, Block Group 6, Census Tract 2527.02, Solano County, California",0,0,0
1000000US060952527026079,060952527026079,"Block 6079, Block Group 6, Census Tract 2527.02, Solano County, California",0,0,0
1000000US060952527026080,060952527026080,"Block 6080, Block Group 6, Census Tract 2527.02, Solano County, California",0,0,0
1000000US060952527026081,060952527026081,"Block 6081, Block Group 6, Census Tract 2527.02, Solano County, California",1,1,0
1000000US060952527026082,060952527026082,"Block 6082, Block Group 6, Census Tract 2527.02, Solano County, California",0,0,0
1000000US060952527026083,060952527026083,"Block 6083, Block Group 6, Census Tract 2527.02, Solano County, California",0,0,0
1000000US060952527026084,060952527026084,"Block 6084, Block Group 6, Census Tract 2527.02, Solano County, California",0,0,0
1000000US060952527026085,060952527026085,"Block 6085, Block Group 6, Census Tract 2527.02, Solano County, California",0,0,0
1000000US060952527026086,060952527026086,"Block 6086, Block Group 6, Census Tract 2527.02, Solano County, California",0,0,0
1000000US060952527026087,060952527026087,"Block 6087, Block Group 6, Census Tract 2527.02, Solano County, California",0,0,0
1000000US060952527026088,060952527026088,"Block 6088, Block Group 6, Census Tract 2527.02, Solano County, California",0,0,0
1000000US060952527026089,060952527026089,"Block 6089, Block Group 6, Census Tract 2527.02, Solano County, California",0,0,0
1000000US060952527026090,060952527026090,"Block 6090, Block Group 6, Census Tract 2527.02, Solano County, California",0,0,0
1000000US060952527026091,060952527026091,"Block 6091, Block Group 6, Census Tract 2527.02, Solano County, California",0,0,0
1000000US060952527026092,060952527026092,"Block 6092, Block Group 6, Census Tract 2527.02, Solano County, California",0,0,0
1000000US060952527026093,060952527026093,"Block 6093, Block Group 6, Census Tract 2527.02, Solano County, California",0,0,0
1000000US060952527026094,060952527026094,"Block 6094, Block Group 6, Census Tract 2527.02, Solano County, California",0,0,0
1000000US060952527026095,060952527026095,"Block 6095, Block Group 6, Census Tract 2527.02, Solano County, California",0,0,0
1000000US060952527026096,060952527026096,"Block 6096, Block Group 6, Census Tract 2527.02, Solano County, California",0,0,0
1000000US060952527026097,060952527026097,"Block 6097, Block Group 6, Census Tract 2527.02, Solano County, California",0,0,0
1000000US060952527026098,060952527026098,"Block 6098, Block Group 6, Census Tract 2527.02, Solano County, California",0,0,0
1000000US060952527026099,060952527026099,"Block 6099, Block Group 6, Census Tract 2527.02, Solano County, California",0,0,0
1000000US060952527026100,060952527026100,"Block 6100, Block Group 6, Census Tract 2527.02, Solano County, California",0,0,0
1000000US060952527026101,060952527026101,"Block 6101, Block Group 6, Census Tract 2527.02, Solano County, California",0,0,0
1000000US060952527026102,060952527026102,"Block 6102, Block Group 6, Census Tract 2527.02, Solano County, California",0,0,0
1000000US060952527026103,060952527026103,"Block 6103, Block Group 6, Census Tract 2527.02, Solano County, California",0,0,0
1000000US060952527026104,060952527026104,"Block 6104, Block Group 6, Census Tract 2527.02, Solano County, California",0,0,0
1000000US060952527026105,060952527026105,"Block 6105, Block Group 6, Census Tract 2527.02, Solano County, California",0,0,0
1000000US060952527026106,060952527026106,"Block 6106, Block Group 6, Census Tract 2527.02, Solano County, California",0,0,0
1000000US060952527026107,060952527026107,"Block 6107, Block Group 6, Census Tract 2527.02, Solano County, California",0,0,0
1000000US060952527026108,060952527026108,"Block 6108, Block Group 6, Census Tract 2527.02, Solano County, California",1,1,0
1000000US060952527026109,060952527026109,"Block 6109, Block Group 6, Census Tract 2527.02, Solano County, California",0,0,0
1000000US060952527026110,060952527026110,"Block 6110, Block Group 6, Census Tract 2527.02, Solano County, California",0,0,0
1000000US060952527026111,060952527026111,"Block 6111, Block Group 6, Census Tract 2527.02, Solano County, California",0,0,0
1000000US060952527026112,060952527026112,"Block 6112, Block Group 6, Census Tract 2527.02, Solano County, California",0,0,0
1000000US060952527026113,060952527026113,"Block 6113, Block Group 6, Census Tract 2527.02, Solano County, California",0,0,0
1000000US060952527026114,060952527026114,"Block 6114, Block Group 6, Census Tract 2527.02, Solano County, California",0,0,0
1000000US060952527026115,060952527026115,"Block 6115, Block Group 6, Census Tract 2527.02, Solano County, California",0,0,0
1000000US060952527026116,060952527026116,"Block 6116, Block Group 6, Census Tract 2527.02, Solano County, California",0,0,0
1000000US060952527026117,060952527026117,"Block 6117, Block Group 6, Census Tract 2527.02, Solano County, California",0,0,0
1000000US060952527026118,060952527026118,"Block 6118, Block Group 6, Census Tract 2527.02, Solano County, California",0,0,0
1000000US060952527026119,060952527026119,"Block 6119, Block Group 6, Census Tract 2527.02, Solano County, California",0,0,0
1000000US060952527026120,060952527026120,"Block 6120, Block Group 6, Census Tract 2527.02, Solano County, California",0,0,0
1000000US060952527026121,060952527026121,"Block 6121, Block Group 6, Census Tract 2527.02, Solano County, California",0,0,0
1000000US060952527026122,060952527026122,"Block 6122, Block Group 6, Census Tract 2527.02, Solano County, California",0,0,0
1000000US060952527026123,060952527026123,"Block 6123, Block Group 6, Census Tract 2527.02, Solano County, California",0,0,0
1000000US060952527026124,060952527026124,"Block 6124, Block Group 6, Census Tract 2527.02, Solano County, California",0,0,0
1000000US060952527026125,060952527026125,"Block 6125, Block Group 6, Census Tract 2527.02, Solano County, California",0,0,0
1000000US060952527026126,060952527026126,"Block 6126, Block Group 6, Census Tract 2527.02, Solano County, California",0,0,0
1000000US060952527026127,060952527026127,"Block 6127, Block Group 6, Census Tract 2527.02, Solano County, California",0,0,0
1000000US060952527026128,060952527026128,"Block 6128, Block Group 6, Census Tract 2527.02, Solano County, California",0,0,0
1000000US060952527026129,060952527026129,"Block 6129, Block Group 6, Census Tract 2527.02, Solano County, California",0,0,0
1000000US060952527026130,060952527026130,"Block 6130, Block Group 6, Census Tract 2527.02, Solano County, California",0,0,0
1000000US060952527026131,060952527026131,"Block 6131, Block Group 6, Census Tract 2527.02, Solano County, California",0,0,0
1000000US060952527026132,060952527026132,"Block 6132, Block Group 6, Census Tract 2527.02, Solano County, California",0,0,0
1000000US060952527026133,060952527026133,"Block 6133, Block Group 6, Census Tract 2527.02, Solano County, California",0,0,0
1000000US060952527026134,060952527026134,"Block 6134, Block Group 6, Census Tract 2527.02, Solano County, California",0,0,0
1000000US060952527026135,060952527026135,"Block 6135, Block Group 6, Census Tract 2527.02, Solano County, California",0,0,0
1000000US060952527026136,060952527026136,"Block 6136, Block Group 6, Census Tract 2527.02, Solano County, California",0,0,0
1000000US060952527026137,060952527026137,"Block 6137, Block Group 6, Census Tract 2527.02, Solano County, California",0,0,0
1000000US060952527026138,060952527026138,"Block 6138, Block Group 6, Census Tract 2527.02, Solano County, California",0,0,0
1000000US060952527026139,060952527026139,"Block 6139, Block Group 6, Census Tract 2527.02, Solano County, California",0,0,0
1000000US060952527026140,060952527026140,"Block 6140, Block Group 6, Census Tract 2527.02, Solano County, California",1,1,0
1000000US060952527026141,060952527026141,"Block 6141, Block Group 6, Census Tract 2527.02, Solano County, California",1,1,0
1000000US060952527026142,060952527026142,"Block 6142, Block Group 6, Census Tract 2527.02, Solano County, California",0,0,0
1000000US060952527026143,060952527026143,"Block 6143, Block Group 6, Census Tract 2527.02, Solano County, California",0,0,0
1000000US060952527026144,060952527026144,"Block 6144, Block Group 6, Census Tract 2527.02, Solano County, California",0,0,0
1000000US060952527026145,060952527026145,"Block 6145, Block Group 6, Census Tract 2527.02, Solano County, California",0,0,0
1000000US060952527026146,060952527026146,"Block 6146, Block Group 6, Census Tract 2527.02, Solano County, California",0,0,0
1000000US060952527026147,060952527026147,"Block 6147, Block Group 6, Census Tract 2527.02, Solano County, California",0,0,0
1000000US060952527026148,060952527026148,"Block 6148, Block Group 6, Census Tract 2527.02, Solano County, California",0,0,0
1000000US060952527026149,060952527026149,"Block 6149, Block Group 6, Census Tract 2527.02, Solano County, California",0,0,0
1000000US060952527026150,060952527026150,"Block 6150, Block Group 6, Census Tract 2527.02, Solano County, California",0,0,0
1000000US060952527026151,060952527026151,"Block 6151, Block Group 6, Census Tract 2527.02, Solano County, California",1,1,0
1000000US060952527026152,060952527026152,"Block 6152, Block Group 6, Census Tract 2527.02, Solano County, California",0,0,0
1000000US060952527026153,060952527026153,"Block 6153, Block Group 6, Census Tract 2527.02, Solano County, California",0,0,0
1000000US060952527026154,060952527026154,"Block 6154, Block Group 6, Census Tract 2527.02, Solano County, California",0,0,0
1000000US060952527026155,060952527026155,"Block 6155, Block Group 6, Census Tract 2527.02, Solano County, California",1,0,1
1000000US060952527026156,060952527026156,"Block 6156, Block Group 6, Census Tract 2527.02, Solano County, California",0,0,0
1000000US060952527026157,060952527026157,"Block 6157, Block Group 6, Census Tract 2527.02, Solano County, California",0,0,0
1000000US060952527026158,060952527026158,"Block 6158, Block Group 6, Census Tract 2527.02, Solano County, California",0,0,0
1000000US060952527026159,060952527026159,"Block 6159, Block Group 6, Census Tract 2527.02, Solano County, California",3,1,2
1000000US060952527026160,060952527026160,"Block 6160, Block Group 6, Census Tract 2527.02, Solano County, California",0,0,0
1000000US060952527026161,060952527026161,"Block 6161, Block Group 6, Census Tract 2527.02, Solano County, California",0,0,0
1000000US060952527026162,060952527026162,"Block 6162, Block Group 6, Census Tract 2527.02, Solano County, California",0,0,0
1000000US060952527026163,060952527026163,"Block 6163, Block Group 6, Census Tract 2527.02, Solano County, California",0,0,0
1000000US060952527026164,060952527026164,"Block 6164, Block Group 6, Census Tract 2527.02, Solano County, California",2,1,1
1000000US060952527026165,060952527026165,"Block 6165, Block Group 6, Census Tract 2527.02, Solano County, California",0,0,0
1000000US060952527026166,060952527026166,"Block 6166, Block Group 6, Census Tract 2527.02, Solano County, California",0,0,0
1000000US060952527026167,060952527026167,"Block 6167, Block Group 6, Census Tract 2527.02, Solano County, California",0,0,0
1000000US060952527026168,060952527026168,"Block 6168, Block Group 6, Census Tract 2527.02, Solano County, California",0,0,0
1000000US060952527026169,060952527026169,"Block 6169, Block Group 6, Census Tract 2527.02, Solano County, California",0,0,0
1000000US060952527026170,060952527026170,"Block 6170, Block Group 6, Census Tract 2527.02, Solano County, California",0,0,0
1000000US060952527026171,060952527026171,"Block 6171, Block Group 6, Census Tract 2527.02, Solano County, California",0,0,0
1000000US060952527026172,060952527026172,"Block 6172, Block Group 6, Census Tract 2527.02, Solano County, California",0,0,0
1000000US060952527026173,060952527026173,"Block 6173, Block Group 6, Census Tract 2527.02, Solano County, California",0,0,0
1000000US060952527026174,060952527026174,"Block 6174, Block Group 6, Census Tract 2527.02, Solano County, California",0,0,0
1000000US060952527026175,060952527026175,"Block 6175, Block Group 6, Census Tract 2527.02, Solano County, California",0,0,0
1000000US060952527026176,060952527026176,"Block 6176, Block Group 6, Census Tract 2527.02, Solano County, California",0,0,0
1000000US060952527026177,060952527026177,"Block 6177, Block Group 6, Census Tract 2527.02, Solano County, California",0,0,0
1000000US060952527026178,060952527026178,"Block 6178, Block Group 6, Census Tract 2527.02, Solano County, California",0,0,0
1000000US060952527026179,060952527026179,"Block 6179, Block Group 6, Census Tract 2527.02, Solano County, California",0,0,0
1000000US060952527026180,060952527026180,"Block 6180, Block Group 6, Census Tract 2527.02, Solano County, California",0,0,0
1000000US060952527026181,060952527026181,"Block 6181, Block Group 6, Census Tract 2527.02, Solano County, California",0,0,0
1000000US060952527026182,060952527026182,"Block 6182, Block Group 6, Census Tract 2527.02, Solano County, California",0,0,0
1000000US060952527026183,060952527026183,"Block 6183, Block Group 6, Census Tract 2527.02, Solano County, California",0,0,0
1000000US060952527026184,060952527026184,"Block 6184, Block Group 6, Census Tract 2527.02, Solano County, California",0,0,0
1000000US060952527026185,060952527026185,"Block 6185, Block Group 6, Census Tract 2527.02, Solano County, California",0,0,0
1000000US060952527026186,060952527026186,"Block 6186, Block Group 6, Census Tract 2527.02, Solano County, California",0,0,0
1000000US060952527026187,060952527026187,"Block 6187, Block Group 6, Census Tract 2527.02, Solano County, California",0,0,0
1000000US060952527026188,060952527026188,"Block 6188, Block Group 6, Census Tract 2527.02, Solano County, California",0,0,0
1000000US060952527026189,060952527026189,"Block 6189, Block Group 6, Census Tract 2527.02, Solano County, California",1,1,0
1000000US060952527026190,060952527026190,"Block 6190, Block Group 6, Census Tract 2527.02, Solano County, California",1,1,0
1000000US060952527026191,060952527026191,"Block 6191, Block Group 6, Census Tract 2527.02, Solano County, California",0,0,0
1000000US060952527026192,060952527026192,"Block 6192, Block Group 6, Census Tract 2527.02, Solano County, California",0,0,0
1000000US060952527026193,060952527026193,"Block 6193, Block Group 6, Census Tract 2527.02, Solano County, California",0,0,0
1000000US060952527026194,060952527026194,"Block 6194, Block Group 6, Census Tract 2527.02, Solano County, California",0,0,0
1000000US060952527026195,060952527026195,"Block 6195, Block Group 6, Census Tract 2527.02, Solano County, California",0,0,0
1000000US060952527026196,060952527026196,"Block 6196, Block Group 6, Census Tract 2527.02, Solano County, California",0,0,0
1000000US060952527026197,060952527026197,"Block 6197, Block Group 6, Census Tract 2527.02, Solano County, California",0,0,0
1000000US060952527026198,060952527026198,"Block 6198, Block Group 6, Census Tract 2527.02, Solano County, California",0,0,0
1000000US060952527026199,060952527026199,"Block 6199, Block Group 6, Census Tract 2527.02, Solano County, California",0,0,0
1000000US060952527026200,060952527026200,"Block 6200, Block Group 6, Census Tract 2527.02, Solano County, California",0,0,0
1000000US060952527026201,060952527026201,"Block 6201, Block Group 6, Census Tract 2527.02, Solano County, California",0,0,0
1000000US060952527026202,060952527026202,"Block 6202, Block Group 6, Census Tract 2527.02, Solano County, California",0,0,0
1000000US060952527026203,060952527026203,"Block 6203, Block Group 6, Census Tract 2527.02, Solano County, California",0,0,0
1000000US060952527026204,060952527026204,"Block 6204, Block Group 6, Census Tract 2527.02, Solano County, California",0,0,0
1000000US060952527026205,060952527026205,"Block 6205, Block Group 6, Census Tract 2527.02, Solano County, California",0,0,0
1000000US060952527026206,060952527026206,"Block 6206, Block Group 6, Census Tract 2527.02, Solano County, California",0,0,0
1000000US060952527026207,060952527026207,"Block 6207, Block Group 6, Census Tract 2527.02, Solano County, California",0,0,0
1000000US060952527026208,060952527026208,"Block 6208, Block Group 6, Census Tract 2527.02, Solano County, California",0,0,0
1000000US060952527026209,060952527026209,"Block 6209, Block Group 6, Census Tract 2527.02, Solano County, California",0,0,0
1000000US060952527026210,060952527026210,"Block 6210, Block Group 6, Census Tract 2527.02, Solano County, California",0,0,0
1000000US060952527026211,060952527026211,"Block 6211, Block Group 6, Census Tract 2527.02, Solano County, California",0,0,0
1000000US060952527026212,060952527026212,"Block 6212, Block Group 6, Census Tract 2527.02, Solano County, California",0,0,0
1000000US060952527026213,060952527026213,"Block 6213, Block Group 6, Census Tract 2527.02, Solano County, California",0,0,0
1000000US060952527026214,060952527026214,"Block 6214, Block Group 6, Census Tract 2527.02, Solano County, California",0,0,0
1000000US060952527026215,060952527026215,"Block 6215, Block Group 6, Census Tract 2527.02, Solano County, California",0,0,0
1000000US060952527026216,060952527026216,"Block 6216, Block Group 6, Census Tract 2527.02, Solano County, California",0,0,0
1000000US060952527026217,060952527026217,"Block 6217, Block Group 6, Census Tract 2527.02, Solano County, California",0,0,0
1000000US060952527026218,060952527026218,"Block 6218, Block Group 6, Census Tract 2527.02, Solano County, California",0,0,0
1000000US060952527026219,060952527026219,"Block 6219, Block Group 6, Census Tract 2527.02, Solano County, California",0,0,0
1000000US060952527026220,060952527026220,"Block 6220, Block Group 6, Census Tract 2527.02, Solano County, California",0,0,0
1000000US060952527026221,060952527026221,"Block 6221, Block Group 6, Census Tract 2527.02, Solano County, California",0,0,0
1000000US060952527026222,060952527026222,"Block 6222, Block Group 6, Census Tract 2527.02, Solano County, California",3,0,3
1000000US060952527026223,060952527026223,"Block 6223, Block Group 6, Census Tract 2527.02, Solano County, California",0,0,0
1000000US060952527026224,060952527026224,"Block 6224, Block Group 6, Census Tract 2527.02, Solano County, California",0,0,0
1000000US060952527026225,060952527026225,"Block 6225, Block Group 6, Census Tract 2527.02, Solano County, California",0,0,0
1000000US060952527026226,060952527026226,"Block 6226, Block Group 6, Census Tract 2527.02, Solano County, California",0,0,0
1000000US060952527026227,060952527026227,"Block 6227, Block Group 6, Census Tract 2527.02, Solano County, California",0,0,0
1000000US060952527026228,060952527026228,"Block 6228, Block Group 6, Census Tract 2527.02, Solano County, California",0,0,0
1000000US060952527026229,060952527026229,"Block 6229, Block Group 6, Census Tract 2527.02, Solano County, California",0,0,0
1000000US060952527026230,060952527026230,"Block 6230, Block Group 6, Census Tract 2527.02, Solano County, California",0,0,0
1000000US060952527026231,060952527026231,"Block 6231, Block Group 6, Census Tract 2527.02, Solano County, California",0,0,0
1000000US060952527026232,060952527026232,"Block 6232, Block Group 6, Census Tract 2527.02, Solano County, California",0,0,0
1000000US060952527026233,060952527026233,"Block 6233, Block Group 6, Census Tract 2527.02, Solano County, California",0,0,0
1000000US060952527026234,060952527026234,"Block 6234, Block Group 6, Census Tract 2527.02, Solano County, California",0,0,0
1000000US060952527026235,060952527026235,"Block 6235, Block Group 6, Census Tract 2527.02, Solano County, California",0,0,0
1000000US060952527026236,060952527026236,"Block 6236, Block Group 6, Census Tract 2527.02, Solano County, California",0,0,0
1000000US060952527026237,060952527026237,"Block 6237, Block Group 6, Census Tract 2527.02, Solano County, California",0,0,0
1000000US060952527026238,060952527026238,"Block 6238, Block Group 6, Census Tract 2527.02, Solano County, California",0,0,0
1000000US060952527026239,060952527026239,"Block 6239, Block Group 6, Census Tract 2527.02, Solano County, California",0,0,0
1000000US060952527026240,060952527026240,"Block 6240, Block Group 6, Census Tract 2527.02, Solano County, California",0,0,0
1000000US060952527026241,060952527026241,"Block 6241, Block Group 6, Census Tract 2527.02, Solano County, California",0,0,0
1000000US060952527026242,060952527026242,"Block 6242, Block Group 6, Census Tract 2527.02, Solano County, California",0,0,0
1000000US060952527026243,060952527026243,"Block 6243, Block Group 6, Census Tract 2527.02, Solano County, California",7,5,2
1000000US060952527026244,060952527026244,"Block 6244, Block Group 6, Census Tract 2527.02, Solano County, California",0,0,0
1000000US060952527026245,060952527026245,"Block 6245, Block Group 6, Census Tract 2527.02, Solano County, California",0,0,0
1000000US060952527026246,060952527026246,"Block 6246, Block Group 6, Census Tract 2527.02, Solano County, California",0,0,0
1000000US060952527026247,060952527026247,"Block 6247, Block Group 6, Census Tract 2527.02, Solano County, California",0,0,0
1000000US060952527026248,060952527026248,"Block 6248, Block Group 6, Census Tract 2527.02, Solano County, California",0,0,0
1000000US060952527026249,060952527026249,"Block 6249, Block Group 6, Census Tract 2527.02, Solano County, California",0,0,0
1000000US060952527026250,060952527026250,"Block 6250, Block Group 6, Census Tract 2527.02, Solano County, California",0,0,0
1000000US060952527026251,060952527026251,"Block 6251, Block Group 6, Census Tract 2527.02, Solano County, California",0,0,0
1000000US060952527026252,060952527026252,"Block 6252, Block Group 6, Census Tract 2527.02, Solano County, California",0,0,0
1000000US060952527026253,060952527026253,"Block 6253, Block Group 6, Census Tract 2527.02, Solano County, California",0,0,0
1000000US060952527026254,060952527026254,"Block 6254, Block Group 6, Census Tract 2527.02, Solano County, California",0,0,0
1000000US060952527026255,060952527026255,"Block 6255, Block Group 6, Census Tract 2527.02, Solano County, California",0,0,0
1000000US060952527026256,060952527026256,"Block 6256, Block Group 6, Census Tract 2527.02, Solano County, California",0,0,0
1000000US060952527026257,060952527026257,"Block 6257, Block Group 6, Census Tract 2527.02, Solano County, California",0,0,0
1000000US060952527026258,060952527026258,"Block 6258, Block Group 6, Census Tract 2527.02, Solano County, California",0,0,0
1000000US060952527026259,060952527026259,"Block 6259, Block Group 6, Census Tract 2527.02, Solano County, California",0,0,0
1000000US060952527026260,060952527026260,"Block 6260, Block Group 6, Census Tract 2527.02, Solano County, California",0,0,0
1000000US060952527026261,060952527026261,"Block 6261, Block Group 6, Census Tract 2527.02, Solano County, California",0,0,0
1000000US060952527026262,060952527026262,"Block 6262, Block Group 6, Census Tract 2527.02, Solano County, California",0,0,0
1000000US060952527026263,060952527026263,"Block 6263, Block Group 6, Census Tract 2527.02, Solano County, California",0,0,0
1000000US060952527026264,060952527026264,"Block 6264, Block Group 6, Census Tract 2527.02, Solano County, California",0,0,0
1000000US060952527026265,060952527026265,"Block 6265, Block Group 6, Census Tract 2527.02, Solano County, California",0,0,0
1000000US060952527026266,060952527026266,"Block 6266, Block Group 6, Census Tract 2527.02, Solano County, California",0,0,0
1000000US060952527026267,060952527026267,"Block 6267, Block Group 6, Census Tract 2527.02, Solano County, California",0,0,0
1000000US060952527026268,060952527026268,"Block 6268, Block Group 6, Census Tract 2527.02, Solano County, California",0,0,0
1000000US060952527026269,060952527026269,"Block 6269, Block Group 6, Census Tract 2527.02, Solano County, California",0,0,0
1000000US060952527026270,060952527026270,"Block 6270, Block Group 6, Census Tract 2527.02, Solano County, California",0,0,0
1000000US060952527026271,060952527026271,"Block 6271, Block Group 6, Census Tract 2527.02, Solano County, California",0,0,0
1000000US060952527026272,060952527026272,"Block 6272, Block Group 6, Census Tract 2527.02, Solano County, California",0,0,0
1000000US060952527026273,060952527026273,"Block 6273, Block Group 6, Census Tract 2527.02, Solano County, California",0,0,0
1000000US060952527026274,060952527026274,"Block 6274, Block Group 6, Census Tract 2527.02, Solano County, California",0,0,0
1000000US060952527026275,060952527026275,"Block 6275, Block Group 6, Census Tract 2527.02, Solano County, California",0,0,0
1000000US060952527026276,060952527026276,"Block 6276, Block Group 6, Census Tract 2527.02, Solano County, California",0,0,0
1000000US060952527026277,060952527026277,"Block 6277, Block Group 6, Census Tract 2527.02, Solano County, California",0,0,0
1000000US060952527026278,060952527026278,"Block 6278, Block Group 6, Census Tract 2527.02, Solano County, California",0,0,0
1000000US060952527026279,060952527026279,"Block 6279, Block Group 6, Census Tract 2527.02, Solano County, California",0,0,0
1000000US060952527026280,060952527026280,"Block 6280, Block Group 6, Census Tract 2527.02, Solano County, California",0,0,0
1000000US060952527026281,060952527026281,"Block 6281, Block Group 6, Census Tract 2527.02, Solano County, California",0,0,0
1000000US060952527026282,060952527026282,"Block 6282, Block Group 6, Census Tract 2527.02, Solano County, California",0,0,0
1000000US060952527026283,060952527026283,"Block 6283, Block Group 6, Census Tract 2527.02, Solano County, California",0,0,0
1000000US060952527026284,060952527026284,"Block 6284, Block Group 6, Census Tract 2527.02, Solano County, California",0,0,0
1000000US060952527026285,060952527026285,"Block 6285, Block Group 6, Census Tract 2527.02, Solano County, California",0,0,0
1000000US060952527026286,060952527026286,"Block 6286, Block Group 6, Census Tract 2527.02, Solano County, California",0,0,0
1000000US060952527026287,060952527026287,"Block 6287, Block Group 6, Census Tract 2527.02, Solano County, California",0,0,0
1000000US060952527026288,060952527026288,"Block 6288, Block Group 6, Census Tract 2527.02, Solano County, California",0,0,0
1000000US060952527026289,060952527026289,"Block 6289, Block Group 6, Census Tract 2527.02, Solano County, California",0,0,0
1000000US060952527026290,060952527026290,"Block 6290, Block Group 6, Census Tract 2527.02, Solano County, California",0,0,0
1000000US060952527026291,060952527026291,"Block 6291, Block Group 6, Census Tract 2527.02, Solano County, California",0,0,0
1000000US060952527026292,060952527026292,"Block 6292, Block Group 6, Census Tract 2527.02, Solano County, California",0,0,0
1000000US060952527026293,060952527026293,"Block 6293, Block Group 6, Census Tract 2527.02, Solano County, California",0,0,0
1000000US060952527026294,060952527026294,"Block 6294, Block Group 6, Census Tract 2527.02, Solano County, California",0,0,0
1000000US060952527026295,060952527026295,"Block 6295, Block Group 6, Census Tract 2527.02, Solano County, California",0,0,0
1000000US060952527026296,060952527026296,"Block 6296, Block Group 6, Census Tract 2527.02, Solano County, California",0,0,0
1000000US060952527026297,060952527026297,"Block 6297, Block Group 6, Census Tract 2527.02, Solano County, California",0,0,0
1000000US060952527026298,060952527026298,"Block 6298, Block Group 6, Census Tract 2527.02, Solano County, California",0,0,0
1000000US060952527026299,060952527026299,"Block 6299, Block Group 6, Census Tract 2527.02, Solano County, California",0,0,0
1000000US060952527026300,060952527026300,"Block 6300, Block Group 6, Census Tract 2527.02, Solano County, California",0,0,0
1000000US060952527026301,060952527026301,"Block 6301, Block Group 6, Census Tract 2527.02, Solano County, California",0,0,0
1000000US060952527026302,060952527026302,"Block 6302, Block Group 6, Census Tract 2527.02, Solano County, California",0,0,0
1000000US060952527026303,060952527026303,"Block 6303, Block Group 6, Census Tract 2527.02, Solano County, California",0,0,0
1000000US060952527026304,060952527026304,"Block 6304, Block Group 6, Census Tract 2527.02, Solano County, California",0,0,0
1000000US060952527026305,060952527026305,"Block 6305, Block Group 6, Census Tract 2527.02, Solano County, California",0,0,0
1000000US060952527026306,060952527026306,"Block 6306, Block Group 6, Census Tract 2527.02, Solano County, California",0,0,0
1000000US060952527026307,060952527026307,"Block 6307, Block Group 6, Census Tract 2527.02, Solano County, California",0,0,0
1000000US060952527026308,060952527026308,"Block 6308, Block Group 6, Census Tract 2527.02, Solano County, California",0,0,0
1000000US060952527026309,060952527026309,"Block 6309, Block Group 6, Census Tract 2527.02, Solano County, California",0,0,0
1000000US060952527026310,060952527026310,"Block 6310, Block Group 6, Census Tract 2527.02, Solano County, California",0,0,0
1000000US060952527026311,060952527026311,"Block 6311, Block Group 6, Census Tract 2527.02, Solano County, California",0,0,0
1000000US060952527026312,060952527026312,"Block 6312, Block Group 6, Census Tract 2527.02, Solano County, California",0,0,0
1000000US060952527026313,060952527026313,"Block 6313, Block Group 6, Census Tract 2527.02, Solano County, California",0,0,0
1000000US060952527026314,060952527026314,"Block 6314, Block Group 6, Census Tract 2527.02, Solano County, California",0,0,0
1000000US060952527026315,060952527026315,"Block 6315, Block Group 6, Census Tract 2527.02, Solano County, California",0,0,0
1000000US060952527026316,060952527026316,"Block 6316, Block Group 6, Census Tract 2527.02, Solano County, California",0,0,0
1000000US060952527026317,060952527026317,"Block 6317, Block Group 6, Census Tract 2527.02, Solano County, California",0,0,0
1000000US060952527026318,060952527026318,"Block 6318, Block Group 6, Census Tract 2527.02, Solano County, California",0,0,0
1000000US060952527026319,060952527026319,"Block 6319, Block Group 6, Census Tract 2527.02, Solano County, California",0,0,0
1000000US060952527026320,060952527026320,"Block 6320, Block Group 6, Census Tract 2527.02, Solano County, California",0,0,0
1000000US060952527026321,060952527026321,"Block 6321, Block Group 6, Census Tract 2527.02, Solano County, California",0,0,0
1000000US060952527026322,060952527026322,"Block 6322, Block Group 6, Census Tract 2527.02, Solano County, California",0,0,0
1000000US060952527026323,060952527026323,"Block 6323, Block Group 6, Census Tract 2527.02, Solano County, California",0,0,0
1000000US060952527026324,060952527026324,"Block 6324, Block Group 6, Census Tract 2527.02, Solano County, California",0,0,0
1000000US060952527026325,060952527026325,"Block 6325, Block Group 6, Census Tract 2527.02, Solano County, California",0,0,0
1000000US060952527026326,060952527026326,"Block 6326, Block Group 6, Census Tract 2527.02, Solano County, California",0,0,0
1000000US060952527026327,060952527026327,"Block 6327, Block Group 6, Census Tract 2527.02, Solano County, California",0,0,0
1000000US060952527026328,060952527026328,"Block 6328, Block Group 6, Census Tract 2527.02, Solano County, California",0,0,0
1000000US060952527026329,060952527026329,"Block 6329, Block Group 6, Census Tract 2527.02, Solano County, California",0,0,0
1000000US060952527026330,060952527026330,"Block 6330, Block Group 6, Census Tract 2527.02, Solano County, California",0,0,0
1000000US060952527026331,060952527026331,"Block 6331, Block Group 6, Census Tract 2527.02, Solano County, California",0,0,0
1000000US060952527026332,060952527026332,"Block 6332, Block Group 6, Census Tract 2527.02, Solano County, California",0,0,0
1000000US060952527026333,060952527026333,"Block 6333, Block Group 6, Census Tract 2527.02, Solano County, California",0,0,0
1000000US060952527026334,060952527026334,"Block 6334, Block Group 6, Census Tract 2527.02, Solano County, California",0,0,0
1000000US060952527026335,060952527026335,"Block 6335, Block Group 6, Census Tract 2527.02, Solano County, California",0,0,0
1000000US060952527026336,060952527026336,"Block 6336, Block Group 6, Census Tract 2527.02, Solano County, California",0,0,0
1000000US060952527026337,060952527026337,"Block 6337, Block Group 6, Census Tract 2527.02, Solano County, California",0,0,0
1000000US060952527026338,060952527026338,"Block 6338, Block Group 6, Census Tract 2527.02, Solano County, California",0,0,0
1000000US060952527026339,060952527026339,"Block 6339, Block Group 6, Census Tract 2527.02, Solano County, California",0,0,0
1000000US060952527026340,060952527026340,"Block 6340, Block Group 6, Census Tract 2527.02, Solano County, California",0,0,0
1000000US060952527026341,060952527026341,"Block 6341, Block Group 6, Census Tract 2527.02, Solano County, California",0,0,0
1000000US060952527026342,060952527026342,"Block 6342, Block Group 6, Census Tract 2527.02, Solano County, California",0,0,0
1000000US060952527026343,060952527026343,"Block 6343, Block Group 6, Census Tract 2527.02, Solano County, California",0,0,0
1000000US060952527026344,060952527026344,"Block 6344, Block Group 6, Census Tract 2527.02, Solano County, California",0,0,0
1000000US060952527026345,060952527026345,"Block 6345, Block Group 6, Census Tract 2527.02, Solano County, California",0,0,0
1000000US060952527026346,060952527026346,"Block 6346, Block Group 6, Census Tract 2527.02, Solano County, California",0,0,0
1000000US060952527026347,060952527026347,"Block 6347, Block Group 6, Census Tract 2527.02, Solano County, California",0,0,0
1000000US060952527026348,060952527026348,"Block 6348, Block Group 6, Census Tract 2527.02, Solano County, California",0,0,0
1000000US060952527026349,060952527026349,"Block 6349, Block Group 6, Census Tract 2527.02, Solano County, California",0,0,0
1000000US060952527026350,060952527026350,"Block 6350, Block Group 6, Census Tract 2527.02, Solano County, California",0,0,0
1000000US060952527026351,060952527026351,"Block 6351, Block Group 6, Census Tract 2527.02, Solano County, California",0,0,0
1000000US060952527026352,060952527026352,"Block 6352, Block Group 6, Census Tract 2527.02, Solano County, California",0,0,0
1000000US060952527026353,060952527026353,"Block 6353, Block Group 6, Census Tract 2527.02, Solano County, California",0,0,0
1000000US060952527026354,060952527026354,"Block 6354, Block Group 6, Census Tract 2527.02, Solano County, California",0,0,0
1000000US060952527026355,060952527026355,"Block 6355, Block Group 6, Census Tract 2527.02, Solano County, California",0,0,0
1000000US060952527026356,060952527026356,"Block 6356, Block Group 6, Census Tract 2527.02, Solano County, California",0,0,0
1000000US060952527026357,060952527026357,"Block 6357, Block Group 6, Census Tract 2527.02, Solano County, California",0,0,0
1000000US060952527026358,060952527026358,"Block 6358, Block Group 6, Census Tract 2527.02, Solano County, California",0,0,0
1000000US060952527026359,060952527026359,"Block 6359, Block Group 6, Census Tract 2527.02, Solano County, California",0,0,0
1000000US060952527026360,060952527026360,"Block 6360, Block Group 6, Census Tract 2527.02, Solano County, California",0,0,0
1000000US060952527026361,060952527026361,"Block 6361, Block Group 6, Census Tract 2527.02, Solano County, California",0,0,0
1000000US060952527026362,060952527026362,"Block 6362, Block Group 6, Census Tract 2527.02, Solano County, California",0,0,0
1000000US060952527026363,060952527026363,"Block 6363, Block Group 6, Census Tract 2527.02, Solano County, California",0,0,0
1000000US060952527026364,060952527026364,"Block 6364, Block Group 6, Census Tract 2527.02, Solano County, California",0,0,0
1000000US060952527026365,060952527026365,"Block 6365, Block Group 6, Census Tract 2527.02, Solano County, California",0,0,0
1000000US060952527026366,060952527026366,"Block 6366, Block Group 6, Census Tract 2527.02, Solano County, California",0,0,0
1000000US060952527026367,060952527026367,"Block 6367, Block Group 6, Census Tract 2527.02, Solano County, California",0,0,0
1000000US060952527026368,060952527026368,"Block 6368, Block Group 6, Census Tract 2527.02, Solano County, California",0,0,0
1000000US060952527026369,060952527026369,"Block 6369, Block Group 6, Census Tract 2527.02, Solano County, California",0,0,0
1000000US060952527026370,060952527026370,"Block 6370, Block Group 6, Census Tract 2527.02, Solano County, California",0,0,0
1000000US060952527026371,060952527026371,"Block 6371, Block Group 6, Census Tract 2527.02, Solano County, California",0,0,0
1000000US060952527026372,060952527026372,"Block 6372, Block Group 6, Census Tract 2527.02, Solano County, California",0,0,0
1000000US060952527026373,060952527026373,"Block 6373, Block Group 6, Census Tract 2527.02, Solano County, California",0,0,0
1000000US060952527026374,060952527026374,"Block 6374, Block Group 6, Census Tract 2527.02, Solano County, California",0,0,0
1000000US060952527026375,060952527026375,"Block 6375, Block Group 6, Census Tract 2527.02, Solano County, California",0,0,0
1000000US060952527026376,060952527026376,"Block 6376, Block Group 6, Census Tract 2527.02, Solano County, California",0,0,0
1000000US060952527026377,060952527026377,"Block 6377, Block Group 6, Census Tract 2527.02, Solano County, California",0,0,0
1000000US060952527026378,060952527026378,"Block 6378, Block Group 6, Census Tract 2527.02, Solano County, California",0,0,0
1000000US060952527026379,060952527026379,"Block 6379, Block Group 6, Census Tract 2527.02, Solano County, California",0,0,0
1000000US060952527026380,060952527026380,"Block 6380, Block Group 6, Census Tract 2527.02, Solano County, California",0,0,0
1000000US060952527026381,060952527026381,"Block 6381, Block Group 6, Census Tract 2527.02, Solano County, California",0,0,0
1000000US060952527026382,060952527026382,"Block 6382, Block Group 6, Census Tract 2527.02, Solano County, California",0,0,0
1000000US060952527026383,060952527026383,"Block 6383, Block Group 6, Census Tract 2527.02, Solano County, California",0,0,0
1000000US060952527026384,060952527026384,"Block 6384, Block Group 6, Census Tract 2527.02, Solano County, California",0,0,0
1000000US060952527026385,060952527026385,"Block 6385, Block Group 6, Census Tract 2527.02, Solano County, California",0,0,0
1000000US060952527026386,060952527026386,"Block 6386, Block Group 6, Census Tract 2527.02, Solano County, California",0,0,0
1000000US060952527026387,060952527026387,"Block 6387, Block Group 6, Census Tract 2527.02, Solano County, California",0,0,0
1000000US060952527026388,060952527026388,"Block 6388, Block Group 6, Census Tract 2527.02, Solano County, California",0,0,0
1000000US060952527026389,060952527026389,"Block 6389, Block Group 6, Census Tract 2527.02, Solano County, California",0,0,0
1000000US060952527026390,060952527026390,"Block 6390, Block Group 6, Census Tract 2527.02, Solano County, California",0,0,0
1000000US060952527026391,060952527026391,"Block 6391, Block Group 6, Census Tract 2527.02, Solano County, California",0,0,0
1000000US060952527026392,060952527026392,"Block 6392, Block Group 6, Census Tract 2527.02, Solano County, California",0,0,0
1000000US060952527026393,060952527026393,"Block 6393, Block Group 6, Census Tract 2527.02, Solano County, California",0,0,0
1000000US060952527026394,060952527026394,"Block 6394, Block Group 6, Census Tract 2527.02, Solano County, California",0,0,0
1000000US060952527026395,060952527026395,"Block 6395, Block Group 6, Census Tract 2527.02, Solano County, California",0,0,0
1000000US060952527026396,060952527026396,"Block 6396, Block Group 6, Census Tract 2527.02, Solano County, California",0,0,0
1000000US060952527026397,060952527026397,"Block 6397, Block Group 6, Census Tract 2527.02, Solano County, California",0,0,0
1000000US060952527026398,060952527026398,"Block 6398, Block Group 6, Census Tract 2527.02, Solano County, California",0,0,0
1000000US060952527026399,060952527026399,"Block 6399, Block Group 6, Census Tract 2527.02, Solano County, California",0,0,0
1000000US060952527026400,060952527026400,"Block 6400, Block Group 6, Census Tract 2527.02, Solano County, California",0,0,0
1000000US060952527026401,060952527026401,"Block 6401, Block Group 6, Census Tract 2527.02, Solano County, California",0,0,0
1000000US060952527026402,060952527026402,"Block 6402, Block Group 6, Census Tract 2527.02, Solano County, California",0,0,0
1000000US060952527026403,060952527026403,"Block 6403, Block Group 6, Census Tract 2527.02, Solano County, California",0,0,0
1000000US060952527026404,060952527026404,"Block 6404, Block Group 6, Census Tract 2527.02, Solano County, California",0,0,0
1000000US060952527026405,060952527026405,"Block 6405, Block Group 6, Census Tract 2527.02, Solano County, California",0,0,0
1000000US060952527026406,060952527026406,"Block 6406, Block Group 6, Census Tract 2527.02, Solano County, California",0,0,0
1000000US060952527026407,060952527026407,"Block 6407, Block Group 6, Census Tract 2527.02, Solano County, California",0,0,0
1000000US060952527026408,060952527026408,"Block 6408, Block Group 6, Census Tract 2527.02, Solano County, California",0,0,0
1000000US060952527026409,060952527026409,"Block 6409, Block Group 6, Census Tract 2527.02, Solano County, California",0,0,0
1000000US060952527026410,060952527026410,"Block 6410, Block Group 6, Census Tract 2527.02, Solano County, California",0,0,0
1000000US060952527026411,060952527026411,"Block 6411, Block Group 6, Census Tract 2527.02, Solano County, California",0,0,0
1000000US060952527026412,060952527026412,"Block 6412, Block Group 6, Census Tract 2527.02, Solano County, California",0,0,0
1000000US060952527026413,060952527026413,"Block 6413, Block Group 6, Census Tract 2527.02, Solano County, California",0,0,0
1000000US060952527026414,060952527026414,"Block 6414, Block Group 6, Census Tract 2527.02, Solano County, California",0,0,0
1000000US060952527026415,060952527026415,"Block 6415, Block Group 6, Census Tract 2527.02, Solano County, California",0,0,0
1000000US060952527026416,060952527026416,"Block 6416, Block Group 6, Census Tract 2527.02, Solano County, California",0,0,0
1000000US060952527026417,060952527026417,"Block 6417, Block Group 6, Census Tract 2527.02, Solano County, California",0,0,0
1000000US060952527026418,060952527026418,"Block 6418, Block Group 6, Census Tract 2527.02, Solano County, California",0,0,0
1000000US060952527026419,060952527026419,"Block 6419, Block Group 6, Census Tract 2527.02, Solano County, California",0,0,0
1000000US060952527026420,060952527026420,"Block 6420, Block Group 6, Census Tract 2527.02, Solano County, California",0,0,0
1000000US060952527026421,060952527026421,"Block 6421, Block Group 6, Census Tract 2527.02, Solano County, California",0,0,0
1000000US060952527026422,060952527026422,"Block 6422, Block Group 6, Census Tract 2527.02, Solano County, California",0,0,0
1000000US060952527026423,060952527026423,"Block 6423, Block Group 6, Census Tract 2527.02, Solano County, California",0,0,0
1000000US060952527026424,060952527026424,"Block 6424, Block Group 6, Census Tract 2527.02, Solano County, California",0,0,0
1000000US060952527026425,060952527026425,"Block 6425, Block Group 6, Census Tract 2527.02, Solano County, California",0,0,0
1000000US060952527026426,060952527026426,"Block 6426, Block Group 6, Census Tract 2527.02, Solano County, California",0,0,0
1000000US060952527026427,060952527026427,"Block 6427, Block Group 6, Census Tract 2527.02, Solano County, California",0,0,0
1000000US060952527026428,060952527026428,"Block 6428, Block Group 6, Census Tract 2527.02, Solano County, California",0,0,0
1000000US060952527026429,060952527026429,"Block 6429, Block Group 6, Census Tract 2527.02, Solano County, California",0,0,0
1000000US060952527026430,060952527026430,"Block 6430, Block Group 6, Census Tract 2527.02, Solano County, California",0,0,0
1000000US060952527026431,060952527026431,"Block 6431, Block Group 6, Census Tract 2527.02, Solano County, California",0,0,0
1000000US060952527026432,060952527026432,"Block 6432, Block Group 6, Census Tract 2527.02, Solano County, California",0,0,0
1000000US060952527026433,060952527026433,"Block 6433, Block Group 6, Census Tract 2527.02, Solano County, California",0,0,0
1000000US060952527026434,060952527026434,"Block 6434, Block Group 6, Census Tract 2527.02, Solano County, California",0,0,0
1000000US060952527026435,060952527026435,"Block 6435, Block Group 6, Census Tract 2527.02, Solano County, California",0,0,0
1000000US060952527026436,060952527026436,"Block 6436, Block Group 6, Census Tract 2527.02, Solano County, California",0,0,0
1000000US060952527026437,060952527026437,"Block 6437, Block Group 6, Census Tract 2527.02, Solano County, California",0,0,0
1000000US060952527026438,060952527026438,"Block 6438, Block Group 6, Census Tract 2527.02, Solano County, California",0,0,0
1000000US060952527031000,060952527031000,"Block 1000, Block Group 1, Census Tract 2527.03, Solano County, California",0,0,0
1000000US060952527031001,060952527031001,"Block 1001, Block Group 1, Census Tract 2527.03, Solano County, California",0,0,0
1000000US060952527031002,060952527031002,"Block 1002, Block Group 1, Census Tract 2527.03, Solano County, California",24,21,3
1000000US060952527031003,060952527031003,"Block 1003, Block Group 1, Census Tract 2527.03, Solano County, California",0,0,0
1000000US060952527031004,060952527031004,"Block 1004, Block Group 1, Census Tract 2527.03, Solano County, California",0,0,0
1000000US060952527031005,060952527031005,"Block 1005, Block Group 1, Census Tract 2527.03, Solano County, California",0,0,0
1000000US060952527031006,060952527031006,"Block 1006, Block Group 1, Census Tract 2527.03, Solano County, California",132,123,9
1000000US060952527031007,060952527031007,"Block 1007, Block Group 1, Census Tract 2527.03, Solano County, California",21,20,1
1000000US060952527031008,060952527031008,"Block 1008, Block Group 1, Census Tract 2527.03, Solano County, California",47,47,0
1000000US060952527031009,060952527031009,"Block 1009, Block Group 1, Census Tract 2527.03, Solano County, California",21,19,2
1000000US060952527031010,060952527031010,"Block 1010, Block Group 1, Census Tract 2527.03, Solano County, California",0,0,0
1000000US060952527031011,060952527031011,"Block 1011, Block Group 1, Census Tract 2527.03, Solano County, California",0,0,0
1000000US060952527031012,060952527031012,"Block 1012, Block Group 1, Census Tract 2527.03, Solano County, California",0,0,0
1000000US060952527031013,060952527031013,"Block 1013, Block Group 1, Census Tract 2527.03, Solano County, California",0,0,0
1000000US060952527031014,060952527031014,"Block 1014, Block Group 1, Census Tract 2527.03, Solano County, California",0,0,0
1000000US060952527031015,060952527031015,"Block 1015, Block Group 1, Census Tract 2527.03, Solano County, California",5,4,1
1000000US060952527031016,060952527031016,"Block 1016, Block Group 1, Census Tract 2527.03, Solano County, California",52,50,2
1000000US060952527031017,060952527031017,"Block 1017, Block Group 1, Census Tract 2527.03, Solano County, California",27,26,1
1000000US060952527031018,060952527031018,"Block 1018, Block Group 1, Census Tract 2527.03, Solano County, California",12,10,2
1000000US060952527032000,060952527032000,"Block 2000, Block Group 2, Census Tract 2527.03, Solano County, California",59,56,3
1000000US060952527032001,060952527032001,"Block 2001, Block Group 2, Census Tract 2527.03, Solano County, California",16,15,1
1000000US060952527032002,060952527032002,"Block 2002, Block Group 2, Census Tract 2527.03, Solano County, California",42,40,2
1000000US060952527032003,060952527032003,"Block 2003, Block Group 2, Census Tract 2527.03, Solano County, California",18,17,1
1000000US060952527032004,060952527032004,"Block 2004, Block Group 2, Census Tract 2527.03, Solano County, California",22,21,1
1000000US060952527032005,060952527032005,"Block 2005, Block Group 2, Census Tract 2527.03, Solano County, California",41,37,4
1000000US060952527032006,060952527032006,"Block 2006, Block Group 2, Census Tract 2527.03, Solano County, California",37,37,0
1000000US060952527032007,060952527032007,"Block 2007, Block Group 2, Census Tract 2527.03, Solano County, California",25,25,0
1000000US060952527032008,060952527032008,"Block 2008, Block Group 2, Census Tract 2527.03, Solano County, California",51,47,4
1000000US060952527032009,060952527032009,"Block 2009, Block Group 2, Census Tract 2527.03, Solano County, California",46,45,1
1000000US060952527032010,060952527032010,"Block 2010, Block Group 2, Census Tract 2527.03, Solano County, California",25,24,1
1000000US060952527032011,060952527032011,"Block 2011, Block Group 2, Census Tract 2527.03, Solano County, California",12,12,0
1000000US060952527032012,060952527032012,"Block 2012, Block Group 2, Census Tract 2527.03, Solano County, California",0,0,0
1000000US060952527032013,060952527032013,"Block 2013, Block Group 2, Census Tract 2527.03, Solano County, California",35,33,2
1000000US060952527032014,060952527032014,"Block 2014, Block Group 2, Census Tract 2527.03, Solano County, California",0,0,0
1000000US060952527032015,060952527032015,"Block 2015, Block Group 2, Census Tract 2527.03, Solano County, California",40,38,2
1000000US060952527032016,060952527032016,"Block 2016, Block Group 2, Census Tract 2527.03, Solano County, California",0,0,0
1000000US060952527032017,060952527032017,"Block 2017, Block Group 2, Census Tract 2527.03, Solano County, California",0,0,0
1000000US060952527032018,060952527032018,"Block 2018, Block Group 2, Census Tract 2527.03, Solano County, California",0,0,0
1000000US060952527032019,060952527032019,"Block 2019, Block Group 2, Census Tract 2527.03, Solano County, California",26,23,3
1000000US060952527032020,060952527032020,"Block 2020, Block Group 2, Census Tract 2527.03, Solano County, California",16,15,1
1000000US060952527033000,060952527033000,"Block 3000, Block Group 3, Census Tract 2527.03, Solano County, California",0,0,0
1000000US060952527033001,060952527033001,"Block 3001, Block Group 3, Census Tract 2527.03, Solano County, California",96,92,4
1000000US060952527033002,060952527033002,"Block 3002, Block Group 3, Census Tract 2527.03, Solano County, California",18,12,6
1000000US060952527033003,060952527033003,"Block 3003, Block Group 3, Census Tract 2527.03, Solano County, California",0,0,0
1000000US060952527033004,060952527033004,"Block 3004, Block Group 3, Census Tract 2527.03, Solano County, California",0,0,0
1000000US060952527033005,060952527033005,"Block 3005, Block Group 3, Census Tract 2527.03, Solano County, California",99,94,5
1000000US060952527033006,060952527033006,"Block 3006, Block Group 3, Census Tract 2527.03, Solano County, California",11,10,1
1000000US060952527033007,060952527033007,"Block 3007, Block Group 3, Census Tract 2527.03, Solano County, California",58,54,4
1000000US060952527033008,060952527033008,"Block 3008, Block Group 3, Census Tract 2527.03, Solano County, California",10,9,1
1000000US060952527033009,060952527033009,"Block 3009, Block Group 3, Census Tract 2527.03, Solano County, California",26,23,3
1000000US060952527033010,060952527033010,"Block 3010, Block Group 3, Census Tract 2527.03, Solano County, California",16,15,1
1000000US060952527033011,060952527033011,"Block 3011, Block Group 3, Census Tract 2527.03, Solano County, California",59,54,5
1000000US060952527033012,060952527033012,"Block 3012, Block Group 3, Census Tract 2527.03, Solano County, California",16,14,2
1000000US060952527033013,060952527033013,"Block 3013, Block Group 3, Census Tract 2527.03, Solano County, California",16,16,0
1000000US060952527041000,060952527041000,"Block 1000, Block Group 1, Census Tract 2527.04, Solano County, California",62,56,6
1000000US060952527041001,060952527041001,"Block 1001, Block Group 1, Census Tract 2527.04, Solano County, California",22,20,2
1000000US060952527041002,060952527041002,"Block 1002, Block Group 1, Census Tract 2527.04, Solano County, California",84,82,2
1000000US060952527041003,060952527041003,"Block 1003, Block Group 1, Census Tract 2527.04, Solano County, California",64,61,3
1000000US060952527041004,060952527041004,"Block 1004, Block Group 1, Census Tract 2527.04, Solano County, California",0,0,0
1000000US060952527041005,060952527041005,"Block 1005, Block Group 1, Census Tract 2527.04, Solano County, California",56,54,2
1000000US060952527041006,060952527041006,"Block 1006, Block Group 1, Census Tract 2527.04, Solano County, California",56,54,2
1000000US060952527041007,060952527041007,"Block 1007, Block Group 1, Census Tract 2527.04, Solano County, California",46,44,2
1000000US060952527041008,060952527041008,"Block 1008, Block Group 1, Census Tract 2527.04, Solano County, California",22,20,2
1000000US060952527042000,060952527042000,"Block 2000, Block Group 2, Census Tract 2527.04, Solano County, California",23,21,2
1000000US060952527042001,060952527042001,"Block 2001, Block Group 2, Census Tract 2527.04, Solano County, California",34,33,1
1000000US060952527042002,060952527042002,"Block 2002, Block Group 2, Census Tract 2527.04, Solano County, California",37,35,2
1000000US060952527042003,060952527042003,"Block 2003, Block Group 2, Census Tract 2527.04, Solano County, California",30,29,1
1000000US060952527042004,060952527042004,"Block 2004, Block Group 2, Census Tract 2527.04, Solano County, California",30,27,3
1000000US060952527042005,060952527042005,"Block 2005, Block Group 2, Census Tract 2527.04, Solano County, California",37,33,4
1000000US060952527042006,060952527042006,"Block 2006, Block Group 2, Census Tract 2527.04, Solano County, California",22,21,1
1000000US060952527042007,060952527042007,"Block 2007, Block Group 2, Census Tract 2527.04, Solano County, California",30,29,1
1000000US060952527043000,060952527043000,"Block 3000, Block Group 3, Census Tract 2527.04, Solano County, California",32,32,0
1000000US060952527043001,060952527043001,"Block 3001, Block Group 3, Census Tract 2527.04, Solano County, California",31,30,1
1000000US060952527043002,060952527043002,"Block 3002, Block Group 3, Census Tract 2527.04, Solano County, California",20,19,1
1000000US060952527043003,060952527043003,"Block 3003, Block Group 3, Census Tract 2527.04, Solano County, California",23,22,1
1000000US060952527043004,060952527043004,"Block 3004, Block Group 3, Census Tract 2527.04, Solano County, California",40,39,1
1000000US060952527043005,060952527043005,"Block 3005, Block Group 3, Census Tract 2527.04, Solano County, California",23,22,1
1000000US060952527043006,060952527043006,"Block 3006, Block Group 3, Census Tract 2527.04, Solano County, California",61,56,5
1000000US060952527043007,060952527043007,"Block 3007, Block Group 3, Census Tract 2527.04, Solano County, California",23,19,4
1000000US060952527043008,060952527043008,"Block 3008, Block Group 3, Census Tract 2527.04, Solano County, California",44,40,4
1000000US060952527044000,060952527044000,"Block 4000, Block Group 4, Census Tract 2527.04, Solano County, California",52,48,4
1000000US060952527044001,060952527044001,"Block 4001, Block Group 4, Census Tract 2527.04, Solano County, California",44,41,3
1000000US060952527044002,060952527044002,"Block 4002, Block Group 4, Census Tract 2527.04, Solano County, California",37,36,1
1000000US060952527044003,060952527044003,"Block 4003, Block Group 4, Census Tract 2527.04, Solano County, California",33,30,3
1000000US060952527044004,060952527044004,"Block 4004, Block Group 4, Census Tract 2527.04, Solano County, California",19,19,0
1000000US060952527044005,060952527044005,"Block 4005, Block Group 4, Census Tract 2527.04, Solano County, California",31,27,4
1000000US060952527044006,060952527044006,"Block 4006, Block Group 4, Census Tract 2527.04, Solano County, California",37,36,1
1000000US060952527045000,060952527045000,"Block 5000, Block Group 5, Census Tract 2527.04, Solano County, California",41,37,4
1000000US060952527045001,060952527045001,"Block 5001, Block Group 5, Census Tract 2527.04, Solano County, California",120,110,10
1000000US060952527045002,060952527045002,"Block 5002, Block Group 5, Census Tract 2527.04, Solano County, California",224,211,13
1000000US060952527045003,060952527045003,"Block 5003, Block Group 5, Census Tract 2527.04, Solano County, California",0,0,0
1000000US060952527045004,060952527045004,"Block 5004, Block Group 5, Census Tract 2527.04, Solano County, California",0,0,0
1000000US060952527045005,060952527045005,"Block 5005, Block Group 5, Census Tract 2527.04, Solano County, California",0,0,0
1000000US060952527045006,060952527045006,"Block 5006, Block Group 5, Census Tract 2527.04, Solano County, California",0,0,0
1000000US060952527045007,060952527045007,"Block 5007, Block Group 5, Census Tract 2527.04, Solano County, California",23,23,0
1000000US060952527045008,060952527045008,"Block 5008, Block Group 5, Census Tract 2527.04, Solano County, California",41,39,2
1000000US060952527045009,060952527045009,"Block 5009, Block Group 5, Census Tract 2527.04, Solano County, California",26,26,0
1000000US060952527045010,060952527045010,"Block 5010, Block Group 5, Census Tract 2527.04, Solano County, California",31,29,2
1000000US060952527045011,060952527045011,"Block 5011, Block Group 5, Census Tract 2527.04, Solano County, California",34,30,4
1000000US060952527045012,060952527045012,"Block 5012, Block Group 5, Census Tract 2527.04, Solano County, California",31,29,2
1000000US060952527045013,060952527045013,"Block 5013, Block Group 5, Census Tract 2527.04, Solano County, California",0,0,0
1000000US060952527045014,060952527045014,"Block 5014, Block Group 5, Census Tract 2527.04, Solano County, California",0,0,0
1000000US060952527051000,060952527051000,"Block 1000, Block Group 1, Census Tract 2527.05, Solano County, California",60,56,4
1000000US060952527051001,060952527051001,"Block 1001, Block Group 1, Census Tract 2527.05, Solano County, California",20,19,1
1000000US060952527051002,060952527051002,"Block 1002, Block Group 1, Census Tract 2527.05, Solano County, California",22,22,0
1000000US060952527051003,060952527051003,"Block 1003, Block Group 1, Census Tract 2527.05, Solano County, California",28,27,1
1000000US060952527051004,060952527051004,"Block 1004, Block Group 1, Census Tract 2527.05, Solano County, California",55,53,2
1000000US060952527051005,060952527051005,"Block 1005, Block Group 1, Census Tract 2527.05, Solano County, California",10,10,0
1000000US060952527051006,060952527051006,"Block 1006, Block Group 1, Census Tract 2527.05, Solano County, California",30,29,1
1000000US060952527051007,060952527051007,"Block 1007, Block Group 1, Census Tract 2527.05, Solano County, California",11,11,0
1000000US060952527051008,060952527051008,"Block 1008, Block Group 1, Census Tract 2527.05, Solano County, California",26,25,1
1000000US060952527051009,060952527051009,"Block 1009, Block Group 1, Census Tract 2527.05, Solano County, California",12,12,0
1000000US060952527051010,060952527051010,"Block 1010, Block Group 1, Census Tract 2527.05, Solano County, California",30,28,2
1000000US060952527051011,060952527051011,"Block 1011, Block Group 1, Census Tract 2527.05, Solano County, California",41,40,1
1000000US060952527052000,060952527052000,"Block 2000, Block Group 2, Census Tract 2527.05, Solano County, California",33,31,2
1000000US060952527052001,060952527052001,"Block 2001, Block Group 2, Census Tract 2527.05, Solano County, California",37,34,3
1000000US060952527052002,060952527052002,"Block 2002, Block Group 2, Census Tract 2527.05, Solano County, California",63,56,7
1000000US060952527052003,060952527052003,"Block 2003, Block Group 2, Census Tract 2527.05, Solano County, California",28,26,2
1000000US060952527052004,060952527052004,"Block 2004, Block Group 2, Census Tract 2527.05, Solano County, California",30,28,2
1000000US060952527052005,060952527052005,"Block 2005, Block Group 2, Census Tract 2527.05, Solano County, California",42,41,1
1000000US060952527052006,060952527052006,"Block 2006, Block Group 2, Census Tract 2527.05, Solano County, California",38,36,2
1000000US060952527052007,060952527052007,"Block 2007, Block Group 2, Census Tract 2527.05, Solano County, California",11,8,3
1000000US060952527053000,060952527053000,"Block 3000, Block Group 3, Census Tract 2527.05, Solano County, California",33,33,0
1000000US060952527053001,060952527053001,"Block 3001, Block Group 3, Census Tract 2527.05, Solano County, California",48,46,2
1000000US060952527053002,060952527053002,"Block 3002, Block Group 3, Census Tract 2527.05, Solano County, California",17,17,0
1000000US060952527053003,060952527053003,"Block 3003, Block Group 3, Census Tract 2527.05, Solano County, California",44,43,1
1000000US060952527053004,060952527053004,"Block 3004, Block Group 3, Census Tract 2527.05, Solano County, California",41,39,2
1000000US060952527053005,060952527053005,"Block 3005, Block Group 3, Census Tract 2527.05, Solano County, California",31,31,0
1000000US060952527053006,060952527053006,"Block 3006, Block Group 3, Census Tract 2527.05, Solano County, California",30,30,0
1000000US060952527053007,060952527053007,"Block 3007, Block Group 3, Census Tract 2527.05, Solano County, California",0,0,0
1000000US060952527054000,060952527054000,"Block 4000, Block Group 4, Census Tract 2527.05, Solano County, California",0,0,0
1000000US060952527054001,060952527054001,"Block 4001, Block Group 4, Census Tract 2527.05, Solano County, California",14,13,1
1000000US060952527054002,060952527054002,"Block 4002, Block Group 4, Census Tract 2527.05, Solano County, California",28,26,2
1000000US060952527054003,060952527054003,"Block 4003, Block Group 4, Census Tract 2527.05, Solano County, California",27,25,2
1000000US060952527054004,060952527054004,"Block 4004, Block Group 4, Census Tract 2527.05, Solano County, California",29,29,0
1000000US060952527054005,060952527054005,"Block 4005, Block Group 4, Census Tract 2527.05, Solano County, California",12,12,0
1000000US060952527054006,060952527054006,"Block 4006, Block Group 4, Census Tract 2527.05, Solano County, California",26,25,1
1000000US060952527054007,060952527054007,"Block 4007, Block Group 4, Census Tract 2527.05, Solano County, California",9,8,1
1000000US060952527054008,060952527054008,"Block 4008, Block Group 4, Census Tract 2527.05, Solano County, California",39,34,5
1000000US060952527054009,060952527054009,"Block 4009, Block Group 4, Census Tract 2527.05, Solano County, California",30,30,0
1000000US060952527054010,060952527054010,"Block 4010, Block Group 4, Census Tract 2527.05, Solano County, California",27,26,1
1000000US060952527054011,060952527054011,"Block 4011, Block Group 4, Census Tract 2527.05, Solano County, California",41,39,2
1000000US060952527054012,060952527054012,"Block 4012, Block Group 4, Census Tract 2527.05, Solano County, California",24,23,1
1000000US060952527054013,060952527054013,"Block 4013, Block Group 4, Census Tract 2527.05, Solano County, California",30,27,3
1000000US060952527054014,060952527054014,"Block 4014, Block Group 4, Census Tract 2527.05, Solano County, California",27,26,1
1000000US060952527054015,060952527054015,"Block 4015, Block Group 4, Census Tract 2527.05, Solano County, California",15,14,1
1000000US060952527054016,060952527054016,"Block 4016, Block Group 4, Census Tract 2527.05, Solano County, California",34,33,1
1000000US060952527054017,060952527054017,"Block 4017, Block Group 4, Census Tract 2527.05, Solano County, California",31,31,0
1000000US060952527054018,060952527054018,"Block 4018, Block Group 4, Census Tract 2527.05, Solano County, California",22,20,2
1000000US060952527054019,060952527054019,"Block 4019, Block Group 4, Census Tract 2527.05, Solano County, California",26,25,1
1000000US060952527054020,060952527054020,"Block 4020, Block Group 4, Census Tract 2527.05, Solano County, California",22,18,4
1000000US060952527054021,060952527054021,"Block 4021, Block Group 4, Census Tract 2527.05, Solano County, California",47,47,0
1000000US060952527054022,060952527054022,"Block 4022, Block Group 4, Census Tract 2527.05, Solano County, California",27,27,0
1000000US060952527054023,060952527054023,"Block 4023, Block Group 4, Census Tract 2527.05, Solano County, California",34,34,0
1000000US060952527054024,060952527054024,"Block 4024, Block Group 4, Census Tract 2527.05, Solano County, California",0,0,0
1000000US060952527055000,060952527055000,"Block 5000, Block Group 5, Census Tract 2527.05, Solano County, California",13,13,0
1000000US060952527055001,060952527055001,"Block 5001, Block Group 5, Census Tract 2527.05, Solano County, California",33,32,1
1000000US060952527055002,060952527055002,"Block 5002, Block Group 5, Census Tract 2527.05, Solano County, California",10,9,1
1000000US060952527055003,060952527055003,"Block 5003, Block Group 5, Census Tract 2527.05, Solano County, California",74,71,3
1000000US060952527055004,060952527055004,"Block 5004, Block Group 5, Census Tract 2527.05, Solano County, California",33,32,1
1000000US060952527055005,060952527055005,"Block 5005, Block Group 5, Census Tract 2527.05, Solano County, California",31,31,0
1000000US060952527055006,060952527055006,"Block 5006, Block Group 5, Census Tract 2527.05, Solano County, California",47,46,1
1000000US060952527055007,060952527055007,"Block 5007, Block Group 5, Census Tract 2527.05, Solano County, California",61,57,4
1000000US060952527055008,060952527055008,"Block 5008, Block Group 5, Census Tract 2527.05, Solano County, California",32,30,2
1000000US060952527055009,060952527055009,"Block 5009, Block Group 5, Census Tract 2527.05, Solano County, California",39,37,2
1000000US060952527055010,060952527055010,"Block 5010, Block Group 5, Census Tract 2527.05, Solano County, California",32,30,2
1000000US060952527061000,060952527061000,"Block 1000, Block Group 1, Census Tract 2527.06, Solano County, California",1,1,0
1000000US060952527061001,060952527061001,"Block 1001, Block Group 1, Census Tract 2527.06, Solano County, California",0,0,0
1000000US060952527061002,060952527061002,"Block 1002, Block Group 1, Census Tract 2527.06, Solano County, California",0,0,0
1000000US060952527061003,060952527061003,"Block 1003, Block Group 1, Census Tract 2527.06, Solano County, California",0,0,0
1000000US060952527061004,060952527061004,"Block 1004, Block Group 1, Census Tract 2527.06, Solano County, California",0,0,0
1000000US060952527061005,060952527061005,"Block 1005, Block Group 1, Census Tract 2527.06, Solano County, California",160,150,10
1000000US060952527061006,060952527061006,"Block 1006, Block Group 1, Census Tract 2527.06, Solano County, California",14,14,0
1000000US060952527061007,060952527061007,"Block 1007, Block Group 1, Census Tract 2527.06, Solano County, California",12,12,0
1000000US060952527061008,060952527061008,"Block 1008, Block Group 1, Census Tract 2527.06, Solano County, California",20,19,1
1000000US060952527061009,060952527061009,"Block 1009, Block Group 1, Census Tract 2527.06, Solano County, California",8,8,0
1000000US060952527061010,060952527061010,"Block 1010, Block Group 1, Census Tract 2527.06, Solano County, California",18,17,1
1000000US060952527061011,060952527061011,"Block 1011, Block Group 1, Census Tract 2527.06, Solano County, California",18,18,0
1000000US060952527061012,060952527061012,"Block 1012, Block Group 1, Census Tract 2527.06, Solano County, California",20,19,1
1000000US060952527061013,060952527061013,"Block 1013, Block Group 1, Census Tract 2527.06, Solano County, California",22,21,1
1000000US060952527061014,060952527061014,"Block 1014, Block Group 1, Census Tract 2527.06, Solano County, California",12,10,2
1000000US060952527061015,060952527061015,"Block 1015, Block Group 1, Census Tract 2527.06, Solano County, California",18,18,0
1000000US060952527061016,060952527061016,"Block 1016, Block Group 1, Census Tract 2527.06, Solano County, California",20,20,0
1000000US060952527061017,060952527061017,"Block 1017, Block Group 1, Census Tract 2527.06, Solano County, California",0,0,0
1000000US060952527061018,060952527061018,"Block 1018, Block Group 1, Census Tract 2527.06, Solano County, California",103,99,4
1000000US060952527061019,060952527061019,"Block 1019, Block Group 1, Census Tract 2527.06, Solano County, California",14,12,2
1000000US060952527061020,060952527061020,"Block 1020, Block Group 1, Census Tract 2527.06, Solano County, California",14,14,0
1000000US060952527061021,060952527061021,"Block 1021, Block Group 1, Census Tract 2527.06, Solano County, California",49,44,5
1000000US060952527061022,060952527061022,"Block 1022, Block Group 1, Census Tract 2527.06, Solano County, California",16,16,0
1000000US060952527061023,060952527061023,"Block 1023, Block Group 1, Census Tract 2527.06, Solano County, California",14,14,0
1000000US060952527061024,060952527061024,"Block 1024, Block Group 1, Census Tract 2527.06, Solano County, California",96,92,4
1000000US060952527061025,060952527061025,"Block 1025, Block Group 1, Census Tract 2527.06, Solano County, California",25,24,1
1000000US060952527061026,060952527061026,"Block 1026, Block Group 1, Census Tract 2527.06, Solano County, California",31,30,1
1000000US060952527061027,060952527061027,"Block 1027, Block Group 1, Census Tract 2527.06, Solano County, California",23,23,0
1000000US060952527061028,060952527061028,"Block 1028, Block Group 1, Census Tract 2527.06, Solano County, California",28,24,4
1000000US060952527061029,060952527061029,"Block 1029, Block Group 1, Census Tract 2527.06, Solano County, California",27,27,0
1000000US060952527061030,060952527061030,"Block 1030, Block Group 1, Census Tract 2527.06, Solano County, California",176,169,7
1000000US060952527061031,060952527061031,"Block 1031, Block Group 1, Census Tract 2527.06, Solano County, California",42,39,3
1000000US060952527061032,060952527061032,"Block 1032, Block Group 1, Census Tract 2527.06, Solano County, California",13,13,0
1000000US060952527061033,060952527061033,"Block 1033, Block Group 1, Census Tract 2527.06, Solano County, California",34,33,1
1000000US060952527061034,060952527061034,"Block 1034, Block Group 1, Census Tract 2527.06, Solano County, California",33,33,0
1000000US060952527061035,060952527061035,"Block 1035, Block Group 1, Census Tract 2527.06, Solano County, California",20,18,2
1000000US060952527061036,060952527061036,"Block 1036, Block Group 1, Census Tract 2527.06, Solano County, California",28,27,1
1000000US060952527061037,060952527061037,"Block 1037, Block Group 1, Census Tract 2527.06, Solano County, California",39,37,2
1000000US060952527061038,060952527061038,"Block 1038, Block Group 1, Census Tract 2527.06, Solano County, California",50,46,4
1000000US060952527061039,060952527061039,"Block 1039, Block Group 1, Census Tract 2527.06, Solano County, California",0,0,0
1000000US060952527061040,060952527061040,"Block 1040, Block Group 1, Census Tract 2527.06, Solano County, California",0,0,0
1000000US060952527061041,060952527061041,"Block 1041, Block Group 1, Census Tract 2527.06, Solano County, California",0,0,0
1000000US060952527061042,060952527061042,"Block 1042, Block Group 1, Census Tract 2527.06, Solano County, California",0,0,0
1000000US060952527061043,060952527061043,"Block 1043, Block Group 1, Census Tract 2527.06, Solano County, California",0,0,0
1000000US060952527061044,060952527061044,"Block 1044, Block Group 1, Census Tract 2527.06, Solano County, California",25,23,2
1000000US060952527071000,060952527071000,"Block 1000, Block Group 1, Census Tract 2527.07, Solano County, California",0,0,0
1000000US060952527071001,060952527071001,"Block 1001, Block Group 1, Census Tract 2527.07, Solano County, California",161,156,5
1000000US060952527071002,060952527071002,"Block 1002, Block Group 1, Census Tract 2527.07, Solano County, California",7,7,0
1000000US060952527071003,060952527071003,"Block 1003, Block Group 1, Census Tract 2527.07, Solano County, California",10,8,2
1000000US060952527071004,060952527071004,"Block 1004, Block Group 1, Census Tract 2527.07, Solano County, California",54,52,2
1000000US060952527071005,060952527071005,"Block 1005, Block Group 1, Census Tract 2527.07, Solano County, California",4,4,0
1000000US060952527071006,060952527071006,"Block 1006, Block Group 1, Census Tract 2527.07, Solano County, California",43,43,0
1000000US060952527071007,060952527071007,"Block 1007, Block Group 1, Census Tract 2527.07, Solano County, California",44,41,3
1000000US060952527071008,060952527071008,"Block 1008, Block Group 1, Census Tract 2527.07, Solano County, California",0,0,0
1000000US060952527071009,060952527071009,"Block 1009, Block Group 1, Census Tract 2527.07, Solano County, California",0,0,0
1000000US060952527071010,060952527071010,"Block 1010, Block Group 1, Census Tract 2527.07, Solano County, California",0,0,0
1000000US060952527071011,060952527071011,"Block 1011, Block Group 1, Census Tract 2527.07, Solano County, California",11,10,1
1000000US060952527071012,060952527071012,"Block 1012, Block Group 1, Census Tract 2527.07, Solano County, California",28,25,3
1000000US060952527071013,060952527071013,"Block 1013, Block Group 1, Census Tract 2527.07, Solano County, California",48,44,4
1000000US060952527071014,060952527071014,"Block 1014, Block Group 1, Census Tract 2527.07, Solano County, California",10,10,0
1000000US060952527071015,060952527071015,"Block 1015, Block Group 1, Census Tract 2527.07, Solano County, California",50,45,5
1000000US060952527071016,060952527071016,"Block 1016, Block Group 1, Census Tract 2527.07, Solano County, California",29,27,2
1000000US060952527071017,060952527071017,"Block 1017, Block Group 1, Census Tract 2527.07, Solano County, California",15,15,0
1000000US060952527071018,060952527071018,"Block 1018, Block Group 1, Census Tract 2527.07, Solano County, California",18,18,0
1000000US060952527071019,060952527071019,"Block 1019, Block Group 1, Census Tract 2527.07, Solano County, California",0,0,0
1000000US060952527071020,060952527071020,"Block 1020, Block Group 1, Census Tract 2527.07, Solano County, California",0,0,0
1000000US060952527071021,060952527071021,"Block 1021, Block Group 1, Census Tract 2527.07, Solano County, California",19,19,0
1000000US060952527071022,060952527071022,"Block 1022, Block Group 1, Census Tract 2527.07, Solano County, California",15,14,1
1000000US060952527071023,060952527071023,"Block 1023, Block Group 1, Census Tract 2527.07, Solano County, California",37,34,3
1000000US060952527071024,060952527071024,"Block 1024, Block Group 1, Census Tract 2527.07, Solano County, California",63,60,3
1000000US060952527071025,060952527071025,"Block 1025, Block Group 1, Census Tract 2527.07, Solano County, California",57,54,3
1000000US060952527071026,060952527071026,"Block 1026, Block Group 1, Census Tract 2527.07, Solano County, California",19,18,1
1000000US060952527071027,060952527071027,"Block 1027, Block Group 1, Census Tract 2527.07, Solano County, California",22,22,0
1000000US060952527071028,060952527071028,"Block 1028, Block Group 1, Census Tract 2527.07, Solano County, California",19,18,1
1000000US060952527072000,060952527072000,"Block 2000, Block Group 2, Census Tract 2527.07, Solano County, California",3,3,0
1000000US060952527072001,060952527072001,"Block 2001, Block Group 2, Census Tract 2527.07, Solano County, California",293,276,17
1000000US060952527072002,060952527072002,"Block 2002, Block Group 2, Census Tract 2527.07, Solano County, California",62,60,2
1000000US060952527072003,060952527072003,"Block 2003, Block Group 2, Census Tract 2527.07, Solano County, California",16,15,1
1000000US060952527072004,060952527072004,"Block 2004, Block Group 2, Census Tract 2527.07, Solano County, California",26,26,0
1000000US060952527072005,060952527072005,"Block 2005, Block Group 2, Census Tract 2527.07, Solano County, California",13,13,0
1000000US060952527072006,060952527072006,"Block 2006, Block Group 2, Census Tract 2527.07, Solano County, California",32,30,2
1000000US060952527072007,060952527072007,"Block 2007, Block Group 2, Census Tract 2527.07, Solano County, California",13,13,0
1000000US060952527072008,060952527072008,"Block 2008, Block Group 2, Census Tract 2527.07, Solano County, California",15,15,0
1000000US060952527072009,060952527072009,"Block 2009, Block Group 2, Census Tract 2527.07, Solano County, California",3,3,0
1000000US060952527072010,060952527072010,"Block 2010, Block Group 2, Census Tract 2527.07, Solano County, California",65,62,3
1000000US060952527072011,060952527072011,"Block 2011, Block Group 2, Census Tract 2527.07, Solano County, California",39,37,2
1000000US060952527072012,060952527072012,"Block 2012, Block Group 2, Census Tract 2527.07, Solano County, California",0,0,0
1000000US060952527072013,060952527072013,"Block 2013, Block Group 2, Census Tract 2527.07, Solano County, California",16,16,0
1000000US060952527072014,060952527072014,"Block 2014, Block Group 2, Census Tract 2527.07, Solano County, California",13,13,0
1000000US060952527072015,060952527072015,"Block 2015, Block Group 2, Census Tract 2527.07, Solano County, California",21,18,3
1000000US060952527072016,060952527072016,"Block 2016, Block Group 2, Census Tract 2527.07, Solano County, California",7,6,1
1000000US060952527072017,060952527072017,"Block 2017, Block Group 2, Census Tract 2527.07, Solano County, California",23,22,1
1000000US060952527072018,060952527072018,"Block 2018, Block Group 2, Census Tract 2527.07, Solano County, California",21,21,0
1000000US060952527072019,060952527072019,"Block 2019, Block Group 2, Census Tract 2527.07, Solano County, California",35,34,1
1000000US060952527072020,060952527072020,"Block 2020, Block Group 2, Census Tract 2527.07, Solano County, California",0,0,0
1000000US060952527072021,060952527072021,"Block 2021, Block Group 2, Census Tract 2527.07, Solano County, California",0,0,0
1000000US060952527073000,060952527073000,"Block 3000, Block Group 3, Census Tract 2527.07, Solano County, California",8,8,0
1000000US060952527073001,060952527073001,"Block 3001, Block Group 3, Census Tract 2527.07, Solano County, California",0,0,0
1000000US060952527073002,060952527073002,"Block 3002, Block Group 3, Census Tract 2527.07, Solano County, California",46,46,0
1000000US060952527073003,060952527073003,"Block 3003, Block Group 3, Census Tract 2527.07, Solano County, California",0,0,0
1000000US060952527073004,060952527073004,"Block 3004, Block Group 3, Census Tract 2527.07, Solano County, California",0,0,0
1000000US060952527073005,060952527073005,"Block 3005, Block Group 3, Census Tract 2527.07, Solano County, California",0,0,0
1000000US060952527073006,060952527073006,"Block 3006, Block Group 3, Census Tract 2527.07, Solano County, California",0,0,0
1000000US060952527073007,060952527073007,"Block 3007, Block Group 3, Census Tract 2527.07, Solano County, California",52,50,2
1000000US060952527073008,060952527073008,"Block 3008, Block Group 3, Census Tract 2527.07, Solano County, California",59,56,3
1000000US060952527073009,060952527073009,"Block 3009, Block Group 3, Census Tract 2527.07, Solano County, California",23,22,1
1000000US060952527073010,060952527073010,"Block 3010, Block Group 3, Census Tract 2527.07, Solano County, California",36,31,5
1000000US060952527073011,060952527073011,"Block 3011, Block Group 3, Census Tract 2527.07, Solano County, California",0,0,0
1000000US060952527073012,060952527073012,"Block 3012, Block Group 3, Census Tract 2527.07, Solano County, California",0,0,0
1000000US060952527073013,060952527073013,"Block 3013, Block Group 3, Census Tract 2527.07, Solano County, California",0,0,0
1000000US060952527073014,060952527073014,"Block 3014, Block Group 3, Census Tract 2527.07, Solano County, California",0,0,0
1000000US060952527073015,060952527073015,"Block 3015, Block Group 3, Census Tract 2527.07, Solano County, California",31,28,3
1000000US060952527073016,060952527073016,"Block 3016, Block Group 3, Census Tract 2527.07, Solano County, California",12,10,2
1000000US060952528011000,060952528011000,"Block 1000, Block Group 1, Census Tract 2528.01, Solano County, California",0,0,0
1000000US060952528011001,060952528011001,"Block 1001, Block Group 1, Census Tract 2528.01, Solano County, California",0,0,0
1000000US060952528011002,060952528011002,"Block 1002, Block Group 1, Census Tract 2528.01, Solano County, California",0,0,0
1000000US060952528011003,060952528011003,"Block 1003, Block Group 1, Census Tract 2528.01, Solano County, California",0,0,0
1000000US060952528011004,060952528011004,"Block 1004, Block Group 1, Census Tract 2528.01, Solano County, California",0,0,0
1000000US060952528011005,060952528011005,"Block 1005, Block Group 1, Census Tract 2528.01, Solano County, California",0,0,0
1000000US060952528011006,060952528011006,"Block 1006, Block Group 1, Census Tract 2528.01, Solano County, California",0,0,0
1000000US060952528011007,060952528011007,"Block 1007, Block Group 1, Census Tract 2528.01, Solano County, California",0,0,0
1000000US060952528011008,060952528011008,"Block 1008, Block Group 1, Census Tract 2528.01, Solano County, California",0,0,0
1000000US060952528011009,060952528011009,"Block 1009, Block Group 1, Census Tract 2528.01, Solano County, California",0,0,0
1000000US060952528011010,060952528011010,"Block 1010, Block Group 1, Census Tract 2528.01, Solano County, California",0,0,0
1000000US060952528011011,060952528011011,"Block 1011, Block Group 1, Census Tract 2528.01, Solano County, California",0,0,0
1000000US060952528012000,060952528012000,"Block 2000, Block Group 2, Census Tract 2528.01, Solano County, California",0,0,0
1000000US060952528012001,060952528012001,"Block 2001, Block Group 2, Census Tract 2528.01, Solano County, California",0,0,0
1000000US060952528012002,060952528012002,"Block 2002, Block Group 2, Census Tract 2528.01, Solano County, California",0,0,0
1000000US060952528012003,060952528012003,"Block 2003, Block Group 2, Census Tract 2528.01, Solano County, California",0,0,0
1000000US060952528012004,060952528012004,"Block 2004, Block Group 2, Census Tract 2528.01, Solano County, California",0,0,0
1000000US060952528012005,060952528012005,"Block 2005, Block Group 2, Census Tract 2528.01, Solano County, California",0,0,0
1000000US060952528012006,060952528012006,"Block 2006, Block Group 2, Census Tract 2528.01, Solano County, California",0,0,0
1000000US060952528012007,060952528012007,"Block 2007, Block Group 2, Census Tract 2528.01, Solano County, California",0,0,0
1000000US060952528012008,060952528012008,"Block 2008, Block Group 2, Census Tract 2528.01, Solano County, California",0,0,0
1000000US060952528012009,060952528012009,"Block 2009, Block Group 2, Census Tract 2528.01, Solano County, California",0,0,0
1000000US060952528012010,060952528012010,"Block 2010, Block Group 2, Census Tract 2528.01, Solano County, California",0,0,0
1000000US060952528012011,060952528012011,"Block 2011, Block Group 2, Census Tract 2528.01, Solano County, California",0,0,0
1000000US060952528012012,060952528012012,"Block 2012, Block Group 2, Census Tract 2528.01, Solano County, California",0,0,0
1000000US060952528012013,060952528012013,"Block 2013, Block Group 2, Census Tract 2528.01, Solano County, California",0,0,0
1000000US060952528012014,060952528012014,"Block 2014, Block Group 2, Census Tract 2528.01, Solano County, California",0,0,0
1000000US060952528012015,060952528012015,"Block 2015, Block Group 2, Census Tract 2528.01, Solano County, California",0,0,0
1000000US060952528012016,060952528012016,"Block 2016, Block Group 2, Census Tract 2528.01, Solano County, California",0,0,0
1000000US060952528012017,060952528012017,"Block 2017, Block Group 2, Census Tract 2528.01, Solano County, California",0,0,0
1000000US060952528012018,060952528012018,"Block 2018, Block Group 2, Census Tract 2528.01, Solano County, California",0,0,0
1000000US060952528012019,060952528012019,"Block 2019, Block Group 2, Census Tract 2528.01, Solano County, California",0,0,0
1000000US060952528013000,060952528013000,"Block 3000, Block Group 3, Census Tract 2528.01, Solano County, California",12,12,0
1000000US060952528013001,060952528013001,"Block 3001, Block Group 3, Census Tract 2528.01, Solano County, California",69,68,1
1000000US060952528013002,060952528013002,"Block 3002, Block Group 3, Census Tract 2528.01, Solano County, California",0,0,0
1000000US060952528013003,060952528013003,"Block 3003, Block Group 3, Census Tract 2528.01, Solano County, California",68,67,1
1000000US060952528013004,060952528013004,"Block 3004, Block Group 3, Census Tract 2528.01, Solano County, California",0,0,0
1000000US060952528013005,060952528013005,"Block 3005, Block Group 3, Census Tract 2528.01, Solano County, California",63,47,16
1000000US060952528013006,060952528013006,"Block 3006, Block Group 3, Census Tract 2528.01, Solano County, California",14,14,0
1000000US060952528013007,060952528013007,"Block 3007, Block Group 3, Census Tract 2528.01, Solano County, California",0,0,0
1000000US060952528013008,060952528013008,"Block 3008, Block Group 3, Census Tract 2528.01, Solano County, California",0,0,0
1000000US060952528013009,060952528013009,"Block 3009, Block Group 3, Census Tract 2528.01, Solano County, California",0,0,0
1000000US060952528013010,060952528013010,"Block 3010, Block Group 3, Census Tract 2528.01, Solano County, California",18,18,0
1000000US060952528014000,060952528014000,"Block 4000, Block Group 4, Census Tract 2528.01, Solano County, California",0,0,0
1000000US060952528014001,060952528014001,"Block 4001, Block Group 4, Census Tract 2528.01, Solano County, California",18,17,1
1000000US060952528014002,060952528014002,"Block 4002, Block Group 4, Census Tract 2528.01, Solano County, California",22,22,0
1000000US060952528014003,060952528014003,"Block 4003, Block Group 4, Census Tract 2528.01, Solano County, California",25,23,2
1000000US060952528014004,060952528014004,"Block 4004, Block Group 4, Census Tract 2528.01, Solano County, California",8,7,1
1000000US060952528014005,060952528014005,"Block 4005, Block Group 4, Census Tract 2528.01, Solano County, California",20,19,1
1000000US060952528014006,060952528014006,"Block 4006, Block Group 4, Census Tract 2528.01, Solano County, California",20,20,0
1000000US060952528014007,060952528014007,"Block 4007, Block Group 4, Census Tract 2528.01, Solano County, California",50,41,9
1000000US060952528014008,060952528014008,"Block 4008, Block Group 4, Census Tract 2528.01, Solano County, California",20,19,1
1000000US060952528014009,060952528014009,"Block 4009, Block Group 4, Census Tract 2528.01, Solano County, California",24,24,0
1000000US060952528014010,060952528014010,"Block 4010, Block Group 4, Census Tract 2528.01, Solano County, California",10,10,0
1000000US060952528014011,060952528014011,"Block 4011, Block Group 4, Census Tract 2528.01, Solano County, California",14,14,0
1000000US060952528014012,060952528014012,"Block 4012, Block Group 4, Census Tract 2528.01, Solano County, California",14,12,2
1000000US060952528014013,060952528014013,"Block 4013, Block Group 4, Census Tract 2528.01, Solano County, California",37,26,11
1000000US060952528014014,060952528014014,"Block 4014, Block Group 4, Census Tract 2528.01, Solano County, California",26,25,1
1000000US060952528014015,060952528014015,"Block 4015, Block Group 4, Census Tract 2528.01, Solano County, California",28,25,3
1000000US060952528014016,060952528014016,"Block 4016, Block Group 4, Census Tract 2528.01, Solano County, California",21,19,2
1000000US060952528014017,060952528014017,"Block 4017, Block Group 4, Census Tract 2528.01, Solano County, California",23,22,1
1000000US060952528015000,060952528015000,"Block 5000, Block Group 5, Census Tract 2528.01, Solano County, California",249,42,207
1000000US060952528015001,060952528015001,"Block 5001, Block Group 5, Census Tract 2528.01, Solano County, California",0,0,0
1000000US060952528015002,060952528015002,"Block 5002, Block Group 5, Census Tract 2528.01, Solano County, California",11,11,0
1000000US060952528015003,060952528015003,"Block 5003, Block Group 5, Census Tract 2528.01, Solano County, California",96,0,96
1000000US060952528015004,060952528015004,"Block 5004, Block Group 5, Census Tract 2528.01, Solano County, California",0,0,0
1000000US060952528015005,060952528015005,"Block 5005, Block Group 5, Census Tract 2528.01, Solano County, California",8,8,0
1000000US060952528015006,060952528015006,"Block 5006, Block Group 5, Census Tract 2528.01, Solano County, California",15,13,2
1000000US060952528015007,060952528015007,"Block 5007, Block Group 5, Census Tract 2528.01, Solano County, California",0,0,0
1000000US060952528015008,060952528015008,"Block 5008, Block Group 5, Census Tract 2528.01, Solano County, California",31,31,0
1000000US060952528015009,060952528015009,"Block 5009, Block Group 5, Census Tract 2528.01, Solano County, California",0,0,0
1000000US060952528015010,060952528015010,"Block 5010, Block Group 5, Census Tract 2528.01, Solano County, California",3,3,0
1000000US060952528015011,060952528015011,"Block 5011, Block Group 5, Census Tract 2528.01, Solano County, California",3,1,2
1000000US060952528015012,060952528015012,"Block 5012, Block Group 5, Census Tract 2528.01, Solano County, California",2,0,2
1000000US060952528015013,060952528015013,"Block 5013, Block Group 5, Census Tract 2528.01, Solano County, California",2,0,2
1000000US060952528015014,060952528015014,"Block 5014, Block Group 5, Census Tract 2528.01, Solano County, California",0,0,0
1000000US060952528015015,060952528015015,"Block 5015, Block Group 5, Census Tract 2528.01, Solano County, California",1,1,0
1000000US060952528021000,060952528021000,"Block 1000, Block Group 1, Census Tract 2528.02, Solano County, California",0,0,0
1000000US060952528021001,060952528021001,"Block 1001, Block Group 1, Census Tract 2528.02, Solano County, California",0,0,0
1000000US060952528021002,060952528021002,"Block 1002, Block Group 1, Census Tract 2528.02, Solano County, California",0,0,0
1000000US060952528021003,060952528021003,"Block 1003, Block Group 1, Census Tract 2528.02, Solano County, California",0,0,0
1000000US060952528021004,060952528021004,"Block 1004, Block Group 1, Census Tract 2528.02, Solano County, California",90,64,26
1000000US060952528021005,060952528021005,"Block 1005, Block Group 1, Census Tract 2528.02, Solano County, California",18,17,1
1000000US060952528021006,060952528021006,"Block 1006, Block Group 1, Census Tract 2528.02, Solano County, California",0,0,0
1000000US060952528021007,060952528021007,"Block 1007, Block Group 1, Census Tract 2528.02, Solano County, California",0,0,0
1000000US060952528021008,060952528021008,"Block 1008, Block Group 1, Census Tract 2528.02, Solano County, California",7,7,0
1000000US060952528021009,060952528021009,"Block 1009, Block Group 1, Census Tract 2528.02, Solano County, California",0,0,0
1000000US060952528021010,060952528021010,"Block 1010, Block Group 1, Census Tract 2528.02, Solano County, California",0,0,0
1000000US060952528021011,060952528021011,"Block 1011, Block Group 1, Census Tract 2528.02, Solano County, California",0,0,0
1000000US060952528021012,060952528021012,"Block 1012, Block Group 1, Census Tract 2528.02, Solano County, California",0,0,0
1000000US060952528021013,060952528021013,"Block 1013, Block Group 1, Census Tract 2528.02, Solano County, California",0,0,0
1000000US060952528021014,060952528021014,"Block 1014, Block Group 1, Census Tract 2528.02, Solano County, California",0,0,0
1000000US060952528021015,060952528021015,"Block 1015, Block Group 1, Census Tract 2528.02, Solano County, California",0,0,0
1000000US060952528021016,060952528021016,"Block 1016, Block Group 1, Census Tract 2528.02, Solano County, California",0,0,0
1000000US060952528021017,060952528021017,"Block 1017, Block Group 1, Census Tract 2528.02, Solano County, California",0,0,0
1000000US060952528021018,060952528021018,"Block 1018, Block Group 1, Census Tract 2528.02, Solano County, California",0,0,0
1000000US060952528021019,060952528021019,"Block 1019, Block Group 1, Census Tract 2528.02, Solano County, California",0,0,0
1000000US060952528021020,060952528021020,"Block 1020, Block Group 1, Census Tract 2528.02, Solano County, California",0,0,0
1000000US060952528021021,060952528021021,"Block 1021, Block Group 1, Census Tract 2528.02, Solano County, California",72,52,20
1000000US060952528021022,060952528021022,"Block 1022, Block Group 1, Census Tract 2528.02, Solano County, California",0,0,0
1000000US060952528021023,060952528021023,"Block 1023, Block Group 1, Census Tract 2528.02, Solano County, California",0,0,0
1000000US060952528021024,060952528021024,"Block 1024, Block Group 1, Census Tract 2528.02, Solano County, California",0,0,0
1000000US060952528021025,060952528021025,"Block 1025, Block Group 1, Census Tract 2528.02, Solano County, California",0,0,0
1000000US060952528021026,060952528021026,"Block 1026, Block Group 1, Census Tract 2528.02, Solano County, California",0,0,0
1000000US060952528021027,060952528021027,"Block 1027, Block Group 1, Census Tract 2528.02, Solano County, California",0,0,0
1000000US060952528021028,060952528021028,"Block 1028, Block Group 1, Census Tract 2528.02, Solano County, California",0,0,0
1000000US060952528021029,060952528021029,"Block 1029, Block Group 1, Census Tract 2528.02, Solano County, California",0,0,0
1000000US060952528021030,060952528021030,"Block 1030, Block Group 1, Census Tract 2528.02, Solano County, California",0,0,0
1000000US060952528021031,060952528021031,"Block 1031, Block Group 1, Census Tract 2528.02, Solano County, California",0,0,0
1000000US060952528021032,060952528021032,"Block 1032, Block Group 1, Census Tract 2528.02, Solano County, California",0,0,0
1000000US060952528021033,060952528021033,"Block 1033, Block Group 1, Census Tract 2528.02, Solano County, California",0,0,0
1000000US060952528021034,060952528021034,"Block 1034, Block Group 1, Census Tract 2528.02, Solano County, California",0,0,0
1000000US060952528021035,060952528021035,"Block 1035, Block Group 1, Census Tract 2528.02, Solano County, California",0,0,0
1000000US060952528021036,060952528021036,"Block 1036, Block Group 1, Census Tract 2528.02, Solano County, California",0,0,0
1000000US060952528021037,060952528021037,"Block 1037, Block Group 1, Census Tract 2528.02, Solano County, California",0,0,0
1000000US060952528021038,060952528021038,"Block 1038, Block Group 1, Census Tract 2528.02, Solano County, California",0,0,0
1000000US060952528021039,060952528021039,"Block 1039, Block Group 1, Census Tract 2528.02, Solano County, California",0,0,0
1000000US060952528021040,060952528021040,"Block 1040, Block Group 1, Census Tract 2528.02, Solano County, California",0,0,0
1000000US060952528021041,060952528021041,"Block 1041, Block Group 1, Census Tract 2528.02, Solano County, California",0,0,0
1000000US060952528021042,060952528021042,"Block 1042, Block Group 1, Census Tract 2528.02, Solano County, California",0,0,0
1000000US060952528021043,060952528021043,"Block 1043, Block Group 1, Census Tract 2528.02, Solano County, California",0,0,0
1000000US060952528021044,060952528021044,"Block 1044, Block Group 1, Census Tract 2528.02, Solano County, California",0,0,0
1000000US060952528021045,060952528021045,"Block 1045, Block Group 1, Census Tract 2528.02, Solano County, California",0,0,0
1000000US060952528021046,060952528021046,"Block 1046, Block Group 1, Census Tract 2528.02, Solano County, California",0,0,0
1000000US060952528021047,060952528021047,"Block 1047, Block Group 1, Census Tract 2528.02, Solano County, California",0,0,0
1000000US060952528021048,060952528021048,"Block 1048, Block Group 1, Census Tract 2528.02, Solano County, California",0,0,0
1000000US060952528021049,060952528021049,"Block 1049, Block Group 1, Census Tract 2528.02, Solano County, California",0,0,0
1000000US060952528021050,060952528021050,"Block 1050, Block Group 1, Census Tract 2528.02, Solano County, California",0,0,0
1000000US060952528021051,060952528021051,"Block 1051, Block Group 1, Census Tract 2528.02, Solano County, California",0,0,0
1000000US060952528021052,060952528021052,"Block 1052, Block Group 1, Census Tract 2528.02, Solano County, California",0,0,0
1000000US060952528021053,060952528021053,"Block 1053, Block Group 1, Census Tract 2528.02, Solano County, California",0,0,0
1000000US060952528021054,060952528021054,"Block 1054, Block Group 1, Census Tract 2528.02, Solano County, California",0,0,0
1000000US060952528022000,060952528022000,"Block 2000, Block Group 2, Census Tract 2528.02, Solano County, California",0,0,0
1000000US060952528022001,060952528022001,"Block 2001, Block Group 2, Census Tract 2528.02, Solano County, California",0,0,0
1000000US060952528022002,060952528022002,"Block 2002, Block Group 2, Census Tract 2528.02, Solano County, California",0,0,0
1000000US060952528022003,060952528022003,"Block 2003, Block Group 2, Census Tract 2528.02, Solano County, California",0,0,0
1000000US060952528022004,060952528022004,"Block 2004, Block Group 2, Census Tract 2528.02, Solano County, California",0,0,0
1000000US060952528022005,060952528022005,"Block 2005, Block Group 2, Census Tract 2528.02, Solano County, California",0,0,0
1000000US060952528022006,060952528022006,"Block 2006, Block Group 2, Census Tract 2528.02, Solano County, California",0,0,0
1000000US060952528022007,060952528022007,"Block 2007, Block Group 2, Census Tract 2528.02, Solano County, California",0,0,0
1000000US060952528022008,060952528022008,"Block 2008, Block Group 2, Census Tract 2528.02, Solano County, California",0,0,0
1000000US060952528022009,060952528022009,"Block 2009, Block Group 2, Census Tract 2528.02, Solano County, California",0,0,0
1000000US060952528022010,060952528022010,"Block 2010, Block Group 2, Census Tract 2528.02, Solano County, California",0,0,0
1000000US060952528022011,060952528022011,"Block 2011, Block Group 2, Census Tract 2528.02, Solano County, California",0,0,0
1000000US060952528022012,060952528022012,"Block 2012, Block Group 2, Census Tract 2528.02, Solano County, California",0,0,0
1000000US060952528022013,060952528022013,"Block 2013, Block Group 2, Census Tract 2528.02, Solano County, California",0,0,0
1000000US060952528022014,060952528022014,"Block 2014, Block Group 2, Census Tract 2528.02, Solano County, California",0,0,0
1000000US060952528022015,060952528022015,"Block 2015, Block Group 2, Census Tract 2528.02, Solano County, California",0,0,0
1000000US060952528022016,060952528022016,"Block 2016, Block Group 2, Census Tract 2528.02, Solano County, California",0,0,0
1000000US060952528022017,060952528022017,"Block 2017, Block Group 2, Census Tract 2528.02, Solano County, California",0,0,0
1000000US060952528022018,060952528022018,"Block 2018, Block Group 2, Census Tract 2528.02, Solano County, California",0,0,0
1000000US060952528022019,060952528022019,"Block 2019, Block Group 2, Census Tract 2528.02, Solano County, California",0,0,0
1000000US060952528022020,060952528022020,"Block 2020, Block Group 2, Census Tract 2528.02, Solano County, California",0,0,0
1000000US060952528022021,060952528022021,"Block 2021, Block Group 2, Census Tract 2528.02, Solano County, California",0,0,0
1000000US060952528022022,060952528022022,"Block 2022, Block Group 2, Census Tract 2528.02, Solano County, California",0,0,0
1000000US060952528022023,060952528022023,"Block 2023, Block Group 2, Census Tract 2528.02, Solano County, California",0,0,0
1000000US060952528022024,060952528022024,"Block 2024, Block Group 2, Census Tract 2528.02, Solano County, California",0,0,0
1000000US060952528022025,060952528022025,"Block 2025, Block Group 2, Census Tract 2528.02, Solano County, California",0,0,0
1000000US060952528022026,060952528022026,"Block 2026, Block Group 2, Census Tract 2528.02, Solano County, California",7,6,1
1000000US060952528022027,060952528022027,"Block 2027, Block Group 2, Census Tract 2528.02, Solano County, California",0,0,0
1000000US060952528022028,060952528022028,"Block 2028, Block Group 2, Census Tract 2528.02, Solano County, California",0,0,0
1000000US060952528022029,060952528022029,"Block 2029, Block Group 2, Census Tract 2528.02, Solano County, California",0,0,0
1000000US060952528022030,060952528022030,"Block 2030, Block Group 2, Census Tract 2528.02, Solano County, California",0,0,0
1000000US060952528022031,060952528022031,"Block 2031, Block Group 2, Census Tract 2528.02, Solano County, California",0,0,0
1000000US060952528022032,060952528022032,"Block 2032, Block Group 2, Census Tract 2528.02, Solano County, California",0,0,0
1000000US060952528022033,060952528022033,"Block 2033, Block Group 2, Census Tract 2528.02, Solano County, California",0,0,0
1000000US060952528022034,060952528022034,"Block 2034, Block Group 2, Census Tract 2528.02, Solano County, California",1,1,0
1000000US060952528022035,060952528022035,"Block 2035, Block Group 2, Census Tract 2528.02, Solano County, California",0,0,0
1000000US060952528022036,060952528022036,"Block 2036, Block Group 2, Census Tract 2528.02, Solano County, California",0,0,0
1000000US060952528022037,060952528022037,"Block 2037, Block Group 2, Census Tract 2528.02, Solano County, California",0,0,0
1000000US060952528022038,060952528022038,"Block 2038, Block Group 2, Census Tract 2528.02, Solano County, California",0,0,0
1000000US060952528022039,060952528022039,"Block 2039, Block Group 2, Census Tract 2528.02, Solano County, California",0,0,0
1000000US060952528022040,060952528022040,"Block 2040, Block Group 2, Census Tract 2528.02, Solano County, California",0,0,0
1000000US060952528022041,060952528022041,"Block 2041, Block Group 2, Census Tract 2528.02, Solano County, California",0,0,0
1000000US060952528022042,060952528022042,"Block 2042, Block Group 2, Census Tract 2528.02, Solano County, California",0,0,0
1000000US060952528022043,060952528022043,"Block 2043, Block Group 2, Census Tract 2528.02, Solano County, California",0,0,0
1000000US060952528022044,060952528022044,"Block 2044, Block Group 2, Census Tract 2528.02, Solano County, California",0,0,0
1000000US060952528022045,060952528022045,"Block 2045, Block Group 2, Census Tract 2528.02, Solano County, California",0,0,0
1000000US060952528022046,060952528022046,"Block 2046, Block Group 2, Census Tract 2528.02, Solano County, California",0,0,0
1000000US060952528022047,060952528022047,"Block 2047, Block Group 2, Census Tract 2528.02, Solano County, California",0,0,0
1000000US060952528022048,060952528022048,"Block 2048, Block Group 2, Census Tract 2528.02, Solano County, California",0,0,0
1000000US060952528022049,060952528022049,"Block 2049, Block Group 2, Census Tract 2528.02, Solano County, California",0,0,0
1000000US060952528022050,060952528022050,"Block 2050, Block Group 2, Census Tract 2528.02, Solano County, California",0,0,0
1000000US060952528022051,060952528022051,"Block 2051, Block Group 2, Census Tract 2528.02, Solano County, California",0,0,0
1000000US060952528022052,060952528022052,"Block 2052, Block Group 2, Census Tract 2528.02, Solano County, California",0,0,0
1000000US060952528022053,060952528022053,"Block 2053, Block Group 2, Census Tract 2528.02, Solano County, California",0,0,0
1000000US060952528022054,060952528022054,"Block 2054, Block Group 2, Census Tract 2528.02, Solano County, California",0,0,0
1000000US060952529031000,060952529031000,"Block 1000, Block Group 1, Census Tract 2529.03, Solano County, California",0,0,0
1000000US060952529031001,060952529031001,"Block 1001, Block Group 1, Census Tract 2529.03, Solano County, California",0,0,0
1000000US060952529031002,060952529031002,"Block 1002, Block Group 1, Census Tract 2529.03, Solano County, California",0,0,0
1000000US060952529031003,060952529031003,"Block 1003, Block Group 1, Census Tract 2529.03, Solano County, California",14,11,3
1000000US060952529031004,060952529031004,"Block 1004, Block Group 1, Census Tract 2529.03, Solano County, California",14,12,2
1000000US060952529031005,060952529031005,"Block 1005, Block Group 1, Census Tract 2529.03, Solano County, California",0,0,0
1000000US060952529031006,060952529031006,"Block 1006, Block Group 1, Census Tract 2529.03, Solano County, California",0,0,0
1000000US060952529031007,060952529031007,"Block 1007, Block Group 1, Census Tract 2529.03, Solano County, California",0,0,0
1000000US060952529031008,060952529031008,"Block 1008, Block Group 1, Census Tract 2529.03, Solano County, California",0,0,0
1000000US060952529031009,060952529031009,"Block 1009, Block Group 1, Census Tract 2529.03, Solano County, California",6,6,0
1000000US060952529031010,060952529031010,"Block 1010, Block Group 1, Census Tract 2529.03, Solano County, California",0,0,0
1000000US060952529031011,060952529031011,"Block 1011, Block Group 1, Census Tract 2529.03, Solano County, California",0,0,0
1000000US060952529031012,060952529031012,"Block 1012, Block Group 1, Census Tract 2529.03, Solano County, California",12,12,0
1000000US060952529031013,060952529031013,"Block 1013, Block Group 1, Census Tract 2529.03, Solano County, California",0,0,0
1000000US060952529031014,060952529031014,"Block 1014, Block Group 1, Census Tract 2529.03, Solano County, California",0,0,0
1000000US060952529031015,060952529031015,"Block 1015, Block Group 1, Census Tract 2529.03, Solano County, California",0,0,0
1000000US060952529031016,060952529031016,"Block 1016, Block Group 1, Census Tract 2529.03, Solano County, California",0,0,0
1000000US060952529031017,060952529031017,"Block 1017, Block Group 1, Census Tract 2529.03, Solano County, California",0,0,0
1000000US060952529031018,060952529031018,"Block 1018, Block Group 1, Census Tract 2529.03, Solano County, California",0,0,0
1000000US060952529031019,060952529031019,"Block 1019, Block Group 1, Census Tract 2529.03, Solano County, California",9,8,1
1000000US060952529031020,060952529031020,"Block 1020, Block Group 1, Census Tract 2529.03, Solano County, California",0,0,0
1000000US060952529031021,060952529031021,"Block 1021, Block Group 1, Census Tract 2529.03, Solano County, California",4,3,1
1000000US060952529031022,060952529031022,"Block 1022, Block Group 1, Census Tract 2529.03, Solano County, California",0,0,0
1000000US060952529031023,060952529031023,"Block 1023, Block Group 1, Census Tract 2529.03, Solano County, California",0,0,0
1000000US060952529031024,060952529031024,"Block 1024, Block Group 1, Census Tract 2529.03, Solano County, California",4,4,0
1000000US060952529031025,060952529031025,"Block 1025, Block Group 1, Census Tract 2529.03, Solano County, California",1,1,0
1000000US060952529031026,060952529031026,"Block 1026, Block Group 1, Census Tract 2529.03, Solano County, California",0,0,0
1000000US060952529031027,060952529031027,"Block 1027, Block Group 1, Census Tract 2529.03, Solano County, California",12,12,0
1000000US060952529031028,060952529031028,"Block 1028, Block Group 1, Census Tract 2529.03, Solano County, California",0,0,0
1000000US060952529031029,060952529031029,"Block 1029, Block Group 1, Census Tract 2529.03, Solano County, California",0,0,0
1000000US060952529031030,060952529031030,"Block 1030, Block Group 1, Census Tract 2529.03, Solano County, California",0,0,0
1000000US060952529031031,060952529031031,"Block 1031, Block Group 1, Census Tract 2529.03, Solano County, California",0,0,0
1000000US060952529031032,060952529031032,"Block 1032, Block Group 1, Census Tract 2529.03, Solano County, California",1,1,0
1000000US060952529031033,060952529031033,"Block 1033, Block Group 1, Census Tract 2529.03, Solano County, California",11,11,0
1000000US060952529031034,060952529031034,"Block 1034, Block Group 1, Census Tract 2529.03, Solano County, California",7,7,0
1000000US060952529031035,060952529031035,"Block 1035, Block Group 1, Census Tract 2529.03, Solano County, California",0,0,0
1000000US060952529031036,060952529031036,"Block 1036, Block Group 1, Census Tract 2529.03, Solano County, California",0,0,0
1000000US060952529031037,060952529031037,"Block 1037, Block Group 1, Census Tract 2529.03, Solano County, California",0,0,0
1000000US060952529031038,060952529031038,"Block 1038, Block Group 1, Census Tract 2529.03, Solano County, California",1,0,1
1000000US060952529031039,060952529031039,"Block 1039, Block Group 1, Census Tract 2529.03, Solano County, California",1,1,0
1000000US060952529031040,060952529031040,"Block 1040, Block Group 1, Census Tract 2529.03, Solano County, California",0,0,0
1000000US060952529031041,060952529031041,"Block 1041, Block Group 1, Census Tract 2529.03, Solano County, California",0,0,0
1000000US060952529031042,060952529031042,"Block 1042, Block Group 1, Census Tract 2529.03, Solano County, California",1,1,0
1000000US060952529031043,060952529031043,"Block 1043, Block Group 1, Census Tract 2529.03, Solano County, California",4,3,1
1000000US060952529031044,060952529031044,"Block 1044, Block Group 1, Census Tract 2529.03, Solano County, California",0,0,0
1000000US060952529031045,060952529031045,"Block 1045, Block Group 1, Census Tract 2529.03, Solano County, California",0,0,0
1000000US060952529031046,060952529031046,"Block 1046, Block Group 1, Census Tract 2529.03, Solano County, California",1,1,0
1000000US060952529031047,060952529031047,"Block 1047, Block Group 1, Census Tract 2529.03, Solano County, California",0,0,0
1000000US060952529031048,060952529031048,"Block 1048, Block Group 1, Census Tract 2529.03, Solano County, California",0,0,0
1000000US060952529031049,060952529031049,"Block 1049, Block Group 1, Census Tract 2529.03, Solano County, California",0,0,0
1000000US060952529031050,060952529031050,"Block 1050, Block Group 1, Census Tract 2529.03, Solano County, California",22,21,1
1000000US060952529031051,060952529031051,"Block 1051, Block Group 1, Census Tract 2529.03, Solano County, California",1,1,0
1000000US060952529031052,060952529031052,"Block 1052, Block Group 1, Census Tract 2529.03, Solano County, California",0,0,0
1000000US060952529031053,060952529031053,"Block 1053, Block Group 1, Census Tract 2529.03, Solano County, California",0,0,0
1000000US060952529031054,060952529031054,"Block 1054, Block Group 1, Census Tract 2529.03, Solano County, California",0,0,0
1000000US060952529031055,060952529031055,"Block 1055, Block Group 1, Census Tract 2529.03, Solano County, California",0,0,0
1000000US060952529031056,060952529031056,"Block 1056, Block Group 1, Census Tract 2529.03, Solano County, California",0,0,0
1000000US060952529031057,060952529031057,"Block 1057, Block Group 1, Census Tract 2529.03, Solano County, California",2,2,0
1000000US060952529031058,060952529031058,"Block 1058, Block Group 1, Census Tract 2529.03, Solano County, California",0,0,0
1000000US060952529031059,060952529031059,"Block 1059, Block Group 1, Census Tract 2529.03, Solano County, California",7,7,0
1000000US060952529031060,060952529031060,"Block 1060, Block Group 1, Census Tract 2529.03, Solano County, California",1,1,0
1000000US060952529031061,060952529031061,"Block 1061, Block Group 1, Census Tract 2529.03, Solano County, California",0,0,0
1000000US060952529031062,060952529031062,"Block 1062, Block Group 1, Census Tract 2529.03, Solano County, California",0,0,0
1000000US060952529031063,060952529031063,"Block 1063, Block Group 1, Census Tract 2529.03, Solano County, California",0,0,0
1000000US060952529031064,060952529031064,"Block 1064, Block Group 1, Census Tract 2529.03, Solano County, California",9,9,0
1000000US060952529031065,060952529031065,"Block 1065, Block Group 1, Census Tract 2529.03, Solano County, California",1,1,0
1000000US060952529031066,060952529031066,"Block 1066, Block Group 1, Census Tract 2529.03, Solano County, California",0,0,0
1000000US060952529031067,060952529031067,"Block 1067, Block Group 1, Census Tract 2529.03, Solano County, California",0,0,0
1000000US060952529031068,060952529031068,"Block 1068, Block Group 1, Census Tract 2529.03, Solano County, California",0,0,0
1000000US060952529031069,060952529031069,"Block 1069, Block Group 1, Census Tract 2529.03, Solano County, California",0,0,0
1000000US060952529031070,060952529031070,"Block 1070, Block Group 1, Census Tract 2529.03, Solano County, California",0,0,0
1000000US060952529031071,060952529031071,"Block 1071, Block Group 1, Census Tract 2529.03, Solano County, California",0,0,0
1000000US060952529031072,060952529031072,"Block 1072, Block Group 1, Census Tract 2529.03, Solano County, California",1,1,0
1000000US060952529031073,060952529031073,"Block 1073, Block Group 1, Census Tract 2529.03, Solano County, California",0,0,0
1000000US060952529031074,060952529031074,"Block 1074, Block Group 1, Census Tract 2529.03, Solano County, California",0,0,0
1000000US060952529031075,060952529031075,"Block 1075, Block Group 1, Census Tract 2529.03, Solano County, California",0,0,0
1000000US060952529031076,060952529031076,"Block 1076, Block Group 1, Census Tract 2529.03, Solano County, California",97,91,6
1000000US060952529031077,060952529031077,"Block 1077, Block Group 1, Census Tract 2529.03, Solano County, California",1,1,0
1000000US060952529031078,060952529031078,"Block 1078, Block Group 1, Census Tract 2529.03, Solano County, California",0,0,0
1000000US060952529031079,060952529031079,"Block 1079, Block Group 1, Census Tract 2529.03, Solano County, California",0,0,0
1000000US060952529031080,060952529031080,"Block 1080, Block Group 1, Census Tract 2529.03, Solano County, California",1,1,0
1000000US060952529031081,060952529031081,"Block 1081, Block Group 1, Census Tract 2529.03, Solano County, California",0,0,0
1000000US060952529031082,060952529031082,"Block 1082, Block Group 1, Census Tract 2529.03, Solano County, California",0,0,0
1000000US060952529031083,060952529031083,"Block 1083, Block Group 1, Census Tract 2529.03, Solano County, California",1,1,0
1000000US060952529031084,060952529031084,"Block 1084, Block Group 1, Census Tract 2529.03, Solano County, California",2,2,0
1000000US060952529031085,060952529031085,"Block 1085, Block Group 1, Census Tract 2529.03, Solano County, California",2,1,1
1000000US060952529031086,060952529031086,"Block 1086, Block Group 1, Census Tract 2529.03, Solano County, California",2,2,0
1000000US060952529031087,060952529031087,"Block 1087, Block Group 1, Census Tract 2529.03, Solano County, California",0,0,0
1000000US060952529031088,060952529031088,"Block 1088, Block Group 1, Census Tract 2529.03, Solano County, California",2,2,0
1000000US060952529031089,060952529031089,"Block 1089, Block Group 1, Census Tract 2529.03, Solano County, California",0,0,0
1000000US060952529031090,060952529031090,"Block 1090, Block Group 1, Census Tract 2529.03, Solano County, California",1,1,0
1000000US060952529031091,060952529031091,"Block 1091, Block Group 1, Census Tract 2529.03, Solano County, California",1,1,0
1000000US060952529031092,060952529031092,"Block 1092, Block Group 1, Census Tract 2529.03, Solano County, California",3,3,0
1000000US060952529031093,060952529031093,"Block 1093, Block Group 1, Census Tract 2529.03, Solano County, California",0,0,0
1000000US060952529031094,060952529031094,"Block 1094, Block Group 1, Census Tract 2529.03, Solano County, California",0,0,0
1000000US060952529031095,060952529031095,"Block 1095, Block Group 1, Census Tract 2529.03, Solano County, California",0,0,0
1000000US060952529031096,060952529031096,"Block 1096, Block Group 1, Census Tract 2529.03, Solano County, California",0,0,0
1000000US060952529031097,060952529031097,"Block 1097, Block Group 1, Census Tract 2529.03, Solano County, California",0,0,0
1000000US060952529031098,060952529031098,"Block 1098, Block Group 1, Census Tract 2529.03, Solano County, California",0,0,0
1000000US060952529031099,060952529031099,"Block 1099, Block Group 1, Census Tract 2529.03, Solano County, California",0,0,0
1000000US060952529031100,060952529031100,"Block 1100, Block Group 1, Census Tract 2529.03, Solano County, California",0,0,0
1000000US060952529031101,060952529031101,"Block 1101, Block Group 1, Census Tract 2529.03, Solano County, California",0,0,0
1000000US060952529031102,060952529031102,"Block 1102, Block Group 1, Census Tract 2529.03, Solano County, California",0,0,0
1000000US060952529031103,060952529031103,"Block 1103, Block Group 1, Census Tract 2529.03, Solano County, California",0,0,0
1000000US060952529031104,060952529031104,"Block 1104, Block Group 1, Census Tract 2529.03, Solano County, California",0,0,0
1000000US060952529031105,060952529031105,"Block 1105, Block Group 1, Census Tract 2529.03, Solano County, California",0,0,0
1000000US060952529031106,060952529031106,"Block 1106, Block Group 1, Census Tract 2529.03, Solano County, California",0,0,0
1000000US060952529031107,060952529031107,"Block 1107, Block Group 1, Census Tract 2529.03, Solano County, California",0,0,0
1000000US060952529031108,060952529031108,"Block 1108, Block Group 1, Census Tract 2529.03, Solano County, California",0,0,0
1000000US060952529031109,060952529031109,"Block 1109, Block Group 1, Census Tract 2529.03, Solano County, California",0,0,0
1000000US060952529031110,060952529031110,"Block 1110, Block Group 1, Census Tract 2529.03, Solano County, California",43,39,4
1000000US060952529031111,060952529031111,"Block 1111, Block Group 1, Census Tract 2529.03, Solano County, California",0,0,0
1000000US060952529031112,060952529031112,"Block 1112, Block Group 1, Census Tract 2529.03, Solano County, California",16,15,1
1000000US060952529031113,060952529031113,"Block 1113, Block Group 1, Census Tract 2529.03, Solano County, California",0,0,0
1000000US060952529031114,060952529031114,"Block 1114, Block Group 1, Census Tract 2529.03, Solano County, California",13,13,0
1000000US060952529031115,060952529031115,"Block 1115, Block Group 1, Census Tract 2529.03, Solano County, California",6,3,3
1000000US060952529031116,060952529031116,"Block 1116, Block Group 1, Census Tract 2529.03, Solano County, California",1,1,0
1000000US060952529031117,060952529031117,"Block 1117, Block Group 1, Census Tract 2529.03, Solano County, California",0,0,0
1000000US060952529031118,060952529031118,"Block 1118, Block Group 1, Census Tract 2529.03, Solano County, California",0,0,0
1000000US060952529031119,060952529031119,"Block 1119, Block Group 1, Census Tract 2529.03, Solano County, California",2,2,0
1000000US060952529031120,060952529031120,"Block 1120, Block Group 1, Census Tract 2529.03, Solano County, California",1,1,0
1000000US060952529031121,060952529031121,"Block 1121, Block Group 1, Census Tract 2529.03, Solano County, California",0,0,0
1000000US060952529031122,060952529031122,"Block 1122, Block Group 1, Census Tract 2529.03, Solano County, California",0,0,0
1000000US060952529031123,060952529031123,"Block 1123, Block Group 1, Census Tract 2529.03, Solano County, California",0,0,0
1000000US060952529031124,060952529031124,"Block 1124, Block Group 1, Census Tract 2529.03, Solano County, California",0,0,0
1000000US060952529031125,060952529031125,"Block 1125, Block Group 1, Census Tract 2529.03, Solano County, California",0,0,0
1000000US060952529031126,060952529031126,"Block 1126, Block Group 1, Census Tract 2529.03, Solano County, California",0,0,0
1000000US060952529031127,060952529031127,"Block 1127, Block Group 1, Census Tract 2529.03, Solano County, California",0,0,0
1000000US060952529031128,060952529031128,"Block 1128, Block Group 1, Census Tract 2529.03, Solano County, California",1,1,0
1000000US060952529031129,060952529031129,"Block 1129, Block Group 1, Census Tract 2529.03, Solano County, California",0,0,0
1000000US060952529031130,060952529031130,"Block 1130, Block Group 1, Census Tract 2529.03, Solano County, California",5,5,0
1000000US060952529031131,060952529031131,"Block 1131, Block Group 1, Census Tract 2529.03, Solano County, California",2,1,1
1000000US060952529031132,060952529031132,"Block 1132, Block Group 1, Census Tract 2529.03, Solano County, California",0,0,0
1000000US060952529031133,060952529031133,"Block 1133, Block Group 1, Census Tract 2529.03, Solano County, California",0,0,0
1000000US060952529031134,060952529031134,"Block 1134, Block Group 1, Census Tract 2529.03, Solano County, California",0,0,0
1000000US060952529032000,060952529032000,"Block 2000, Block Group 2, Census Tract 2529.03, Solano County, California",163,158,5
1000000US060952529032001,060952529032001,"Block 2001, Block Group 2, Census Tract 2529.03, Solano County, California",14,12,2
1000000US060952529032002,060952529032002,"Block 2002, Block Group 2, Census Tract 2529.03, Solano County, California",0,0,0
1000000US060952529032003,060952529032003,"Block 2003, Block Group 2, Census Tract 2529.03, Solano County, California",1,1,0
1000000US060952529032004,060952529032004,"Block 2004, Block Group 2, Census Tract 2529.03, Solano County, California",1,1,0
1000000US060952529032005,060952529032005,"Block 2005, Block Group 2, Census Tract 2529.03, Solano County, California",0,0,0
1000000US060952529032006,060952529032006,"Block 2006, Block Group 2, Census Tract 2529.03, Solano County, California",0,0,0
1000000US060952529032007,060952529032007,"Block 2007, Block Group 2, Census Tract 2529.03, Solano County, California",0,0,0
1000000US060952529032008,060952529032008,"Block 2008, Block Group 2, Census Tract 2529.03, Solano County, California",0,0,0
1000000US060952529032009,060952529032009,"Block 2009, Block Group 2, Census Tract 2529.03, Solano County, California",0,0,0
1000000US060952529032010,060952529032010,"Block 2010, Block Group 2, Census Tract 2529.03, Solano County, California",0,0,0
1000000US060952529032011,060952529032011,"Block 2011, Block Group 2, Census Tract 2529.03, Solano County, California",0,0,0
1000000US060952529032012,060952529032012,"Block 2012, Block Group 2, Census Tract 2529.03, Solano County, California",0,0,0
1000000US060952529032013,060952529032013,"Block 2013, Block Group 2, Census Tract 2529.03, Solano County, California",9,9,0
1000000US060952529032014,060952529032014,"Block 2014, Block Group 2, Census Tract 2529.03, Solano County, California",1,1,0
1000000US060952529032015,060952529032015,"Block 2015, Block Group 2, Census Tract 2529.03, Solano County, California",22,22,0
1000000US060952529032016,060952529032016,"Block 2016, Block Group 2, Census Tract 2529.03, Solano County, California",1,1,0
1000000US060952529032017,060952529032017,"Block 2017, Block Group 2, Census Tract 2529.03, Solano County, California",0,0,0
1000000US060952529032018,060952529032018,"Block 2018, Block Group 2, Census Tract 2529.03, Solano County, California",0,0,0
1000000US060952529032019,060952529032019,"Block 2019, Block Group 2, Census Tract 2529.03, Solano County, California",30,26,4
1000000US060952529032020,060952529032020,"Block 2020, Block Group 2, Census Tract 2529.03, Solano County, California",0,0,0
1000000US060952529032021,060952529032021,"Block 2021, Block Group 2, Census Tract 2529.03, Solano County, California",0,0,0
1000000US060952529032022,060952529032022,"Block 2022, Block Group 2, Census Tract 2529.03, Solano County, California",1,1,0
1000000US060952529032023,060952529032023,"Block 2023, Block Group 2, Census Tract 2529.03, Solano County, California",2,2,0
1000000US060952529032024,060952529032024,"Block 2024, Block Group 2, Census Tract 2529.03, Solano County, California",0,0,0
1000000US060952529032025,060952529032025,"Block 2025, Block Group 2, Census Tract 2529.03, Solano County, California",0,0,0
1000000US060952529032026,060952529032026,"Block 2026, Block Group 2, Census Tract 2529.03, Solano County, California",18,18,0
1000000US060952529032027,060952529032027,"Block 2027, Block Group 2, Census Tract 2529.03, Solano County, California",13,12,1
1000000US060952529032028,060952529032028,"Block 2028, Block Group 2, Census Tract 2529.03, Solano County, California",0,0,0
1000000US060952529032029,060952529032029,"Block 2029, Block Group 2, Census Tract 2529.03, Solano County, California",0,0,0
1000000US060952529032030,060952529032030,"Block 2030, Block Group 2, Census Tract 2529.03, Solano County, California",0,0,0
1000000US060952529032031,060952529032031,"Block 2031, Block Group 2, Census Tract 2529.03, Solano County, California",0,0,0
1000000US060952529032032,060952529032032,"Block 2032, Block Group 2, Census Tract 2529.03, Solano County, California",9,8,1
1000000US060952529032033,060952529032033,"Block 2033, Block Group 2, Census Tract 2529.03, Solano County, California",0,0,0
1000000US060952529032034,060952529032034,"Block 2034, Block Group 2, Census Tract 2529.03, Solano County, California",37,37,0
1000000US060952529032035,060952529032035,"Block 2035, Block Group 2, Census Tract 2529.03, Solano County, California",0,0,0
1000000US060952529032036,060952529032036,"Block 2036, Block Group 2, Census Tract 2529.03, Solano County, California",1,1,0
1000000US060952529032037,060952529032037,"Block 2037, Block Group 2, Census Tract 2529.03, Solano County, California",3,3,0
1000000US060952529032038,060952529032038,"Block 2038, Block Group 2, Census Tract 2529.03, Solano County, California",23,21,2
1000000US060952529032039,060952529032039,"Block 2039, Block Group 2, Census Tract 2529.03, Solano County, California",0,0,0
1000000US060952529032040,060952529032040,"Block 2040, Block Group 2, Census Tract 2529.03, Solano County, California",0,0,0
1000000US060952529032041,060952529032041,"Block 2041, Block Group 2, Census Tract 2529.03, Solano County, California",0,0,0
1000000US060952529033000,060952529033000,"Block 3000, Block Group 3, Census Tract 2529.03, Solano County, California",41,39,2
1000000US060952529033001,060952529033001,"Block 3001, Block Group 3, Census Tract 2529.03, Solano County, California",28,28,0
1000000US060952529033002,060952529033002,"Block 3002, Block Group 3, Census Tract 2529.03, Solano County, California",3,2,1
1000000US060952529033003,060952529033003,"Block 3003, Block Group 3, Census Tract 2529.03, Solano County, California",7,7,0
1000000US060952529033004,060952529033004,"Block 3004, Block Group 3, Census Tract 2529.03, Solano County, California",29,25,4
1000000US060952529033005,060952529033005,"Block 3005, Block Group 3, Census Tract 2529.03, Solano County, California",32,31,1
1000000US060952529033006,060952529033006,"Block 3006, Block Group 3, Census Tract 2529.03, Solano County, California",24,24,0
1000000US060952529033007,060952529033007,"Block 3007, Block Group 3, Census Tract 2529.03, Solano County, California",1,1,0
1000000US060952529033008,060952529033008,"Block 3008, Block Group 3, Census Tract 2529.03, Solano County, California",34,33,1
1000000US060952529033009,060952529033009,"Block 3009, Block Group 3, Census Tract 2529.03, Solano County, California",13,13,0
1000000US060952529033010,060952529033010,"Block 3010, Block Group 3, Census Tract 2529.03, Solano County, California",8,8,0
1000000US060952529033011,060952529033011,"Block 3011, Block Group 3, Census Tract 2529.03, Solano County, California",25,23,2
1000000US060952529033012,060952529033012,"Block 3012, Block Group 3, Census Tract 2529.03, Solano County, California",6,6,0
1000000US060952529033013,060952529033013,"Block 3013, Block Group 3, Census Tract 2529.03, Solano County, California",42,42,0
1000000US060952529033014,060952529033014,"Block 3014, Block Group 3, Census Tract 2529.03, Solano County, California",2,2,0
1000000US060952529033015,060952529033015,"Block 3015, Block Group 3, Census Tract 2529.03, Solano County, California",11,11,0
1000000US060952529033016,060952529033016,"Block 3016, Block Group 3, Census Tract 2529.03, Solano County, California",0,0,0
1000000US060952529033017,060952529033017,"Block 3017, Block Group 3, Census Tract 2529.03, Solano County, California",0,0,0
1000000US060952529033018,060952529033018,"Block 3018, Block Group 3, Census Tract 2529.03, Solano County, California",7,7,0
1000000US060952529033019,060952529033019,"Block 3019, Block Group 3, Census Tract 2529.03, Solano County, California",14,13,1
1000000US060952529033020,060952529033020,"Block 3020, Block Group 3, Census Tract 2529.03, Solano County, California",1,1,0
1000000US060952529033021,060952529033021,"Block 3021, Block Group 3, Census Tract 2529.03, Solano County, California",0,0,0
1000000US060952529033022,060952529033022,"Block 3022, Block Group 3, Census Tract 2529.03, Solano County, California",0,0,0
1000000US060952529033023,060952529033023,"Block 3023, Block Group 3, Census Tract 2529.03, Solano County, California",0,0,0
1000000US060952529033024,060952529033024,"Block 3024, Block Group 3, Census Tract 2529.03, Solano County, California",0,0,0
1000000US060952529033025,060952529033025,"Block 3025, Block Group 3, Census Tract 2529.03, Solano County, California",0,0,0
1000000US060952529033026,060952529033026,"Block 3026, Block Group 3, Census Tract 2529.03, Solano County, California",22,18,4
1000000US060952529033027,060952529033027,"Block 3027, Block Group 3, Census Tract 2529.03, Solano County, California",0,0,0
1000000US060952529033028,060952529033028,"Block 3028, Block Group 3, Census Tract 2529.03, Solano County, California",3,3,0
1000000US060952529033029,060952529033029,"Block 3029, Block Group 3, Census Tract 2529.03, Solano County, California",0,0,0
1000000US060952529033030,060952529033030,"Block 3030, Block Group 3, Census Tract 2529.03, Solano County, California",12,10,2
1000000US060952529033031,060952529033031,"Block 3031, Block Group 3, Census Tract 2529.03, Solano County, California",0,0,0
1000000US060952529033032,060952529033032,"Block 3032, Block Group 3, Census Tract 2529.03, Solano County, California",2,1,1
1000000US060952529033033,060952529033033,"Block 3033, Block Group 3, Census Tract 2529.03, Solano County, California",0,0,0
1000000US060952529033034,060952529033034,"Block 3034, Block Group 3, Census Tract 2529.03, Solano County, California",0,0,0
1000000US060952529033035,060952529033035,"Block 3035, Block Group 3, Census Tract 2529.03, Solano County, California",0,0,0
1000000US060952529033036,060952529033036,"Block 3036, Block Group 3, Census Tract 2529.03, Solano County, California",0,0,0
1000000US060952529033037,060952529033037,"Block 3037, Block Group 3, Census Tract 2529.03, Solano County, California",0,0,0
1000000US060952529033038,060952529033038,"Block 3038, Block Group 3, Census Tract 2529.03, Solano County, California",39,38,1
1000000US060952529033039,060952529033039,"Block 3039, Block Group 3, Census Tract 2529.03, Solano County, California",0,0,0
1000000US060952529033040,060952529033040,"Block 3040, Block Group 3, Census Tract 2529.03, Solano County, California",12,11,1
1000000US060952529033041,060952529033041,"Block 3041, Block Group 3, Census Tract 2529.03, Solano County, California",0,0,0
1000000US060952529033042,060952529033042,"Block 3042, Block Group 3, Census Tract 2529.03, Solano County, California",125,117,8
1000000US060952529033043,060952529033043,"Block 3043, Block Group 3, Census Tract 2529.03, Solano County, California",5,5,0
1000000US060952529033044,060952529033044,"Block 3044, Block Group 3, Census Tract 2529.03, Solano County, California",2,1,1
1000000US060952529033045,060952529033045,"Block 3045, Block Group 3, Census Tract 2529.03, Solano County, California",0,0,0
1000000US060952529033046,060952529033046,"Block 3046, Block Group 3, Census Tract 2529.03, Solano County, California",2,2,0
1000000US060952529033047,060952529033047,"Block 3047, Block Group 3, Census Tract 2529.03, Solano County, California",2,2,0
1000000US060952529033048,060952529033048,"Block 3048, Block Group 3, Census Tract 2529.03, Solano County, California",0,0,0
1000000US060952529033049,060952529033049,"Block 3049, Block Group 3, Census Tract 2529.03, Solano County, California",0,0,0
1000000US060952529033050,060952529033050,"Block 3050, Block Group 3, Census Tract 2529.03, Solano County, California",0,0,0
1000000US060952529033051,060952529033051,"Block 3051, Block Group 3, Census Tract 2529.03, Solano County, California",1,0,1
1000000US060952529033052,060952529033052,"Block 3052, Block Group 3, Census Tract 2529.03, Solano County, California",8,7,1
1000000US060952529033053,060952529033053,"Block 3053, Block Group 3, Census Tract 2529.03, Solano County, California",0,0,0
1000000US060952529033054,060952529033054,"Block 3054, Block Group 3, Census Tract 2529.03, Solano County, California",0,0,0
1000000US060952529033055,060952529033055,"Block 3055, Block Group 3, Census Tract 2529.03, Solano County, California",1,1,0
1000000US060952529033056,060952529033056,"Block 3056, Block Group 3, Census Tract 2529.03, Solano County, California",1,1,0
1000000US060952529033057,060952529033057,"Block 3057, Block Group 3, Census Tract 2529.03, Solano County, California",2,2,0
1000000US060952529033058,060952529033058,"Block 3058, Block Group 3, Census Tract 2529.03, Solano County, California",0,0,0
1000000US060952529033059,060952529033059,"Block 3059, Block Group 3, Census Tract 2529.03, Solano County, California",1,1,0
1000000US060952529034000,060952529034000,"Block 4000, Block Group 4, Census Tract 2529.03, Solano County, California",0,0,0
1000000US060952529034001,060952529034001,"Block 4001, Block Group 4, Census Tract 2529.03, Solano County, California",0,0,0
1000000US060952529034002,060952529034002,"Block 4002, Block Group 4, Census Tract 2529.03, Solano County, California",0,0,0
1000000US060952529034003,060952529034003,"Block 4003, Block Group 4, Census Tract 2529.03, Solano County, California",0,0,0
1000000US060952529034004,060952529034004,"Block 4004, Block Group 4, Census Tract 2529.03, Solano County, California",0,0,0
1000000US060952529034005,060952529034005,"Block 4005, Block Group 4, Census Tract 2529.03, Solano County, California",9,7,2
1000000US060952529034006,060952529034006,"Block 4006, Block Group 4, Census Tract 2529.03, Solano County, California",1,1,0
1000000US060952529034007,060952529034007,"Block 4007, Block Group 4, Census Tract 2529.03, Solano County, California",1,1,0
1000000US060952529034008,060952529034008,"Block 4008, Block Group 4, Census Tract 2529.03, Solano County, California",1,1,0
1000000US060952529034009,060952529034009,"Block 4009, Block Group 4, Census Tract 2529.03, Solano County, California",0,0,0
1000000US060952529034010,060952529034010,"Block 4010, Block Group 4, Census Tract 2529.03, Solano County, California",0,0,0
1000000US060952529034011,060952529034011,"Block 4011, Block Group 4, Census Tract 2529.03, Solano County, California",0,0,0
1000000US060952529034012,060952529034012,"Block 4012, Block Group 4, Census Tract 2529.03, Solano County, California",0,0,0
1000000US060952529034013,060952529034013,"Block 4013, Block Group 4, Census Tract 2529.03, Solano County, California",0,0,0
1000000US060952529034014,060952529034014,"Block 4014, Block Group 4, Census Tract 2529.03, Solano County, California",0,0,0
1000000US060952529034015,060952529034015,"Block 4015, Block Group 4, Census Tract 2529.03, Solano County, California",0,0,0
1000000US060952529034016,060952529034016,"Block 4016, Block Group 4, Census Tract 2529.03, Solano County, California",0,0,0
1000000US060952529034017,060952529034017,"Block 4017, Block Group 4, Census Tract 2529.03, Solano County, California",0,0,0
1000000US060952529034018,060952529034018,"Block 4018, Block Group 4, Census Tract 2529.03, Solano County, California",0,0,0
1000000US060952529034019,060952529034019,"Block 4019, Block Group 4, Census Tract 2529.03, Solano County, California",0,0,0
1000000US060952529034020,060952529034020,"Block 4020, Block Group 4, Census Tract 2529.03, Solano County, California",0,0,0
1000000US060952529034021,060952529034021,"Block 4021, Block Group 4, Census Tract 2529.03, Solano County, California",0,0,0
1000000US060952529034022,060952529034022,"Block 4022, Block Group 4, Census Tract 2529.03, Solano County, California",0,0,0
1000000US060952529034023,060952529034023,"Block 4023, Block Group 4, Census Tract 2529.03, Solano County, California",1,1,0
1000000US060952529034024,060952529034024,"Block 4024, Block Group 4, Census Tract 2529.03, Solano County, California",0,0,0
1000000US060952529034025,060952529034025,"Block 4025, Block Group 4, Census Tract 2529.03, Solano County, California",0,0,0
1000000US060952529034026,060952529034026,"Block 4026, Block Group 4, Census Tract 2529.03, Solano County, California",0,0,0
1000000US060952529034027,060952529034027,"Block 4027, Block Group 4, Census Tract 2529.03, Solano County, California",16,15,1
1000000US060952529034028,060952529034028,"Block 4028, Block Group 4, Census Tract 2529.03, Solano County, California",0,0,0
1000000US060952529034029,060952529034029,"Block 4029, Block Group 4, Census Tract 2529.03, Solano County, California",0,0,0
1000000US060952529034030,060952529034030,"Block 4030, Block Group 4, Census Tract 2529.03, Solano County, California",0,0,0
1000000US060952529034031,060952529034031,"Block 4031, Block Group 4, Census Tract 2529.03, Solano County, California",5,5,0
1000000US060952529034032,060952529034032,"Block 4032, Block Group 4, Census Tract 2529.03, Solano County, California",0,0,0
1000000US060952529034033,060952529034033,"Block 4033, Block Group 4, Census Tract 2529.03, Solano County, California",1,1,0
1000000US060952529034034,060952529034034,"Block 4034, Block Group 4, Census Tract 2529.03, Solano County, California",1,1,0
1000000US060952529034035,060952529034035,"Block 4035, Block Group 4, Census Tract 2529.03, Solano County, California",1,1,0
1000000US060952529034036,060952529034036,"Block 4036, Block Group 4, Census Tract 2529.03, Solano County, California",0,0,0
1000000US060952529034037,060952529034037,"Block 4037, Block Group 4, Census Tract 2529.03, Solano County, California",0,0,0
1000000US060952529034038,060952529034038,"Block 4038, Block Group 4, Census Tract 2529.03, Solano County, California",1,1,0
1000000US060952529034039,060952529034039,"Block 4039, Block Group 4, Census Tract 2529.03, Solano County, California",0,0,0
1000000US060952529034040,060952529034040,"Block 4040, Block Group 4, Census Tract 2529.03, Solano County, California",0,0,0
1000000US060952529034041,060952529034041,"Block 4041, Block Group 4, Census Tract 2529.03, Solano County, California",1,1,0
1000000US060952529034042,060952529034042,"Block 4042, Block Group 4, Census Tract 2529.03, Solano County, California",7,6,1
1000000US060952529034043,060952529034043,"Block 4043, Block Group 4, Census Tract 2529.03, Solano County, California",0,0,0
1000000US060952529034044,060952529034044,"Block 4044, Block Group 4, Census Tract 2529.03, Solano County, California",0,0,0
1000000US060952529034045,060952529034045,"Block 4045, Block Group 4, Census Tract 2529.03, Solano County, California",0,0,0
1000000US060952529034046,060952529034046,"Block 4046, Block Group 4, Census Tract 2529.03, Solano County, California",0,0,0
1000000US060952529034047,060952529034047,"Block 4047, Block Group 4, Census Tract 2529.03, Solano County, California",0,0,0
1000000US060952529034048,060952529034048,"Block 4048, Block Group 4, Census Tract 2529.03, Solano County, California",0,0,0
1000000US060952529034049,060952529034049,"Block 4049, Block Group 4, Census Tract 2529.03, Solano County, California",0,0,0
1000000US060952529034050,060952529034050,"Block 4050, Block Group 4, Census Tract 2529.03, Solano County, California",0,0,0
1000000US060952529034051,060952529034051,"Block 4051, Block Group 4, Census Tract 2529.03, Solano County, California",1,0,1
1000000US060952529034052,060952529034052,"Block 4052, Block Group 4, Census Tract 2529.03, Solano County, California",0,0,0
1000000US060952529034053,060952529034053,"Block 4053, Block Group 4, Census Tract 2529.03, Solano County, California",0,0,0
1000000US060952529034054,060952529034054,"Block 4054, Block Group 4, Census Tract 2529.03, Solano County, California",0,0,0
1000000US060952529034055,060952529034055,"Block 4055, Block Group 4, Census Tract 2529.03, Solano County, California",1,1,0
1000000US060952529034056,060952529034056,"Block 4056, Block Group 4, Census Tract 2529.03, Solano County, California",0,0,0
1000000US060952529034057,060952529034057,"Block 4057, Block Group 4, Census Tract 2529.03, Solano County, California",0,0,0
1000000US060952529034058,060952529034058,"Block 4058, Block Group 4, Census Tract 2529.03, Solano County, California",0,0,0
1000000US060952529034059,060952529034059,"Block 4059, Block Group 4, Census Tract 2529.03, Solano County, California",0,0,0
1000000US060952529034060,060952529034060,"Block 4060, Block Group 4, Census Tract 2529.03, Solano County, California",0,0,0
1000000US060952529034061,060952529034061,"Block 4061, Block Group 4, Census Tract 2529.03, Solano County, California",0,0,0
1000000US060952529034062,060952529034062,"Block 4062, Block Group 4, Census Tract 2529.03, Solano County, California",0,0,0
1000000US060952529034063,060952529034063,"Block 4063, Block Group 4, Census Tract 2529.03, Solano County, California",0,0,0
1000000US060952529034064,060952529034064,"Block 4064, Block Group 4, Census Tract 2529.03, Solano County, California",0,0,0
1000000US060952529034065,060952529034065,"Block 4065, Block Group 4, Census Tract 2529.03, Solano County, California",0,0,0
1000000US060952529034066,060952529034066,"Block 4066, Block Group 4, Census Tract 2529.03, Solano County, California",0,0,0
1000000US060952529034067,060952529034067,"Block 4067, Block Group 4, Census Tract 2529.03, Solano County, California",0,0,0
1000000US060952529034068,060952529034068,"Block 4068, Block Group 4, Census Tract 2529.03, Solano County, California",0,0,0
1000000US060952529034069,060952529034069,"Block 4069, Block Group 4, Census Tract 2529.03, Solano County, California",1,1,0
1000000US060952529034070,060952529034070,"Block 4070, Block Group 4, Census Tract 2529.03, Solano County, California",1,1,0
1000000US060952529034071,060952529034071,"Block 4071, Block Group 4, Census Tract 2529.03, Solano County, California",0,0,0
1000000US060952529034072,060952529034072,"Block 4072, Block Group 4, Census Tract 2529.03, Solano County, California",0,0,0
1000000US060952529034073,060952529034073,"Block 4073, Block Group 4, Census Tract 2529.03, Solano County, California",0,0,0
1000000US060952529034074,060952529034074,"Block 4074, Block Group 4, Census Tract 2529.03, Solano County, California",0,0,0
1000000US060952529034075,060952529034075,"Block 4075, Block Group 4, Census Tract 2529.03, Solano County, California",0,0,0
1000000US060952529034076,060952529034076,"Block 4076, Block Group 4, Census Tract 2529.03, Solano County, California",0,0,0
1000000US060952529034077,060952529034077,"Block 4077, Block Group 4, Census Tract 2529.03, Solano County, California",0,0,0
1000000US060952529034078,060952529034078,"Block 4078, Block Group 4, Census Tract 2529.03, Solano County, California",0,0,0
1000000US060952529034079,060952529034079,"Block 4079, Block Group 4, Census Tract 2529.03, Solano County, California",1,0,1
1000000US060952529034080,060952529034080,"Block 4080, Block Group 4, Census Tract 2529.03, Solano County, California",0,0,0
1000000US060952529034081,060952529034081,"Block 4081, Block Group 4, Census Tract 2529.03, Solano County, California",0,0,0
1000000US060952529034082,060952529034082,"Block 4082, Block Group 4, Census Tract 2529.03, Solano County, California",0,0,0
1000000US060952529034083,060952529034083,"Block 4083, Block Group 4, Census Tract 2529.03, Solano County, California",0,0,0
1000000US060952529034084,060952529034084,"Block 4084, Block Group 4, Census Tract 2529.03, Solano County, California",5,4,1
1000000US060952529034085,060952529034085,"Block 4085, Block Group 4, Census Tract 2529.03, Solano County, California",0,0,0
1000000US060952529034086,060952529034086,"Block 4086, Block Group 4, Census Tract 2529.03, Solano County, California",0,0,0
1000000US060952529034087,060952529034087,"Block 4087, Block Group 4, Census Tract 2529.03, Solano County, California",0,0,0
1000000US060952529034088,060952529034088,"Block 4088, Block Group 4, Census Tract 2529.03, Solano County, California",1,1,0
1000000US060952529034089,060952529034089,"Block 4089, Block Group 4, Census Tract 2529.03, Solano County, California",0,0,0
1000000US060952529034090,060952529034090,"Block 4090, Block Group 4, Census Tract 2529.03, Solano County, California",0,0,0
1000000US060952529034091,060952529034091,"Block 4091, Block Group 4, Census Tract 2529.03, Solano County, California",0,0,0
1000000US060952529034092,060952529034092,"Block 4092, Block Group 4, Census Tract 2529.03, Solano County, California",14,14,0
1000000US060952529034093,060952529034093,"Block 4093, Block Group 4, Census Tract 2529.03, Solano County, California",1,0,1
1000000US060952529034094,060952529034094,"Block 4094, Block Group 4, Census Tract 2529.03, Solano County, California",0,0,0
1000000US060952529034095,060952529034095,"Block 4095, Block Group 4, Census Tract 2529.03, Solano County, California",0,0,0
1000000US060952529034096,060952529034096,"Block 4096, Block Group 4, Census Tract 2529.03, Solano County, California",0,0,0
1000000US060952529034097,060952529034097,"Block 4097, Block Group 4, Census Tract 2529.03, Solano County, California",0,0,0
1000000US060952529034098,060952529034098,"Block 4098, Block Group 4, Census Tract 2529.03, Solano County, California",21,20,1
1000000US060952529034099,060952529034099,"Block 4099, Block Group 4, Census Tract 2529.03, Solano County, California",4,4,0
1000000US060952529034100,060952529034100,"Block 4100, Block Group 4, Census Tract 2529.03, Solano County, California",0,0,0
1000000US060952529034101,060952529034101,"Block 4101, Block Group 4, Census Tract 2529.03, Solano County, California",0,0,0
1000000US060952529034102,060952529034102,"Block 4102, Block Group 4, Census Tract 2529.03, Solano County, California",0,0,0
1000000US060952529034103,060952529034103,"Block 4103, Block Group 4, Census Tract 2529.03, Solano County, California",0,0,0
1000000US060952529034104,060952529034104,"Block 4104, Block Group 4, Census Tract 2529.03, Solano County, California",0,0,0
1000000US060952529034105,060952529034105,"Block 4105, Block Group 4, Census Tract 2529.03, Solano County, California",0,0,0
1000000US060952529034106,060952529034106,"Block 4106, Block Group 4, Census Tract 2529.03, Solano County, California",2,2,0
1000000US060952529034107,060952529034107,"Block 4107, Block Group 4, Census Tract 2529.03, Solano County, California",1,1,0
1000000US060952529034108,060952529034108,"Block 4108, Block Group 4, Census Tract 2529.03, Solano County, California",0,0,0
1000000US060952529034109,060952529034109,"Block 4109, Block Group 4, Census Tract 2529.03, Solano County, California",4,4,0
1000000US060952529034110,060952529034110,"Block 4110, Block Group 4, Census Tract 2529.03, Solano County, California",1,1,0
1000000US060952529034111,060952529034111,"Block 4111, Block Group 4, Census Tract 2529.03, Solano County, California",7,7,0
1000000US060952529034112,060952529034112,"Block 4112, Block Group 4, Census Tract 2529.03, Solano County, California",0,0,0
1000000US060952529034113,060952529034113,"Block 4113, Block Group 4, Census Tract 2529.03, Solano County, California",8,6,2
1000000US060952529034114,060952529034114,"Block 4114, Block Group 4, Census Tract 2529.03, Solano County, California",0,0,0
1000000US060952529034115,060952529034115,"Block 4115, Block Group 4, Census Tract 2529.03, Solano County, California",1,1,0
1000000US060952529034116,060952529034116,"Block 4116, Block Group 4, Census Tract 2529.03, Solano County, California",0,0,0
1000000US060952529034117,060952529034117,"Block 4117, Block Group 4, Census Tract 2529.03, Solano County, California",5,4,1
1000000US060952529034118,060952529034118,"Block 4118, Block Group 4, Census Tract 2529.03, Solano County, California",5,5,0
1000000US060952529034119,060952529034119,"Block 4119, Block Group 4, Census Tract 2529.03, Solano County, California",7,7,0
1000000US060952529034120,060952529034120,"Block 4120, Block Group 4, Census Tract 2529.03, Solano County, California",14,13,1
1000000US060952529034121,060952529034121,"Block 4121, Block Group 4, Census Tract 2529.03, Solano County, California",13,13,0
1000000US060952529034122,060952529034122,"Block 4122, Block Group 4, Census Tract 2529.03, Solano County, California",0,0,0
1000000US060952529034123,060952529034123,"Block 4123, Block Group 4, Census Tract 2529.03, Solano County, California",2,2,0
1000000US060952529034124,060952529034124,"Block 4124, Block Group 4, Census Tract 2529.03, Solano County, California",0,0,0
1000000US060952529034125,060952529034125,"Block 4125, Block Group 4, Census Tract 2529.03, Solano County, California",4,4,0
1000000US060952529034126,060952529034126,"Block 4126, Block Group 4, Census Tract 2529.03, Solano County, California",1,1,0
1000000US060952529034127,060952529034127,"Block 4127, Block Group 4, Census Tract 2529.03, Solano County, California",1,1,0
1000000US060952529034128,060952529034128,"Block 4128, Block Group 4, Census Tract 2529.03, Solano County, California",7,7,0
1000000US060952529034129,060952529034129,"Block 4129, Block Group 4, Census Tract 2529.03, Solano County, California",1,1,0
1000000US060952529034130,060952529034130,"Block 4130, Block Group 4, Census Tract 2529.03, Solano County, California",20,19,1
1000000US060952529034131,060952529034131,"Block 4131, Block Group 4, Census Tract 2529.03, Solano County, California",18,15,3
1000000US060952529034132,060952529034132,"Block 4132, Block Group 4, Census Tract 2529.03, Solano County, California",0,0,0
1000000US060952529034133,060952529034133,"Block 4133, Block Group 4, Census Tract 2529.03, Solano County, California",0,0,0
1000000US060952529034134,060952529034134,"Block 4134, Block Group 4, Census Tract 2529.03, Solano County, California",0,0,0
1000000US060952529034135,060952529034135,"Block 4135, Block Group 4, Census Tract 2529.03, Solano County, California",0,0,0
1000000US060952529034136,060952529034136,"Block 4136, Block Group 4, Census Tract 2529.03, Solano County, California",0,0,0
1000000US060952529034137,060952529034137,"Block 4137, Block Group 4, Census Tract 2529.03, Solano County, California",16,16,0
1000000US060952529034138,060952529034138,"Block 4138, Block Group 4, Census Tract 2529.03, Solano County, California",0,0,0
1000000US060952529034139,060952529034139,"Block 4139, Block Group 4, Census Tract 2529.03, Solano County, California",0,0,0
1000000US060952529034140,060952529034140,"Block 4140, Block Group 4, Census Tract 2529.03, Solano County, California",1,1,0
1000000US060952529034141,060952529034141,"Block 4141, Block Group 4, Census Tract 2529.03, Solano County, California",0,0,0
1000000US060952529034142,060952529034142,"Block 4142, Block Group 4, Census Tract 2529.03, Solano County, California",0,0,0
1000000US060952529034143,060952529034143,"Block 4143, Block Group 4, Census Tract 2529.03, Solano County, California",1,1,0
1000000US060952529034144,060952529034144,"Block 4144, Block Group 4, Census Tract 2529.03, Solano County, California",0,0,0
1000000US060952529034145,060952529034145,"Block 4145, Block Group 4, Census Tract 2529.03, Solano County, California",0,0,0
1000000US060952529034146,060952529034146,"Block 4146, Block Group 4, Census Tract 2529.03, Solano County, California",0,0,0
1000000US060952529034147,060952529034147,"Block 4147, Block Group 4, Census Tract 2529.03, Solano County, California",0,0,0
1000000US060952529034148,060952529034148,"Block 4148, Block Group 4, Census Tract 2529.03, Solano County, California",1,1,0
1000000US060952529034149,060952529034149,"Block 4149, Block Group 4, Census Tract 2529.03, Solano County, California",0,0,0
1000000US060952529034150,060952529034150,"Block 4150, Block Group 4, Census Tract 2529.03, Solano County, California",0,0,0
1000000US060952529034151,060952529034151,"Block 4151, Block Group 4, Census Tract 2529.03, Solano County, California",0,0,0
1000000US060952529034152,060952529034152,"Block 4152, Block Group 4, Census Tract 2529.03, Solano County, California",3,3,0
1000000US060952529034153,060952529034153,"Block 4153, Block Group 4, Census Tract 2529.03, Solano County, California",0,0,0
1000000US060952529034154,060952529034154,"Block 4154, Block Group 4, Census Tract 2529.03, Solano County, California",0,0,0
1000000US060952529034155,060952529034155,"Block 4155, Block Group 4, Census Tract 2529.03, Solano County, California",0,0,0
1000000US060952529034156,060952529034156,"Block 4156, Block Group 4, Census Tract 2529.03, Solano County, California",1,1,0
1000000US060952529034157,060952529034157,"Block 4157, Block Group 4, Census Tract 2529.03, Solano County, California",2,1,1
1000000US060952529034158,060952529034158,"Block 4158, Block Group 4, Census Tract 2529.03, Solano County, California",0,0,0
1000000US060952529034159,060952529034159,"Block 4159, Block Group 4, Census Tract 2529.03, Solano County, California",2,2,0
1000000US060952529034160,060952529034160,"Block 4160, Block Group 4, Census Tract 2529.03, Solano County, California",4,4,0
1000000US060952529034161,060952529034161,"Block 4161, Block Group 4, Census Tract 2529.03, Solano County, California",0,0,0
1000000US060952529034162,060952529034162,"Block 4162, Block Group 4, Census Tract 2529.03, Solano County, California",2,2,0
1000000US060952529034163,060952529034163,"Block 4163, Block Group 4, Census Tract 2529.03, Solano County, California",12,12,0
1000000US060952529034164,060952529034164,"Block 4164, Block Group 4, Census Tract 2529.03, Solano County, California",0,0,0
1000000US060952529034165,060952529034165,"Block 4165, Block Group 4, Census Tract 2529.03, Solano County, California",0,0,0
1000000US060952529034166,060952529034166,"Block 4166, Block Group 4, Census Tract 2529.03, Solano County, California",9,7,2
1000000US060952529034167,060952529034167,"Block 4167, Block Group 4, Census Tract 2529.03, Solano County, California",0,0,0
1000000US060952529034168,060952529034168,"Block 4168, Block Group 4, Census Tract 2529.03, Solano County, California",1,1,0
1000000US060952529034169,060952529034169,"Block 4169, Block Group 4, Census Tract 2529.03, Solano County, California",0,0,0
1000000US060952529034170,060952529034170,"Block 4170, Block Group 4, Census Tract 2529.03, Solano County, California",0,0,0
1000000US060952529034171,060952529034171,"Block 4171, Block Group 4, Census Tract 2529.03, Solano County, California",2,2,0
1000000US060952529034172,060952529034172,"Block 4172, Block Group 4, Census Tract 2529.03, Solano County, California",0,0,0
1000000US060952529034173,060952529034173,"Block 4173, Block Group 4, Census Tract 2529.03, Solano County, California",0,0,0
1000000US060952529034174,060952529034174,"Block 4174, Block Group 4, Census Tract 2529.03, Solano County, California",1,1,0
1000000US060952529034175,060952529034175,"Block 4175, Block Group 4, Census Tract 2529.03, Solano County, California",0,0,0
1000000US060952529034176,060952529034176,"Block 4176, Block Group 4, Census Tract 2529.03, Solano County, California",4,3,1
1000000US060952529034177,060952529034177,"Block 4177, Block Group 4, Census Tract 2529.03, Solano County, California",2,2,0
1000000US060952529034178,060952529034178,"Block 4178, Block Group 4, Census Tract 2529.03, Solano County, California",1,1,0
1000000US060952529034179,060952529034179,"Block 4179, Block Group 4, Census Tract 2529.03, Solano County, California",18,15,3
1000000US060952529034180,060952529034180,"Block 4180, Block Group 4, Census Tract 2529.03, Solano County, California",0,0,0
1000000US060952529034181,060952529034181,"Block 4181, Block Group 4, Census Tract 2529.03, Solano County, California",0,0,0
1000000US060952529034182,060952529034182,"Block 4182, Block Group 4, Census Tract 2529.03, Solano County, California",0,0,0
1000000US060952529034183,060952529034183,"Block 4183, Block Group 4, Census Tract 2529.03, Solano County, California",2,2,0
1000000US060952529034184,060952529034184,"Block 4184, Block Group 4, Census Tract 2529.03, Solano County, California",0,0,0
1000000US060952529034185,060952529034185,"Block 4185, Block Group 4, Census Tract 2529.03, Solano County, California",2,2,0
1000000US060952529034186,060952529034186,"Block 4186, Block Group 4, Census Tract 2529.03, Solano County, California",0,0,0
1000000US060952529034187,060952529034187,"Block 4187, Block Group 4, Census Tract 2529.03, Solano County, California",0,0,0
1000000US060952529034188,060952529034188,"Block 4188, Block Group 4, Census Tract 2529.03, Solano County, California",3,3,0
1000000US060952529034189,060952529034189,"Block 4189, Block Group 4, Census Tract 2529.03, Solano County, California",1,1,0
1000000US060952529034190,060952529034190,"Block 4190, Block Group 4, Census Tract 2529.03, Solano County, California",1,1,0
1000000US060952529034191,060952529034191,"Block 4191, Block Group 4, Census Tract 2529.03, Solano County, California",33,29,4
1000000US060952529034192,060952529034192,"Block 4192, Block Group 4, Census Tract 2529.03, Solano County, California",0,0,0
1000000US060952529034193,060952529034193,"Block 4193, Block Group 4, Census Tract 2529.03, Solano County, California",1,1,0
1000000US060952529034194,060952529034194,"Block 4194, Block Group 4, Census Tract 2529.03, Solano County, California",0,0,0
1000000US060952529034195,060952529034195,"Block 4195, Block Group 4, Census Tract 2529.03, Solano County, California",0,0,0
1000000US060952529034196,060952529034196,"Block 4196, Block Group 4, Census Tract 2529.03, Solano County, California",0,0,0
1000000US060952529034197,060952529034197,"Block 4197, Block Group 4, Census Tract 2529.03, Solano County, California",0,0,0
1000000US060952529034198,060952529034198,"Block 4198, Block Group 4, Census Tract 2529.03, Solano County, California",1,0,1
1000000US060952529034199,060952529034199,"Block 4199, Block Group 4, Census Tract 2529.03, Solano County, California",1,1,0
1000000US060952529034200,060952529034200,"Block 4200, Block Group 4, Census Tract 2529.03, Solano County, California",2,2,0
1000000US060952529034201,060952529034201,"Block 4201, Block Group 4, Census Tract 2529.03, Solano County, California",3,3,0
1000000US060952529034202,060952529034202,"Block 4202, Block Group 4, Census Tract 2529.03, Solano County, California",0,0,0
1000000US060952529034203,060952529034203,"Block 4203, Block Group 4, Census Tract 2529.03, Solano County, California",6,6,0
1000000US060952529034204,060952529034204,"Block 4204, Block Group 4, Census Tract 2529.03, Solano County, California",9,7,2
1000000US060952529034205,060952529034205,"Block 4205, Block Group 4, Census Tract 2529.03, Solano County, California",1,1,0
1000000US060952529034206,060952529034206,"Block 4206, Block Group 4, Census Tract 2529.03, Solano County, California",2,2,0
1000000US060952529034207,060952529034207,"Block 4207, Block Group 4, Census Tract 2529.03, Solano County, California",0,0,0
1000000US060952529034208,060952529034208,"Block 4208, Block Group 4, Census Tract 2529.03, Solano County, California",0,0,0
1000000US060952529034209,060952529034209,"Block 4209, Block Group 4, Census Tract 2529.03, Solano County, California",0,0,0
1000000US060952529034210,060952529034210,"Block 4210, Block Group 4, Census Tract 2529.03, Solano County, California",0,0,0
1000000US060952529034211,060952529034211,"Block 4211, Block Group 4, Census Tract 2529.03, Solano County, California",0,0,0
1000000US060952529034212,060952529034212,"Block 4212, Block Group 4, Census Tract 2529.03, Solano County, California",0,0,0
1000000US060952529034213,060952529034213,"Block 4213, Block Group 4, Census Tract 2529.03, Solano County, California",0,0,0
1000000US060952529034214,060952529034214,"Block 4214, Block Group 4, Census Tract 2529.03, Solano County, California",2,2,0
1000000US060952529034215,060952529034215,"Block 4215, Block Group 4, Census Tract 2529.03, Solano County, California",1,1,0
1000000US060952529034216,060952529034216,"Block 4216, Block Group 4, Census Tract 2529.03, Solano County, California",0,0,0
1000000US060952529034217,060952529034217,"Block 4217, Block Group 4, Census Tract 2529.03, Solano County, California",14,13,1
1000000US060952529034218,060952529034218,"Block 4218, Block Group 4, Census Tract 2529.03, Solano County, California",0,0,0
1000000US060952529034219,060952529034219,"Block 4219, Block Group 4, Census Tract 2529.03, Solano County, California",0,0,0
1000000US060952529034220,060952529034220,"Block 4220, Block Group 4, Census Tract 2529.03, Solano County, California",8,6,2
1000000US060952529034221,060952529034221,"Block 4221, Block Group 4, Census Tract 2529.03, Solano County, California",0,0,0
1000000US060952529034222,060952529034222,"Block 4222, Block Group 4, Census Tract 2529.03, Solano County, California",0,0,0
1000000US060952529034223,060952529034223,"Block 4223, Block Group 4, Census Tract 2529.03, Solano County, California",0,0,0
1000000US060952529034224,060952529034224,"Block 4224, Block Group 4, Census Tract 2529.03, Solano County, California",0,0,0
1000000US060952529034225,060952529034225,"Block 4225, Block Group 4, Census Tract 2529.03, Solano County, California",0,0,0
1000000US060952529034226,060952529034226,"Block 4226, Block Group 4, Census Tract 2529.03, Solano County, California",8,8,0
1000000US060952529034227,060952529034227,"Block 4227, Block Group 4, Census Tract 2529.03, Solano County, California",2,2,0
1000000US060952529034228,060952529034228,"Block 4228, Block Group 4, Census Tract 2529.03, Solano County, California",3,3,0
1000000US060952529034229,060952529034229,"Block 4229, Block Group 4, Census Tract 2529.03, Solano County, California",0,0,0
1000000US060952529034230,060952529034230,"Block 4230, Block Group 4, Census Tract 2529.03, Solano County, California",0,0,0
1000000US060952529034231,060952529034231,"Block 4231, Block Group 4, Census Tract 2529.03, Solano County, California",0,0,0
1000000US060952529034232,060952529034232,"Block 4232, Block Group 4, Census Tract 2529.03, Solano County, California",0,0,0
1000000US060952529034233,060952529034233,"Block 4233, Block Group 4, Census Tract 2529.03, Solano County, California",0,0,0
1000000US060952529034234,060952529034234,"Block 4234, Block Group 4, Census Tract 2529.03, Solano County, California",0,0,0
1000000US060952529034235,060952529034235,"Block 4235, Block Group 4, Census Tract 2529.03, Solano County, California",0,0,0
1000000US060952529034236,060952529034236,"Block 4236, Block Group 4, Census Tract 2529.03, Solano County, California",0,0,0
1000000US060952529034237,060952529034237,"Block 4237, Block Group 4, Census Tract 2529.03, Solano County, California",0,0,0
1000000US060952529034238,060952529034238,"Block 4238, Block Group 4, Census Tract 2529.03, Solano County, California",0,0,0
1000000US060952529034239,060952529034239,"Block 4239, Block Group 4, Census Tract 2529.03, Solano County, California",3,2,1
1000000US060952529034240,060952529034240,"Block 4240, Block Group 4, Census Tract 2529.03, Solano County, California",0,0,0
1000000US060952529034241,060952529034241,"Block 4241, Block Group 4, Census Tract 2529.03, Solano County, California",0,0,0
1000000US060952529034242,060952529034242,"Block 4242, Block Group 4, Census Tract 2529.03, Solano County, California",0,0,0
1000000US060952529034243,060952529034243,"Block 4243, Block Group 4, Census Tract 2529.03, Solano County, California",0,0,0
1000000US060952529034244,060952529034244,"Block 4244, Block Group 4, Census Tract 2529.03, Solano County, California",2,2,0
1000000US060952529034245,060952529034245,"Block 4245, Block Group 4, Census Tract 2529.03, Solano County, California",0,0,0
1000000US060952529034246,060952529034246,"Block 4246, Block Group 4, Census Tract 2529.03, Solano County, California",0,0,0
1000000US060952529034247,060952529034247,"Block 4247, Block Group 4, Census Tract 2529.03, Solano County, California",0,0,0
1000000US060952529034248,060952529034248,"Block 4248, Block Group 4, Census Tract 2529.03, Solano County, California",1,1,0
1000000US060952529034249,060952529034249,"Block 4249, Block Group 4, Census Tract 2529.03, Solano County, California",0,0,0
1000000US060952529034250,060952529034250,"Block 4250, Block Group 4, Census Tract 2529.03, Solano County, California",0,0,0
1000000US060952529034251,060952529034251,"Block 4251, Block Group 4, Census Tract 2529.03, Solano County, California",0,0,0
1000000US060952529034252,060952529034252,"Block 4252, Block Group 4, Census Tract 2529.03, Solano County, California",0,0,0
1000000US060952529034253,060952529034253,"Block 4253, Block Group 4, Census Tract 2529.03, Solano County, California",0,0,0
1000000US060952529034254,060952529034254,"Block 4254, Block Group 4, Census Tract 2529.03, Solano County, California",0,0,0
1000000US060952529034255,060952529034255,"Block 4255, Block Group 4, Census Tract 2529.03, Solano County, California",0,0,0
1000000US060952529034256,060952529034256,"Block 4256, Block Group 4, Census Tract 2529.03, Solano County, California",0,0,0
1000000US060952529034257,060952529034257,"Block 4257, Block Group 4, Census Tract 2529.03, Solano County, California",0,0,0
1000000US060952529034258,060952529034258,"Block 4258, Block Group 4, Census Tract 2529.03, Solano County, California",0,0,0
1000000US060952529034259,060952529034259,"Block 4259, Block Group 4, Census Tract 2529.03, Solano County, California",0,0,0
1000000US060952529034260,060952529034260,"Block 4260, Block Group 4, Census Tract 2529.03, Solano County, California",0,0,0
1000000US060952529034261,060952529034261,"Block 4261, Block Group 4, Census Tract 2529.03, Solano County, California",0,0,0
1000000US060952529034262,060952529034262,"Block 4262, Block Group 4, Census Tract 2529.03, Solano County, California",0,0,0
1000000US060952529034263,060952529034263,"Block 4263, Block Group 4, Census Tract 2529.03, Solano County, California",0,0,0
1000000US060952529034264,060952529034264,"Block 4264, Block Group 4, Census Tract 2529.03, Solano County, California",0,0,0
1000000US060952529034265,060952529034265,"Block 4265, Block Group 4, Census Tract 2529.03, Solano County, California",0,0,0
1000000US060952529034266,060952529034266,"Block 4266, Block Group 4, Census Tract 2529.03, Solano County, California",0,0,0
1000000US060952529041000,060952529041000,"Block 1000, Block Group 1, Census Tract 2529.04, Solano County, California",0,0,0
1000000US060952529041001,060952529041001,"Block 1001, Block Group 1, Census Tract 2529.04, Solano County, California",0,0,0
1000000US060952529041002,060952529041002,"Block 1002, Block Group 1, Census Tract 2529.04, Solano County, California",2,2,0
1000000US060952529041003,060952529041003,"Block 1003, Block Group 1, Census Tract 2529.04, Solano County, California",11,11,0
1000000US060952529041004,060952529041004,"Block 1004, Block Group 1, Census Tract 2529.04, Solano County, California",24,21,3
1000000US060952529041005,060952529041005,"Block 1005, Block Group 1, Census Tract 2529.04, Solano County, California",1,0,1
1000000US060952529041006,060952529041006,"Block 1006, Block Group 1, Census Tract 2529.04, Solano County, California",0,0,0
1000000US060952529041007,060952529041007,"Block 1007, Block Group 1, Census Tract 2529.04, Solano County, California",0,0,0
1000000US060952529041008,060952529041008,"Block 1008, Block Group 1, Census Tract 2529.04, Solano County, California",32,30,2
1000000US060952529041009,060952529041009,"Block 1009, Block Group 1, Census Tract 2529.04, Solano County, California",4,4,0
1000000US060952529041010,060952529041010,"Block 1010, Block Group 1, Census Tract 2529.04, Solano County, California",33,32,1
1000000US060952529041011,060952529041011,"Block 1011, Block Group 1, Census Tract 2529.04, Solano County, California",0,0,0
1000000US060952529041012,060952529041012,"Block 1012, Block Group 1, Census Tract 2529.04, Solano County, California",0,0,0
1000000US060952529041013,060952529041013,"Block 1013, Block Group 1, Census Tract 2529.04, Solano County, California",0,0,0
1000000US060952529041014,060952529041014,"Block 1014, Block Group 1, Census Tract 2529.04, Solano County, California",0,0,0
1000000US060952529041015,060952529041015,"Block 1015, Block Group 1, Census Tract 2529.04, Solano County, California",2,2,0
1000000US060952529041016,060952529041016,"Block 1016, Block Group 1, Census Tract 2529.04, Solano County, California",0,0,0
1000000US060952529041017,060952529041017,"Block 1017, Block Group 1, Census Tract 2529.04, Solano County, California",5,5,0
1000000US060952529041018,060952529041018,"Block 1018, Block Group 1, Census Tract 2529.04, Solano County, California",0,0,0
1000000US060952529041019,060952529041019,"Block 1019, Block Group 1, Census Tract 2529.04, Solano County, California",0,0,0
1000000US060952529041020,060952529041020,"Block 1020, Block Group 1, Census Tract 2529.04, Solano County, California",4,4,0
1000000US060952529041021,060952529041021,"Block 1021, Block Group 1, Census Tract 2529.04, Solano County, California",0,0,0
1000000US060952529041022,060952529041022,"Block 1022, Block Group 1, Census Tract 2529.04, Solano County, California",0,0,0
1000000US060952529041023,060952529041023,"Block 1023, Block Group 1, Census Tract 2529.04, Solano County, California",0,0,0
1000000US060952529041024,060952529041024,"Block 1024, Block Group 1, Census Tract 2529.04, Solano County, California",0,0,0
1000000US060952529041025,060952529041025,"Block 1025, Block Group 1, Census Tract 2529.04, Solano County, California",0,0,0
1000000US060952529041026,060952529041026,"Block 1026, Block Group 1, Census Tract 2529.04, Solano County, California",44,39,5
1000000US060952529041027,060952529041027,"Block 1027, Block Group 1, Census Tract 2529.04, Solano County, California",3,3,0
1000000US060952529041028,060952529041028,"Block 1028, Block Group 1, Census Tract 2529.04, Solano County, California",0,0,0
1000000US060952529041029,060952529041029,"Block 1029, Block Group 1, Census Tract 2529.04, Solano County, California",0,0,0
1000000US060952529041030,060952529041030,"Block 1030, Block Group 1, Census Tract 2529.04, Solano County, California",0,0,0
1000000US060952529041031,060952529041031,"Block 1031, Block Group 1, Census Tract 2529.04, Solano County, California",1,1,0
1000000US060952529041032,060952529041032,"Block 1032, Block Group 1, Census Tract 2529.04, Solano County, California",0,0,0
1000000US060952529041033,060952529041033,"Block 1033, Block Group 1, Census Tract 2529.04, Solano County, California",17,16,1
1000000US060952529041034,060952529041034,"Block 1034, Block Group 1, Census Tract 2529.04, Solano County, California",2,2,0
1000000US060952529041035,060952529041035,"Block 1035, Block Group 1, Census Tract 2529.04, Solano County, California",4,4,0
1000000US060952529041036,060952529041036,"Block 1036, Block Group 1, Census Tract 2529.04, Solano County, California",0,0,0
1000000US060952529041037,060952529041037,"Block 1037, Block Group 1, Census Tract 2529.04, Solano County, California",20,18,2
1000000US060952529041038,060952529041038,"Block 1038, Block Group 1, Census Tract 2529.04, Solano County, California",9,8,1
1000000US060952529041039,060952529041039,"Block 1039, Block Group 1, Census Tract 2529.04, Solano County, California",0,0,0
1000000US060952529041040,060952529041040,"Block 1040, Block Group 1, Census Tract 2529.04, Solano County, California",8,6,2
1000000US060952529041041,060952529041041,"Block 1041, Block Group 1, Census Tract 2529.04, Solano County, California",27,25,2
1000000US060952529041042,060952529041042,"Block 1042, Block Group 1, Census Tract 2529.04, Solano County, California",23,22,1
1000000US060952529041043,060952529041043,"Block 1043, Block Group 1, Census Tract 2529.04, Solano County, California",20,18,2
1000000US060952529041044,060952529041044,"Block 1044, Block Group 1, Census Tract 2529.04, Solano County, California",17,17,0
1000000US060952529041045,060952529041045,"Block 1045, Block Group 1, Census Tract 2529.04, Solano County, California",0,0,0
1000000US060952529041046,060952529041046,"Block 1046, Block Group 1, Census Tract 2529.04, Solano County, California",0,0,0
1000000US060952529041047,060952529041047,"Block 1047, Block Group 1, Census Tract 2529.04, Solano County, California",0,0,0
1000000US060952529041048,060952529041048,"Block 1048, Block Group 1, Census Tract 2529.04, Solano County, California",0,0,0
1000000US060952529041049,060952529041049,"Block 1049, Block Group 1, Census Tract 2529.04, Solano County, California",14,14,0
1000000US060952529041050,060952529041050,"Block 1050, Block Group 1, Census Tract 2529.04, Solano County, California",43,37,6
1000000US060952529041051,060952529041051,"Block 1051, Block Group 1, Census Tract 2529.04, Solano County, California",8,8,0
1000000US060952529041052,060952529041052,"Block 1052, Block Group 1, Census Tract 2529.04, Solano County, California",26,25,1
1000000US060952529041053,060952529041053,"Block 1053, Block Group 1, Census Tract 2529.04, Solano County, California",32,30,2
1000000US060952529041054,060952529041054,"Block 1054, Block Group 1, Census Tract 2529.04, Solano County, California",1,1,0
1000000US060952529041055,060952529041055,"Block 1055, Block Group 1, Census Tract 2529.04, Solano County, California",19,19,0
1000000US060952529041056,060952529041056,"Block 1056, Block Group 1, Census Tract 2529.04, Solano County, California",2,2,0
1000000US060952529041057,060952529041057,"Block 1057, Block Group 1, Census Tract 2529.04, Solano County, California",18,17,1
1000000US060952529041058,060952529041058,"Block 1058, Block Group 1, Census Tract 2529.04, Solano County, California",0,0,0
1000000US060952529041059,060952529041059,"Block 1059, Block Group 1, Census Tract 2529.04, Solano County, California",15,15,0
1000000US060952529041060,060952529041060,"Block 1060, Block Group 1, Census Tract 2529.04, Solano County, California",1,1,0
1000000US060952529041061,060952529041061,"Block 1061, Block Group 1, Census Tract 2529.04, Solano County, California",0,0,0
1000000US060952529041062,060952529041062,"Block 1062, Block Group 1, Census Tract 2529.04, Solano County, California",0,0,0
1000000US060952529041063,060952529041063,"Block 1063, Block Group 1, Census Tract 2529.04, Solano County, California",92,88,4
1000000US060952529041064,060952529041064,"Block 1064, Block Group 1, Census Tract 2529.04, Solano County, California",0,0,0
1000000US060952529041065,060952529041065,"Block 1065, Block Group 1, Census Tract 2529.04, Solano County, California",0,0,0
1000000US060952529041066,060952529041066,"Block 1066, Block Group 1, Census Tract 2529.04, Solano County, California",0,0,0
1000000US060952529041067,060952529041067,"Block 1067, Block Group 1, Census Tract 2529.04, Solano County, California",0,0,0
1000000US060952529041068,060952529041068,"Block 1068, Block Group 1, Census Tract 2529.04, Solano County, California",0,0,0
1000000US060952529041069,060952529041069,"Block 1069, Block Group 1, Census Tract 2529.04, Solano County, California",0,0,0
1000000US060952529041070,060952529041070,"Block 1070, Block Group 1, Census Tract 2529.04, Solano County, California",0,0,0
1000000US060952529041071,060952529041071,"Block 1071, Block Group 1, Census Tract 2529.04, Solano County, California",22,21,1
1000000US060952529042000,060952529042000,"Block 2000, Block Group 2, Census Tract 2529.04, Solano County, California",6,6,0
1000000US060952529042001,060952529042001,"Block 2001, Block Group 2, Census Tract 2529.04, Solano County, California",0,0,0
1000000US060952529042002,060952529042002,"Block 2002, Block Group 2, Census Tract 2529.04, Solano County, California",0,0,0
1000000US060952529042003,060952529042003,"Block 2003, Block Group 2, Census Tract 2529.04, Solano County, California",0,0,0
1000000US060952529042004,060952529042004,"Block 2004, Block Group 2, Census Tract 2529.04, Solano County, California",2,1,1
1000000US060952529042005,060952529042005,"Block 2005, Block Group 2, Census Tract 2529.04, Solano County, California",0,0,0
1000000US060952529042006,060952529042006,"Block 2006, Block Group 2, Census Tract 2529.04, Solano County, California",0,0,0
1000000US060952529042007,060952529042007,"Block 2007, Block Group 2, Census Tract 2529.04, Solano County, California",0,0,0
1000000US060952529042008,060952529042008,"Block 2008, Block Group 2, Census Tract 2529.04, Solano County, California",0,0,0
1000000US060952529042009,060952529042009,"Block 2009, Block Group 2, Census Tract 2529.04, Solano County, California",0,0,0
1000000US060952529042010,060952529042010,"Block 2010, Block Group 2, Census Tract 2529.04, Solano County, California",0,0,0
1000000US060952529042011,060952529042011,"Block 2011, Block Group 2, Census Tract 2529.04, Solano County, California",0,0,0
1000000US060952529042012,060952529042012,"Block 2012, Block Group 2, Census Tract 2529.04, Solano County, California",0,0,0
1000000US060952529042013,060952529042013,"Block 2013, Block Group 2, Census Tract 2529.04, Solano County, California",0,0,0
1000000US060952529042014,060952529042014,"Block 2014, Block Group 2, Census Tract 2529.04, Solano County, California",0,0,0
1000000US060952529042015,060952529042015,"Block 2015, Block Group 2, Census Tract 2529.04, Solano County, California",0,0,0
1000000US060952529042016,060952529042016,"Block 2016, Block Group 2, Census Tract 2529.04, Solano County, California",0,0,0
1000000US060952529042017,060952529042017,"Block 2017, Block Group 2, Census Tract 2529.04, Solano County, California",0,0,0
1000000US060952529042018,060952529042018,"Block 2018, Block Group 2, Census Tract 2529.04, Solano County, California",0,0,0
1000000US060952529042019,060952529042019,"Block 2019, Block Group 2, Census Tract 2529.04, Solano County, California",0,0,0
1000000US060952529042020,060952529042020,"Block 2020, Block Group 2, Census Tract 2529.04, Solano County, California",3,3,0
1000000US060952529042021,060952529042021,"Block 2021, Block Group 2, Census Tract 2529.04, Solano County, California",0,0,0
1000000US060952529042022,060952529042022,"Block 2022, Block Group 2, Census Tract 2529.04, Solano County, California",0,0,0
1000000US060952529042023,060952529042023,"Block 2023, Block Group 2, Census Tract 2529.04, Solano County, California",0,0,0
1000000US060952529042024,060952529042024,"Block 2024, Block Group 2, Census Tract 2529.04, Solano County, California",0,0,0
1000000US060952529042025,060952529042025,"Block 2025, Block Group 2, Census Tract 2529.04, Solano County, California",3,3,0
1000000US060952529042026,060952529042026,"Block 2026, Block Group 2, Census Tract 2529.04, Solano County, California",4,4,0
1000000US060952529042027,060952529042027,"Block 2027, Block Group 2, Census Tract 2529.04, Solano County, California",2,2,0
1000000US060952529042028,060952529042028,"Block 2028, Block Group 2, Census Tract 2529.04, Solano County, California",1,1,0
1000000US060952529042029,060952529042029,"Block 2029, Block Group 2, Census Tract 2529.04, Solano County, California",0,0,0
1000000US060952529042030,060952529042030,"Block 2030, Block Group 2, Census Tract 2529.04, Solano County, California",0,0,0
1000000US060952529042031,060952529042031,"Block 2031, Block Group 2, Census Tract 2529.04, Solano County, California",10,10,0
1000000US060952529042032,060952529042032,"Block 2032, Block Group 2, Census Tract 2529.04, Solano County, California",2,2,0
1000000US060952529042033,060952529042033,"Block 2033, Block Group 2, Census Tract 2529.04, Solano County, California",0,0,0
1000000US060952529042034,060952529042034,"Block 2034, Block Group 2, Census Tract 2529.04, Solano County, California",0,0,0
1000000US060952529042035,060952529042035,"Block 2035, Block Group 2, Census Tract 2529.04, Solano County, California",0,0,0
1000000US060952529042036,060952529042036,"Block 2036, Block Group 2, Census Tract 2529.04, Solano County, California",0,0,0
1000000US060952529042037,060952529042037,"Block 2037, Block Group 2, Census Tract 2529.04, Solano County, California",0,0,0
1000000US060952529042038,060952529042038,"Block 2038, Block Group 2, Census Tract 2529.04, Solano County, California",0,0,0
1000000US060952529042039,060952529042039,"Block 2039, Block Group 2, Census Tract 2529.04, Solano County, California",0,0,0
1000000US060952529042040,060952529042040,"Block 2040, Block Group 2, Census Tract 2529.04, Solano County, California",5,4,1
1000000US060952529042041,060952529042041,"Block 2041, Block Group 2, Census Tract 2529.04, Solano County, California",0,0,0
1000000US060952529042042,060952529042042,"Block 2042, Block Group 2, Census Tract 2529.04, Solano County, California",0,0,0
1000000US060952529042043,060952529042043,"Block 2043, Block Group 2, Census Tract 2529.04, Solano County, California",0,0,0
1000000US060952529042044,060952529042044,"Block 2044, Block Group 2, Census Tract 2529.04, Solano County, California",14,14,0
1000000US060952529042045,060952529042045,"Block 2045, Block Group 2, Census Tract 2529.04, Solano County, California",1,1,0
1000000US060952529042046,060952529042046,"Block 2046, Block Group 2, Census Tract 2529.04, Solano County, California",0,0,0
1000000US060952529042047,060952529042047,"Block 2047, Block Group 2, Census Tract 2529.04, Solano County, California",0,0,0
1000000US060952529042048,060952529042048,"Block 2048, Block Group 2, Census Tract 2529.04, Solano County, California",0,0,0
1000000US060952529042049,060952529042049,"Block 2049, Block Group 2, Census Tract 2529.04, Solano County, California",0,0,0
1000000US060952529042050,060952529042050,"Block 2050, Block Group 2, Census Tract 2529.04, Solano County, California",117,85,32
1000000US060952529042051,060952529042051,"Block 2051, Block Group 2, Census Tract 2529.04, Solano County, California",1,1,0
1000000US060952529042052,060952529042052,"Block 2052, Block Group 2, Census Tract 2529.04, Solano County, California",0,0,0
1000000US060952529042053,060952529042053,"Block 2053, Block Group 2, Census Tract 2529.04, Solano County, California",0,0,0
1000000US060952529042054,060952529042054,"Block 2054, Block Group 2, Census Tract 2529.04, Solano County, California",17,17,0
1000000US060952529042055,060952529042055,"Block 2055, Block Group 2, Census Tract 2529.04, Solano County, California",34,31,3
1000000US060952529042056,060952529042056,"Block 2056, Block Group 2, Census Tract 2529.04, Solano County, California",31,31,0
1000000US060952529042057,060952529042057,"Block 2057, Block Group 2, Census Tract 2529.04, Solano County, California",7,7,0
1000000US060952529042058,060952529042058,"Block 2058, Block Group 2, Census Tract 2529.04, Solano County, California",0,0,0
1000000US060952529042059,060952529042059,"Block 2059, Block Group 2, Census Tract 2529.04, Solano County, California",0,0,0
1000000US060952529042060,060952529042060,"Block 2060, Block Group 2, Census Tract 2529.04, Solano County, California",0,0,0
1000000US060952529042061,060952529042061,"Block 2061, Block Group 2, Census Tract 2529.04, Solano County, California",0,0,0
1000000US060952529042062,060952529042062,"Block 2062, Block Group 2, Census Tract 2529.04, Solano County, California",101,94,7
1000000US060952529042063,060952529042063,"Block 2063, Block Group 2, Census Tract 2529.04, Solano County, California",0,0,0
1000000US060952529042064,060952529042064,"Block 2064, Block Group 2, Census Tract 2529.04, Solano County, California",0,0,0
1000000US060952529042065,060952529042065,"Block 2065, Block Group 2, Census Tract 2529.04, Solano County, California",0,0,0
1000000US060952529042066,060952529042066,"Block 2066, Block Group 2, Census Tract 2529.04, Solano County, California",8,6,2
1000000US060952529042067,060952529042067,"Block 2067, Block Group 2, Census Tract 2529.04, Solano County, California",3,3,0
1000000US060952529042068,060952529042068,"Block 2068, Block Group 2, Census Tract 2529.04, Solano County, California",10,10,0
1000000US060952529042069,060952529042069,"Block 2069, Block Group 2, Census Tract 2529.04, Solano County, California",0,0,0
1000000US060952529042070,060952529042070,"Block 2070, Block Group 2, Census Tract 2529.04, Solano County, California",56,51,5
1000000US060952529042071,060952529042071,"Block 2071, Block Group 2, Census Tract 2529.04, Solano County, California",0,0,0
1000000US060952529042072,060952529042072,"Block 2072, Block Group 2, Census Tract 2529.04, Solano County, California",4,4,0
1000000US060952529042073,060952529042073,"Block 2073, Block Group 2, Census Tract 2529.04, Solano County, California",0,0,0
1000000US060952529042074,060952529042074,"Block 2074, Block Group 2, Census Tract 2529.04, Solano County, California",18,17,1
1000000US060952529042075,060952529042075,"Block 2075, Block Group 2, Census Tract 2529.04, Solano County, California",18,12,6
1000000US060952529042076,060952529042076,"Block 2076, Block Group 2, Census Tract 2529.04, Solano County, California",0,0,0
1000000US060952529042077,060952529042077,"Block 2077, Block Group 2, Census Tract 2529.04, Solano County, California",0,0,0
1000000US060952529042078,060952529042078,"Block 2078, Block Group 2, Census Tract 2529.04, Solano County, California",0,0,0
1000000US060952529042079,060952529042079,"Block 2079, Block Group 2, Census Tract 2529.04, Solano County, California",0,0,0
1000000US060952529042080,060952529042080,"Block 2080, Block Group 2, Census Tract 2529.04, Solano County, California",0,0,0
1000000US060952529042081,060952529042081,"Block 2081, Block Group 2, Census Tract 2529.04, Solano County, California",1,1,0
1000000US060952529042082,060952529042082,"Block 2082, Block Group 2, Census Tract 2529.04, Solano County, California",0,0,0
1000000US060952529042083,060952529042083,"Block 2083, Block Group 2, Census Tract 2529.04, Solano County, California",1,1,0
1000000US060952529042084,060952529042084,"Block 2084, Block Group 2, Census Tract 2529.04, Solano County, California",0,0,0
1000000US060952529042085,060952529042085,"Block 2085, Block Group 2, Census Tract 2529.04, Solano County, California",0,0,0
1000000US060952529042086,060952529042086,"Block 2086, Block Group 2, Census Tract 2529.04, Solano County, California",0,0,0
1000000US060952529042087,060952529042087,"Block 2087, Block Group 2, Census Tract 2529.04, Solano County, California",0,0,0
1000000US060952529042088,060952529042088,"Block 2088, Block Group 2, Census Tract 2529.04, Solano County, California",0,0,0
1000000US060952529042089,060952529042089,"Block 2089, Block Group 2, Census Tract 2529.04, Solano County, California",0,0,0
1000000US060952529042090,060952529042090,"Block 2090, Block Group 2, Census Tract 2529.04, Solano County, California",1,1,0
1000000US060952529042091,060952529042091,"Block 2091, Block Group 2, Census Tract 2529.04, Solano County, California",0,0,0
1000000US060952529042092,060952529042092,"Block 2092, Block Group 2, Census Tract 2529.04, Solano County, California",0,0,0
1000000US060952529042093,060952529042093,"Block 2093, Block Group 2, Census Tract 2529.04, Solano County, California",0,0,0
1000000US060952529042094,060952529042094,"Block 2094, Block Group 2, Census Tract 2529.04, Solano County, California",0,0,0
1000000US060952529042095,060952529042095,"Block 2095, Block Group 2, Census Tract 2529.04, Solano County, California",0,0,0
1000000US060952529042096,060952529042096,"Block 2096, Block Group 2, Census Tract 2529.04, Solano County, California",0,0,0
1000000US060952529042097,060952529042097,"Block 2097, Block Group 2, Census Tract 2529.04, Solano County, California",0,0,0
1000000US060952529042098,060952529042098,"Block 2098, Block Group 2, Census Tract 2529.04, Solano County, California",0,0,0
1000000US060952529042099,060952529042099,"Block 2099, Block Group 2, Census Tract 2529.04, Solano County, California",0,0,0
1000000US060952529042100,060952529042100,"Block 2100, Block Group 2, Census Tract 2529.04, Solano County, California",0,0,0
1000000US060952529042101,060952529042101,"Block 2101, Block Group 2, Census Tract 2529.04, Solano County, California",0,0,0
1000000US060952529042102,060952529042102,"Block 2102, Block Group 2, Census Tract 2529.04, Solano County, California",0,0,0
1000000US060952529042103,060952529042103,"Block 2103, Block Group 2, Census Tract 2529.04, Solano County, California",0,0,0
1000000US060952529042104,060952529042104,"Block 2104, Block Group 2, Census Tract 2529.04, Solano County, California",0,0,0
1000000US060952529042105,060952529042105,"Block 2105, Block Group 2, Census Tract 2529.04, Solano County, California",0,0,0
1000000US060952529042106,060952529042106,"Block 2106, Block Group 2, Census Tract 2529.04, Solano County, California",0,0,0
1000000US060952529042107,060952529042107,"Block 2107, Block Group 2, Census Tract 2529.04, Solano County, California",0,0,0
1000000US060952529042108,060952529042108,"Block 2108, Block Group 2, Census Tract 2529.04, Solano County, California",0,0,0
1000000US060952529042109,060952529042109,"Block 2109, Block Group 2, Census Tract 2529.04, Solano County, California",0,0,0
1000000US060952529042110,060952529042110,"Block 2110, Block Group 2, Census Tract 2529.04, Solano County, California",0,0,0
1000000US060952529042111,060952529042111,"Block 2111, Block Group 2, Census Tract 2529.04, Solano County, California",0,0,0
1000000US060952529042112,060952529042112,"Block 2112, Block Group 2, Census Tract 2529.04, Solano County, California",0,0,0
1000000US060952529042113,060952529042113,"Block 2113, Block Group 2, Census Tract 2529.04, Solano County, California",0,0,0
1000000US060952529042114,060952529042114,"Block 2114, Block Group 2, Census Tract 2529.04, Solano County, California",0,0,0
1000000US060952529042115,060952529042115,"Block 2115, Block Group 2, Census Tract 2529.04, Solano County, California",0,0,0
1000000US060952529042116,060952529042116,"Block 2116, Block Group 2, Census Tract 2529.04, Solano County, California",0,0,0
1000000US060952529042117,060952529042117,"Block 2117, Block Group 2, Census Tract 2529.04, Solano County, California",0,0,0
1000000US060952529042118,060952529042118,"Block 2118, Block Group 2, Census Tract 2529.04, Solano County, California",0,0,0
1000000US060952529042119,060952529042119,"Block 2119, Block Group 2, Census Tract 2529.04, Solano County, California",0,0,0
1000000US060952529042120,060952529042120,"Block 2120, Block Group 2, Census Tract 2529.04, Solano County, California",0,0,0
1000000US060952529042121,060952529042121,"Block 2121, Block Group 2, Census Tract 2529.04, Solano County, California",0,0,0
1000000US060952529042122,060952529042122,"Block 2122, Block Group 2, Census Tract 2529.04, Solano County, California",0,0,0
1000000US060952529042123,060952529042123,"Block 2123, Block Group 2, Census Tract 2529.04, Solano County, California",0,0,0
1000000US060952529042124,060952529042124,"Block 2124, Block Group 2, Census Tract 2529.04, Solano County, California",0,0,0
1000000US060952529042125,060952529042125,"Block 2125, Block Group 2, Census Tract 2529.04, Solano County, California",1,1,0
1000000US060952529042126,060952529042126,"Block 2126, Block Group 2, Census Tract 2529.04, Solano County, California",0,0,0
1000000US060952529042127,060952529042127,"Block 2127, Block Group 2, Census Tract 2529.04, Solano County, California",0,0,0
1000000US060952529042128,060952529042128,"Block 2128, Block Group 2, Census Tract 2529.04, Solano County, California",0,0,0
1000000US060952529042129,060952529042129,"Block 2129, Block Group 2, Census Tract 2529.04, Solano County, California",9,8,1
1000000US060952529042130,060952529042130,"Block 2130, Block Group 2, Census Tract 2529.04, Solano County, California",0,0,0
1000000US060952529042131,060952529042131,"Block 2131, Block Group 2, Census Tract 2529.04, Solano County, California",2,2,0
1000000US060952529042132,060952529042132,"Block 2132, Block Group 2, Census Tract 2529.04, Solano County, California",0,0,0
1000000US060952529042133,060952529042133,"Block 2133, Block Group 2, Census Tract 2529.04, Solano County, California",0,0,0
1000000US060952529042134,060952529042134,"Block 2134, Block Group 2, Census Tract 2529.04, Solano County, California",0,0,0
1000000US060952529042135,060952529042135,"Block 2135, Block Group 2, Census Tract 2529.04, Solano County, California",0,0,0
1000000US060952529042136,060952529042136,"Block 2136, Block Group 2, Census Tract 2529.04, Solano County, California",0,0,0
1000000US060952529042137,060952529042137,"Block 2137, Block Group 2, Census Tract 2529.04, Solano County, California",35,33,2
1000000US060952529042138,060952529042138,"Block 2138, Block Group 2, Census Tract 2529.04, Solano County, California",0,0,0
1000000US060952529042139,060952529042139,"Block 2139, Block Group 2, Census Tract 2529.04, Solano County, California",0,0,0
1000000US060952529042140,060952529042140,"Block 2140, Block Group 2, Census Tract 2529.04, Solano County, California",316,295,21
1000000US060952529042141,060952529042141,"Block 2141, Block Group 2, Census Tract 2529.04, Solano County, California",0,0,0
1000000US060952529042142,060952529042142,"Block 2142, Block Group 2, Census Tract 2529.04, Solano County, California",0,0,0
1000000US060952529042143,060952529042143,"Block 2143, Block Group 2, Census Tract 2529.04, Solano County, California",0,0,0
1000000US060952529042144,060952529042144,"Block 2144, Block Group 2, Census Tract 2529.04, Solano County, California",2,2,0
1000000US060952529042145,060952529042145,"Block 2145, Block Group 2, Census Tract 2529.04, Solano County, California",0,0,0
1000000US060952529042146,060952529042146,"Block 2146, Block Group 2, Census Tract 2529.04, Solano County, California",0,0,0
1000000US060952529043000,060952529043000,"Block 3000, Block Group 3, Census Tract 2529.04, Solano County, California",0,0,0
1000000US060952529043001,060952529043001,"Block 3001, Block Group 3, Census Tract 2529.04, Solano County, California",0,0,0
1000000US060952529043002,060952529043002,"Block 3002, Block Group 3, Census Tract 2529.04, Solano County, California",0,0,0
1000000US060952529043003,060952529043003,"Block 3003, Block Group 3, Census Tract 2529.04, Solano County, California",0,0,0
1000000US060952529043004,060952529043004,"Block 3004, Block Group 3, Census Tract 2529.04, Solano County, California",0,0,0
1000000US060952529043005,060952529043005,"Block 3005, Block Group 3, Census Tract 2529.04, Solano County, California",0,0,0
1000000US060952529043006,060952529043006,"Block 3006, Block Group 3, Census Tract 2529.04, Solano County, California",0,0,0
1000000US060952529043007,060952529043007,"Block 3007, Block Group 3, Census Tract 2529.04, Solano County, California",0,0,0
1000000US060952529043008,060952529043008,"Block 3008, Block Group 3, Census Tract 2529.04, Solano County, California",0,0,0
1000000US060952529043009,060952529043009,"Block 3009, Block Group 3, Census Tract 2529.04, Solano County, California",0,0,0
1000000US060952529043010,060952529043010,"Block 3010, Block Group 3, Census Tract 2529.04, Solano County, California",11,10,1
1000000US060952529043011,060952529043011,"Block 3011, Block Group 3, Census Tract 2529.04, Solano County, California",0,0,0
1000000US060952529043012,060952529043012,"Block 3012, Block Group 3, Census Tract 2529.04, Solano County, California",0,0,0
1000000US060952529043013,060952529043013,"Block 3013, Block Group 3, Census Tract 2529.04, Solano County, California",0,0,0
1000000US060952529043014,060952529043014,"Block 3014, Block Group 3, Census Tract 2529.04, Solano County, California",0,0,0
1000000US060952529043015,060952529043015,"Block 3015, Block Group 3, Census Tract 2529.04, Solano County, California",0,0,0
1000000US060952529043016,060952529043016,"Block 3016, Block Group 3, Census Tract 2529.04, Solano County, California",0,0,0
1000000US060952529043017,060952529043017,"Block 3017, Block Group 3, Census Tract 2529.04, Solano County, California",0,0,0
1000000US060952529043018,060952529043018,"Block 3018, Block Group 3, Census Tract 2529.04, Solano County, California",0,0,0
1000000US060952529043019,060952529043019,"Block 3019, Block Group 3, Census Tract 2529.04, Solano County, California",0,0,0
1000000US060952529043020,060952529043020,"Block 3020, Block Group 3, Census Tract 2529.04, Solano County, California",0,0,0
1000000US060952529043021,060952529043021,"Block 3021, Block Group 3, Census Tract 2529.04, Solano County, California",0,0,0
1000000US060952529043022,060952529043022,"Block 3022, Block Group 3, Census Tract 2529.04, Solano County, California",0,0,0
1000000US060952529043023,060952529043023,"Block 3023, Block Group 3, Census Tract 2529.04, Solano County, California",0,0,0
1000000US060952529043024,060952529043024,"Block 3024, Block Group 3, Census Tract 2529.04, Solano County, California",4,4,0
1000000US060952529043025,060952529043025,"Block 3025, Block Group 3, Census Tract 2529.04, Solano County, California",0,0,0
1000000US060952529043026,060952529043026,"Block 3026, Block Group 3, Census Tract 2529.04, Solano County, California",0,0,0
1000000US060952529043027,060952529043027,"Block 3027, Block Group 3, Census Tract 2529.04, Solano County, California",0,0,0
1000000US060952529043028,060952529043028,"Block 3028, Block Group 3, Census Tract 2529.04, Solano County, California",0,0,0
1000000US060952529043029,060952529043029,"Block 3029, Block Group 3, Census Tract 2529.04, Solano County, California",0,0,0
1000000US060952529043030,060952529043030,"Block 3030, Block Group 3, Census Tract 2529.04, Solano County, California",7,7,0
1000000US060952529043031,060952529043031,"Block 3031, Block Group 3, Census Tract 2529.04, Solano County, California",0,0,0
1000000US060952529043032,060952529043032,"Block 3032, Block Group 3, Census Tract 2529.04, Solano County, California",1,1,0
1000000US060952529043033,060952529043033,"Block 3033, Block Group 3, Census Tract 2529.04, Solano County, California",1,1,0
1000000US060952529043034,060952529043034,"Block 3034, Block Group 3, Census Tract 2529.04, Solano County, California",0,0,0
1000000US060952529043035,060952529043035,"Block 3035, Block Group 3, Census Tract 2529.04, Solano County, California",0,0,0
1000000US060952529043036,060952529043036,"Block 3036, Block Group 3, Census Tract 2529.04, Solano County, California",0,0,0
1000000US060952529043037,060952529043037,"Block 3037, Block Group 3, Census Tract 2529.04, Solano County, California",0,0,0
1000000US060952529043038,060952529043038,"Block 3038, Block Group 3, Census Tract 2529.04, Solano County, California",0,0,0
1000000US060952529043039,060952529043039,"Block 3039, Block Group 3, Census Tract 2529.04, Solano County, California",9,9,0
1000000US060952529043040,060952529043040,"Block 3040, Block Group 3, Census Tract 2529.04, Solano County, California",2,2,0
1000000US060952529043041,060952529043041,"Block 3041, Block Group 3, Census Tract 2529.04, Solano County, California",1,1,0
1000000US060952529043042,060952529043042,"Block 3042, Block Group 3, Census Tract 2529.04, Solano County, California",1,1,0
1000000US060952529043043,060952529043043,"Block 3043, Block Group 3, Census Tract 2529.04, Solano County, California",7,5,2
1000000US060952529043044,060952529043044,"Block 3044, Block Group 3, Census Tract 2529.04, Solano County, California",3,3,0
1000000US060952529043045,060952529043045,"Block 3045, Block Group 3, Census Tract 2529.04, Solano County, California",0,0,0
1000000US060952529043046,060952529043046,"Block 3046, Block Group 3, Census Tract 2529.04, Solano County, California",11,8,3
1000000US060952529043047,060952529043047,"Block 3047, Block Group 3, Census Tract 2529.04, Solano County, California",3,3,0
1000000US060952529043048,060952529043048,"Block 3048, Block Group 3, Census Tract 2529.04, Solano County, California",0,0,0
1000000US060952529043049,060952529043049,"Block 3049, Block Group 3, Census Tract 2529.04, Solano County, California",0,0,0
1000000US060952529043050,060952529043050,"Block 3050, Block Group 3, Census Tract 2529.04, Solano County, California",7,5,2
1000000US060952529043051,060952529043051,"Block 3051, Block Group 3, Census Tract 2529.04, Solano County, California",5,5,0
1000000US060952529043052,060952529043052,"Block 3052, Block Group 3, Census Tract 2529.04, Solano County, California",4,2,2
1000000US060952529043053,060952529043053,"Block 3053, Block Group 3, Census Tract 2529.04, Solano County, California",0,0,0
1000000US060952529043054,060952529043054,"Block 3054, Block Group 3, Census Tract 2529.04, Solano County, California",0,0,0
1000000US060952529043055,060952529043055,"Block 3055, Block Group 3, Census Tract 2529.04, Solano County, California",0,0,0
1000000US060952529043056,060952529043056,"Block 3056, Block Group 3, Census Tract 2529.04, Solano County, California",0,0,0
1000000US060952529043057,060952529043057,"Block 3057, Block Group 3, Census Tract 2529.04, Solano County, California",1,1,0
1000000US060952529043058,060952529043058,"Block 3058, Block Group 3, Census Tract 2529.04, Solano County, California",0,0,0
1000000US060952529043059,060952529043059,"Block 3059, Block Group 3, Census Tract 2529.04, Solano County, California",0,0,0
1000000US060952529043060,060952529043060,"Block 3060, Block Group 3, Census Tract 2529.04, Solano County, California",0,0,0
1000000US060952529043061,060952529043061,"Block 3061, Block Group 3, Census Tract 2529.04, Solano County, California",0,0,0
1000000US060952529043062,060952529043062,"Block 3062, Block Group 3, Census Tract 2529.04, Solano County, California",0,0,0
1000000US060952529043063,060952529043063,"Block 3063, Block Group 3, Census Tract 2529.04, Solano County, California",24,23,1
1000000US060952529043064,060952529043064,"Block 3064, Block Group 3, Census Tract 2529.04, Solano County, California",0,0,0
1000000US060952529043065,060952529043065,"Block 3065, Block Group 3, Census Tract 2529.04, Solano County, California",15,14,1
1000000US060952529043066,060952529043066,"Block 3066, Block Group 3, Census Tract 2529.04, Solano County, California",5,5,0
1000000US060952529043067,060952529043067,"Block 3067, Block Group 3, Census Tract 2529.04, Solano County, California",0,0,0
1000000US060952529043068,060952529043068,"Block 3068, Block Group 3, Census Tract 2529.04, Solano County, California",102,100,2
1000000US060952529043069,060952529043069,"Block 3069, Block Group 3, Census Tract 2529.04, Solano County, California",48,47,1
1000000US060952529043070,060952529043070,"Block 3070, Block Group 3, Census Tract 2529.04, Solano County, California",40,38,2
1000000US060952529043071,060952529043071,"Block 3071, Block Group 3, Census Tract 2529.04, Solano County, California",12,11,1
1000000US060952529043072,060952529043072,"Block 3072, Block Group 3, Census Tract 2529.04, Solano County, California",14,14,0
1000000US060952529043073,060952529043073,"Block 3073, Block Group 3, Census Tract 2529.04, Solano County, California",18,18,0
1000000US060952529043074,060952529043074,"Block 3074, Block Group 3, Census Tract 2529.04, Solano County, California",23,21,2
1000000US060952529043075,060952529043075,"Block 3075, Block Group 3, Census Tract 2529.04, Solano County, California",0,0,0
1000000US060952529043076,060952529043076,"Block 3076, Block Group 3, Census Tract 2529.04, Solano County, California",0,0,0
1000000US060952529043077,060952529043077,"Block 3077, Block Group 3, Census Tract 2529.04, Solano County, California",0,0,0
1000000US060952529043078,060952529043078,"Block 3078, Block Group 3, Census Tract 2529.04, Solano County, California",2,2,0
1000000US060952529043079,060952529043079,"Block 3079, Block Group 3, Census Tract 2529.04, Solano County, California",0,0,0
1000000US060952529043080,060952529043080,"Block 3080, Block Group 3, Census Tract 2529.04, Solano County, California",1,1,0
1000000US060952529043081,060952529043081,"Block 3081, Block Group 3, Census Tract 2529.04, Solano County, California",1,1,0
1000000US060952529043082,060952529043082,"Block 3082, Block Group 3, Census Tract 2529.04, Solano County, California",2,2,0
1000000US060952529043083,060952529043083,"Block 3083, Block Group 3, Census Tract 2529.04, Solano County, California",0,0,0
1000000US060952529043084,060952529043084,"Block 3084, Block Group 3, Census Tract 2529.04, Solano County, California",0,0,0
1000000US060952529043085,060952529043085,"Block 3085, Block Group 3, Census Tract 2529.04, Solano County, California",0,0,0
1000000US060952529043086,060952529043086,"Block 3086, Block Group 3, Census Tract 2529.04, Solano County, California",14,10,4
1000000US060952529043087,060952529043087,"Block 3087, Block Group 3, Census Tract 2529.04, Solano County, California",1,0,1
1000000US060952529043088,060952529043088,"Block 3088, Block Group 3, Census Tract 2529.04, Solano County, California",5,5,0
1000000US060952529043089,060952529043089,"Block 3089, Block Group 3, Census Tract 2529.04, Solano County, California",0,0,0
1000000US060952529043090,060952529043090,"Block 3090, Block Group 3, Census Tract 2529.04, Solano County, California",0,0,0
1000000US060952529043091,060952529043091,"Block 3091, Block Group 3, Census Tract 2529.04, Solano County, California",0,0,0
1000000US060952529043092,060952529043092,"Block 3092, Block Group 3, Census Tract 2529.04, Solano County, California",0,0,0
1000000US060952529043093,060952529043093,"Block 3093, Block Group 3, Census Tract 2529.04, Solano County, California",0,0,0
1000000US060952529043094,060952529043094,"Block 3094, Block Group 3, Census Tract 2529.04, Solano County, California",0,0,0
1000000US060952529043095,060952529043095,"Block 3095, Block Group 3, Census Tract 2529.04, Solano County, California",0,0,0
1000000US060952529043096,060952529043096,"Block 3096, Block Group 3, Census Tract 2529.04, Solano County, California",0,0,0
1000000US060952529043097,060952529043097,"Block 3097, Block Group 3, Census Tract 2529.04, Solano County, California",0,0,0
1000000US060952529043098,060952529043098,"Block 3098, Block Group 3, Census Tract 2529.04, Solano County, California",18,17,1
1000000US060952529043099,060952529043099,"Block 3099, Block Group 3, Census Tract 2529.04, Solano County, California",0,0,0
1000000US060952529043100,060952529043100,"Block 3100, Block Group 3, Census Tract 2529.04, Solano County, California",5,5,0
1000000US060952529043101,060952529043101,"Block 3101, Block Group 3, Census Tract 2529.04, Solano County, California",0,0,0
1000000US060952529043102,060952529043102,"Block 3102, Block Group 3, Census Tract 2529.04, Solano County, California",0,0,0
1000000US060952529043103,060952529043103,"Block 3103, Block Group 3, Census Tract 2529.04, Solano County, California",0,0,0
1000000US060952529043104,060952529043104,"Block 3104, Block Group 3, Census Tract 2529.04, Solano County, California",1,1,0
1000000US060952529043105,060952529043105,"Block 3105, Block Group 3, Census Tract 2529.04, Solano County, California",0,0,0
1000000US060952529043106,060952529043106,"Block 3106, Block Group 3, Census Tract 2529.04, Solano County, California",0,0,0
1000000US060952529043107,060952529043107,"Block 3107, Block Group 3, Census Tract 2529.04, Solano County, California",0,0,0
1000000US060952529043108,060952529043108,"Block 3108, Block Group 3, Census Tract 2529.04, Solano County, California",0,0,0
1000000US060952529043109,060952529043109,"Block 3109, Block Group 3, Census Tract 2529.04, Solano County, California",0,0,0
1000000US060952529043110,060952529043110,"Block 3110, Block Group 3, Census Tract 2529.04, Solano County, California",0,0,0
1000000US060952529043111,060952529043111,"Block 3111, Block Group 3, Census Tract 2529.04, Solano County, California",0,0,0
1000000US060952529043112,060952529043112,"Block 3112, Block Group 3, Census Tract 2529.04, Solano County, California",0,0,0
1000000US060952529043113,060952529043113,"Block 3113, Block Group 3, Census Tract 2529.04, Solano County, California",0,0,0
1000000US060952529043114,060952529043114,"Block 3114, Block Group 3, Census Tract 2529.04, Solano County, California",0,0,0
1000000US060952529043115,060952529043115,"Block 3115, Block Group 3, Census Tract 2529.04, Solano County, California",0,0,0
1000000US060952529043116,060952529043116,"Block 3116, Block Group 3, Census Tract 2529.04, Solano County, California",2,2,0
1000000US060952529043117,060952529043117,"Block 3117, Block Group 3, Census Tract 2529.04, Solano County, California",4,4,0
1000000US060952529043118,060952529043118,"Block 3118, Block Group 3, Census Tract 2529.04, Solano County, California",14,11,3
1000000US060952529043119,060952529043119,"Block 3119, Block Group 3, Census Tract 2529.04, Solano County, California",0,0,0
1000000US060952529043120,060952529043120,"Block 3120, Block Group 3, Census Tract 2529.04, Solano County, California",0,0,0
1000000US060952529043121,060952529043121,"Block 3121, Block Group 3, Census Tract 2529.04, Solano County, California",9,9,0
1000000US060952529043122,060952529043122,"Block 3122, Block Group 3, Census Tract 2529.04, Solano County, California",21,19,2
1000000US060952529043123,060952529043123,"Block 3123, Block Group 3, Census Tract 2529.04, Solano County, California",8,8,0
1000000US060952529043124,060952529043124,"Block 3124, Block Group 3, Census Tract 2529.04, Solano County, California",1,1,0
1000000US060952529043125,060952529043125,"Block 3125, Block Group 3, Census Tract 2529.04, Solano County, California",2,2,0
1000000US060952529043126,060952529043126,"Block 3126, Block Group 3, Census Tract 2529.04, Solano County, California",3,3,0
1000000US060952529043127,060952529043127,"Block 3127, Block Group 3, Census Tract 2529.04, Solano County, California",4,4,0
1000000US060952529043128,060952529043128,"Block 3128, Block Group 3, Census Tract 2529.04, Solano County, California",0,0,0
1000000US060952529043129,060952529043129,"Block 3129, Block Group 3, Census Tract 2529.04, Solano County, California",0,0,0
1000000US060952529081000,060952529081000,"Block 1000, Block Group 1, Census Tract 2529.08, Solano County, California",115,113,2
1000000US060952529081001,060952529081001,"Block 1001, Block Group 1, Census Tract 2529.08, Solano County, California",11,11,0
1000000US060952529081002,060952529081002,"Block 1002, Block Group 1, Census Tract 2529.08, Solano County, California",24,23,1
1000000US060952529081003,060952529081003,"Block 1003, Block Group 1, Census Tract 2529.08, Solano County, California",0,0,0
1000000US060952529081004,060952529081004,"Block 1004, Block Group 1, Census Tract 2529.08, Solano County, California",37,36,1
1000000US060952529081005,060952529081005,"Block 1005, Block Group 1, Census Tract 2529.08, Solano County, California",19,18,1
1000000US060952529081006,060952529081006,"Block 1006, Block Group 1, Census Tract 2529.08, Solano County, California",93,90,3
1000000US060952529081007,060952529081007,"Block 1007, Block Group 1, Census Tract 2529.08, Solano County, California",31,28,3
1000000US060952529081008,060952529081008,"Block 1008, Block Group 1, Census Tract 2529.08, Solano County, California",26,26,0
1000000US060952529082000,060952529082000,"Block 2000, Block Group 2, Census Tract 2529.08, Solano County, California",112,111,1
1000000US060952529082001,060952529082001,"Block 2001, Block Group 2, Census Tract 2529.08, Solano County, California",128,116,12
1000000US060952529082002,060952529082002,"Block 2002, Block Group 2, Census Tract 2529.08, Solano County, California",0,0,0
1000000US060952529082003,060952529082003,"Block 2003, Block Group 2, Census Tract 2529.08, Solano County, California",65,64,1
1000000US060952529082004,060952529082004,"Block 2004, Block Group 2, Census Tract 2529.08, Solano County, California",0,0,0
1000000US060952529082005,060952529082005,"Block 2005, Block Group 2, Census Tract 2529.08, Solano County, California",41,38,3
1000000US060952529082006,060952529082006,"Block 2006, Block Group 2, Census Tract 2529.08, Solano County, California",0,0,0
1000000US060952529082007,060952529082007,"Block 2007, Block Group 2, Census Tract 2529.08, Solano County, California",27,26,1
1000000US060952529082008,060952529082008,"Block 2008, Block Group 2, Census Tract 2529.08, Solano County, California",180,174,6
1000000US060952529082009,060952529082009,"Block 2009, Block Group 2, Census Tract 2529.08, Solano County, California",10,10,0
1000000US060952529082010,060952529082010,"Block 2010, Block Group 2, Census Tract 2529.08, Solano County, California",46,40,6
1000000US060952529082011,060952529082011,"Block 2011, Block Group 2, Census Tract 2529.08, Solano County, California",84,80,4
1000000US060952529083000,060952529083000,"Block 3000, Block Group 3, Census Tract 2529.08, Solano County, California",0,0,0
1000000US060952529083001,060952529083001,"Block 3001, Block Group 3, Census Tract 2529.08, Solano County, California",0,0,0
1000000US060952529083002,060952529083002,"Block 3002, Block Group 3, Census Tract 2529.08, Solano County, California",22,20,2
1000000US060952529083003,060952529083003,"Block 3003, Block Group 3, Census Tract 2529.08, Solano County, California",20,19,1
1000000US060952529083004,060952529083004,"Block 3004, Block Group 3, Census Tract 2529.08, Solano County, California",0,0,0
1000000US060952529083005,060952529083005,"Block 3005, Block Group 3, Census Tract 2529.08, Solano County, California",0,0,0
1000000US060952529083006,060952529083006,"Block 3006, Block Group 3, Census Tract 2529.08, Solano County, California",64,59,5
1000000US060952529083007,060952529083007,"Block 3007, Block Group 3, Census Tract 2529.08, Solano County, California",23,22,1
1000000US060952529083008,060952529083008,"Block 3008, Block Group 3, Census Tract 2529.08, Solano County, California",24,24,0
1000000US060952529083009,060952529083009,"Block 3009, Block Group 3, Census Tract 2529.08, Solano County, California",25,24,1
1000000US060952529083010,060952529083010,"Block 3010, Block Group 3, Census Tract 2529.08, Solano County, California",24,24,0
1000000US060952529083011,060952529083011,"Block 3011, Block Group 3, Census Tract 2529.08, Solano County, California",38,36,2
1000000US060952529083012,060952529083012,"Block 3012, Block Group 3, Census Tract 2529.08, Solano County, California",34,32,2
1000000US060952529083013,060952529083013,"Block 3013, Block Group 3, Census Tract 2529.08, Solano County, California",21,21,0
1000000US060952529091000,060952529091000,"Block 1000, Block Group 1, Census Tract 2529.09, Solano County, California",63,61,2
1000000US060952529091001,060952529091001,"Block 1001, Block Group 1, Census Tract 2529.09, Solano County, California",53,51,2
1000000US060952529091002,060952529091002,"Block 1002, Block Group 1, Census Tract 2529.09, Solano County, California",35,33,2
1000000US060952529091003,060952529091003,"Block 1003, Block Group 1, Census Tract 2529.09, Solano County, California",42,40,2
1000000US060952529091004,060952529091004,"Block 1004, Block Group 1, Census Tract 2529.09, Solano County, California",45,42,3
1000000US060952529091005,060952529091005,"Block 1005, Block Group 1, Census Tract 2529.09, Solano County, California",36,34,2
1000000US060952529091006,060952529091006,"Block 1006, Block Group 1, Census Tract 2529.09, Solano County, California",57,57,0
1000000US060952529091007,060952529091007,"Block 1007, Block Group 1, Census Tract 2529.09, Solano County, California",52,48,4
1000000US060952529091008,060952529091008,"Block 1008, Block Group 1, Census Tract 2529.09, Solano County, California",28,26,2
1000000US060952529091009,060952529091009,"Block 1009, Block Group 1, Census Tract 2529.09, Solano County, California",54,50,4
1000000US060952529091010,060952529091010,"Block 1010, Block Group 1, Census Tract 2529.09, Solano County, California",0,0,0
1000000US060952529091011,060952529091011,"Block 1011, Block Group 1, Census Tract 2529.09, Solano County, California",0,0,0
1000000US060952529091012,060952529091012,"Block 1012, Block Group 1, Census Tract 2529.09, Solano County, California",21,21,0
1000000US060952529091013,060952529091013,"Block 1013, Block Group 1, Census Tract 2529.09, Solano County, California",46,45,1
1000000US060952529091014,060952529091014,"Block 1014, Block Group 1, Census Tract 2529.09, Solano County, California",7,7,0
1000000US060952529091015,060952529091015,"Block 1015, Block Group 1, Census Tract 2529.09, Solano County, California",0,0,0
1000000US060952529091016,060952529091016,"Block 1016, Block Group 1, Census Tract 2529.09, Solano County, California",0,0,0
1000000US060952529091017,060952529091017,"Block 1017, Block Group 1, Census Tract 2529.09, Solano County, California",0,0,0
1000000US060952529091018,060952529091018,"Block 1018, Block Group 1, Census Tract 2529.09, Solano County, California",0,0,0
1000000US060952529092000,060952529092000,"Block 2000, Block Group 2, Census Tract 2529.09, Solano County, California",0,0,0
1000000US060952529092001,060952529092001,"Block 2001, Block Group 2, Census Tract 2529.09, Solano County, California",1,1,0
1000000US060952529092002,060952529092002,"Block 2002, Block Group 2, Census Tract 2529.09, Solano County, California",0,0,0
1000000US060952529092003,060952529092003,"Block 2003, Block Group 2, Census Tract 2529.09, Solano County, California",0,0,0
1000000US060952529092004,060952529092004,"Block 2004, Block Group 2, Census Tract 2529.09, Solano County, California",1,1,0
1000000US060952529092005,060952529092005,"Block 2005, Block Group 2, Census Tract 2529.09, Solano County, California",0,0,0
1000000US060952529092006,060952529092006,"Block 2006, Block Group 2, Census Tract 2529.09, Solano County, California",0,0,0
1000000US060952529092007,060952529092007,"Block 2007, Block Group 2, Census Tract 2529.09, Solano County, California",3,3,0
1000000US060952529092008,060952529092008,"Block 2008, Block Group 2, Census Tract 2529.09, Solano County, California",0,0,0
1000000US060952529092009,060952529092009,"Block 2009, Block Group 2, Census Tract 2529.09, Solano County, California",1,1,0
1000000US060952529092010,060952529092010,"Block 2010, Block Group 2, Census Tract 2529.09, Solano County, California",0,0,0
1000000US060952529092011,060952529092011,"Block 2011, Block Group 2, Census Tract 2529.09, Solano County, California",47,47,0
1000000US060952529092012,060952529092012,"Block 2012, Block Group 2, Census Tract 2529.09, Solano County, California",12,12,0
1000000US060952529092013,060952529092013,"Block 2013, Block Group 2, Census Tract 2529.09, Solano County, California",67,66,1
1000000US060952529092014,060952529092014,"Block 2014, Block Group 2, Census Tract 2529.09, Solano County, California",44,43,1
1000000US060952529092015,060952529092015,"Block 2015, Block Group 2, Census Tract 2529.09, Solano County, California",39,39,0
1000000US060952529092016,060952529092016,"Block 2016, Block Group 2, Census Tract 2529.09, Solano County, California",21,21,0
1000000US060952529092017,060952529092017,"Block 2017, Block Group 2, Census Tract 2529.09, Solano County, California",18,18,0
1000000US060952529092018,060952529092018,"Block 2018, Block Group 2, Census Tract 2529.09, Solano County, California",17,17,0
1000000US060952529092019,060952529092019,"Block 2019, Block Group 2, Census Tract 2529.09, Solano County, California",20,20,0
1000000US060952529092020,060952529092020,"Block 2020, Block Group 2, Census Tract 2529.09, Solano County, California",16,16,0
1000000US060952529092021,060952529092021,"Block 2021, Block Group 2, Census Tract 2529.09, Solano County, California",42,40,2
1000000US060952529092022,060952529092022,"Block 2022, Block Group 2, Census Tract 2529.09, Solano County, California",22,22,0
1000000US060952529092023,060952529092023,"Block 2023, Block Group 2, Census Tract 2529.09, Solano County, California",0,0,0
1000000US060952529092024,060952529092024,"Block 2024, Block Group 2, Census Tract 2529.09, Solano County, California",0,0,0
1000000US060952529092025,060952529092025,"Block 2025, Block Group 2, Census Tract 2529.09, Solano County, California",0,0,0
1000000US060952529092026,060952529092026,"Block 2026, Block Group 2, Census Tract 2529.09, Solano County, California",2,2,0
1000000US060952529092027,060952529092027,"Block 2027, Block Group 2, Census Tract 2529.09, Solano County, California",0,0,0
1000000US060952529092028,060952529092028,"Block 2028, Block Group 2, Census Tract 2529.09, Solano County, California",0,0,0
1000000US060952529092029,060952529092029,"Block 2029, Block Group 2, Census Tract 2529.09, Solano County, California",0,0,0
1000000US060952529092030,060952529092030,"Block 2030, Block Group 2, Census Tract 2529.09, Solano County, California",43,43,0
1000000US060952529092031,060952529092031,"Block 2031, Block Group 2, Census Tract 2529.09, Solano County, California",8,8,0
1000000US060952529092032,060952529092032,"Block 2032, Block Group 2, Census Tract 2529.09, Solano County, California",35,35,0
1000000US060952529092033,060952529092033,"Block 2033, Block Group 2, Census Tract 2529.09, Solano County, California",41,39,2
1000000US060952529092034,060952529092034,"Block 2034, Block Group 2, Census Tract 2529.09, Solano County, California",31,30,1
1000000US060952529092035,060952529092035,"Block 2035, Block Group 2, Census Tract 2529.09, Solano County, California",17,16,1
1000000US060952529092036,060952529092036,"Block 2036, Block Group 2, Census Tract 2529.09, Solano County, California",13,12,1
1000000US060952529092037,060952529092037,"Block 2037, Block Group 2, Census Tract 2529.09, Solano County, California",10,10,0
1000000US060952529101000,060952529101000,"Block 1000, Block Group 1, Census Tract 2529.10, Solano County, California",70,66,4
1000000US060952529101001,060952529101001,"Block 1001, Block Group 1, Census Tract 2529.10, Solano County, California",25,23,2
1000000US060952529101002,060952529101002,"Block 1002, Block Group 1, Census Tract 2529.10, Solano County, California",42,42,0
1000000US060952529101003,060952529101003,"Block 1003, Block Group 1, Census Tract 2529.10, Solano County, California",62,60,2
1000000US060952529101004,060952529101004,"Block 1004, Block Group 1, Census Tract 2529.10, Solano County, California",0,0,0
1000000US060952529101005,060952529101005,"Block 1005, Block Group 1, Census Tract 2529.10, Solano County, California",77,67,10
1000000US060952529101006,060952529101006,"Block 1006, Block Group 1, Census Tract 2529.10, Solano County, California",18,18,0
1000000US060952529101007,060952529101007,"Block 1007, Block Group 1, Census Tract 2529.10, Solano County, California",25,23,2
1000000US060952529101008,060952529101008,"Block 1008, Block Group 1, Census Tract 2529.10, Solano County, California",29,28,1
1000000US060952529101009,060952529101009,"Block 1009, Block Group 1, Census Tract 2529.10, Solano County, California",27,27,0
1000000US060952529101010,060952529101010,"Block 1010, Block Group 1, Census Tract 2529.10, Solano County, California",20,20,0
1000000US060952529101011,060952529101011,"Block 1011, Block Group 1, Census Tract 2529.10, Solano County, California",24,24,0
1000000US060952529101012,060952529101012,"Block 1012, Block Group 1, Census Tract 2529.10, Solano County, California",25,25,0
1000000US060952529101013,060952529101013,"Block 1013, Block Group 1, Census Tract 2529.10, Solano County, California",15,15,0
1000000US060952529101014,060952529101014,"Block 1014, Block Group 1, Census Tract 2529.10, Solano County, California",15,14,1
1000000US060952529102000,060952529102000,"Block 2000, Block Group 2, Census Tract 2529.10, Solano County, California",48,47,1
1000000US060952529102001,060952529102001,"Block 2001, Block Group 2, Census Tract 2529.10, Solano County, California",30,29,1
1000000US060952529102002,060952529102002,"Block 2002, Block Group 2, Census Tract 2529.10, Solano County, California",47,46,1
1000000US060952529102003,060952529102003,"Block 2003, Block Group 2, Census Tract 2529.10, Solano County, California",39,38,1
1000000US060952529102004,060952529102004,"Block 2004, Block Group 2, Census Tract 2529.10, Solano County, California",150,149,1
1000000US060952529102005,060952529102005,"Block 2005, Block Group 2, Census Tract 2529.10, Solano County, California",52,51,1
1000000US060952529102006,060952529102006,"Block 2006, Block Group 2, Census Tract 2529.10, Solano County, California",42,41,1
1000000US060952529102007,060952529102007,"Block 2007, Block Group 2, Census Tract 2529.10, Solano County, California",46,44,2
1000000US060952529102008,060952529102008,"Block 2008, Block Group 2, Census Tract 2529.10, Solano County, California",68,67,1
1000000US060952529103000,060952529103000,"Block 3000, Block Group 3, Census Tract 2529.10, Solano County, California",62,59,3
1000000US060952529103001,060952529103001,"Block 3001, Block Group 3, Census Tract 2529.10, Solano County, California",48,46,2
1000000US060952529103002,060952529103002,"Block 3002, Block Group 3, Census Tract 2529.10, Solano County, California",9,7,2
1000000US060952529103003,060952529103003,"Block 3003, Block Group 3, Census Tract 2529.10, Solano County, California",49,48,1
1000000US060952529103004,060952529103004,"Block 3004, Block Group 3, Census Tract 2529.10, Solano County, California",34,33,1
1000000US060952529103005,060952529103005,"Block 3005, Block Group 3, Census Tract 2529.10, Solano County, California",36,32,4
1000000US060952529103006,060952529103006,"Block 3006, Block Group 3, Census Tract 2529.10, Solano County, California",9,9,0
1000000US060952529103007,060952529103007,"Block 3007, Block Group 3, Census Tract 2529.10, Solano County, California",29,28,1
1000000US060952529103008,060952529103008,"Block 3008, Block Group 3, Census Tract 2529.10, Solano County, California",53,52,1
1000000US060952529103009,060952529103009,"Block 3009, Block Group 3, Census Tract 2529.10, Solano County, California",23,21,2
1000000US060952529103010,060952529103010,"Block 3010, Block Group 3, Census Tract 2529.10, Solano County, California",42,39,3
1000000US060952529103011,060952529103011,"Block 3011, Block Group 3, Census Tract 2529.10, Solano County, California",44,40,4
1000000US060952529103012,060952529103012,"Block 3012, Block Group 3, Census Tract 2529.10, Solano County, California",12,12,0
1000000US060952529103013,060952529103013,"Block 3013, Block Group 3, Census Tract 2529.10, Solano County, California",37,35,2
1000000US060952529103014,060952529103014,"Block 3014, Block Group 3, Census Tract 2529.10, Solano County, California",56,55,1
1000000US060952529103015,060952529103015,"Block 3015, Block Group 3, Census Tract 2529.10, Solano County, California",40,40,0
1000000US060952529103016,060952529103016,"Block 3016, Block Group 3, Census Tract 2529.10, Solano County, California",14,14,0
1000000US060952529103017,060952529103017,"Block 3017, Block Group 3, Census Tract 2529.10, Solano County, California",54,49,5
1000000US060952529104000,060952529104000,"Block 4000, Block Group 4, Census Tract 2529.10, Solano County, California",21,20,1
1000000US060952529104001,060952529104001,"Block 4001, Block Group 4, Census Tract 2529.10, Solano County, California",12,11,1
1000000US060952529104002,060952529104002,"Block 4002, Block Group 4, Census Tract 2529.10, Solano County, California",13,13,0
1000000US060952529104003,060952529104003,"Block 4003, Block Group 4, Census Tract 2529.10, Solano County, California",89,84,5
1000000US060952529104004,060952529104004,"Block 4004, Block Group 4, Census Tract 2529.10, Solano County, California",20,19,1
1000000US060952529104005,060952529104005,"Block 4005, Block Group 4, Census Tract 2529.10, Solano County, California",102,94,8
1000000US060952529104006,060952529104006,"Block 4006, Block Group 4, Census Tract 2529.10, Solano County, California",15,13,2
1000000US060952529104007,060952529104007,"Block 4007, Block Group 4, Census Tract 2529.10, Solano County, California",10,10,0
1000000US060952529104008,060952529104008,"Block 4008, Block Group 4, Census Tract 2529.10, Solano County, California",31,30,1
1000000US060952529104009,060952529104009,"Block 4009, Block Group 4, Census Tract 2529.10, Solano County, California",30,29,1
1000000US060952529104010,060952529104010,"Block 4010, Block Group 4, Census Tract 2529.10, Solano County, California",16,16,0
1000000US060952529111000,060952529111000,"Block 1000, Block Group 1, Census Tract 2529.11, Solano County, California",0,0,0
1000000US060952529111001,060952529111001,"Block 1001, Block Group 1, Census Tract 2529.11, Solano County, California",0,0,0
1000000US060952529111002,060952529111002,"Block 1002, Block Group 1, Census Tract 2529.11, Solano County, California",0,0,0
1000000US060952529111003,060952529111003,"Block 1003, Block Group 1, Census Tract 2529.11, Solano County, California",0,0,0
1000000US060952529111004,060952529111004,"Block 1004, Block Group 1, Census Tract 2529.11, Solano County, California",0,0,0
1000000US060952529111005,060952529111005,"Block 1005, Block Group 1, Census Tract 2529.11, Solano County, California",0,0,0
1000000US060952529111006,060952529111006,"Block 1006, Block Group 1, Census Tract 2529.11, Solano County, California",0,0,0
1000000US060952529111007,060952529111007,"Block 1007, Block Group 1, Census Tract 2529.11, Solano County, California",0,0,0
1000000US060952529111008,060952529111008,"Block 1008, Block Group 1, Census Tract 2529.11, Solano County, California",0,0,0
1000000US060952529111009,060952529111009,"Block 1009, Block Group 1, Census Tract 2529.11, Solano County, California",0,0,0
1000000US060952529111010,060952529111010,"Block 1010, Block Group 1, Census Tract 2529.11, Solano County, California",0,0,0
1000000US060952529111011,060952529111011,"Block 1011, Block Group 1, Census Tract 2529.11, Solano County, California",0,0,0
1000000US060952529111012,060952529111012,"Block 1012, Block Group 1, Census Tract 2529.11, Solano County, California",0,0,0
1000000US060952529111013,060952529111013,"Block 1013, Block Group 1, Census Tract 2529.11, Solano County, California",2,2,0
1000000US060952529111014,060952529111014,"Block 1014, Block Group 1, Census Tract 2529.11, Solano County, California",0,0,0
1000000US060952529111015,060952529111015,"Block 1015, Block Group 1, Census Tract 2529.11, Solano County, California",0,0,0
1000000US060952529111016,060952529111016,"Block 1016, Block Group 1, Census Tract 2529.11, Solano County, California",0,0,0
1000000US060952529111017,060952529111017,"Block 1017, Block Group 1, Census Tract 2529.11, Solano County, California",8,8,0
1000000US060952529111018,060952529111018,"Block 1018, Block Group 1, Census Tract 2529.11, Solano County, California",186,172,14
1000000US060952529111019,060952529111019,"Block 1019, Block Group 1, Census Tract 2529.11, Solano County, California",129,119,10
1000000US060952529111020,060952529111020,"Block 1020, Block Group 1, Census Tract 2529.11, Solano County, California",33,31,2
1000000US060952529111021,060952529111021,"Block 1021, Block Group 1, Census Tract 2529.11, Solano County, California",0,0,0
1000000US060952529111022,060952529111022,"Block 1022, Block Group 1, Census Tract 2529.11, Solano County, California",0,0,0
1000000US060952529111023,060952529111023,"Block 1023, Block Group 1, Census Tract 2529.11, Solano County, California",4,4,0
1000000US060952529111024,060952529111024,"Block 1024, Block Group 1, Census Tract 2529.11, Solano County, California",73,73,0
1000000US060952529111025,060952529111025,"Block 1025, Block Group 1, Census Tract 2529.11, Solano County, California",88,87,1
1000000US060952529111026,060952529111026,"Block 1026, Block Group 1, Census Tract 2529.11, Solano County, California",68,67,1
1000000US060952529111027,060952529111027,"Block 1027, Block Group 1, Census Tract 2529.11, Solano County, California",1,1,0
1000000US060952529111028,060952529111028,"Block 1028, Block Group 1, Census Tract 2529.11, Solano County, California",62,60,2
1000000US060952529111029,060952529111029,"Block 1029, Block Group 1, Census Tract 2529.11, Solano County, California",26,23,3
1000000US060952529111030,060952529111030,"Block 1030, Block Group 1, Census Tract 2529.11, Solano County, California",15,15,0
1000000US060952529111031,060952529111031,"Block 1031, Block Group 1, Census Tract 2529.11, Solano County, California",23,21,2
1000000US060952529111032,060952529111032,"Block 1032, Block Group 1, Census Tract 2529.11, Solano County, California",41,41,0
1000000US060952529111033,060952529111033,"Block 1033, Block Group 1, Census Tract 2529.11, Solano County, California",84,83,1
1000000US060952529111034,060952529111034,"Block 1034, Block Group 1, Census Tract 2529.11, Solano County, California",72,67,5
1000000US060952529111035,060952529111035,"Block 1035, Block Group 1, Census Tract 2529.11, Solano County, California",35,35,0
1000000US060952529111036,060952529111036,"Block 1036, Block Group 1, Census Tract 2529.11, Solano County, California",0,0,0
1000000US060952529111037,060952529111037,"Block 1037, Block Group 1, Census Tract 2529.11, Solano County, California",56,53,3
1000000US060952529112000,060952529112000,"Block 2000, Block Group 2, Census Tract 2529.11, Solano County, California",0,0,0
1000000US060952529112001,060952529112001,"Block 2001, Block Group 2, Census Tract 2529.11, Solano County, California",1,1,0
1000000US060952529112002,060952529112002,"Block 2002, Block Group 2, Census Tract 2529.11, Solano County, California",0,0,0
1000000US060952529112003,060952529112003,"Block 2003, Block Group 2, Census Tract 2529.11, Solano County, California",0,0,0
1000000US060952529112004,060952529112004,"Block 2004, Block Group 2, Census Tract 2529.11, Solano County, California",0,0,0
1000000US060952529112005,060952529112005,"Block 2005, Block Group 2, Census Tract 2529.11, Solano County, California",0,0,0
1000000US060952529112006,060952529112006,"Block 2006, Block Group 2, Census Tract 2529.11, Solano County, California",0,0,0
1000000US060952529112007,060952529112007,"Block 2007, Block Group 2, Census Tract 2529.11, Solano County, California",0,0,0
1000000US060952529112008,060952529112008,"Block 2008, Block Group 2, Census Tract 2529.11, Solano County, California",0,0,0
1000000US060952529112009,060952529112009,"Block 2009, Block Group 2, Census Tract 2529.11, Solano County, California",344,323,21
1000000US060952529112010,060952529112010,"Block 2010, Block Group 2, Census Tract 2529.11, Solano County, California",34,31,3
1000000US060952529112011,060952529112011,"Block 2011, Block Group 2, Census Tract 2529.11, Solano County, California",50,47,3
1000000US060952529112012,060952529112012,"Block 2012, Block Group 2, Census Tract 2529.11, Solano County, California",24,24,0
1000000US060952529112013,060952529112013,"Block 2013, Block Group 2, Census Tract 2529.11, Solano County, California",28,26,2
1000000US060952529112014,060952529112014,"Block 2014, Block Group 2, Census Tract 2529.11, Solano County, California",20,20,0
1000000US060952529112015,060952529112015,"Block 2015, Block Group 2, Census Tract 2529.11, Solano County, California",0,0,0
1000000US060952529112016,060952529112016,"Block 2016, Block Group 2, Census Tract 2529.11, Solano County, California",31,30,1
1000000US060952529112017,060952529112017,"Block 2017, Block Group 2, Census Tract 2529.11, Solano County, California",26,26,0
1000000US060952529112018,060952529112018,"Block 2018, Block Group 2, Census Tract 2529.11, Solano County, California",28,26,2
1000000US060952529112019,060952529112019,"Block 2019, Block Group 2, Census Tract 2529.11, Solano County, California",0,0,0
1000000US060952529112020,060952529112020,"Block 2020, Block Group 2, Census Tract 2529.11, Solano County, California",15,15,0
1000000US060952529112021,060952529112021,"Block 2021, Block Group 2, Census Tract 2529.11, Solano County, California",28,27,1
1000000US060952529112022,060952529112022,"Block 2022, Block Group 2, Census Tract 2529.11, Solano County, California",49,48,1
1000000US060952529112023,060952529112023,"Block 2023, Block Group 2, Census Tract 2529.11, Solano County, California",0,0,0
1000000US060952529112024,060952529112024,"Block 2024, Block Group 2, Census Tract 2529.11, Solano County, California",0,0,0
1000000US060952529112025,060952529112025,"Block 2025, Block Group 2, Census Tract 2529.11, Solano County, California",1,1,0
1000000US060952529112026,060952529112026,"Block 2026, Block Group 2, Census Tract 2529.11, Solano County, California",0,0,0
1000000US060952529112027,060952529112027,"Block 2027, Block Group 2, Census Tract 2529.11, Solano County, California",0,0,0
1000000US060952529112028,060952529112028,"Block 2028, Block Group 2, Census Tract 2529.11, Solano County, California",0,0,0
1000000US060952529112029,060952529112029,"Block 2029, Block Group 2, Census Tract 2529.11, Solano County, California",0,0,0
1000000US060952529112030,060952529112030,"Block 2030, Block Group 2, Census Tract 2529.11, Solano County, California",0,0,0
1000000US060952529113000,060952529113000,"Block 3000, Block Group 3, Census Tract 2529.11, Solano County, California",90,85,5
1000000US060952529113001,060952529113001,"Block 3001, Block Group 3, Census Tract 2529.11, Solano County, California",40,39,1
1000000US060952529113002,060952529113002,"Block 3002, Block Group 3, Census Tract 2529.11, Solano County, California",30,29,1
1000000US060952529113003,060952529113003,"Block 3003, Block Group 3, Census Tract 2529.11, Solano County, California",7,7,0
1000000US060952529113004,060952529113004,"Block 3004, Block Group 3, Census Tract 2529.11, Solano County, California",68,66,2
1000000US060952529113005,060952529113005,"Block 3005, Block Group 3, Census Tract 2529.11, Solano County, California",10,10,0
1000000US060952529113006,060952529113006,"Block 3006, Block Group 3, Census Tract 2529.11, Solano County, California",14,14,0
1000000US060952529113007,060952529113007,"Block 3007, Block Group 3, Census Tract 2529.11, Solano County, California",7,7,0
1000000US060952529113008,060952529113008,"Block 3008, Block Group 3, Census Tract 2529.11, Solano County, California",34,31,3
1000000US060952529114000,060952529114000,"Block 4000, Block Group 4, Census Tract 2529.11, Solano County, California",0,0,0
1000000US060952529114001,060952529114001,"Block 4001, Block Group 4, Census Tract 2529.11, Solano County, California",60,55,5
1000000US060952529114002,060952529114002,"Block 4002, Block Group 4, Census Tract 2529.11, Solano County, California",389,364,25
1000000US060952529114003,060952529114003,"Block 4003, Block Group 4, Census Tract 2529.11, Solano County, California",38,36,2
1000000US060952529114004,060952529114004,"Block 4004, Block Group 4, Census Tract 2529.11, Solano County, California",46,44,2
1000000US060952529114005,060952529114005,"Block 4005, Block Group 4, Census Tract 2529.11, Solano County, California",38,34,4
1000000US060952529114006,060952529114006,"Block 4006, Block Group 4, Census Tract 2529.11, Solano County, California",46,42,4
1000000US060952529114007,060952529114007,"Block 4007, Block Group 4, Census Tract 2529.11, Solano County, California",43,41,2
1000000US060952529114008,060952529114008,"Block 4008, Block Group 4, Census Tract 2529.11, Solano County, California",46,44,2
1000000US060952529114009,060952529114009,"Block 4009, Block Group 4, Census Tract 2529.11, Solano County, California",36,36,0
1000000US060952529114010,060952529114010,"Block 4010, Block Group 4, Census Tract 2529.11, Solano County, California",184,169,15
1000000US060952529114011,060952529114011,"Block 4011, Block Group 4, Census Tract 2529.11, Solano County, California",38,34,4
1000000US060952529121000,060952529121000,"Block 1000, Block Group 1, Census Tract 2529.12, Solano County, California",94,92,2
1000000US060952529121001,060952529121001,"Block 1001, Block Group 1, Census Tract 2529.12, Solano County, California",22,21,1
1000000US060952529121002,060952529121002,"Block 1002, Block Group 1, Census Tract 2529.12, Solano County, California",12,11,1
1000000US060952529121003,060952529121003,"Block 1003, Block Group 1, Census Tract 2529.12, Solano County, California",11,10,1
1000000US060952529121004,060952529121004,"Block 1004, Block Group 1, Census Tract 2529.12, Solano County, California",25,25,0
1000000US060952529121005,060952529121005,"Block 1005, Block Group 1, Census Tract 2529.12, Solano County, California",0,0,0
1000000US060952529121006,060952529121006,"Block 1006, Block Group 1, Census Tract 2529.12, Solano County, California",11,11,0
1000000US060952529121007,060952529121007,"Block 1007, Block Group 1, Census Tract 2529.12, Solano County, California",49,47,2
1000000US060952529121008,060952529121008,"Block 1008, Block Group 1, Census Tract 2529.12, Solano County, California",20,20,0
1000000US060952529121009,060952529121009,"Block 1009, Block Group 1, Census Tract 2529.12, Solano County, California",41,40,1
1000000US060952529121010,060952529121010,"Block 1010, Block Group 1, Census Tract 2529.12, Solano County, California",21,20,1
1000000US060952529121011,060952529121011,"Block 1011, Block Group 1, Census Tract 2529.12, Solano County, California",39,38,1
1000000US060952529121012,060952529121012,"Block 1012, Block Group 1, Census Tract 2529.12, Solano County, California",38,37,1
1000000US060952529121013,060952529121013,"Block 1013, Block Group 1, Census Tract 2529.12, Solano County, California",0,0,0
1000000US060952529121014,060952529121014,"Block 1014, Block Group 1, Census Tract 2529.12, Solano County, California",0,0,0
1000000US060952529121015,060952529121015,"Block 1015, Block Group 1, Census Tract 2529.12, Solano County, California",44,41,3
1000000US060952529121016,060952529121016,"Block 1016, Block Group 1, Census Tract 2529.12, Solano County, California",19,17,2
1000000US060952529121017,060952529121017,"Block 1017, Block Group 1, Census Tract 2529.12, Solano County, California",14,14,0
1000000US060952529121018,060952529121018,"Block 1018, Block Group 1, Census Tract 2529.12, Solano County, California",0,0,0
1000000US060952529122000,060952529122000,"Block 2000, Block Group 2, Census Tract 2529.12, Solano County, California",14,14,0
1000000US060952529122001,060952529122001,"Block 2001, Block Group 2, Census Tract 2529.12, Solano County, California",13,12,1
1000000US060952529122002,060952529122002,"Block 2002, Block Group 2, Census Tract 2529.12, Solano County, California",29,29,0
1000000US060952529122003,060952529122003,"Block 2003, Block Group 2, Census Tract 2529.12, Solano County, California",78,74,4
1000000US060952529122004,060952529122004,"Block 2004, Block Group 2, Census Tract 2529.12, Solano County, California",25,25,0
1000000US060952529122005,060952529122005,"Block 2005, Block Group 2, Census Tract 2529.12, Solano County, California",0,0,0
1000000US060952529122006,060952529122006,"Block 2006, Block Group 2, Census Tract 2529.12, Solano County, California",12,10,2
1000000US060952529122007,060952529122007,"Block 2007, Block Group 2, Census Tract 2529.12, Solano County, California",10,9,1
1000000US060952529122008,060952529122008,"Block 2008, Block Group 2, Census Tract 2529.12, Solano County, California",24,24,0
1000000US060952529122009,060952529122009,"Block 2009, Block Group 2, Census Tract 2529.12, Solano County, California",0,0,0
1000000US060952529122010,060952529122010,"Block 2010, Block Group 2, Census Tract 2529.12, Solano County, California",0,0,0
1000000US060952529122011,060952529122011,"Block 2011, Block Group 2, Census Tract 2529.12, Solano County, California",22,22,0
1000000US060952529122012,060952529122012,"Block 2012, Block Group 2, Census Tract 2529.12, Solano County, California",35,35,0
1000000US060952529122013,060952529122013,"Block 2013, Block Group 2, Census Tract 2529.12, Solano County, California",24,24,0
1000000US060952529122014,060952529122014,"Block 2014, Block Group 2, Census Tract 2529.12, Solano County, California",0,0,0
1000000US060952529122015,060952529122015,"Block 2015, Block Group 2, Census Tract 2529.12, Solano County, California",0,0,0
1000000US060952529123000,060952529123000,"Block 3000, Block Group 3, Census Tract 2529.12, Solano County, California",0,0,0
1000000US060952529123001,060952529123001,"Block 3001, Block Group 3, Census Tract 2529.12, Solano County, California",17,10,7
1000000US060952529123002,060952529123002,"Block 3002, Block Group 3, Census Tract 2529.12, Solano County, California",87,85,2
1000000US060952529123003,060952529123003,"Block 3003, Block Group 3, Census Tract 2529.12, Solano County, California",19,18,1
1000000US060952529123004,060952529123004,"Block 3004, Block Group 3, Census Tract 2529.12, Solano County, California",16,14,2
1000000US060952529123005,060952529123005,"Block 3005, Block Group 3, Census Tract 2529.12, Solano County, California",7,7,0
1000000US060952529123006,060952529123006,"Block 3006, Block Group 3, Census Tract 2529.12, Solano County, California",16,16,0
1000000US060952529123007,060952529123007,"Block 3007, Block Group 3, Census Tract 2529.12, Solano County, California",17,17,0
1000000US060952529123008,060952529123008,"Block 3008, Block Group 3, Census Tract 2529.12, Solano County, California",28,28,0
1000000US060952529123009,060952529123009,"Block 3009, Block Group 3, Census Tract 2529.12, Solano County, California",15,14,1
1000000US060952529123010,060952529123010,"Block 3010, Block Group 3, Census Tract 2529.12, Solano County, California",0,0,0
1000000US060952529123011,060952529123011,"Block 3011, Block Group 3, Census Tract 2529.12, Solano County, California",20,20,0
1000000US060952529123012,060952529123012,"Block 3012, Block Group 3, Census Tract 2529.12, Solano County, California",165,149,16
1000000US060952529123013,060952529123013,"Block 3013, Block Group 3, Census Tract 2529.12, Solano County, California",9,7,2
1000000US060952529123014,060952529123014,"Block 3014, Block Group 3, Census Tract 2529.12, Solano County, California",0,0,0
1000000US060952529123015,060952529123015,"Block 3015, Block Group 3, Census Tract 2529.12, Solano County, California",0,0,0
1000000US060952529123016,060952529123016,"Block 3016, Block Group 3, Census Tract 2529.12, Solano County, California",0,0,0
1000000US060952529124000,060952529124000,"Block 4000, Block Group 4, Census Tract 2529.12, Solano County, California",19,19,0
1000000US060952529124001,060952529124001,"Block 4001, Block Group 4, Census Tract 2529.12, Solano County, California",24,23,1
1000000US060952529124002,060952529124002,"Block 4002, Block Group 4, Census Tract 2529.12, Solano County, California",129,128,1
1000000US060952529124003,060952529124003,"Block 4003, Block Group 4, Census Tract 2529.12, Solano County, California",9,9,0
1000000US060952529124004,060952529124004,"Block 4004, Block Group 4, Census Tract 2529.12, Solano County, California",20,19,1
1000000US060952529124005,060952529124005,"Block 4005, Block Group 4, Census Tract 2529.12, Solano County, California",0,0,0
1000000US060952529124006,060952529124006,"Block 4006, Block Group 4, Census Tract 2529.12, Solano County, California",0,0,0
1000000US060952529124007,060952529124007,"Block 4007, Block Group 4, Census Tract 2529.12, Solano County, California",26,26,0
1000000US060952529124008,060952529124008,"Block 4008, Block Group 4, Census Tract 2529.12, Solano County, California",18,17,1
1000000US060952529124009,060952529124009,"Block 4009, Block Group 4, Census Tract 2529.12, Solano County, California",5,5,0
1000000US060952529124010,060952529124010,"Block 4010, Block Group 4, Census Tract 2529.12, Solano County, California",13,12,1
1000000US060952529124011,060952529124011,"Block 4011, Block Group 4, Census Tract 2529.12, Solano County, California",29,27,2
1000000US060952529124012,060952529124012,"Block 4012, Block Group 4, Census Tract 2529.12, Solano County, California",1,1,0
1000000US060952529124013,060952529124013,"Block 4013, Block Group 4, Census Tract 2529.12, Solano County, California",25,25,0
1000000US060952529124014,060952529124014,"Block 4014, Block Group 4, Census Tract 2529.12, Solano County, California",42,40,2
1000000US060952529124015,060952529124015,"Block 4015, Block Group 4, Census Tract 2529.12, Solano County, California",1,1,0
1000000US060952529124016,060952529124016,"Block 4016, Block Group 4, Census Tract 2529.12, Solano County, California",0,0,0
1000000US060952529124017,060952529124017,"Block 4017, Block Group 4, Census Tract 2529.12, Solano County, California",16,16,0
1000000US060952529124018,060952529124018,"Block 4018, Block Group 4, Census Tract 2529.12, Solano County, California",12,11,1
1000000US060952529124019,060952529124019,"Block 4019, Block Group 4, Census Tract 2529.12, Solano County, California",16,16,0
1000000US060952529124020,060952529124020,"Block 4020, Block Group 4, Census Tract 2529.12, Solano County, California",29,29,0
1000000US060952529125000,060952529125000,"Block 5000, Block Group 5, Census Tract 2529.12, Solano County, California",5,5,0
1000000US060952529125001,060952529125001,"Block 5001, Block Group 5, Census Tract 2529.12, Solano County, California",11,10,1
1000000US060952529125002,060952529125002,"Block 5002, Block Group 5, Census Tract 2529.12, Solano County, California",10,10,0
1000000US060952529125003,060952529125003,"Block 5003, Block Group 5, Census Tract 2529.12, Solano County, California",12,11,1
1000000US060952529125004,060952529125004,"Block 5004, Block Group 5, Census Tract 2529.12, Solano County, California",11,11,0
1000000US060952529125005,060952529125005,"Block 5005, Block Group 5, Census Tract 2529.12, Solano County, California",26,26,0
1000000US060952529125006,060952529125006,"Block 5006, Block Group 5, Census Tract 2529.12, Solano County, California",26,26,0
1000000US060952529125007,060952529125007,"Block 5007, Block Group 5, Census Tract 2529.12, Solano County, California",19,19,0
1000000US060952529125008,060952529125008,"Block 5008, Block Group 5, Census Tract 2529.12, Solano County, California",19,19,0
1000000US060952529125009,060952529125009,"Block 5009, Block Group 5, Census Tract 2529.12, Solano County, California",63,63,0
1000000US060952529125010,060952529125010,"Block 5010, Block Group 5, Census Tract 2529.12, Solano County, California",14,14,0
1000000US060952529125011,060952529125011,"Block 5011, Block Group 5, Census Tract 2529.12, Solano County, California",19,19,0
1000000US060952529125012,060952529125012,"Block 5012, Block Group 5, Census Tract 2529.12, Solano County, California",36,35,1
1000000US060952529125013,060952529125013,"Block 5013, Block Group 5, Census Tract 2529.12, Solano County, California",22,22,0
1000000US060952529125014,060952529125014,"Block 5014, Block Group 5, Census Tract 2529.12, Solano County, California",32,32,0
1000000US060952529125015,060952529125015,"Block 5015, Block Group 5, Census Tract 2529.12, Solano County, California",20,20,0
1000000US060952529131000,060952529131000,"Block 1000, Block Group 1, Census Tract 2529.13, Solano County, California",29,28,1
1000000US060952529131001,060952529131001,"Block 1001, Block Group 1, Census Tract 2529.13, Solano County, California",14,14,0
1000000US060952529131002,060952529131002,"Block 1002, Block Group 1, Census Tract 2529.13, Solano County, California",106,99,7
1000000US060952529131003,060952529131003,"Block 1003, Block Group 1, Census Tract 2529.13, Solano County, California",41,39,2
1000000US060952529131004,060952529131004,"Block 1004, Block Group 1, Census Tract 2529.13, Solano County, California",45,45,0
1000000US060952529131005,060952529131005,"Block 1005, Block Group 1, Census Tract 2529.13, Solano County, California",33,31,2
1000000US060952529131006,060952529131006,"Block 1006, Block Group 1, Census Tract 2529.13, Solano County, California",57,56,1
1000000US060952529131007,060952529131007,"Block 1007, Block Group 1, Census Tract 2529.13, Solano County, California",36,36,0
1000000US060952529131008,060952529131008,"Block 1008, Block Group 1, Census Tract 2529.13, Solano County, California",15,14,1
1000000US060952529131009,060952529131009,"Block 1009, Block Group 1, Census Tract 2529.13, Solano County, California",27,26,1
1000000US060952529131010,060952529131010,"Block 1010, Block Group 1, Census Tract 2529.13, Solano County, California",32,32,0
1000000US060952529131011,060952529131011,"Block 1011, Block Group 1, Census Tract 2529.13, Solano County, California",45,45,0
1000000US060952529132000,060952529132000,"Block 2000, Block Group 2, Census Tract 2529.13, Solano County, California",0,0,0
1000000US060952529132001,060952529132001,"Block 2001, Block Group 2, Census Tract 2529.13, Solano County, California",0,0,0
1000000US060952529132002,060952529132002,"Block 2002, Block Group 2, Census Tract 2529.13, Solano County, California",55,52,3
1000000US060952529132003,060952529132003,"Block 2003, Block Group 2, Census Tract 2529.13, Solano County, California",13,13,0
1000000US060952529132004,060952529132004,"Block 2004, Block Group 2, Census Tract 2529.13, Solano County, California",43,42,1
1000000US060952529132005,060952529132005,"Block 2005, Block Group 2, Census Tract 2529.13, Solano County, California",11,10,1
1000000US060952529132006,060952529132006,"Block 2006, Block Group 2, Census Tract 2529.13, Solano County, California",28,27,1
1000000US060952529132007,060952529132007,"Block 2007, Block Group 2, Census Tract 2529.13, Solano County, California",33,33,0
1000000US060952529132008,060952529132008,"Block 2008, Block Group 2, Census Tract 2529.13, Solano County, California",16,16,0
1000000US060952529132009,060952529132009,"Block 2009, Block Group 2, Census Tract 2529.13, Solano County, California",20,18,2
1000000US060952529132010,060952529132010,"Block 2010, Block Group 2, Census Tract 2529.13, Solano County, California",11,10,1
1000000US060952529132011,060952529132011,"Block 2011, Block Group 2, Census Tract 2529.13, Solano County, California",12,10,2
1000000US060952529132012,060952529132012,"Block 2012, Block Group 2, Census Tract 2529.13, Solano County, California",18,18,0
1000000US060952529132013,060952529132013,"Block 2013, Block Group 2, Census Tract 2529.13, Solano County, California",15,15,0
1000000US060952529132014,060952529132014,"Block 2014, Block Group 2, Census Tract 2529.13, Solano County, California",36,34,2
1000000US060952529132015,060952529132015,"Block 2015, Block Group 2, Census Tract 2529.13, Solano County, California",25,25,0
1000000US060952529132016,060952529132016,"Block 2016, Block Group 2, Census Tract 2529.13, Solano County, California",10,8,2
1000000US060952529132017,060952529132017,"Block 2017, Block Group 2, Census Tract 2529.13, Solano County, California",28,28,0
1000000US060952529132018,060952529132018,"Block 2018, Block Group 2, Census Tract 2529.13, Solano County, California",43,43,0
1000000US060952529132019,060952529132019,"Block 2019, Block Group 2, Census Tract 2529.13, Solano County, California",10,9,1
1000000US060952529132020,060952529132020,"Block 2020, Block Group 2, Census Tract 2529.13, Solano County, California",13,13,0
1000000US060952529133000,060952529133000,"Block 3000, Block Group 3, Census Tract 2529.13, Solano County, California",0,0,0
1000000US060952529133001,060952529133001,"Block 3001, Block Group 3, Census Tract 2529.13, Solano County, California",37,34,3
1000000US060952529133002,060952529133002,"Block 3002, Block Group 3, Census Tract 2529.13, Solano County, California",38,36,2
1000000US060952529133003,060952529133003,"Block 3003, Block Group 3, Census Tract 2529.13, Solano County, California",49,47,2
1000000US060952529133004,060952529133004,"Block 3004, Block Group 3, Census Tract 2529.13, Solano County, California",25,23,2
1000000US060952529133005,060952529133005,"Block 3005, Block Group 3, Census Tract 2529.13, Solano County, California",12,11,1
1000000US060952529133006,060952529133006,"Block 3006, Block Group 3, Census Tract 2529.13, Solano County, California",28,26,2
1000000US060952529133007,060952529133007,"Block 3007, Block Group 3, Census Tract 2529.13, Solano County, California",42,40,2
1000000US060952529133008,060952529133008,"Block 3008, Block Group 3, Census Tract 2529.13, Solano County, California",40,40,0
1000000US060952529133009,060952529133009,"Block 3009, Block Group 3, Census Tract 2529.13, Solano County, California",55,52,3
1000000US060952529133010,060952529133010,"Block 3010, Block Group 3, Census Tract 2529.13, Solano County, California",31,30,1
1000000US060952529133011,060952529133011,"Block 3011, Block Group 3, Census Tract 2529.13, Solano County, California",34,32,2
1000000US060952529134000,060952529134000,"Block 4000, Block Group 4, Census Tract 2529.13, Solano County, California",135,130,5
1000000US060952529134001,060952529134001,"Block 4001, Block Group 4, Census Tract 2529.13, Solano County, California",52,50,2
1000000US060952529134002,060952529134002,"Block 4002, Block Group 4, Census Tract 2529.13, Solano County, California",15,13,2
1000000US060952529134003,060952529134003,"Block 4003, Block Group 4, Census Tract 2529.13, Solano County, California",5,5,0
1000000US060952529134004,060952529134004,"Block 4004, Block Group 4, Census Tract 2529.13, Solano County, California",15,14,1
1000000US060952529134005,060952529134005,"Block 4005, Block Group 4, Census Tract 2529.13, Solano County, California",22,22,0
1000000US060952529134006,060952529134006,"Block 4006, Block Group 4, Census Tract 2529.13, Solano County, California",31,29,2
1000000US060952529134007,060952529134007,"Block 4007, Block Group 4, Census Tract 2529.13, Solano County, California",46,45,1
1000000US060952529134008,060952529134008,"Block 4008, Block Group 4, Census Tract 2529.13, Solano County, California",30,29,1
1000000US060952529134009,060952529134009,"Block 4009, Block Group 4, Census Tract 2529.13, Solano County, California",43,42,1
1000000US060952529134010,060952529134010,"Block 4010, Block Group 4, Census Tract 2529.13, Solano County, California",29,28,1
1000000US060952529134011,060952529134011,"Block 4011, Block Group 4, Census Tract 2529.13, Solano County, California",12,12,0
1000000US060952529134012,060952529134012,"Block 4012, Block Group 4, Census Tract 2529.13, Solano County, California",27,25,2
1000000US060952529134013,060952529134013,"Block 4013, Block Group 4, Census Tract 2529.13, Solano County, California",0,0,0
1000000US060952529134014,060952529134014,"Block 4014, Block Group 4, Census Tract 2529.13, Solano County, California",0,0,0
1000000US060952529134015,060952529134015,"Block 4015, Block Group 4, Census Tract 2529.13, Solano County, California",0,0,0
1000000US060952529134016,060952529134016,"Block 4016, Block Group 4, Census Tract 2529.13, Solano County, California",0,0,0
1000000US060952529134017,060952529134017,"Block 4017, Block Group 4, Census Tract 2529.13, Solano County, California",0,0,0
1000000US060952529141000,060952529141000,"Block 1000, Block Group 1, Census Tract 2529.14, Solano County, California",1,1,0
1000000US060952529141001,060952529141001,"Block 1001, Block Group 1, Census Tract 2529.14, Solano County, California",0,0,0
1000000US060952529141002,060952529141002,"Block 1002, Block Group 1, Census Tract 2529.14, Solano County, California",22,22,0
1000000US060952529141003,060952529141003,"Block 1003, Block Group 1, Census Tract 2529.14, Solano County, California",12,10,2
1000000US060952529141004,060952529141004,"Block 1004, Block Group 1, Census Tract 2529.14, Solano County, California",42,40,2
1000000US060952529141005,060952529141005,"Block 1005, Block Group 1, Census Tract 2529.14, Solano County, California",27,27,0
1000000US060952529141006,060952529141006,"Block 1006, Block Group 1, Census Tract 2529.14, Solano County, California",49,49,0
1000000US060952529141007,060952529141007,"Block 1007, Block Group 1, Census Tract 2529.14, Solano County, California",0,0,0
1000000US060952529141008,060952529141008,"Block 1008, Block Group 1, Census Tract 2529.14, Solano County, California",7,7,0
1000000US060952529141009,060952529141009,"Block 1009, Block Group 1, Census Tract 2529.14, Solano County, California",0,0,0
1000000US060952529141010,060952529141010,"Block 1010, Block Group 1, Census Tract 2529.14, Solano County, California",45,44,1
1000000US060952529141011,060952529141011,"Block 1011, Block Group 1, Census Tract 2529.14, Solano County, California",21,20,1
1000000US060952529141012,060952529141012,"Block 1012, Block Group 1, Census Tract 2529.14, Solano County, California",21,21,0
1000000US060952529141013,060952529141013,"Block 1013, Block Group 1, Census Tract 2529.14, Solano County, California",20,19,1
1000000US060952529141014,060952529141014,"Block 1014, Block Group 1, Census Tract 2529.14, Solano County, California",25,24,1
1000000US060952529141015,060952529141015,"Block 1015, Block Group 1, Census Tract 2529.14, Solano County, California",0,0,0
1000000US060952529141016,060952529141016,"Block 1016, Block Group 1, Census Tract 2529.14, Solano County, California",3,3,0
1000000US060952529141017,060952529141017,"Block 1017, Block Group 1, Census Tract 2529.14, Solano County, California",102,97,5
1000000US060952529141018,060952529141018,"Block 1018, Block Group 1, Census Tract 2529.14, Solano County, California",20,18,2
1000000US060952529141019,060952529141019,"Block 1019, Block Group 1, Census Tract 2529.14, Solano County, California",20,18,2
1000000US060952529141020,060952529141020,"Block 1020, Block Group 1, Census Tract 2529.14, Solano County, California",12,10,2
1000000US060952529141021,060952529141021,"Block 1021, Block Group 1, Census Tract 2529.14, Solano County, California",23,23,0
1000000US060952529141022,060952529141022,"Block 1022, Block Group 1, Census Tract 2529.14, Solano County, California",12,12,0
1000000US060952529141023,060952529141023,"Block 1023, Block Group 1, Census Tract 2529.14, Solano County, California",48,46,2
1000000US060952529141024,060952529141024,"Block 1024, Block Group 1, Census Tract 2529.14, Solano County, California",20,19,1
1000000US060952529141025,060952529141025,"Block 1025, Block Group 1, Census Tract 2529.14, Solano County, California",7,7,0
1000000US060952529141026,060952529141026,"Block 1026, Block Group 1, Census Tract 2529.14, Solano County, California",9,9,0
1000000US060952529141027,060952529141027,"Block 1027, Block Group 1, Census Tract 2529.14, Solano County, California",46,44,2
1000000US060952529141028,060952529141028,"Block 1028, Block Group 1, Census Tract 2529.14, Solano County, California",4,4,0
1000000US060952529141029,060952529141029,"Block 1029, Block Group 1, Census Tract 2529.14, Solano County, California",36,33,3
1000000US060952529141030,060952529141030,"Block 1030, Block Group 1, Census Tract 2529.14, Solano County, California",37,35,2
1000000US060952529141031,060952529141031,"Block 1031, Block Group 1, Census Tract 2529.14, Solano County, California",14,14,0
1000000US060952529141032,060952529141032,"Block 1032, Block Group 1, Census Tract 2529.14, Solano County, California",15,15,0
1000000US060952529141033,060952529141033,"Block 1033, Block Group 1, Census Tract 2529.14, Solano County, California",28,27,1
1000000US060952529141034,060952529141034,"Block 1034, Block Group 1, Census Tract 2529.14, Solano County, California",0,0,0
1000000US060952529141035,060952529141035,"Block 1035, Block Group 1, Census Tract 2529.14, Solano County, California",12,12,0
1000000US060952529141036,060952529141036,"Block 1036, Block Group 1, Census Tract 2529.14, Solano County, California",21,20,1
1000000US060952529142000,060952529142000,"Block 2000, Block Group 2, Census Tract 2529.14, Solano County, California",19,19,0
1000000US060952529142001,060952529142001,"Block 2001, Block Group 2, Census Tract 2529.14, Solano County, California",20,19,1
1000000US060952529142002,060952529142002,"Block 2002, Block Group 2, Census Tract 2529.14, Solano County, California",72,60,12
1000000US060952529142003,060952529142003,"Block 2003, Block Group 2, Census Tract 2529.14, Solano County, California",85,81,4
1000000US060952529142004,060952529142004,"Block 2004, Block Group 2, Census Tract 2529.14, Solano County, California",50,39,11
1000000US060952529142005,060952529142005,"Block 2005, Block Group 2, Census Tract 2529.14, Solano County, California",86,73,13
1000000US060952529142006,060952529142006,"Block 2006, Block Group 2, Census Tract 2529.14, Solano County, California",96,77,19
1000000US060952529142007,060952529142007,"Block 2007, Block Group 2, Census Tract 2529.14, Solano County, California",51,49,2
1000000US060952529142008,060952529142008,"Block 2008, Block Group 2, Census Tract 2529.14, Solano County, California",32,30,2
1000000US060952529142009,060952529142009,"Block 2009, Block Group 2, Census Tract 2529.14, Solano County, California",30,29,1
1000000US060952529142010,060952529142010,"Block 2010, Block Group 2, Census Tract 2529.14, Solano County, California",60,53,7
1000000US060952529143000,060952529143000,"Block 3000, Block Group 3, Census Tract 2529.14, Solano County, California",181,175,6
1000000US060952529143001,060952529143001,"Block 3001, Block Group 3, Census Tract 2529.14, Solano County, California",26,25,1
1000000US060952529143002,060952529143002,"Block 3002, Block Group 3, Census Tract 2529.14, Solano County, California",11,11,0
1000000US060952529143003,060952529143003,"Block 3003, Block Group 3, Census Tract 2529.14, Solano County, California",33,32,1
1000000US060952529143004,060952529143004,"Block 3004, Block Group 3, Census Tract 2529.14, Solano County, California",16,16,0
1000000US060952529143005,060952529143005,"Block 3005, Block Group 3, Census Tract 2529.14, Solano County, California",78,75,3
1000000US060952529143006,060952529143006,"Block 3006, Block Group 3, Census Tract 2529.14, Solano County, California",27,26,1
1000000US060952529143007,060952529143007,"Block 3007, Block Group 3, Census Tract 2529.14, Solano County, California",49,46,3
1000000US060952529143008,060952529143008,"Block 3008, Block Group 3, Census Tract 2529.14, Solano County, California",29,27,2
1000000US060952529143009,060952529143009,"Block 3009, Block Group 3, Census Tract 2529.14, Solano County, California",29,28,1
1000000US060952529151000,060952529151000,"Block 1000, Block Group 1, Census Tract 2529.15, Solano County, California",0,0,0
1000000US060952529151001,060952529151001,"Block 1001, Block Group 1, Census Tract 2529.15, Solano County, California",0,0,0
1000000US060952529151002,060952529151002,"Block 1002, Block Group 1, Census Tract 2529.15, Solano County, California",3,3,0
1000000US060952529151003,060952529151003,"Block 1003, Block Group 1, Census Tract 2529.15, Solano County, California",0,0,0
1000000US060952529151004,060952529151004,"Block 1004, Block Group 1, Census Tract 2529.15, Solano County, California",0,0,0
1000000US060952529151005,060952529151005,"Block 1005, Block Group 1, Census Tract 2529.15, Solano County, California",0,0,0
1000000US060952529151006,060952529151006,"Block 1006, Block Group 1, Census Tract 2529.15, Solano County, California",0,0,0
1000000US060952529151007,060952529151007,"Block 1007, Block Group 1, Census Tract 2529.15, Solano County, California",0,0,0
1000000US060952529151008,060952529151008,"Block 1008, Block Group 1, Census Tract 2529.15, Solano County, California",70,69,1
1000000US060952529151009,060952529151009,"Block 1009, Block Group 1, Census Tract 2529.15, Solano County, California",49,46,3
1000000US060952529151010,060952529151010,"Block 1010, Block Group 1, Census Tract 2529.15, Solano County, California",63,62,1
1000000US060952529151011,060952529151011,"Block 1011, Block Group 1, Census Tract 2529.15, Solano County, California",31,29,2
1000000US060952529151012,060952529151012,"Block 1012, Block Group 1, Census Tract 2529.15, Solano County, California",53,51,2
1000000US060952529151013,060952529151013,"Block 1013, Block Group 1, Census Tract 2529.15, Solano County, California",27,26,1
1000000US060952529151014,060952529151014,"Block 1014, Block Group 1, Census Tract 2529.15, Solano County, California",18,16,2
1000000US060952529151015,060952529151015,"Block 1015, Block Group 1, Census Tract 2529.15, Solano County, California",4,4,0
1000000US060952529151016,060952529151016,"Block 1016, Block Group 1, Census Tract 2529.15, Solano County, California",8,8,0
1000000US060952529151017,060952529151017,"Block 1017, Block Group 1, Census Tract 2529.15, Solano County, California",11,11,0
1000000US060952529151018,060952529151018,"Block 1018, Block Group 1, Census Tract 2529.15, Solano County, California",25,24,1
1000000US060952529151019,060952529151019,"Block 1019, Block Group 1, Census Tract 2529.15, Solano County, California",0,0,0
1000000US060952529151020,060952529151020,"Block 1020, Block Group 1, Census Tract 2529.15, Solano County, California",39,38,1
1000000US060952529151021,060952529151021,"Block 1021, Block Group 1, Census Tract 2529.15, Solano County, California",44,44,0
1000000US060952529151022,060952529151022,"Block 1022, Block Group 1, Census Tract 2529.15, Solano County, California",9,9,0
1000000US060952529152000,060952529152000,"Block 2000, Block Group 2, Census Tract 2529.15, Solano County, California",0,0,0
1000000US060952529152001,060952529152001,"Block 2001, Block Group 2, Census Tract 2529.15, Solano County, California",0,0,0
1000000US060952529152002,060952529152002,"Block 2002, Block Group 2, Census Tract 2529.15, Solano County, California",1,1,0
1000000US060952529152003,060952529152003,"Block 2003, Block Group 2, Census Tract 2529.15, Solano County, California",0,0,0
1000000US060952529152004,060952529152004,"Block 2004, Block Group 2, Census Tract 2529.15, Solano County, California",0,0,0
1000000US060952529152005,060952529152005,"Block 2005, Block Group 2, Census Tract 2529.15, Solano County, California",0,0,0
1000000US060952529152006,060952529152006,"Block 2006, Block Group 2, Census Tract 2529.15, Solano County, California",0,0,0
1000000US060952529152007,060952529152007,"Block 2007, Block Group 2, Census Tract 2529.15, Solano County, California",0,0,0
1000000US060952529152008,060952529152008,"Block 2008, Block Group 2, Census Tract 2529.15, Solano County, California",0,0,0
1000000US060952529152009,060952529152009,"Block 2009, Block Group 2, Census Tract 2529.15, Solano County, California",0,0,0
1000000US060952529152010,060952529152010,"Block 2010, Block Group 2, Census Tract 2529.15, Solano County, California",0,0,0
1000000US060952529152011,060952529152011,"Block 2011, Block Group 2, Census Tract 2529.15, Solano County, California",6,6,0
1000000US060952529152012,060952529152012,"Block 2012, Block Group 2, Census Tract 2529.15, Solano County, California",19,15,4
1000000US060952529152013,060952529152013,"Block 2013, Block Group 2, Census Tract 2529.15, Solano County, California",0,0,0
1000000US060952529152014,060952529152014,"Block 2014, Block Group 2, Census Tract 2529.15, Solano County, California",0,0,0
1000000US060952529152015,060952529152015,"Block 2015, Block Group 2, Census Tract 2529.15, Solano County, California",14,13,1
1000000US060952529152016,060952529152016,"Block 2016, Block Group 2, Census Tract 2529.15, Solano County, California",31,28,3
1000000US060952529152017,060952529152017,"Block 2017, Block Group 2, Census Tract 2529.15, Solano County, California",0,0,0
1000000US060952529152018,060952529152018,"Block 2018, Block Group 2, Census Tract 2529.15, Solano County, California",25,25,0
1000000US060952529152019,060952529152019,"Block 2019, Block Group 2, Census Tract 2529.15, Solano County, California",49,48,1
1000000US060952529152020,060952529152020,"Block 2020, Block Group 2, Census Tract 2529.15, Solano County, California",29,28,1
1000000US060952529152021,060952529152021,"Block 2021, Block Group 2, Census Tract 2529.15, Solano County, California",10,10,0
1000000US060952529152022,060952529152022,"Block 2022, Block Group 2, Census Tract 2529.15, Solano County, California",0,0,0
1000000US060952529152023,060952529152023,"Block 2023, Block Group 2, Census Tract 2529.15, Solano County, California",74,74,0
1000000US060952529152024,060952529152024,"Block 2024, Block Group 2, Census Tract 2529.15, Solano County, California",16,16,0
1000000US060952529152025,060952529152025,"Block 2025, Block Group 2, Census Tract 2529.15, Solano County, California",34,33,1
1000000US060952529152026,060952529152026,"Block 2026, Block Group 2, Census Tract 2529.15, Solano County, California",31,30,1
1000000US060952529152027,060952529152027,"Block 2027, Block Group 2, Census Tract 2529.15, Solano County, California",62,61,1
1000000US060952529152028,060952529152028,"Block 2028, Block Group 2, Census Tract 2529.15, Solano County, California",53,52,1
1000000US060952529152029,060952529152029,"Block 2029, Block Group 2, Census Tract 2529.15, Solano County, California",1,0,1
1000000US060952529152030,060952529152030,"Block 2030, Block Group 2, Census Tract 2529.15, Solano County, California",0,0,0
1000000US060952529152031,060952529152031,"Block 2031, Block Group 2, Census Tract 2529.15, Solano County, California",0,0,0
1000000US060952529152032,060952529152032,"Block 2032, Block Group 2, Census Tract 2529.15, Solano County, California",0,0,0
1000000US060952529152033,060952529152033,"Block 2033, Block Group 2, Census Tract 2529.15, Solano County, California",0,0,0
1000000US060952529152034,060952529152034,"Block 2034, Block Group 2, Census Tract 2529.15, Solano County, California",6,6,0
1000000US060952529152035,060952529152035,"Block 2035, Block Group 2, Census Tract 2529.15, Solano County, California",0,0,0
1000000US060952529152036,060952529152036,"Block 2036, Block Group 2, Census Tract 2529.15, Solano County, California",22,22,0
1000000US060952529152037,060952529152037,"Block 2037, Block Group 2, Census Tract 2529.15, Solano County, California",14,14,0
1000000US060952529152038,060952529152038,"Block 2038, Block Group 2, Census Tract 2529.15, Solano County, California",66,61,5
1000000US060952529152039,060952529152039,"Block 2039, Block Group 2, Census Tract 2529.15, Solano County, California",29,27,2
1000000US060952529152040,060952529152040,"Block 2040, Block Group 2, Census Tract 2529.15, Solano County, California",2,2,0
1000000US060952529152041,060952529152041,"Block 2041, Block Group 2, Census Tract 2529.15, Solano County, California",18,17,1
1000000US060952529152042,060952529152042,"Block 2042, Block Group 2, Census Tract 2529.15, Solano County, California",12,12,0
1000000US060952529152043,060952529152043,"Block 2043, Block Group 2, Census Tract 2529.15, Solano County, California",8,8,0
1000000US060952529152044,060952529152044,"Block 2044, Block Group 2, Census Tract 2529.15, Solano County, California",0,0,0
1000000US060952529152045,060952529152045,"Block 2045, Block Group 2, Census Tract 2529.15, Solano County, California",5,5,0
1000000US060952530001000,060952530001000,"Block 1000, Block Group 1, Census Tract 2530, Solano County, California",0,0,0
1000000US060952530001001,060952530001001,"Block 1001, Block Group 1, Census Tract 2530, Solano County, California",0,0,0
1000000US060952530001002,060952530001002,"Block 1002, Block Group 1, Census Tract 2530, Solano County, California",0,0,0
1000000US060952530001003,060952530001003,"Block 1003, Block Group 1, Census Tract 2530, Solano County, California",0,0,0
1000000US060952530001004,060952530001004,"Block 1004, Block Group 1, Census Tract 2530, Solano County, California",0,0,0
1000000US060952530001005,060952530001005,"Block 1005, Block Group 1, Census Tract 2530, Solano County, California",0,0,0
1000000US060952530001006,060952530001006,"Block 1006, Block Group 1, Census Tract 2530, Solano County, California",0,0,0
1000000US060952530001007,060952530001007,"Block 1007, Block Group 1, Census Tract 2530, Solano County, California",0,0,0
1000000US060952530001008,060952530001008,"Block 1008, Block Group 1, Census Tract 2530, Solano County, California",0,0,0
1000000US060952530001009,060952530001009,"Block 1009, Block Group 1, Census Tract 2530, Solano County, California",0,0,0
1000000US060952530001010,060952530001010,"Block 1010, Block Group 1, Census Tract 2530, Solano County, California",0,0,0
1000000US060952530001011,060952530001011,"Block 1011, Block Group 1, Census Tract 2530, Solano County, California",0,0,0
1000000US060952530001012,060952530001012,"Block 1012, Block Group 1, Census Tract 2530, Solano County, California",0,0,0
1000000US060952530001013,060952530001013,"Block 1013, Block Group 1, Census Tract 2530, Solano County, California",0,0,0
1000000US060952530001014,060952530001014,"Block 1014, Block Group 1, Census Tract 2530, Solano County, California",0,0,0
1000000US060952530001015,060952530001015,"Block 1015, Block Group 1, Census Tract 2530, Solano County, California",0,0,0
1000000US060952530001016,060952530001016,"Block 1016, Block Group 1, Census Tract 2530, Solano County, California",0,0,0
1000000US060952531011000,060952531011000,"Block 1000, Block Group 1, Census Tract 2531.01, Solano County, California",0,0,0
1000000US060952531011001,060952531011001,"Block 1001, Block Group 1, Census Tract 2531.01, Solano County, California",0,0,0
1000000US060952531011002,060952531011002,"Block 1002, Block Group 1, Census Tract 2531.01, Solano County, California",0,0,0
1000000US060952531011003,060952531011003,"Block 1003, Block Group 1, Census Tract 2531.01, Solano County, California",0,0,0
1000000US060952531011004,060952531011004,"Block 1004, Block Group 1, Census Tract 2531.01, Solano County, California",41,40,1
1000000US060952531011005,060952531011005,"Block 1005, Block Group 1, Census Tract 2531.01, Solano County, California",4,4,0
1000000US060952531011006,060952531011006,"Block 1006, Block Group 1, Census Tract 2531.01, Solano County, California",0,0,0
1000000US060952531011007,060952531011007,"Block 1007, Block Group 1, Census Tract 2531.01, Solano County, California",40,36,4
1000000US060952531011008,060952531011008,"Block 1008, Block Group 1, Census Tract 2531.01, Solano County, California",0,0,0
1000000US060952531011009,060952531011009,"Block 1009, Block Group 1, Census Tract 2531.01, Solano County, California",0,0,0
1000000US060952531011010,060952531011010,"Block 1010, Block Group 1, Census Tract 2531.01, Solano County, California",0,0,0
1000000US060952531011011,060952531011011,"Block 1011, Block Group 1, Census Tract 2531.01, Solano County, California",0,0,0
1000000US060952531011012,060952531011012,"Block 1012, Block Group 1, Census Tract 2531.01, Solano County, California",74,70,4
1000000US060952531011013,060952531011013,"Block 1013, Block Group 1, Census Tract 2531.01, Solano County, California",12,12,0
1000000US060952531011014,060952531011014,"Block 1014, Block Group 1, Census Tract 2531.01, Solano County, California",0,0,0
1000000US060952531011015,060952531011015,"Block 1015, Block Group 1, Census Tract 2531.01, Solano County, California",19,15,4
1000000US060952531011016,060952531011016,"Block 1016, Block Group 1, Census Tract 2531.01, Solano County, California",0,0,0
1000000US060952531011017,060952531011017,"Block 1017, Block Group 1, Census Tract 2531.01, Solano County, California",0,0,0
1000000US060952531011018,060952531011018,"Block 1018, Block Group 1, Census Tract 2531.01, Solano County, California",0,0,0
1000000US060952531011019,060952531011019,"Block 1019, Block Group 1, Census Tract 2531.01, Solano County, California",1,1,0
1000000US060952531011020,060952531011020,"Block 1020, Block Group 1, Census Tract 2531.01, Solano County, California",9,9,0
1000000US060952531011021,060952531011021,"Block 1021, Block Group 1, Census Tract 2531.01, Solano County, California",0,0,0
1000000US060952531011022,060952531011022,"Block 1022, Block Group 1, Census Tract 2531.01, Solano County, California",0,0,0
1000000US060952531011023,060952531011023,"Block 1023, Block Group 1, Census Tract 2531.01, Solano County, California",0,0,0
1000000US060952531011024,060952531011024,"Block 1024, Block Group 1, Census Tract 2531.01, Solano County, California",0,0,0
1000000US060952531011025,060952531011025,"Block 1025, Block Group 1, Census Tract 2531.01, Solano County, California",2,2,0
1000000US060952531011026,060952531011026,"Block 1026, Block Group 1, Census Tract 2531.01, Solano County, California",1,1,0
1000000US060952531011027,060952531011027,"Block 1027, Block Group 1, Census Tract 2531.01, Solano County, California",3,3,0
1000000US060952531011028,060952531011028,"Block 1028, Block Group 1, Census Tract 2531.01, Solano County, California",8,7,1
1000000US060952531011029,060952531011029,"Block 1029, Block Group 1, Census Tract 2531.01, Solano County, California",3,3,0
1000000US060952531011030,060952531011030,"Block 1030, Block Group 1, Census Tract 2531.01, Solano County, California",2,2,0
1000000US060952531011031,060952531011031,"Block 1031, Block Group 1, Census Tract 2531.01, Solano County, California",0,0,0
1000000US060952531011032,060952531011032,"Block 1032, Block Group 1, Census Tract 2531.01, Solano County, California",8,6,2
1000000US060952531011033,060952531011033,"Block 1033, Block Group 1, Census Tract 2531.01, Solano County, California",10,9,1
1000000US060952531011034,060952531011034,"Block 1034, Block Group 1, Census Tract 2531.01, Solano County, California",0,0,0
1000000US060952531011035,060952531011035,"Block 1035, Block Group 1, Census Tract 2531.01, Solano County, California",0,0,0
1000000US060952531011036,060952531011036,"Block 1036, Block Group 1, Census Tract 2531.01, Solano County, California",0,0,0
1000000US060952531012000,060952531012000,"Block 2000, Block Group 2, Census Tract 2531.01, Solano County, California",0,0,0
1000000US060952531012001,060952531012001,"Block 2001, Block Group 2, Census Tract 2531.01, Solano County, California",0,0,0
1000000US060952531012002,060952531012002,"Block 2002, Block Group 2, Census Tract 2531.01, Solano County, California",0,0,0
1000000US060952531012003,060952531012003,"Block 2003, Block Group 2, Census Tract 2531.01, Solano County, California",0,0,0
1000000US060952531012004,060952531012004,"Block 2004, Block Group 2, Census Tract 2531.01, Solano County, California",26,23,3
1000000US060952531012005,060952531012005,"Block 2005, Block Group 2, Census Tract 2531.01, Solano County, California",12,10,2
1000000US060952531012006,060952531012006,"Block 2006, Block Group 2, Census Tract 2531.01, Solano County, California",0,0,0
1000000US060952531012007,060952531012007,"Block 2007, Block Group 2, Census Tract 2531.01, Solano County, California",0,0,0
1000000US060952531012008,060952531012008,"Block 2008, Block Group 2, Census Tract 2531.01, Solano County, California",1,1,0
1000000US060952531012009,060952531012009,"Block 2009, Block Group 2, Census Tract 2531.01, Solano County, California",1,1,0
1000000US060952531012010,060952531012010,"Block 2010, Block Group 2, Census Tract 2531.01, Solano County, California",27,24,3
1000000US060952531012011,060952531012011,"Block 2011, Block Group 2, Census Tract 2531.01, Solano County, California",32,28,4
1000000US060952531012012,060952531012012,"Block 2012, Block Group 2, Census Tract 2531.01, Solano County, California",29,26,3
1000000US060952531012013,060952531012013,"Block 2013, Block Group 2, Census Tract 2531.01, Solano County, California",19,18,1
1000000US060952531012014,060952531012014,"Block 2014, Block Group 2, Census Tract 2531.01, Solano County, California",31,30,1
1000000US060952531012015,060952531012015,"Block 2015, Block Group 2, Census Tract 2531.01, Solano County, California",27,27,0
1000000US060952531012016,060952531012016,"Block 2016, Block Group 2, Census Tract 2531.01, Solano County, California",27,25,2
1000000US060952531012017,060952531012017,"Block 2017, Block Group 2, Census Tract 2531.01, Solano County, California",14,14,0
1000000US060952531012018,060952531012018,"Block 2018, Block Group 2, Census Tract 2531.01, Solano County, California",17,16,1
1000000US060952531012019,060952531012019,"Block 2019, Block Group 2, Census Tract 2531.01, Solano County, California",13,13,0
1000000US060952531012020,060952531012020,"Block 2020, Block Group 2, Census Tract 2531.01, Solano County, California",19,19,0
1000000US060952531012021,060952531012021,"Block 2021, Block Group 2, Census Tract 2531.01, Solano County, California",0,0,0
1000000US060952531012022,060952531012022,"Block 2022, Block Group 2, Census Tract 2531.01, Solano County, California",0,0,0
1000000US060952531012023,060952531012023,"Block 2023, Block Group 2, Census Tract 2531.01, Solano County, California",0,0,0
1000000US060952531012024,060952531012024,"Block 2024, Block Group 2, Census Tract 2531.01, Solano County, California",0,0,0
1000000US060952531012025,060952531012025,"Block 2025, Block Group 2, Census Tract 2531.01, Solano County, California",0,0,0
1000000US060952531012026,060952531012026,"Block 2026, Block Group 2, Census Tract 2531.01, Solano County, California",0,0,0
1000000US060952531012027,060952531012027,"Block 2027, Block Group 2, Census Tract 2531.01, Solano County, California",0,0,0
1000000US060952531012028,060952531012028,"Block 2028, Block Group 2, Census Tract 2531.01, Solano County, California",0,0,0
1000000US060952531012029,060952531012029,"Block 2029, Block Group 2, Census Tract 2531.01, Solano County, California",17,16,1
1000000US060952531013000,060952531013000,"Block 3000, Block Group 3, Census Tract 2531.01, Solano County, California",16,16,0
1000000US060952531013001,060952531013001,"Block 3001, Block Group 3, Census Tract 2531.01, Solano County, California",26,24,2
1000000US060952531013002,060952531013002,"Block 3002, Block Group 3, Census Tract 2531.01, Solano County, California",28,25,3
1000000US060952531013003,060952531013003,"Block 3003, Block Group 3, Census Tract 2531.01, Solano County, California",17,16,1
1000000US060952531013004,060952531013004,"Block 3004, Block Group 3, Census Tract 2531.01, Solano County, California",24,24,0
1000000US060952531013005,060952531013005,"Block 3005, Block Group 3, Census Tract 2531.01, Solano County, California",37,37,0
1000000US060952531013006,060952531013006,"Block 3006, Block Group 3, Census Tract 2531.01, Solano County, California",34,31,3
1000000US060952531013007,060952531013007,"Block 3007, Block Group 3, Census Tract 2531.01, Solano County, California",27,26,1
1000000US060952531013008,060952531013008,"Block 3008, Block Group 3, Census Tract 2531.01, Solano County, California",13,13,0
1000000US060952531013009,060952531013009,"Block 3009, Block Group 3, Census Tract 2531.01, Solano County, California",22,21,1
1000000US060952531013010,060952531013010,"Block 3010, Block Group 3, Census Tract 2531.01, Solano County, California",33,29,4
1000000US060952531013011,060952531013011,"Block 3011, Block Group 3, Census Tract 2531.01, Solano County, California",37,37,0
1000000US060952531013012,060952531013012,"Block 3012, Block Group 3, Census Tract 2531.01, Solano County, California",18,15,3
1000000US060952531013013,060952531013013,"Block 3013, Block Group 3, Census Tract 2531.01, Solano County, California",15,12,3
1000000US060952531014000,060952531014000,"Block 4000, Block Group 4, Census Tract 2531.01, Solano County, California",22,21,1
1000000US060952531014001,060952531014001,"Block 4001, Block Group 4, Census Tract 2531.01, Solano County, California",29,26,3
1000000US060952531014002,060952531014002,"Block 4002, Block Group 4, Census Tract 2531.01, Solano County, California",15,15,0
1000000US060952531014003,060952531014003,"Block 4003, Block Group 4, Census Tract 2531.01, Solano County, California",14,14,0
1000000US060952531014004,060952531014004,"Block 4004, Block Group 4, Census Tract 2531.01, Solano County, California",29,27,2
1000000US060952531014005,060952531014005,"Block 4005, Block Group 4, Census Tract 2531.01, Solano County, California",24,23,1
1000000US060952531014006,060952531014006,"Block 4006, Block Group 4, Census Tract 2531.01, Solano County, California",22,22,0
1000000US060952531014007,060952531014007,"Block 4007, Block Group 4, Census Tract 2531.01, Solano County, California",21,20,1
1000000US060952531014008,060952531014008,"Block 4008, Block Group 4, Census Tract 2531.01, Solano County, California",20,20,0
1000000US060952531014009,060952531014009,"Block 4009, Block Group 4, Census Tract 2531.01, Solano County, California",20,20,0
1000000US060952531014010,060952531014010,"Block 4010, Block Group 4, Census Tract 2531.01, Solano County, California",23,23,0
1000000US060952531014011,060952531014011,"Block 4011, Block Group 4, Census Tract 2531.01, Solano County, California",12,12,0
1000000US060952531014012,060952531014012,"Block 4012, Block Group 4, Census Tract 2531.01, Solano County, California",15,14,1
1000000US060952531014013,060952531014013,"Block 4013, Block Group 4, Census Tract 2531.01, Solano County, California",10,9,1
1000000US060952531015000,060952531015000,"Block 5000, Block Group 5, Census Tract 2531.01, Solano County, California",18,17,1
1000000US060952531015001,060952531015001,"Block 5001, Block Group 5, Census Tract 2531.01, Solano County, California",104,92,12
1000000US060952531015002,060952531015002,"Block 5002, Block Group 5, Census Tract 2531.01, Solano County, California",165,156,9
1000000US060952531015003,060952531015003,"Block 5003, Block Group 5, Census Tract 2531.01, Solano County, California",53,49,4
1000000US060952531015004,060952531015004,"Block 5004, Block Group 5, Census Tract 2531.01, Solano County, California",71,69,2
1000000US060952531015005,060952531015005,"Block 5005, Block Group 5, Census Tract 2531.01, Solano County, California",8,8,0
1000000US060952531015006,060952531015006,"Block 5006, Block Group 5, Census Tract 2531.01, Solano County, California",19,19,0
1000000US060952531015007,060952531015007,"Block 5007, Block Group 5, Census Tract 2531.01, Solano County, California",19,18,1
1000000US060952531015008,060952531015008,"Block 5008, Block Group 5, Census Tract 2531.01, Solano County, California",0,0,0
1000000US060952531016000,060952531016000,"Block 6000, Block Group 6, Census Tract 2531.01, Solano County, California",59,52,7
1000000US060952531016001,060952531016001,"Block 6001, Block Group 6, Census Tract 2531.01, Solano County, California",10,10,0
1000000US060952531016002,060952531016002,"Block 6002, Block Group 6, Census Tract 2531.01, Solano County, California",12,10,2
1000000US060952531016003,060952531016003,"Block 6003, Block Group 6, Census Tract 2531.01, Solano County, California",0,0,0
1000000US060952531016004,060952531016004,"Block 6004, Block Group 6, Census Tract 2531.01, Solano County, California",0,0,0
1000000US060952531016005,060952531016005,"Block 6005, Block Group 6, Census Tract 2531.01, Solano County, California",0,0,0
1000000US060952531016006,060952531016006,"Block 6006, Block Group 6, Census Tract 2531.01, Solano County, California",8,8,0
1000000US060952531016007,060952531016007,"Block 6007, Block Group 6, Census Tract 2531.01, Solano County, California",0,0,0
1000000US060952531016008,060952531016008,"Block 6008, Block Group 6, Census Tract 2531.01, Solano County, California",0,0,0
1000000US060952531016009,060952531016009,"Block 6009, Block Group 6, Census Tract 2531.01, Solano County, California",0,0,0
1000000US060952531016010,060952531016010,"Block 6010, Block Group 6, Census Tract 2531.01, Solano County, California",4,4,0
1000000US060952531016011,060952531016011,"Block 6011, Block Group 6, Census Tract 2531.01, Solano County, California",0,0,0
1000000US060952531016012,060952531016012,"Block 6012, Block Group 6, Census Tract 2531.01, Solano County, California",151,147,4
1000000US060952531016013,060952531016013,"Block 6013, Block Group 6, Census Tract 2531.01, Solano County, California",12,11,1
1000000US060952531016014,060952531016014,"Block 6014, Block Group 6, Census Tract 2531.01, Solano County, California",20,20,0
1000000US060952531016015,060952531016015,"Block 6015, Block Group 6, Census Tract 2531.01, Solano County, California",0,0,0
1000000US060952531016016,060952531016016,"Block 6016, Block Group 6, Census Tract 2531.01, Solano County, California",34,32,2
1000000US060952531016017,060952531016017,"Block 6017, Block Group 6, Census Tract 2531.01, Solano County, California",13,13,0
1000000US060952531016018,060952531016018,"Block 6018, Block Group 6, Census Tract 2531.01, Solano County, California",56,50,6
1000000US060952531016019,060952531016019,"Block 6019, Block Group 6, Census Tract 2531.01, Solano County, California",52,50,2
1000000US060952531016020,060952531016020,"Block 6020, Block Group 6, Census Tract 2531.01, Solano County, California",26,23,3
1000000US060952531016021,060952531016021,"Block 6021, Block Group 6, Census Tract 2531.01, Solano County, California",20,20,0
1000000US060952531016022,060952531016022,"Block 6022, Block Group 6, Census Tract 2531.01, Solano County, California",0,0,0
1000000US060952531016023,060952531016023,"Block 6023, Block Group 6, Census Tract 2531.01, Solano County, California",0,0,0
1000000US060952531016024,060952531016024,"Block 6024, Block Group 6, Census Tract 2531.01, Solano County, California",0,0,0
1000000US060952531016025,060952531016025,"Block 6025, Block Group 6, Census Tract 2531.01, Solano County, California",0,0,0
1000000US060952531016026,060952531016026,"Block 6026, Block Group 6, Census Tract 2531.01, Solano County, California",0,0,0
1000000US060952531016027,060952531016027,"Block 6027, Block Group 6, Census Tract 2531.01, Solano County, California",0,0,0
1000000US060952531016028,060952531016028,"Block 6028, Block Group 6, Census Tract 2531.01, Solano County, California",0,0,0
1000000US060952531016029,060952531016029,"Block 6029, Block Group 6, Census Tract 2531.01, Solano County, California",0,0,0
1000000US060952531016030,060952531016030,"Block 6030, Block Group 6, Census Tract 2531.01, Solano County, California",0,0,0
1000000US060952531016031,060952531016031,"Block 6031, Block Group 6, Census Tract 2531.01, Solano County, California",0,0,0
1000000US060952531016032,060952531016032,"Block 6032, Block Group 6, Census Tract 2531.01, Solano County, California",0,0,0
1000000US060952531016033,060952531016033,"Block 6033, Block Group 6, Census Tract 2531.01, Solano County, California",0,0,0
1000000US060952531016034,060952531016034,"Block 6034, Block Group 6, Census Tract 2531.01, Solano County, California",0,0,0
1000000US060952531016035,060952531016035,"Block 6035, Block Group 6, Census Tract 2531.01, Solano County, California",0,0,0
1000000US060952531051000,060952531051000,"Block 1000, Block Group 1, Census Tract 2531.05, Solano County, California",0,0,0
1000000US060952531051001,060952531051001,"Block 1001, Block Group 1, Census Tract 2531.05, Solano County, California",0,0,0
1000000US060952531051002,060952531051002,"Block 1002, Block Group 1, Census Tract 2531.05, Solano County, California",0,0,0
1000000US060952531051003,060952531051003,"Block 1003, Block Group 1, Census Tract 2531.05, Solano County, California",0,0,0
1000000US060952531051004,060952531051004,"Block 1004, Block Group 1, Census Tract 2531.05, Solano County, California",0,0,0
1000000US060952531051005,060952531051005,"Block 1005, Block Group 1, Census Tract 2531.05, Solano County, California",0,0,0
1000000US060952531051006,060952531051006,"Block 1006, Block Group 1, Census Tract 2531.05, Solano County, California",0,0,0
1000000US060952531051007,060952531051007,"Block 1007, Block Group 1, Census Tract 2531.05, Solano County, California",0,0,0
1000000US060952531051008,060952531051008,"Block 1008, Block Group 1, Census Tract 2531.05, Solano County, California",0,0,0
1000000US060952531051009,060952531051009,"Block 1009, Block Group 1, Census Tract 2531.05, Solano County, California",5,3,2
1000000US060952531051010,060952531051010,"Block 1010, Block Group 1, Census Tract 2531.05, Solano County, California",0,0,0
1000000US060952531051011,060952531051011,"Block 1011, Block Group 1, Census Tract 2531.05, Solano County, California",0,0,0
1000000US060952531051012,060952531051012,"Block 1012, Block Group 1, Census Tract 2531.05, Solano County, California",0,0,0
1000000US060952531051013,060952531051013,"Block 1013, Block Group 1, Census Tract 2531.05, Solano County, California",0,0,0
1000000US060952531051014,060952531051014,"Block 1014, Block Group 1, Census Tract 2531.05, Solano County, California",0,0,0
1000000US060952531051015,060952531051015,"Block 1015, Block Group 1, Census Tract 2531.05, Solano County, California",0,0,0
1000000US060952531051016,060952531051016,"Block 1016, Block Group 1, Census Tract 2531.05, Solano County, California",0,0,0
1000000US060952531051017,060952531051017,"Block 1017, Block Group 1, Census Tract 2531.05, Solano County, California",0,0,0
1000000US060952531051018,060952531051018,"Block 1018, Block Group 1, Census Tract 2531.05, Solano County, California",0,0,0
1000000US060952531051019,060952531051019,"Block 1019, Block Group 1, Census Tract 2531.05, Solano County, California",0,0,0
1000000US060952531051020,060952531051020,"Block 1020, Block Group 1, Census Tract 2531.05, Solano County, California",0,0,0
1000000US060952531051021,060952531051021,"Block 1021, Block Group 1, Census Tract 2531.05, Solano County, California",148,137,11
1000000US060952531051022,060952531051022,"Block 1022, Block Group 1, Census Tract 2531.05, Solano County, California",0,0,0
1000000US060952531051023,060952531051023,"Block 1023, Block Group 1, Census Tract 2531.05, Solano County, California",0,0,0
1000000US060952531051024,060952531051024,"Block 1024, Block Group 1, Census Tract 2531.05, Solano County, California",0,0,0
1000000US060952531051025,060952531051025,"Block 1025, Block Group 1, Census Tract 2531.05, Solano County, California",0,0,0
1000000US060952531051026,060952531051026,"Block 1026, Block Group 1, Census Tract 2531.05, Solano County, California",0,0,0
1000000US060952531051027,060952531051027,"Block 1027, Block Group 1, Census Tract 2531.05, Solano County, California",0,0,0
1000000US060952531051028,060952531051028,"Block 1028, Block Group 1, Census Tract 2531.05, Solano County, California",0,0,0
1000000US060952531051029,060952531051029,"Block 1029, Block Group 1, Census Tract 2531.05, Solano County, California",0,0,0
1000000US060952531051030,060952531051030,"Block 1030, Block Group 1, Census Tract 2531.05, Solano County, California",0,0,0
1000000US060952531051031,060952531051031,"Block 1031, Block Group 1, Census Tract 2531.05, Solano County, California",0,0,0
1000000US060952531051032,060952531051032,"Block 1032, Block Group 1, Census Tract 2531.05, Solano County, California",0,0,0
1000000US060952531051033,060952531051033,"Block 1033, Block Group 1, Census Tract 2531.05, Solano County, California",0,0,0
1000000US060952531051034,060952531051034,"Block 1034, Block Group 1, Census Tract 2531.05, Solano County, California",0,0,0
1000000US060952531051035,060952531051035,"Block 1035, Block Group 1, Census Tract 2531.05, Solano County, California",0,0,0
1000000US060952531051036,060952531051036,"Block 1036, Block Group 1, Census Tract 2531.05, Solano County, California",296,275,21
1000000US060952531051037,060952531051037,"Block 1037, Block Group 1, Census Tract 2531.05, Solano County, California",7,7,0
1000000US060952531051038,060952531051038,"Block 1038, Block Group 1, Census Tract 2531.05, Solano County, California",0,0,0
1000000US060952531051039,060952531051039,"Block 1039, Block Group 1, Census Tract 2531.05, Solano County, California",39,37,2
1000000US060952531051040,060952531051040,"Block 1040, Block Group 1, Census Tract 2531.05, Solano County, California",19,19,0
1000000US060952531051041,060952531051041,"Block 1041, Block Group 1, Census Tract 2531.05, Solano County, California",28,27,1
1000000US060952531051042,060952531051042,"Block 1042, Block Group 1, Census Tract 2531.05, Solano County, California",0,0,0
1000000US060952531051043,060952531051043,"Block 1043, Block Group 1, Census Tract 2531.05, Solano County, California",0,0,0
1000000US060952531051044,060952531051044,"Block 1044, Block Group 1, Census Tract 2531.05, Solano County, California",0,0,0
1000000US060952531051045,060952531051045,"Block 1045, Block Group 1, Census Tract 2531.05, Solano County, California",48,47,1
1000000US060952531052000,060952531052000,"Block 2000, Block Group 2, Census Tract 2531.05, Solano County, California",0,0,0
1000000US060952531052001,060952531052001,"Block 2001, Block Group 2, Census Tract 2531.05, Solano County, California",176,157,19
1000000US060952531052002,060952531052002,"Block 2002, Block Group 2, Census Tract 2531.05, Solano County, California",0,0,0
1000000US060952531052003,060952531052003,"Block 2003, Block Group 2, Census Tract 2531.05, Solano County, California",0,0,0
1000000US060952531052004,060952531052004,"Block 2004, Block Group 2, Census Tract 2531.05, Solano County, California",0,0,0
1000000US060952531052005,060952531052005,"Block 2005, Block Group 2, Census Tract 2531.05, Solano County, California",413,377,36
1000000US060952531052006,060952531052006,"Block 2006, Block Group 2, Census Tract 2531.05, Solano County, California",1,1,0
1000000US060952531052007,060952531052007,"Block 2007, Block Group 2, Census Tract 2531.05, Solano County, California",0,0,0
1000000US060952531052008,060952531052008,"Block 2008, Block Group 2, Census Tract 2531.05, Solano County, California",39,35,4
1000000US060952531052009,060952531052009,"Block 2009, Block Group 2, Census Tract 2531.05, Solano County, California",0,0,0
1000000US060952531052010,060952531052010,"Block 2010, Block Group 2, Census Tract 2531.05, Solano County, California",1,1,0
1000000US060952531052011,060952531052011,"Block 2011, Block Group 2, Census Tract 2531.05, Solano County, California",192,168,24
1000000US060952531052012,060952531052012,"Block 2012, Block Group 2, Census Tract 2531.05, Solano County, California",0,0,0
1000000US060952531052013,060952531052013,"Block 2013, Block Group 2, Census Tract 2531.05, Solano County, California",0,0,0
1000000US060952531052014,060952531052014,"Block 2014, Block Group 2, Census Tract 2531.05, Solano County, California",0,0,0
1000000US060952531052015,060952531052015,"Block 2015, Block Group 2, Census Tract 2531.05, Solano County, California",0,0,0
1000000US060952531053000,060952531053000,"Block 3000, Block Group 3, Census Tract 2531.05, Solano County, California",0,0,0
1000000US060952531053001,060952531053001,"Block 3001, Block Group 3, Census Tract 2531.05, Solano County, California",33,33,0
1000000US060952531053002,060952531053002,"Block 3002, Block Group 3, Census Tract 2531.05, Solano County, California",49,48,1
1000000US060952531053003,060952531053003,"Block 3003, Block Group 3, Census Tract 2531.05, Solano County, California",40,39,1
1000000US060952531053004,060952531053004,"Block 3004, Block Group 3, Census Tract 2531.05, Solano County, California",0,0,0
1000000US060952531053005,060952531053005,"Block 3005, Block Group 3, Census Tract 2531.05, Solano County, California",27,26,1
1000000US060952531053006,060952531053006,"Block 3006, Block Group 3, Census Tract 2531.05, Solano County, California",0,0,0
1000000US060952531053007,060952531053007,"Block 3007, Block Group 3, Census Tract 2531.05, Solano County, California",41,40,1
1000000US060952531053008,060952531053008,"Block 3008, Block Group 3, Census Tract 2531.05, Solano County, California",75,72,3
1000000US060952531053009,060952531053009,"Block 3009, Block Group 3, Census Tract 2531.05, Solano County, California",36,36,0
1000000US060952531053010,060952531053010,"Block 3010, Block Group 3, Census Tract 2531.05, Solano County, California",39,38,1
1000000US060952531053011,060952531053011,"Block 3011, Block Group 3, Census Tract 2531.05, Solano County, California",44,40,4
1000000US060952531053012,060952531053012,"Block 3012, Block Group 3, Census Tract 2531.05, Solano County, California",0,0,0
1000000US060952531053013,060952531053013,"Block 3013, Block Group 3, Census Tract 2531.05, Solano County, California",0,0,0
1000000US060952531053014,060952531053014,"Block 3014, Block Group 3, Census Tract 2531.05, Solano County, California",28,26,2
1000000US060952531053015,060952531053015,"Block 3015, Block Group 3, Census Tract 2531.05, Solano County, California",37,37,0
1000000US060952531053016,060952531053016,"Block 3016, Block Group 3, Census Tract 2531.05, Solano County, California",29,27,2
1000000US060952531054000,060952531054000,"Block 4000, Block Group 4, Census Tract 2531.05, Solano County, California",52,48,4
1000000US060952531054001,060952531054001,"Block 4001, Block Group 4, Census Tract 2531.05, Solano County, California",10,9,1
1000000US060952531054002,060952531054002,"Block 4002, Block Group 4, Census Tract 2531.05, Solano County, California",49,45,4
1000000US060952531054003,060952531054003,"Block 4003, Block Group 4, Census Tract 2531.05, Solano County, California",11,11,0
1000000US060952531054004,060952531054004,"Block 4004, Block Group 4, Census Tract 2531.05, Solano County, California",54,54,0
1000000US060952531054005,060952531054005,"Block 4005, Block Group 4, Census Tract 2531.05, Solano County, California",19,19,0
1000000US060952531054006,060952531054006,"Block 4006, Block Group 4, Census Tract 2531.05, Solano County, California",11,10,1
1000000US060952531054007,060952531054007,"Block 4007, Block Group 4, Census Tract 2531.05, Solano County, California",25,24,1
1000000US060952531054008,060952531054008,"Block 4008, Block Group 4, Census Tract 2531.05, Solano County, California",25,24,1
1000000US060952531054009,060952531054009,"Block 4009, Block Group 4, Census Tract 2531.05, Solano County, California",43,38,5
1000000US060952531055000,060952531055000,"Block 5000, Block Group 5, Census Tract 2531.05, Solano County, California",6,6,0
1000000US060952531055001,060952531055001,"Block 5001, Block Group 5, Census Tract 2531.05, Solano County, California",235,218,17
1000000US060952531055002,060952531055002,"Block 5002, Block Group 5, Census Tract 2531.05, Solano County, California",136,119,17
1000000US060952531055003,060952531055003,"Block 5003, Block Group 5, Census Tract 2531.05, Solano County, California",0,0,0
1000000US060952531055004,060952531055004,"Block 5004, Block Group 5, Census Tract 2531.05, Solano County, California",0,0,0
1000000US060952531061000,060952531061000,"Block 1000, Block Group 1, Census Tract 2531.06, Solano County, California",46,45,1
1000000US060952531061001,060952531061001,"Block 1001, Block Group 1, Census Tract 2531.06, Solano County, California",42,42,0
1000000US060952531061002,060952531061002,"Block 1002, Block Group 1, Census Tract 2531.06, Solano County, California",154,149,5
1000000US060952531061003,060952531061003,"Block 1003, Block Group 1, Census Tract 2531.06, Solano County, California",39,37,2
1000000US060952531061004,060952531061004,"Block 1004, Block Group 1, Census Tract 2531.06, Solano County, California",26,23,3
1000000US060952531062000,060952531062000,"Block 2000, Block Group 2, Census Tract 2531.06, Solano County, California",0,0,0
1000000US060952531062001,060952531062001,"Block 2001, Block Group 2, Census Tract 2531.06, Solano County, California",62,57,5
1000000US060952531062002,060952531062002,"Block 2002, Block Group 2, Census Tract 2531.06, Solano County, California",18,17,1
1000000US060952531062003,060952531062003,"Block 2003, Block Group 2, Census Tract 2531.06, Solano County, California",25,24,1
1000000US060952531062004,060952531062004,"Block 2004, Block Group 2, Census Tract 2531.06, Solano County, California",106,97,9
1000000US060952531062005,060952531062005,"Block 2005, Block Group 2, Census Tract 2531.06, Solano County, California",45,43,2
1000000US060952531062006,060952531062006,"Block 2006, Block Group 2, Census Tract 2531.06, Solano County, California",14,14,0
1000000US060952531062007,060952531062007,"Block 2007, Block Group 2, Census Tract 2531.06, Solano County, California",30,29,1
1000000US060952531063000,060952531063000,"Block 3000, Block Group 3, Census Tract 2531.06, Solano County, California",388,372,16
1000000US060952531063001,060952531063001,"Block 3001, Block Group 3, Census Tract 2531.06, Solano County, California",40,39,1
1000000US060952531063002,060952531063002,"Block 3002, Block Group 3, Census Tract 2531.06, Solano County, California",12,12,0
1000000US060952531063003,060952531063003,"Block 3003, Block Group 3, Census Tract 2531.06, Solano County, California",12,12,0
1000000US060952531063004,060952531063004,"Block 3004, Block Group 3, Census Tract 2531.06, Solano County, California",50,48,2
1000000US060952531063005,060952531063005,"Block 3005, Block Group 3, Census Tract 2531.06, Solano County, California",24,23,1
1000000US060952531063006,060952531063006,"Block 3006, Block Group 3, Census Tract 2531.06, Solano County, California",21,21,0
1000000US060952531063007,060952531063007,"Block 3007, Block Group 3, Census Tract 2531.06, Solano County, California",47,46,1
1000000US060952531063008,060952531063008,"Block 3008, Block Group 3, Census Tract 2531.06, Solano County, California",38,36,2
1000000US060952531063009,060952531063009,"Block 3009, Block Group 3, Census Tract 2531.06, Solano County, California",31,30,1
1000000US060952531063010,060952531063010,"Block 3010, Block Group 3, Census Tract 2531.06, Solano County, California",36,33,3
1000000US060952531063011,060952531063011,"Block 3011, Block Group 3, Census Tract 2531.06, Solano County, California",28,27,1
1000000US060952531063012,060952531063012,"Block 3012, Block Group 3, Census Tract 2531.06, Solano County, California",0,0,0
1000000US060952531063013,060952531063013,"Block 3013, Block Group 3, Census Tract 2531.06, Solano County, California",0,0,0
1000000US060952531063014,060952531063014,"Block 3014, Block Group 3, Census Tract 2531.06, Solano County, California",0,0,0
1000000US060952531063015,060952531063015,"Block 3015, Block Group 3, Census Tract 2531.06, Solano County, California",0,0,0
1000000US060952531063016,060952531063016,"Block 3016, Block Group 3, Census Tract 2531.06, Solano County, California",0,0,0
1000000US060952531063017,060952531063017,"Block 3017, Block Group 3, Census Tract 2531.06, Solano County, California",0,0,0
1000000US060952531071000,060952531071000,"Block 1000, Block Group 1, Census Tract 2531.07, Solano County, California",0,0,0
1000000US060952531071001,060952531071001,"Block 1001, Block Group 1, Census Tract 2531.07, Solano County, California",0,0,0
1000000US060952531071002,060952531071002,"Block 1002, Block Group 1, Census Tract 2531.07, Solano County, California",0,0,0
1000000US060952531071003,060952531071003,"Block 1003, Block Group 1, Census Tract 2531.07, Solano County, California",0,0,0
1000000US060952531071004,060952531071004,"Block 1004, Block Group 1, Census Tract 2531.07, Solano County, California",0,0,0
1000000US060952531071005,060952531071005,"Block 1005, Block Group 1, Census Tract 2531.07, Solano County, California",128,126,2
1000000US060952531071006,060952531071006,"Block 1006, Block Group 1, Census Tract 2531.07, Solano County, California",12,11,1
1000000US060952531071007,060952531071007,"Block 1007, Block Group 1, Census Tract 2531.07, Solano County, California",39,35,4
1000000US060952531071008,060952531071008,"Block 1008, Block Group 1, Census Tract 2531.07, Solano County, California",10,9,1
1000000US060952531071009,060952531071009,"Block 1009, Block Group 1, Census Tract 2531.07, Solano County, California",14,14,0
1000000US060952531071010,060952531071010,"Block 1010, Block Group 1, Census Tract 2531.07, Solano County, California",37,36,1
1000000US060952531071011,060952531071011,"Block 1011, Block Group 1, Census Tract 2531.07, Solano County, California",0,0,0
1000000US060952531071012,060952531071012,"Block 1012, Block Group 1, Census Tract 2531.07, Solano County, California",50,47,3
1000000US060952531071013,060952531071013,"Block 1013, Block Group 1, Census Tract 2531.07, Solano County, California",33,31,2
1000000US060952531071014,060952531071014,"Block 1014, Block Group 1, Census Tract 2531.07, Solano County, California",37,34,3
1000000US060952531071015,060952531071015,"Block 1015, Block Group 1, Census Tract 2531.07, Solano County, California",32,31,1
1000000US060952531071016,060952531071016,"Block 1016, Block Group 1, Census Tract 2531.07, Solano County, California",6,6,0
1000000US060952531071017,060952531071017,"Block 1017, Block Group 1, Census Tract 2531.07, Solano County, California",1,1,0
1000000US060952531072000,060952531072000,"Block 2000, Block Group 2, Census Tract 2531.07, Solano County, California",210,199,11
1000000US060952531072001,060952531072001,"Block 2001, Block Group 2, Census Tract 2531.07, Solano County, California",36,34,2
1000000US060952531072002,060952531072002,"Block 2002, Block Group 2, Census Tract 2531.07, Solano County, California",30,29,1
1000000US060952531072003,060952531072003,"Block 2003, Block Group 2, Census Tract 2531.07, Solano County, California",18,17,1
1000000US060952531072004,060952531072004,"Block 2004, Block Group 2, Census Tract 2531.07, Solano County, California",29,25,4
1000000US060952531072005,060952531072005,"Block 2005, Block Group 2, Census Tract 2531.07, Solano County, California",37,37,0
1000000US060952531072006,060952531072006,"Block 2006, Block Group 2, Census Tract 2531.07, Solano County, California",38,38,0
1000000US060952531072007,060952531072007,"Block 2007, Block Group 2, Census Tract 2531.07, Solano County, California",103,100,3
1000000US060952531072008,060952531072008,"Block 2008, Block Group 2, Census Tract 2531.07, Solano County, California",0,0,0
1000000US060952531072009,060952531072009,"Block 2009, Block Group 2, Census Tract 2531.07, Solano County, California",0,0,0
1000000US060952531072010,060952531072010,"Block 2010, Block Group 2, Census Tract 2531.07, Solano County, California",40,39,1
1000000US060952531072011,060952531072011,"Block 2011, Block Group 2, Census Tract 2531.07, Solano County, California",45,43,2
1000000US060952531072012,060952531072012,"Block 2012, Block Group 2, Census Tract 2531.07, Solano County, California",14,14,0
1000000US060952531072013,060952531072013,"Block 2013, Block Group 2, Census Tract 2531.07, Solano County, California",41,38,3
1000000US060952531072014,060952531072014,"Block 2014, Block Group 2, Census Tract 2531.07, Solano County, California",19,17,2
1000000US060952531072015,060952531072015,"Block 2015, Block Group 2, Census Tract 2531.07, Solano County, California",0,0,0
1000000US060952531072016,060952531072016,"Block 2016, Block Group 2, Census Tract 2531.07, Solano County, California",0,0,0
1000000US060952531072017,060952531072017,"Block 2017, Block Group 2, Census Tract 2531.07, Solano County, California",32,31,1
1000000US060952531073000,060952531073000,"Block 3000, Block Group 3, Census Tract 2531.07, Solano County, California",45,39,6
1000000US060952531073001,060952531073001,"Block 3001, Block Group 3, Census Tract 2531.07, Solano County, California",31,27,4
1000000US060952531073002,060952531073002,"Block 3002, Block Group 3, Census Tract 2531.07, Solano County, California",449,397,52
1000000US060952531073003,060952531073003,"Block 3003, Block Group 3, Census Tract 2531.07, Solano County, California",20,20,0
1000000US060952531073004,060952531073004,"Block 3004, Block Group 3, Census Tract 2531.07, Solano County, California",15,12,3
1000000US060952531073005,060952531073005,"Block 3005, Block Group 3, Census Tract 2531.07, Solano County, California",25,23,2
1000000US060952531073006,060952531073006,"Block 3006, Block Group 3, Census Tract 2531.07, Solano County, California",0,0,0
1000000US060952531073007,060952531073007,"Block 3007, Block Group 3, Census Tract 2531.07, Solano County, California",47,41,6
1000000US060952531073008,060952531073008,"Block 3008, Block Group 3, Census Tract 2531.07, Solano County, California",15,12,3
1000000US060952531073009,060952531073009,"Block 3009, Block Group 3, Census Tract 2531.07, Solano County, California",18,15,3
1000000US060952531073010,060952531073010,"Block 3010, Block Group 3, Census Tract 2531.07, Solano County, California",55,51,4
1000000US060952531073011,060952531073011,"Block 3011, Block Group 3, Census Tract 2531.07, Solano County, California",29,25,4
1000000US060952531073012,060952531073012,"Block 3012, Block Group 3, Census Tract 2531.07, Solano County, California",94,84,10
1000000US060952531073013,060952531073013,"Block 3013, Block Group 3, Census Tract 2531.07, Solano County, California",0,0,0
1000000US060952531073014,060952531073014,"Block 3014, Block Group 3, Census Tract 2531.07, Solano County, California",4,3,1
1000000US060952531073015,060952531073015,"Block 3015, Block Group 3, Census Tract 2531.07, Solano County, California",0,0,0
1000000US060952531073016,060952531073016,"Block 3016, Block Group 3, Census Tract 2531.07, Solano County, California",24,22,2
1000000US060952531073017,060952531073017,"Block 3017, Block Group 3, Census Tract 2531.07, Solano County, California",26,24,2
1000000US060952531073018,060952531073018,"Block 3018, Block Group 3, Census Tract 2531.07, Solano County, California",26,26,0
1000000US060952531074000,060952531074000,"Block 4000, Block Group 4, Census Tract 2531.07, Solano County, California",0,0,0
1000000US060952531074001,060952531074001,"Block 4001, Block Group 4, Census Tract 2531.07, Solano County, California",168,159,9
1000000US060952531074002,060952531074002,"Block 4002, Block Group 4, Census Tract 2531.07, Solano County, California",0,0,0
1000000US060952531074003,060952531074003,"Block 4003, Block Group 4, Census Tract 2531.07, Solano County, California",12,10,2
1000000US060952531074004,060952531074004,"Block 4004, Block Group 4, Census Tract 2531.07, Solano County, California",68,65,3
1000000US060952531074005,060952531074005,"Block 4005, Block Group 4, Census Tract 2531.07, Solano County, California",12,10,2
1000000US060952531074006,060952531074006,"Block 4006, Block Group 4, Census Tract 2531.07, Solano County, California",14,14,0
1000000US060952531074007,060952531074007,"Block 4007, Block Group 4, Census Tract 2531.07, Solano County, California",93,81,12
1000000US060952531074008,060952531074008,"Block 4008, Block Group 4, Census Tract 2531.07, Solano County, California",14,13,1
1000000US060952531074009,060952531074009,"Block 4009, Block Group 4, Census Tract 2531.07, Solano County, California",33,27,6
1000000US060952531074010,060952531074010,"Block 4010, Block Group 4, Census Tract 2531.07, Solano County, California",15,13,2
1000000US060952531081000,060952531081000,"Block 1000, Block Group 1, Census Tract 2531.08, Solano County, California",57,56,1
1000000US060952531081001,060952531081001,"Block 1001, Block Group 1, Census Tract 2531.08, Solano County, California",45,45,0
1000000US060952531081002,060952531081002,"Block 1002, Block Group 1, Census Tract 2531.08, Solano County, California",33,33,0
1000000US060952531081003,060952531081003,"Block 1003, Block Group 1, Census Tract 2531.08, Solano County, California",16,16,0
1000000US060952531081004,060952531081004,"Block 1004, Block Group 1, Census Tract 2531.08, Solano County, California",80,76,4
1000000US060952531081005,060952531081005,"Block 1005, Block Group 1, Census Tract 2531.08, Solano County, California",89,87,2
1000000US060952531081006,060952531081006,"Block 1006, Block Group 1, Census Tract 2531.08, Solano County, California",41,41,0
1000000US060952531081007,060952531081007,"Block 1007, Block Group 1, Census Tract 2531.08, Solano County, California",27,27,0
1000000US060952531081008,060952531081008,"Block 1008, Block Group 1, Census Tract 2531.08, Solano County, California",36,36,0
1000000US060952531081009,060952531081009,"Block 1009, Block Group 1, Census Tract 2531.08, Solano County, California",24,23,1
1000000US060952531081010,060952531081010,"Block 1010, Block Group 1, Census Tract 2531.08, Solano County, California",33,31,2
1000000US060952531081011,060952531081011,"Block 1011, Block Group 1, Census Tract 2531.08, Solano County, California",26,23,3
1000000US060952531081012,060952531081012,"Block 1012, Block Group 1, Census Tract 2531.08, Solano County, California",24,24,0
1000000US060952531081013,060952531081013,"Block 1013, Block Group 1, Census Tract 2531.08, Solano County, California",59,59,0
1000000US060952531081014,060952531081014,"Block 1014, Block Group 1, Census Tract 2531.08, Solano County, California",54,53,1
1000000US060952531081015,060952531081015,"Block 1015, Block Group 1, Census Tract 2531.08, Solano County, California",0,0,0
1000000US060952531081016,060952531081016,"Block 1016, Block Group 1, Census Tract 2531.08, Solano County, California",0,0,0
1000000US060952531081017,060952531081017,"Block 1017, Block Group 1, Census Tract 2531.08, Solano County, California",27,24,3
1000000US060952531081018,060952531081018,"Block 1018, Block Group 1, Census Tract 2531.08, Solano County, California",15,12,3
1000000US060952531081019,060952531081019,"Block 1019, Block Group 1, Census Tract 2531.08, Solano County, California",18,18,0
1000000US060952531081020,060952531081020,"Block 1020, Block Group 1, Census Tract 2531.08, Solano County, California",12,12,0
1000000US060952531082000,060952531082000,"Block 2000, Block Group 2, Census Tract 2531.08, Solano County, California",30,28,2
1000000US060952531082001,060952531082001,"Block 2001, Block Group 2, Census Tract 2531.08, Solano County, California",12,12,0
1000000US060952531082002,060952531082002,"Block 2002, Block Group 2, Census Tract 2531.08, Solano County, California",166,155,11
1000000US060952531082003,060952531082003,"Block 2003, Block Group 2, Census Tract 2531.08, Solano County, California",21,19,2
1000000US060952531082004,060952531082004,"Block 2004, Block Group 2, Census Tract 2531.08, Solano County, California",27,24,3
1000000US060952531082005,060952531082005,"Block 2005, Block Group 2, Census Tract 2531.08, Solano County, California",28,24,4
1000000US060952531082006,060952531082006,"Block 2006, Block Group 2, Census Tract 2531.08, Solano County, California",15,15,0
1000000US060952531082007,060952531082007,"Block 2007, Block Group 2, Census Tract 2531.08, Solano County, California",28,28,0
1000000US060952531082008,060952531082008,"Block 2008, Block Group 2, Census Tract 2531.08, Solano County, California",30,28,2
1000000US060952531082009,060952531082009,"Block 2009, Block Group 2, Census Tract 2531.08, Solano County, California",9,9,0
1000000US060952531082010,060952531082010,"Block 2010, Block Group 2, Census Tract 2531.08, Solano County, California",35,34,1
1000000US060952531082011,060952531082011,"Block 2011, Block Group 2, Census Tract 2531.08, Solano County, California",24,24,0
1000000US060952531082012,060952531082012,"Block 2012, Block Group 2, Census Tract 2531.08, Solano County, California",21,21,0
1000000US060952531082013,060952531082013,"Block 2013, Block Group 2, Census Tract 2531.08, Solano County, California",17,17,0
1000000US060952531082014,060952531082014,"Block 2014, Block Group 2, Census Tract 2531.08, Solano County, California",0,0,0
1000000US060952531083000,060952531083000,"Block 3000, Block Group 3, Census Tract 2531.08, Solano County, California",0,0,0
1000000US060952531083001,060952531083001,"Block 3001, Block Group 3, Census Tract 2531.08, Solano County, California",0,0,0
1000000US060952531083002,060952531083002,"Block 3002, Block Group 3, Census Tract 2531.08, Solano County, California",64,63,1
1000000US060952531083003,060952531083003,"Block 3003, Block Group 3, Census Tract 2531.08, Solano County, California",7,7,0
1000000US060952531083004,060952531083004,"Block 3004, Block Group 3, Census Tract 2531.08, Solano County, California",0,0,0
1000000US060952531083005,060952531083005,"Block 3005, Block Group 3, Census Tract 2531.08, Solano County, California",0,0,0
1000000US060952531083006,060952531083006,"Block 3006, Block Group 3, Census Tract 2531.08, Solano County, California",98,86,12
1000000US060952531083007,060952531083007,"Block 3007, Block Group 3, Census Tract 2531.08, Solano County, California",69,69,0
1000000US060952531083008,060952531083008,"Block 3008, Block Group 3, Census Tract 2531.08, Solano County, California",0,0,0
1000000US060952531083009,060952531083009,"Block 3009, Block Group 3, Census Tract 2531.08, Solano County, California",0,0,0
1000000US060952531083010,060952531083010,"Block 3010, Block Group 3, Census Tract 2531.08, Solano County, California",0,0,0
1000000US060952531083011,060952531083011,"Block 3011, Block Group 3, Census Tract 2531.08, Solano County, California",0,0,0
1000000US060952531083012,060952531083012,"Block 3012, Block Group 3, Census Tract 2531.08, Solano County, California",1,1,0
1000000US060952531083013,060952531083013,"Block 3013, Block Group 3, Census Tract 2531.08, Solano County, California",0,0,0
1000000US060952531083014,060952531083014,"Block 3014, Block Group 3, Census Tract 2531.08, Solano County, California",0,0,0
1000000US060952531083015,060952531083015,"Block 3015, Block Group 3, Census Tract 2531.08, Solano County, California",0,0,0
1000000US060952531083016,060952531083016,"Block 3016, Block Group 3, Census Tract 2531.08, Solano County, California",0,0,0
1000000US060952531083017,060952531083017,"Block 3017, Block Group 3, Census Tract 2531.08, Solano County, California",0,0,0
1000000US060952531083018,060952531083018,"Block 3018, Block Group 3, Census Tract 2531.08, Solano County, California",0,0,0
1000000US060952531083019,060952531083019,"Block 3019, Block Group 3, Census Tract 2531.08, Solano County, California",0,0,0
1000000US060952531083020,060952531083020,"Block 3020, Block Group 3, Census Tract 2531.08, Solano County, California",0,0,0
1000000US060952531083021,060952531083021,"Block 3021, Block Group 3, Census Tract 2531.08, Solano County, California",8,8,0
1000000US060952531083022,060952531083022,"Block 3022, Block Group 3, Census Tract 2531.08, Solano County, California",0,0,0
1000000US060952531083023,060952531083023,"Block 3023, Block Group 3, Census Tract 2531.08, Solano County, California",0,0,0
1000000US060952531083024,060952531083024,"Block 3024, Block Group 3, Census Tract 2531.08, Solano County, California",0,0,0
1000000US060952531083025,060952531083025,"Block 3025, Block Group 3, Census Tract 2531.08, Solano County, California",40,33,7
1000000US060952531083026,060952531083026,"Block 3026, Block Group 3, Census Tract 2531.08, Solano County, California",0,0,0
1000000US060952531083027,060952531083027,"Block 3027, Block Group 3, Census Tract 2531.08, Solano County, California",0,0,0
1000000US060952531083028,060952531083028,"Block 3028, Block Group 3, Census Tract 2531.08, Solano County, California",0,0,0
1000000US060952531083029,060952531083029,"Block 3029, Block Group 3, Census Tract 2531.08, Solano County, California",0,0,0
1000000US060952531083030,060952531083030,"Block 3030, Block Group 3, Census Tract 2531.08, Solano County, California",0,0,0
1000000US060952531083031,060952531083031,"Block 3031, Block Group 3, Census Tract 2531.08, Solano County, California",0,0,0
1000000US060952531083032,060952531083032,"Block 3032, Block Group 3, Census Tract 2531.08, Solano County, California",0,0,0
1000000US060952531083033,060952531083033,"Block 3033, Block Group 3, Census Tract 2531.08, Solano County, California",0,0,0
1000000US060952531083034,060952531083034,"Block 3034, Block Group 3, Census Tract 2531.08, Solano County, California",0,0,0
1000000US060952531083035,060952531083035,"Block 3035, Block Group 3, Census Tract 2531.08, Solano County, California",52,49,3
1000000US060952531083036,060952531083036,"Block 3036, Block Group 3, Census Tract 2531.08, Solano County, California",7,6,1
1000000US060952531083037,060952531083037,"Block 3037, Block Group 3, Census Tract 2531.08, Solano County, California",20,19,1
1000000US060952531083038,060952531083038,"Block 3038, Block Group 3, Census Tract 2531.08, Solano County, California",22,22,0
1000000US060952531083039,060952531083039,"Block 3039, Block Group 3, Census Tract 2531.08, Solano County, California",20,20,0
1000000US060952531083040,060952531083040,"Block 3040, Block Group 3, Census Tract 2531.08, Solano County, California",0,0,0
1000000US060952531083041,060952531083041,"Block 3041, Block Group 3, Census Tract 2531.08, Solano County, California",0,0,0
1000000US060952531083042,060952531083042,"Block 3042, Block Group 3, Census Tract 2531.08, Solano County, California",0,0,0
1000000US060952532011000,060952532011000,"Block 1000, Block Group 1, Census Tract 2532.01, Solano County, California",25,25,0
1000000US060952532011001,060952532011001,"Block 1001, Block Group 1, Census Tract 2532.01, Solano County, California",39,37,2
1000000US060952532011002,060952532011002,"Block 1002, Block Group 1, Census Tract 2532.01, Solano County, California",18,18,0
1000000US060952532011003,060952532011003,"Block 1003, Block Group 1, Census Tract 2532.01, Solano County, California",17,17,0
1000000US060952532011004,060952532011004,"Block 1004, Block Group 1, Census Tract 2532.01, Solano County, California",13,12,1
1000000US060952532011005,060952532011005,"Block 1005, Block Group 1, Census Tract 2532.01, Solano County, California",31,31,0
1000000US060952532011006,060952532011006,"Block 1006, Block Group 1, Census Tract 2532.01, Solano County, California",53,51,2
1000000US060952532011007,060952532011007,"Block 1007, Block Group 1, Census Tract 2532.01, Solano County, California",9,9,0
1000000US060952532011008,060952532011008,"Block 1008, Block Group 1, Census Tract 2532.01, Solano County, California",29,29,0
1000000US060952532011009,060952532011009,"Block 1009, Block Group 1, Census Tract 2532.01, Solano County, California",23,22,1
1000000US060952532011010,060952532011010,"Block 1010, Block Group 1, Census Tract 2532.01, Solano County, California",20,19,1
1000000US060952532011011,060952532011011,"Block 1011, Block Group 1, Census Tract 2532.01, Solano County, California",23,22,1
1000000US060952532011012,060952532011012,"Block 1012, Block Group 1, Census Tract 2532.01, Solano County, California",15,14,1
1000000US060952532011013,060952532011013,"Block 1013, Block Group 1, Census Tract 2532.01, Solano County, California",0,0,0
1000000US060952532011014,060952532011014,"Block 1014, Block Group 1, Census Tract 2532.01, Solano County, California",26,25,1
1000000US060952532011015,060952532011015,"Block 1015, Block Group 1, Census Tract 2532.01, Solano County, California",44,43,1
1000000US060952532011016,060952532011016,"Block 1016, Block Group 1, Census Tract 2532.01, Solano County, California",14,14,0
1000000US060952532011017,060952532011017,"Block 1017, Block Group 1, Census Tract 2532.01, Solano County, California",13,13,0
1000000US060952532011018,060952532011018,"Block 1018, Block Group 1, Census Tract 2532.01, Solano County, California",13,13,0
1000000US060952532011019,060952532011019,"Block 1019, Block Group 1, Census Tract 2532.01, Solano County, California",13,13,0
1000000US060952532011020,060952532011020,"Block 1020, Block Group 1, Census Tract 2532.01, Solano County, California",18,17,1
1000000US060952532011021,060952532011021,"Block 1021, Block Group 1, Census Tract 2532.01, Solano County, California",17,17,0
1000000US060952532011022,060952532011022,"Block 1022, Block Group 1, Census Tract 2532.01, Solano County, California",16,14,2
1000000US060952532011023,060952532011023,"Block 1023, Block Group 1, Census Tract 2532.01, Solano County, California",8,8,0
1000000US060952532011024,060952532011024,"Block 1024, Block Group 1, Census Tract 2532.01, Solano County, California",13,12,1
1000000US060952532012000,060952532012000,"Block 2000, Block Group 2, Census Tract 2532.01, Solano County, California",9,9,0
1000000US060952532012001,060952532012001,"Block 2001, Block Group 2, Census Tract 2532.01, Solano County, California",1,1,0
1000000US060952532012002,060952532012002,"Block 2002, Block Group 2, Census Tract 2532.01, Solano County, California",2,2,0
1000000US060952532012003,060952532012003,"Block 2003, Block Group 2, Census Tract 2532.01, Solano County, California",0,0,0
1000000US060952532012004,060952532012004,"Block 2004, Block Group 2, Census Tract 2532.01, Solano County, California",1,1,0
1000000US060952532012005,060952532012005,"Block 2005, Block Group 2, Census Tract 2532.01, Solano County, California",4,4,0
1000000US060952532012006,060952532012006,"Block 2006, Block Group 2, Census Tract 2532.01, Solano County, California",0,0,0
1000000US060952532012007,060952532012007,"Block 2007, Block Group 2, Census Tract 2532.01, Solano County, California",0,0,0
1000000US060952532012008,060952532012008,"Block 2008, Block Group 2, Census Tract 2532.01, Solano County, California",18,17,1
1000000US060952532012009,060952532012009,"Block 2009, Block Group 2, Census Tract 2532.01, Solano County, California",0,0,0
1000000US060952532012010,060952532012010,"Block 2010, Block Group 2, Census Tract 2532.01, Solano County, California",9,9,0
1000000US060952532012011,060952532012011,"Block 2011, Block Group 2, Census Tract 2532.01, Solano County, California",27,27,0
1000000US060952532012012,060952532012012,"Block 2012, Block Group 2, Census Tract 2532.01, Solano County, California",26,25,1
1000000US060952532012013,060952532012013,"Block 2013, Block Group 2, Census Tract 2532.01, Solano County, California",11,11,0
1000000US060952532012014,060952532012014,"Block 2014, Block Group 2, Census Tract 2532.01, Solano County, California",12,12,0
1000000US060952532012015,060952532012015,"Block 2015, Block Group 2, Census Tract 2532.01, Solano County, California",15,15,0
1000000US060952532012016,060952532012016,"Block 2016, Block Group 2, Census Tract 2532.01, Solano County, California",1,1,0
1000000US060952532012017,060952532012017,"Block 2017, Block Group 2, Census Tract 2532.01, Solano County, California",10,10,0
1000000US060952532012018,060952532012018,"Block 2018, Block Group 2, Census Tract 2532.01, Solano County, California",11,11,0
1000000US060952532012019,060952532012019,"Block 2019, Block Group 2, Census Tract 2532.01, Solano County, California",36,34,2
1000000US060952532012020,060952532012020,"Block 2020, Block Group 2, Census Tract 2532.01, Solano County, California",15,15,0
1000000US060952532012021,060952532012021,"Block 2021, Block Group 2, Census Tract 2532.01, Solano County, California",19,19,0
1000000US060952532012022,060952532012022,"Block 2022, Block Group 2, Census Tract 2532.01, Solano County, California",18,17,1
1000000US060952532012023,060952532012023,"Block 2023, Block Group 2, Census Tract 2532.01, Solano County, California",26,25,1
1000000US060952532012024,060952532012024,"Block 2024, Block Group 2, Census Tract 2532.01, Solano County, California",20,19,1
1000000US060952532012025,060952532012025,"Block 2025, Block Group 2, Census Tract 2532.01, Solano County, California",20,19,1
1000000US060952532012026,060952532012026,"Block 2026, Block Group 2, Census Tract 2532.01, Solano County, California",1,1,0
1000000US060952532012027,060952532012027,"Block 2027, Block Group 2, Census Tract 2532.01, Solano County, California",11,11,0
1000000US060952532012028,060952532012028,"Block 2028, Block Group 2, Census Tract 2532.01, Solano County, California",2,2,0
1000000US060952532012029,060952532012029,"Block 2029, Block Group 2, Census Tract 2532.01, Solano County, California",13,11,2
1000000US060952532013000,060952532013000,"Block 3000, Block Group 3, Census Tract 2532.01, Solano County, California",11,11,0
1000000US060952532013001,060952532013001,"Block 3001, Block Group 3, Census Tract 2532.01, Solano County, California",9,9,0
1000000US060952532013002,060952532013002,"Block 3002, Block Group 3, Census Tract 2532.01, Solano County, California",74,73,1
1000000US060952532013003,060952532013003,"Block 3003, Block Group 3, Census Tract 2532.01, Solano County, California",22,22,0
1000000US060952532013004,060952532013004,"Block 3004, Block Group 3, Census Tract 2532.01, Solano County, California",16,13,3
1000000US060952532013005,060952532013005,"Block 3005, Block Group 3, Census Tract 2532.01, Solano County, California",13,11,2
1000000US060952532013006,060952532013006,"Block 3006, Block Group 3, Census Tract 2532.01, Solano County, California",9,8,1
1000000US060952532013007,060952532013007,"Block 3007, Block Group 3, Census Tract 2532.01, Solano County, California",31,31,0
1000000US060952532013008,060952532013008,"Block 3008, Block Group 3, Census Tract 2532.01, Solano County, California",5,5,0
1000000US060952532013009,060952532013009,"Block 3009, Block Group 3, Census Tract 2532.01, Solano County, California",3,3,0
1000000US060952532013010,060952532013010,"Block 3010, Block Group 3, Census Tract 2532.01, Solano County, California",9,9,0
1000000US060952532013011,060952532013011,"Block 3011, Block Group 3, Census Tract 2532.01, Solano County, California",72,68,4
1000000US060952532013012,060952532013012,"Block 3012, Block Group 3, Census Tract 2532.01, Solano County, California",28,27,1
1000000US060952532013013,060952532013013,"Block 3013, Block Group 3, Census Tract 2532.01, Solano County, California",18,16,2
1000000US060952532013014,060952532013014,"Block 3014, Block Group 3, Census Tract 2532.01, Solano County, California",38,37,1
1000000US060952532013015,060952532013015,"Block 3015, Block Group 3, Census Tract 2532.01, Solano County, California",29,26,3
1000000US060952532013016,060952532013016,"Block 3016, Block Group 3, Census Tract 2532.01, Solano County, California",12,10,2
1000000US060952532013017,060952532013017,"Block 3017, Block Group 3, Census Tract 2532.01, Solano County, California",23,23,0
1000000US060952532013018,060952532013018,"Block 3018, Block Group 3, Census Tract 2532.01, Solano County, California",24,23,1
1000000US060952532013019,060952532013019,"Block 3019, Block Group 3, Census Tract 2532.01, Solano County, California",4,4,0
1000000US060952532013020,060952532013020,"Block 3020, Block Group 3, Census Tract 2532.01, Solano County, California",11,10,1
1000000US060952532013021,060952532013021,"Block 3021, Block Group 3, Census Tract 2532.01, Solano County, California",21,20,1
1000000US060952532013022,060952532013022,"Block 3022, Block Group 3, Census Tract 2532.01, Solano County, California",23,22,1
1000000US060952532014000,060952532014000,"Block 4000, Block Group 4, Census Tract 2532.01, Solano County, California",0,0,0
1000000US060952532014001,060952532014001,"Block 4001, Block Group 4, Census Tract 2532.01, Solano County, California",0,0,0
1000000US060952532014002,060952532014002,"Block 4002, Block Group 4, Census Tract 2532.01, Solano County, California",0,0,0
1000000US060952532014003,060952532014003,"Block 4003, Block Group 4, Census Tract 2532.01, Solano County, California",3,3,0
1000000US060952532014004,060952532014004,"Block 4004, Block Group 4, Census Tract 2532.01, Solano County, California",2,2,0
1000000US060952532014005,060952532014005,"Block 4005, Block Group 4, Census Tract 2532.01, Solano County, California",0,0,0
1000000US060952532014006,060952532014006,"Block 4006, Block Group 4, Census Tract 2532.01, Solano County, California",0,0,0
1000000US060952532014007,060952532014007,"Block 4007, Block Group 4, Census Tract 2532.01, Solano County, California",84,82,2
1000000US060952532014008,060952532014008,"Block 4008, Block Group 4, Census Tract 2532.01, Solano County, California",7,7,0
1000000US060952532014009,060952532014009,"Block 4009, Block Group 4, Census Tract 2532.01, Solano County, California",10,10,0
1000000US060952532014010,060952532014010,"Block 4010, Block Group 4, Census Tract 2532.01, Solano County, California",15,15,0
1000000US060952532014011,060952532014011,"Block 4011, Block Group 4, Census Tract 2532.01, Solano County, California",140,136,4
1000000US060952532014012,060952532014012,"Block 4012, Block Group 4, Census Tract 2532.01, Solano County, California",12,12,0
1000000US060952532014013,060952532014013,"Block 4013, Block Group 4, Census Tract 2532.01, Solano County, California",54,52,2
1000000US060952532014014,060952532014014,"Block 4014, Block Group 4, Census Tract 2532.01, Solano County, California",0,0,0
1000000US060952532014015,060952532014015,"Block 4015, Block Group 4, Census Tract 2532.01, Solano County, California",1,1,0
1000000US060952532014016,060952532014016,"Block 4016, Block Group 4, Census Tract 2532.01, Solano County, California",0,0,0
1000000US060952532014017,060952532014017,"Block 4017, Block Group 4, Census Tract 2532.01, Solano County, California",42,42,0
1000000US060952532014018,060952532014018,"Block 4018, Block Group 4, Census Tract 2532.01, Solano County, California",15,15,0
1000000US060952532014019,060952532014019,"Block 4019, Block Group 4, Census Tract 2532.01, Solano County, California",0,0,0
1000000US060952532014020,060952532014020,"Block 4020, Block Group 4, Census Tract 2532.01, Solano County, California",52,51,1
1000000US060952532014021,060952532014021,"Block 4021, Block Group 4, Census Tract 2532.01, Solano County, California",34,34,0
1000000US060952532014022,060952532014022,"Block 4022, Block Group 4, Census Tract 2532.01, Solano County, California",10,10,0
1000000US060952532014023,060952532014023,"Block 4023, Block Group 4, Census Tract 2532.01, Solano County, California",7,7,0
1000000US060952532014024,060952532014024,"Block 4024, Block Group 4, Census Tract 2532.01, Solano County, California",25,24,1
1000000US060952532014025,060952532014025,"Block 4025, Block Group 4, Census Tract 2532.01, Solano County, California",11,11,0
1000000US060952532031000,060952532031000,"Block 1000, Block Group 1, Census Tract 2532.03, Solano County, California",20,19,1
1000000US060952532031001,060952532031001,"Block 1001, Block Group 1, Census Tract 2532.03, Solano County, California",5,5,0
1000000US060952532031002,060952532031002,"Block 1002, Block Group 1, Census Tract 2532.03, Solano County, California",1,1,0
1000000US060952532031003,060952532031003,"Block 1003, Block Group 1, Census Tract 2532.03, Solano County, California",0,0,0
1000000US060952532031004,060952532031004,"Block 1004, Block Group 1, Census Tract 2532.03, Solano County, California",3,3,0
1000000US060952532031005,060952532031005,"Block 1005, Block Group 1, Census Tract 2532.03, Solano County, California",97,91,6
1000000US060952532031006,060952532031006,"Block 1006, Block Group 1, Census Tract 2532.03, Solano County, California",33,32,1
1000000US060952532031007,060952532031007,"Block 1007, Block Group 1, Census Tract 2532.03, Solano County, California",26,24,2
1000000US060952532031008,060952532031008,"Block 1008, Block Group 1, Census Tract 2532.03, Solano County, California",36,33,3
1000000US060952532031009,060952532031009,"Block 1009, Block Group 1, Census Tract 2532.03, Solano County, California",28,28,0
1000000US060952532031010,060952532031010,"Block 1010, Block Group 1, Census Tract 2532.03, Solano County, California",26,24,2
1000000US060952532031011,060952532031011,"Block 1011, Block Group 1, Census Tract 2532.03, Solano County, California",26,25,1
1000000US060952532031012,060952532031012,"Block 1012, Block Group 1, Census Tract 2532.03, Solano County, California",26,24,2
1000000US060952532031013,060952532031013,"Block 1013, Block Group 1, Census Tract 2532.03, Solano County, California",27,24,3
1000000US060952532031014,060952532031014,"Block 1014, Block Group 1, Census Tract 2532.03, Solano County, California",26,24,2
1000000US060952532031015,060952532031015,"Block 1015, Block Group 1, Census Tract 2532.03, Solano County, California",28,28,0
1000000US060952532031016,060952532031016,"Block 1016, Block Group 1, Census Tract 2532.03, Solano County, California",30,27,3
1000000US060952532031017,060952532031017,"Block 1017, Block Group 1, Census Tract 2532.03, Solano County, California",26,25,1
1000000US060952532031018,060952532031018,"Block 1018, Block Group 1, Census Tract 2532.03, Solano County, California",26,24,2
1000000US060952532031019,060952532031019,"Block 1019, Block Group 1, Census Tract 2532.03, Solano County, California",54,48,6
1000000US060952532031020,060952532031020,"Block 1020, Block Group 1, Census Tract 2532.03, Solano County, California",79,75,4
1000000US060952532031021,060952532031021,"Block 1021, Block Group 1, Census Tract 2532.03, Solano County, California",26,25,1
1000000US060952532032000,060952532032000,"Block 2000, Block Group 2, Census Tract 2532.03, Solano County, California",3,3,0
1000000US060952532032001,060952532032001,"Block 2001, Block Group 2, Census Tract 2532.03, Solano County, California",76,75,1
1000000US060952532032002,060952532032002,"Block 2002, Block Group 2, Census Tract 2532.03, Solano County, California",17,17,0
1000000US060952532032003,060952532032003,"Block 2003, Block Group 2, Census Tract 2532.03, Solano County, California",36,33,3
1000000US060952532032004,060952532032004,"Block 2004, Block Group 2, Census Tract 2532.03, Solano County, California",12,12,0
1000000US060952532032005,060952532032005,"Block 2005, Block Group 2, Census Tract 2532.03, Solano County, California",14,14,0
1000000US060952532032006,060952532032006,"Block 2006, Block Group 2, Census Tract 2532.03, Solano County, California",7,6,1
1000000US060952532032007,060952532032007,"Block 2007, Block Group 2, Census Tract 2532.03, Solano County, California",33,29,4
1000000US060952532032008,060952532032008,"Block 2008, Block Group 2, Census Tract 2532.03, Solano County, California",23,22,1
1000000US060952532032009,060952532032009,"Block 2009, Block Group 2, Census Tract 2532.03, Solano County, California",23,22,1
1000000US060952532032010,060952532032010,"Block 2010, Block Group 2, Census Tract 2532.03, Solano County, California",25,23,2
1000000US060952532032011,060952532032011,"Block 2011, Block Group 2, Census Tract 2532.03, Solano County, California",30,27,3
1000000US060952532032012,060952532032012,"Block 2012, Block Group 2, Census Tract 2532.03, Solano County, California",43,42,1
1000000US060952532032013,060952532032013,"Block 2013, Block Group 2, Census Tract 2532.03, Solano County, California",39,38,1
1000000US060952532032014,060952532032014,"Block 2014, Block Group 2, Census Tract 2532.03, Solano County, California",20,20,0
1000000US060952532032015,060952532032015,"Block 2015, Block Group 2, Census Tract 2532.03, Solano County, California",22,22,0
1000000US060952532032016,060952532032016,"Block 2016, Block Group 2, Census Tract 2532.03, Solano County, California",67,63,4
1000000US060952532032017,060952532032017,"Block 2017, Block Group 2, Census Tract 2532.03, Solano County, California",11,10,1
1000000US060952532032018,060952532032018,"Block 2018, Block Group 2, Census Tract 2532.03, Solano County, California",25,22,3
1000000US060952532032019,060952532032019,"Block 2019, Block Group 2, Census Tract 2532.03, Solano County, California",20,19,1
1000000US060952532032020,060952532032020,"Block 2020, Block Group 2, Census Tract 2532.03, Solano County, California",20,19,1
1000000US060952532032021,060952532032021,"Block 2021, Block Group 2, Census Tract 2532.03, Solano County, California",27,26,1
1000000US060952532032022,060952532032022,"Block 2022, Block Group 2, Census Tract 2532.03, Solano County, California",20,20,0
1000000US060952532032023,060952532032023,"Block 2023, Block Group 2, Census Tract 2532.03, Solano County, California",0,0,0
1000000US060952532033000,060952532033000,"Block 3000, Block Group 3, Census Tract 2532.03, Solano County, California",0,0,0
1000000US060952532033001,060952532033001,"Block 3001, Block Group 3, Census Tract 2532.03, Solano County, California",0,0,0
1000000US060952532033002,060952532033002,"Block 3002, Block Group 3, Census Tract 2532.03, Solano County, California",0,0,0
1000000US060952532033003,060952532033003,"Block 3003, Block Group 3, Census Tract 2532.03, Solano County, California",0,0,0
1000000US060952532033004,060952532033004,"Block 3004, Block Group 3, Census Tract 2532.03, Solano County, California",25,22,3
1000000US060952532033005,060952532033005,"Block 3005, Block Group 3, Census Tract 2532.03, Solano County, California",13,12,1
1000000US060952532033006,060952532033006,"Block 3006, Block Group 3, Census Tract 2532.03, Solano County, California",30,29,1
1000000US060952532033007,060952532033007,"Block 3007, Block Group 3, Census Tract 2532.03, Solano County, California",15,14,1
1000000US060952532033008,060952532033008,"Block 3008, Block Group 3, Census Tract 2532.03, Solano County, California",16,16,0
1000000US060952532033009,060952532033009,"Block 3009, Block Group 3, Census Tract 2532.03, Solano County, California",12,11,1
1000000US060952532033010,060952532033010,"Block 3010, Block Group 3, Census Tract 2532.03, Solano County, California",10,10,0
1000000US060952532033011,060952532033011,"Block 3011, Block Group 3, Census Tract 2532.03, Solano County, California",25,24,1
1000000US060952532033012,060952532033012,"Block 3012, Block Group 3, Census Tract 2532.03, Solano County, California",14,14,0
1000000US060952532033013,060952532033013,"Block 3013, Block Group 3, Census Tract 2532.03, Solano County, California",132,119,13
1000000US060952532033014,060952532033014,"Block 3014, Block Group 3, Census Tract 2532.03, Solano County, California",0,0,0
1000000US060952532033015,060952532033015,"Block 3015, Block Group 3, Census Tract 2532.03, Solano County, California",0,0,0
1000000US060952532033016,060952532033016,"Block 3016, Block Group 3, Census Tract 2532.03, Solano County, California",22,21,1
1000000US060952532033017,060952532033017,"Block 3017, Block Group 3, Census Tract 2532.03, Solano County, California",35,29,6
1000000US060952532033018,060952532033018,"Block 3018, Block Group 3, Census Tract 2532.03, Solano County, California",2,2,0
1000000US060952532033019,060952532033019,"Block 3019, Block Group 3, Census Tract 2532.03, Solano County, California",14,13,1
1000000US060952532033020,060952532033020,"Block 3020, Block Group 3, Census Tract 2532.03, Solano County, California",0,0,0
1000000US060952532033021,060952532033021,"Block 3021, Block Group 3, Census Tract 2532.03, Solano County, California",0,0,0
1000000US060952532033022,060952532033022,"Block 3022, Block Group 3, Census Tract 2532.03, Solano County, California",0,0,0
1000000US060952532041000,060952532041000,"Block 1000, Block Group 1, Census Tract 2532.04, Solano County, California",0,0,0
1000000US060952532041001,060952532041001,"Block 1001, Block Group 1, Census Tract 2532.04, Solano County, California",0,0,0
1000000US060952532041002,060952532041002,"Block 1002, Block Group 1, Census Tract 2532.04, Solano County, California",0,0,0
1000000US060952532041003,060952532041003,"Block 1003, Block Group 1, Census Tract 2532.04, Solano County, California",0,0,0
1000000US060952532041004,060952532041004,"Block 1004, Block Group 1, Census Tract 2532.04, Solano County, California",0,0,0
1000000US060952532041005,060952532041005,"Block 1005, Block Group 1, Census Tract 2532.04, Solano County, California",0,0,0
1000000US060952532041006,060952532041006,"Block 1006, Block Group 1, Census Tract 2532.04, Solano County, California",1,1,0
1000000US060952532041007,060952532041007,"Block 1007, Block Group 1, Census Tract 2532.04, Solano County, California",0,0,0
1000000US060952532041008,060952532041008,"Block 1008, Block Group 1, Census Tract 2532.04, Solano County, California",390,372,18
1000000US060952532041009,060952532041009,"Block 1009, Block Group 1, Census Tract 2532.04, Solano County, California",15,15,0
1000000US060952532041010,060952532041010,"Block 1010, Block Group 1, Census Tract 2532.04, Solano County, California",13,13,0
1000000US060952532041011,060952532041011,"Block 1011, Block Group 1, Census Tract 2532.04, Solano County, California",1,1,0
1000000US060952532041012,060952532041012,"Block 1012, Block Group 1, Census Tract 2532.04, Solano County, California",0,0,0
1000000US060952532041013,060952532041013,"Block 1013, Block Group 1, Census Tract 2532.04, Solano County, California",0,0,0
1000000US060952532041014,060952532041014,"Block 1014, Block Group 1, Census Tract 2532.04, Solano County, California",11,10,1
1000000US060952532041015,060952532041015,"Block 1015, Block Group 1, Census Tract 2532.04, Solano County, California",0,0,0
1000000US060952532041016,060952532041016,"Block 1016, Block Group 1, Census Tract 2532.04, Solano County, California",0,0,0
1000000US060952532041017,060952532041017,"Block 1017, Block Group 1, Census Tract 2532.04, Solano County, California",0,0,0
1000000US060952532041018,060952532041018,"Block 1018, Block Group 1, Census Tract 2532.04, Solano County, California",0,0,0
1000000US060952532041019,060952532041019,"Block 1019, Block Group 1, Census Tract 2532.04, Solano County, California",0,0,0
1000000US060952532041020,060952532041020,"Block 1020, Block Group 1, Census Tract 2532.04, Solano County, California",9,7,2
1000000US060952532041021,060952532041021,"Block 1021, Block Group 1, Census Tract 2532.04, Solano County, California",3,3,0
1000000US060952532041022,060952532041022,"Block 1022, Block Group 1, Census Tract 2532.04, Solano County, California",1,0,1
1000000US060952532041023,060952532041023,"Block 1023, Block Group 1, Census Tract 2532.04, Solano County, California",0,0,0
1000000US060952532041024,060952532041024,"Block 1024, Block Group 1, Census Tract 2532.04, Solano County, California",9,8,1
1000000US060952532041025,060952532041025,"Block 1025, Block Group 1, Census Tract 2532.04, Solano County, California",1,1,0
1000000US060952532041026,060952532041026,"Block 1026, Block Group 1, Census Tract 2532.04, Solano County, California",2,1,1
1000000US060952532041027,060952532041027,"Block 1027, Block Group 1, Census Tract 2532.04, Solano County, California",0,0,0
1000000US060952532041028,060952532041028,"Block 1028, Block Group 1, Census Tract 2532.04, Solano County, California",4,3,1
1000000US060952532041029,060952532041029,"Block 1029, Block Group 1, Census Tract 2532.04, Solano County, California",59,52,7
1000000US060952532041030,060952532041030,"Block 1030, Block Group 1, Census Tract 2532.04, Solano County, California",1,1,0
1000000US060952532041031,060952532041031,"Block 1031, Block Group 1, Census Tract 2532.04, Solano County, California",0,0,0
1000000US060952532041032,060952532041032,"Block 1032, Block Group 1, Census Tract 2532.04, Solano County, California",0,0,0
1000000US060952532041033,060952532041033,"Block 1033, Block Group 1, Census Tract 2532.04, Solano County, California",0,0,0
1000000US060952532041034,060952532041034,"Block 1034, Block Group 1, Census Tract 2532.04, Solano County, California",0,0,0
1000000US060952532041035,060952532041035,"Block 1035, Block Group 1, Census Tract 2532.04, Solano County, California",45,39,6
1000000US060952532041036,060952532041036,"Block 1036, Block Group 1, Census Tract 2532.04, Solano County, California",15,15,0
1000000US060952532041037,060952532041037,"Block 1037, Block Group 1, Census Tract 2532.04, Solano County, California",26,25,1
1000000US060952532041038,060952532041038,"Block 1038, Block Group 1, Census Tract 2532.04, Solano County, California",0,0,0
1000000US060952532041039,060952532041039,"Block 1039, Block Group 1, Census Tract 2532.04, Solano County, California",14,12,2
1000000US060952532041040,060952532041040,"Block 1040, Block Group 1, Census Tract 2532.04, Solano County, California",1,1,0
1000000US060952532041041,060952532041041,"Block 1041, Block Group 1, Census Tract 2532.04, Solano County, California",1,1,0
1000000US060952532041042,060952532041042,"Block 1042, Block Group 1, Census Tract 2532.04, Solano County, California",0,0,0
1000000US060952532041043,060952532041043,"Block 1043, Block Group 1, Census Tract 2532.04, Solano County, California",0,0,0
1000000US060952532041044,060952532041044,"Block 1044, Block Group 1, Census Tract 2532.04, Solano County, California",0,0,0
1000000US060952532041045,060952532041045,"Block 1045, Block Group 1, Census Tract 2532.04, Solano County, California",0,0,0
1000000US060952532042000,060952532042000,"Block 2000, Block Group 2, Census Tract 2532.04, Solano County, California",4,4,0
1000000US060952532042001,060952532042001,"Block 2001, Block Group 2, Census Tract 2532.04, Solano County, California",9,9,0
1000000US060952532042002,060952532042002,"Block 2002, Block Group 2, Census Tract 2532.04, Solano County, California",12,12,0
1000000US060952532042003,060952532042003,"Block 2003, Block Group 2, Census Tract 2532.04, Solano County, California",4,4,0
1000000US060952532042004,060952532042004,"Block 2004, Block Group 2, Census Tract 2532.04, Solano County, California",37,36,1
1000000US060952532042005,060952532042005,"Block 2005, Block Group 2, Census Tract 2532.04, Solano County, California",0,0,0
1000000US060952532042006,060952532042006,"Block 2006, Block Group 2, Census Tract 2532.04, Solano County, California",0,0,0
1000000US060952532042007,060952532042007,"Block 2007, Block Group 2, Census Tract 2532.04, Solano County, California",0,0,0
1000000US060952532042008,060952532042008,"Block 2008, Block Group 2, Census Tract 2532.04, Solano County, California",24,24,0
1000000US060952532042009,060952532042009,"Block 2009, Block Group 2, Census Tract 2532.04, Solano County, California",84,84,0
1000000US060952532042010,060952532042010,"Block 2010, Block Group 2, Census Tract 2532.04, Solano County, California",71,68,3
1000000US060952532042011,060952532042011,"Block 2011, Block Group 2, Census Tract 2532.04, Solano County, California",5,5,0
1000000US060952532042012,060952532042012,"Block 2012, Block Group 2, Census Tract 2532.04, Solano County, California",3,3,0
1000000US060952532042013,060952532042013,"Block 2013, Block Group 2, Census Tract 2532.04, Solano County, California",0,0,0
1000000US060952532042014,060952532042014,"Block 2014, Block Group 2, Census Tract 2532.04, Solano County, California",76,72,4
1000000US060952532042015,060952532042015,"Block 2015, Block Group 2, Census Tract 2532.04, Solano County, California",41,38,3
1000000US060952532043000,060952532043000,"Block 3000, Block Group 3, Census Tract 2532.04, Solano County, California",93,90,3
1000000US060952532043001,060952532043001,"Block 3001, Block Group 3, Census Tract 2532.04, Solano County, California",12,12,0
1000000US060952532043002,060952532043002,"Block 3002, Block Group 3, Census Tract 2532.04, Solano County, California",19,18,1
1000000US060952532043003,060952532043003,"Block 3003, Block Group 3, Census Tract 2532.04, Solano County, California",17,16,1
1000000US060952532043004,060952532043004,"Block 3004, Block Group 3, Census Tract 2532.04, Solano County, California",17,16,1
1000000US060952532043005,060952532043005,"Block 3005, Block Group 3, Census Tract 2532.04, Solano County, California",16,16,0
1000000US060952532043006,060952532043006,"Block 3006, Block Group 3, Census Tract 2532.04, Solano County, California",46,44,2
1000000US060952532043007,060952532043007,"Block 3007, Block Group 3, Census Tract 2532.04, Solano County, California",78,76,2
1000000US060952532043008,060952532043008,"Block 3008, Block Group 3, Census Tract 2532.04, Solano County, California",0,0,0
1000000US060952532043009,060952532043009,"Block 3009, Block Group 3, Census Tract 2532.04, Solano County, California",8,8,0
1000000US060952532043010,060952532043010,"Block 3010, Block Group 3, Census Tract 2532.04, Solano County, California",20,19,1
1000000US060952532043011,060952532043011,"Block 3011, Block Group 3, Census Tract 2532.04, Solano County, California",0,0,0
1000000US060952532043012,060952532043012,"Block 3012, Block Group 3, Census Tract 2532.04, Solano County, California",20,20,0
1000000US060952532043013,060952532043013,"Block 3013, Block Group 3, Census Tract 2532.04, Solano County, California",13,13,0
1000000US060952532043014,060952532043014,"Block 3014, Block Group 3, Census Tract 2532.04, Solano County, California",18,18,0
1000000US060952532043015,060952532043015,"Block 3015, Block Group 3, Census Tract 2532.04, Solano County, California",58,56,2
1000000US060952532043016,060952532043016,"Block 3016, Block Group 3, Census Tract 2532.04, Solano County, California",24,23,1
1000000US060952532043017,060952532043017,"Block 3017, Block Group 3, Census Tract 2532.04, Solano County, California",21,20,1
1000000US060952532043018,060952532043018,"Block 3018, Block Group 3, Census Tract 2532.04, Solano County, California",50,50,0
1000000US060952532043019,060952532043019,"Block 3019, Block Group 3, Census Tract 2532.04, Solano County, California",32,32,0
1000000US060952532044000,060952532044000,"Block 4000, Block Group 4, Census Tract 2532.04, Solano County, California",36,35,1
1000000US060952532044001,060952532044001,"Block 4001, Block Group 4, Census Tract 2532.04, Solano County, California",25,23,2
1000000US060952532044002,060952532044002,"Block 4002, Block Group 4, Census Tract 2532.04, Solano County, California",27,26,1
1000000US060952532044003,060952532044003,"Block 4003, Block Group 4, Census Tract 2532.04, Solano County, California",32,31,1
1000000US060952532044004,060952532044004,"Block 4004, Block Group 4, Census Tract 2532.04, Solano County, California",31,25,6
1000000US060952532044005,060952532044005,"Block 4005, Block Group 4, Census Tract 2532.04, Solano County, California",30,30,0
1000000US060952532044006,060952532044006,"Block 4006, Block Group 4, Census Tract 2532.04, Solano County, California",57,52,5
1000000US060952532044007,060952532044007,"Block 4007, Block Group 4, Census Tract 2532.04, Solano County, California",67,61,6
1000000US060952532044008,060952532044008,"Block 4008, Block Group 4, Census Tract 2532.04, Solano County, California",127,105,22
1000000US060952532045000,060952532045000,"Block 5000, Block Group 5, Census Tract 2532.04, Solano County, California",372,343,29
1000000US060952532045001,060952532045001,"Block 5001, Block Group 5, Census Tract 2532.04, Solano County, California",0,0,0
1000000US060952532045002,060952532045002,"Block 5002, Block Group 5, Census Tract 2532.04, Solano County, California",21,20,1
1000000US060952532045003,060952532045003,"Block 5003, Block Group 5, Census Tract 2532.04, Solano County, California",0,0,0
1000000US060952532045004,060952532045004,"Block 5004, Block Group 5, Census Tract 2532.04, Solano County, California",32,21,11
1000000US060952532045005,060952532045005,"Block 5005, Block Group 5, Census Tract 2532.04, Solano County, California",13,12,1
1000000US060952532045006,060952532045006,"Block 5006, Block Group 5, Census Tract 2532.04, Solano County, California",21,16,5
1000000US060952532045007,060952532045007,"Block 5007, Block Group 5, Census Tract 2532.04, Solano County, California",0,0,0
1000000US060952532045008,060952532045008,"Block 5008, Block Group 5, Census Tract 2532.04, Solano County, California",0,0,0
1000000US060952532051000,060952532051000,"Block 1000, Block Group 1, Census Tract 2532.05, Solano County, California",14,14,0
1000000US060952532051001,060952532051001,"Block 1001, Block Group 1, Census Tract 2532.05, Solano County, California",36,36,0
1000000US060952532051002,060952532051002,"Block 1002, Block Group 1, Census Tract 2532.05, Solano County, California",11,10,1
1000000US060952532051003,060952532051003,"Block 1003, Block Group 1, Census Tract 2532.05, Solano County, California",69,67,2
1000000US060952532051004,060952532051004,"Block 1004, Block Group 1, Census Tract 2532.05, Solano County, California",20,20,0
1000000US060952532051005,060952532051005,"Block 1005, Block Group 1, Census Tract 2532.05, Solano County, California",14,13,1
1000000US060952532051006,060952532051006,"Block 1006, Block Group 1, Census Tract 2532.05, Solano County, California",47,43,4
1000000US060952532051007,060952532051007,"Block 1007, Block Group 1, Census Tract 2532.05, Solano County, California",15,15,0
1000000US060952532051008,060952532051008,"Block 1008, Block Group 1, Census Tract 2532.05, Solano County, California",32,32,0
1000000US060952532051009,060952532051009,"Block 1009, Block Group 1, Census Tract 2532.05, Solano County, California",73,71,2
1000000US060952532051010,060952532051010,"Block 1010, Block Group 1, Census Tract 2532.05, Solano County, California",17,15,2
1000000US060952532051011,060952532051011,"Block 1011, Block Group 1, Census Tract 2532.05, Solano County, California",14,14,0
1000000US060952532051012,060952532051012,"Block 1012, Block Group 1, Census Tract 2532.05, Solano County, California",15,14,1
1000000US060952532051013,060952532051013,"Block 1013, Block Group 1, Census Tract 2532.05, Solano County, California",24,23,1
1000000US060952532051014,060952532051014,"Block 1014, Block Group 1, Census Tract 2532.05, Solano County, California",27,25,2
1000000US060952532052000,060952532052000,"Block 2000, Block Group 2, Census Tract 2532.05, Solano County, California",61,58,3
1000000US060952532052001,060952532052001,"Block 2001, Block Group 2, Census Tract 2532.05, Solano County, California",23,23,0
1000000US060952532052002,060952532052002,"Block 2002, Block Group 2, Census Tract 2532.05, Solano County, California",9,9,0
1000000US060952532052003,060952532052003,"Block 2003, Block Group 2, Census Tract 2532.05, Solano County, California",22,22,0
1000000US060952532052004,060952532052004,"Block 2004, Block Group 2, Census Tract 2532.05, Solano County, California",14,14,0
1000000US060952532052005,060952532052005,"Block 2005, Block Group 2, Census Tract 2532.05, Solano County, California",3,3,0
1000000US060952532052006,060952532052006,"Block 2006, Block Group 2, Census Tract 2532.05, Solano County, California",1,1,0
1000000US060952532052007,060952532052007,"Block 2007, Block Group 2, Census Tract 2532.05, Solano County, California",3,3,0
1000000US060952532052008,060952532052008,"Block 2008, Block Group 2, Census Tract 2532.05, Solano County, California",13,13,0
1000000US060952532052009,060952532052009,"Block 2009, Block Group 2, Census Tract 2532.05, Solano County, California",8,8,0
1000000US060952532052010,060952532052010,"Block 2010, Block Group 2, Census Tract 2532.05, Solano County, California",47,44,3
1000000US060952532052011,060952532052011,"Block 2011, Block Group 2, Census Tract 2532.05, Solano County, California",36,35,1
1000000US060952532052012,060952532052012,"Block 2012, Block Group 2, Census Tract 2532.05, Solano County, California",0,0,0
1000000US060952532052013,060952532052013,"Block 2013, Block Group 2, Census Tract 2532.05, Solano County, California",29,28,1
1000000US060952532053000,060952532053000,"Block 3000, Block Group 3, Census Tract 2532.05, Solano County, California",2,2,0
1000000US060952532053001,060952532053001,"Block 3001, Block Group 3, Census Tract 2532.05, Solano County, California",0,0,0
1000000US060952532053002,060952532053002,"Block 3002, Block Group 3, Census Tract 2532.05, Solano County, California",0,0,0
1000000US060952532053003,060952532053003,"Block 3003, Block Group 3, Census Tract 2532.05, Solano County, California",0,0,0
1000000US060952532053004,060952532053004,"Block 3004, Block Group 3, Census Tract 2532.05, Solano County, California",166,126,40
1000000US060952532053005,060952532053005,"Block 3005, Block Group 3, Census Tract 2532.05, Solano County, California",0,0,0
1000000US060952532053006,060952532053006,"Block 3006, Block Group 3, Census Tract 2532.05, Solano County, California",14,14,0
1000000US060952532053007,060952532053007,"Block 3007, Block Group 3, Census Tract 2532.05, Solano County, California",0,0,0
1000000US060952532053008,060952532053008,"Block 3008, Block Group 3, Census Tract 2532.05, Solano County, California",0,0,0
1000000US060952532053009,060952532053009,"Block 3009, Block Group 3, Census Tract 2532.05, Solano County, California",0,0,0
1000000US060952532053010,060952532053010,"Block 3010, Block Group 3, Census Tract 2532.05, Solano County, California",0,0,0
1000000US060952532053011,060952532053011,"Block 3011, Block Group 3, Census Tract 2532.05, Solano County, California",0,0,0
1000000US060952532053012,060952532053012,"Block 3012, Block Group 3, Census Tract 2532.05, Solano County, California",0,0,0
1000000US060952532053013,060952532053013,"Block 3013, Block Group 3, Census Tract 2532.05, Solano County, California",0,0,0
1000000US060952532053014,060952532053014,"Block 3014, Block Group 3, Census Tract 2532.05, Solano County, California",0,0,0
1000000US060952532053015,060952532053015,"Block 3015, Block Group 3, Census Tract 2532.05, Solano County, California",0,0,0
1000000US060952532053016,060952532053016,"Block 3016, Block Group 3, Census Tract 2532.05, Solano County, California",0,0,0
1000000US060952532053017,060952532053017,"Block 3017, Block Group 3, Census Tract 2532.05, Solano County, California",0,0,0
1000000US060952532053018,060952532053018,"Block 3018, Block Group 3, Census Tract 2532.05, Solano County, California",0,0,0
1000000US060952532053019,060952532053019,"Block 3019, Block Group 3, Census Tract 2532.05, Solano County, California",0,0,0
1000000US060952532053020,060952532053020,"Block 3020, Block Group 3, Census Tract 2532.05, Solano County, California",0,0,0
1000000US060952532053021,060952532053021,"Block 3021, Block Group 3, Census Tract 2532.05, Solano County, California",0,0,0
1000000US060952532053022,060952532053022,"Block 3022, Block Group 3, Census Tract 2532.05, Solano County, California",0,0,0
1000000US060952532053023,060952532053023,"Block 3023, Block Group 3, Census Tract 2532.05, Solano County, California",0,0,0
1000000US060952532053024,060952532053024,"Block 3024, Block Group 3, Census Tract 2532.05, Solano County, California",0,0,0
1000000US060952532053025,060952532053025,"Block 3025, Block Group 3, Census Tract 2532.05, Solano County, California",0,0,0
1000000US060952532053026,060952532053026,"Block 3026, Block Group 3, Census Tract 2532.05, Solano County, California",82,68,14
1000000US060952532053027,060952532053027,"Block 3027, Block Group 3, Census Tract 2532.05, Solano County, California",11,10,1
1000000US060952532053028,060952532053028,"Block 3028, Block Group 3, Census Tract 2532.05, Solano County, California",23,23,0
1000000US060952532053029,060952532053029,"Block 3029, Block Group 3, Census Tract 2532.05, Solano County, California",44,41,3
1000000US060952532053030,060952532053030,"Block 3030, Block Group 3, Census Tract 2532.05, Solano County, California",4,3,1
1000000US060952532053031,060952532053031,"Block 3031, Block Group 3, Census Tract 2532.05, Solano County, California",18,17,1
1000000US060952532061000,060952532061000,"Block 1000, Block Group 1, Census Tract 2532.06, Solano County, California",93,92,1
1000000US060952532061001,060952532061001,"Block 1001, Block Group 1, Census Tract 2532.06, Solano County, California",14,14,0
1000000US060952532061002,060952532061002,"Block 1002, Block Group 1, Census Tract 2532.06, Solano County, California",33,31,2
1000000US060952532061003,060952532061003,"Block 1003, Block Group 1, Census Tract 2532.06, Solano County, California",9,9,0
1000000US060952532061004,060952532061004,"Block 1004, Block Group 1, Census Tract 2532.06, Solano County, California",0,0,0
1000000US060952532061005,060952532061005,"Block 1005, Block Group 1, Census Tract 2532.06, Solano County, California",9,9,0
1000000US060952532061006,060952532061006,"Block 1006, Block Group 1, Census Tract 2532.06, Solano County, California",33,32,1
1000000US060952532061007,060952532061007,"Block 1007, Block Group 1, Census Tract 2532.06, Solano County, California",32,32,0
1000000US060952532061008,060952532061008,"Block 1008, Block Group 1, Census Tract 2532.06, Solano County, California",39,39,0
1000000US060952532061009,060952532061009,"Block 1009, Block Group 1, Census Tract 2532.06, Solano County, California",73,73,0
1000000US060952532061010,060952532061010,"Block 1010, Block Group 1, Census Tract 2532.06, Solano County, California",16,14,2
1000000US060952532061011,060952532061011,"Block 1011, Block Group 1, Census Tract 2532.06, Solano County, California",16,16,0
1000000US060952532061012,060952532061012,"Block 1012, Block Group 1, Census Tract 2532.06, Solano County, California",32,29,3
1000000US060952532061013,060952532061013,"Block 1013, Block Group 1, Census Tract 2532.06, Solano County, California",15,15,0
1000000US060952532061014,060952532061014,"Block 1014, Block Group 1, Census Tract 2532.06, Solano County, California",8,7,1
1000000US060952532061015,060952532061015,"Block 1015, Block Group 1, Census Tract 2532.06, Solano County, California",1,1,0
1000000US060952532061016,060952532061016,"Block 1016, Block Group 1, Census Tract 2532.06, Solano County, California",28,27,1
1000000US060952532061017,060952532061017,"Block 1017, Block Group 1, Census Tract 2532.06, Solano County, California",39,38,1
1000000US060952532061018,060952532061018,"Block 1018, Block Group 1, Census Tract 2532.06, Solano County, California",15,14,1
1000000US060952532061019,060952532061019,"Block 1019, Block Group 1, Census Tract 2532.06, Solano County, California",28,28,0
1000000US060952532061020,060952532061020,"Block 1020, Block Group 1, Census Tract 2532.06, Solano County, California",10,10,0
1000000US060952532061021,060952532061021,"Block 1021, Block Group 1, Census Tract 2532.06, Solano County, California",7,6,1
1000000US060952532062000,060952532062000,"Block 2000, Block Group 2, Census Tract 2532.06, Solano County, California",0,0,0
1000000US060952532062001,060952532062001,"Block 2001, Block Group 2, Census Tract 2532.06, Solano County, California",9,9,0
1000000US060952532062002,060952532062002,"Block 2002, Block Group 2, Census Tract 2532.06, Solano County, California",1,1,0
1000000US060952532062003,060952532062003,"Block 2003, Block Group 2, Census Tract 2532.06, Solano County, California",6,6,0
1000000US060952532062004,060952532062004,"Block 2004, Block Group 2, Census Tract 2532.06, Solano County, California",0,0,0
1000000US060952532062005,060952532062005,"Block 2005, Block Group 2, Census Tract 2532.06, Solano County, California",7,6,1
1000000US060952532062006,060952532062006,"Block 2006, Block Group 2, Census Tract 2532.06, Solano County, California",19,19,0
1000000US060952532062007,060952532062007,"Block 2007, Block Group 2, Census Tract 2532.06, Solano County, California",9,9,0
1000000US060952532062008,060952532062008,"Block 2008, Block Group 2, Census Tract 2532.06, Solano County, California",11,11,0
1000000US060952532062009,060952532062009,"Block 2009, Block Group 2, Census Tract 2532.06, Solano County, California",0,0,0
1000000US060952532062010,060952532062010,"Block 2010, Block Group 2, Census Tract 2532.06, Solano County, California",12,11,1
1000000US060952532062011,060952532062011,"Block 2011, Block Group 2, Census Tract 2532.06, Solano County, California",0,0,0
1000000US060952532062012,060952532062012,"Block 2012, Block Group 2, Census Tract 2532.06, Solano County, California",0,0,0
1000000US060952532062013,060952532062013,"Block 2013, Block Group 2, Census Tract 2532.06, Solano County, California",0,0,0
1000000US060952532062014,060952532062014,"Block 2014, Block Group 2, Census Tract 2532.06, Solano County, California",0,0,0
1000000US060952532062015,060952532062015,"Block 2015, Block Group 2, Census Tract 2532.06, Solano County, California",1,1,0
1000000US060952532062016,060952532062016,"Block 2016, Block Group 2, Census Tract 2532.06, Solano County, California",4,4,0
1000000US060952532062017,060952532062017,"Block 2017, Block Group 2, Census Tract 2532.06, Solano County, California",17,17,0
1000000US060952532062018,060952532062018,"Block 2018, Block Group 2, Census Tract 2532.06, Solano County, California",4,4,0
1000000US060952532062019,060952532062019,"Block 2019, Block Group 2, Census Tract 2532.06, Solano County, California",0,0,0
1000000US060952532062020,060952532062020,"Block 2020, Block Group 2, Census Tract 2532.06, Solano County, California",129,126,3
1000000US060952532062021,060952532062021,"Block 2021, Block Group 2, Census Tract 2532.06, Solano County, California",9,9,0
1000000US060952532062022,060952532062022,"Block 2022, Block Group 2, Census Tract 2532.06, Solano County, California",21,21,0
1000000US060952532062023,060952532062023,"Block 2023, Block Group 2, Census Tract 2532.06, Solano County, California",48,47,1
1000000US060952532062024,060952532062024,"Block 2024, Block Group 2, Census Tract 2532.06, Solano County, California",19,17,2
1000000US060952532062025,060952532062025,"Block 2025, Block Group 2, Census Tract 2532.06, Solano County, California",18,17,1
1000000US060952532062026,060952532062026,"Block 2026, Block Group 2, Census Tract 2532.06, Solano County, California",0,0,0
1000000US060952532062027,060952532062027,"Block 2027, Block Group 2, Census Tract 2532.06, Solano County, California",67,66,1
1000000US060952532062028,060952532062028,"Block 2028, Block Group 2, Census Tract 2532.06, Solano County, California",22,20,2
1000000US060952532062029,060952532062029,"Block 2029, Block Group 2, Census Tract 2532.06, Solano County, California",24,21,3
1000000US060952532062030,060952532062030,"Block 2030, Block Group 2, Census Tract 2532.06, Solano County, California",23,23,0
1000000US060952532062031,060952532062031,"Block 2031, Block Group 2, Census Tract 2532.06, Solano County, California",0,0,0
1000000US060952532062032,060952532062032,"Block 2032, Block Group 2, Census Tract 2532.06, Solano County, California",0,0,0
1000000US060952533001000,060952533001000,"Block 1000, Block Group 1, Census Tract 2533, Solano County, California",2,2,0
1000000US060952533001001,060952533001001,"Block 1001, Block Group 1, Census Tract 2533, Solano County, California",1,1,0
1000000US060952533001002,060952533001002,"Block 1002, Block Group 1, Census Tract 2533, Solano County, California",0,0,0
1000000US060952533001003,060952533001003,"Block 1003, Block Group 1, Census Tract 2533, Solano County, California",1,1,0
1000000US060952533001004,060952533001004,"Block 1004, Block Group 1, Census Tract 2533, Solano County, California",9,9,0
1000000US060952533001005,060952533001005,"Block 1005, Block Group 1, Census Tract 2533, Solano County, California",2,2,0
1000000US060952533001006,060952533001006,"Block 1006, Block Group 1, Census Tract 2533, Solano County, California",6,5,1
1000000US060952533001007,060952533001007,"Block 1007, Block Group 1, Census Tract 2533, Solano County, California",5,5,0
1000000US060952533001008,060952533001008,"Block 1008, Block Group 1, Census Tract 2533, Solano County, California",0,0,0
1000000US060952533001009,060952533001009,"Block 1009, Block Group 1, Census Tract 2533, Solano County, California",0,0,0
1000000US060952533001010,060952533001010,"Block 1010, Block Group 1, Census Tract 2533, Solano County, California",1,1,0
1000000US060952533001011,060952533001011,"Block 1011, Block Group 1, Census Tract 2533, Solano County, California",9,8,1
1000000US060952533001012,060952533001012,"Block 1012, Block Group 1, Census Tract 2533, Solano County, California",0,0,0
1000000US060952533001013,060952533001013,"Block 1013, Block Group 1, Census Tract 2533, Solano County, California",3,3,0
1000000US060952533001014,060952533001014,"Block 1014, Block Group 1, Census Tract 2533, Solano County, California",2,2,0
1000000US060952533001015,060952533001015,"Block 1015, Block Group 1, Census Tract 2533, Solano County, California",6,4,2
1000000US060952533001016,060952533001016,"Block 1016, Block Group 1, Census Tract 2533, Solano County, California",0,0,0
1000000US060952533001017,060952533001017,"Block 1017, Block Group 1, Census Tract 2533, Solano County, California",0,0,0
1000000US060952533001018,060952533001018,"Block 1018, Block Group 1, Census Tract 2533, Solano County, California",0,0,0
1000000US060952533001019,060952533001019,"Block 1019, Block Group 1, Census Tract 2533, Solano County, California",0,0,0
1000000US060952533001020,060952533001020,"Block 1020, Block Group 1, Census Tract 2533, Solano County, California",0,0,0
1000000US060952533001021,060952533001021,"Block 1021, Block Group 1, Census Tract 2533, Solano County, California",1,1,0
1000000US060952533001022,060952533001022,"Block 1022, Block Group 1, Census Tract 2533, Solano County, California",0,0,0
1000000US060952533001023,060952533001023,"Block 1023, Block Group 1, Census Tract 2533, Solano County, California",1,1,0
1000000US060952533001024,060952533001024,"Block 1024, Block Group 1, Census Tract 2533, Solano County, California",4,4,0
1000000US060952533001025,060952533001025,"Block 1025, Block Group 1, Census Tract 2533, Solano County, California",3,2,1
1000000US060952533001026,060952533001026,"Block 1026, Block Group 1, Census Tract 2533, Solano County, California",0,0,0
1000000US060952533001027,060952533001027,"Block 1027, Block Group 1, Census Tract 2533, Solano County, California",2,2,0
1000000US060952533001028,060952533001028,"Block 1028, Block Group 1, Census Tract 2533, Solano County, California",0,0,0
1000000US060952533001029,060952533001029,"Block 1029, Block Group 1, Census Tract 2533, Solano County, California",1,1,0
1000000US060952533001030,060952533001030,"Block 1030, Block Group 1, Census Tract 2533, Solano County, California",8,7,1
1000000US060952533001031,060952533001031,"Block 1031, Block Group 1, Census Tract 2533, Solano County, California",2,2,0
1000000US060952533001032,060952533001032,"Block 1032, Block Group 1, Census Tract 2533, Solano County, California",5,5,0
1000000US060952533001033,060952533001033,"Block 1033, Block Group 1, Census Tract 2533, Solano County, California",0,0,0
1000000US060952533001034,060952533001034,"Block 1034, Block Group 1, Census Tract 2533, Solano County, California",2,2,0
1000000US060952533001035,060952533001035,"Block 1035, Block Group 1, Census Tract 2533, Solano County, California",0,0,0
1000000US060952533001036,060952533001036,"Block 1036, Block Group 1, Census Tract 2533, Solano County, California",0,0,0
1000000US060952533001037,060952533001037,"Block 1037, Block Group 1, Census Tract 2533, Solano County, California",0,0,0
1000000US060952533001038,060952533001038,"Block 1038, Block Group 1, Census Tract 2533, Solano County, California",3,3,0
1000000US060952533001039,060952533001039,"Block 1039, Block Group 1, Census Tract 2533, Solano County, California",0,0,0
1000000US060952533001040,060952533001040,"Block 1040, Block Group 1, Census Tract 2533, Solano County, California",0,0,0
1000000US060952533001041,060952533001041,"Block 1041, Block Group 1, Census Tract 2533, Solano County, California",0,0,0
1000000US060952533001042,060952533001042,"Block 1042, Block Group 1, Census Tract 2533, Solano County, California",0,0,0
1000000US060952533001043,060952533001043,"Block 1043, Block Group 1, Census Tract 2533, Solano County, California",1,1,0
1000000US060952533001044,060952533001044,"Block 1044, Block Group 1, Census Tract 2533, Solano County, California",0,0,0
1000000US060952533001045,060952533001045,"Block 1045, Block Group 1, Census Tract 2533, Solano County, California",6,5,1
1000000US060952533001046,060952533001046,"Block 1046, Block Group 1, Census Tract 2533, Solano County, California",0,0,0
1000000US060952533001047,060952533001047,"Block 1047, Block Group 1, Census Tract 2533, Solano County, California",5,5,0
1000000US060952533001048,060952533001048,"Block 1048, Block Group 1, Census Tract 2533, Solano County, California",5,4,1
1000000US060952533001049,060952533001049,"Block 1049, Block Group 1, Census Tract 2533, Solano County, California",7,7,0
1000000US060952533001050,060952533001050,"Block 1050, Block Group 1, Census Tract 2533, Solano County, California",1,1,0
1000000US060952533001051,060952533001051,"Block 1051, Block Group 1, Census Tract 2533, Solano County, California",0,0,0
1000000US060952533001052,060952533001052,"Block 1052, Block Group 1, Census Tract 2533, Solano County, California",4,4,0
1000000US060952533001053,060952533001053,"Block 1053, Block Group 1, Census Tract 2533, Solano County, California",0,0,0
1000000US060952533001054,060952533001054,"Block 1054, Block Group 1, Census Tract 2533, Solano County, California",15,12,3
1000000US060952533001055,060952533001055,"Block 1055, Block Group 1, Census Tract 2533, Solano County, California",0,0,0
1000000US060952533001056,060952533001056,"Block 1056, Block Group 1, Census Tract 2533, Solano County, California",0,0,0
1000000US060952533001057,060952533001057,"Block 1057, Block Group 1, Census Tract 2533, Solano County, California",0,0,0
1000000US060952533001058,060952533001058,"Block 1058, Block Group 1, Census Tract 2533, Solano County, California",3,3,0
1000000US060952533001059,060952533001059,"Block 1059, Block Group 1, Census Tract 2533, Solano County, California",0,0,0
1000000US060952533001060,060952533001060,"Block 1060, Block Group 1, Census Tract 2533, Solano County, California",14,0,14
1000000US060952533001061,060952533001061,"Block 1061, Block Group 1, Census Tract 2533, Solano County, California",0,0,0
1000000US060952533001062,060952533001062,"Block 1062, Block Group 1, Census Tract 2533, Solano County, California",0,0,0
1000000US060952533001063,060952533001063,"Block 1063, Block Group 1, Census Tract 2533, Solano County, California",0,0,0
1000000US060952533001064,060952533001064,"Block 1064, Block Group 1, Census Tract 2533, Solano County, California",9,6,3
1000000US060952533001065,060952533001065,"Block 1065, Block Group 1, Census Tract 2533, Solano County, California",0,0,0
1000000US060952533001066,060952533001066,"Block 1066, Block Group 1, Census Tract 2533, Solano County, California",0,0,0
1000000US060952533001067,060952533001067,"Block 1067, Block Group 1, Census Tract 2533, Solano County, California",0,0,0
1000000US060952533001068,060952533001068,"Block 1068, Block Group 1, Census Tract 2533, Solano County, California",0,0,0
1000000US060952533001069,060952533001069,"Block 1069, Block Group 1, Census Tract 2533, Solano County, California",0,0,0
1000000US060952533001070,060952533001070,"Block 1070, Block Group 1, Census Tract 2533, Solano County, California",0,0,0
1000000US060952533001071,060952533001071,"Block 1071, Block Group 1, Census Tract 2533, Solano County, California",0,0,0
1000000US060952533001072,060952533001072,"Block 1072, Block Group 1, Census Tract 2533, Solano County, California",0,0,0
1000000US060952533001073,060952533001073,"Block 1073, Block Group 1, Census Tract 2533, Solano County, California",0,0,0
1000000US060952533001074,060952533001074,"Block 1074, Block Group 1, Census Tract 2533, Solano County, California",2,2,0
1000000US060952533001075,060952533001075,"Block 1075, Block Group 1, Census Tract 2533, Solano County, California",0,0,0
1000000US060952533001076,060952533001076,"Block 1076, Block Group 1, Census Tract 2533, Solano County, California",0,0,0
1000000US060952533001077,060952533001077,"Block 1077, Block Group 1, Census Tract 2533, Solano County, California",0,0,0
1000000US060952533001078,060952533001078,"Block 1078, Block Group 1, Census Tract 2533, Solano County, California",0,0,0
1000000US060952533001079,060952533001079,"Block 1079, Block Group 1, Census Tract 2533, Solano County, California",2,2,0
1000000US060952533001080,060952533001080,"Block 1080, Block Group 1, Census Tract 2533, Solano County, California",0,0,0
1000000US060952533001081,060952533001081,"Block 1081, Block Group 1, Census Tract 2533, Solano County, California",5,5,0
1000000US060952533001082,060952533001082,"Block 1082, Block Group 1, Census Tract 2533, Solano County, California",0,0,0
1000000US060952533001083,060952533001083,"Block 1083, Block Group 1, Census Tract 2533, Solano County, California",2,2,0
1000000US060952533001084,060952533001084,"Block 1084, Block Group 1, Census Tract 2533, Solano County, California",0,0,0
1000000US060952533001085,060952533001085,"Block 1085, Block Group 1, Census Tract 2533, Solano County, California",3,3,0
1000000US060952533001086,060952533001086,"Block 1086, Block Group 1, Census Tract 2533, Solano County, California",2,0,2
1000000US060952533001087,060952533001087,"Block 1087, Block Group 1, Census Tract 2533, Solano County, California",0,0,0
1000000US060952533001088,060952533001088,"Block 1088, Block Group 1, Census Tract 2533, Solano County, California",0,0,0
1000000US060952533001089,060952533001089,"Block 1089, Block Group 1, Census Tract 2533, Solano County, California",2,2,0
1000000US060952533001090,060952533001090,"Block 1090, Block Group 1, Census Tract 2533, Solano County, California",1,1,0
1000000US060952533001091,060952533001091,"Block 1091, Block Group 1, Census Tract 2533, Solano County, California",0,0,0
1000000US060952533001092,060952533001092,"Block 1092, Block Group 1, Census Tract 2533, Solano County, California",0,0,0
1000000US060952533001093,060952533001093,"Block 1093, Block Group 1, Census Tract 2533, Solano County, California",0,0,0
1000000US060952533001094,060952533001094,"Block 1094, Block Group 1, Census Tract 2533, Solano County, California",0,0,0
1000000US060952533001095,060952533001095,"Block 1095, Block Group 1, Census Tract 2533, Solano County, California",1,1,0
1000000US060952533001096,060952533001096,"Block 1096, Block Group 1, Census Tract 2533, Solano County, California",0,0,0
1000000US060952533001097,060952533001097,"Block 1097, Block Group 1, Census Tract 2533, Solano County, California",2,2,0
1000000US060952533001098,060952533001098,"Block 1098, Block Group 1, Census Tract 2533, Solano County, California",0,0,0
1000000US060952533001099,060952533001099,"Block 1099, Block Group 1, Census Tract 2533, Solano County, California",2,2,0
1000000US060952533001100,060952533001100,"Block 1100, Block Group 1, Census Tract 2533, Solano County, California",4,4,0
1000000US060952533001101,060952533001101,"Block 1101, Block Group 1, Census Tract 2533, Solano County, California",0,0,0
1000000US060952533001102,060952533001102,"Block 1102, Block Group 1, Census Tract 2533, Solano County, California",0,0,0
1000000US060952533001103,060952533001103,"Block 1103, Block Group 1, Census Tract 2533, Solano County, California",0,0,0
1000000US060952533001104,060952533001104,"Block 1104, Block Group 1, Census Tract 2533, Solano County, California",0,0,0
1000000US060952533001105,060952533001105,"Block 1105, Block Group 1, Census Tract 2533, Solano County, California",5,5,0
1000000US060952533001106,060952533001106,"Block 1106, Block Group 1, Census Tract 2533, Solano County, California",0,0,0
1000000US060952533001107,060952533001107,"Block 1107, Block Group 1, Census Tract 2533, Solano County, California",0,0,0
1000000US060952533001108,060952533001108,"Block 1108, Block Group 1, Census Tract 2533, Solano County, California",3,3,0
1000000US060952533001109,060952533001109,"Block 1109, Block Group 1, Census Tract 2533, Solano County, California",0,0,0
1000000US060952533001110,060952533001110,"Block 1110, Block Group 1, Census Tract 2533, Solano County, California",23,21,2
1000000US060952533001111,060952533001111,"Block 1111, Block Group 1, Census Tract 2533, Solano County, California",1,1,0
1000000US060952533001112,060952533001112,"Block 1112, Block Group 1, Census Tract 2533, Solano County, California",6,6,0
1000000US060952533001113,060952533001113,"Block 1113, Block Group 1, Census Tract 2533, Solano County, California",3,3,0
1000000US060952533001114,060952533001114,"Block 1114, Block Group 1, Census Tract 2533, Solano County, California",2,2,0
1000000US060952533001115,060952533001115,"Block 1115, Block Group 1, Census Tract 2533, Solano County, California",0,0,0
1000000US060952533001116,060952533001116,"Block 1116, Block Group 1, Census Tract 2533, Solano County, California",0,0,0
1000000US060952533001117,060952533001117,"Block 1117, Block Group 1, Census Tract 2533, Solano County, California",3,3,0
1000000US060952533001118,060952533001118,"Block 1118, Block Group 1, Census Tract 2533, Solano County, California",0,0,0
1000000US060952533001119,060952533001119,"Block 1119, Block Group 1, Census Tract 2533, Solano County, California",0,0,0
1000000US060952533001120,060952533001120,"Block 1120, Block Group 1, Census Tract 2533, Solano County, California",0,0,0
1000000US060952533001121,060952533001121,"Block 1121, Block Group 1, Census Tract 2533, Solano County, California",0,0,0
1000000US060952533001122,060952533001122,"Block 1122, Block Group 1, Census Tract 2533, Solano County, California",0,0,0
1000000US060952533001123,060952533001123,"Block 1123, Block Group 1, Census Tract 2533, Solano County, California",0,0,0
1000000US060952533001124,060952533001124,"Block 1124, Block Group 1, Census Tract 2533, Solano County, California",0,0,0
1000000US060952533001125,060952533001125,"Block 1125, Block Group 1, Census Tract 2533, Solano County, California",0,0,0
1000000US060952533001126,060952533001126,"Block 1126, Block Group 1, Census Tract 2533, Solano County, California",0,0,0
1000000US060952533001127,060952533001127,"Block 1127, Block Group 1, Census Tract 2533, Solano County, California",0,0,0
1000000US060952533001128,060952533001128,"Block 1128, Block Group 1, Census Tract 2533, Solano County, California",0,0,0
1000000US060952533001129,060952533001129,"Block 1129, Block Group 1, Census Tract 2533, Solano County, California",0,0,0
1000000US060952533001130,060952533001130,"Block 1130, Block Group 1, Census Tract 2533, Solano County, California",0,0,0
1000000US060952533001131,060952533001131,"Block 1131, Block Group 1, Census Tract 2533, Solano County, California",0,0,0
1000000US060952533001132,060952533001132,"Block 1132, Block Group 1, Census Tract 2533, Solano County, California",0,0,0
1000000US060952533001133,060952533001133,"Block 1133, Block Group 1, Census Tract 2533, Solano County, California",0,0,0
1000000US060952533001134,060952533001134,"Block 1134, Block Group 1, Census Tract 2533, Solano County, California",0,0,0
1000000US060952533001135,060952533001135,"Block 1135, Block Group 1, Census Tract 2533, Solano County, California",3,2,1
1000000US060952533001136,060952533001136,"Block 1136, Block Group 1, Census Tract 2533, Solano County, California",0,0,0
1000000US060952533001137,060952533001137,"Block 1137, Block Group 1, Census Tract 2533, Solano County, California",0,0,0
1000000US060952533001138,060952533001138,"Block 1138, Block Group 1, Census Tract 2533, Solano County, California",0,0,0
1000000US060952533001139,060952533001139,"Block 1139, Block Group 1, Census Tract 2533, Solano County, California",0,0,0
1000000US060952533001140,060952533001140,"Block 1140, Block Group 1, Census Tract 2533, Solano County, California",0,0,0
1000000US060952533001141,060952533001141,"Block 1141, Block Group 1, Census Tract 2533, Solano County, California",8,6,2
1000000US060952533001142,060952533001142,"Block 1142, Block Group 1, Census Tract 2533, Solano County, California",20,17,3
1000000US060952533001143,060952533001143,"Block 1143, Block Group 1, Census Tract 2533, Solano County, California",1,1,0
1000000US060952533001144,060952533001144,"Block 1144, Block Group 1, Census Tract 2533, Solano County, California",18,16,2
1000000US060952533001145,060952533001145,"Block 1145, Block Group 1, Census Tract 2533, Solano County, California",18,16,2
1000000US060952533001146,060952533001146,"Block 1146, Block Group 1, Census Tract 2533, Solano County, California",0,0,0
1000000US060952533001147,060952533001147,"Block 1147, Block Group 1, Census Tract 2533, Solano County, California",1,1,0
1000000US060952533001148,060952533001148,"Block 1148, Block Group 1, Census Tract 2533, Solano County, California",0,0,0
1000000US060952533001149,060952533001149,"Block 1149, Block Group 1, Census Tract 2533, Solano County, California",27,24,3
1000000US060952533001150,060952533001150,"Block 1150, Block Group 1, Census Tract 2533, Solano County, California",12,12,0
1000000US060952533001151,060952533001151,"Block 1151, Block Group 1, Census Tract 2533, Solano County, California",0,0,0
1000000US060952533001152,060952533001152,"Block 1152, Block Group 1, Census Tract 2533, Solano County, California",0,0,0
1000000US060952533001153,060952533001153,"Block 1153, Block Group 1, Census Tract 2533, Solano County, California",1,1,0
1000000US060952533001154,060952533001154,"Block 1154, Block Group 1, Census Tract 2533, Solano County, California",1,1,0
1000000US060952533001155,060952533001155,"Block 1155, Block Group 1, Census Tract 2533, Solano County, California",0,0,0
1000000US060952533001156,060952533001156,"Block 1156, Block Group 1, Census Tract 2533, Solano County, California",0,0,0
1000000US060952533001157,060952533001157,"Block 1157, Block Group 1, Census Tract 2533, Solano County, California",0,0,0
1000000US060952533001158,060952533001158,"Block 1158, Block Group 1, Census Tract 2533, Solano County, California",0,0,0
1000000US060952533001159,060952533001159,"Block 1159, Block Group 1, Census Tract 2533, Solano County, California",0,0,0
1000000US060952533001160,060952533001160,"Block 1160, Block Group 1, Census Tract 2533, Solano County, California",0,0,0
1000000US060952533001161,060952533001161,"Block 1161, Block Group 1, Census Tract 2533, Solano County, California",0,0,0
1000000US060952533001162,060952533001162,"Block 1162, Block Group 1, Census Tract 2533, Solano County, California",0,0,0
1000000US060952533001163,060952533001163,"Block 1163, Block Group 1, Census Tract 2533, Solano County, California",0,0,0
1000000US060952533001164,060952533001164,"Block 1164, Block Group 1, Census Tract 2533, Solano County, California",0,0,0
1000000US060952533001165,060952533001165,"Block 1165, Block Group 1, Census Tract 2533, Solano County, California",0,0,0
1000000US060952533001166,060952533001166,"Block 1166, Block Group 1, Census Tract 2533, Solano County, California",0,0,0
1000000US060952533001167,060952533001167,"Block 1167, Block Group 1, Census Tract 2533, Solano County, California",0,0,0
1000000US060952533001168,060952533001168,"Block 1168, Block Group 1, Census Tract 2533, Solano County, California",1,1,0
1000000US060952533001169,060952533001169,"Block 1169, Block Group 1, Census Tract 2533, Solano County, California",0,0,0
1000000US060952533001170,060952533001170,"Block 1170, Block Group 1, Census Tract 2533, Solano County, California",0,0,0
1000000US060952533001171,060952533001171,"Block 1171, Block Group 1, Census Tract 2533, Solano County, California",24,21,3
1000000US060952533001172,060952533001172,"Block 1172, Block Group 1, Census Tract 2533, Solano County, California",0,0,0
1000000US060952533001173,060952533001173,"Block 1173, Block Group 1, Census Tract 2533, Solano County, California",0,0,0
1000000US060952533001174,060952533001174,"Block 1174, Block Group 1, Census Tract 2533, Solano County, California",0,0,0
1000000US060952533001175,060952533001175,"Block 1175, Block Group 1, Census Tract 2533, Solano County, California",0,0,0
1000000US060952533001176,060952533001176,"Block 1176, Block Group 1, Census Tract 2533, Solano County, California",0,0,0
1000000US060952533001177,060952533001177,"Block 1177, Block Group 1, Census Tract 2533, Solano County, California",0,0,0
1000000US060952533001178,060952533001178,"Block 1178, Block Group 1, Census Tract 2533, Solano County, California",0,0,0
1000000US060952533001179,060952533001179,"Block 1179, Block Group 1, Census Tract 2533, Solano County, California",0,0,0
1000000US060952533001180,060952533001180,"Block 1180, Block Group 1, Census Tract 2533, Solano County, California",0,0,0
1000000US060952533001181,060952533001181,"Block 1181, Block Group 1, Census Tract 2533, Solano County, California",0,0,0
1000000US060952533001182,060952533001182,"Block 1182, Block Group 1, Census Tract 2533, Solano County, California",0,0,0
1000000US060952533001183,060952533001183,"Block 1183, Block Group 1, Census Tract 2533, Solano County, California",0,0,0
1000000US060952533001184,060952533001184,"Block 1184, Block Group 1, Census Tract 2533, Solano County, California",0,0,0
1000000US060952533001185,060952533001185,"Block 1185, Block Group 1, Census Tract 2533, Solano County, California",0,0,0
1000000US060952533001186,060952533001186,"Block 1186, Block Group 1, Census Tract 2533, Solano County, California",0,0,0
1000000US060952533001187,060952533001187,"Block 1187, Block Group 1, Census Tract 2533, Solano County, California",0,0,0
1000000US060952533001188,060952533001188,"Block 1188, Block Group 1, Census Tract 2533, Solano County, California",12,11,1
1000000US060952533001189,060952533001189,"Block 1189, Block Group 1, Census Tract 2533, Solano County, California",0,0,0
1000000US060952533001190,060952533001190,"Block 1190, Block Group 1, Census Tract 2533, Solano County, California",2,2,0
1000000US060952533001191,060952533001191,"Block 1191, Block Group 1, Census Tract 2533, Solano County, California",0,0,0
1000000US060952533001192,060952533001192,"Block 1192, Block Group 1, Census Tract 2533, Solano County, California",0,0,0
1000000US060952533001193,060952533001193,"Block 1193, Block Group 1, Census Tract 2533, Solano County, California",0,0,0
1000000US060952533001194,060952533001194,"Block 1194, Block Group 1, Census Tract 2533, Solano County, California",0,0,0
1000000US060952533001195,060952533001195,"Block 1195, Block Group 1, Census Tract 2533, Solano County, California",0,0,0
1000000US060952533001196,060952533001196,"Block 1196, Block Group 1, Census Tract 2533, Solano County, California",0,0,0
1000000US060952533001197,060952533001197,"Block 1197, Block Group 1, Census Tract 2533, Solano County, California",0,0,0
1000000US060952533001198,060952533001198,"Block 1198, Block Group 1, Census Tract 2533, Solano County, California",1,1,0
1000000US060952533001199,060952533001199,"Block 1199, Block Group 1, Census Tract 2533, Solano County, California",0,0,0
1000000US060952533001200,060952533001200,"Block 1200, Block Group 1, Census Tract 2533, Solano County, California",0,0,0
1000000US060952533001201,060952533001201,"Block 1201, Block Group 1, Census Tract 2533, Solano County, California",0,0,0
1000000US060952533001202,060952533001202,"Block 1202, Block Group 1, Census Tract 2533, Solano County, California",0,0,0
1000000US060952533001203,060952533001203,"Block 1203, Block Group 1, Census Tract 2533, Solano County, California",0,0,0
1000000US060952533001204,060952533001204,"Block 1204, Block Group 1, Census Tract 2533, Solano County, California",0,0,0
1000000US060952533001205,060952533001205,"Block 1205, Block Group 1, Census Tract 2533, Solano County, California",0,0,0
1000000US060952533001206,060952533001206,"Block 1206, Block Group 1, Census Tract 2533, Solano County, California",0,0,0
1000000US060952533001207,060952533001207,"Block 1207, Block Group 1, Census Tract 2533, Solano County, California",1,1,0
1000000US060952533001208,060952533001208,"Block 1208, Block Group 1, Census Tract 2533, Solano County, California",2,2,0
1000000US060952533001209,060952533001209,"Block 1209, Block Group 1, Census Tract 2533, Solano County, California",1,1,0
1000000US060952533001210,060952533001210,"Block 1210, Block Group 1, Census Tract 2533, Solano County, California",3,3,0
1000000US060952533001211,060952533001211,"Block 1211, Block Group 1, Census Tract 2533, Solano County, California",0,0,0
1000000US060952533001212,060952533001212,"Block 1212, Block Group 1, Census Tract 2533, Solano County, California",0,0,0
1000000US060952533001213,060952533001213,"Block 1213, Block Group 1, Census Tract 2533, Solano County, California",0,0,0
1000000US060952533001214,060952533001214,"Block 1214, Block Group 1, Census Tract 2533, Solano County, California",0,0,0
1000000US060952533001215,060952533001215,"Block 1215, Block Group 1, Census Tract 2533, Solano County, California",0,0,0
1000000US060952533001216,060952533001216,"Block 1216, Block Group 1, Census Tract 2533, Solano County, California",0,0,0
1000000US060952533001217,060952533001217,"Block 1217, Block Group 1, Census Tract 2533, Solano County, California",1,1,0
1000000US060952533001218,060952533001218,"Block 1218, Block Group 1, Census Tract 2533, Solano County, California",1,1,0
1000000US060952533001219,060952533001219,"Block 1219, Block Group 1, Census Tract 2533, Solano County, California",0,0,0
1000000US060952533001220,060952533001220,"Block 1220, Block Group 1, Census Tract 2533, Solano County, California",0,0,0
1000000US060952533001221,060952533001221,"Block 1221, Block Group 1, Census Tract 2533, Solano County, California",0,0,0
1000000US060952533001222,060952533001222,"Block 1222, Block Group 1, Census Tract 2533, Solano County, California",2,1,1
1000000US060952533001223,060952533001223,"Block 1223, Block Group 1, Census Tract 2533, Solano County, California",0,0,0
1000000US060952533001224,060952533001224,"Block 1224, Block Group 1, Census Tract 2533, Solano County, California",1,0,1
1000000US060952533001225,060952533001225,"Block 1225, Block Group 1, Census Tract 2533, Solano County, California",2,2,0
1000000US060952533001226,060952533001226,"Block 1226, Block Group 1, Census Tract 2533, Solano County, California",0,0,0
1000000US060952533001227,060952533001227,"Block 1227, Block Group 1, Census Tract 2533, Solano County, California",0,0,0
1000000US060952533001228,060952533001228,"Block 1228, Block Group 1, Census Tract 2533, Solano County, California",0,0,0
1000000US060952533001229,060952533001229,"Block 1229, Block Group 1, Census Tract 2533, Solano County, California",0,0,0
1000000US060952533001230,060952533001230,"Block 1230, Block Group 1, Census Tract 2533, Solano County, California",0,0,0
1000000US060952533001231,060952533001231,"Block 1231, Block Group 1, Census Tract 2533, Solano County, California",0,0,0
1000000US060952533001232,060952533001232,"Block 1232, Block Group 1, Census Tract 2533, Solano County, California",0,0,0
1000000US060952533001233,060952533001233,"Block 1233, Block Group 1, Census Tract 2533, Solano County, California",0,0,0
1000000US060952533001234,060952533001234,"Block 1234, Block Group 1, Census Tract 2533, Solano County, California",0,0,0
1000000US060952533001235,060952533001235,"Block 1235, Block Group 1, Census Tract 2533, Solano County, California",0,0,0
1000000US060952533001236,060952533001236,"Block 1236, Block Group 1, Census Tract 2533, Solano County, California",0,0,0
1000000US060952533001237,060952533001237,"Block 1237, Block Group 1, Census Tract 2533, Solano County, California",0,0,0
1000000US060952533001238,060952533001238,"Block 1238, Block Group 1, Census Tract 2533, Solano County, California",0,0,0
1000000US060952533001239,060952533001239,"Block 1239, Block Group 1, Census Tract 2533, Solano County, California",1,1,0
1000000US060952533001240,060952533001240,"Block 1240, Block Group 1, Census Tract 2533, Solano County, California",0,0,0
1000000US060952533001241,060952533001241,"Block 1241, Block Group 1, Census Tract 2533, Solano County, California",0,0,0
1000000US060952533001242,060952533001242,"Block 1242, Block Group 1, Census Tract 2533, Solano County, California",0,0,0
1000000US060952533001243,060952533001243,"Block 1243, Block Group 1, Census Tract 2533, Solano County, California",0,0,0
1000000US060952533001244,060952533001244,"Block 1244, Block Group 1, Census Tract 2533, Solano County, California",0,0,0
1000000US060952533001245,060952533001245,"Block 1245, Block Group 1, Census Tract 2533, Solano County, California",0,0,0
1000000US060952533001246,060952533001246,"Block 1246, Block Group 1, Census Tract 2533, Solano County, California",0,0,0
1000000US060952533001247,060952533001247,"Block 1247, Block Group 1, Census Tract 2533, Solano County, California",1,1,0
1000000US060952533001248,060952533001248,"Block 1248, Block Group 1, Census Tract 2533, Solano County, California",1,1,0
1000000US060952533001249,060952533001249,"Block 1249, Block Group 1, Census Tract 2533, Solano County, California",0,0,0
1000000US060952533001250,060952533001250,"Block 1250, Block Group 1, Census Tract 2533, Solano County, California",5,5,0
1000000US060952533001251,060952533001251,"Block 1251, Block Group 1, Census Tract 2533, Solano County, California",1,1,0
1000000US060952533001252,060952533001252,"Block 1252, Block Group 1, Census Tract 2533, Solano County, California",1,1,0
1000000US060952533001253,060952533001253,"Block 1253, Block Group 1, Census Tract 2533, Solano County, California",0,0,0
1000000US060952533001254,060952533001254,"Block 1254, Block Group 1, Census Tract 2533, Solano County, California",1,1,0
1000000US060952533001255,060952533001255,"Block 1255, Block Group 1, Census Tract 2533, Solano County, California",0,0,0
1000000US060952533001256,060952533001256,"Block 1256, Block Group 1, Census Tract 2533, Solano County, California",3,3,0
1000000US060952533001257,060952533001257,"Block 1257, Block Group 1, Census Tract 2533, Solano County, California",0,0,0
1000000US060952533001258,060952533001258,"Block 1258, Block Group 1, Census Tract 2533, Solano County, California",1,1,0
1000000US060952533001259,060952533001259,"Block 1259, Block Group 1, Census Tract 2533, Solano County, California",3,3,0
1000000US060952533001260,060952533001260,"Block 1260, Block Group 1, Census Tract 2533, Solano County, California",0,0,0
1000000US060952533001261,060952533001261,"Block 1261, Block Group 1, Census Tract 2533, Solano County, California",9,7,2
1000000US060952533001262,060952533001262,"Block 1262, Block Group 1, Census Tract 2533, Solano County, California",9,9,0
1000000US060952533001263,060952533001263,"Block 1263, Block Group 1, Census Tract 2533, Solano County, California",2,1,1
1000000US060952533001264,060952533001264,"Block 1264, Block Group 1, Census Tract 2533, Solano County, California",0,0,0
1000000US060952533001265,060952533001265,"Block 1265, Block Group 1, Census Tract 2533, Solano County, California",0,0,0
1000000US060952533001266,060952533001266,"Block 1266, Block Group 1, Census Tract 2533, Solano County, California",0,0,0
1000000US060952533001267,060952533001267,"Block 1267, Block Group 1, Census Tract 2533, Solano County, California",0,0,0
1000000US060952533001268,060952533001268,"Block 1268, Block Group 1, Census Tract 2533, Solano County, California",1,0,1
1000000US060952533001269,060952533001269,"Block 1269, Block Group 1, Census Tract 2533, Solano County, California",0,0,0
1000000US060952533001270,060952533001270,"Block 1270, Block Group 1, Census Tract 2533, Solano County, California",0,0,0
1000000US060952533001271,060952533001271,"Block 1271, Block Group 1, Census Tract 2533, Solano County, California",0,0,0
1000000US060952533001272,060952533001272,"Block 1272, Block Group 1, Census Tract 2533, Solano County, California",0,0,0
1000000US060952533001273,060952533001273,"Block 1273, Block Group 1, Census Tract 2533, Solano County, California",1,1,0
1000000US060952533001274,060952533001274,"Block 1274, Block Group 1, Census Tract 2533, Solano County, California",2,2,0
1000000US060952533001275,060952533001275,"Block 1275, Block Group 1, Census Tract 2533, Solano County, California",1,1,0
1000000US060952533001276,060952533001276,"Block 1276, Block Group 1, Census Tract 2533, Solano County, California",6,6,0
1000000US060952533001277,060952533001277,"Block 1277, Block Group 1, Census Tract 2533, Solano County, California",6,5,1
1000000US060952533001278,060952533001278,"Block 1278, Block Group 1, Census Tract 2533, Solano County, California",0,0,0
1000000US060952533001279,060952533001279,"Block 1279, Block Group 1, Census Tract 2533, Solano County, California",43,40,3
1000000US060952533001280,060952533001280,"Block 1280, Block Group 1, Census Tract 2533, Solano County, California",1,1,0
1000000US060952533001281,060952533001281,"Block 1281, Block Group 1, Census Tract 2533, Solano County, California",0,0,0
1000000US060952533001282,060952533001282,"Block 1282, Block Group 1, Census Tract 2533, Solano County, California",6,6,0
1000000US060952533001283,060952533001283,"Block 1283, Block Group 1, Census Tract 2533, Solano County, California",0,0,0
1000000US060952533001284,060952533001284,"Block 1284, Block Group 1, Census Tract 2533, Solano County, California",1,1,0
1000000US060952533001285,060952533001285,"Block 1285, Block Group 1, Census Tract 2533, Solano County, California",0,0,0
1000000US060952533001286,060952533001286,"Block 1286, Block Group 1, Census Tract 2533, Solano County, California",0,0,0
1000000US060952533001287,060952533001287,"Block 1287, Block Group 1, Census Tract 2533, Solano County, California",2,2,0
1000000US060952533001288,060952533001288,"Block 1288, Block Group 1, Census Tract 2533, Solano County, California",0,0,0
1000000US060952533001289,060952533001289,"Block 1289, Block Group 1, Census Tract 2533, Solano County, California",0,0,0
1000000US060952533001290,060952533001290,"Block 1290, Block Group 1, Census Tract 2533, Solano County, California",0,0,0
1000000US060952533001291,060952533001291,"Block 1291, Block Group 1, Census Tract 2533, Solano County, California",0,0,0
1000000US060952533001292,060952533001292,"Block 1292, Block Group 1, Census Tract 2533, Solano County, California",0,0,0
1000000US060952533001293,060952533001293,"Block 1293, Block Group 1, Census Tract 2533, Solano County, California",0,0,0
1000000US060952533001294,060952533001294,"Block 1294, Block Group 1, Census Tract 2533, Solano County, California",6,5,1
1000000US060952533001295,060952533001295,"Block 1295, Block Group 1, Census Tract 2533, Solano County, California",0,0,0
1000000US060952533001296,060952533001296,"Block 1296, Block Group 1, Census Tract 2533, Solano County, California",0,0,0
1000000US060952533001297,060952533001297,"Block 1297, Block Group 1, Census Tract 2533, Solano County, California",5,5,0
1000000US060952533001298,060952533001298,"Block 1298, Block Group 1, Census Tract 2533, Solano County, California",0,0,0
1000000US060952533001299,060952533001299,"Block 1299, Block Group 1, Census Tract 2533, Solano County, California",0,0,0
1000000US060952533001300,060952533001300,"Block 1300, Block Group 1, Census Tract 2533, Solano County, California",1,0,1
1000000US060952533001301,060952533001301,"Block 1301, Block Group 1, Census Tract 2533, Solano County, California",0,0,0
1000000US060952533001302,060952533001302,"Block 1302, Block Group 1, Census Tract 2533, Solano County, California",0,0,0
1000000US060952533001303,060952533001303,"Block 1303, Block Group 1, Census Tract 2533, Solano County, California",0,0,0
1000000US060952533001304,060952533001304,"Block 1304, Block Group 1, Census Tract 2533, Solano County, California",0,0,0
1000000US060952533001305,060952533001305,"Block 1305, Block Group 1, Census Tract 2533, Solano County, California",14,12,2
1000000US060952533001306,060952533001306,"Block 1306, Block Group 1, Census Tract 2533, Solano County, California",2,2,0
1000000US060952533001307,060952533001307,"Block 1307, Block Group 1, Census Tract 2533, Solano County, California",0,0,0
1000000US060952533001308,060952533001308,"Block 1308, Block Group 1, Census Tract 2533, Solano County, California",13,13,0
1000000US060952533001309,060952533001309,"Block 1309, Block Group 1, Census Tract 2533, Solano County, California",1,0,1
1000000US060952533001310,060952533001310,"Block 1310, Block Group 1, Census Tract 2533, Solano County, California",0,0,0
1000000US060952533001311,060952533001311,"Block 1311, Block Group 1, Census Tract 2533, Solano County, California",1,1,0
1000000US060952533001312,060952533001312,"Block 1312, Block Group 1, Census Tract 2533, Solano County, California",1,1,0
1000000US060952533001313,060952533001313,"Block 1313, Block Group 1, Census Tract 2533, Solano County, California",0,0,0
1000000US060952533001314,060952533001314,"Block 1314, Block Group 1, Census Tract 2533, Solano County, California",0,0,0
1000000US060952533001315,060952533001315,"Block 1315, Block Group 1, Census Tract 2533, Solano County, California",0,0,0
1000000US060952533001316,060952533001316,"Block 1316, Block Group 1, Census Tract 2533, Solano County, California",0,0,0
1000000US060952533001317,060952533001317,"Block 1317, Block Group 1, Census Tract 2533, Solano County, California",0,0,0
1000000US060952533001318,060952533001318,"Block 1318, Block Group 1, Census Tract 2533, Solano County, California",0,0,0
1000000US060952533001319,060952533001319,"Block 1319, Block Group 1, Census Tract 2533, Solano County, California",0,0,0
1000000US060952533001320,060952533001320,"Block 1320, Block Group 1, Census Tract 2533, Solano County, California",1,1,0
1000000US060952533001321,060952533001321,"Block 1321, Block Group 1, Census Tract 2533, Solano County, California",0,0,0
1000000US060952533001322,060952533001322,"Block 1322, Block Group 1, Census Tract 2533, Solano County, California",0,0,0
1000000US060952533001323,060952533001323,"Block 1323, Block Group 1, Census Tract 2533, Solano County, California",0,0,0
1000000US060952533001324,060952533001324,"Block 1324, Block Group 1, Census Tract 2533, Solano County, California",0,0,0
1000000US060952533001325,060952533001325,"Block 1325, Block Group 1, Census Tract 2533, Solano County, California",0,0,0
1000000US060952533001326,060952533001326,"Block 1326, Block Group 1, Census Tract 2533, Solano County, California",0,0,0
1000000US060952533001327,060952533001327,"Block 1327, Block Group 1, Census Tract 2533, Solano County, California",0,0,0
1000000US060952533001328,060952533001328,"Block 1328, Block Group 1, Census Tract 2533, Solano County, California",0,0,0
1000000US060952533001329,060952533001329,"Block 1329, Block Group 1, Census Tract 2533, Solano County, California",0,0,0
1000000US060952533001330,060952533001330,"Block 1330, Block Group 1, Census Tract 2533, Solano County, California",2,2,0
1000000US060952533001331,060952533001331,"Block 1331, Block Group 1, Census Tract 2533, Solano County, California",0,0,0
1000000US060952533001332,060952533001332,"Block 1332, Block Group 1, Census Tract 2533, Solano County, California",6,5,1
1000000US060952533001333,060952533001333,"Block 1333, Block Group 1, Census Tract 2533, Solano County, California",0,0,0
1000000US060952533001334,060952533001334,"Block 1334, Block Group 1, Census Tract 2533, Solano County, California",0,0,0
1000000US060952533001335,060952533001335,"Block 1335, Block Group 1, Census Tract 2533, Solano County, California",1,1,0
1000000US060952533001336,060952533001336,"Block 1336, Block Group 1, Census Tract 2533, Solano County, California",0,0,0
1000000US060952533001337,060952533001337,"Block 1337, Block Group 1, Census Tract 2533, Solano County, California",0,0,0
1000000US060952533001338,060952533001338,"Block 1338, Block Group 1, Census Tract 2533, Solano County, California",0,0,0
1000000US060952533001339,060952533001339,"Block 1339, Block Group 1, Census Tract 2533, Solano County, California",0,0,0
1000000US060952533001340,060952533001340,"Block 1340, Block Group 1, Census Tract 2533, Solano County, California",0,0,0
1000000US060952533001341,060952533001341,"Block 1341, Block Group 1, Census Tract 2533, Solano County, California",0,0,0
1000000US060952533001342,060952533001342,"Block 1342, Block Group 1, Census Tract 2533, Solano County, California",0,0,0
1000000US060952533001343,060952533001343,"Block 1343, Block Group 1, Census Tract 2533, Solano County, California",2,2,0
1000000US060952533001344,060952533001344,"Block 1344, Block Group 1, Census Tract 2533, Solano County, California",0,0,0
1000000US060952533001345,060952533001345,"Block 1345, Block Group 1, Census Tract 2533, Solano County, California",0,0,0
1000000US060952533001346,060952533001346,"Block 1346, Block Group 1, Census Tract 2533, Solano County, California",0,0,0
1000000US060952533001347,060952533001347,"Block 1347, Block Group 1, Census Tract 2533, Solano County, California",1,1,0
1000000US060952533001348,060952533001348,"Block 1348, Block Group 1, Census Tract 2533, Solano County, California",0,0,0
1000000US060952533001349,060952533001349,"Block 1349, Block Group 1, Census Tract 2533, Solano County, California",2,2,0
1000000US060952533001350,060952533001350,"Block 1350, Block Group 1, Census Tract 2533, Solano County, California",2,2,0
1000000US060952533001351,060952533001351,"Block 1351, Block Group 1, Census Tract 2533, Solano County, California",0,0,0
1000000US060952533001352,060952533001352,"Block 1352, Block Group 1, Census Tract 2533, Solano County, California",3,3,0
1000000US060952533001353,060952533001353,"Block 1353, Block Group 1, Census Tract 2533, Solano County, California",1,1,0
1000000US060952533001354,060952533001354,"Block 1354, Block Group 1, Census Tract 2533, Solano County, California",0,0,0
1000000US060952533001355,060952533001355,"Block 1355, Block Group 1, Census Tract 2533, Solano County, California",0,0,0
1000000US060952533001356,060952533001356,"Block 1356, Block Group 1, Census Tract 2533, Solano County, California",0,0,0
1000000US060952533001357,060952533001357,"Block 1357, Block Group 1, Census Tract 2533, Solano County, California",0,0,0
1000000US060952533001358,060952533001358,"Block 1358, Block Group 1, Census Tract 2533, Solano County, California",0,0,0
1000000US060952533001359,060952533001359,"Block 1359, Block Group 1, Census Tract 2533, Solano County, California",0,0,0
1000000US060952533001360,060952533001360,"Block 1360, Block Group 1, Census Tract 2533, Solano County, California",0,0,0
1000000US060952533001361,060952533001361,"Block 1361, Block Group 1, Census Tract 2533, Solano County, California",0,0,0
1000000US060952533001362,060952533001362,"Block 1362, Block Group 1, Census Tract 2533, Solano County, California",0,0,0
1000000US060952533001363,060952533001363,"Block 1363, Block Group 1, Census Tract 2533, Solano County, California",0,0,0
1000000US060952533001364,060952533001364,"Block 1364, Block Group 1, Census Tract 2533, Solano County, California",0,0,0
1000000US060952533001365,060952533001365,"Block 1365, Block Group 1, Census Tract 2533, Solano County, California",0,0,0
1000000US060952533001366,060952533001366,"Block 1366, Block Group 1, Census Tract 2533, Solano County, California",5,5,0
1000000US060952533001367,060952533001367,"Block 1367, Block Group 1, Census Tract 2533, Solano County, California",0,0,0
1000000US060952533001368,060952533001368,"Block 1368, Block Group 1, Census Tract 2533, Solano County, California",0,0,0
1000000US060952533001369,060952533001369,"Block 1369, Block Group 1, Census Tract 2533, Solano County, California",0,0,0
1000000US060952533001370,060952533001370,"Block 1370, Block Group 1, Census Tract 2533, Solano County, California",0,0,0
1000000US060952533001371,060952533001371,"Block 1371, Block Group 1, Census Tract 2533, Solano County, California",0,0,0
1000000US060952533001372,060952533001372,"Block 1372, Block Group 1, Census Tract 2533, Solano County, California",0,0,0
1000000US060952533001373,060952533001373,"Block 1373, Block Group 1, Census Tract 2533, Solano County, California",0,0,0
1000000US060952533001374,060952533001374,"Block 1374, Block Group 1, Census Tract 2533, Solano County, California",0,0,0
1000000US060952533001375,060952533001375,"Block 1375, Block Group 1, Census Tract 2533, Solano County, California",0,0,0
1000000US060952533001376,060952533001376,"Block 1376, Block Group 1, Census Tract 2533, Solano County, California",0,0,0
1000000US060952533001377,060952533001377,"Block 1377, Block Group 1, Census Tract 2533, Solano County, California",0,0,0
1000000US060952533001378,060952533001378,"Block 1378, Block Group 1, Census Tract 2533, Solano County, California",0,0,0
1000000US060952533001379,060952533001379,"Block 1379, Block Group 1, Census Tract 2533, Solano County, California",1,1,0
1000000US060952533001380,060952533001380,"Block 1380, Block Group 1, Census Tract 2533, Solano County, California",0,0,0
1000000US060952533001381,060952533001381,"Block 1381, Block Group 1, Census Tract 2533, Solano County, California",0,0,0
1000000US060952533001382,060952533001382,"Block 1382, Block Group 1, Census Tract 2533, Solano County, California",0,0,0
1000000US060952533001383,060952533001383,"Block 1383, Block Group 1, Census Tract 2533, Solano County, California",0,0,0
1000000US060952533001384,060952533001384,"Block 1384, Block Group 1, Census Tract 2533, Solano County, California",0,0,0
1000000US060952533001385,060952533001385,"Block 1385, Block Group 1, Census Tract 2533, Solano County, California",0,0,0
1000000US060952533001386,060952533001386,"Block 1386, Block Group 1, Census Tract 2533, Solano County, California",0,0,0
1000000US060952533001387,060952533001387,"Block 1387, Block Group 1, Census Tract 2533, Solano County, California",0,0,0
1000000US060952533001388,060952533001388,"Block 1388, Block Group 1, Census Tract 2533, Solano County, California",0,0,0
1000000US060952533001389,060952533001389,"Block 1389, Block Group 1, Census Tract 2533, Solano County, California",0,0,0
1000000US060952533001390,060952533001390,"Block 1390, Block Group 1, Census Tract 2533, Solano County, California",0,0,0
1000000US060952533001391,060952533001391,"Block 1391, Block Group 1, Census Tract 2533, Solano County, California",0,0,0
1000000US060952533001392,060952533001392,"Block 1392, Block Group 1, Census Tract 2533, Solano County, California",0,0,0
1000000US060952533001393,060952533001393,"Block 1393, Block Group 1, Census Tract 2533, Solano County, California",0,0,0
1000000US060952533001394,060952533001394,"Block 1394, Block Group 1, Census Tract 2533, Solano County, California",0,0,0
1000000US060952533001395,060952533001395,"Block 1395, Block Group 1, Census Tract 2533, Solano County, California",0,0,0
1000000US060952533001396,060952533001396,"Block 1396, Block Group 1, Census Tract 2533, Solano County, California",0,0,0
1000000US060952533001397,060952533001397,"Block 1397, Block Group 1, Census Tract 2533, Solano County, California",1,1,0
1000000US060952533001398,060952533001398,"Block 1398, Block Group 1, Census Tract 2533, Solano County, California",0,0,0
1000000US060952533001399,060952533001399,"Block 1399, Block Group 1, Census Tract 2533, Solano County, California",0,0,0
1000000US060952533001400,060952533001400,"Block 1400, Block Group 1, Census Tract 2533, Solano County, California",0,0,0
1000000US060952533001401,060952533001401,"Block 1401, Block Group 1, Census Tract 2533, Solano County, California",0,0,0
1000000US060952533001402,060952533001402,"Block 1402, Block Group 1, Census Tract 2533, Solano County, California",0,0,0
1000000US060952533001403,060952533001403,"Block 1403, Block Group 1, Census Tract 2533, Solano County, California",0,0,0
1000000US060952533001404,060952533001404,"Block 1404, Block Group 1, Census Tract 2533, Solano County, California",1,0,1
1000000US060952533001405,060952533001405,"Block 1405, Block Group 1, Census Tract 2533, Solano County, California",0,0,0
1000000US060952533001406,060952533001406,"Block 1406, Block Group 1, Census Tract 2533, Solano County, California",0,0,0
1000000US060952533001407,060952533001407,"Block 1407, Block Group 1, Census Tract 2533, Solano County, California",0,0,0
1000000US060952533001408,060952533001408,"Block 1408, Block Group 1, Census Tract 2533, Solano County, California",0,0,0
1000000US060952533001409,060952533001409,"Block 1409, Block Group 1, Census Tract 2533, Solano County, California",0,0,0
1000000US060952533001410,060952533001410,"Block 1410, Block Group 1, Census Tract 2533, Solano County, California",0,0,0
1000000US060952533001411,060952533001411,"Block 1411, Block Group 1, Census Tract 2533, Solano County, California",0,0,0
1000000US060952533001412,060952533001412,"Block 1412, Block Group 1, Census Tract 2533, Solano County, California",1,0,1
1000000US060952533001413,060952533001413,"Block 1413, Block Group 1, Census Tract 2533, Solano County, California",0,0,0
1000000US060952533001414,060952533001414,"Block 1414, Block Group 1, Census Tract 2533, Solano County, California",0,0,0
1000000US060952533001415,060952533001415,"Block 1415, Block Group 1, Census Tract 2533, Solano County, California",0,0,0
1000000US060952533001416,060952533001416,"Block 1416, Block Group 1, Census Tract 2533, Solano County, California",0,0,0
1000000US060952533001417,060952533001417,"Block 1417, Block Group 1, Census Tract 2533, Solano County, California",0,0,0
1000000US060952533001418,060952533001418,"Block 1418, Block Group 1, Census Tract 2533, Solano County, California",0,0,0
1000000US060952533001419,060952533001419,"Block 1419, Block Group 1, Census Tract 2533, Solano County, California",0,0,0
1000000US060952533001420,060952533001420,"Block 1420, Block Group 1, Census Tract 2533, Solano County, California",0,0,0
1000000US060952533001421,060952533001421,"Block 1421, Block Group 1, Census Tract 2533, Solano County, California",0,0,0
1000000US060952533001422,060952533001422,"Block 1422, Block Group 1, Census Tract 2533, Solano County, California",0,0,0
1000000US060952533001423,060952533001423,"Block 1423, Block Group 1, Census Tract 2533, Solano County, California",0,0,0
1000000US060952533001424,060952533001424,"Block 1424, Block Group 1, Census Tract 2533, Solano County, California",0,0,0
1000000US060952533001425,060952533001425,"Block 1425, Block Group 1, Census Tract 2533, Solano County, California",0,0,0
1000000US060952533001426,060952533001426,"Block 1426, Block Group 1, Census Tract 2533, Solano County, California",0,0,0
1000000US060952533001427,060952533001427,"Block 1427, Block Group 1, Census Tract 2533, Solano County, California",0,0,0
1000000US060952533001428,060952533001428,"Block 1428, Block Group 1, Census Tract 2533, Solano County, California",0,0,0
1000000US060952533001429,060952533001429,"Block 1429, Block Group 1, Census Tract 2533, Solano County, California",0,0,0
1000000US060952533001430,060952533001430,"Block 1430, Block Group 1, Census Tract 2533, Solano County, California",0,0,0
1000000US060952533001431,060952533001431,"Block 1431, Block Group 1, Census Tract 2533, Solano County, California",1,1,0
1000000US060952533001432,060952533001432,"Block 1432, Block Group 1, Census Tract 2533, Solano County, California",0,0,0
1000000US060952533001433,060952533001433,"Block 1433, Block Group 1, Census Tract 2533, Solano County, California",4,4,0
1000000US060952533001434,060952533001434,"Block 1434, Block Group 1, Census Tract 2533, Solano County, California",0,0,0
1000000US060952533001435,060952533001435,"Block 1435, Block Group 1, Census Tract 2533, Solano County, California",2,2,0
1000000US060952533001436,060952533001436,"Block 1436, Block Group 1, Census Tract 2533, Solano County, California",28,28,0
1000000US060952533001437,060952533001437,"Block 1437, Block Group 1, Census Tract 2533, Solano County, California",0,0,0
1000000US060952533001438,060952533001438,"Block 1438, Block Group 1, Census Tract 2533, Solano County, California",0,0,0
1000000US060952533001439,060952533001439,"Block 1439, Block Group 1, Census Tract 2533, Solano County, California",0,0,0
1000000US060952533001440,060952533001440,"Block 1440, Block Group 1, Census Tract 2533, Solano County, California",0,0,0
1000000US060952533001441,060952533001441,"Block 1441, Block Group 1, Census Tract 2533, Solano County, California",2,2,0
1000000US060952533001442,060952533001442,"Block 1442, Block Group 1, Census Tract 2533, Solano County, California",0,0,0
1000000US060952533001443,060952533001443,"Block 1443, Block Group 1, Census Tract 2533, Solano County, California",0,0,0
1000000US060952533001444,060952533001444,"Block 1444, Block Group 1, Census Tract 2533, Solano County, California",0,0,0
1000000US060952533001445,060952533001445,"Block 1445, Block Group 1, Census Tract 2533, Solano County, California",0,0,0
1000000US060952533001446,060952533001446,"Block 1446, Block Group 1, Census Tract 2533, Solano County, California",0,0,0
1000000US060952533001447,060952533001447,"Block 1447, Block Group 1, Census Tract 2533, Solano County, California",2,2,0
1000000US060952533001448,060952533001448,"Block 1448, Block Group 1, Census Tract 2533, Solano County, California",0,0,0
1000000US060952533002000,060952533002000,"Block 2000, Block Group 2, Census Tract 2533, Solano County, California",6,4,2
1000000US060952533002001,060952533002001,"Block 2001, Block Group 2, Census Tract 2533, Solano County, California",0,0,0
1000000US060952533002002,060952533002002,"Block 2002, Block Group 2, Census Tract 2533, Solano County, California",5,4,1
1000000US060952533002003,060952533002003,"Block 2003, Block Group 2, Census Tract 2533, Solano County, California",0,0,0
1000000US060952533002004,060952533002004,"Block 2004, Block Group 2, Census Tract 2533, Solano County, California",0,0,0
1000000US060952533002005,060952533002005,"Block 2005, Block Group 2, Census Tract 2533, Solano County, California",0,0,0
1000000US060952533002006,060952533002006,"Block 2006, Block Group 2, Census Tract 2533, Solano County, California",0,0,0
1000000US060952533002007,060952533002007,"Block 2007, Block Group 2, Census Tract 2533, Solano County, California",0,0,0
1000000US060952533002008,060952533002008,"Block 2008, Block Group 2, Census Tract 2533, Solano County, California",4,3,1
1000000US060952533002009,060952533002009,"Block 2009, Block Group 2, Census Tract 2533, Solano County, California",6,4,2
1000000US060952533002010,060952533002010,"Block 2010, Block Group 2, Census Tract 2533, Solano County, California",0,0,0
1000000US060952533002011,060952533002011,"Block 2011, Block Group 2, Census Tract 2533, Solano County, California",0,0,0
1000000US060952533002012,060952533002012,"Block 2012, Block Group 2, Census Tract 2533, Solano County, California",0,0,0
1000000US060952533002013,060952533002013,"Block 2013, Block Group 2, Census Tract 2533, Solano County, California",0,0,0
1000000US060952533002014,060952533002014,"Block 2014, Block Group 2, Census Tract 2533, Solano County, California",1,1,0
1000000US060952533002015,060952533002015,"Block 2015, Block Group 2, Census Tract 2533, Solano County, California",0,0,0
1000000US060952533002016,060952533002016,"Block 2016, Block Group 2, Census Tract 2533, Solano County, California",0,0,0
1000000US060952533002017,060952533002017,"Block 2017, Block Group 2, Census Tract 2533, Solano County, California",0,0,0
1000000US060952533002018,060952533002018,"Block 2018, Block Group 2, Census Tract 2533, Solano County, California",0,0,0
1000000US060952533002019,060952533002019,"Block 2019, Block Group 2, Census Tract 2533, Solano County, California",0,0,0
1000000US060952533002020,060952533002020,"Block 2020, Block Group 2, Census Tract 2533, Solano County, California",1,1,0
1000000US060952533002021,060952533002021,"Block 2021, Block Group 2, Census Tract 2533, Solano County, California",0,0,0
1000000US060952533002022,060952533002022,"Block 2022, Block Group 2, Census Tract 2533, Solano County, California",0,0,0
1000000US060952533002023,060952533002023,"Block 2023, Block Group 2, Census Tract 2533, Solano County, California",0,0,0
1000000US060952533002024,060952533002024,"Block 2024, Block Group 2, Census Tract 2533, Solano County, California",0,0,0
1000000US060952533002025,060952533002025,"Block 2025, Block Group 2, Census Tract 2533, Solano County, California",0,0,0
1000000US060952533002026,060952533002026,"Block 2026, Block Group 2, Census Tract 2533, Solano County, California",0,0,0
1000000US060952533002027,060952533002027,"Block 2027, Block Group 2, Census Tract 2533, Solano County, California",0,0,0
1000000US060952533002028,060952533002028,"Block 2028, Block Group 2, Census Tract 2533, Solano County, California",0,0,0
1000000US060952533002029,060952533002029,"Block 2029, Block Group 2, Census Tract 2533, Solano County, California",0,0,0
1000000US060952533002030,060952533002030,"Block 2030, Block Group 2, Census Tract 2533, Solano County, California",0,0,0
1000000US060952533002031,060952533002031,"Block 2031, Block Group 2, Census Tract 2533, Solano County, California",0,0,0
1000000US060952533002032,060952533002032,"Block 2032, Block Group 2, Census Tract 2533, Solano County, California",0,0,0
1000000US060952533002033,060952533002033,"Block 2033, Block Group 2, Census Tract 2533, Solano County, California",0,0,0
1000000US060952533002034,060952533002034,"Block 2034, Block Group 2, Census Tract 2533, Solano County, California",0,0,0
1000000US060952533002035,060952533002035,"Block 2035, Block Group 2, Census Tract 2533, Solano County, California",0,0,0
1000000US060952533002036,060952533002036,"Block 2036, Block Group 2, Census Tract 2533, Solano County, California",0,0,0
1000000US060952533002037,060952533002037,"Block 2037, Block Group 2, Census Tract 2533, Solano County, California",0,0,0
1000000US060952533002038,060952533002038,"Block 2038, Block Group 2, Census Tract 2533, Solano County, California",0,0,0
1000000US060952533002039,060952533002039,"Block 2039, Block Group 2, Census Tract 2533, Solano County, California",0,0,0
1000000US060952533002040,060952533002040,"Block 2040, Block Group 2, Census Tract 2533, Solano County, California",0,0,0
1000000US060952533002041,060952533002041,"Block 2041, Block Group 2, Census Tract 2533, Solano County, California",0,0,0
1000000US060952533002042,060952533002042,"Block 2042, Block Group 2, Census Tract 2533, Solano County, California",0,0,0
1000000US060952533002043,060952533002043,"Block 2043, Block Group 2, Census Tract 2533, Solano County, California",1,1,0
1000000US060952533002044,060952533002044,"Block 2044, Block Group 2, Census Tract 2533, Solano County, California",0,0,0
1000000US060952533002045,060952533002045,"Block 2045, Block Group 2, Census Tract 2533, Solano County, California",0,0,0
1000000US060952533002046,060952533002046,"Block 2046, Block Group 2, Census Tract 2533, Solano County, California",2,2,0
1000000US060952533002047,060952533002047,"Block 2047, Block Group 2, Census Tract 2533, Solano County, California",0,0,0
1000000US060952533002048,060952533002048,"Block 2048, Block Group 2, Census Tract 2533, Solano County, California",2,2,0
1000000US060952533002049,060952533002049,"Block 2049, Block Group 2, Census Tract 2533, Solano County, California",11,11,0
1000000US060952533002050,060952533002050,"Block 2050, Block Group 2, Census Tract 2533, Solano County, California",2,1,1
1000000US060952533002051,060952533002051,"Block 2051, Block Group 2, Census Tract 2533, Solano County, California",9,7,2
1000000US060952533002052,060952533002052,"Block 2052, Block Group 2, Census Tract 2533, Solano County, California",0,0,0
1000000US060952533002053,060952533002053,"Block 2053, Block Group 2, Census Tract 2533, Solano County, California",2,2,0
1000000US060952533002054,060952533002054,"Block 2054, Block Group 2, Census Tract 2533, Solano County, California",0,0,0
1000000US060952533002055,060952533002055,"Block 2055, Block Group 2, Census Tract 2533, Solano County, California",3,3,0
1000000US060952533002056,060952533002056,"Block 2056, Block Group 2, Census Tract 2533, Solano County, California",2,2,0
1000000US060952533002057,060952533002057,"Block 2057, Block Group 2, Census Tract 2533, Solano County, California",1,1,0
1000000US060952533002058,060952533002058,"Block 2058, Block Group 2, Census Tract 2533, Solano County, California",2,1,1
1000000US060952533002059,060952533002059,"Block 2059, Block Group 2, Census Tract 2533, Solano County, California",3,3,0
1000000US060952533002060,060952533002060,"Block 2060, Block Group 2, Census Tract 2533, Solano County, California",3,3,0
1000000US060952533002061,060952533002061,"Block 2061, Block Group 2, Census Tract 2533, Solano County, California",0,0,0
1000000US060952533002062,060952533002062,"Block 2062, Block Group 2, Census Tract 2533, Solano County, California",14,13,1
1000000US060952533002063,060952533002063,"Block 2063, Block Group 2, Census Tract 2533, Solano County, California",3,3,0
1000000US060952533002064,060952533002064,"Block 2064, Block Group 2, Census Tract 2533, Solano County, California",1,1,0
1000000US060952533002065,060952533002065,"Block 2065, Block Group 2, Census Tract 2533, Solano County, California",1,1,0
1000000US060952533002066,060952533002066,"Block 2066, Block Group 2, Census Tract 2533, Solano County, California",0,0,0
1000000US060952533002067,060952533002067,"Block 2067, Block Group 2, Census Tract 2533, Solano County, California",0,0,0
1000000US060952533002068,060952533002068,"Block 2068, Block Group 2, Census Tract 2533, Solano County, California",0,0,0
1000000US060952533002069,060952533002069,"Block 2069, Block Group 2, Census Tract 2533, Solano County, California",4,4,0
1000000US060952533002070,060952533002070,"Block 2070, Block Group 2, Census Tract 2533, Solano County, California",0,0,0
1000000US060952533002071,060952533002071,"Block 2071, Block Group 2, Census Tract 2533, Solano County, California",0,0,0
1000000US060952533002072,060952533002072,"Block 2072, Block Group 2, Census Tract 2533, Solano County, California",1,1,0
1000000US060952533002073,060952533002073,"Block 2073, Block Group 2, Census Tract 2533, Solano County, California",0,0,0
1000000US060952533002074,060952533002074,"Block 2074, Block Group 2, Census Tract 2533, Solano County, California",0,0,0
1000000US060952533002075,060952533002075,"Block 2075, Block Group 2, Census Tract 2533, Solano County, California",1,0,1
1000000US060952533002076,060952533002076,"Block 2076, Block Group 2, Census Tract 2533, Solano County, California",0,0,0
1000000US060952533002077,060952533002077,"Block 2077, Block Group 2, Census Tract 2533, Solano County, California",0,0,0
1000000US060952533002078,060952533002078,"Block 2078, Block Group 2, Census Tract 2533, Solano County, California",0,0,0
1000000US060952533002079,060952533002079,"Block 2079, Block Group 2, Census Tract 2533, Solano County, California",0,0,0
1000000US060952533002080,060952533002080,"Block 2080, Block Group 2, Census Tract 2533, Solano County, California",0,0,0
1000000US060952533002081,060952533002081,"Block 2081, Block Group 2, Census Tract 2533, Solano County, California",0,0,0
1000000US060952533002082,060952533002082,"Block 2082, Block Group 2, Census Tract 2533, Solano County, California",0,0,0
1000000US060952533002083,060952533002083,"Block 2083, Block Group 2, Census Tract 2533, Solano County, California",0,0,0
1000000US060952533002084,060952533002084,"Block 2084, Block Group 2, Census Tract 2533, Solano County, California",2,2,0
1000000US060952533002085,060952533002085,"Block 2085, Block Group 2, Census Tract 2533, Solano County, California",2,2,0
1000000US060952533002086,060952533002086,"Block 2086, Block Group 2, Census Tract 2533, Solano County, California",0,0,0
1000000US060952533002087,060952533002087,"Block 2087, Block Group 2, Census Tract 2533, Solano County, California",0,0,0
1000000US060952533002088,060952533002088,"Block 2088, Block Group 2, Census Tract 2533, Solano County, California",0,0,0
1000000US060952533002089,060952533002089,"Block 2089, Block Group 2, Census Tract 2533, Solano County, California",0,0,0
1000000US060952533002090,060952533002090,"Block 2090, Block Group 2, Census Tract 2533, Solano County, California",0,0,0
1000000US060952533002091,060952533002091,"Block 2091, Block Group 2, Census Tract 2533, Solano County, California",0,0,0
1000000US060952533002092,060952533002092,"Block 2092, Block Group 2, Census Tract 2533, Solano County, California",3,3,0
1000000US060952533002093,060952533002093,"Block 2093, Block Group 2, Census Tract 2533, Solano County, California",0,0,0
1000000US060952533002094,060952533002094,"Block 2094, Block Group 2, Census Tract 2533, Solano County, California",0,0,0
1000000US060952533002095,060952533002095,"Block 2095, Block Group 2, Census Tract 2533, Solano County, California",0,0,0
1000000US060952533002096,060952533002096,"Block 2096, Block Group 2, Census Tract 2533, Solano County, California",0,0,0
1000000US060952533002097,060952533002097,"Block 2097, Block Group 2, Census Tract 2533, Solano County, California",0,0,0
1000000US060952533002098,060952533002098,"Block 2098, Block Group 2, Census Tract 2533, Solano County, California",0,0,0
1000000US060952533002099,060952533002099,"Block 2099, Block Group 2, Census Tract 2533, Solano County, California",0,0,0
1000000US060952533002100,060952533002100,"Block 2100, Block Group 2, Census Tract 2533, Solano County, California",1,1,0
1000000US060952533002101,060952533002101,"Block 2101, Block Group 2, Census Tract 2533, Solano County, California",0,0,0
1000000US060952533002102,060952533002102,"Block 2102, Block Group 2, Census Tract 2533, Solano County, California",0,0,0
1000000US060952533002103,060952533002103,"Block 2103, Block Group 2, Census Tract 2533, Solano County, California",0,0,0
1000000US060952533002104,060952533002104,"Block 2104, Block Group 2, Census Tract 2533, Solano County, California",0,0,0
1000000US060952533002105,060952533002105,"Block 2105, Block Group 2, Census Tract 2533, Solano County, California",1,0,1
1000000US060952533002106,060952533002106,"Block 2106, Block Group 2, Census Tract 2533, Solano County, California",4,4,0
1000000US060952533002107,060952533002107,"Block 2107, Block Group 2, Census Tract 2533, Solano County, California",0,0,0
1000000US060952533002108,060952533002108,"Block 2108, Block Group 2, Census Tract 2533, Solano County, California",0,0,0
1000000US060952533002109,060952533002109,"Block 2109, Block Group 2, Census Tract 2533, Solano County, California",0,0,0
1000000US060952533002110,060952533002110,"Block 2110, Block Group 2, Census Tract 2533, Solano County, California",1,1,0
1000000US060952533002111,060952533002111,"Block 2111, Block Group 2, Census Tract 2533, Solano County, California",0,0,0
1000000US060952533002112,060952533002112,"Block 2112, Block Group 2, Census Tract 2533, Solano County, California",4,3,1
1000000US060952533002113,060952533002113,"Block 2113, Block Group 2, Census Tract 2533, Solano County, California",1,1,0
1000000US060952533002114,060952533002114,"Block 2114, Block Group 2, Census Tract 2533, Solano County, California",0,0,0
1000000US060952533002115,060952533002115,"Block 2115, Block Group 2, Census Tract 2533, Solano County, California",0,0,0
1000000US060952533002116,060952533002116,"Block 2116, Block Group 2, Census Tract 2533, Solano County, California",0,0,0
1000000US060952533002117,060952533002117,"Block 2117, Block Group 2, Census Tract 2533, Solano County, California",0,0,0
1000000US060952533002118,060952533002118,"Block 2118, Block Group 2, Census Tract 2533, Solano County, California",2,2,0
1000000US060952533002119,060952533002119,"Block 2119, Block Group 2, Census Tract 2533, Solano County, California",16,16,0
1000000US060952533002120,060952533002120,"Block 2120, Block Group 2, Census Tract 2533, Solano County, California",0,0,0
1000000US060952533002121,060952533002121,"Block 2121, Block Group 2, Census Tract 2533, Solano County, California",0,0,0
1000000US060952533002122,060952533002122,"Block 2122, Block Group 2, Census Tract 2533, Solano County, California",0,0,0
1000000US060952533002123,060952533002123,"Block 2123, Block Group 2, Census Tract 2533, Solano County, California",3,3,0
1000000US060952533002124,060952533002124,"Block 2124, Block Group 2, Census Tract 2533, Solano County, California",3,3,0
1000000US060952533002125,060952533002125,"Block 2125, Block Group 2, Census Tract 2533, Solano County, California",3,3,0
1000000US060952533002126,060952533002126,"Block 2126, Block Group 2, Census Tract 2533, Solano County, California",0,0,0
1000000US060952533002127,060952533002127,"Block 2127, Block Group 2, Census Tract 2533, Solano County, California",0,0,0
1000000US060952533002128,060952533002128,"Block 2128, Block Group 2, Census Tract 2533, Solano County, California",0,0,0
1000000US060952533002129,060952533002129,"Block 2129, Block Group 2, Census Tract 2533, Solano County, California",0,0,0
1000000US060952533002130,060952533002130,"Block 2130, Block Group 2, Census Tract 2533, Solano County, California",0,0,0
1000000US060952533002131,060952533002131,"Block 2131, Block Group 2, Census Tract 2533, Solano County, California",1,1,0
1000000US060952533002132,060952533002132,"Block 2132, Block Group 2, Census Tract 2533, Solano County, California",1,1,0
1000000US060952533002133,060952533002133,"Block 2133, Block Group 2, Census Tract 2533, Solano County, California",1,0,1
1000000US060952533002134,060952533002134,"Block 2134, Block Group 2, Census Tract 2533, Solano County, California",0,0,0
1000000US060952533002135,060952533002135,"Block 2135, Block Group 2, Census Tract 2533, Solano County, California",0,0,0
1000000US060952533002136,060952533002136,"Block 2136, Block Group 2, Census Tract 2533, Solano County, California",1,1,0
1000000US060952533002137,060952533002137,"Block 2137, Block Group 2, Census Tract 2533, Solano County, California",0,0,0
1000000US060952533002138,060952533002138,"Block 2138, Block Group 2, Census Tract 2533, Solano County, California",0,0,0
1000000US060952533002139,060952533002139,"Block 2139, Block Group 2, Census Tract 2533, Solano County, California",1,1,0
1000000US060952533002140,060952533002140,"Block 2140, Block Group 2, Census Tract 2533, Solano County, California",0,0,0
1000000US060952533002141,060952533002141,"Block 2141, Block Group 2, Census Tract 2533, Solano County, California",2,2,0
1000000US060952533002142,060952533002142,"Block 2142, Block Group 2, Census Tract 2533, Solano County, California",0,0,0
1000000US060952533002143,060952533002143,"Block 2143, Block Group 2, Census Tract 2533, Solano County, California",1,0,1
1000000US060952533002144,060952533002144,"Block 2144, Block Group 2, Census Tract 2533, Solano County, California",0,0,0
1000000US060952533002145,060952533002145,"Block 2145, Block Group 2, Census Tract 2533, Solano County, California",1,1,0
1000000US060952533002146,060952533002146,"Block 2146, Block Group 2, Census Tract 2533, Solano County, California",0,0,0
1000000US060952533002147,060952533002147,"Block 2147, Block Group 2, Census Tract 2533, Solano County, California",0,0,0
1000000US060952533002148,060952533002148,"Block 2148, Block Group 2, Census Tract 2533, Solano County, California",0,0,0
1000000US060952533002149,060952533002149,"Block 2149, Block Group 2, Census Tract 2533, Solano County, California",0,0,0
1000000US060952533002150,060952533002150,"Block 2150, Block Group 2, Census Tract 2533, Solano County, California",0,0,0
1000000US060952533002151,060952533002151,"Block 2151, Block Group 2, Census Tract 2533, Solano County, California",2,2,0
1000000US060952533002152,060952533002152,"Block 2152, Block Group 2, Census Tract 2533, Solano County, California",0,0,0
1000000US060952533002153,060952533002153,"Block 2153, Block Group 2, Census Tract 2533, Solano County, California",2,2,0
1000000US060952533002154,060952533002154,"Block 2154, Block Group 2, Census Tract 2533, Solano County, California",0,0,0
1000000US060952533002155,060952533002155,"Block 2155, Block Group 2, Census Tract 2533, Solano County, California",0,0,0
1000000US060952533002156,060952533002156,"Block 2156, Block Group 2, Census Tract 2533, Solano County, California",0,0,0
1000000US060952533002157,060952533002157,"Block 2157, Block Group 2, Census Tract 2533, Solano County, California",0,0,0
1000000US060952533002158,060952533002158,"Block 2158, Block Group 2, Census Tract 2533, Solano County, California",0,0,0
1000000US060952533002159,060952533002159,"Block 2159, Block Group 2, Census Tract 2533, Solano County, California",0,0,0
1000000US060952533002160,060952533002160,"Block 2160, Block Group 2, Census Tract 2533, Solano County, California",0,0,0
1000000US060952533002161,060952533002161,"Block 2161, Block Group 2, Census Tract 2533, Solano County, California",1,0,1
1000000US060952533002162,060952533002162,"Block 2162, Block Group 2, Census Tract 2533, Solano County, California",0,0,0
1000000US060952533002163,060952533002163,"Block 2163, Block Group 2, Census Tract 2533, Solano County, California",0,0,0
1000000US060952533002164,060952533002164,"Block 2164, Block Group 2, Census Tract 2533, Solano County, California",0,0,0
1000000US060952533002165,060952533002165,"Block 2165, Block Group 2, Census Tract 2533, Solano County, California",4,4,0
1000000US060952533002166,060952533002166,"Block 2166, Block Group 2, Census Tract 2533, Solano County, California",2,2,0
1000000US060952533002167,060952533002167,"Block 2167, Block Group 2, Census Tract 2533, Solano County, California",0,0,0
1000000US060952533002168,060952533002168,"Block 2168, Block Group 2, Census Tract 2533, Solano County, California",0,0,0
1000000US060952533002169,060952533002169,"Block 2169, Block Group 2, Census Tract 2533, Solano County, California",0,0,0
1000000US060952533002170,060952533002170,"Block 2170, Block Group 2, Census Tract 2533, Solano County, California",4,4,0
1000000US060952533002171,060952533002171,"Block 2171, Block Group 2, Census Tract 2533, Solano County, California",0,0,0
1000000US060952533002172,060952533002172,"Block 2172, Block Group 2, Census Tract 2533, Solano County, California",2,2,0
1000000US060952533002173,060952533002173,"Block 2173, Block Group 2, Census Tract 2533, Solano County, California",0,0,0
1000000US060952533002174,060952533002174,"Block 2174, Block Group 2, Census Tract 2533, Solano County, California",2,2,0
1000000US060952533002175,060952533002175,"Block 2175, Block Group 2, Census Tract 2533, Solano County, California",1,1,0
1000000US060952533002176,060952533002176,"Block 2176, Block Group 2, Census Tract 2533, Solano County, California",0,0,0
1000000US060952533002177,060952533002177,"Block 2177, Block Group 2, Census Tract 2533, Solano County, California",0,0,0
1000000US060952533002178,060952533002178,"Block 2178, Block Group 2, Census Tract 2533, Solano County, California",2,2,0
1000000US060952533002179,060952533002179,"Block 2179, Block Group 2, Census Tract 2533, Solano County, California",0,0,0
1000000US060952533002180,060952533002180,"Block 2180, Block Group 2, Census Tract 2533, Solano County, California",3,3,0
1000000US060952533002181,060952533002181,"Block 2181, Block Group 2, Census Tract 2533, Solano County, California",1,1,0
1000000US060952533002182,060952533002182,"Block 2182, Block Group 2, Census Tract 2533, Solano County, California",0,0,0
1000000US060952533002183,060952533002183,"Block 2183, Block Group 2, Census Tract 2533, Solano County, California",1,1,0
1000000US060952533002184,060952533002184,"Block 2184, Block Group 2, Census Tract 2533, Solano County, California",1,1,0
1000000US060952533002185,060952533002185,"Block 2185, Block Group 2, Census Tract 2533, Solano County, California",0,0,0
1000000US060952533002186,060952533002186,"Block 2186, Block Group 2, Census Tract 2533, Solano County, California",16,14,2
1000000US060952533002187,060952533002187,"Block 2187, Block Group 2, Census Tract 2533, Solano County, California",1,1,0
1000000US060952533002188,060952533002188,"Block 2188, Block Group 2, Census Tract 2533, Solano County, California",0,0,0
1000000US060952533002189,060952533002189,"Block 2189, Block Group 2, Census Tract 2533, Solano County, California",0,0,0
1000000US060952533002190,060952533002190,"Block 2190, Block Group 2, Census Tract 2533, Solano County, California",0,0,0
1000000US060952533002191,060952533002191,"Block 2191, Block Group 2, Census Tract 2533, Solano County, California",0,0,0
1000000US060952533002192,060952533002192,"Block 2192, Block Group 2, Census Tract 2533, Solano County, California",0,0,0
1000000US060952533002193,060952533002193,"Block 2193, Block Group 2, Census Tract 2533, Solano County, California",1,0,1
1000000US060952533002194,060952533002194,"Block 2194, Block Group 2, Census Tract 2533, Solano County, California",0,0,0
1000000US060952533002195,060952533002195,"Block 2195, Block Group 2, Census Tract 2533, Solano County, California",4,4,0
1000000US060952533002196,060952533002196,"Block 2196, Block Group 2, Census Tract 2533, Solano County, California",0,0,0
1000000US060952533002197,060952533002197,"Block 2197, Block Group 2, Census Tract 2533, Solano County, California",0,0,0
1000000US060952533002198,060952533002198,"Block 2198, Block Group 2, Census Tract 2533, Solano County, California",0,0,0
1000000US060952533002199,060952533002199,"Block 2199, Block Group 2, Census Tract 2533, Solano County, California",1,1,0
1000000US060952533002200,060952533002200,"Block 2200, Block Group 2, Census Tract 2533, Solano County, California",0,0,0
1000000US060952533002201,060952533002201,"Block 2201, Block Group 2, Census Tract 2533, Solano County, California",0,0,0
1000000US060952533002202,060952533002202,"Block 2202, Block Group 2, Census Tract 2533, Solano County, California",1,1,0
1000000US060952533002203,060952533002203,"Block 2203, Block Group 2, Census Tract 2533, Solano County, California",0,0,0
1000000US060952533002204,060952533002204,"Block 2204, Block Group 2, Census Tract 2533, Solano County, California",5,5,0
1000000US060952533002205,060952533002205,"Block 2205, Block Group 2, Census Tract 2533, Solano County, California",2,2,0
1000000US060952533002206,060952533002206,"Block 2206, Block Group 2, Census Tract 2533, Solano County, California",0,0,0
1000000US060952533002207,060952533002207,"Block 2207, Block Group 2, Census Tract 2533, Solano County, California",0,0,0
1000000US060952533002208,060952533002208,"Block 2208, Block Group 2, Census Tract 2533, Solano County, California",0,0,0
1000000US060952533002209,060952533002209,"Block 2209, Block Group 2, Census Tract 2533, Solano County, California",0,0,0
1000000US060952533002210,060952533002210,"Block 2210, Block Group 2, Census Tract 2533, Solano County, California",0,0,0
1000000US060952533002211,060952533002211,"Block 2211, Block Group 2, Census Tract 2533, Solano County, California",0,0,0
1000000US060952533002212,060952533002212,"Block 2212, Block Group 2, Census Tract 2533, Solano County, California",0,0,0
1000000US060952533002213,060952533002213,"Block 2213, Block Group 2, Census Tract 2533, Solano County, California",0,0,0
1000000US060952533002214,060952533002214,"Block 2214, Block Group 2, Census Tract 2533, Solano County, California",0,0,0
1000000US060952533002215,060952533002215,"Block 2215, Block Group 2, Census Tract 2533, Solano County, California",0,0,0
1000000US060952533002216,060952533002216,"Block 2216, Block Group 2, Census Tract 2533, Solano County, California",0,0,0
1000000US060952533002217,060952533002217,"Block 2217, Block Group 2, Census Tract 2533, Solano County, California",0,0,0
1000000US060952533002218,060952533002218,"Block 2218, Block Group 2, Census Tract 2533, Solano County, California",0,0,0
1000000US060952533002219,060952533002219,"Block 2219, Block Group 2, Census Tract 2533, Solano County, California",0,0,0
1000000US060952533002220,060952533002220,"Block 2220, Block Group 2, Census Tract 2533, Solano County, California",3,2,1
1000000US060952533002221,060952533002221,"Block 2221, Block Group 2, Census Tract 2533, Solano County, California",0,0,0
1000000US060952533002222,060952533002222,"Block 2222, Block Group 2, Census Tract 2533, Solano County, California",0,0,0
1000000US060952533002223,060952533002223,"Block 2223, Block Group 2, Census Tract 2533, Solano County, California",0,0,0
1000000US060952533002224,060952533002224,"Block 2224, Block Group 2, Census Tract 2533, Solano County, California",0,0,0
1000000US060952533002225,060952533002225,"Block 2225, Block Group 2, Census Tract 2533, Solano County, California",3,2,1
1000000US060952533002226,060952533002226,"Block 2226, Block Group 2, Census Tract 2533, Solano County, California",0,0,0
1000000US060952533002227,060952533002227,"Block 2227, Block Group 2, Census Tract 2533, Solano County, California",0,0,0
1000000US060952533002228,060952533002228,"Block 2228, Block Group 2, Census Tract 2533, Solano County, California",0,0,0
1000000US060952533002229,060952533002229,"Block 2229, Block Group 2, Census Tract 2533, Solano County, California",1,1,0
1000000US060952533002230,060952533002230,"Block 2230, Block Group 2, Census Tract 2533, Solano County, California",0,0,0
1000000US060952533002231,060952533002231,"Block 2231, Block Group 2, Census Tract 2533, Solano County, California",0,0,0
1000000US060952533002232,060952533002232,"Block 2232, Block Group 2, Census Tract 2533, Solano County, California",1,1,0
1000000US060952533002233,060952533002233,"Block 2233, Block Group 2, Census Tract 2533, Solano County, California",0,0,0
1000000US060952533002234,060952533002234,"Block 2234, Block Group 2, Census Tract 2533, Solano County, California",0,0,0
1000000US060952533002235,060952533002235,"Block 2235, Block Group 2, Census Tract 2533, Solano County, California",2,2,0
1000000US060952533002236,060952533002236,"Block 2236, Block Group 2, Census Tract 2533, Solano County, California",0,0,0
1000000US060952533002237,060952533002237,"Block 2237, Block Group 2, Census Tract 2533, Solano County, California",0,0,0
1000000US060952533002238,060952533002238,"Block 2238, Block Group 2, Census Tract 2533, Solano County, California",1,1,0
1000000US060952533002239,060952533002239,"Block 2239, Block Group 2, Census Tract 2533, Solano County, California",0,0,0
1000000US060952533002240,060952533002240,"Block 2240, Block Group 2, Census Tract 2533, Solano County, California",1,0,1
1000000US060952533002241,060952533002241,"Block 2241, Block Group 2, Census Tract 2533, Solano County, California",0,0,0
1000000US060952533002242,060952533002242,"Block 2242, Block Group 2, Census Tract 2533, Solano County, California",1,1,0
1000000US060952533002243,060952533002243,"Block 2243, Block Group 2, Census Tract 2533, Solano County, California",0,0,0
1000000US060952533002244,060952533002244,"Block 2244, Block Group 2, Census Tract 2533, Solano County, California",0,0,0
1000000US060952533002245,060952533002245,"Block 2245, Block Group 2, Census Tract 2533, Solano County, California",4,4,0
1000000US060952533002246,060952533002246,"Block 2246, Block Group 2, Census Tract 2533, Solano County, California",0,0,0
1000000US060952533002247,060952533002247,"Block 2247, Block Group 2, Census Tract 2533, Solano County, California",0,0,0
1000000US060952533002248,060952533002248,"Block 2248, Block Group 2, Census Tract 2533, Solano County, California",0,0,0
1000000US060952533002249,060952533002249,"Block 2249, Block Group 2, Census Tract 2533, Solano County, California",0,0,0
1000000US060952533002250,060952533002250,"Block 2250, Block Group 2, Census Tract 2533, Solano County, California",0,0,0
1000000US060952533002251,060952533002251,"Block 2251, Block Group 2, Census Tract 2533, Solano County, California",0,0,0
1000000US060952533002252,060952533002252,"Block 2252, Block Group 2, Census Tract 2533, Solano County, California",1,1,0
1000000US060952533002253,060952533002253,"Block 2253, Block Group 2, Census Tract 2533, Solano County, California",1,1,0
1000000US060952533002254,060952533002254,"Block 2254, Block Group 2, Census Tract 2533, Solano County, California",0,0,0
1000000US060952533002255,060952533002255,"Block 2255, Block Group 2, Census Tract 2533, Solano County, California",0,0,0
1000000US060952533002256,060952533002256,"Block 2256, Block Group 2, Census Tract 2533, Solano County, California",0,0,0
1000000US060952533002257,060952533002257,"Block 2257, Block Group 2, Census Tract 2533, Solano County, California",0,0,0
1000000US060952533002258,060952533002258,"Block 2258, Block Group 2, Census Tract 2533, Solano County, California",1,1,0
1000000US060952533002259,060952533002259,"Block 2259, Block Group 2, Census Tract 2533, Solano County, California",0,0,0
1000000US060952533002260,060952533002260,"Block 2260, Block Group 2, Census Tract 2533, Solano County, California",7,7,0
1000000US060952533002261,060952533002261,"Block 2261, Block Group 2, Census Tract 2533, Solano County, California",0,0,0
1000000US060952533002262,060952533002262,"Block 2262, Block Group 2, Census Tract 2533, Solano County, California",1,1,0
1000000US060952533002263,060952533002263,"Block 2263, Block Group 2, Census Tract 2533, Solano County, California",0,0,0
1000000US060952533002264,060952533002264,"Block 2264, Block Group 2, Census Tract 2533, Solano County, California",3,3,0
1000000US060952533002265,060952533002265,"Block 2265, Block Group 2, Census Tract 2533, Solano County, California",5,4,1
1000000US060952533002266,060952533002266,"Block 2266, Block Group 2, Census Tract 2533, Solano County, California",0,0,0
1000000US060952533002267,060952533002267,"Block 2267, Block Group 2, Census Tract 2533, Solano County, California",0,0,0
1000000US060952533002268,060952533002268,"Block 2268, Block Group 2, Census Tract 2533, Solano County, California",4,4,0
1000000US060952533002269,060952533002269,"Block 2269, Block Group 2, Census Tract 2533, Solano County, California",1,1,0
1000000US060952533002270,060952533002270,"Block 2270, Block Group 2, Census Tract 2533, Solano County, California",4,4,0
1000000US060952533002271,060952533002271,"Block 2271, Block Group 2, Census Tract 2533, Solano County, California",0,0,0
1000000US060952533002272,060952533002272,"Block 2272, Block Group 2, Census Tract 2533, Solano County, California",0,0,0
1000000US060952533002273,060952533002273,"Block 2273, Block Group 2, Census Tract 2533, Solano County, California",0,0,0
1000000US060952533002274,060952533002274,"Block 2274, Block Group 2, Census Tract 2533, Solano County, California",2,2,0
1000000US060952533002275,060952533002275,"Block 2275, Block Group 2, Census Tract 2533, Solano County, California",0,0,0
1000000US060952533002276,060952533002276,"Block 2276, Block Group 2, Census Tract 2533, Solano County, California",0,0,0
1000000US060952533002277,060952533002277,"Block 2277, Block Group 2, Census Tract 2533, Solano County, California",4,4,0
1000000US060952533002278,060952533002278,"Block 2278, Block Group 2, Census Tract 2533, Solano County, California",1,1,0
1000000US060952533002279,060952533002279,"Block 2279, Block Group 2, Census Tract 2533, Solano County, California",7,7,0
1000000US060952533002280,060952533002280,"Block 2280, Block Group 2, Census Tract 2533, Solano County, California",0,0,0
1000000US060952533002281,060952533002281,"Block 2281, Block Group 2, Census Tract 2533, Solano County, California",3,3,0
1000000US060952533002282,060952533002282,"Block 2282, Block Group 2, Census Tract 2533, Solano County, California",0,0,0
1000000US060952533002283,060952533002283,"Block 2283, Block Group 2, Census Tract 2533, Solano County, California",2,1,1
1000000US060952533002284,060952533002284,"Block 2284, Block Group 2, Census Tract 2533, Solano County, California",0,0,0
1000000US060952533002285,060952533002285,"Block 2285, Block Group 2, Census Tract 2533, Solano County, California",0,0,0
1000000US060952533002286,060952533002286,"Block 2286, Block Group 2, Census Tract 2533, Solano County, California",1,1,0
1000000US060952533002287,060952533002287,"Block 2287, Block Group 2, Census Tract 2533, Solano County, California",0,0,0
1000000US060952533002288,060952533002288,"Block 2288, Block Group 2, Census Tract 2533, Solano County, California",0,0,0
1000000US060952533002289,060952533002289,"Block 2289, Block Group 2, Census Tract 2533, Solano County, California",0,0,0
1000000US060952533002290,060952533002290,"Block 2290, Block Group 2, Census Tract 2533, Solano County, California",0,0,0
1000000US060952533002291,060952533002291,"Block 2291, Block Group 2, Census Tract 2533, Solano County, California",0,0,0
1000000US060952533002292,060952533002292,"Block 2292, Block Group 2, Census Tract 2533, Solano County, California",0,0,0
1000000US060952533002293,060952533002293,"Block 2293, Block Group 2, Census Tract 2533, Solano County, California",0,0,0
1000000US060952533002294,060952533002294,"Block 2294, Block Group 2, Census Tract 2533, Solano County, California",7,7,0
1000000US060952533002295,060952533002295,"Block 2295, Block Group 2, Census Tract 2533, Solano County, California",0,0,0
1000000US060952533002296,060952533002296,"Block 2296, Block Group 2, Census Tract 2533, Solano County, California",0,0,0
1000000US060952533002297,060952533002297,"Block 2297, Block Group 2, Census Tract 2533, Solano County, California",0,0,0
1000000US060952533002298,060952533002298,"Block 2298, Block Group 2, Census Tract 2533, Solano County, California",0,0,0
1000000US060952533002299,060952533002299,"Block 2299, Block Group 2, Census Tract 2533, Solano County, California",1,1,0
1000000US060952533002300,060952533002300,"Block 2300, Block Group 2, Census Tract 2533, Solano County, California",0,0,0
1000000US060952533002301,060952533002301,"Block 2301, Block Group 2, Census Tract 2533, Solano County, California",0,0,0
1000000US060952533002302,060952533002302,"Block 2302, Block Group 2, Census Tract 2533, Solano County, California",1,1,0
1000000US060952533002303,060952533002303,"Block 2303, Block Group 2, Census Tract 2533, Solano County, California",0,0,0
1000000US060952533002304,060952533002304,"Block 2304, Block Group 2, Census Tract 2533, Solano County, California",0,0,0
1000000US060952533002305,060952533002305,"Block 2305, Block Group 2, Census Tract 2533, Solano County, California",0,0,0
1000000US060952533002306,060952533002306,"Block 2306, Block Group 2, Census Tract 2533, Solano County, California",0,0,0
1000000US060952533002307,060952533002307,"Block 2307, Block Group 2, Census Tract 2533, Solano County, California",1,1,0
1000000US060952533002308,060952533002308,"Block 2308, Block Group 2, Census Tract 2533, Solano County, California",1,1,0
1000000US060952533002309,060952533002309,"Block 2309, Block Group 2, Census Tract 2533, Solano County, California",0,0,0
1000000US060952533002310,060952533002310,"Block 2310, Block Group 2, Census Tract 2533, Solano County, California",0,0,0
1000000US060952533002311,060952533002311,"Block 2311, Block Group 2, Census Tract 2533, Solano County, California",0,0,0
1000000US060952533002312,060952533002312,"Block 2312, Block Group 2, Census Tract 2533, Solano County, California",0,0,0
1000000US060952533002313,060952533002313,"Block 2313, Block Group 2, Census Tract 2533, Solano County, California",0,0,0
1000000US060952533002314,060952533002314,"Block 2314, Block Group 2, Census Tract 2533, Solano County, California",1,0,1
1000000US060952533002315,060952533002315,"Block 2315, Block Group 2, Census Tract 2533, Solano County, California",3,3,0
1000000US060952533002316,060952533002316,"Block 2316, Block Group 2, Census Tract 2533, Solano County, California",0,0,0
1000000US060952533002317,060952533002317,"Block 2317, Block Group 2, Census Tract 2533, Solano County, California",2,0,2
1000000US060952533002318,060952533002318,"Block 2318, Block Group 2, Census Tract 2533, Solano County, California",0,0,0
1000000US060952533002319,060952533002319,"Block 2319, Block Group 2, Census Tract 2533, Solano County, California",8,8,0
1000000US060952533002320,060952533002320,"Block 2320, Block Group 2, Census Tract 2533, Solano County, California",0,0,0
1000000US060952533002321,060952533002321,"Block 2321, Block Group 2, Census Tract 2533, Solano County, California",5,5,0
1000000US060952533002322,060952533002322,"Block 2322, Block Group 2, Census Tract 2533, Solano County, California",5,4,1
1000000US060952533002323,060952533002323,"Block 2323, Block Group 2, Census Tract 2533, Solano County, California",0,0,0
1000000US060952533002324,060952533002324,"Block 2324, Block Group 2, Census Tract 2533, Solano County, California",0,0,0
1000000US060952533002325,060952533002325,"Block 2325, Block Group 2, Census Tract 2533, Solano County, California",0,0,0
1000000US060952533002326,060952533002326,"Block 2326, Block Group 2, Census Tract 2533, Solano County, California",0,0,0
1000000US060952533002327,060952533002327,"Block 2327, Block Group 2, Census Tract 2533, Solano County, California",0,0,0
1000000US060952533002328,060952533002328,"Block 2328, Block Group 2, Census Tract 2533, Solano County, California",0,0,0
1000000US060952533002329,060952533002329,"Block 2329, Block Group 2, Census Tract 2533, Solano County, California",0,0,0
1000000US060952533002330,060952533002330,"Block 2330, Block Group 2, Census Tract 2533, Solano County, California",0,0,0
1000000US060952533002331,060952533002331,"Block 2331, Block Group 2, Census Tract 2533, Solano County, California",0,0,0
1000000US060952533002332,060952533002332,"Block 2332, Block Group 2, Census Tract 2533, Solano County, California",0,0,0
1000000US060952533002333,060952533002333,"Block 2333, Block Group 2, Census Tract 2533, Solano County, California",0,0,0
1000000US060952533002334,060952533002334,"Block 2334, Block Group 2, Census Tract 2533, Solano County, California",3,3,0
1000000US060952533002335,060952533002335,"Block 2335, Block Group 2, Census Tract 2533, Solano County, California",0,0,0
1000000US060952533002336,060952533002336,"Block 2336, Block Group 2, Census Tract 2533, Solano County, California",2,2,0
1000000US060952533002337,060952533002337,"Block 2337, Block Group 2, Census Tract 2533, Solano County, California",0,0,0
1000000US060952533002338,060952533002338,"Block 2338, Block Group 2, Census Tract 2533, Solano County, California",0,0,0
1000000US060952533002339,060952533002339,"Block 2339, Block Group 2, Census Tract 2533, Solano County, California",4,3,1
1000000US060952533002340,060952533002340,"Block 2340, Block Group 2, Census Tract 2533, Solano County, California",2,2,0
1000000US060952533002341,060952533002341,"Block 2341, Block Group 2, Census Tract 2533, Solano County, California",3,3,0
1000000US060952533002342,060952533002342,"Block 2342, Block Group 2, Census Tract 2533, Solano County, California",5,4,1
1000000US060952533002343,060952533002343,"Block 2343, Block Group 2, Census Tract 2533, Solano County, California",1,1,0
1000000US060952533002344,060952533002344,"Block 2344, Block Group 2, Census Tract 2533, Solano County, California",0,0,0
1000000US060952533002345,060952533002345,"Block 2345, Block Group 2, Census Tract 2533, Solano County, California",0,0,0
1000000US060952533002346,060952533002346,"Block 2346, Block Group 2, Census Tract 2533, Solano County, California",0,0,0
1000000US060952533002347,060952533002347,"Block 2347, Block Group 2, Census Tract 2533, Solano County, California",0,0,0
1000000US060952533002348,060952533002348,"Block 2348, Block Group 2, Census Tract 2533, Solano County, California",4,4,0
1000000US060952533002349,060952533002349,"Block 2349, Block Group 2, Census Tract 2533, Solano County, California",0,0,0
1000000US060952533002350,060952533002350,"Block 2350, Block Group 2, Census Tract 2533, Solano County, California",1,1,0
1000000US060952533002351,060952533002351,"Block 2351, Block Group 2, Census Tract 2533, Solano County, California",0,0,0
1000000US060952533002352,060952533002352,"Block 2352, Block Group 2, Census Tract 2533, Solano County, California",0,0,0
1000000US060952533002353,060952533002353,"Block 2353, Block Group 2, Census Tract 2533, Solano County, California",0,0,0
1000000US060952533002354,060952533002354,"Block 2354, Block Group 2, Census Tract 2533, Solano County, California",1,1,0
1000000US060952533002355,060952533002355,"Block 2355, Block Group 2, Census Tract 2533, Solano County, California",1,1,0
1000000US060952533002356,060952533002356,"Block 2356, Block Group 2, Census Tract 2533, Solano County, California",3,3,0
1000000US060952533002357,060952533002357,"Block 2357, Block Group 2, Census Tract 2533, Solano County, California",6,6,0
1000000US060952533002358,060952533002358,"Block 2358, Block Group 2, Census Tract 2533, Solano County, California",0,0,0
1000000US060952533002359,060952533002359,"Block 2359, Block Group 2, Census Tract 2533, Solano County, California",9,9,0
1000000US060952533002360,060952533002360,"Block 2360, Block Group 2, Census Tract 2533, Solano County, California",12,11,1
1000000US060952533002361,060952533002361,"Block 2361, Block Group 2, Census Tract 2533, Solano County, California",1,1,0
1000000US060952533002362,060952533002362,"Block 2362, Block Group 2, Census Tract 2533, Solano County, California",1,1,0
1000000US060952533002363,060952533002363,"Block 2363, Block Group 2, Census Tract 2533, Solano County, California",0,0,0
1000000US060952533002364,060952533002364,"Block 2364, Block Group 2, Census Tract 2533, Solano County, California",0,0,0
1000000US060952533002365,060952533002365,"Block 2365, Block Group 2, Census Tract 2533, Solano County, California",0,0,0
1000000US060952533002366,060952533002366,"Block 2366, Block Group 2, Census Tract 2533, Solano County, California",0,0,0
1000000US060952533002367,060952533002367,"Block 2367, Block Group 2, Census Tract 2533, Solano County, California",0,0,0
1000000US060952533002368,060952533002368,"Block 2368, Block Group 2, Census Tract 2533, Solano County, California",1,1,0
1000000US060952533002369,060952533002369,"Block 2369, Block Group 2, Census Tract 2533, Solano County, California",7,7,0
1000000US060952533002370,060952533002370,"Block 2370, Block Group 2, Census Tract 2533, Solano County, California",5,5,0
1000000US060952533002371,060952533002371,"Block 2371, Block Group 2, Census Tract 2533, Solano County, California",1,1,0
1000000US060952533002372,060952533002372,"Block 2372, Block Group 2, Census Tract 2533, Solano County, California",0,0,0
1000000US060952533002373,060952533002373,"Block 2373, Block Group 2, Census Tract 2533, Solano County, California",0,0,0
1000000US060952533002374,060952533002374,"Block 2374, Block Group 2, Census Tract 2533, Solano County, California",0,0,0
1000000US060952533002375,060952533002375,"Block 2375, Block Group 2, Census Tract 2533, Solano County, California",0,0,0
1000000US060952533002376,060952533002376,"Block 2376, Block Group 2, Census Tract 2533, Solano County, California",0,0,0
1000000US060952533002377,060952533002377,"Block 2377, Block Group 2, Census Tract 2533, Solano County, California",0,0,0
1000000US060952533002378,060952533002378,"Block 2378, Block Group 2, Census Tract 2533, Solano County, California",3,3,0
1000000US060952533002379,060952533002379,"Block 2379, Block Group 2, Census Tract 2533, Solano County, California",7,6,1
1000000US060952533002380,060952533002380,"Block 2380, Block Group 2, Census Tract 2533, Solano County, California",5,5,0
1000000US060952533002381,060952533002381,"Block 2381, Block Group 2, Census Tract 2533, Solano County, California",3,3,0
1000000US060952533002382,060952533002382,"Block 2382, Block Group 2, Census Tract 2533, Solano County, California",9,9,0
1000000US060952533002383,060952533002383,"Block 2383, Block Group 2, Census Tract 2533, Solano County, California",0,0,0
1000000US060952533002384,060952533002384,"Block 2384, Block Group 2, Census Tract 2533, Solano County, California",0,0,0
1000000US060952533002385,060952533002385,"Block 2385, Block Group 2, Census Tract 2533, Solano County, California",0,0,0
1000000US060952533002386,060952533002386,"Block 2386, Block Group 2, Census Tract 2533, Solano County, California",4,3,1
1000000US060952533002387,060952533002387,"Block 2387, Block Group 2, Census Tract 2533, Solano County, California",0,0,0
1000000US060952533002388,060952533002388,"Block 2388, Block Group 2, Census Tract 2533, Solano County, California",3,2,1
1000000US060952533002389,060952533002389,"Block 2389, Block Group 2, Census Tract 2533, Solano County, California",2,2,0
1000000US060952533002390,060952533002390,"Block 2390, Block Group 2, Census Tract 2533, Solano County, California",0,0,0
1000000US060952533002391,060952533002391,"Block 2391, Block Group 2, Census Tract 2533, Solano County, California",0,0,0
1000000US060952533002392,060952533002392,"Block 2392, Block Group 2, Census Tract 2533, Solano County, California",0,0,0
1000000US060952533002393,060952533002393,"Block 2393, Block Group 2, Census Tract 2533, Solano County, California",0,0,0
1000000US060952533002394,060952533002394,"Block 2394, Block Group 2, Census Tract 2533, Solano County, California",0,0,0
1000000US060952533002395,060952533002395,"Block 2395, Block Group 2, Census Tract 2533, Solano County, California",0,0,0
1000000US060952533002396,060952533002396,"Block 2396, Block Group 2, Census Tract 2533, Solano County, California",0,0,0
1000000US060952533002397,060952533002397,"Block 2397, Block Group 2, Census Tract 2533, Solano County, California",0,0,0
1000000US060952533002398,060952533002398,"Block 2398, Block Group 2, Census Tract 2533, Solano County, California",0,0,0
1000000US060952533002399,060952533002399,"Block 2399, Block Group 2, Census Tract 2533, Solano County, California",0,0,0
1000000US060952533002400,060952533002400,"Block 2400, Block Group 2, Census Tract 2533, Solano County, California",0,0,0
1000000US060952533002401,060952533002401,"Block 2401, Block Group 2, Census Tract 2533, Solano County, California",0,0,0
1000000US060952533002402,060952533002402,"Block 2402, Block Group 2, Census Tract 2533, Solano County, California",0,0,0
1000000US060952533002403,060952533002403,"Block 2403, Block Group 2, Census Tract 2533, Solano County, California",0,0,0
1000000US060952533002404,060952533002404,"Block 2404, Block Group 2, Census Tract 2533, Solano County, California",0,0,0
1000000US060952533002405,060952533002405,"Block 2405, Block Group 2, Census Tract 2533, Solano County, California",0,0,0
1000000US060952533002406,060952533002406,"Block 2406, Block Group 2, Census Tract 2533, Solano County, California",0,0,0
1000000US060952533002407,060952533002407,"Block 2407, Block Group 2, Census Tract 2533, Solano County, California",0,0,0
1000000US060952533002408,060952533002408,"Block 2408, Block Group 2, Census Tract 2533, Solano County, California",0,0,0
1000000US060952533002409,060952533002409,"Block 2409, Block Group 2, Census Tract 2533, Solano County, California",1,0,1
1000000US060952533002410,060952533002410,"Block 2410, Block Group 2, Census Tract 2533, Solano County, California",0,0,0
1000000US060952533002411,060952533002411,"Block 2411, Block Group 2, Census Tract 2533, Solano County, California",0,0,0
1000000US060952533002412,060952533002412,"Block 2412, Block Group 2, Census Tract 2533, Solano County, California",0,0,0
1000000US060952533002413,060952533002413,"Block 2413, Block Group 2, Census Tract 2533, Solano County, California",0,0,0
1000000US060952533002414,060952533002414,"Block 2414, Block Group 2, Census Tract 2533, Solano County, California",0,0,0
1000000US060952533002415,060952533002415,"Block 2415, Block Group 2, Census Tract 2533, Solano County, California",0,0,0
1000000US060952533002416,060952533002416,"Block 2416, Block Group 2, Census Tract 2533, Solano County, California",0,0,0
1000000US060952533002417,060952533002417,"Block 2417, Block Group 2, Census Tract 2533, Solano County, California",0,0,0
1000000US060952533002418,060952533002418,"Block 2418, Block Group 2, Census Tract 2533, Solano County, California",0,0,0
1000000US060952533002419,060952533002419,"Block 2419, Block Group 2, Census Tract 2533, Solano County, California",0,0,0
1000000US060952533002420,060952533002420,"Block 2420, Block Group 2, Census Tract 2533, Solano County, California",0,0,0
1000000US060952533002421,060952533002421,"Block 2421, Block Group 2, Census Tract 2533, Solano County, California",0,0,0
1000000US060952533002422,060952533002422,"Block 2422, Block Group 2, Census Tract 2533, Solano County, California",0,0,0
1000000US060952533002423,060952533002423,"Block 2423, Block Group 2, Census Tract 2533, Solano County, California",0,0,0
1000000US060952533002424,060952533002424,"Block 2424, Block Group 2, Census Tract 2533, Solano County, California",0,0,0
1000000US060952533002425,060952533002425,"Block 2425, Block Group 2, Census Tract 2533, Solano County, California",0,0,0
1000000US060952533002426,060952533002426,"Block 2426, Block Group 2, Census Tract 2533, Solano County, California",0,0,0
1000000US060952533002427,060952533002427,"Block 2427, Block Group 2, Census Tract 2533, Solano County, California",0,0,0
1000000US060952533002428,060952533002428,"Block 2428, Block Group 2, Census Tract 2533, Solano County, California",0,0,0
1000000US060952533002429,060952533002429,"Block 2429, Block Group 2, Census Tract 2533, Solano County, California",0,0,0
1000000US060952533002430,060952533002430,"Block 2430, Block Group 2, Census Tract 2533, Solano County, California",0,0,0
1000000US060952533002431,060952533002431,"Block 2431, Block Group 2, Census Tract 2533, Solano County, California",0,0,0
1000000US060952533002432,060952533002432,"Block 2432, Block Group 2, Census Tract 2533, Solano County, California",0,0,0
1000000US060952533002433,060952533002433,"Block 2433, Block Group 2, Census Tract 2533, Solano County, California",0,0,0
1000000US060952533002434,060952533002434,"Block 2434, Block Group 2, Census Tract 2533, Solano County, California",0,0,0
1000000US060952533002435,060952533002435,"Block 2435, Block Group 2, Census Tract 2533, Solano County, California",0,0,0
1000000US060952533002436,060952533002436,"Block 2436, Block Group 2, Census Tract 2533, Solano County, California",0,0,0
1000000US060952533002437,060952533002437,"Block 2437, Block Group 2, Census Tract 2533, Solano County, California",0,0,0
1000000US060952533002438,060952533002438,"Block 2438, Block Group 2, Census Tract 2533, Solano County, California",0,0,0
1000000US060952533002439,060952533002439,"Block 2439, Block Group 2, Census Tract 2533, Solano County, California",0,0,0
1000000US060952533002440,060952533002440,"Block 2440, Block Group 2, Census Tract 2533, Solano County, California",0,0,0
1000000US060952533002441,060952533002441,"Block 2441, Block Group 2, Census Tract 2533, Solano County, California",0,0,0
1000000US060952533002442,060952533002442,"Block 2442, Block Group 2, Census Tract 2533, Solano County, California",3,2,1
1000000US060952533002443,060952533002443,"Block 2443, Block Group 2, Census Tract 2533, Solano County, California",0,0,0
1000000US060952533002444,060952533002444,"Block 2444, Block Group 2, Census Tract 2533, Solano County, California",0,0,0
1000000US060952533002445,060952533002445,"Block 2445, Block Group 2, Census Tract 2533, Solano County, California",0,0,0
1000000US060952533002446,060952533002446,"Block 2446, Block Group 2, Census Tract 2533, Solano County, California",0,0,0
1000000US060952533002447,060952533002447,"Block 2447, Block Group 2, Census Tract 2533, Solano County, California",0,0,0
1000000US060952533002448,060952533002448,"Block 2448, Block Group 2, Census Tract 2533, Solano County, California",0,0,0
1000000US060952534021000,060952534021000,"Block 1000, Block Group 1, Census Tract 2534.02, Solano County, California",0,0,0
1000000US060952534021001,060952534021001,"Block 1001, Block Group 1, Census Tract 2534.02, Solano County, California",0,0,0
1000000US060952534021002,060952534021002,"Block 1002, Block Group 1, Census Tract 2534.02, Solano County, California",4,2,2
1000000US060952534021003,060952534021003,"Block 1003, Block Group 1, Census Tract 2534.02, Solano County, California",0,0,0
1000000US060952534021004,060952534021004,"Block 1004, Block Group 1, Census Tract 2534.02, Solano County, California",0,0,0
1000000US060952534021005,060952534021005,"Block 1005, Block Group 1, Census Tract 2534.02, Solano County, California",0,0,0
1000000US060952534021006,060952534021006,"Block 1006, Block Group 1, Census Tract 2534.02, Solano County, California",0,0,0
1000000US060952534021007,060952534021007,"Block 1007, Block Group 1, Census Tract 2534.02, Solano County, California",0,0,0
1000000US060952534021008,060952534021008,"Block 1008, Block Group 1, Census Tract 2534.02, Solano County, California",0,0,0
1000000US060952534021009,060952534021009,"Block 1009, Block Group 1, Census Tract 2534.02, Solano County, California",0,0,0
1000000US060952534021010,060952534021010,"Block 1010, Block Group 1, Census Tract 2534.02, Solano County, California",0,0,0
1000000US060952534021011,060952534021011,"Block 1011, Block Group 1, Census Tract 2534.02, Solano County, California",0,0,0
1000000US060952534021012,060952534021012,"Block 1012, Block Group 1, Census Tract 2534.02, Solano County, California",0,0,0
1000000US060952534021013,060952534021013,"Block 1013, Block Group 1, Census Tract 2534.02, Solano County, California",0,0,0
1000000US060952534021014,060952534021014,"Block 1014, Block Group 1, Census Tract 2534.02, Solano County, California",2,2,0
1000000US060952534021015,060952534021015,"Block 1015, Block Group 1, Census Tract 2534.02, Solano County, California",1,1,0
1000000US060952534021016,060952534021016,"Block 1016, Block Group 1, Census Tract 2534.02, Solano County, California",0,0,0
1000000US060952534021017,060952534021017,"Block 1017, Block Group 1, Census Tract 2534.02, Solano County, California",2,2,0
1000000US060952534021018,060952534021018,"Block 1018, Block Group 1, Census Tract 2534.02, Solano County, California",3,3,0
1000000US060952534021019,060952534021019,"Block 1019, Block Group 1, Census Tract 2534.02, Solano County, California",0,0,0
1000000US060952534021020,060952534021020,"Block 1020, Block Group 1, Census Tract 2534.02, Solano County, California",2,2,0
1000000US060952534021021,060952534021021,"Block 1021, Block Group 1, Census Tract 2534.02, Solano County, California",1,1,0
1000000US060952534021022,060952534021022,"Block 1022, Block Group 1, Census Tract 2534.02, Solano County, California",17,15,2
1000000US060952534021023,060952534021023,"Block 1023, Block Group 1, Census Tract 2534.02, Solano County, California",2,2,0
1000000US060952534021024,060952534021024,"Block 1024, Block Group 1, Census Tract 2534.02, Solano County, California",107,102,5
1000000US060952534021025,060952534021025,"Block 1025, Block Group 1, Census Tract 2534.02, Solano County, California",12,10,2
1000000US060952534021026,060952534021026,"Block 1026, Block Group 1, Census Tract 2534.02, Solano County, California",20,20,0
1000000US060952534021027,060952534021027,"Block 1027, Block Group 1, Census Tract 2534.02, Solano County, California",24,24,0
1000000US060952534021028,060952534021028,"Block 1028, Block Group 1, Census Tract 2534.02, Solano County, California",8,8,0
1000000US060952534021029,060952534021029,"Block 1029, Block Group 1, Census Tract 2534.02, Solano County, California",1,1,0
1000000US060952534021030,060952534021030,"Block 1030, Block Group 1, Census Tract 2534.02, Solano County, California",12,12,0
1000000US060952534021031,060952534021031,"Block 1031, Block Group 1, Census Tract 2534.02, Solano County, California",20,19,1
1000000US060952534021032,060952534021032,"Block 1032, Block Group 1, Census Tract 2534.02, Solano County, California",11,10,1
1000000US060952534021033,060952534021033,"Block 1033, Block Group 1, Census Tract 2534.02, Solano County, California",22,21,1
1000000US060952534021034,060952534021034,"Block 1034, Block Group 1, Census Tract 2534.02, Solano County, California",11,11,0
1000000US060952534021035,060952534021035,"Block 1035, Block Group 1, Census Tract 2534.02, Solano County, California",11,10,1
1000000US060952534021036,060952534021036,"Block 1036, Block Group 1, Census Tract 2534.02, Solano County, California",5,5,0
1000000US060952534021037,060952534021037,"Block 1037, Block Group 1, Census Tract 2534.02, Solano County, California",1,1,0
1000000US060952534021038,060952534021038,"Block 1038, Block Group 1, Census Tract 2534.02, Solano County, California",0,0,0
1000000US060952534021039,060952534021039,"Block 1039, Block Group 1, Census Tract 2534.02, Solano County, California",9,9,0
1000000US060952534021040,060952534021040,"Block 1040, Block Group 1, Census Tract 2534.02, Solano County, California",59,57,2
1000000US060952534021041,060952534021041,"Block 1041, Block Group 1, Census Tract 2534.02, Solano County, California",23,22,1
1000000US060952534021042,060952534021042,"Block 1042, Block Group 1, Census Tract 2534.02, Solano County, California",3,3,0
1000000US060952534021043,060952534021043,"Block 1043, Block Group 1, Census Tract 2534.02, Solano County, California",20,17,3
1000000US060952534021044,060952534021044,"Block 1044, Block Group 1, Census Tract 2534.02, Solano County, California",6,6,0
1000000US060952534021045,060952534021045,"Block 1045, Block Group 1, Census Tract 2534.02, Solano County, California",11,10,1
1000000US060952534021046,060952534021046,"Block 1046, Block Group 1, Census Tract 2534.02, Solano County, California",23,20,3
1000000US060952534021047,060952534021047,"Block 1047, Block Group 1, Census Tract 2534.02, Solano County, California",6,6,0
1000000US060952534021048,060952534021048,"Block 1048, Block Group 1, Census Tract 2534.02, Solano County, California",8,8,0
1000000US060952534021049,060952534021049,"Block 1049, Block Group 1, Census Tract 2534.02, Solano County, California",11,10,1
1000000US060952534021050,060952534021050,"Block 1050, Block Group 1, Census Tract 2534.02, Solano County, California",18,18,0
1000000US060952534021051,060952534021051,"Block 1051, Block Group 1, Census Tract 2534.02, Solano County, California",2,2,0
1000000US060952534021052,060952534021052,"Block 1052, Block Group 1, Census Tract 2534.02, Solano County, California",4,4,0
1000000US060952534021053,060952534021053,"Block 1053, Block Group 1, Census Tract 2534.02, Solano County, California",9,7,2
1000000US060952534021054,060952534021054,"Block 1054, Block Group 1, Census Tract 2534.02, Solano County, California",5,4,1
1000000US060952534022000,060952534022000,"Block 2000, Block Group 2, Census Tract 2534.02, Solano County, California",4,4,0
1000000US060952534022001,060952534022001,"Block 2001, Block Group 2, Census Tract 2534.02, Solano County, California",24,23,1
1000000US060952534022002,060952534022002,"Block 2002, Block Group 2, Census Tract 2534.02, Solano County, California",36,34,2
1000000US060952534022003,060952534022003,"Block 2003, Block Group 2, Census Tract 2534.02, Solano County, California",37,30,7
1000000US060952534022004,060952534022004,"Block 2004, Block Group 2, Census Tract 2534.02, Solano County, California",24,23,1
1000000US060952534022005,060952534022005,"Block 2005, Block Group 2, Census Tract 2534.02, Solano County, California",19,19,0
1000000US060952534022006,060952534022006,"Block 2006, Block Group 2, Census Tract 2534.02, Solano County, California",40,37,3
1000000US060952534022007,060952534022007,"Block 2007, Block Group 2, Census Tract 2534.02, Solano County, California",12,12,0
1000000US060952534022008,060952534022008,"Block 2008, Block Group 2, Census Tract 2534.02, Solano County, California",26,25,1
1000000US060952534022009,060952534022009,"Block 2009, Block Group 2, Census Tract 2534.02, Solano County, California",40,39,1
1000000US060952534022010,060952534022010,"Block 2010, Block Group 2, Census Tract 2534.02, Solano County, California",15,14,1
1000000US060952534022011,060952534022011,"Block 2011, Block Group 2, Census Tract 2534.02, Solano County, California",15,14,1
1000000US060952534022012,060952534022012,"Block 2012, Block Group 2, Census Tract 2534.02, Solano County, California",23,20,3
1000000US060952534023000,060952534023000,"Block 3000, Block Group 3, Census Tract 2534.02, Solano County, California",0,0,0
1000000US060952534023001,060952534023001,"Block 3001, Block Group 3, Census Tract 2534.02, Solano County, California",2,1,1
1000000US060952534023002,060952534023002,"Block 3002, Block Group 3, Census Tract 2534.02, Solano County, California",12,9,3
1000000US060952534023003,060952534023003,"Block 3003, Block Group 3, Census Tract 2534.02, Solano County, California",0,0,0
1000000US060952534023004,060952534023004,"Block 3004, Block Group 3, Census Tract 2534.02, Solano County, California",0,0,0
1000000US060952534023005,060952534023005,"Block 3005, Block Group 3, Census Tract 2534.02, Solano County, California",13,12,1
1000000US060952534023006,060952534023006,"Block 3006, Block Group 3, Census Tract 2534.02, Solano County, California",50,48,2
1000000US060952534023007,060952534023007,"Block 3007, Block Group 3, Census Tract 2534.02, Solano County, California",11,10,1
1000000US060952534023008,060952534023008,"Block 3008, Block Group 3, Census Tract 2534.02, Solano County, California",7,7,0
1000000US060952534023009,060952534023009,"Block 3009, Block Group 3, Census Tract 2534.02, Solano County, California",9,7,2
1000000US060952534023010,060952534023010,"Block 3010, Block Group 3, Census Tract 2534.02, Solano County, California",17,15,2
1000000US060952534023011,060952534023011,"Block 3011, Block Group 3, Census Tract 2534.02, Solano County, California",9,9,0
1000000US060952534023012,060952534023012,"Block 3012, Block Group 3, Census Tract 2534.02, Solano County, California",14,13,1
1000000US060952534023013,060952534023013,"Block 3013, Block Group 3, Census Tract 2534.02, Solano County, California",5,3,2
1000000US060952534023014,060952534023014,"Block 3014, Block Group 3, Census Tract 2534.02, Solano County, California",15,15,0
1000000US060952534023015,060952534023015,"Block 3015, Block Group 3, Census Tract 2534.02, Solano County, California",21,19,2
1000000US060952534023016,060952534023016,"Block 3016, Block Group 3, Census Tract 2534.02, Solano County, California",39,37,2
1000000US060952534023017,060952534023017,"Block 3017, Block Group 3, Census Tract 2534.02, Solano County, California",37,35,2
1000000US060952534023018,060952534023018,"Block 3018, Block Group 3, Census Tract 2534.02, Solano County, California",14,14,0
1000000US060952534023019,060952534023019,"Block 3019, Block Group 3, Census Tract 2534.02, Solano County, California",41,37,4
1000000US060952534023020,060952534023020,"Block 3020, Block Group 3, Census Tract 2534.02, Solano County, California",0,0,0
1000000US060952534023021,060952534023021,"Block 3021, Block Group 3, Census Tract 2534.02, Solano County, California",0,0,0
1000000US060952534024000,060952534024000,"Block 4000, Block Group 4, Census Tract 2534.02, Solano County, California",0,0,0
1000000US060952534024001,060952534024001,"Block 4001, Block Group 4, Census Tract 2534.02, Solano County, California",0,0,0
1000000US060952534024002,060952534024002,"Block 4002, Block Group 4, Census Tract 2534.02, Solano County, California",0,0,0
1000000US060952534024003,060952534024003,"Block 4003, Block Group 4, Census Tract 2534.02, Solano County, California",0,0,0
1000000US060952534024004,060952534024004,"Block 4004, Block Group 4, Census Tract 2534.02, Solano County, California",17,15,2
1000000US060952534024005,060952534024005,"Block 4005, Block Group 4, Census Tract 2534.02, Solano County, California",11,10,1
1000000US060952534024006,060952534024006,"Block 4006, Block Group 4, Census Tract 2534.02, Solano County, California",29,28,1
1000000US060952534024007,060952534024007,"Block 4007, Block Group 4, Census Tract 2534.02, Solano County, California",17,17,0
1000000US060952534024008,060952534024008,"Block 4008, Block Group 4, Census Tract 2534.02, Solano County, California",10,8,2
1000000US060952534024009,060952534024009,"Block 4009, Block Group 4, Census Tract 2534.02, Solano County, California",120,114,6
1000000US060952534024010,060952534024010,"Block 4010, Block Group 4, Census Tract 2534.02, Solano County, California",29,25,4
1000000US060952534024011,060952534024011,"Block 4011, Block Group 4, Census Tract 2534.02, Solano County, California",19,17,2
1000000US060952534024012,060952534024012,"Block 4012, Block Group 4, Census Tract 2534.02, Solano County, California",0,0,0
1000000US060952534024013,060952534024013,"Block 4013, Block Group 4, Census Tract 2534.02, Solano County, California",22,19,3
1000000US060952534024014,060952534024014,"Block 4014, Block Group 4, Census Tract 2534.02, Solano County, California",25,25,0
1000000US060952534024015,060952534024015,"Block 4015, Block Group 4, Census Tract 2534.02, Solano County, California",18,18,0
1000000US060952534024016,060952534024016,"Block 4016, Block Group 4, Census Tract 2534.02, Solano County, California",0,0,0
1000000US060952534024017,060952534024017,"Block 4017, Block Group 4, Census Tract 2534.02, Solano County, California",0,0,0
1000000US060952534024018,060952534024018,"Block 4018, Block Group 4, Census Tract 2534.02, Solano County, California",158,146,12
1000000US060952534024019,060952534024019,"Block 4019, Block Group 4, Census Tract 2534.02, Solano County, California",13,13,0
1000000US060952534024020,060952534024020,"Block 4020, Block Group 4, Census Tract 2534.02, Solano County, California",0,0,0
1000000US060952534024021,060952534024021,"Block 4021, Block Group 4, Census Tract 2534.02, Solano County, California",0,0,0
1000000US060952534024022,060952534024022,"Block 4022, Block Group 4, Census Tract 2534.02, Solano County, California",17,17,0
1000000US060952534024023,060952534024023,"Block 4023, Block Group 4, Census Tract 2534.02, Solano County, California",17,15,2
1000000US060952534024024,060952534024024,"Block 4024, Block Group 4, Census Tract 2534.02, Solano County, California",23,23,0
1000000US060952534024025,060952534024025,"Block 4025, Block Group 4, Census Tract 2534.02, Solano County, California",88,84,4
1000000US060952534024026,060952534024026,"Block 4026, Block Group 4, Census Tract 2534.02, Solano County, California",0,0,0
1000000US060952534024027,060952534024027,"Block 4027, Block Group 4, Census Tract 2534.02, Solano County, California",21,21,0
1000000US060952534024028,060952534024028,"Block 4028, Block Group 4, Census Tract 2534.02, Solano County, California",0,0,0
1000000US060952534024029,060952534024029,"Block 4029, Block Group 4, Census Tract 2534.02, Solano County, California",4,4,0
1000000US060952534024030,060952534024030,"Block 4030, Block Group 4, Census Tract 2534.02, Solano County, California",1,1,0
1000000US060952534024031,060952534024031,"Block 4031, Block Group 4, Census Tract 2534.02, Solano County, California",1,1,0
1000000US060952534024032,060952534024032,"Block 4032, Block Group 4, Census Tract 2534.02, Solano County, California",3,3,0
1000000US060952534024033,060952534024033,"Block 4033, Block Group 4, Census Tract 2534.02, Solano County, California",24,22,2
1000000US060952534024034,060952534024034,"Block 4034, Block Group 4, Census Tract 2534.02, Solano County, California",13,12,1
1000000US060952534024035,060952534024035,"Block 4035, Block Group 4, Census Tract 2534.02, Solano County, California",13,13,0
1000000US060952534024036,060952534024036,"Block 4036, Block Group 4, Census Tract 2534.02, Solano County, California",24,24,0
1000000US060952534024037,060952534024037,"Block 4037, Block Group 4, Census Tract 2534.02, Solano County, California",33,31,2
1000000US060952534024038,060952534024038,"Block 4038, Block Group 4, Census Tract 2534.02, Solano County, California",10,10,0
1000000US060952534024039,060952534024039,"Block 4039, Block Group 4, Census Tract 2534.02, Solano County, California",11,9,2
1000000US060952534025000,060952534025000,"Block 5000, Block Group 5, Census Tract 2534.02, Solano County, California",0,0,0
1000000US060952534025001,060952534025001,"Block 5001, Block Group 5, Census Tract 2534.02, Solano County, California",45,43,2
1000000US060952534025002,060952534025002,"Block 5002, Block Group 5, Census Tract 2534.02, Solano County, California",7,7,0
1000000US060952534025003,060952534025003,"Block 5003, Block Group 5, Census Tract 2534.02, Solano County, California",7,7,0
1000000US060952534025004,060952534025004,"Block 5004, Block Group 5, Census Tract 2534.02, Solano County, California",47,44,3
1000000US060952534025005,060952534025005,"Block 5005, Block Group 5, Census Tract 2534.02, Solano County, California",9,7,2
1000000US060952534025006,060952534025006,"Block 5006, Block Group 5, Census Tract 2534.02, Solano County, California",8,8,0
1000000US060952534025007,060952534025007,"Block 5007, Block Group 5, Census Tract 2534.02, Solano County, California",0,0,0
1000000US060952534025008,060952534025008,"Block 5008, Block Group 5, Census Tract 2534.02, Solano County, California",24,24,0
1000000US060952534025009,060952534025009,"Block 5009, Block Group 5, Census Tract 2534.02, Solano County, California",14,13,1
1000000US060952534025010,060952534025010,"Block 5010, Block Group 5, Census Tract 2534.02, Solano County, California",6,6,0
1000000US060952534025011,060952534025011,"Block 5011, Block Group 5, Census Tract 2534.02, Solano County, California",9,9,0
1000000US060952534025012,060952534025012,"Block 5012, Block Group 5, Census Tract 2534.02, Solano County, California",7,7,0
1000000US060952534025013,060952534025013,"Block 5013, Block Group 5, Census Tract 2534.02, Solano County, California",20,20,0
1000000US060952534025014,060952534025014,"Block 5014, Block Group 5, Census Tract 2534.02, Solano County, California",16,15,1
1000000US060952534025015,060952534025015,"Block 5015, Block Group 5, Census Tract 2534.02, Solano County, California",36,32,4
1000000US060952534025016,060952534025016,"Block 5016, Block Group 5, Census Tract 2534.02, Solano County, California",25,24,1
1000000US060952534025017,060952534025017,"Block 5017, Block Group 5, Census Tract 2534.02, Solano County, California",16,16,0
1000000US060952534025018,060952534025018,"Block 5018, Block Group 5, Census Tract 2534.02, Solano County, California",8,8,0
1000000US060952534025019,060952534025019,"Block 5019, Block Group 5, Census Tract 2534.02, Solano County, California",46,43,3
1000000US060952534025020,060952534025020,"Block 5020, Block Group 5, Census Tract 2534.02, Solano County, California",0,0,0
1000000US060952534025021,060952534025021,"Block 5021, Block Group 5, Census Tract 2534.02, Solano County, California",0,0,0
1000000US060952534025022,060952534025022,"Block 5022, Block Group 5, Census Tract 2534.02, Solano County, California",14,14,0
1000000US060952534025023,060952534025023,"Block 5023, Block Group 5, Census Tract 2534.02, Solano County, California",0,0,0
1000000US060952534025024,060952534025024,"Block 5024, Block Group 5, Census Tract 2534.02, Solano County, California",36,36,0
1000000US060952534025025,060952534025025,"Block 5025, Block Group 5, Census Tract 2534.02, Solano County, California",0,0,0
1000000US060952534025026,060952534025026,"Block 5026, Block Group 5, Census Tract 2534.02, Solano County, California",11,11,0
1000000US060952534025027,060952534025027,"Block 5027, Block Group 5, Census Tract 2534.02, Solano County, California",1,1,0
1000000US060952534025028,060952534025028,"Block 5028, Block Group 5, Census Tract 2534.02, Solano County, California",0,0,0
1000000US060952534025029,060952534025029,"Block 5029, Block Group 5, Census Tract 2534.02, Solano County, California",1,1,0
1000000US060952534025030,060952534025030,"Block 5030, Block Group 5, Census Tract 2534.02, Solano County, California",24,24,0
1000000US060952534025031,060952534025031,"Block 5031, Block Group 5, Census Tract 2534.02, Solano County, California",18,18,0
1000000US060952534031000,060952534031000,"Block 1000, Block Group 1, Census Tract 2534.03, Solano County, California",43,40,3
1000000US060952534031001,060952534031001,"Block 1001, Block Group 1, Census Tract 2534.03, Solano County, California",10,9,1
1000000US060952534031002,060952534031002,"Block 1002, Block Group 1, Census Tract 2534.03, Solano County, California",36,33,3
1000000US060952534031003,060952534031003,"Block 1003, Block Group 1, Census Tract 2534.03, Solano County, California",38,36,2
1000000US060952534031004,060952534031004,"Block 1004, Block Group 1, Census Tract 2534.03, Solano County, California",29,28,1
1000000US060952534031005,060952534031005,"Block 1005, Block Group 1, Census Tract 2534.03, Solano County, California",37,34,3
1000000US060952534031006,060952534031006,"Block 1006, Block Group 1, Census Tract 2534.03, Solano County, California",43,39,4
1000000US060952534031007,060952534031007,"Block 1007, Block Group 1, Census Tract 2534.03, Solano County, California",66,64,2
1000000US060952534031008,060952534031008,"Block 1008, Block Group 1, Census Tract 2534.03, Solano County, California",10,10,0
1000000US060952534031009,060952534031009,"Block 1009, Block Group 1, Census Tract 2534.03, Solano County, California",14,14,0
1000000US060952534031010,060952534031010,"Block 1010, Block Group 1, Census Tract 2534.03, Solano County, California",8,8,0
1000000US060952534031011,060952534031011,"Block 1011, Block Group 1, Census Tract 2534.03, Solano County, California",24,24,0
1000000US060952534031012,060952534031012,"Block 1012, Block Group 1, Census Tract 2534.03, Solano County, California",17,17,0
1000000US060952534031013,060952534031013,"Block 1013, Block Group 1, Census Tract 2534.03, Solano County, California",0,0,0
1000000US060952534031014,060952534031014,"Block 1014, Block Group 1, Census Tract 2534.03, Solano County, California",38,38,0
1000000US060952534031015,060952534031015,"Block 1015, Block Group 1, Census Tract 2534.03, Solano County, California",22,22,0
1000000US060952534031016,060952534031016,"Block 1016, Block Group 1, Census Tract 2534.03, Solano County, California",23,23,0
1000000US060952534031017,060952534031017,"Block 1017, Block Group 1, Census Tract 2534.03, Solano County, California",13,12,1
1000000US060952534031018,060952534031018,"Block 1018, Block Group 1, Census Tract 2534.03, Solano County, California",12,12,0
1000000US060952534031019,060952534031019,"Block 1019, Block Group 1, Census Tract 2534.03, Solano County, California",16,16,0
1000000US060952534031020,060952534031020,"Block 1020, Block Group 1, Census Tract 2534.03, Solano County, California",33,30,3
1000000US060952534031021,060952534031021,"Block 1021, Block Group 1, Census Tract 2534.03, Solano County, California",0,0,0
1000000US060952534031022,060952534031022,"Block 1022, Block Group 1, Census Tract 2534.03, Solano County, California",0,0,0
1000000US060952534032000,060952534032000,"Block 2000, Block Group 2, Census Tract 2534.03, Solano County, California",33,32,1
1000000US060952534032001,060952534032001,"Block 2001, Block Group 2, Census Tract 2534.03, Solano County, California",93,89,4
1000000US060952534032002,060952534032002,"Block 2002, Block Group 2, Census Tract 2534.03, Solano County, California",22,21,1
1000000US060952534032003,060952534032003,"Block 2003, Block Group 2, Census Tract 2534.03, Solano County, California",15,14,1
1000000US060952534032004,060952534032004,"Block 2004, Block Group 2, Census Tract 2534.03, Solano County, California",12,12,0
1000000US060952534032005,060952534032005,"Block 2005, Block Group 2, Census Tract 2534.03, Solano County, California",11,11,0
1000000US060952534032006,060952534032006,"Block 2006, Block Group 2, Census Tract 2534.03, Solano County, California",13,12,1
1000000US060952534032007,060952534032007,"Block 2007, Block Group 2, Census Tract 2534.03, Solano County, California",12,12,0
1000000US060952534032008,060952534032008,"Block 2008, Block Group 2, Census Tract 2534.03, Solano County, California",29,28,1
1000000US060952534032009,060952534032009,"Block 2009, Block Group 2, Census Tract 2534.03, Solano County, California",52,51,1
1000000US060952534032010,060952534032010,"Block 2010, Block Group 2, Census Tract 2534.03, Solano County, California",9,7,2
1000000US060952534032011,060952534032011,"Block 2011, Block Group 2, Census Tract 2534.03, Solano County, California",25,24,1
1000000US060952534032012,060952534032012,"Block 2012, Block Group 2, Census Tract 2534.03, Solano County, California",27,25,2
1000000US060952534032013,060952534032013,"Block 2013, Block Group 2, Census Tract 2534.03, Solano County, California",16,16,0
1000000US060952534032014,060952534032014,"Block 2014, Block Group 2, Census Tract 2534.03, Solano County, California",9,7,2
1000000US060952534032015,060952534032015,"Block 2015, Block Group 2, Census Tract 2534.03, Solano County, California",0,0,0
1000000US060952534032016,060952534032016,"Block 2016, Block Group 2, Census Tract 2534.03, Solano County, California",10,9,1
1000000US060952534033000,060952534033000,"Block 3000, Block Group 3, Census Tract 2534.03, Solano County, California",0,0,0
1000000US060952534033001,060952534033001,"Block 3001, Block Group 3, Census Tract 2534.03, Solano County, California",73,69,4
1000000US060952534033002,060952534033002,"Block 3002, Block Group 3, Census Tract 2534.03, Solano County, California",44,44,0
1000000US060952534033003,060952534033003,"Block 3003, Block Group 3, Census Tract 2534.03, Solano County, California",14,14,0
1000000US060952534033004,060952534033004,"Block 3004, Block Group 3, Census Tract 2534.03, Solano County, California",41,39,2
1000000US060952534033005,060952534033005,"Block 3005, Block Group 3, Census Tract 2534.03, Solano County, California",100,94,6
1000000US060952534033006,060952534033006,"Block 3006, Block Group 3, Census Tract 2534.03, Solano County, California",26,26,0
1000000US060952534033007,060952534033007,"Block 3007, Block Group 3, Census Tract 2534.03, Solano County, California",17,16,1
1000000US060952534033008,060952534033008,"Block 3008, Block Group 3, Census Tract 2534.03, Solano County, California",12,11,1
1000000US060952534033009,060952534033009,"Block 3009, Block Group 3, Census Tract 2534.03, Solano County, California",12,12,0
1000000US060952534033010,060952534033010,"Block 3010, Block Group 3, Census Tract 2534.03, Solano County, California",88,86,2
1000000US060952534033011,060952534033011,"Block 3011, Block Group 3, Census Tract 2534.03, Solano County, California",104,100,4
1000000US060952534033012,060952534033012,"Block 3012, Block Group 3, Census Tract 2534.03, Solano County, California",20,20,0
1000000US060952534033013,060952534033013,"Block 3013, Block Group 3, Census Tract 2534.03, Solano County, California",4,3,1
1000000US060952534033014,060952534033014,"Block 3014, Block Group 3, Census Tract 2534.03, Solano County, California",1,1,0
1000000US060952534033015,060952534033015,"Block 3015, Block Group 3, Census Tract 2534.03, Solano County, California",0,0,0
1000000US060952534033016,060952534033016,"Block 3016, Block Group 3, Census Tract 2534.03, Solano County, California",40,38,2
1000000US060952534033017,060952534033017,"Block 3017, Block Group 3, Census Tract 2534.03, Solano County, California",62,59,3
1000000US060952534033018,060952534033018,"Block 3018, Block Group 3, Census Tract 2534.03, Solano County, California",37,36,1
1000000US060952534033019,060952534033019,"Block 3019, Block Group 3, Census Tract 2534.03, Solano County, California",0,0,0
1000000US060952534033020,060952534033020,"Block 3020, Block Group 3, Census Tract 2534.03, Solano County, California",12,12,0
1000000US060952534033021,060952534033021,"Block 3021, Block Group 3, Census Tract 2534.03, Solano County, California",0,0,0
1000000US060952534033022,060952534033022,"Block 3022, Block Group 3, Census Tract 2534.03, Solano County, California",15,10,5
1000000US060952534033023,060952534033023,"Block 3023, Block Group 3, Census Tract 2534.03, Solano County, California",3,3,0
1000000US060952534033024,060952534033024,"Block 3024, Block Group 3, Census Tract 2534.03, Solano County, California",0,0,0
1000000US060952534033025,060952534033025,"Block 3025, Block Group 3, Census Tract 2534.03, Solano County, California",0,0,0
1000000US060952534041000,060952534041000,"Block 1000, Block Group 1, Census Tract 2534.04, Solano County, California",16,16,0
1000000US060952534041001,060952534041001,"Block 1001, Block Group 1, Census Tract 2534.04, Solano County, California",15,15,0
1000000US060952534041002,060952534041002,"Block 1002, Block Group 1, Census Tract 2534.04, Solano County, California",41,41,0
1000000US060952534041003,060952534041003,"Block 1003, Block Group 1, Census Tract 2534.04, Solano County, California",26,24,2
1000000US060952534041004,060952534041004,"Block 1004, Block Group 1, Census Tract 2534.04, Solano County, California",44,44,0
1000000US060952534041005,060952534041005,"Block 1005, Block Group 1, Census Tract 2534.04, Solano County, California",77,74,3
1000000US060952534041006,060952534041006,"Block 1006, Block Group 1, Census Tract 2534.04, Solano County, California",44,40,4
1000000US060952534041007,060952534041007,"Block 1007, Block Group 1, Census Tract 2534.04, Solano County, California",0,0,0
1000000US060952534041008,060952534041008,"Block 1008, Block Group 1, Census Tract 2534.04, Solano County, California",12,11,1
1000000US060952534041009,060952534041009,"Block 1009, Block Group 1, Census Tract 2534.04, Solano County, California",0,0,0
1000000US060952534041010,060952534041010,"Block 1010, Block Group 1, Census Tract 2534.04, Solano County, California",0,0,0
1000000US060952534041011,060952534041011,"Block 1011, Block Group 1, Census Tract 2534.04, Solano County, California",40,39,1
1000000US060952534041012,060952534041012,"Block 1012, Block Group 1, Census Tract 2534.04, Solano County, California",30,28,2
1000000US060952534041013,060952534041013,"Block 1013, Block Group 1, Census Tract 2534.04, Solano County, California",39,34,5
1000000US060952534041014,060952534041014,"Block 1014, Block Group 1, Census Tract 2534.04, Solano County, California",21,20,1
1000000US060952534041015,060952534041015,"Block 1015, Block Group 1, Census Tract 2534.04, Solano County, California",14,13,1
1000000US060952534041016,060952534041016,"Block 1016, Block Group 1, Census Tract 2534.04, Solano County, California",28,25,3
1000000US060952534041017,060952534041017,"Block 1017, Block Group 1, Census Tract 2534.04, Solano County, California",23,21,2
1000000US060952534041018,060952534041018,"Block 1018, Block Group 1, Census Tract 2534.04, Solano County, California",83,61,22
1000000US060952534041019,060952534041019,"Block 1019, Block Group 1, Census Tract 2534.04, Solano County, California",0,0,0
1000000US060952534041020,060952534041020,"Block 1020, Block Group 1, Census Tract 2534.04, Solano County, California",19,19,0
1000000US060952534041021,060952534041021,"Block 1021, Block Group 1, Census Tract 2534.04, Solano County, California",22,22,0
1000000US060952534041022,060952534041022,"Block 1022, Block Group 1, Census Tract 2534.04, Solano County, California",12,12,0
1000000US060952534041023,060952534041023,"Block 1023, Block Group 1, Census Tract 2534.04, Solano County, California",17,16,1
1000000US060952534042000,060952534042000,"Block 2000, Block Group 2, Census Tract 2534.04, Solano County, California",72,67,5
1000000US060952534042001,060952534042001,"Block 2001, Block Group 2, Census Tract 2534.04, Solano County, California",44,41,3
1000000US060952534042002,060952534042002,"Block 2002, Block Group 2, Census Tract 2534.04, Solano County, California",11,11,0
1000000US060952534042003,060952534042003,"Block 2003, Block Group 2, Census Tract 2534.04, Solano County, California",22,22,0
1000000US060952534042004,060952534042004,"Block 2004, Block Group 2, Census Tract 2534.04, Solano County, California",35,35,0
1000000US060952534042005,060952534042005,"Block 2005, Block Group 2, Census Tract 2534.04, Solano County, California",0,0,0
1000000US060952534042006,060952534042006,"Block 2006, Block Group 2, Census Tract 2534.04, Solano County, California",19,19,0
1000000US060952534042007,060952534042007,"Block 2007, Block Group 2, Census Tract 2534.04, Solano County, California",17,17,0
1000000US060952534042008,060952534042008,"Block 2008, Block Group 2, Census Tract 2534.04, Solano County, California",15,14,1
1000000US060952534042009,060952534042009,"Block 2009, Block Group 2, Census Tract 2534.04, Solano County, California",36,36,0
1000000US060952534042010,060952534042010,"Block 2010, Block Group 2, Census Tract 2534.04, Solano County, California",33,29,4
1000000US060952534042011,060952534042011,"Block 2011, Block Group 2, Census Tract 2534.04, Solano County, California",17,14,3
1000000US060952534042012,060952534042012,"Block 2012, Block Group 2, Census Tract 2534.04, Solano County, California",16,16,0
1000000US060952534042013,060952534042013,"Block 2013, Block Group 2, Census Tract 2534.04, Solano County, California",28,26,2
1000000US060952534042014,060952534042014,"Block 2014, Block Group 2, Census Tract 2534.04, Solano County, California",9,9,0
1000000US060952534042015,060952534042015,"Block 2015, Block Group 2, Census Tract 2534.04, Solano County, California",30,27,3
1000000US060952534042016,060952534042016,"Block 2016, Block Group 2, Census Tract 2534.04, Solano County, California",18,18,0
1000000US060952534042017,060952534042017,"Block 2017, Block Group 2, Census Tract 2534.04, Solano County, California",19,18,1
1000000US060952534043000,060952534043000,"Block 3000, Block Group 3, Census Tract 2534.04, Solano County, California",5,5,0
1000000US060952534043001,060952534043001,"Block 3001, Block Group 3, Census Tract 2534.04, Solano County, California",60,57,3
1000000US060952534043002,060952534043002,"Block 3002, Block Group 3, Census Tract 2534.04, Solano County, California",10,10,0
1000000US060952534043003,060952534043003,"Block 3003, Block Group 3, Census Tract 2534.04, Solano County, California",12,12,0
1000000US060952534043004,060952534043004,"Block 3004, Block Group 3, Census Tract 2534.04, Solano County, California",21,21,0
1000000US060952534043005,060952534043005,"Block 3005, Block Group 3, Census Tract 2534.04, Solano County, California",20,20,0
1000000US060952534043006,060952534043006,"Block 3006, Block Group 3, Census Tract 2534.04, Solano County, California",65,64,1
1000000US060952534043007,060952534043007,"Block 3007, Block Group 3, Census Tract 2534.04, Solano County, California",7,7,0
1000000US060952534043008,060952534043008,"Block 3008, Block Group 3, Census Tract 2534.04, Solano County, California",17,15,2
1000000US060952534043009,060952534043009,"Block 3009, Block Group 3, Census Tract 2534.04, Solano County, California",5,5,0
1000000US060952534043010,060952534043010,"Block 3010, Block Group 3, Census Tract 2534.04, Solano County, California",105,97,8
1000000US060952534043011,060952534043011,"Block 3011, Block Group 3, Census Tract 2534.04, Solano County, California",30,30,0
1000000US060952534043012,060952534043012,"Block 3012, Block Group 3, Census Tract 2534.04, Solano County, California",31,29,2
1000000US060952534043013,060952534043013,"Block 3013, Block Group 3, Census Tract 2534.04, Solano County, California",28,27,1
1000000US060952534044000,060952534044000,"Block 4000, Block Group 4, Census Tract 2534.04, Solano County, California",52,52,0
1000000US060952534044001,060952534044001,"Block 4001, Block Group 4, Census Tract 2534.04, Solano County, California",21,20,1
1000000US060952534044002,060952534044002,"Block 4002, Block Group 4, Census Tract 2534.04, Solano County, California",0,0,0
1000000US060952534044003,060952534044003,"Block 4003, Block Group 4, Census Tract 2534.04, Solano County, California",51,50,1
1000000US060952534044004,060952534044004,"Block 4004, Block Group 4, Census Tract 2534.04, Solano County, California",28,26,2
1000000US060952534044005,060952534044005,"Block 4005, Block Group 4, Census Tract 2534.04, Solano County, California",26,24,2
1000000US060952534044006,060952534044006,"Block 4006, Block Group 4, Census Tract 2534.04, Solano County, California",0,0,0
1000000US060952534044007,060952534044007,"Block 4007, Block Group 4, Census Tract 2534.04, Solano County, California",185,181,4
1000000US060952534044008,060952534044008,"Block 4008, Block Group 4, Census Tract 2534.04, Solano County, California",43,41,2
1000000US060952534044009,060952534044009,"Block 4009, Block Group 4, Census Tract 2534.04, Solano County, California",122,115,7
1000000US060952534044010,060952534044010,"Block 4010, Block Group 4, Census Tract 2534.04, Solano County, California",15,14,1
1000000US060952534044011,060952534044011,"Block 4011, Block Group 4, Census Tract 2534.04, Solano County, California",28,27,1
1000000US060952534044012,060952534044012,"Block 4012, Block Group 4, Census Tract 2534.04, Solano County, California",52,52,0
1000000US060952534044013,060952534044013,"Block 4013, Block Group 4, Census Tract 2534.04, Solano County, California",0,0,0
1000000US060952534044014,060952534044014,"Block 4014, Block Group 4, Census Tract 2534.04, Solano County, California",29,29,0
1000000US060952534044015,060952534044015,"Block 4015, Block Group 4, Census Tract 2534.04, Solano County, California",31,28,3
1000000US060952534044016,060952534044016,"Block 4016, Block Group 4, Census Tract 2534.04, Solano County, California",20,20,0
1000000US060952534044017,060952534044017,"Block 4017, Block Group 4, Census Tract 2534.04, Solano County, California",0,0,0
1000000US060952534044018,060952534044018,"Block 4018, Block Group 4, Census Tract 2534.04, Solano County, California",20,18,2
1000000US060952535001000,060952535001000,"Block 1000, Block Group 1, Census Tract 2535, Solano County, California",0,0,0
1000000US060952535001001,060952535001001,"Block 1001, Block Group 1, Census Tract 2535, Solano County, California",0,0,0
1000000US060952535001002,060952535001002,"Block 1002, Block Group 1, Census Tract 2535, Solano County, California",0,0,0
1000000US060952535001003,060952535001003,"Block 1003, Block Group 1, Census Tract 2535, Solano County, California",0,0,0
1000000US060952535001004,060952535001004,"Block 1004, Block Group 1, Census Tract 2535, Solano County, California",0,0,0
1000000US060952535001005,060952535001005,"Block 1005, Block Group 1, Census Tract 2535, Solano County, California",0,0,0
1000000US060952535001006,060952535001006,"Block 1006, Block Group 1, Census Tract 2535, Solano County, California",0,0,0
1000000US060952535001007,060952535001007,"Block 1007, Block Group 1, Census Tract 2535, Solano County, California",1,1,0
1000000US060952535001008,060952535001008,"Block 1008, Block Group 1, Census Tract 2535, Solano County, California",0,0,0
1000000US060952535001009,060952535001009,"Block 1009, Block Group 1, Census Tract 2535, Solano County, California",0,0,0
1000000US060952535001010,060952535001010,"Block 1010, Block Group 1, Census Tract 2535, Solano County, California",2,1,1
1000000US060952535001011,060952535001011,"Block 1011, Block Group 1, Census Tract 2535, Solano County, California",0,0,0
1000000US060952535001012,060952535001012,"Block 1012, Block Group 1, Census Tract 2535, Solano County, California",0,0,0
1000000US060952535001013,060952535001013,"Block 1013, Block Group 1, Census Tract 2535, Solano County, California",0,0,0
1000000US060952535001014,060952535001014,"Block 1014, Block Group 1, Census Tract 2535, Solano County, California",5,4,1
1000000US060952535001015,060952535001015,"Block 1015, Block Group 1, Census Tract 2535, Solano County, California",1,1,0
1000000US060952535001016,060952535001016,"Block 1016, Block Group 1, Census Tract 2535, Solano County, California",0,0,0
1000000US060952535001017,060952535001017,"Block 1017, Block Group 1, Census Tract 2535, Solano County, California",0,0,0
1000000US060952535001018,060952535001018,"Block 1018, Block Group 1, Census Tract 2535, Solano County, California",0,0,0
1000000US060952535001019,060952535001019,"Block 1019, Block Group 1, Census Tract 2535, Solano County, California",0,0,0
1000000US060952535001020,060952535001020,"Block 1020, Block Group 1, Census Tract 2535, Solano County, California",0,0,0
1000000US060952535001021,060952535001021,"Block 1021, Block Group 1, Census Tract 2535, Solano County, California",0,0,0
1000000US060952535001022,060952535001022,"Block 1022, Block Group 1, Census Tract 2535, Solano County, California",2,1,1
1000000US060952535001023,060952535001023,"Block 1023, Block Group 1, Census Tract 2535, Solano County, California",16,4,12
1000000US060952535001024,060952535001024,"Block 1024, Block Group 1, Census Tract 2535, Solano County, California",5,5,0
1000000US060952535001025,060952535001025,"Block 1025, Block Group 1, Census Tract 2535, Solano County, California",2,2,0
1000000US060952535001026,060952535001026,"Block 1026, Block Group 1, Census Tract 2535, Solano County, California",7,7,0
1000000US060952535001027,060952535001027,"Block 1027, Block Group 1, Census Tract 2535, Solano County, California",5,4,1
1000000US060952535001028,060952535001028,"Block 1028, Block Group 1, Census Tract 2535, Solano County, California",1,1,0
1000000US060952535001029,060952535001029,"Block 1029, Block Group 1, Census Tract 2535, Solano County, California",0,0,0
1000000US060952535001030,060952535001030,"Block 1030, Block Group 1, Census Tract 2535, Solano County, California",3,3,0
1000000US060952535001031,060952535001031,"Block 1031, Block Group 1, Census Tract 2535, Solano County, California",0,0,0
1000000US060952535001032,060952535001032,"Block 1032, Block Group 1, Census Tract 2535, Solano County, California",0,0,0
1000000US060952535001033,060952535001033,"Block 1033, Block Group 1, Census Tract 2535, Solano County, California",5,5,0
1000000US060952535001034,060952535001034,"Block 1034, Block Group 1, Census Tract 2535, Solano County, California",3,3,0
1000000US060952535001035,060952535001035,"Block 1035, Block Group 1, Census Tract 2535, Solano County, California",16,4,12
1000000US060952535001036,060952535001036,"Block 1036, Block Group 1, Census Tract 2535, Solano County, California",0,0,0
1000000US060952535001037,060952535001037,"Block 1037, Block Group 1, Census Tract 2535, Solano County, California",4,3,1
1000000US060952535001038,060952535001038,"Block 1038, Block Group 1, Census Tract 2535, Solano County, California",0,0,0
1000000US060952535001039,060952535001039,"Block 1039, Block Group 1, Census Tract 2535, Solano County, California",0,0,0
1000000US060952535001040,060952535001040,"Block 1040, Block Group 1, Census Tract 2535, Solano County, California",0,0,0
1000000US060952535001041,060952535001041,"Block 1041, Block Group 1, Census Tract 2535, Solano County, California",2,2,0
1000000US060952535001042,060952535001042,"Block 1042, Block Group 1, Census Tract 2535, Solano County, California",0,0,0
1000000US060952535001043,060952535001043,"Block 1043, Block Group 1, Census Tract 2535, Solano County, California",0,0,0
1000000US060952535001044,060952535001044,"Block 1044, Block Group 1, Census Tract 2535, Solano County, California",0,0,0
1000000US060952535001045,060952535001045,"Block 1045, Block Group 1, Census Tract 2535, Solano County, California",2,2,0
1000000US060952535001046,060952535001046,"Block 1046, Block Group 1, Census Tract 2535, Solano County, California",0,0,0
1000000US060952535001047,060952535001047,"Block 1047, Block Group 1, Census Tract 2535, Solano County, California",0,0,0
1000000US060952535001048,060952535001048,"Block 1048, Block Group 1, Census Tract 2535, Solano County, California",0,0,0
1000000US060952535001049,060952535001049,"Block 1049, Block Group 1, Census Tract 2535, Solano County, California",0,0,0
1000000US060952535001050,060952535001050,"Block 1050, Block Group 1, Census Tract 2535, Solano County, California",0,0,0
1000000US060952535001051,060952535001051,"Block 1051, Block Group 1, Census Tract 2535, Solano County, California",0,0,0
1000000US060952535001052,060952535001052,"Block 1052, Block Group 1, Census Tract 2535, Solano County, California",0,0,0
1000000US060952535001053,060952535001053,"Block 1053, Block Group 1, Census Tract 2535, Solano County, California",0,0,0
1000000US060952535001054,060952535001054,"Block 1054, Block Group 1, Census Tract 2535, Solano County, California",7,7,0
1000000US060952535001055,060952535001055,"Block 1055, Block Group 1, Census Tract 2535, Solano County, California",0,0,0
1000000US060952535001056,060952535001056,"Block 1056, Block Group 1, Census Tract 2535, Solano County, California",3,3,0
1000000US060952535001057,060952535001057,"Block 1057, Block Group 1, Census Tract 2535, Solano County, California",0,0,0
1000000US060952535001058,060952535001058,"Block 1058, Block Group 1, Census Tract 2535, Solano County, California",0,0,0
1000000US060952535001059,060952535001059,"Block 1059, Block Group 1, Census Tract 2535, Solano County, California",0,0,0
1000000US060952535001060,060952535001060,"Block 1060, Block Group 1, Census Tract 2535, Solano County, California",0,0,0
1000000US060952535001061,060952535001061,"Block 1061, Block Group 1, Census Tract 2535, Solano County, California",1,1,0
1000000US060952535001062,060952535001062,"Block 1062, Block Group 1, Census Tract 2535, Solano County, California",0,0,0
1000000US060952535001063,060952535001063,"Block 1063, Block Group 1, Census Tract 2535, Solano County, California",0,0,0
1000000US060952535001064,060952535001064,"Block 1064, Block Group 1, Census Tract 2535, Solano County, California",1,1,0
1000000US060952535001065,060952535001065,"Block 1065, Block Group 1, Census Tract 2535, Solano County, California",0,0,0
1000000US060952535001066,060952535001066,"Block 1066, Block Group 1, Census Tract 2535, Solano County, California",0,0,0
1000000US060952535001067,060952535001067,"Block 1067, Block Group 1, Census Tract 2535, Solano County, California",0,0,0
1000000US060952535001068,060952535001068,"Block 1068, Block Group 1, Census Tract 2535, Solano County, California",2,2,0
1000000US060952535001069,060952535001069,"Block 1069, Block Group 1, Census Tract 2535, Solano County, California",0,0,0
1000000US060952535001070,060952535001070,"Block 1070, Block Group 1, Census Tract 2535, Solano County, California",1,1,0
1000000US060952535001071,060952535001071,"Block 1071, Block Group 1, Census Tract 2535, Solano County, California",0,0,0
1000000US060952535001072,060952535001072,"Block 1072, Block Group 1, Census Tract 2535, Solano County, California",3,3,0
1000000US060952535001073,060952535001073,"Block 1073, Block Group 1, Census Tract 2535, Solano County, California",3,3,0
1000000US060952535001074,060952535001074,"Block 1074, Block Group 1, Census Tract 2535, Solano County, California",0,0,0
1000000US060952535001075,060952535001075,"Block 1075, Block Group 1, Census Tract 2535, Solano County, California",0,0,0
1000000US060952535001076,060952535001076,"Block 1076, Block Group 1, Census Tract 2535, Solano County, California",0,0,0
1000000US060952535001077,060952535001077,"Block 1077, Block Group 1, Census Tract 2535, Solano County, California",0,0,0
1000000US060952535001078,060952535001078,"Block 1078, Block Group 1, Census Tract 2535, Solano County, California",0,0,0
1000000US060952535001079,060952535001079,"Block 1079, Block Group 1, Census Tract 2535, Solano County, California",0,0,0
1000000US060952535001080,060952535001080,"Block 1080, Block Group 1, Census Tract 2535, Solano County, California",0,0,0
1000000US060952535001081,060952535001081,"Block 1081, Block Group 1, Census Tract 2535, Solano County, California",0,0,0
1000000US060952535001082,060952535001082,"Block 1082, Block Group 1, Census Tract 2535, Solano County, California",0,0,0
1000000US060952535001083,060952535001083,"Block 1083, Block Group 1, Census Tract 2535, Solano County, California",3,3,0
1000000US060952535001084,060952535001084,"Block 1084, Block Group 1, Census Tract 2535, Solano County, California",1,1,0
1000000US060952535001085,060952535001085,"Block 1085, Block Group 1, Census Tract 2535, Solano County, California",0,0,0
1000000US060952535001086,060952535001086,"Block 1086, Block Group 1, Census Tract 2535, Solano County, California",3,3,0
1000000US060952535001087,060952535001087,"Block 1087, Block Group 1, Census Tract 2535, Solano County, California",1,0,1
1000000US060952535001088,060952535001088,"Block 1088, Block Group 1, Census Tract 2535, Solano County, California",0,0,0
1000000US060952535001089,060952535001089,"Block 1089, Block Group 1, Census Tract 2535, Solano County, California",0,0,0
1000000US060952535001090,060952535001090,"Block 1090, Block Group 1, Census Tract 2535, Solano County, California",1,1,0
1000000US060952535001091,060952535001091,"Block 1091, Block Group 1, Census Tract 2535, Solano County, California",0,0,0
1000000US060952535001092,060952535001092,"Block 1092, Block Group 1, Census Tract 2535, Solano County, California",2,2,0
1000000US060952535001093,060952535001093,"Block 1093, Block Group 1, Census Tract 2535, Solano County, California",4,4,0
1000000US060952535001094,060952535001094,"Block 1094, Block Group 1, Census Tract 2535, Solano County, California",1,1,0
1000000US060952535001095,060952535001095,"Block 1095, Block Group 1, Census Tract 2535, Solano County, California",0,0,0
1000000US060952535001096,060952535001096,"Block 1096, Block Group 1, Census Tract 2535, Solano County, California",1,1,0
1000000US060952535001097,060952535001097,"Block 1097, Block Group 1, Census Tract 2535, Solano County, California",0,0,0
1000000US060952535001098,060952535001098,"Block 1098, Block Group 1, Census Tract 2535, Solano County, California",0,0,0
1000000US060952535001099,060952535001099,"Block 1099, Block Group 1, Census Tract 2535, Solano County, California",3,2,1
1000000US060952535001100,060952535001100,"Block 1100, Block Group 1, Census Tract 2535, Solano County, California",0,0,0
1000000US060952535001101,060952535001101,"Block 1101, Block Group 1, Census Tract 2535, Solano County, California",0,0,0
1000000US060952535001102,060952535001102,"Block 1102, Block Group 1, Census Tract 2535, Solano County, California",0,0,0
1000000US060952535001103,060952535001103,"Block 1103, Block Group 1, Census Tract 2535, Solano County, California",0,0,0
1000000US060952535001104,060952535001104,"Block 1104, Block Group 1, Census Tract 2535, Solano County, California",1,1,0
1000000US060952535001105,060952535001105,"Block 1105, Block Group 1, Census Tract 2535, Solano County, California",0,0,0
1000000US060952535001106,060952535001106,"Block 1106, Block Group 1, Census Tract 2535, Solano County, California",0,0,0
1000000US060952535001107,060952535001107,"Block 1107, Block Group 1, Census Tract 2535, Solano County, California",0,0,0
1000000US060952535001108,060952535001108,"Block 1108, Block Group 1, Census Tract 2535, Solano County, California",5,5,0
1000000US060952535001109,060952535001109,"Block 1109, Block Group 1, Census Tract 2535, Solano County, California",0,0,0
1000000US060952535001110,060952535001110,"Block 1110, Block Group 1, Census Tract 2535, Solano County, California",0,0,0
1000000US060952535001111,060952535001111,"Block 1111, Block Group 1, Census Tract 2535, Solano County, California",0,0,0
1000000US060952535001112,060952535001112,"Block 1112, Block Group 1, Census Tract 2535, Solano County, California",1,1,0
1000000US060952535001113,060952535001113,"Block 1113, Block Group 1, Census Tract 2535, Solano County, California",0,0,0
1000000US060952535001114,060952535001114,"Block 1114, Block Group 1, Census Tract 2535, Solano County, California",0,0,0
1000000US060952535001115,060952535001115,"Block 1115, Block Group 1, Census Tract 2535, Solano County, California",0,0,0
1000000US060952535001116,060952535001116,"Block 1116, Block Group 1, Census Tract 2535, Solano County, California",0,0,0
1000000US060952535001117,060952535001117,"Block 1117, Block Group 1, Census Tract 2535, Solano County, California",0,0,0
1000000US060952535001118,060952535001118,"Block 1118, Block Group 1, Census Tract 2535, Solano County, California",0,0,0
1000000US060952535001119,060952535001119,"Block 1119, Block Group 1, Census Tract 2535, Solano County, California",0,0,0
1000000US060952535001120,060952535001120,"Block 1120, Block Group 1, Census Tract 2535, Solano County, California",0,0,0
1000000US060952535001121,060952535001121,"Block 1121, Block Group 1, Census Tract 2535, Solano County, California",0,0,0
1000000US060952535001122,060952535001122,"Block 1122, Block Group 1, Census Tract 2535, Solano County, California",0,0,0
1000000US060952535001123,060952535001123,"Block 1123, Block Group 1, Census Tract 2535, Solano County, California",0,0,0
1000000US060952535001124,060952535001124,"Block 1124, Block Group 1, Census Tract 2535, Solano County, California",0,0,0
1000000US060952535001125,060952535001125,"Block 1125, Block Group 1, Census Tract 2535, Solano County, California",0,0,0
1000000US060952535001126,060952535001126,"Block 1126, Block Group 1, Census Tract 2535, Solano County, California",0,0,0
1000000US060952535001127,060952535001127,"Block 1127, Block Group 1, Census Tract 2535, Solano County, California",0,0,0
1000000US060952535001128,060952535001128,"Block 1128, Block Group 1, Census Tract 2535, Solano County, California",0,0,0
1000000US060952535001129,060952535001129,"Block 1129, Block Group 1, Census Tract 2535, Solano County, California",0,0,0
1000000US060952535001130,060952535001130,"Block 1130, Block Group 1, Census Tract 2535, Solano County, California",0,0,0
1000000US060952535001131,060952535001131,"Block 1131, Block Group 1, Census Tract 2535, Solano County, California",0,0,0
1000000US060952535001132,060952535001132,"Block 1132, Block Group 1, Census Tract 2535, Solano County, California",0,0,0
1000000US060952535001133,060952535001133,"Block 1133, Block Group 1, Census Tract 2535, Solano County, California",0,0,0
1000000US060952535001134,060952535001134,"Block 1134, Block Group 1, Census Tract 2535, Solano County, California",0,0,0
1000000US060952535001135,060952535001135,"Block 1135, Block Group 1, Census Tract 2535, Solano County, California",0,0,0
1000000US060952535001136,060952535001136,"Block 1136, Block Group 1, Census Tract 2535, Solano County, California",0,0,0
1000000US060952535001137,060952535001137,"Block 1137, Block Group 1, Census Tract 2535, Solano County, California",0,0,0
1000000US060952535001138,060952535001138,"Block 1138, Block Group 1, Census Tract 2535, Solano County, California",0,0,0
1000000US060952535001139,060952535001139,"Block 1139, Block Group 1, Census Tract 2535, Solano County, California",0,0,0
1000000US060952535001140,060952535001140,"Block 1140, Block Group 1, Census Tract 2535, Solano County, California",2,1,1
1000000US060952535001141,060952535001141,"Block 1141, Block Group 1, Census Tract 2535, Solano County, California",0,0,0
1000000US060952535001142,060952535001142,"Block 1142, Block Group 1, Census Tract 2535, Solano County, California",0,0,0
1000000US060952535001143,060952535001143,"Block 1143, Block Group 1, Census Tract 2535, Solano County, California",0,0,0
1000000US060952535001144,060952535001144,"Block 1144, Block Group 1, Census Tract 2535, Solano County, California",0,0,0
1000000US060952535001145,060952535001145,"Block 1145, Block Group 1, Census Tract 2535, Solano County, California",0,0,0
1000000US060952535001146,060952535001146,"Block 1146, Block Group 1, Census Tract 2535, Solano County, California",0,0,0
1000000US060952535001147,060952535001147,"Block 1147, Block Group 1, Census Tract 2535, Solano County, California",0,0,0
1000000US060952535001148,060952535001148,"Block 1148, Block Group 1, Census Tract 2535, Solano County, California",0,0,0
1000000US060952535001149,060952535001149,"Block 1149, Block Group 1, Census Tract 2535, Solano County, California",0,0,0
1000000US060952535001150,060952535001150,"Block 1150, Block Group 1, Census Tract 2535, Solano County, California",0,0,0
1000000US060952535001151,060952535001151,"Block 1151, Block Group 1, Census Tract 2535, Solano County, California",0,0,0
1000000US060952535001152,060952535001152,"Block 1152, Block Group 1, Census Tract 2535, Solano County, California",0,0,0
1000000US060952535001153,060952535001153,"Block 1153, Block Group 1, Census Tract 2535, Solano County, California",0,0,0
1000000US060952535001154,060952535001154,"Block 1154, Block Group 1, Census Tract 2535, Solano County, California",0,0,0
1000000US060952535001155,060952535001155,"Block 1155, Block Group 1, Census Tract 2535, Solano County, California",0,0,0
1000000US060952535001156,060952535001156,"Block 1156, Block Group 1, Census Tract 2535, Solano County, California",0,0,0
1000000US060952535001157,060952535001157,"Block 1157, Block Group 1, Census Tract 2535, Solano County, California",0,0,0
1000000US060952535001158,060952535001158,"Block 1158, Block Group 1, Census Tract 2535, Solano County, California",1,1,0
1000000US060952535001159,060952535001159,"Block 1159, Block Group 1, Census Tract 2535, Solano County, California",0,0,0
1000000US060952535001160,060952535001160,"Block 1160, Block Group 1, Census Tract 2535, Solano County, California",0,0,0
1000000US060952535001161,060952535001161,"Block 1161, Block Group 1, Census Tract 2535, Solano County, California",0,0,0
1000000US060952535001162,060952535001162,"Block 1162, Block Group 1, Census Tract 2535, Solano County, California",0,0,0
1000000US060952535001163,060952535001163,"Block 1163, Block Group 1, Census Tract 2535, Solano County, California",0,0,0
1000000US060952535001164,060952535001164,"Block 1164, Block Group 1, Census Tract 2535, Solano County, California",0,0,0
1000000US060952535001165,060952535001165,"Block 1165, Block Group 1, Census Tract 2535, Solano County, California",0,0,0
1000000US060952535001166,060952535001166,"Block 1166, Block Group 1, Census Tract 2535, Solano County, California",0,0,0
1000000US060952535001167,060952535001167,"Block 1167, Block Group 1, Census Tract 2535, Solano County, California",0,0,0
1000000US060952535001168,060952535001168,"Block 1168, Block Group 1, Census Tract 2535, Solano County, California",0,0,0
1000000US060952535001169,060952535001169,"Block 1169, Block Group 1, Census Tract 2535, Solano County, California",0,0,0
1000000US060952535001170,060952535001170,"Block 1170, Block Group 1, Census Tract 2535, Solano County, California",4,3,1
1000000US060952535001171,060952535001171,"Block 1171, Block Group 1, Census Tract 2535, Solano County, California",0,0,0
1000000US060952535001172,060952535001172,"Block 1172, Block Group 1, Census Tract 2535, Solano County, California",0,0,0
1000000US060952535001173,060952535001173,"Block 1173, Block Group 1, Census Tract 2535, Solano County, California",0,0,0
1000000US060952535001174,060952535001174,"Block 1174, Block Group 1, Census Tract 2535, Solano County, California",0,0,0
1000000US060952535001175,060952535001175,"Block 1175, Block Group 1, Census Tract 2535, Solano County, California",0,0,0
1000000US060952535001176,060952535001176,"Block 1176, Block Group 1, Census Tract 2535, Solano County, California",6,6,0
1000000US060952535001177,060952535001177,"Block 1177, Block Group 1, Census Tract 2535, Solano County, California",0,0,0
1000000US060952535001178,060952535001178,"Block 1178, Block Group 1, Census Tract 2535, Solano County, California",0,0,0
1000000US060952535001179,060952535001179,"Block 1179, Block Group 1, Census Tract 2535, Solano County, California",0,0,0
1000000US060952535001180,060952535001180,"Block 1180, Block Group 1, Census Tract 2535, Solano County, California",3,3,0
1000000US060952535001181,060952535001181,"Block 1181, Block Group 1, Census Tract 2535, Solano County, California",0,0,0
1000000US060952535001182,060952535001182,"Block 1182, Block Group 1, Census Tract 2535, Solano County, California",0,0,0
1000000US060952535001183,060952535001183,"Block 1183, Block Group 1, Census Tract 2535, Solano County, California",2,1,1
1000000US060952535001184,060952535001184,"Block 1184, Block Group 1, Census Tract 2535, Solano County, California",0,0,0
1000000US060952535001185,060952535001185,"Block 1185, Block Group 1, Census Tract 2535, Solano County, California",4,4,0
1000000US060952535001186,060952535001186,"Block 1186, Block Group 1, Census Tract 2535, Solano County, California",3,2,1
1000000US060952535001187,060952535001187,"Block 1187, Block Group 1, Census Tract 2535, Solano County, California",1,1,0
1000000US060952535001188,060952535001188,"Block 1188, Block Group 1, Census Tract 2535, Solano County, California",1,1,0
1000000US060952535001189,060952535001189,"Block 1189, Block Group 1, Census Tract 2535, Solano County, California",0,0,0
1000000US060952535001190,060952535001190,"Block 1190, Block Group 1, Census Tract 2535, Solano County, California",0,0,0
1000000US060952535001191,060952535001191,"Block 1191, Block Group 1, Census Tract 2535, Solano County, California",0,0,0
1000000US060952535001192,060952535001192,"Block 1192, Block Group 1, Census Tract 2535, Solano County, California",0,0,0
1000000US060952535001193,060952535001193,"Block 1193, Block Group 1, Census Tract 2535, Solano County, California",0,0,0
1000000US060952535001194,060952535001194,"Block 1194, Block Group 1, Census Tract 2535, Solano County, California",0,0,0
1000000US060952535001195,060952535001195,"Block 1195, Block Group 1, Census Tract 2535, Solano County, California",1,1,0
1000000US060952535001196,060952535001196,"Block 1196, Block Group 1, Census Tract 2535, Solano County, California",0,0,0
1000000US060952535001197,060952535001197,"Block 1197, Block Group 1, Census Tract 2535, Solano County, California",0,0,0
1000000US060952535001198,060952535001198,"Block 1198, Block Group 1, Census Tract 2535, Solano County, California",0,0,0
1000000US060952535001199,060952535001199,"Block 1199, Block Group 1, Census Tract 2535, Solano County, California",0,0,0
1000000US060952535001200,060952535001200,"Block 1200, Block Group 1, Census Tract 2535, Solano County, California",0,0,0
1000000US060952535001201,060952535001201,"Block 1201, Block Group 1, Census Tract 2535, Solano County, California",0,0,0
1000000US060952535001202,060952535001202,"Block 1202, Block Group 1, Census Tract 2535, Solano County, California",0,0,0
1000000US060952535001203,060952535001203,"Block 1203, Block Group 1, Census Tract 2535, Solano County, California",0,0,0
1000000US060952535001204,060952535001204,"Block 1204, Block Group 1, Census Tract 2535, Solano County, California",3,3,0
1000000US060952535001205,060952535001205,"Block 1205, Block Group 1, Census Tract 2535, Solano County, California",0,0,0
1000000US060952535001206,060952535001206,"Block 1206, Block Group 1, Census Tract 2535, Solano County, California",0,0,0
1000000US060952535001207,060952535001207,"Block 1207, Block Group 1, Census Tract 2535, Solano County, California",0,0,0
1000000US060952535001208,060952535001208,"Block 1208, Block Group 1, Census Tract 2535, Solano County, California",0,0,0
1000000US060952535001209,060952535001209,"Block 1209, Block Group 1, Census Tract 2535, Solano County, California",0,0,0
1000000US060952535001210,060952535001210,"Block 1210, Block Group 1, Census Tract 2535, Solano County, California",0,0,0
1000000US060952535001211,060952535001211,"Block 1211, Block Group 1, Census Tract 2535, Solano County, California",0,0,0
1000000US060952535001212,060952535001212,"Block 1212, Block Group 1, Census Tract 2535, Solano County, California",4,4,0
1000000US060952535001213,060952535001213,"Block 1213, Block Group 1, Census Tract 2535, Solano County, California",1,1,0
1000000US060952535001214,060952535001214,"Block 1214, Block Group 1, Census Tract 2535, Solano County, California",0,0,0
1000000US060952535001215,060952535001215,"Block 1215, Block Group 1, Census Tract 2535, Solano County, California",0,0,0
1000000US060952535001216,060952535001216,"Block 1216, Block Group 1, Census Tract 2535, Solano County, California",2,2,0
1000000US060952535001217,060952535001217,"Block 1217, Block Group 1, Census Tract 2535, Solano County, California",0,0,0
1000000US060952535001218,060952535001218,"Block 1218, Block Group 1, Census Tract 2535, Solano County, California",0,0,0
1000000US060952535001219,060952535001219,"Block 1219, Block Group 1, Census Tract 2535, Solano County, California",0,0,0
1000000US060952535001220,060952535001220,"Block 1220, Block Group 1, Census Tract 2535, Solano County, California",0,0,0
1000000US060952535001221,060952535001221,"Block 1221, Block Group 1, Census Tract 2535, Solano County, California",0,0,0
1000000US060952535001222,060952535001222,"Block 1222, Block Group 1, Census Tract 2535, Solano County, California",1,1,0
1000000US060952535001223,060952535001223,"Block 1223, Block Group 1, Census Tract 2535, Solano County, California",0,0,0
1000000US060952535001224,060952535001224,"Block 1224, Block Group 1, Census Tract 2535, Solano County, California",0,0,0
1000000US060952535001225,060952535001225,"Block 1225, Block Group 1, Census Tract 2535, Solano County, California",0,0,0
1000000US060952535001226,060952535001226,"Block 1226, Block Group 1, Census Tract 2535, Solano County, California",0,0,0
1000000US060952535001227,060952535001227,"Block 1227, Block Group 1, Census Tract 2535, Solano County, California",0,0,0
1000000US060952535001228,060952535001228,"Block 1228, Block Group 1, Census Tract 2535, Solano County, California",0,0,0
1000000US060952535001229,060952535001229,"Block 1229, Block Group 1, Census Tract 2535, Solano County, California",0,0,0
1000000US060952535001230,060952535001230,"Block 1230, Block Group 1, Census Tract 2535, Solano County, California",1,0,1
1000000US060952535001231,060952535001231,"Block 1231, Block Group 1, Census Tract 2535, Solano County, California",0,0,0
1000000US060952535001232,060952535001232,"Block 1232, Block Group 1, Census Tract 2535, Solano County, California",0,0,0
1000000US060952535001233,060952535001233,"Block 1233, Block Group 1, Census Tract 2535, Solano County, California",0,0,0
1000000US060952535001234,060952535001234,"Block 1234, Block Group 1, Census Tract 2535, Solano County, California",1,1,0
1000000US060952535001235,060952535001235,"Block 1235, Block Group 1, Census Tract 2535, Solano County, California",0,0,0
1000000US060952535001236,060952535001236,"Block 1236, Block Group 1, Census Tract 2535, Solano County, California",0,0,0
1000000US060952535001237,060952535001237,"Block 1237, Block Group 1, Census Tract 2535, Solano County, California",0,0,0
1000000US060952535001238,060952535001238,"Block 1238, Block Group 1, Census Tract 2535, Solano County, California",0,0,0
1000000US060952535001239,060952535001239,"Block 1239, Block Group 1, Census Tract 2535, Solano County, California",0,0,0
1000000US060952535001240,060952535001240,"Block 1240, Block Group 1, Census Tract 2535, Solano County, California",0,0,0
1000000US060952535001241,060952535001241,"Block 1241, Block Group 1, Census Tract 2535, Solano County, California",1,1,0
1000000US060952535001242,060952535001242,"Block 1242, Block Group 1, Census Tract 2535, Solano County, California",0,0,0
1000000US060952535001243,060952535001243,"Block 1243, Block Group 1, Census Tract 2535, Solano County, California",0,0,0
1000000US060952535001244,060952535001244,"Block 1244, Block Group 1, Census Tract 2535, Solano County, California",0,0,0
1000000US060952535001245,060952535001245,"Block 1245, Block Group 1, Census Tract 2535, Solano County, California",0,0,0
1000000US060952535001246,060952535001246,"Block 1246, Block Group 1, Census Tract 2535, Solano County, California",0,0,0
1000000US060952535001247,060952535001247,"Block 1247, Block Group 1, Census Tract 2535, Solano County, California",0,0,0
1000000US060952535001248,060952535001248,"Block 1248, Block Group 1, Census Tract 2535, Solano County, California",0,0,0
1000000US060952535001249,060952535001249,"Block 1249, Block Group 1, Census Tract 2535, Solano County, California",0,0,0
1000000US060952535001250,060952535001250,"Block 1250, Block Group 1, Census Tract 2535, Solano County, California",5,5,0
1000000US060952535001251,060952535001251,"Block 1251, Block Group 1, Census Tract 2535, Solano County, California",0,0,0
1000000US060952535001252,060952535001252,"Block 1252, Block Group 1, Census Tract 2535, Solano County, California",4,2,2
1000000US060952535001253,060952535001253,"Block 1253, Block Group 1, Census Tract 2535, Solano County, California",1,1,0
1000000US060952535001254,060952535001254,"Block 1254, Block Group 1, Census Tract 2535, Solano County, California",0,0,0
1000000US060952535001255,060952535001255,"Block 1255, Block Group 1, Census Tract 2535, Solano County, California",0,0,0
1000000US060952535001256,060952535001256,"Block 1256, Block Group 1, Census Tract 2535, Solano County, California",0,0,0
1000000US060952535001257,060952535001257,"Block 1257, Block Group 1, Census Tract 2535, Solano County, California",0,0,0
1000000US060952535001258,060952535001258,"Block 1258, Block Group 1, Census Tract 2535, Solano County, California",0,0,0
1000000US060952535001259,060952535001259,"Block 1259, Block Group 1, Census Tract 2535, Solano County, California",0,0,0
1000000US060952535001260,060952535001260,"Block 1260, Block Group 1, Census Tract 2535, Solano County, California",0,0,0
1000000US060952535001261,060952535001261,"Block 1261, Block Group 1, Census Tract 2535, Solano County, California",0,0,0
1000000US060952535001262,060952535001262,"Block 1262, Block Group 1, Census Tract 2535, Solano County, California",0,0,0
1000000US060952535001263,060952535001263,"Block 1263, Block Group 1, Census Tract 2535, Solano County, California",0,0,0
1000000US060952535001264,060952535001264,"Block 1264, Block Group 1, Census Tract 2535, Solano County, California",0,0,0
1000000US060952535001265,060952535001265,"Block 1265, Block Group 1, Census Tract 2535, Solano County, California",1,1,0
1000000US060952535001266,060952535001266,"Block 1266, Block Group 1, Census Tract 2535, Solano County, California",0,0,0
1000000US060952535001267,060952535001267,"Block 1267, Block Group 1, Census Tract 2535, Solano County, California",1,1,0
1000000US060952535001268,060952535001268,"Block 1268, Block Group 1, Census Tract 2535, Solano County, California",0,0,0
1000000US060952535001269,060952535001269,"Block 1269, Block Group 1, Census Tract 2535, Solano County, California",2,2,0
1000000US060952535001270,060952535001270,"Block 1270, Block Group 1, Census Tract 2535, Solano County, California",0,0,0
1000000US060952535001271,060952535001271,"Block 1271, Block Group 1, Census Tract 2535, Solano County, California",0,0,0
1000000US060952535001272,060952535001272,"Block 1272, Block Group 1, Census Tract 2535, Solano County, California",0,0,0
1000000US060952535001273,060952535001273,"Block 1273, Block Group 1, Census Tract 2535, Solano County, California",0,0,0
1000000US060952535001274,060952535001274,"Block 1274, Block Group 1, Census Tract 2535, Solano County, California",0,0,0
1000000US060952535001275,060952535001275,"Block 1275, Block Group 1, Census Tract 2535, Solano County, California",0,0,0
1000000US060952535001276,060952535001276,"Block 1276, Block Group 1, Census Tract 2535, Solano County, California",0,0,0
1000000US060952535001277,060952535001277,"Block 1277, Block Group 1, Census Tract 2535, Solano County, California",1,1,0
1000000US060952535001278,060952535001278,"Block 1278, Block Group 1, Census Tract 2535, Solano County, California",0,0,0
1000000US060952535001279,060952535001279,"Block 1279, Block Group 1, Census Tract 2535, Solano County, California",0,0,0
1000000US060952535001280,060952535001280,"Block 1280, Block Group 1, Census Tract 2535, Solano County, California",0,0,0
1000000US060952535001281,060952535001281,"Block 1281, Block Group 1, Census Tract 2535, Solano County, California",0,0,0
1000000US060952535001282,060952535001282,"Block 1282, Block Group 1, Census Tract 2535, Solano County, California",3,1,2
1000000US060952535001283,060952535001283,"Block 1283, Block Group 1, Census Tract 2535, Solano County, California",0,0,0
1000000US060952535001284,060952535001284,"Block 1284, Block Group 1, Census Tract 2535, Solano County, California",0,0,0
1000000US060952535001285,060952535001285,"Block 1285, Block Group 1, Census Tract 2535, Solano County, California",0,0,0
1000000US060952535001286,060952535001286,"Block 1286, Block Group 1, Census Tract 2535, Solano County, California",0,0,0
1000000US060952535001287,060952535001287,"Block 1287, Block Group 1, Census Tract 2535, Solano County, California",0,0,0
1000000US060952535001288,060952535001288,"Block 1288, Block Group 1, Census Tract 2535, Solano County, California",1,1,0
1000000US060952535001289,060952535001289,"Block 1289, Block Group 1, Census Tract 2535, Solano County, California",0,0,0
1000000US060952535001290,060952535001290,"Block 1290, Block Group 1, Census Tract 2535, Solano County, California",0,0,0
1000000US060952535001291,060952535001291,"Block 1291, Block Group 1, Census Tract 2535, Solano County, California",2,0,2
1000000US060952535001292,060952535001292,"Block 1292, Block Group 1, Census Tract 2535, Solano County, California",4,3,1
1000000US060952535001293,060952535001293,"Block 1293, Block Group 1, Census Tract 2535, Solano County, California",0,0,0
1000000US060952535001294,060952535001294,"Block 1294, Block Group 1, Census Tract 2535, Solano County, California",0,0,0
1000000US060952535001295,060952535001295,"Block 1295, Block Group 1, Census Tract 2535, Solano County, California",0,0,0
1000000US060952535001296,060952535001296,"Block 1296, Block Group 1, Census Tract 2535, Solano County, California",0,0,0
1000000US060952535001297,060952535001297,"Block 1297, Block Group 1, Census Tract 2535, Solano County, California",0,0,0
1000000US060952535001298,060952535001298,"Block 1298, Block Group 1, Census Tract 2535, Solano County, California",1,1,0
1000000US060952535001299,060952535001299,"Block 1299, Block Group 1, Census Tract 2535, Solano County, California",0,0,0
1000000US060952535001300,060952535001300,"Block 1300, Block Group 1, Census Tract 2535, Solano County, California",0,0,0
1000000US060952535001301,060952535001301,"Block 1301, Block Group 1, Census Tract 2535, Solano County, California",0,0,0
1000000US060952535001302,060952535001302,"Block 1302, Block Group 1, Census Tract 2535, Solano County, California",0,0,0
1000000US060952535001303,060952535001303,"Block 1303, Block Group 1, Census Tract 2535, Solano County, California",0,0,0
1000000US060952535001304,060952535001304,"Block 1304, Block Group 1, Census Tract 2535, Solano County, California",0,0,0
1000000US060952535001305,060952535001305,"Block 1305, Block Group 1, Census Tract 2535, Solano County, California",0,0,0
1000000US060952535001306,060952535001306,"Block 1306, Block Group 1, Census Tract 2535, Solano County, California",6,3,3
1000000US060952535001307,060952535001307,"Block 1307, Block Group 1, Census Tract 2535, Solano County, California",0,0,0
1000000US060952535001308,060952535001308,"Block 1308, Block Group 1, Census Tract 2535, Solano County, California",0,0,0
1000000US060952535001309,060952535001309,"Block 1309, Block Group 1, Census Tract 2535, Solano County, California",0,0,0
1000000US060952535001310,060952535001310,"Block 1310, Block Group 1, Census Tract 2535, Solano County, California",2,1,1
1000000US060952535001311,060952535001311,"Block 1311, Block Group 1, Census Tract 2535, Solano County, California",0,0,0
1000000US060952535001312,060952535001312,"Block 1312, Block Group 1, Census Tract 2535, Solano County, California",0,0,0
1000000US060952535001313,060952535001313,"Block 1313, Block Group 1, Census Tract 2535, Solano County, California",19,18,1
1000000US060952535001314,060952535001314,"Block 1314, Block Group 1, Census Tract 2535, Solano County, California",1,1,0
1000000US060952535001315,060952535001315,"Block 1315, Block Group 1, Census Tract 2535, Solano County, California",0,0,0
1000000US060952535001316,060952535001316,"Block 1316, Block Group 1, Census Tract 2535, Solano County, California",0,0,0
1000000US060952535001317,060952535001317,"Block 1317, Block Group 1, Census Tract 2535, Solano County, California",0,0,0
1000000US060952535001318,060952535001318,"Block 1318, Block Group 1, Census Tract 2535, Solano County, California",0,0,0
1000000US060952535001319,060952535001319,"Block 1319, Block Group 1, Census Tract 2535, Solano County, California",0,0,0
1000000US060952535001320,060952535001320,"Block 1320, Block Group 1, Census Tract 2535, Solano County, California",0,0,0
1000000US060952535001321,060952535001321,"Block 1321, Block Group 1, Census Tract 2535, Solano County, California",0,0,0
1000000US060952535001322,060952535001322,"Block 1322, Block Group 1, Census Tract 2535, Solano County, California",0,0,0
1000000US060952535001323,060952535001323,"Block 1323, Block Group 1, Census Tract 2535, Solano County, California",0,0,0
1000000US060952535001324,060952535001324,"Block 1324, Block Group 1, Census Tract 2535, Solano County, California",0,0,0
1000000US060952535001325,060952535001325,"Block 1325, Block Group 1, Census Tract 2535, Solano County, California",0,0,0
1000000US060952535001326,060952535001326,"Block 1326, Block Group 1, Census Tract 2535, Solano County, California",0,0,0
1000000US060952535001327,060952535001327,"Block 1327, Block Group 1, Census Tract 2535, Solano County, California",0,0,0
1000000US060952535001328,060952535001328,"Block 1328, Block Group 1, Census Tract 2535, Solano County, California",0,0,0
1000000US060952535001329,060952535001329,"Block 1329, Block Group 1, Census Tract 2535, Solano County, California",0,0,0
1000000US060952535001330,060952535001330,"Block 1330, Block Group 1, Census Tract 2535, Solano County, California",0,0,0
1000000US060952535001331,060952535001331,"Block 1331, Block Group 1, Census Tract 2535, Solano County, California",0,0,0
1000000US060952535001332,060952535001332,"Block 1332, Block Group 1, Census Tract 2535, Solano County, California",0,0,0
1000000US060952535001333,060952535001333,"Block 1333, Block Group 1, Census Tract 2535, Solano County, California",0,0,0
1000000US060952535001334,060952535001334,"Block 1334, Block Group 1, Census Tract 2535, Solano County, California",0,0,0
1000000US060952535001335,060952535001335,"Block 1335, Block Group 1, Census Tract 2535, Solano County, California",0,0,0
1000000US060952535001336,060952535001336,"Block 1336, Block Group 1, Census Tract 2535, Solano County, California",1,1,0
1000000US060952535001337,060952535001337,"Block 1337, Block Group 1, Census Tract 2535, Solano County, California",0,0,0
1000000US060952535001338,060952535001338,"Block 1338, Block Group 1, Census Tract 2535, Solano County, California",0,0,0
1000000US060952535001339,060952535001339,"Block 1339, Block Group 1, Census Tract 2535, Solano County, California",0,0,0
1000000US060952535001340,060952535001340,"Block 1340, Block Group 1, Census Tract 2535, Solano County, California",0,0,0
1000000US060952535001341,060952535001341,"Block 1341, Block Group 1, Census Tract 2535, Solano County, California",0,0,0
1000000US060952535001342,060952535001342,"Block 1342, Block Group 1, Census Tract 2535, Solano County, California",0,0,0
1000000US060952535001343,060952535001343,"Block 1343, Block Group 1, Census Tract 2535, Solano County, California",0,0,0
1000000US060952535001344,060952535001344,"Block 1344, Block Group 1, Census Tract 2535, Solano County, California",0,0,0
1000000US060952535001345,060952535001345,"Block 1345, Block Group 1, Census Tract 2535, Solano County, California",0,0,0
1000000US060952535001346,060952535001346,"Block 1346, Block Group 1, Census Tract 2535, Solano County, California",0,0,0
1000000US060952535001347,060952535001347,"Block 1347, Block Group 1, Census Tract 2535, Solano County, California",0,0,0
1000000US060952535001348,060952535001348,"Block 1348, Block Group 1, Census Tract 2535, Solano County, California",0,0,0
1000000US060952535001349,060952535001349,"Block 1349, Block Group 1, Census Tract 2535, Solano County, California",0,0,0
1000000US060952535001350,060952535001350,"Block 1350, Block Group 1, Census Tract 2535, Solano County, California",1,1,0
1000000US060952535001351,060952535001351,"Block 1351, Block Group 1, Census Tract 2535, Solano County, California",0,0,0
1000000US060952535001352,060952535001352,"Block 1352, Block Group 1, Census Tract 2535, Solano County, California",0,0,0
1000000US060952535001353,060952535001353,"Block 1353, Block Group 1, Census Tract 2535, Solano County, California",0,0,0
1000000US060952535001354,060952535001354,"Block 1354, Block Group 1, Census Tract 2535, Solano County, California",0,0,0
1000000US060952535001355,060952535001355,"Block 1355, Block Group 1, Census Tract 2535, Solano County, California",0,0,0
1000000US060952535001356,060952535001356,"Block 1356, Block Group 1, Census Tract 2535, Solano County, California",0,0,0
1000000US060952535001357,060952535001357,"Block 1357, Block Group 1, Census Tract 2535, Solano County, California",0,0,0
1000000US060952535001358,060952535001358,"Block 1358, Block Group 1, Census Tract 2535, Solano County, California",0,0,0
1000000US060952535001359,060952535001359,"Block 1359, Block Group 1, Census Tract 2535, Solano County, California",0,0,0
1000000US060952535001360,060952535001360,"Block 1360, Block Group 1, Census Tract 2535, Solano County, California",3,2,1
1000000US060952535001361,060952535001361,"Block 1361, Block Group 1, Census Tract 2535, Solano County, California",3,3,0
1000000US060952535001362,060952535001362,"Block 1362, Block Group 1, Census Tract 2535, Solano County, California",0,0,0
1000000US060952535001363,060952535001363,"Block 1363, Block Group 1, Census Tract 2535, Solano County, California",173,156,17
1000000US060952535001364,060952535001364,"Block 1364, Block Group 1, Census Tract 2535, Solano County, California",19,19,0
1000000US060952535001365,060952535001365,"Block 1365, Block Group 1, Census Tract 2535, Solano County, California",11,11,0
1000000US060952535001366,060952535001366,"Block 1366, Block Group 1, Census Tract 2535, Solano County, California",12,10,2
1000000US060952535001367,060952535001367,"Block 1367, Block Group 1, Census Tract 2535, Solano County, California",20,17,3
1000000US060952535001368,060952535001368,"Block 1368, Block Group 1, Census Tract 2535, Solano County, California",8,8,0
1000000US060952535001369,060952535001369,"Block 1369, Block Group 1, Census Tract 2535, Solano County, California",26,26,0
1000000US060952535001370,060952535001370,"Block 1370, Block Group 1, Census Tract 2535, Solano County, California",20,17,3
1000000US060952535001371,060952535001371,"Block 1371, Block Group 1, Census Tract 2535, Solano County, California",58,50,8
1000000US060952535001372,060952535001372,"Block 1372, Block Group 1, Census Tract 2535, Solano County, California",19,16,3
1000000US060952535001373,060952535001373,"Block 1373, Block Group 1, Census Tract 2535, Solano County, California",20,17,3
1000000US060952535001374,060952535001374,"Block 1374, Block Group 1, Census Tract 2535, Solano County, California",11,11,0
1000000US060952535001375,060952535001375,"Block 1375, Block Group 1, Census Tract 2535, Solano County, California",7,6,1
1000000US060952535001376,060952535001376,"Block 1376, Block Group 1, Census Tract 2535, Solano County, California",21,20,1
1000000US060952535001377,060952535001377,"Block 1377, Block Group 1, Census Tract 2535, Solano County, California",8,8,0
1000000US060952535001378,060952535001378,"Block 1378, Block Group 1, Census Tract 2535, Solano County, California",19,19,0
1000000US060952535001379,060952535001379,"Block 1379, Block Group 1, Census Tract 2535, Solano County, California",21,20,1
1000000US060952535001380,060952535001380,"Block 1380, Block Group 1, Census Tract 2535, Solano County, California",0,0,0
1000000US060952535001381,060952535001381,"Block 1381, Block Group 1, Census Tract 2535, Solano County, California",6,4,2
1000000US060952535001382,060952535001382,"Block 1382, Block Group 1, Census Tract 2535, Solano County, California",9,9,0
1000000US060952535001383,060952535001383,"Block 1383, Block Group 1, Census Tract 2535, Solano County, California",13,12,1
1000000US060952535001384,060952535001384,"Block 1384, Block Group 1, Census Tract 2535, Solano County, California",0,0,0
1000000US060952535001385,060952535001385,"Block 1385, Block Group 1, Census Tract 2535, Solano County, California",19,17,2
1000000US060952535001386,060952535001386,"Block 1386, Block Group 1, Census Tract 2535, Solano County, California",0,0,0
1000000US060952535001387,060952535001387,"Block 1387, Block Group 1, Census Tract 2535, Solano County, California",0,0,0
1000000US060952535001388,060952535001388,"Block 1388, Block Group 1, Census Tract 2535, Solano County, California",0,0,0
1000000US060952535001389,060952535001389,"Block 1389, Block Group 1, Census Tract 2535, Solano County, California",0,0,0
1000000US060952535001390,060952535001390,"Block 1390, Block Group 1, Census Tract 2535, Solano County, California",0,0,0
1000000US060952535001391,060952535001391,"Block 1391, Block Group 1, Census Tract 2535, Solano County, California",0,0,0
1000000US060952535001392,060952535001392,"Block 1392, Block Group 1, Census Tract 2535, Solano County, California",0,0,0
1000000US060952535001393,060952535001393,"Block 1393, Block Group 1, Census Tract 2535, Solano County, California",0,0,0
1000000US060952535001394,060952535001394,"Block 1394, Block Group 1, Census Tract 2535, Solano County, California",0,0,0
1000000US060952535001395,060952535001395,"Block 1395, Block Group 1, Census Tract 2535, Solano County, California",0,0,0
1000000US060952535001396,060952535001396,"Block 1396, Block Group 1, Census Tract 2535, Solano County, California",0,0,0
1000000US060952535001397,060952535001397,"Block 1397, Block Group 1, Census Tract 2535, Solano County, California",0,0,0
1000000US060952535001398,060952535001398,"Block 1398, Block Group 1, Census Tract 2535, Solano County, California",0,0,0
1000000US060952535001399,060952535001399,"Block 1399, Block Group 1, Census Tract 2535, Solano County, California",0,0,0
1000000US060952535001400,060952535001400,"Block 1400, Block Group 1, Census Tract 2535, Solano County, California",0,0,0
1000000US060952535001401,060952535001401,"Block 1401, Block Group 1, Census Tract 2535, Solano County, California",0,0,0
1000000US060952535001402,060952535001402,"Block 1402, Block Group 1, Census Tract 2535, Solano County, California",0,0,0
1000000US060952535001403,060952535001403,"Block 1403, Block Group 1, Census Tract 2535, Solano County, California",0,0,0
1000000US060952535001404,060952535001404,"Block 1404, Block Group 1, Census Tract 2535, Solano County, California",0,0,0
1000000US060952535001405,060952535001405,"Block 1405, Block Group 1, Census Tract 2535, Solano County, California",0,0,0
1000000US060952535001406,060952535001406,"Block 1406, Block Group 1, Census Tract 2535, Solano County, California",0,0,0
1000000US060952535001407,060952535001407,"Block 1407, Block Group 1, Census Tract 2535, Solano County, California",0,0,0
1000000US060952535001408,060952535001408,"Block 1408, Block Group 1, Census Tract 2535, Solano County, California",0,0,0
1000000US060952535001409,060952535001409,"Block 1409, Block Group 1, Census Tract 2535, Solano County, California",0,0,0
1000000US060952535001410,060952535001410,"Block 1410, Block Group 1, Census Tract 2535, Solano County, California",0,0,0
1000000US060952535001411,060952535001411,"Block 1411, Block Group 1, Census Tract 2535, Solano County, California",0,0,0
1000000US060952535001412,060952535001412,"Block 1412, Block Group 1, Census Tract 2535, Solano County, California",0,0,0
1000000US060952535001413,060952535001413,"Block 1413, Block Group 1, Census Tract 2535, Solano County, California",11,0,11
1000000US060952535001414,060952535001414,"Block 1414, Block Group 1, Census Tract 2535, Solano County, California",0,0,0
1000000US060952535001415,060952535001415,"Block 1415, Block Group 1, Census Tract 2535, Solano County, California",0,0,0
1000000US060952535001416,060952535001416,"Block 1416, Block Group 1, Census Tract 2535, Solano County, California",0,0,0
1000000US060952535001417,060952535001417,"Block 1417, Block Group 1, Census Tract 2535, Solano County, California",0,0,0
1000000US060952535001418,060952535001418,"Block 1418, Block Group 1, Census Tract 2535, Solano County, California",0,0,0
1000000US060952535001419,060952535001419,"Block 1419, Block Group 1, Census Tract 2535, Solano County, California",0,0,0
1000000US060952535001420,060952535001420,"Block 1420, Block Group 1, Census Tract 2535, Solano County, California",4,0,4
1000000US060952535001421,060952535001421,"Block 1421, Block Group 1, Census Tract 2535, Solano County, California",0,0,0
1000000US060952535001422,060952535001422,"Block 1422, Block Group 1, Census Tract 2535, Solano County, California",0,0,0
1000000US060952535001423,060952535001423,"Block 1423, Block Group 1, Census Tract 2535, Solano County, California",0,0,0
1000000US060952535001424,060952535001424,"Block 1424, Block Group 1, Census Tract 2535, Solano County, California",0,0,0
1000000US060952535001425,060952535001425,"Block 1425, Block Group 1, Census Tract 2535, Solano County, California",0,0,0
1000000US060952535001426,060952535001426,"Block 1426, Block Group 1, Census Tract 2535, Solano County, California",0,0,0
1000000US060952535001427,060952535001427,"Block 1427, Block Group 1, Census Tract 2535, Solano County, California",0,0,0
1000000US060952535001428,060952535001428,"Block 1428, Block Group 1, Census Tract 2535, Solano County, California",0,0,0
1000000US060952535001429,060952535001429,"Block 1429, Block Group 1, Census Tract 2535, Solano County, California",0,0,0
1000000US060952535001430,060952535001430,"Block 1430, Block Group 1, Census Tract 2535, Solano County, California",0,0,0
1000000US060952535001431,060952535001431,"Block 1431, Block Group 1, Census Tract 2535, Solano County, California",0,0,0
1000000US060952535001432,060952535001432,"Block 1432, Block Group 1, Census Tract 2535, Solano County, California",0,0,0
1000000US060952535001433,060952535001433,"Block 1433, Block Group 1, Census Tract 2535, Solano County, California",0,0,0
1000000US060952535001434,060952535001434,"Block 1434, Block Group 1, Census Tract 2535, Solano County, California",3,2,1
1000000US060952535001435,060952535001435,"Block 1435, Block Group 1, Census Tract 2535, Solano County, California",0,0,0
1000000US060952535001436,060952535001436,"Block 1436, Block Group 1, Census Tract 2535, Solano County, California",0,0,0
1000000US060952535001437,060952535001437,"Block 1437, Block Group 1, Census Tract 2535, Solano County, California",3,3,0
1000000US060952535001438,060952535001438,"Block 1438, Block Group 1, Census Tract 2535, Solano County, California",0,0,0
1000000US060952535001439,060952535001439,"Block 1439, Block Group 1, Census Tract 2535, Solano County, California",5,5,0
1000000US060952535001440,060952535001440,"Block 1440, Block Group 1, Census Tract 2535, Solano County, California",1,1,0
1000000US060952535001441,060952535001441,"Block 1441, Block Group 1, Census Tract 2535, Solano County, California",1,1,0
1000000US060952535001442,060952535001442,"Block 1442, Block Group 1, Census Tract 2535, Solano County, California",0,0,0
1000000US060952535001443,060952535001443,"Block 1443, Block Group 1, Census Tract 2535, Solano County, California",0,0,0
1000000US060952535001444,060952535001444,"Block 1444, Block Group 1, Census Tract 2535, Solano County, California",0,0,0
1000000US060952535001445,060952535001445,"Block 1445, Block Group 1, Census Tract 2535, Solano County, California",0,0,0
1000000US060952535001446,060952535001446,"Block 1446, Block Group 1, Census Tract 2535, Solano County, California",11,11,0
1000000US060952535001447,060952535001447,"Block 1447, Block Group 1, Census Tract 2535, Solano County, California",0,0,0
1000000US060952535001448,060952535001448,"Block 1448, Block Group 1, Census Tract 2535, Solano County, California",2,2,0
1000000US060952535001449,060952535001449,"Block 1449, Block Group 1, Census Tract 2535, Solano County, California",3,3,0
1000000US060952535001450,060952535001450,"Block 1450, Block Group 1, Census Tract 2535, Solano County, California",0,0,0
1000000US060952535001451,060952535001451,"Block 1451, Block Group 1, Census Tract 2535, Solano County, California",2,2,0
1000000US060952535001452,060952535001452,"Block 1452, Block Group 1, Census Tract 2535, Solano County, California",0,0,0
1000000US060952535001453,060952535001453,"Block 1453, Block Group 1, Census Tract 2535, Solano County, California",0,0,0
1000000US060952535001454,060952535001454,"Block 1454, Block Group 1, Census Tract 2535, Solano County, California",0,0,0
1000000US060952535001455,060952535001455,"Block 1455, Block Group 1, Census Tract 2535, Solano County, California",0,0,0
1000000US060952535001456,060952535001456,"Block 1456, Block Group 1, Census Tract 2535, Solano County, California",0,0,0
1000000US060952535001457,060952535001457,"Block 1457, Block Group 1, Census Tract 2535, Solano County, California",0,0,0
1000000US060952535001458,060952535001458,"Block 1458, Block Group 1, Census Tract 2535, Solano County, California",0,0,0
1000000US060952535001459,060952535001459,"Block 1459, Block Group 1, Census Tract 2535, Solano County, California",0,0,0
1000000US060952535001460,060952535001460,"Block 1460, Block Group 1, Census Tract 2535, Solano County, California",0,0,0
1000000US060952535001461,060952535001461,"Block 1461, Block Group 1, Census Tract 2535, Solano County, California",0,0,0
1000000US060952535001462,060952535001462,"Block 1462, Block Group 1, Census Tract 2535, Solano County, California",0,0,0
1000000US060952535001463,060952535001463,"Block 1463, Block Group 1, Census Tract 2535, Solano County, California",0,0,0
1000000US060952535001464,060952535001464,"Block 1464, Block Group 1, Census Tract 2535, Solano County, California",0,0,0
1000000US060952535001465,060952535001465,"Block 1465, Block Group 1, Census Tract 2535, Solano County, California",0,0,0
1000000US060952535001466,060952535001466,"Block 1466, Block Group 1, Census Tract 2535, Solano County, California",0,0,0
1000000US060952535001467,060952535001467,"Block 1467, Block Group 1, Census Tract 2535, Solano County, California",0,0,0
1000000US060952535001468,060952535001468,"Block 1468, Block Group 1, Census Tract 2535, Solano County, California",0,0,0
1000000US060952535001469,060952535001469,"Block 1469, Block Group 1, Census Tract 2535, Solano County, California",0,0,0
1000000US060952535001470,060952535001470,"Block 1470, Block Group 1, Census Tract 2535, Solano County, California",1,1,0
1000000US060952535001471,060952535001471,"Block 1471, Block Group 1, Census Tract 2535, Solano County, California",0,0,0
1000000US060952535001472,060952535001472,"Block 1472, Block Group 1, Census Tract 2535, Solano County, California",0,0,0
1000000US060952535001473,060952535001473,"Block 1473, Block Group 1, Census Tract 2535, Solano County, California",0,0,0
1000000US060952535001474,060952535001474,"Block 1474, Block Group 1, Census Tract 2535, Solano County, California",5,4,1
1000000US060952535001475,060952535001475,"Block 1475, Block Group 1, Census Tract 2535, Solano County, California",1,1,0
1000000US060952535001476,060952535001476,"Block 1476, Block Group 1, Census Tract 2535, Solano County, California",0,0,0
1000000US060952535001477,060952535001477,"Block 1477, Block Group 1, Census Tract 2535, Solano County, California",0,0,0
1000000US060952535001478,060952535001478,"Block 1478, Block Group 1, Census Tract 2535, Solano County, California",0,0,0
1000000US060952535001479,060952535001479,"Block 1479, Block Group 1, Census Tract 2535, Solano County, California",0,0,0
1000000US060952535001480,060952535001480,"Block 1480, Block Group 1, Census Tract 2535, Solano County, California",0,0,0
1000000US060952535001481,060952535001481,"Block 1481, Block Group 1, Census Tract 2535, Solano County, California",0,0,0
1000000US060952535001482,060952535001482,"Block 1482, Block Group 1, Census Tract 2535, Solano County, California",0,0,0
1000000US060952535001483,060952535001483,"Block 1483, Block Group 1, Census Tract 2535, Solano County, California",0,0,0
1000000US060952535001484,060952535001484,"Block 1484, Block Group 1, Census Tract 2535, Solano County, California",0,0,0
1000000US060952535001485,060952535001485,"Block 1485, Block Group 1, Census Tract 2535, Solano County, California",0,0,0
1000000US060952535001486,060952535001486,"Block 1486, Block Group 1, Census Tract 2535, Solano County, California",0,0,0
1000000US060952535001487,060952535001487,"Block 1487, Block Group 1, Census Tract 2535, Solano County, California",0,0,0
1000000US060952535001488,060952535001488,"Block 1488, Block Group 1, Census Tract 2535, Solano County, California",0,0,0
1000000US060952535001489,060952535001489,"Block 1489, Block Group 1, Census Tract 2535, Solano County, California",0,0,0
1000000US060952535001490,060952535001490,"Block 1490, Block Group 1, Census Tract 2535, Solano County, California",0,0,0
1000000US060952535001491,060952535001491,"Block 1491, Block Group 1, Census Tract 2535, Solano County, California",0,0,0
1000000US060952535001492,060952535001492,"Block 1492, Block Group 1, Census Tract 2535, Solano County, California",0,0,0
1000000US060952535001493,060952535001493,"Block 1493, Block Group 1, Census Tract 2535, Solano County, California",0,0,0
1000000US060952535001494,060952535001494,"Block 1494, Block Group 1, Census Tract 2535, Solano County, California",0,0,0
1000000US060952535001495,060952535001495,"Block 1495, Block Group 1, Census Tract 2535, Solano County, California",0,0,0
1000000US060952535001496,060952535001496,"Block 1496, Block Group 1, Census Tract 2535, Solano County, California",0,0,0
1000000US060952535001497,060952535001497,"Block 1497, Block Group 1, Census Tract 2535, Solano County, California",0,0,0
1000000US060952535001498,060952535001498,"Block 1498, Block Group 1, Census Tract 2535, Solano County, California",0,0,0
1000000US060952535001499,060952535001499,"Block 1499, Block Group 1, Census Tract 2535, Solano County, California",0,0,0
1000000US060952535001500,060952535001500,"Block 1500, Block Group 1, Census Tract 2535, Solano County, California",0,0,0
1000000US060952535001501,060952535001501,"Block 1501, Block Group 1, Census Tract 2535, Solano County, California",0,0,0
1000000US060952535001502,060952535001502,"Block 1502, Block Group 1, Census Tract 2535, Solano County, California",0,0,0
1000000US060952535001503,060952535001503,"Block 1503, Block Group 1, Census Tract 2535, Solano County, California",0,0,0
1000000US060952535001504,060952535001504,"Block 1504, Block Group 1, Census Tract 2535, Solano County, California",0,0,0
1000000US060952535001505,060952535001505,"Block 1505, Block Group 1, Census Tract 2535, Solano County, California",0,0,0
1000000US060952535001506,060952535001506,"Block 1506, Block Group 1, Census Tract 2535, Solano County, California",0,0,0
1000000US060952535001507,060952535001507,"Block 1507, Block Group 1, Census Tract 2535, Solano County, California",1,1,0
1000000US060952535001508,060952535001508,"Block 1508, Block Group 1, Census Tract 2535, Solano County, California",0,0,0
1000000US060952535001509,060952535001509,"Block 1509, Block Group 1, Census Tract 2535, Solano County, California",0,0,0
1000000US060952535001510,060952535001510,"Block 1510, Block Group 1, Census Tract 2535, Solano County, California",0,0,0
1000000US060952535001511,060952535001511,"Block 1511, Block Group 1, Census Tract 2535, Solano County, California",0,0,0
1000000US060952535001512,060952535001512,"Block 1512, Block Group 1, Census Tract 2535, Solano County, California",0,0,0
1000000US060952535001513,060952535001513,"Block 1513, Block Group 1, Census Tract 2535, Solano County, California",1,1,0
1000000US060952535001514,060952535001514,"Block 1514, Block Group 1, Census Tract 2535, Solano County, California",0,0,0
1000000US060952535001515,060952535001515,"Block 1515, Block Group 1, Census Tract 2535, Solano County, California",0,0,0
1000000US060952535001516,060952535001516,"Block 1516, Block Group 1, Census Tract 2535, Solano County, California",0,0,0
1000000US060952535001517,060952535001517,"Block 1517, Block Group 1, Census Tract 2535, Solano County, California",0,0,0
1000000US060952535001518,060952535001518,"Block 1518, Block Group 1, Census Tract 2535, Solano County, California",0,0,0
1000000US060952535001519,060952535001519,"Block 1519, Block Group 1, Census Tract 2535, Solano County, California",0,0,0
1000000US060952535001520,060952535001520,"Block 1520, Block Group 1, Census Tract 2535, Solano County, California",0,0,0
1000000US060952535001521,060952535001521,"Block 1521, Block Group 1, Census Tract 2535, Solano County, California",1,1,0
1000000US060952535001522,060952535001522,"Block 1522, Block Group 1, Census Tract 2535, Solano County, California",0,0,0
1000000US060952535001523,060952535001523,"Block 1523, Block Group 1, Census Tract 2535, Solano County, California",0,0,0
1000000US060952535001524,060952535001524,"Block 1524, Block Group 1, Census Tract 2535, Solano County, California",0,0,0
1000000US060952535001525,060952535001525,"Block 1525, Block Group 1, Census Tract 2535, Solano County, California",0,0,0
1000000US060952535001526,060952535001526,"Block 1526, Block Group 1, Census Tract 2535, Solano County, California",0,0,0
1000000US060952535001527,060952535001527,"Block 1527, Block Group 1, Census Tract 2535, Solano County, California",61,57,4
1000000US060952535001528,060952535001528,"Block 1528, Block Group 1, Census Tract 2535, Solano County, California",22,21,1
1000000US060952535001529,060952535001529,"Block 1529, Block Group 1, Census Tract 2535, Solano County, California",22,20,2
1000000US060952535001530,060952535001530,"Block 1530, Block Group 1, Census Tract 2535, Solano County, California",27,25,2
1000000US060952535001531,060952535001531,"Block 1531, Block Group 1, Census Tract 2535, Solano County, California",27,26,1
1000000US060952535001532,060952535001532,"Block 1532, Block Group 1, Census Tract 2535, Solano County, California",0,0,0
1000000US060952535001533,060952535001533,"Block 1533, Block Group 1, Census Tract 2535, Solano County, California",0,0,0
1000000US060952535001534,060952535001534,"Block 1534, Block Group 1, Census Tract 2535, Solano County, California",45,44,1
1000000US060952535001535,060952535001535,"Block 1535, Block Group 1, Census Tract 2535, Solano County, California",26,25,1
1000000US060952535001536,060952535001536,"Block 1536, Block Group 1, Census Tract 2535, Solano County, California",0,0,0
1000000US060952535001537,060952535001537,"Block 1537, Block Group 1, Census Tract 2535, Solano County, California",42,40,2
1000000US060952535001538,060952535001538,"Block 1538, Block Group 1, Census Tract 2535, Solano County, California",16,15,1
1000000US060952535001539,060952535001539,"Block 1539, Block Group 1, Census Tract 2535, Solano County, California",0,0,0
1000000US060952535001540,060952535001540,"Block 1540, Block Group 1, Census Tract 2535, Solano County, California",19,18,1
1000000US060952535001541,060952535001541,"Block 1541, Block Group 1, Census Tract 2535, Solano County, California",9,9,0
1000000US060952535001542,060952535001542,"Block 1542, Block Group 1, Census Tract 2535, Solano County, California",0,0,0
1000000US060952535001543,060952535001543,"Block 1543, Block Group 1, Census Tract 2535, Solano County, California",45,39,6
1000000US060952535001544,060952535001544,"Block 1544, Block Group 1, Census Tract 2535, Solano County, California",6,6,0
1000000US060952535001545,060952535001545,"Block 1545, Block Group 1, Census Tract 2535, Solano County, California",11,9,2
1000000US060952535001546,060952535001546,"Block 1546, Block Group 1, Census Tract 2535, Solano County, California",0,0,0
1000000US060952535001547,060952535001547,"Block 1547, Block Group 1, Census Tract 2535, Solano County, California",17,17,0
1000000US060952535001548,060952535001548,"Block 1548, Block Group 1, Census Tract 2535, Solano County, California",0,0,0
1000000US060952535001549,060952535001549,"Block 1549, Block Group 1, Census Tract 2535, Solano County, California",14,14,0
1000000US060952535001550,060952535001550,"Block 1550, Block Group 1, Census Tract 2535, Solano County, California",11,11,0
1000000US060952535001551,060952535001551,"Block 1551, Block Group 1, Census Tract 2535, Solano County, California",46,41,5
1000000US060952535001552,060952535001552,"Block 1552, Block Group 1, Census Tract 2535, Solano County, California",0,0,0
1000000US060952535001553,060952535001553,"Block 1553, Block Group 1, Census Tract 2535, Solano County, California",53,46,7
1000000US060952535001554,060952535001554,"Block 1554, Block Group 1, Census Tract 2535, Solano County, California",15,12,3
1000000US060952535001555,060952535001555,"Block 1555, Block Group 1, Census Tract 2535, Solano County, California",12,12,0
1000000US060952535001556,060952535001556,"Block 1556, Block Group 1, Census Tract 2535, Solano County, California",23,18,5
1000000US060952535001557,060952535001557,"Block 1557, Block Group 1, Census Tract 2535, Solano County, California",7,6,1
1000000US060952535001558,060952535001558,"Block 1558, Block Group 1, Census Tract 2535, Solano County, California",9,8,1
1000000US060952535001559,060952535001559,"Block 1559, Block Group 1, Census Tract 2535, Solano County, California",14,13,1
1000000US060952535001560,060952535001560,"Block 1560, Block Group 1, Census Tract 2535, Solano County, California",26,24,2
1000000US060952535001561,060952535001561,"Block 1561, Block Group 1, Census Tract 2535, Solano County, California",95,82,13
1000000US060952535001562,060952535001562,"Block 1562, Block Group 1, Census Tract 2535, Solano County, California",19,17,2
1000000US060952535001563,060952535001563,"Block 1563, Block Group 1, Census Tract 2535, Solano County, California",21,19,2
1000000US060952535001564,060952535001564,"Block 1564, Block Group 1, Census Tract 2535, Solano County, California",10,7,3
1000000US060952535001565,060952535001565,"Block 1565, Block Group 1, Census Tract 2535, Solano County, California",13,12,1
1000000US060952535001566,060952535001566,"Block 1566, Block Group 1, Census Tract 2535, Solano County, California",16,15,1
1000000US060952535001567,060952535001567,"Block 1567, Block Group 1, Census Tract 2535, Solano County, California",19,13,6
1000000US060952535001568,060952535001568,"Block 1568, Block Group 1, Census Tract 2535, Solano County, California",21,17,4
1000000US060952535001569,060952535001569,"Block 1569, Block Group 1, Census Tract 2535, Solano County, California",15,13,2
1000000US060952535001570,060952535001570,"Block 1570, Block Group 1, Census Tract 2535, Solano County, California",15,13,2
1000000US060952535001571,060952535001571,"Block 1571, Block Group 1, Census Tract 2535, Solano County, California",13,9,4
1000000US060952535001572,060952535001572,"Block 1572, Block Group 1, Census Tract 2535, Solano County, California",0,0,0
1000000US060952535001573,060952535001573,"Block 1573, Block Group 1, Census Tract 2535, Solano County, California",19,19,0
1000000US060952535001574,060952535001574,"Block 1574, Block Group 1, Census Tract 2535, Solano County, California",25,24,1
1000000US060952535001575,060952535001575,"Block 1575, Block Group 1, Census Tract 2535, Solano County, California",79,74,5
1000000US060952535001576,060952535001576,"Block 1576, Block Group 1, Census Tract 2535, Solano County, California",22,21,1
1000000US060952535001577,060952535001577,"Block 1577, Block Group 1, Census Tract 2535, Solano County, California",13,12,1
1000000US060952535001578,060952535001578,"Block 1578, Block Group 1, Census Tract 2535, Solano County, California",43,42,1
1000000US060952535001579,060952535001579,"Block 1579, Block Group 1, Census Tract 2535, Solano County, California",30,28,2
1000000US060952535001580,060952535001580,"Block 1580, Block Group 1, Census Tract 2535, Solano County, California",38,35,3
1000000US060952535001581,060952535001581,"Block 1581, Block Group 1, Census Tract 2535, Solano County, California",18,18,0
1000000US060952535001582,060952535001582,"Block 1582, Block Group 1, Census Tract 2535, Solano County, California",7,6,1
1000000US060952535001583,060952535001583,"Block 1583, Block Group 1, Census Tract 2535, Solano County, California",0,0,0
1000000US060952535001584,060952535001584,"Block 1584, Block Group 1, Census Tract 2535, Solano County, California",20,19,1
1000000US060952535001585,060952535001585,"Block 1585, Block Group 1, Census Tract 2535, Solano County, California",13,11,2
1000000US060952535001586,060952535001586,"Block 1586, Block Group 1, Census Tract 2535, Solano County, California",15,12,3
1000000US060952535001587,060952535001587,"Block 1587, Block Group 1, Census Tract 2535, Solano County, California",17,17,0
1000000US060952535001588,060952535001588,"Block 1588, Block Group 1, Census Tract 2535, Solano County, California",15,11,4
1000000US060952535001589,060952535001589,"Block 1589, Block Group 1, Census Tract 2535, Solano County, California",18,16,2
1000000US060952535001590,060952535001590,"Block 1590, Block Group 1, Census Tract 2535, Solano County, California",19,15,4
1000000US060952535001591,060952535001591,"Block 1591, Block Group 1, Census Tract 2535, Solano County, California",21,16,5
1000000US060952535001592,060952535001592,"Block 1592, Block Group 1, Census Tract 2535, Solano County, California",0,0,0
1000000US060952535001593,060952535001593,"Block 1593, Block Group 1, Census Tract 2535, Solano County, California",27,26,1
1000000US060952535001594,060952535001594,"Block 1594, Block Group 1, Census Tract 2535, Solano County, California",12,11,1
1000000US060952535001595,060952535001595,"Block 1595, Block Group 1, Census Tract 2535, Solano County, California",7,7,0
1000000US060952535001596,060952535001596,"Block 1596, Block Group 1, Census Tract 2535, Solano County, California",24,18,6
1000000US060952535001597,060952535001597,"Block 1597, Block Group 1, Census Tract 2535, Solano County, California",22,21,1
1000000US060952535001598,060952535001598,"Block 1598, Block Group 1, Census Tract 2535, Solano County, California",10,10,0
1000000US060952535001599,060952535001599,"Block 1599, Block Group 1, Census Tract 2535, Solano County, California",0,0,0
1000000US060952535001600,060952535001600,"Block 1600, Block Group 1, Census Tract 2535, Solano County, California",0,0,0
1000000US060952535001601,060952535001601,"Block 1601, Block Group 1, Census Tract 2535, Solano County, California",23,23,0
1000000US060952535001602,060952535001602,"Block 1602, Block Group 1, Census Tract 2535, Solano County, California",0,0,0
1000000US060952535001603,060952535001603,"Block 1603, Block Group 1, Census Tract 2535, Solano County, California",0,0,0
1000000US060952535001604,060952535001604,"Block 1604, Block Group 1, Census Tract 2535, Solano County, California",0,0,0
1000000US060952535001605,060952535001605,"Block 1605, Block Group 1, Census Tract 2535, Solano County, California",0,0,0
1000000US060952535001606,060952535001606,"Block 1606, Block Group 1, Census Tract 2535, Solano County, California",0,0,0
1000000US060952535001607,060952535001607,"Block 1607, Block Group 1, Census Tract 2535, Solano County, California",0,0,0
1000000US060952535001608,060952535001608,"Block 1608, Block Group 1, Census Tract 2535, Solano County, California",0,0,0
1000000US060952535001609,060952535001609,"Block 1609, Block Group 1, Census Tract 2535, Solano County, California",0,0,0
1000000US060952535001610,060952535001610,"Block 1610, Block Group 1, Census Tract 2535, Solano County, California",0,0,0
1000000US060952535001611,060952535001611,"Block 1611, Block Group 1, Census Tract 2535, Solano County, California",0,0,0
1000000US060952535001612,060952535001612,"Block 1612, Block Group 1, Census Tract 2535, Solano County, California",0,0,0
1000000US060952535001613,060952535001613,"Block 1613, Block Group 1, Census Tract 2535, Solano County, California",0,0,0
1000000US060952535001614,060952535001614,"Block 1614, Block Group 1, Census Tract 2535, Solano County, California",0,0,0
1000000US060952535001615,060952535001615,"Block 1615, Block Group 1, Census Tract 2535, Solano County, California",0,0,0
1000000US060952535001616,060952535001616,"Block 1616, Block Group 1, Census Tract 2535, Solano County, California",0,0,0
1000000US060952535001617,060952535001617,"Block 1617, Block Group 1, Census Tract 2535, Solano County, California",0,0,0
1000000US060952535001618,060952535001618,"Block 1618, Block Group 1, Census Tract 2535, Solano County, California",54,40,14
1000000US060952535001619,060952535001619,"Block 1619, Block Group 1, Census Tract 2535, Solano County, California",30,28,2
1000000US060952535001620,060952535001620,"Block 1620, Block Group 1, Census Tract 2535, Solano County, California",0,0,0
1000000US060952535001621,060952535001621,"Block 1621, Block Group 1, Census Tract 2535, Solano County, California",0,0,0
1000000US060952535001622,060952535001622,"Block 1622, Block Group 1, Census Tract 2535, Solano County, California",0,0,0
1000000US060952535001623,060952535001623,"Block 1623, Block Group 1, Census Tract 2535, Solano County, California",0,0,0
1000000US060952535001624,060952535001624,"Block 1624, Block Group 1, Census Tract 2535, Solano County, California",0,0,0
1000000US060952535001625,060952535001625,"Block 1625, Block Group 1, Census Tract 2535, Solano County, California",0,0,0
1000000US060952535001626,060952535001626,"Block 1626, Block Group 1, Census Tract 2535, Solano County, California",0,0,0
1000000US060952535001627,060952535001627,"Block 1627, Block Group 1, Census Tract 2535, Solano County, California",0,0,0
1000000US060952535001628,060952535001628,"Block 1628, Block Group 1, Census Tract 2535, Solano County, California",0,0,0
1000000US060952535001629,060952535001629,"Block 1629, Block Group 1, Census Tract 2535, Solano County, California",0,0,0
1000000US060952535001630,060952535001630,"Block 1630, Block Group 1, Census Tract 2535, Solano County, California",0,0,0
1000000US060952535001631,060952535001631,"Block 1631, Block Group 1, Census Tract 2535, Solano County, California",0,0,0
1000000US060952535001632,060952535001632,"Block 1632, Block Group 1, Census Tract 2535, Solano County, California",0,0,0
1000000US060952535001633,060952535001633,"Block 1633, Block Group 1, Census Tract 2535, Solano County, California",0,0,0
1000000US060952535001634,060952535001634,"Block 1634, Block Group 1, Census Tract 2535, Solano County, California",0,0,0
1000000US060952535001635,060952535001635,"Block 1635, Block Group 1, Census Tract 2535, Solano County, California",0,0,0
1000000US060952535001636,060952535001636,"Block 1636, Block Group 1, Census Tract 2535, Solano County, California",0,0,0
1000000US060952535001637,060952535001637,"Block 1637, Block Group 1, Census Tract 2535, Solano County, California",1,1,0
1000000US060952535001638,060952535001638,"Block 1638, Block Group 1, Census Tract 2535, Solano County, California",0,0,0
1000000US060952535001639,060952535001639,"Block 1639, Block Group 1, Census Tract 2535, Solano County, California",0,0,0
1000000US060952535001640,060952535001640,"Block 1640, Block Group 1, Census Tract 2535, Solano County, California",0,0,0
1000000US060952535001641,060952535001641,"Block 1641, Block Group 1, Census Tract 2535, Solano County, California",0,0,0
1000000US060952535001642,060952535001642,"Block 1642, Block Group 1, Census Tract 2535, Solano County, California",0,0,0
1000000US060952535001643,060952535001643,"Block 1643, Block Group 1, Census Tract 2535, Solano County, California",0,0,0
1000000US060952535001644,060952535001644,"Block 1644, Block Group 1, Census Tract 2535, Solano County, California",0,0,0
1000000US060952535001645,060952535001645,"Block 1645, Block Group 1, Census Tract 2535, Solano County, California",0,0,0
1000000US060952535001646,060952535001646,"Block 1646, Block Group 1, Census Tract 2535, Solano County, California",0,0,0
1000000US060952535001647,060952535001647,"Block 1647, Block Group 1, Census Tract 2535, Solano County, California",0,0,0
1000000US060952535001648,060952535001648,"Block 1648, Block Group 1, Census Tract 2535, Solano County, California",0,0,0
1000000US060952535001649,060952535001649,"Block 1649, Block Group 1, Census Tract 2535, Solano County, California",0,0,0
1000000US060952535001650,060952535001650,"Block 1650, Block Group 1, Census Tract 2535, Solano County, California",0,0,0
1000000US060952535001651,060952535001651,"Block 1651, Block Group 1, Census Tract 2535, Solano County, California",0,0,0
1000000US060952535001652,060952535001652,"Block 1652, Block Group 1, Census Tract 2535, Solano County, California",0,0,0
1000000US060952535001653,060952535001653,"Block 1653, Block Group 1, Census Tract 2535, Solano County, California",0,0,0
1000000US060952535001654,060952535001654,"Block 1654, Block Group 1, Census Tract 2535, Solano County, California",0,0,0
1000000US060952535001655,060952535001655,"Block 1655, Block Group 1, Census Tract 2535, Solano County, California",0,0,0
1000000US060952535001656,060952535001656,"Block 1656, Block Group 1, Census Tract 2535, Solano County, California",0,0,0
1000000US060952535001657,060952535001657,"Block 1657, Block Group 1, Census Tract 2535, Solano County, California",0,0,0
1000000US060952535001658,060952535001658,"Block 1658, Block Group 1, Census Tract 2535, Solano County, California",0,0,0
1000000US060952535001659,060952535001659,"Block 1659, Block Group 1, Census Tract 2535, Solano County, California",0,0,0
1000000US060952535001660,060952535001660,"Block 1660, Block Group 1, Census Tract 2535, Solano County, California",0,0,0
1000000US060952535001661,060952535001661,"Block 1661, Block Group 1, Census Tract 2535, Solano County, California",0,0,0
1000000US060952535001662,060952535001662,"Block 1662, Block Group 1, Census Tract 2535, Solano County, California",2,2,0
1000000US060952535001663,060952535001663,"Block 1663, Block Group 1, Census Tract 2535, Solano County, California",5,5,0
1000000US060952535001664,060952535001664,"Block 1664, Block Group 1, Census Tract 2535, Solano County, California",1,1,0
1000000US060952535001665,060952535001665,"Block 1665, Block Group 1, Census Tract 2535, Solano County, California",0,0,0
1000000US060952535001666,060952535001666,"Block 1666, Block Group 1, Census Tract 2535, Solano County, California",0,0,0
1000000US060952535001667,060952535001667,"Block 1667, Block Group 1, Census Tract 2535, Solano County, California",0,0,0
1000000US060952535001668,060952535001668,"Block 1668, Block Group 1, Census Tract 2535, Solano County, California",0,0,0
1000000US060952535001669,060952535001669,"Block 1669, Block Group 1, Census Tract 2535, Solano County, California",0,0,0
1000000US060952535001670,060952535001670,"Block 1670, Block Group 1, Census Tract 2535, Solano County, California",4,3,1
1000000US060952535001671,060952535001671,"Block 1671, Block Group 1, Census Tract 2535, Solano County, California",0,0,0
1000000US060952535001672,060952535001672,"Block 1672, Block Group 1, Census Tract 2535, Solano County, California",0,0,0
1000000US060952535001673,060952535001673,"Block 1673, Block Group 1, Census Tract 2535, Solano County, California",0,0,0
1000000US060952535001674,060952535001674,"Block 1674, Block Group 1, Census Tract 2535, Solano County, California",10,8,2
1000000US060952535001675,060952535001675,"Block 1675, Block Group 1, Census Tract 2535, Solano County, California",20,16,4
1000000US060952535001676,060952535001676,"Block 1676, Block Group 1, Census Tract 2535, Solano County, California",0,0,0
1000000US060952535001677,060952535001677,"Block 1677, Block Group 1, Census Tract 2535, Solano County, California",0,0,0
1000000US060952535001678,060952535001678,"Block 1678, Block Group 1, Census Tract 2535, Solano County, California",0,0,0
1000000US060952535001679,060952535001679,"Block 1679, Block Group 1, Census Tract 2535, Solano County, California",0,0,0
1000000US060952535001680,060952535001680,"Block 1680, Block Group 1, Census Tract 2535, Solano County, California",0,0,0
1000000US060952535001681,060952535001681,"Block 1681, Block Group 1, Census Tract 2535, Solano County, California",0,0,0
1000000US060952535001682,060952535001682,"Block 1682, Block Group 1, Census Tract 2535, Solano County, California",0,0,0
1000000US060952535001683,060952535001683,"Block 1683, Block Group 1, Census Tract 2535, Solano County, California",0,0,0
1000000US060952535001684,060952535001684,"Block 1684, Block Group 1, Census Tract 2535, Solano County, California",0,0,0
1000000US060952535002000,060952535002000,"Block 2000, Block Group 2, Census Tract 2535, Solano County, California",0,0,0
1000000US060952535002001,060952535002001,"Block 2001, Block Group 2, Census Tract 2535, Solano County, California",35,35,0
1000000US060952535002002,060952535002002,"Block 2002, Block Group 2, Census Tract 2535, Solano County, California",0,0,0
1000000US060952535002003,060952535002003,"Block 2003, Block Group 2, Census Tract 2535, Solano County, California",128,119,9
1000000US060952535002004,060952535002004,"Block 2004, Block Group 2, Census Tract 2535, Solano County, California",9,8,1
1000000US060952535002005,060952535002005,"Block 2005, Block Group 2, Census Tract 2535, Solano County, California",19,19,0
1000000US060952535002006,060952535002006,"Block 2006, Block Group 2, Census Tract 2535, Solano County, California",24,23,1
1000000US060952535002007,060952535002007,"Block 2007, Block Group 2, Census Tract 2535, Solano County, California",10,10,0
1000000US060952535002008,060952535002008,"Block 2008, Block Group 2, Census Tract 2535, Solano County, California",24,21,3
1000000US060952535002009,060952535002009,"Block 2009, Block Group 2, Census Tract 2535, Solano County, California",10,9,1
1000000US060952535002010,060952535002010,"Block 2010, Block Group 2, Census Tract 2535, Solano County, California",35,34,1
1000000US060952535002011,060952535002011,"Block 2011, Block Group 2, Census Tract 2535, Solano County, California",27,27,0
1000000US060952535002012,060952535002012,"Block 2012, Block Group 2, Census Tract 2535, Solano County, California",11,11,0
1000000US060952535002013,060952535002013,"Block 2013, Block Group 2, Census Tract 2535, Solano County, California",41,39,2
1000000US060952535002014,060952535002014,"Block 2014, Block Group 2, Census Tract 2535, Solano County, California",14,14,0
1000000US060952535002015,060952535002015,"Block 2015, Block Group 2, Census Tract 2535, Solano County, California",15,12,3
1000000US060952535002016,060952535002016,"Block 2016, Block Group 2, Census Tract 2535, Solano County, California",14,14,0
1000000US060952535002017,060952535002017,"Block 2017, Block Group 2, Census Tract 2535, Solano County, California",0,0,0
1000000US060952535002018,060952535002018,"Block 2018, Block Group 2, Census Tract 2535, Solano County, California",10,10,0
1000000US060952535002019,060952535002019,"Block 2019, Block Group 2, Census Tract 2535, Solano County, California",28,27,1
1000000US060952535002020,060952535002020,"Block 2020, Block Group 2, Census Tract 2535, Solano County, California",18,18,0
1000000US060952535002021,060952535002021,"Block 2021, Block Group 2, Census Tract 2535, Solano County, California",17,16,1
1000000US060952535002022,060952535002022,"Block 2022, Block Group 2, Census Tract 2535, Solano County, California",18,18,0
1000000US060952535002023,060952535002023,"Block 2023, Block Group 2, Census Tract 2535, Solano County, California",19,18,1
1000000US060952535002024,060952535002024,"Block 2024, Block Group 2, Census Tract 2535, Solano County, California",29,27,2
1000000US060952535002025,060952535002025,"Block 2025, Block Group 2, Census Tract 2535, Solano County, California",51,44,7
1000000US060952535002026,060952535002026,"Block 2026, Block Group 2, Census Tract 2535, Solano County, California",17,14,3
1000000US060952535002027,060952535002027,"Block 2027, Block Group 2, Census Tract 2535, Solano County, California",21,17,4
1000000US060952535002028,060952535002028,"Block 2028, Block Group 2, Census Tract 2535, Solano County, California",0,0,0
1000000US060952535002029,060952535002029,"Block 2029, Block Group 2, Census Tract 2535, Solano County, California",4,4,0
1000000US060952535002030,060952535002030,"Block 2030, Block Group 2, Census Tract 2535, Solano County, California",4,4,0
1000000US060952535002031,060952535002031,"Block 2031, Block Group 2, Census Tract 2535, Solano County, California",10,9,1
1000000US060952535002032,060952535002032,"Block 2032, Block Group 2, Census Tract 2535, Solano County, California",16,14,2
1000000US060952535002033,060952535002033,"Block 2033, Block Group 2, Census Tract 2535, Solano County, California",12,10,2
1000000US060952535002034,060952535002034,"Block 2034, Block Group 2, Census Tract 2535, Solano County, California",0,0,0
1000000US060952535002035,060952535002035,"Block 2035, Block Group 2, Census Tract 2535, Solano County, California",3,2,1
1000000US060952535003000,060952535003000,"Block 3000, Block Group 3, Census Tract 2535, Solano County, California",4,3,1
1000000US060952535003001,060952535003001,"Block 3001, Block Group 3, Census Tract 2535, Solano County, California",0,0,0
1000000US060952535003002,060952535003002,"Block 3002, Block Group 3, Census Tract 2535, Solano County, California",0,0,0
1000000US060952535003003,060952535003003,"Block 3003, Block Group 3, Census Tract 2535, Solano County, California",40,34,6
1000000US060952535003004,060952535003004,"Block 3004, Block Group 3, Census Tract 2535, Solano County, California",16,16,0
1000000US060952535003005,060952535003005,"Block 3005, Block Group 3, Census Tract 2535, Solano County, California",9,9,0
1000000US060952535003006,060952535003006,"Block 3006, Block Group 3, Census Tract 2535, Solano County, California",23,20,3
1000000US060952535003007,060952535003007,"Block 3007, Block Group 3, Census Tract 2535, Solano County, California",0,0,0
1000000US060952535003008,060952535003008,"Block 3008, Block Group 3, Census Tract 2535, Solano County, California",22,19,3
1000000US060952535003009,060952535003009,"Block 3009, Block Group 3, Census Tract 2535, Solano County, California",12,10,2
1000000US060952535003010,060952535003010,"Block 3010, Block Group 3, Census Tract 2535, Solano County, California",2,2,0
1000000US060952535003011,060952535003011,"Block 3011, Block Group 3, Census Tract 2535, Solano County, California",11,10,1
1000000US060952535003012,060952535003012,"Block 3012, Block Group 3, Census Tract 2535, Solano County, California",22,19,3
1000000US060952535003013,060952535003013,"Block 3013, Block Group 3, Census Tract 2535, Solano County, California",5,4,1
1000000US060952535003014,060952535003014,"Block 3014, Block Group 3, Census Tract 2535, Solano County, California",13,11,2
1000000US060952535003015,060952535003015,"Block 3015, Block Group 3, Census Tract 2535, Solano County, California",0,0,0
1000000US060952535003016,060952535003016,"Block 3016, Block Group 3, Census Tract 2535, Solano County, California",0,0,0
1000000US060952535003017,060952535003017,"Block 3017, Block Group 3, Census Tract 2535, Solano County, California",1,1,0
1000000US060952535003018,060952535003018,"Block 3018, Block Group 3, Census Tract 2535, Solano County, California",0,0,0
1000000US060952535003019,060952535003019,"Block 3019, Block Group 3, Census Tract 2535, Solano County, California",13,13,0
1000000US060952535003020,060952535003020,"Block 3020, Block Group 3, Census Tract 2535, Solano County, California",16,12,4
1000000US060952535003021,060952535003021,"Block 3021, Block Group 3, Census Tract 2535, Solano County, California",17,10,7
1000000US060952535003022,060952535003022,"Block 3022, Block Group 3, Census Tract 2535, Solano County, California",17,14,3
1000000US060952535003023,060952535003023,"Block 3023, Block Group 3, Census Tract 2535, Solano County, California",7,6,1
1000000US060952535003024,060952535003024,"Block 3024, Block Group 3, Census Tract 2535, Solano County, California",25,21,4
1000000US060952535003025,060952535003025,"Block 3025, Block Group 3, Census Tract 2535, Solano County, California",22,17,5
1000000US060952535003026,060952535003026,"Block 3026, Block Group 3, Census Tract 2535, Solano County, California",17,11,6
1000000US060952535003027,060952535003027,"Block 3027, Block Group 3, Census Tract 2535, Solano County, California",0,0,0
1000000US060952535003028,060952535003028,"Block 3028, Block Group 3, Census Tract 2535, Solano County, California",7,7,0
1000000US060952535003029,060952535003029,"Block 3029, Block Group 3, Census Tract 2535, Solano County, California",0,0,0
1000000US060952535003030,060952535003030,"Block 3030, Block Group 3, Census Tract 2535, Solano County, California",72,49,23
1000000US060952535003031,060952535003031,"Block 3031, Block Group 3, Census Tract 2535, Solano County, California",11,8,3
1000000US060952535003032,060952535003032,"Block 3032, Block Group 3, Census Tract 2535, Solano County, California",20,17,3
1000000US060952535003033,060952535003033,"Block 3033, Block Group 3, Census Tract 2535, Solano County, California",26,20,6
1000000US060952535003034,060952535003034,"Block 3034, Block Group 3, Census Tract 2535, Solano County, California",12,11,1
1000000US060952535003035,060952535003035,"Block 3035, Block Group 3, Census Tract 2535, Solano County, California",11,8,3
1000000US060952535003036,060952535003036,"Block 3036, Block Group 3, Census Tract 2535, Solano County, California",15,15,0
1000000US060952535003037,060952535003037,"Block 3037, Block Group 3, Census Tract 2535, Solano County, California",14,12,2
1000000US060952535003038,060952535003038,"Block 3038, Block Group 3, Census Tract 2535, Solano County, California",42,41,1
1000000US060952535003039,060952535003039,"Block 3039, Block Group 3, Census Tract 2535, Solano County, California",18,17,1
1000000US060952535003040,060952535003040,"Block 3040, Block Group 3, Census Tract 2535, Solano County, California",24,19,5
1000000US060952535003041,060952535003041,"Block 3041, Block Group 3, Census Tract 2535, Solano County, California",23,16,7
1000000US060952535003042,060952535003042,"Block 3042, Block Group 3, Census Tract 2535, Solano County, California",7,6,1
1000000US060952535003043,060952535003043,"Block 3043, Block Group 3, Census Tract 2535, Solano County, California",15,14,1
1000000US060952535003044,060952535003044,"Block 3044, Block Group 3, Census Tract 2535, Solano County, California",1,1,0
1000000US060952535003045,060952535003045,"Block 3045, Block Group 3, Census Tract 2535, Solano County, California",9,7,2
1000000US060952535003046,060952535003046,"Block 3046, Block Group 3, Census Tract 2535, Solano County, California",4,2,2
1000000US060952535003047,060952535003047,"Block 3047, Block Group 3, Census Tract 2535, Solano County, California",2,1,1
1000000US060952535003048,060952535003048,"Block 3048, Block Group 3, Census Tract 2535, Solano County, California",5,3,2
1000000US060952535003049,060952535003049,"Block 3049, Block Group 3, Census Tract 2535, Solano County, California",0,0,0
1000000US060952535003050,060952535003050,"Block 3050, Block Group 3, Census Tract 2535, Solano County, California",14,11,3
1000000US060952535003051,060952535003051,"Block 3051, Block Group 3, Census Tract 2535, Solano County, California",7,7,0
1000000US060952535004000,060952535004000,"Block 4000, Block Group 4, Census Tract 2535, Solano County, California",3,3,0
1000000US060952535004001,060952535004001,"Block 4001, Block Group 4, Census Tract 2535, Solano County, California",0,0,0
1000000US060952535004002,060952535004002,"Block 4002, Block Group 4, Census Tract 2535, Solano County, California",0,0,0
1000000US060952535004003,060952535004003,"Block 4003, Block Group 4, Census Tract 2535, Solano County, California",0,0,0
1000000US060952535004004,060952535004004,"Block 4004, Block Group 4, Census Tract 2535, Solano County, California",5,5,0
1000000US060952535004005,060952535004005,"Block 4005, Block Group 4, Census Tract 2535, Solano County, California",4,4,0
1000000US060952535004006,060952535004006,"Block 4006, Block Group 4, Census Tract 2535, Solano County, California",0,0,0
1000000US060952535004007,060952535004007,"Block 4007, Block Group 4, Census Tract 2535, Solano County, California",6,6,0
1000000US060952535004008,060952535004008,"Block 4008, Block Group 4, Census Tract 2535, Solano County, California",0,0,0
1000000US060952535004009,060952535004009,"Block 4009, Block Group 4, Census Tract 2535, Solano County, California",0,0,0
1000000US060952535004010,060952535004010,"Block 4010, Block Group 4, Census Tract 2535, Solano County, California",0,0,0
1000000US060952535004011,060952535004011,"Block 4011, Block Group 4, Census Tract 2535, Solano County, California",0,0,0
1000000US060952535004012,060952535004012,"Block 4012, Block Group 4, Census Tract 2535, Solano County, California",0,0,0
1000000US060952535004013,060952535004013,"Block 4013, Block Group 4, Census Tract 2535, Solano County, California",0,0,0
1000000US060952535004014,060952535004014,"Block 4014, Block Group 4, Census Tract 2535, Solano County, California",2,2,0
1000000US060952535004015,060952535004015,"Block 4015, Block Group 4, Census Tract 2535, Solano County, California",0,0,0
1000000US060952535004016,060952535004016,"Block 4016, Block Group 4, Census Tract 2535, Solano County, California",0,0,0
1000000US060952535004017,060952535004017,"Block 4017, Block Group 4, Census Tract 2535, Solano County, California",2,2,0
1000000US060952535004018,060952535004018,"Block 4018, Block Group 4, Census Tract 2535, Solano County, California",5,5,0
1000000US060952535004019,060952535004019,"Block 4019, Block Group 4, Census Tract 2535, Solano County, California",0,0,0
1000000US060952535004020,060952535004020,"Block 4020, Block Group 4, Census Tract 2535, Solano County, California",0,0,0
1000000US060952535004021,060952535004021,"Block 4021, Block Group 4, Census Tract 2535, Solano County, California",0,0,0
1000000US060952535004022,060952535004022,"Block 4022, Block Group 4, Census Tract 2535, Solano County, California",0,0,0
1000000US060952535004023,060952535004023,"Block 4023, Block Group 4, Census Tract 2535, Solano County, California",0,0,0
1000000US060952535004024,060952535004024,"Block 4024, Block Group 4, Census Tract 2535, Solano County, California",0,0,0
1000000US060952535004025,060952535004025,"Block 4025, Block Group 4, Census Tract 2535, Solano County, California",0,0,0
1000000US060952535004026,060952535004026,"Block 4026, Block Group 4, Census Tract 2535, Solano County, California",5,4,1
1000000US060952535004027,060952535004027,"Block 4027, Block Group 4, Census Tract 2535, Solano County, California",0,0,0
1000000US060952535004028,060952535004028,"Block 4028, Block Group 4, Census Tract 2535, Solano County, California",1,1,0
1000000US060952535004029,060952535004029,"Block 4029, Block Group 4, Census Tract 2535, Solano County, California",0,0,0
1000000US060952535004030,060952535004030,"Block 4030, Block Group 4, Census Tract 2535, Solano County, California",0,0,0
1000000US060952535004031,060952535004031,"Block 4031, Block Group 4, Census Tract 2535, Solano County, California",0,0,0
1000000US060952535004032,060952535004032,"Block 4032, Block Group 4, Census Tract 2535, Solano County, California",0,0,0
1000000US060952535004033,060952535004033,"Block 4033, Block Group 4, Census Tract 2535, Solano County, California",0,0,0
1000000US060952535004034,060952535004034,"Block 4034, Block Group 4, Census Tract 2535, Solano County, California",0,0,0
1000000US060952535004035,060952535004035,"Block 4035, Block Group 4, Census Tract 2535, Solano County, California",0,0,0
1000000US060952535004036,060952535004036,"Block 4036, Block Group 4, Census Tract 2535, Solano County, California",0,0,0
1000000US060952535004037,060952535004037,"Block 4037, Block Group 4, Census Tract 2535, Solano County, California",0,0,0
1000000US060952535004038,060952535004038,"Block 4038, Block Group 4, Census Tract 2535, Solano County, California",0,0,0
1000000US060952535004039,060952535004039,"Block 4039, Block Group 4, Census Tract 2535, Solano County, California",0,0,0
1000000US060952535004040,060952535004040,"Block 4040, Block Group 4, Census Tract 2535, Solano County, California",0,0,0
1000000US060952535004041,060952535004041,"Block 4041, Block Group 4, Census Tract 2535, Solano County, California",0,0,0
1000000US060952535004042,060952535004042,"Block 4042, Block Group 4, Census Tract 2535, Solano County, California",0,0,0
1000000US060952535004043,060952535004043,"Block 4043, Block Group 4, Census Tract 2535, Solano County, California",0,0,0
1000000US060952535004044,060952535004044,"Block 4044, Block Group 4, Census Tract 2535, Solano County, California",0,0,0
1000000US060952535004045,060952535004045,"Block 4045, Block Group 4, Census Tract 2535, Solano County, California",3,3,0
1000000US060952535004046,060952535004046,"Block 4046, Block Group 4, Census Tract 2535, Solano County, California",0,0,0
1000000US060952535004047,060952535004047,"Block 4047, Block Group 4, Census Tract 2535, Solano County, California",0,0,0
1000000US060952535004048,060952535004048,"Block 4048, Block Group 4, Census Tract 2535, Solano County, California",2,2,0
1000000US060952535004049,060952535004049,"Block 4049, Block Group 4, Census Tract 2535, Solano County, California",0,0,0
1000000US060952535004050,060952535004050,"Block 4050, Block Group 4, Census Tract 2535, Solano County, California",0,0,0
1000000US060952535004051,060952535004051,"Block 4051, Block Group 4, Census Tract 2535, Solano County, California",0,0,0
1000000US060952535004052,060952535004052,"Block 4052, Block Group 4, Census Tract 2535, Solano County, California",1,1,0
1000000US060952535004053,060952535004053,"Block 4053, Block Group 4, Census Tract 2535, Solano County, California",0,0,0
1000000US060952535004054,060952535004054,"Block 4054, Block Group 4, Census Tract 2535, Solano County, California",2,2,0
1000000US060952535004055,060952535004055,"Block 4055, Block Group 4, Census Tract 2535, Solano County, California",0,0,0
1000000US060952535004056,060952535004056,"Block 4056, Block Group 4, Census Tract 2535, Solano County, California",0,0,0
1000000US060952535004057,060952535004057,"Block 4057, Block Group 4, Census Tract 2535, Solano County, California",0,0,0
1000000US060952535004058,060952535004058,"Block 4058, Block Group 4, Census Tract 2535, Solano County, California",2,2,0
1000000US060952535004059,060952535004059,"Block 4059, Block Group 4, Census Tract 2535, Solano County, California",0,0,0
1000000US060952535004060,060952535004060,"Block 4060, Block Group 4, Census Tract 2535, Solano County, California",0,0,0
1000000US060952535004061,060952535004061,"Block 4061, Block Group 4, Census Tract 2535, Solano County, California",3,3,0
1000000US060952535004062,060952535004062,"Block 4062, Block Group 4, Census Tract 2535, Solano County, California",1,1,0
1000000US060952535004063,060952535004063,"Block 4063, Block Group 4, Census Tract 2535, Solano County, California",0,0,0
1000000US060952535004064,060952535004064,"Block 4064, Block Group 4, Census Tract 2535, Solano County, California",0,0,0
1000000US060952535004065,060952535004065,"Block 4065, Block Group 4, Census Tract 2535, Solano County, California",0,0,0
1000000US060952535004066,060952535004066,"Block 4066, Block Group 4, Census Tract 2535, Solano County, California",0,0,0
1000000US060952535004067,060952535004067,"Block 4067, Block Group 4, Census Tract 2535, Solano County, California",0,0,0
1000000US060952535004068,060952535004068,"Block 4068, Block Group 4, Census Tract 2535, Solano County, California",3,3,0
1000000US060952535004069,060952535004069,"Block 4069, Block Group 4, Census Tract 2535, Solano County, California",0,0,0
1000000US060952535004070,060952535004070,"Block 4070, Block Group 4, Census Tract 2535, Solano County, California",1,1,0
1000000US060952535004071,060952535004071,"Block 4071, Block Group 4, Census Tract 2535, Solano County, California",0,0,0
1000000US060952535004072,060952535004072,"Block 4072, Block Group 4, Census Tract 2535, Solano County, California",38,36,2
1000000US060952535004073,060952535004073,"Block 4073, Block Group 4, Census Tract 2535, Solano County, California",0,0,0
1000000US060952535004074,060952535004074,"Block 4074, Block Group 4, Census Tract 2535, Solano County, California",21,19,2
1000000US060952535004075,060952535004075,"Block 4075, Block Group 4, Census Tract 2535, Solano County, California",190,152,38
1000000US060952535004076,060952535004076,"Block 4076, Block Group 4, Census Tract 2535, Solano County, California",15,14,1
1000000US060952535004077,060952535004077,"Block 4077, Block Group 4, Census Tract 2535, Solano County, California",39,38,1
1000000US060952535004078,060952535004078,"Block 4078, Block Group 4, Census Tract 2535, Solano County, California",10,9,1
1000000US060952535004079,060952535004079,"Block 4079, Block Group 4, Census Tract 2535, Solano County, California",0,0,0
1000000US060952535004080,060952535004080,"Block 4080, Block Group 4, Census Tract 2535, Solano County, California",36,34,2
1000000US060952535004081,060952535004081,"Block 4081, Block Group 4, Census Tract 2535, Solano County, California",19,17,2
1000000US060952535004082,060952535004082,"Block 4082, Block Group 4, Census Tract 2535, Solano County, California",0,0,0
1000000US060952535004083,060952535004083,"Block 4083, Block Group 4, Census Tract 2535, Solano County, California",0,0,0
1000000US060952535004084,060952535004084,"Block 4084, Block Group 4, Census Tract 2535, Solano County, California",0,0,0
1000000US060952535004085,060952535004085,"Block 4085, Block Group 4, Census Tract 2535, Solano County, California",1,1,0
1000000US060952535004086,060952535004086,"Block 4086, Block Group 4, Census Tract 2535, Solano County, California",0,0,0
1000000US060952535004087,060952535004087,"Block 4087, Block Group 4, Census Tract 2535, Solano County, California",0,0,0
1000000US060952535004088,060952535004088,"Block 4088, Block Group 4, Census Tract 2535, Solano County, California",0,0,0
1000000US060952535004089,060952535004089,"Block 4089, Block Group 4, Census Tract 2535, Solano County, California",0,0,0
1000000US060952535004090,060952535004090,"Block 4090, Block Group 4, Census Tract 2535, Solano County, California",0,0,0
1000000US060952535004091,060952535004091,"Block 4091, Block Group 4, Census Tract 2535, Solano County, California",0,0,0
1000000US060952535004092,060952535004092,"Block 4092, Block Group 4, Census Tract 2535, Solano County, California",0,0,0
1000000US060952535004093,060952535004093,"Block 4093, Block Group 4, Census Tract 2535, Solano County, California",0,0,0
1000000US060952535004094,060952535004094,"Block 4094, Block Group 4, Census Tract 2535, Solano County, California",0,0,0
1000000US060952535004095,060952535004095,"Block 4095, Block Group 4, Census Tract 2535, Solano County, California",0,0,0
1000000US060952535004096,060952535004096,"Block 4096, Block Group 4, Census Tract 2535, Solano County, California",1,1,0
1000000US060952535004097,060952535004097,"Block 4097, Block Group 4, Census Tract 2535, Solano County, California",0,0,0
1000000US060952535004098,060952535004098,"Block 4098, Block Group 4, Census Tract 2535, Solano County, California",1,1,0
1000000US060952535004099,060952535004099,"Block 4099, Block Group 4, Census Tract 2535, Solano County, California",7,7,0
1000000US060952535004100,060952535004100,"Block 4100, Block Group 4, Census Tract 2535, Solano County, California",0,0,0
1000000US060952535004101,060952535004101,"Block 4101, Block Group 4, Census Tract 2535, Solano County, California",0,0,0
1000000US060952535004102,060952535004102,"Block 4102, Block Group 4, Census Tract 2535, Solano County, California",0,0,0
1000000US060952535004103,060952535004103,"Block 4103, Block Group 4, Census Tract 2535, Solano County, California",0,0,0
1000000US060952535004104,060952535004104,"Block 4104, Block Group 4, Census Tract 2535, Solano County, California",0,0,0
1000000US060952535004105,060952535004105,"Block 4105, Block Group 4, Census Tract 2535, Solano County, California",1,1,0
1000000US060952535004106,060952535004106,"Block 4106, Block Group 4, Census Tract 2535, Solano County, California",7,7,0
1000000US060952535004107,060952535004107,"Block 4107, Block Group 4, Census Tract 2535, Solano County, California",3,3,0
1000000US060952535004108,060952535004108,"Block 4108, Block Group 4, Census Tract 2535, Solano County, California",0,0,0
1000000US060952535004109,060952535004109,"Block 4109, Block Group 4, Census Tract 2535, Solano County, California",1,1,0
1000000US060952535004110,060952535004110,"Block 4110, Block Group 4, Census Tract 2535, Solano County, California",0,0,0
1000000US060952535004111,060952535004111,"Block 4111, Block Group 4, Census Tract 2535, Solano County, California",0,0,0
1000000US060952535004112,060952535004112,"Block 4112, Block Group 4, Census Tract 2535, Solano County, California",0,0,0
1000000US060952535004113,060952535004113,"Block 4113, Block Group 4, Census Tract 2535, Solano County, California",0,0,0
1000000US060952535004114,060952535004114,"Block 4114, Block Group 4, Census Tract 2535, Solano County, California",0,0,0
1000000US060952535004115,060952535004115,"Block 4115, Block Group 4, Census Tract 2535, Solano County, California",0,0,0
1000000US060952535004116,060952535004116,"Block 4116, Block Group 4, Census Tract 2535, Solano County, California",0,0,0
1000000US060952535004117,060952535004117,"Block 4117, Block Group 4, Census Tract 2535, Solano County, California",0,0,0
1000000US060952535004118,060952535004118,"Block 4118, Block Group 4, Census Tract 2535, Solano County, California",0,0,0
1000000US060952535004119,060952535004119,"Block 4119, Block Group 4, Census Tract 2535, Solano County, California",0,0,0
1000000US060952535004120,060952535004120,"Block 4120, Block Group 4, Census Tract 2535, Solano County, California",0,0,0
1000000US060952535004121,060952535004121,"Block 4121, Block Group 4, Census Tract 2535, Solano County, California",2,2,0
1000000US060952535004122,060952535004122,"Block 4122, Block Group 4, Census Tract 2535, Solano County, California",0,0,0
1000000US060952535004123,060952535004123,"Block 4123, Block Group 4, Census Tract 2535, Solano County, California",0,0,0
1000000US060952535004124,060952535004124,"Block 4124, Block Group 4, Census Tract 2535, Solano County, California",0,0,0
1000000US060952535004125,060952535004125,"Block 4125, Block Group 4, Census Tract 2535, Solano County, California",0,0,0
1000000US060952535004126,060952535004126,"Block 4126, Block Group 4, Census Tract 2535, Solano County, California",0,0,0
1000000US060952535004127,060952535004127,"Block 4127, Block Group 4, Census Tract 2535, Solano County, California",1,1,0
1000000US060952535004128,060952535004128,"Block 4128, Block Group 4, Census Tract 2535, Solano County, California",6,5,1
1000000US060952535004129,060952535004129,"Block 4129, Block Group 4, Census Tract 2535, Solano County, California",3,3,0
1000000US060952535004130,060952535004130,"Block 4130, Block Group 4, Census Tract 2535, Solano County, California",4,3,1
1000000US060952535004131,060952535004131,"Block 4131, Block Group 4, Census Tract 2535, Solano County, California",0,0,0
1000000US060952535004132,060952535004132,"Block 4132, Block Group 4, Census Tract 2535, Solano County, California",0,0,0
1000000US060952535004133,060952535004133,"Block 4133, Block Group 4, Census Tract 2535, Solano County, California",0,0,0
1000000US060952535004134,060952535004134,"Block 4134, Block Group 4, Census Tract 2535, Solano County, California",0,0,0
1000000US060952535004135,060952535004135,"Block 4135, Block Group 4, Census Tract 2535, Solano County, California",0,0,0
1000000US060952535004136,060952535004136,"Block 4136, Block Group 4, Census Tract 2535, Solano County, California",0,0,0
1000000US060952535004137,060952535004137,"Block 4137, Block Group 4, Census Tract 2535, Solano County, California",0,0,0
1000000US060952535004138,060952535004138,"Block 4138, Block Group 4, Census Tract 2535, Solano County, California",0,0,0
1000000US060952535004139,060952535004139,"Block 4139, Block Group 4, Census Tract 2535, Solano County, California",0,0,0
1000000US060952535004140,060952535004140,"Block 4140, Block Group 4, Census Tract 2535, Solano County, California",0,0,0
1000000US060952535004141,060952535004141,"Block 4141, Block Group 4, Census Tract 2535, Solano County, California",0,0,0
1000000US060952535004142,060952535004142,"Block 4142, Block Group 4, Census Tract 2535, Solano County, California",11,8,3
1000000US060952535004143,060952535004143,"Block 4143, Block Group 4, Census Tract 2535, Solano County, California",0,0,0
1000000US060952535004144,060952535004144,"Block 4144, Block Group 4, Census Tract 2535, Solano County, California",11,11,0
1000000US060952535004145,060952535004145,"Block 4145, Block Group 4, Census Tract 2535, Solano County, California",0,0,0
1000000US060952535004146,060952535004146,"Block 4146, Block Group 4, Census Tract 2535, Solano County, California",0,0,0
1000000US060952535004147,060952535004147,"Block 4147, Block Group 4, Census Tract 2535, Solano County, California",0,0,0
1000000US060952535004148,060952535004148,"Block 4148, Block Group 4, Census Tract 2535, Solano County, California",1,1,0
1000000US060952535004149,060952535004149,"Block 4149, Block Group 4, Census Tract 2535, Solano County, California",2,2,0
1000000US060952535004150,060952535004150,"Block 4150, Block Group 4, Census Tract 2535, Solano County, California",0,0,0
1000000US060952535004151,060952535004151,"Block 4151, Block Group 4, Census Tract 2535, Solano County, California",0,0,0
1000000US060952535004152,060952535004152,"Block 4152, Block Group 4, Census Tract 2535, Solano County, California",0,0,0
1000000US060952535004153,060952535004153,"Block 4153, Block Group 4, Census Tract 2535, Solano County, California",0,0,0
1000000US060952535004154,060952535004154,"Block 4154, Block Group 4, Census Tract 2535, Solano County, California",0,0,0
1000000US060952535004155,060952535004155,"Block 4155, Block Group 4, Census Tract 2535, Solano County, California",0,0,0
1000000US060952535004156,060952535004156,"Block 4156, Block Group 4, Census Tract 2535, Solano County, California",0,0,0
1000000US060952535004157,060952535004157,"Block 4157, Block Group 4, Census Tract 2535, Solano County, California",0,0,0
1000000US060952535004158,060952535004158,"Block 4158, Block Group 4, Census Tract 2535, Solano County, California",0,0,0
1000000US060952535004159,060952535004159,"Block 4159, Block Group 4, Census Tract 2535, Solano County, California",0,0,0
1000000US060952535004160,060952535004160,"Block 4160, Block Group 4, Census Tract 2535, Solano County, California",0,0,0
1000000US060952535004161,060952535004161,"Block 4161, Block Group 4, Census Tract 2535, Solano County, California",0,0,0
1000000US060952535004162,060952535004162,"Block 4162, Block Group 4, Census Tract 2535, Solano County, California",0,0,0
1000000US060952535004163,060952535004163,"Block 4163, Block Group 4, Census Tract 2535, Solano County, California",0,0,0
1000000US060952535004164,060952535004164,"Block 4164, Block Group 4, Census Tract 2535, Solano County, California",0,0,0
1000000US060952535004165,060952535004165,"Block 4165, Block Group 4, Census Tract 2535, Solano County, California",0,0,0
1000000US060952535004166,060952535004166,"Block 4166, Block Group 4, Census Tract 2535, Solano County, California",4,3,1
1000000US060952535004167,060952535004167,"Block 4167, Block Group 4, Census Tract 2535, Solano County, California",8,2,6
1000000US060952535004168,060952535004168,"Block 4168, Block Group 4, Census Tract 2535, Solano County, California",0,0,0
1000000US060952535004169,060952535004169,"Block 4169, Block Group 4, Census Tract 2535, Solano County, California",0,0,0
1000000US060952535004170,060952535004170,"Block 4170, Block Group 4, Census Tract 2535, Solano County, California",0,0,0
1000000US060952535004171,060952535004171,"Block 4171, Block Group 4, Census Tract 2535, Solano County, California",0,0,0
1000000US060952535004172,060952535004172,"Block 4172, Block Group 4, Census Tract 2535, Solano County, California",0,0,0
1000000US060952535004173,060952535004173,"Block 4173, Block Group 4, Census Tract 2535, Solano County, California",0,0,0
1000000US060952535004174,060952535004174,"Block 4174, Block Group 4, Census Tract 2535, Solano County, California",0,0,0
1000000US060952535004175,060952535004175,"Block 4175, Block Group 4, Census Tract 2535, Solano County, California",28,25,3
1000000US060952535004176,060952535004176,"Block 4176, Block Group 4, Census Tract 2535, Solano County, California",15,15,0
1000000US060952535004177,060952535004177,"Block 4177, Block Group 4, Census Tract 2535, Solano County, California",0,0,0
1000000US060952535004178,060952535004178,"Block 4178, Block Group 4, Census Tract 2535, Solano County, California",4,4,0
1000000US060952535004179,060952535004179,"Block 4179, Block Group 4, Census Tract 2535, Solano County, California",0,0,0
1000000US060952535004180,060952535004180,"Block 4180, Block Group 4, Census Tract 2535, Solano County, California",0,0,0
1000000US060952535004181,060952535004181,"Block 4181, Block Group 4, Census Tract 2535, Solano County, California",0,0,0
1000000US060952535004182,060952535004182,"Block 4182, Block Group 4, Census Tract 2535, Solano County, California",0,0,0
1000000US060959800001000,060959800001000,"Block 1000, Block Group 1, Census Tract 9800, Solano County, California",0,0,0
1000000US060959800001001,060959800001001,"Block 1001, Block Group 1, Census Tract 9800, Solano County, California",0,0,0
1000000US060959800001002,060959800001002,"Block 1002, Block Group 1, Census Tract 9800, Solano County, California",0,0,0
1000000US060959800001003,060959800001003,"Block 1003, Block Group 1, Census Tract 9800, Solano County, California",0,0,0
1000000US060959800001004,060959800001004,"Block 1004, Block Group 1, Census Tract 9800, Solano County, California",0,0,0
1000000US060959800001005,060959800001005,"Block 1005, Block Group 1, Census Tract 9800, Solano County, California",0,0,0
1000000US060959800001006,060959800001006,"Block 1006, Block Group 1, Census Tract 9800, Solano County, California",0,0,0
1000000US060959800001007,060959800001007,"Block 1007, Block Group 1, Census Tract 9800, Solano County, California",0,0,0
1000000US060959800001008,060959800001008,"Block 1008, Block Group 1, Census Tract 9800, Solano County, California",0,0,0
1000000US060959800001009,060959800001009,"Block 1009, Block Group 1, Census Tract 9800, Solano County, California",0,0,0
1000000US060959800001010,060959800001010,"Block 1010, Block Group 1, Census Tract 9800, Solano County, California",0,0,0
1000000US060959800001011,060959800001011,"Block 1011, Block Group 1, Census Tract 9800, Solano County, California",0,0,0
1000000US060959800001012,060959800001012,"Block 1012, Block Group 1, Census Tract 9800, Solano County, California",0,0,0
1000000US060959800001013,060959800001013,"Block 1013, Block Group 1, Census Tract 9800, Solano County, California",0,0,0
1000000US060959800001014,060959800001014,"Block 1014, Block Group 1, Census Tract 9800, Solano County, California",0,0,0
1000000US060959800001015,060959800001015,"Block 1015, Block Group 1, Census Tract 9800, Solano County, California",0,0,0
1000000US060959800001016,060959800001016,"Block 1016, Block Group 1, Census Tract 9800, Solano County, California",0,0,0
1000000US060959800001017,060959800001017,"Block 1017, Block Group 1, Census Tract 9800, Solano County, California",0,0,0
1000000US060959800001018,060959800001018,"Block 1018, Block Group 1, Census Tract 9800, Solano County, California",0,0,0
1000000US060959800001019,060959800001019,"Block 1019, Block Group 1, Census Tract 9800, Solano County, California",0,0,0
1000000US060959800001020,060959800001020,"Block 1020, Block Group 1, Census Tract 9800, Solano County, California",0,0,0
1000000US060959800001021,060959800001021,"Block 1021, Block Group 1, Census Tract 9800, Solano County, California",0,0,0
1000000US060959800001022,060959800001022,"Block 1022, Block Group 1, Census Tract 9800, Solano County, California",0,0,0
1000000US060959800001023,060959800001023,"Block 1023, Block Group 1, Census Tract 9800, Solano County, California",0,0,0
1000000US060959800001024,060959800001024,"Block 1024, Block Group 1, Census Tract 9800, Solano County, California",0,0,0
1000000US060959800001025,060959800001025,"Block 1025, Block Group 1, Census Tract 9800, Solano County, California",0,0,0
1000000US060959800001026,060959800001026,"Block 1026, Block Group 1, Census Tract 9800, Solano County, California",0,0,0
1000000US060959800001027,060959800001027,"Block 1027, Block Group 1, Census Tract 9800, Solano County, California",0,0,0
1000000US060959800001028,060959800001028,"Block 1028, Block Group 1, Census Tract 9800, Solano County, California",0,0,0
1000000US060959800001029,060959800001029,"Block 1029, Block Group 1, Census Tract 9800, Solano County, California",0,0,0
1000000US060959800001030,060959800001030,"Block 1030, Block Group 1, Census Tract 9800, Solano County, California",0,0,0
1000000US060959800001031,060959800001031,"Block 1031, Block Group 1, Census Tract 9800, Solano County, California",0,0,0
1000000US060959800001032,060959800001032,"Block 1032, Block Group 1, Census Tract 9800, Solano County, California",0,0,0
1000000US060959800001033,060959800001033,"Block 1033, Block Group 1, Census Tract 9800, Solano County, California",0,0,0
1000000US060959800001034,060959800001034,"Block 1034, Block Group 1, Census Tract 9800, Solano County, California",0,0,0
1000000US060959800001035,060959800001035,"Block 1035, Block Group 1, Census Tract 9800, Solano County, California",0,0,0
1000000US060959800001036,060959800001036,"Block 1036, Block Group 1, Census Tract 9800, Solano County, California",0,0,0
1000000US060959800001037,060959800001037,"Block 1037, Block Group 1, Census Tract 9800, Solano County, California",0,0,0
1000000US060959800001038,060959800001038,"Block 1038, Block Group 1, Census Tract 9800, Solano County, California",0,0,0
1000000US060959800001039,060959800001039,"Block 1039, Block Group 1, Census Tract 9800, Solano County, California",0,0,0
1000000US060959800001040,060959800001040,"Block 1040, Block Group 1, Census Tract 9800, Solano County, California",0,0,0
1000000US060959800001041,060959800001041,"Block 1041, Block Group 1, Census Tract 9800, Solano County, California",0,0,0
1000000US060959800001042,060959800001042,"Block 1042, Block Group 1, Census Tract 9800, Solano County, California",0,0,0
1000000US060959800001043,060959800001043,"Block 1043, Block Group 1, Census Tract 9800, Solano County, California",0,0,0
1000000US060959800001044,060959800001044,"Block 1044, Block Group 1, Census Tract 9800, Solano County, California",0,0,0
1000000US060959800001045,060959800001045,"Block 1045, Block Group 1, Census Tract 9800, Solano County, California",0,0,0
1000000US060959800001046,060959800001046,"Block 1046, Block Group 1, Census Tract 9800, Solano County, California",0,0,0
1000000US060959800001047,060959800001047,"Block 1047, Block Group 1, Census Tract 9800, Solano County, California",0,0,0
1000000US060959800001048,060959800001048,"Block 1048, Block Group 1, Census Tract 9800, Solano County, California",0,0,0
1000000US060959800001049,060959800001049,"Block 1049, Block Group 1, Census Tract 9800, Solano County, California",0,0,0
1000000US060959800001050,060959800001050,"Block 1050, Block Group 1, Census Tract 9800, Solano County, California",0,0,0
1000000US060959800001051,060959800001051,"Block 1051, Block Group 1, Census Tract 9800, Solano County, California",0,0,0
1000000US060959800001052,060959800001052,"Block 1052, Block Group 1, Census Tract 9800, Solano County, California",0,0,0
1000000US060959800001053,060959800001053,"Block 1053, Block Group 1, Census Tract 9800, Solano County, California",0,0,0
1000000US060959800001054,060959800001054,"Block 1054, Block Group 1, Census Tract 9800, Solano County, California",0,0,0
1000000US060959800001055,060959800001055,"Block 1055, Block Group 1, Census Tract 9800, Solano County, California",0,0,0
1000000US060959800001056,060959800001056,"Block 1056, Block Group 1, Census Tract 9800, Solano County, California",0,0,0
1000000US060959800001057,060959800001057,"Block 1057, Block Group 1, Census Tract 9800, Solano County, California",3,3,0
1000000US060959800001058,060959800001058,"Block 1058, Block Group 1, Census Tract 9800, Solano County, California",0,0,0
1000000US060959800001059,060959800001059,"Block 1059, Block Group 1, Census Tract 9800, Solano County, California",0,0,0
1000000US060959800001060,060959800001060,"Block 1060, Block Group 1, Census Tract 9800, Solano County, California",0,0,0
1000000US060959800001061,060959800001061,"Block 1061, Block Group 1, Census Tract 9800, Solano County, California",0,0,0
1000000US060959800001062,060959800001062,"Block 1062, Block Group 1, Census Tract 9800, Solano County, California",0,0,0
1000000US060959800001063,060959800001063,"Block 1063, Block Group 1, Census Tract 9800, Solano County, California",0,0,0
1000000US060959800001064,060959800001064,"Block 1064, Block Group 1, Census Tract 9800, Solano County, California",0,0,0
1000000US060959800001065,060959800001065,"Block 1065, Block Group 1, Census Tract 9800, Solano County, California",0,0,0
