Id,Id2,Geography,Number,Occupied,Vacant
1000000US060971501001000,060971501001000,"Block 1000, Block Group 1, Census Tract 1501, Sonoma County, California",82,55,27
1000000US060971501001001,060971501001001,"Block 1001, Block Group 1, Census Tract 1501, Sonoma County, California",26,22,4
1000000US060971501001002,060971501001002,"Block 1002, Block Group 1, Census Tract 1501, Sonoma County, California",0,0,0
1000000US060971501001003,060971501001003,"Block 1003, Block Group 1, Census Tract 1501, Sonoma County, California",0,0,0
1000000US060971501001004,060971501001004,"Block 1004, Block Group 1, Census Tract 1501, Sonoma County, California",33,27,6
1000000US060971501001005,060971501001005,"Block 1005, Block Group 1, Census Tract 1501, Sonoma County, California",0,0,0
1000000US060971501001006,060971501001006,"Block 1006, Block Group 1, Census Tract 1501, Sonoma County, California",0,0,0
1000000US060971501001007,060971501001007,"Block 1007, Block Group 1, Census Tract 1501, Sonoma County, California",21,17,4
1000000US060971501001008,060971501001008,"Block 1008, Block Group 1, Census Tract 1501, Sonoma County, California",0,0,0
1000000US060971501001009,060971501001009,"Block 1009, Block Group 1, Census Tract 1501, Sonoma County, California",0,0,0
1000000US060971501001010,060971501001010,"Block 1010, Block Group 1, Census Tract 1501, Sonoma County, California",64,54,10
1000000US060971501001011,060971501001011,"Block 1011, Block Group 1, Census Tract 1501, Sonoma County, California",6,6,0
1000000US060971501001012,060971501001012,"Block 1012, Block Group 1, Census Tract 1501, Sonoma County, California",26,23,3
1000000US060971501001013,060971501001013,"Block 1013, Block Group 1, Census Tract 1501, Sonoma County, California",22,20,2
1000000US060971501001014,060971501001014,"Block 1014, Block Group 1, Census Tract 1501, Sonoma County, California",0,0,0
1000000US060971501001015,060971501001015,"Block 1015, Block Group 1, Census Tract 1501, Sonoma County, California",28,19,9
1000000US060971501001016,060971501001016,"Block 1016, Block Group 1, Census Tract 1501, Sonoma County, California",4,4,0
1000000US060971501001017,060971501001017,"Block 1017, Block Group 1, Census Tract 1501, Sonoma County, California",19,15,4
1000000US060971501001018,060971501001018,"Block 1018, Block Group 1, Census Tract 1501, Sonoma County, California",0,0,0
1000000US060971501001019,060971501001019,"Block 1019, Block Group 1, Census Tract 1501, Sonoma County, California",12,11,1
1000000US060971501001020,060971501001020,"Block 1020, Block Group 1, Census Tract 1501, Sonoma County, California",41,30,11
1000000US060971501001021,060971501001021,"Block 1021, Block Group 1, Census Tract 1501, Sonoma County, California",40,35,5
1000000US060971501001022,060971501001022,"Block 1022, Block Group 1, Census Tract 1501, Sonoma County, California",36,27,9
1000000US060971501001023,060971501001023,"Block 1023, Block Group 1, Census Tract 1501, Sonoma County, California",8,6,2
1000000US060971501001024,060971501001024,"Block 1024, Block Group 1, Census Tract 1501, Sonoma County, California",0,0,0
1000000US060971501001025,060971501001025,"Block 1025, Block Group 1, Census Tract 1501, Sonoma County, California",7,4,3
1000000US060971501001026,060971501001026,"Block 1026, Block Group 1, Census Tract 1501, Sonoma County, California",5,4,1
1000000US060971501001027,060971501001027,"Block 1027, Block Group 1, Census Tract 1501, Sonoma County, California",1,1,0
1000000US060971501001028,060971501001028,"Block 1028, Block Group 1, Census Tract 1501, Sonoma County, California",10,7,3
1000000US060971501001029,060971501001029,"Block 1029, Block Group 1, Census Tract 1501, Sonoma County, California",29,26,3
1000000US060971501001030,060971501001030,"Block 1030, Block Group 1, Census Tract 1501, Sonoma County, California",0,0,0
1000000US060971501001031,060971501001031,"Block 1031, Block Group 1, Census Tract 1501, Sonoma County, California",6,6,0
1000000US060971501001032,060971501001032,"Block 1032, Block Group 1, Census Tract 1501, Sonoma County, California",7,7,0
1000000US060971501001033,060971501001033,"Block 1033, Block Group 1, Census Tract 1501, Sonoma County, California",4,3,1
1000000US060971501001034,060971501001034,"Block 1034, Block Group 1, Census Tract 1501, Sonoma County, California",3,3,0
1000000US060971501001035,060971501001035,"Block 1035, Block Group 1, Census Tract 1501, Sonoma County, California",26,22,4
1000000US060971501001036,060971501001036,"Block 1036, Block Group 1, Census Tract 1501, Sonoma County, California",0,0,0
1000000US060971501001037,060971501001037,"Block 1037, Block Group 1, Census Tract 1501, Sonoma County, California",6,5,1
1000000US060971501001038,060971501001038,"Block 1038, Block Group 1, Census Tract 1501, Sonoma County, California",63,51,12
1000000US060971501001039,060971501001039,"Block 1039, Block Group 1, Census Tract 1501, Sonoma County, California",19,17,2
1000000US060971501001040,060971501001040,"Block 1040, Block Group 1, Census Tract 1501, Sonoma County, California",0,0,0
1000000US060971501002000,060971501002000,"Block 2000, Block Group 2, Census Tract 1501, Sonoma County, California",26,22,4
1000000US060971501002001,060971501002001,"Block 2001, Block Group 2, Census Tract 1501, Sonoma County, California",0,0,0
1000000US060971501002002,060971501002002,"Block 2002, Block Group 2, Census Tract 1501, Sonoma County, California",0,0,0
1000000US060971501002003,060971501002003,"Block 2003, Block Group 2, Census Tract 1501, Sonoma County, California",18,18,0
1000000US060971501002004,060971501002004,"Block 2004, Block Group 2, Census Tract 1501, Sonoma County, California",5,5,0
1000000US060971501002005,060971501002005,"Block 2005, Block Group 2, Census Tract 1501, Sonoma County, California",2,2,0
1000000US060971501002006,060971501002006,"Block 2006, Block Group 2, Census Tract 1501, Sonoma County, California",1,1,0
1000000US060971501002007,060971501002007,"Block 2007, Block Group 2, Census Tract 1501, Sonoma County, California",100,82,18
1000000US060971501002008,060971501002008,"Block 2008, Block Group 2, Census Tract 1501, Sonoma County, California",0,0,0
1000000US060971501002009,060971501002009,"Block 2009, Block Group 2, Census Tract 1501, Sonoma County, California",8,8,0
1000000US060971501002010,060971501002010,"Block 2010, Block Group 2, Census Tract 1501, Sonoma County, California",9,9,0
1000000US060971501002011,060971501002011,"Block 2011, Block Group 2, Census Tract 1501, Sonoma County, California",26,24,2
1000000US060971501002012,060971501002012,"Block 2012, Block Group 2, Census Tract 1501, Sonoma County, California",0,0,0
1000000US060971501002013,060971501002013,"Block 2013, Block Group 2, Census Tract 1501, Sonoma County, California",0,0,0
1000000US060971501002014,060971501002014,"Block 2014, Block Group 2, Census Tract 1501, Sonoma County, California",0,0,0
1000000US060971501002015,060971501002015,"Block 2015, Block Group 2, Census Tract 1501, Sonoma County, California",0,0,0
1000000US060971501002016,060971501002016,"Block 2016, Block Group 2, Census Tract 1501, Sonoma County, California",0,0,0
1000000US060971501002017,060971501002017,"Block 2017, Block Group 2, Census Tract 1501, Sonoma County, California",40,32,8
1000000US060971501002018,060971501002018,"Block 2018, Block Group 2, Census Tract 1501, Sonoma County, California",0,0,0
1000000US060971501002019,060971501002019,"Block 2019, Block Group 2, Census Tract 1501, Sonoma County, California",6,5,1
1000000US060971501002020,060971501002020,"Block 2020, Block Group 2, Census Tract 1501, Sonoma County, California",3,1,2
1000000US060971501002021,060971501002021,"Block 2021, Block Group 2, Census Tract 1501, Sonoma County, California",0,0,0
1000000US060971501002022,060971501002022,"Block 2022, Block Group 2, Census Tract 1501, Sonoma County, California",0,0,0
1000000US060971501002023,060971501002023,"Block 2023, Block Group 2, Census Tract 1501, Sonoma County, California",0,0,0
1000000US060971501002024,060971501002024,"Block 2024, Block Group 2, Census Tract 1501, Sonoma County, California",13,10,3
1000000US060971501002025,060971501002025,"Block 2025, Block Group 2, Census Tract 1501, Sonoma County, California",2,2,0
1000000US060971501002026,060971501002026,"Block 2026, Block Group 2, Census Tract 1501, Sonoma County, California",31,26,5
1000000US060971501002027,060971501002027,"Block 2027, Block Group 2, Census Tract 1501, Sonoma County, California",5,5,0
1000000US060971501002028,060971501002028,"Block 2028, Block Group 2, Census Tract 1501, Sonoma County, California",0,0,0
1000000US060971501002029,060971501002029,"Block 2029, Block Group 2, Census Tract 1501, Sonoma County, California",0,0,0
1000000US060971501002030,060971501002030,"Block 2030, Block Group 2, Census Tract 1501, Sonoma County, California",0,0,0
1000000US060971501002031,060971501002031,"Block 2031, Block Group 2, Census Tract 1501, Sonoma County, California",0,0,0
1000000US060971501002032,060971501002032,"Block 2032, Block Group 2, Census Tract 1501, Sonoma County, California",10,10,0
1000000US060971501002033,060971501002033,"Block 2033, Block Group 2, Census Tract 1501, Sonoma County, California",0,0,0
1000000US060971501002034,060971501002034,"Block 2034, Block Group 2, Census Tract 1501, Sonoma County, California",0,0,0
1000000US060971501002035,060971501002035,"Block 2035, Block Group 2, Census Tract 1501, Sonoma County, California",0,0,0
1000000US060971501002036,060971501002036,"Block 2036, Block Group 2, Census Tract 1501, Sonoma County, California",0,0,0
1000000US060971501002037,060971501002037,"Block 2037, Block Group 2, Census Tract 1501, Sonoma County, California",2,1,1
1000000US060971501002038,060971501002038,"Block 2038, Block Group 2, Census Tract 1501, Sonoma County, California",0,0,0
1000000US060971501002039,060971501002039,"Block 2039, Block Group 2, Census Tract 1501, Sonoma County, California",1,1,0
1000000US060971501002040,060971501002040,"Block 2040, Block Group 2, Census Tract 1501, Sonoma County, California",0,0,0
1000000US060971501002041,060971501002041,"Block 2041, Block Group 2, Census Tract 1501, Sonoma County, California",0,0,0
1000000US060971501002042,060971501002042,"Block 2042, Block Group 2, Census Tract 1501, Sonoma County, California",0,0,0
1000000US060971501002043,060971501002043,"Block 2043, Block Group 2, Census Tract 1501, Sonoma County, California",0,0,0
1000000US060971501002044,060971501002044,"Block 2044, Block Group 2, Census Tract 1501, Sonoma County, California",1,1,0
1000000US060971501002045,060971501002045,"Block 2045, Block Group 2, Census Tract 1501, Sonoma County, California",0,0,0
1000000US060971501002046,060971501002046,"Block 2046, Block Group 2, Census Tract 1501, Sonoma County, California",0,0,0
1000000US060971501003000,060971501003000,"Block 3000, Block Group 3, Census Tract 1501, Sonoma County, California",28,22,6
1000000US060971501003001,060971501003001,"Block 3001, Block Group 3, Census Tract 1501, Sonoma County, California",72,57,15
1000000US060971501003002,060971501003002,"Block 3002, Block Group 3, Census Tract 1501, Sonoma County, California",0,0,0
1000000US060971501003003,060971501003003,"Block 3003, Block Group 3, Census Tract 1501, Sonoma County, California",0,0,0
1000000US060971501003004,060971501003004,"Block 3004, Block Group 3, Census Tract 1501, Sonoma County, California",0,0,0
1000000US060971501003005,060971501003005,"Block 3005, Block Group 3, Census Tract 1501, Sonoma County, California",0,0,0
1000000US060971501003006,060971501003006,"Block 3006, Block Group 3, Census Tract 1501, Sonoma County, California",0,0,0
1000000US060971501003007,060971501003007,"Block 3007, Block Group 3, Census Tract 1501, Sonoma County, California",0,0,0
1000000US060971501003008,060971501003008,"Block 3008, Block Group 3, Census Tract 1501, Sonoma County, California",2,0,2
1000000US060971501003009,060971501003009,"Block 3009, Block Group 3, Census Tract 1501, Sonoma County, California",0,0,0
1000000US060971501003010,060971501003010,"Block 3010, Block Group 3, Census Tract 1501, Sonoma County, California",0,0,0
1000000US060971501003011,060971501003011,"Block 3011, Block Group 3, Census Tract 1501, Sonoma County, California",7,4,3
1000000US060971501003012,060971501003012,"Block 3012, Block Group 3, Census Tract 1501, Sonoma County, California",2,0,2
1000000US060971501003013,060971501003013,"Block 3013, Block Group 3, Census Tract 1501, Sonoma County, California",25,21,4
1000000US060971501003014,060971501003014,"Block 3014, Block Group 3, Census Tract 1501, Sonoma County, California",15,13,2
1000000US060971501003015,060971501003015,"Block 3015, Block Group 3, Census Tract 1501, Sonoma County, California",0,0,0
1000000US060971501003016,060971501003016,"Block 3016, Block Group 3, Census Tract 1501, Sonoma County, California",1,1,0
1000000US060971501003017,060971501003017,"Block 3017, Block Group 3, Census Tract 1501, Sonoma County, California",15,14,1
1000000US060971501003018,060971501003018,"Block 3018, Block Group 3, Census Tract 1501, Sonoma County, California",14,13,1
1000000US060971501003019,060971501003019,"Block 3019, Block Group 3, Census Tract 1501, Sonoma County, California",0,0,0
1000000US060971501003020,060971501003020,"Block 3020, Block Group 3, Census Tract 1501, Sonoma County, California",0,0,0
1000000US060971501003021,060971501003021,"Block 3021, Block Group 3, Census Tract 1501, Sonoma County, California",0,0,0
1000000US060971501003022,060971501003022,"Block 3022, Block Group 3, Census Tract 1501, Sonoma County, California",1,1,0
1000000US060971501003023,060971501003023,"Block 3023, Block Group 3, Census Tract 1501, Sonoma County, California",15,9,6
1000000US060971501003024,060971501003024,"Block 3024, Block Group 3, Census Tract 1501, Sonoma County, California",15,13,2
1000000US060971501003025,060971501003025,"Block 3025, Block Group 3, Census Tract 1501, Sonoma County, California",15,14,1
1000000US060971501003026,060971501003026,"Block 3026, Block Group 3, Census Tract 1501, Sonoma County, California",0,0,0
1000000US060971501003027,060971501003027,"Block 3027, Block Group 3, Census Tract 1501, Sonoma County, California",0,0,0
1000000US060971501003028,060971501003028,"Block 3028, Block Group 3, Census Tract 1501, Sonoma County, California",0,0,0
1000000US060971501003029,060971501003029,"Block 3029, Block Group 3, Census Tract 1501, Sonoma County, California",1,1,0
1000000US060971501003030,060971501003030,"Block 3030, Block Group 3, Census Tract 1501, Sonoma County, California",0,0,0
1000000US060971501003031,060971501003031,"Block 3031, Block Group 3, Census Tract 1501, Sonoma County, California",0,0,0
1000000US060971501003032,060971501003032,"Block 3032, Block Group 3, Census Tract 1501, Sonoma County, California",1,1,0
1000000US060971501003033,060971501003033,"Block 3033, Block Group 3, Census Tract 1501, Sonoma County, California",2,2,0
1000000US060971501003034,060971501003034,"Block 3034, Block Group 3, Census Tract 1501, Sonoma County, California",0,0,0
1000000US060971501003035,060971501003035,"Block 3035, Block Group 3, Census Tract 1501, Sonoma County, California",2,2,0
1000000US060971501003036,060971501003036,"Block 3036, Block Group 3, Census Tract 1501, Sonoma County, California",0,0,0
1000000US060971501003037,060971501003037,"Block 3037, Block Group 3, Census Tract 1501, Sonoma County, California",0,0,0
1000000US060971501003038,060971501003038,"Block 3038, Block Group 3, Census Tract 1501, Sonoma County, California",0,0,0
1000000US060971501003039,060971501003039,"Block 3039, Block Group 3, Census Tract 1501, Sonoma County, California",0,0,0
1000000US060971501003040,060971501003040,"Block 3040, Block Group 3, Census Tract 1501, Sonoma County, California",0,0,0
1000000US060971501003041,060971501003041,"Block 3041, Block Group 3, Census Tract 1501, Sonoma County, California",0,0,0
1000000US060971501003042,060971501003042,"Block 3042, Block Group 3, Census Tract 1501, Sonoma County, California",0,0,0
1000000US060971501003043,060971501003043,"Block 3043, Block Group 3, Census Tract 1501, Sonoma County, California",0,0,0
1000000US060971501003044,060971501003044,"Block 3044, Block Group 3, Census Tract 1501, Sonoma County, California",0,0,0
1000000US060971501003045,060971501003045,"Block 3045, Block Group 3, Census Tract 1501, Sonoma County, California",0,0,0
1000000US060971501003046,060971501003046,"Block 3046, Block Group 3, Census Tract 1501, Sonoma County, California",0,0,0
1000000US060971501003047,060971501003047,"Block 3047, Block Group 3, Census Tract 1501, Sonoma County, California",0,0,0
1000000US060971501003048,060971501003048,"Block 3048, Block Group 3, Census Tract 1501, Sonoma County, California",0,0,0
1000000US060971501003049,060971501003049,"Block 3049, Block Group 3, Census Tract 1501, Sonoma County, California",0,0,0
1000000US060971501003050,060971501003050,"Block 3050, Block Group 3, Census Tract 1501, Sonoma County, California",0,0,0
1000000US060971501003051,060971501003051,"Block 3051, Block Group 3, Census Tract 1501, Sonoma County, California",0,0,0
1000000US060971501003052,060971501003052,"Block 3052, Block Group 3, Census Tract 1501, Sonoma County, California",0,0,0
1000000US060971501003053,060971501003053,"Block 3053, Block Group 3, Census Tract 1501, Sonoma County, California",0,0,0
1000000US060971501003054,060971501003054,"Block 3054, Block Group 3, Census Tract 1501, Sonoma County, California",0,0,0
1000000US060971501003055,060971501003055,"Block 3055, Block Group 3, Census Tract 1501, Sonoma County, California",0,0,0
1000000US060971501003056,060971501003056,"Block 3056, Block Group 3, Census Tract 1501, Sonoma County, California",0,0,0
1000000US060971501003057,060971501003057,"Block 3057, Block Group 3, Census Tract 1501, Sonoma County, California",0,0,0
1000000US060971501003058,060971501003058,"Block 3058, Block Group 3, Census Tract 1501, Sonoma County, California",0,0,0
1000000US060971501003059,060971501003059,"Block 3059, Block Group 3, Census Tract 1501, Sonoma County, California",0,0,0
1000000US060971501003060,060971501003060,"Block 3060, Block Group 3, Census Tract 1501, Sonoma County, California",0,0,0
1000000US060971501003061,060971501003061,"Block 3061, Block Group 3, Census Tract 1501, Sonoma County, California",0,0,0
1000000US060971501003062,060971501003062,"Block 3062, Block Group 3, Census Tract 1501, Sonoma County, California",0,0,0
1000000US060971501003063,060971501003063,"Block 3063, Block Group 3, Census Tract 1501, Sonoma County, California",0,0,0
1000000US060971501003064,060971501003064,"Block 3064, Block Group 3, Census Tract 1501, Sonoma County, California",0,0,0
1000000US060971501003065,060971501003065,"Block 3065, Block Group 3, Census Tract 1501, Sonoma County, California",0,0,0
1000000US060971501003066,060971501003066,"Block 3066, Block Group 3, Census Tract 1501, Sonoma County, California",0,0,0
1000000US060971501003067,060971501003067,"Block 3067, Block Group 3, Census Tract 1501, Sonoma County, California",0,0,0
1000000US060971501003068,060971501003068,"Block 3068, Block Group 3, Census Tract 1501, Sonoma County, California",0,0,0
1000000US060971501003069,060971501003069,"Block 3069, Block Group 3, Census Tract 1501, Sonoma County, California",0,0,0
1000000US060971501003070,060971501003070,"Block 3070, Block Group 3, Census Tract 1501, Sonoma County, California",0,0,0
1000000US060971501003071,060971501003071,"Block 3071, Block Group 3, Census Tract 1501, Sonoma County, California",0,0,0
1000000US060971501003072,060971501003072,"Block 3072, Block Group 3, Census Tract 1501, Sonoma County, California",0,0,0
1000000US060971501003073,060971501003073,"Block 3073, Block Group 3, Census Tract 1501, Sonoma County, California",0,0,0
1000000US060971501003074,060971501003074,"Block 3074, Block Group 3, Census Tract 1501, Sonoma County, California",0,0,0
1000000US060971501003075,060971501003075,"Block 3075, Block Group 3, Census Tract 1501, Sonoma County, California",0,0,0
1000000US060971501003076,060971501003076,"Block 3076, Block Group 3, Census Tract 1501, Sonoma County, California",0,0,0
1000000US060971501003077,060971501003077,"Block 3077, Block Group 3, Census Tract 1501, Sonoma County, California",0,0,0
1000000US060971501003078,060971501003078,"Block 3078, Block Group 3, Census Tract 1501, Sonoma County, California",0,0,0
1000000US060971501003079,060971501003079,"Block 3079, Block Group 3, Census Tract 1501, Sonoma County, California",0,0,0
1000000US060971501003080,060971501003080,"Block 3080, Block Group 3, Census Tract 1501, Sonoma County, California",0,0,0
1000000US060971501003081,060971501003081,"Block 3081, Block Group 3, Census Tract 1501, Sonoma County, California",0,0,0
1000000US060971501003082,060971501003082,"Block 3082, Block Group 3, Census Tract 1501, Sonoma County, California",0,0,0
1000000US060971501003083,060971501003083,"Block 3083, Block Group 3, Census Tract 1501, Sonoma County, California",0,0,0
1000000US060971501003084,060971501003084,"Block 3084, Block Group 3, Census Tract 1501, Sonoma County, California",0,0,0
1000000US060971501003085,060971501003085,"Block 3085, Block Group 3, Census Tract 1501, Sonoma County, California",0,0,0
1000000US060971501003086,060971501003086,"Block 3086, Block Group 3, Census Tract 1501, Sonoma County, California",0,0,0
1000000US060971501003087,060971501003087,"Block 3087, Block Group 3, Census Tract 1501, Sonoma County, California",0,0,0
1000000US060971501003088,060971501003088,"Block 3088, Block Group 3, Census Tract 1501, Sonoma County, California",0,0,0
1000000US060971501003089,060971501003089,"Block 3089, Block Group 3, Census Tract 1501, Sonoma County, California",0,0,0
1000000US060971501003090,060971501003090,"Block 3090, Block Group 3, Census Tract 1501, Sonoma County, California",0,0,0
1000000US060971502021000,060971502021000,"Block 1000, Block Group 1, Census Tract 1502.02, Sonoma County, California",12,8,4
1000000US060971502021001,060971502021001,"Block 1001, Block Group 1, Census Tract 1502.02, Sonoma County, California",1,0,1
1000000US060971502021002,060971502021002,"Block 1002, Block Group 1, Census Tract 1502.02, Sonoma County, California",26,19,7
1000000US060971502021003,060971502021003,"Block 1003, Block Group 1, Census Tract 1502.02, Sonoma County, California",28,24,4
1000000US060971502021004,060971502021004,"Block 1004, Block Group 1, Census Tract 1502.02, Sonoma County, California",81,65,16
1000000US060971502021005,060971502021005,"Block 1005, Block Group 1, Census Tract 1502.02, Sonoma County, California",22,16,6
1000000US060971502021006,060971502021006,"Block 1006, Block Group 1, Census Tract 1502.02, Sonoma County, California",32,27,5
1000000US060971502021007,060971502021007,"Block 1007, Block Group 1, Census Tract 1502.02, Sonoma County, California",46,39,7
1000000US060971502021008,060971502021008,"Block 1008, Block Group 1, Census Tract 1502.02, Sonoma County, California",16,13,3
1000000US060971502021009,060971502021009,"Block 1009, Block Group 1, Census Tract 1502.02, Sonoma County, California",0,0,0
1000000US060971502021010,060971502021010,"Block 1010, Block Group 1, Census Tract 1502.02, Sonoma County, California",13,10,3
1000000US060971502021011,060971502021011,"Block 1011, Block Group 1, Census Tract 1502.02, Sonoma County, California",46,40,6
1000000US060971502021012,060971502021012,"Block 1012, Block Group 1, Census Tract 1502.02, Sonoma County, California",68,54,14
1000000US060971502021013,060971502021013,"Block 1013, Block Group 1, Census Tract 1502.02, Sonoma County, California",40,32,8
1000000US060971502021014,060971502021014,"Block 1014, Block Group 1, Census Tract 1502.02, Sonoma County, California",12,11,1
1000000US060971502021015,060971502021015,"Block 1015, Block Group 1, Census Tract 1502.02, Sonoma County, California",1,1,0
1000000US060971502022000,060971502022000,"Block 2000, Block Group 2, Census Tract 1502.02, Sonoma County, California",0,0,0
1000000US060971502022001,060971502022001,"Block 2001, Block Group 2, Census Tract 1502.02, Sonoma County, California",19,13,6
1000000US060971502022002,060971502022002,"Block 2002, Block Group 2, Census Tract 1502.02, Sonoma County, California",0,0,0
1000000US060971502022003,060971502022003,"Block 2003, Block Group 2, Census Tract 1502.02, Sonoma County, California",19,18,1
1000000US060971502022004,060971502022004,"Block 2004, Block Group 2, Census Tract 1502.02, Sonoma County, California",16,16,0
1000000US060971502022005,060971502022005,"Block 2005, Block Group 2, Census Tract 1502.02, Sonoma County, California",8,6,2
1000000US060971502022006,060971502022006,"Block 2006, Block Group 2, Census Tract 1502.02, Sonoma County, California",14,12,2
1000000US060971502022007,060971502022007,"Block 2007, Block Group 2, Census Tract 1502.02, Sonoma County, California",22,22,0
1000000US060971502022008,060971502022008,"Block 2008, Block Group 2, Census Tract 1502.02, Sonoma County, California",44,42,2
1000000US060971502022009,060971502022009,"Block 2009, Block Group 2, Census Tract 1502.02, Sonoma County, California",23,21,2
1000000US060971502022010,060971502022010,"Block 2010, Block Group 2, Census Tract 1502.02, Sonoma County, California",42,38,4
1000000US060971502022011,060971502022011,"Block 2011, Block Group 2, Census Tract 1502.02, Sonoma County, California",12,12,0
1000000US060971502022012,060971502022012,"Block 2012, Block Group 2, Census Tract 1502.02, Sonoma County, California",43,40,3
1000000US060971502022013,060971502022013,"Block 2013, Block Group 2, Census Tract 1502.02, Sonoma County, California",57,50,7
1000000US060971502022014,060971502022014,"Block 2014, Block Group 2, Census Tract 1502.02, Sonoma County, California",19,16,3
1000000US060971502022015,060971502022015,"Block 2015, Block Group 2, Census Tract 1502.02, Sonoma County, California",0,0,0
1000000US060971502022016,060971502022016,"Block 2016, Block Group 2, Census Tract 1502.02, Sonoma County, California",0,0,0
1000000US060971502022017,060971502022017,"Block 2017, Block Group 2, Census Tract 1502.02, Sonoma County, California",109,88,21
1000000US060971502022018,060971502022018,"Block 2018, Block Group 2, Census Tract 1502.02, Sonoma County, California",22,20,2
1000000US060971502022019,060971502022019,"Block 2019, Block Group 2, Census Tract 1502.02, Sonoma County, California",13,8,5
1000000US060971502022020,060971502022020,"Block 2020, Block Group 2, Census Tract 1502.02, Sonoma County, California",42,38,4
1000000US060971502022021,060971502022021,"Block 2021, Block Group 2, Census Tract 1502.02, Sonoma County, California",25,23,2
1000000US060971502022022,060971502022022,"Block 2022, Block Group 2, Census Tract 1502.02, Sonoma County, California",0,0,0
1000000US060971502022023,060971502022023,"Block 2023, Block Group 2, Census Tract 1502.02, Sonoma County, California",14,14,0
1000000US060971502022024,060971502022024,"Block 2024, Block Group 2, Census Tract 1502.02, Sonoma County, California",2,2,0
1000000US060971502023000,060971502023000,"Block 3000, Block Group 3, Census Tract 1502.02, Sonoma County, California",0,0,0
1000000US060971502023001,060971502023001,"Block 3001, Block Group 3, Census Tract 1502.02, Sonoma County, California",178,131,47
1000000US060971502023002,060971502023002,"Block 3002, Block Group 3, Census Tract 1502.02, Sonoma County, California",0,0,0
1000000US060971502023003,060971502023003,"Block 3003, Block Group 3, Census Tract 1502.02, Sonoma County, California",16,13,3
1000000US060971502023004,060971502023004,"Block 3004, Block Group 3, Census Tract 1502.02, Sonoma County, California",0,0,0
1000000US060971502023005,060971502023005,"Block 3005, Block Group 3, Census Tract 1502.02, Sonoma County, California",31,22,9
1000000US060971502023006,060971502023006,"Block 3006, Block Group 3, Census Tract 1502.02, Sonoma County, California",3,3,0
1000000US060971502023007,060971502023007,"Block 3007, Block Group 3, Census Tract 1502.02, Sonoma County, California",15,13,2
1000000US060971502023008,060971502023008,"Block 3008, Block Group 3, Census Tract 1502.02, Sonoma County, California",2,1,1
1000000US060971502023009,060971502023009,"Block 3009, Block Group 3, Census Tract 1502.02, Sonoma County, California",4,4,0
1000000US060971502023010,060971502023010,"Block 3010, Block Group 3, Census Tract 1502.02, Sonoma County, California",5,4,1
1000000US060971502023011,060971502023011,"Block 3011, Block Group 3, Census Tract 1502.02, Sonoma County, California",20,18,2
1000000US060971502023012,060971502023012,"Block 3012, Block Group 3, Census Tract 1502.02, Sonoma County, California",17,14,3
1000000US060971502023013,060971502023013,"Block 3013, Block Group 3, Census Tract 1502.02, Sonoma County, California",22,18,4
1000000US060971502023014,060971502023014,"Block 3014, Block Group 3, Census Tract 1502.02, Sonoma County, California",53,48,5
1000000US060971502023015,060971502023015,"Block 3015, Block Group 3, Census Tract 1502.02, Sonoma County, California",5,5,0
1000000US060971502023016,060971502023016,"Block 3016, Block Group 3, Census Tract 1502.02, Sonoma County, California",0,0,0
1000000US060971502023017,060971502023017,"Block 3017, Block Group 3, Census Tract 1502.02, Sonoma County, California",1,1,0
1000000US060971502024000,060971502024000,"Block 4000, Block Group 4, Census Tract 1502.02, Sonoma County, California",43,28,15
1000000US060971502024001,060971502024001,"Block 4001, Block Group 4, Census Tract 1502.02, Sonoma County, California",16,7,9
1000000US060971502024002,060971502024002,"Block 4002, Block Group 4, Census Tract 1502.02, Sonoma County, California",15,10,5
1000000US060971502024003,060971502024003,"Block 4003, Block Group 4, Census Tract 1502.02, Sonoma County, California",20,13,7
1000000US060971502024004,060971502024004,"Block 4004, Block Group 4, Census Tract 1502.02, Sonoma County, California",0,0,0
1000000US060971502024005,060971502024005,"Block 4005, Block Group 4, Census Tract 1502.02, Sonoma County, California",5,4,1
1000000US060971502024006,060971502024006,"Block 4006, Block Group 4, Census Tract 1502.02, Sonoma County, California",0,0,0
1000000US060971502024007,060971502024007,"Block 4007, Block Group 4, Census Tract 1502.02, Sonoma County, California",0,0,0
1000000US060971502024008,060971502024008,"Block 4008, Block Group 4, Census Tract 1502.02, Sonoma County, California",0,0,0
1000000US060971502024009,060971502024009,"Block 4009, Block Group 4, Census Tract 1502.02, Sonoma County, California",143,121,22
1000000US060971502024010,060971502024010,"Block 4010, Block Group 4, Census Tract 1502.02, Sonoma County, California",0,0,0
1000000US060971502024011,060971502024011,"Block 4011, Block Group 4, Census Tract 1502.02, Sonoma County, California",1,1,0
1000000US060971502024012,060971502024012,"Block 4012, Block Group 4, Census Tract 1502.02, Sonoma County, California",13,13,0
1000000US060971502024013,060971502024013,"Block 4013, Block Group 4, Census Tract 1502.02, Sonoma County, California",36,34,2
1000000US060971502024014,060971502024014,"Block 4014, Block Group 4, Census Tract 1502.02, Sonoma County, California",43,43,0
1000000US060971502024015,060971502024015,"Block 4015, Block Group 4, Census Tract 1502.02, Sonoma County, California",70,66,4
1000000US060971502024016,060971502024016,"Block 4016, Block Group 4, Census Tract 1502.02, Sonoma County, California",0,0,0
1000000US060971502024017,060971502024017,"Block 4017, Block Group 4, Census Tract 1502.02, Sonoma County, California",41,38,3
1000000US060971502024018,060971502024018,"Block 4018, Block Group 4, Census Tract 1502.02, Sonoma County, California",28,25,3
1000000US060971502024019,060971502024019,"Block 4019, Block Group 4, Census Tract 1502.02, Sonoma County, California",142,128,14
1000000US060971502024020,060971502024020,"Block 4020, Block Group 4, Census Tract 1502.02, Sonoma County, California",17,17,0
1000000US060971502024021,060971502024021,"Block 4021, Block Group 4, Census Tract 1502.02, Sonoma County, California",0,0,0
1000000US060971502024022,060971502024022,"Block 4022, Block Group 4, Census Tract 1502.02, Sonoma County, California",0,0,0
1000000US060971502024023,060971502024023,"Block 4023, Block Group 4, Census Tract 1502.02, Sonoma County, California",31,28,3
1000000US060971502024024,060971502024024,"Block 4024, Block Group 4, Census Tract 1502.02, Sonoma County, California",6,6,0
1000000US060971502024025,060971502024025,"Block 4025, Block Group 4, Census Tract 1502.02, Sonoma County, California",0,0,0
1000000US060971502024026,060971502024026,"Block 4026, Block Group 4, Census Tract 1502.02, Sonoma County, California",0,0,0
1000000US060971502024027,060971502024027,"Block 4027, Block Group 4, Census Tract 1502.02, Sonoma County, California",0,0,0
1000000US060971502024028,060971502024028,"Block 4028, Block Group 4, Census Tract 1502.02, Sonoma County, California",1,0,1
1000000US060971502024029,060971502024029,"Block 4029, Block Group 4, Census Tract 1502.02, Sonoma County, California",0,0,0
1000000US060971502024030,060971502024030,"Block 4030, Block Group 4, Census Tract 1502.02, Sonoma County, California",76,69,7
1000000US060971502024031,060971502024031,"Block 4031, Block Group 4, Census Tract 1502.02, Sonoma County, California",10,9,1
1000000US060971502024032,060971502024032,"Block 4032, Block Group 4, Census Tract 1502.02, Sonoma County, California",8,7,1
1000000US060971502024033,060971502024033,"Block 4033, Block Group 4, Census Tract 1502.02, Sonoma County, California",9,8,1
1000000US060971502025000,060971502025000,"Block 5000, Block Group 5, Census Tract 1502.02, Sonoma County, California",70,68,2
1000000US060971502025001,060971502025001,"Block 5001, Block Group 5, Census Tract 1502.02, Sonoma County, California",2,2,0
1000000US060971502025002,060971502025002,"Block 5002, Block Group 5, Census Tract 1502.02, Sonoma County, California",12,10,2
1000000US060971502025003,060971502025003,"Block 5003, Block Group 5, Census Tract 1502.02, Sonoma County, California",2,1,1
1000000US060971502025004,060971502025004,"Block 5004, Block Group 5, Census Tract 1502.02, Sonoma County, California",8,7,1
1000000US060971502025005,060971502025005,"Block 5005, Block Group 5, Census Tract 1502.02, Sonoma County, California",38,34,4
1000000US060971502025006,060971502025006,"Block 5006, Block Group 5, Census Tract 1502.02, Sonoma County, California",0,0,0
1000000US060971502025007,060971502025007,"Block 5007, Block Group 5, Census Tract 1502.02, Sonoma County, California",11,10,1
1000000US060971502025008,060971502025008,"Block 5008, Block Group 5, Census Tract 1502.02, Sonoma County, California",13,13,0
1000000US060971502025009,060971502025009,"Block 5009, Block Group 5, Census Tract 1502.02, Sonoma County, California",16,16,0
1000000US060971502025010,060971502025010,"Block 5010, Block Group 5, Census Tract 1502.02, Sonoma County, California",14,13,1
1000000US060971502025011,060971502025011,"Block 5011, Block Group 5, Census Tract 1502.02, Sonoma County, California",0,0,0
1000000US060971502025012,060971502025012,"Block 5012, Block Group 5, Census Tract 1502.02, Sonoma County, California",20,19,1
1000000US060971502025013,060971502025013,"Block 5013, Block Group 5, Census Tract 1502.02, Sonoma County, California",60,39,21
1000000US060971502025014,060971502025014,"Block 5014, Block Group 5, Census Tract 1502.02, Sonoma County, California",16,16,0
1000000US060971502025015,060971502025015,"Block 5015, Block Group 5, Census Tract 1502.02, Sonoma County, California",12,12,0
1000000US060971502025016,060971502025016,"Block 5016, Block Group 5, Census Tract 1502.02, Sonoma County, California",0,0,0
1000000US060971502025017,060971502025017,"Block 5017, Block Group 5, Census Tract 1502.02, Sonoma County, California",48,45,3
1000000US060971502025018,060971502025018,"Block 5018, Block Group 5, Census Tract 1502.02, Sonoma County, California",40,39,1
1000000US060971502025019,060971502025019,"Block 5019, Block Group 5, Census Tract 1502.02, Sonoma County, California",33,30,3
1000000US060971502025020,060971502025020,"Block 5020, Block Group 5, Census Tract 1502.02, Sonoma County, California",18,18,0
1000000US060971502025021,060971502025021,"Block 5021, Block Group 5, Census Tract 1502.02, Sonoma County, California",101,96,5
1000000US060971502025022,060971502025022,"Block 5022, Block Group 5, Census Tract 1502.02, Sonoma County, California",45,43,2
1000000US060971502025023,060971502025023,"Block 5023, Block Group 5, Census Tract 1502.02, Sonoma County, California",17,17,0
1000000US060971502025024,060971502025024,"Block 5024, Block Group 5, Census Tract 1502.02, Sonoma County, California",16,15,1
1000000US060971502025025,060971502025025,"Block 5025, Block Group 5, Census Tract 1502.02, Sonoma County, California",6,5,1
1000000US060971502025026,060971502025026,"Block 5026, Block Group 5, Census Tract 1502.02, Sonoma County, California",0,0,0
1000000US060971502031000,060971502031000,"Block 1000, Block Group 1, Census Tract 1502.03, Sonoma County, California",14,13,1
1000000US060971502031001,060971502031001,"Block 1001, Block Group 1, Census Tract 1502.03, Sonoma County, California",20,18,2
1000000US060971502031002,060971502031002,"Block 1002, Block Group 1, Census Tract 1502.03, Sonoma County, California",36,29,7
1000000US060971502031003,060971502031003,"Block 1003, Block Group 1, Census Tract 1502.03, Sonoma County, California",133,117,16
1000000US060971502031004,060971502031004,"Block 1004, Block Group 1, Census Tract 1502.03, Sonoma County, California",22,22,0
1000000US060971502031005,060971502031005,"Block 1005, Block Group 1, Census Tract 1502.03, Sonoma County, California",0,0,0
1000000US060971502031006,060971502031006,"Block 1006, Block Group 1, Census Tract 1502.03, Sonoma County, California",172,145,27
1000000US060971502031007,060971502031007,"Block 1007, Block Group 1, Census Tract 1502.03, Sonoma County, California",4,4,0
1000000US060971502031008,060971502031008,"Block 1008, Block Group 1, Census Tract 1502.03, Sonoma County, California",41,35,6
1000000US060971502031009,060971502031009,"Block 1009, Block Group 1, Census Tract 1502.03, Sonoma County, California",34,30,4
1000000US060971502031010,060971502031010,"Block 1010, Block Group 1, Census Tract 1502.03, Sonoma County, California",5,4,1
1000000US060971502031011,060971502031011,"Block 1011, Block Group 1, Census Tract 1502.03, Sonoma County, California",1,1,0
1000000US060971502031012,060971502031012,"Block 1012, Block Group 1, Census Tract 1502.03, Sonoma County, California",15,13,2
1000000US060971502031013,060971502031013,"Block 1013, Block Group 1, Census Tract 1502.03, Sonoma County, California",54,49,5
1000000US060971502031014,060971502031014,"Block 1014, Block Group 1, Census Tract 1502.03, Sonoma County, California",0,0,0
1000000US060971502031015,060971502031015,"Block 1015, Block Group 1, Census Tract 1502.03, Sonoma County, California",12,11,1
1000000US060971502031016,060971502031016,"Block 1016, Block Group 1, Census Tract 1502.03, Sonoma County, California",47,45,2
1000000US060971502031017,060971502031017,"Block 1017, Block Group 1, Census Tract 1502.03, Sonoma County, California",13,11,2
1000000US060971502031018,060971502031018,"Block 1018, Block Group 1, Census Tract 1502.03, Sonoma County, California",22,22,0
1000000US060971502031019,060971502031019,"Block 1019, Block Group 1, Census Tract 1502.03, Sonoma County, California",103,98,5
1000000US060971502031020,060971502031020,"Block 1020, Block Group 1, Census Tract 1502.03, Sonoma County, California",24,23,1
1000000US060971502031021,060971502031021,"Block 1021, Block Group 1, Census Tract 1502.03, Sonoma County, California",27,27,0
1000000US060971502032000,060971502032000,"Block 2000, Block Group 2, Census Tract 1502.03, Sonoma County, California",67,65,2
1000000US060971502032001,060971502032001,"Block 2001, Block Group 2, Census Tract 1502.03, Sonoma County, California",8,5,3
1000000US060971502032002,060971502032002,"Block 2002, Block Group 2, Census Tract 1502.03, Sonoma County, California",0,0,0
1000000US060971502032003,060971502032003,"Block 2003, Block Group 2, Census Tract 1502.03, Sonoma County, California",21,19,2
1000000US060971502032004,060971502032004,"Block 2004, Block Group 2, Census Tract 1502.03, Sonoma County, California",16,15,1
1000000US060971502032005,060971502032005,"Block 2005, Block Group 2, Census Tract 1502.03, Sonoma County, California",50,48,2
1000000US060971502032006,060971502032006,"Block 2006, Block Group 2, Census Tract 1502.03, Sonoma County, California",2,1,1
1000000US060971502032007,060971502032007,"Block 2007, Block Group 2, Census Tract 1502.03, Sonoma County, California",12,11,1
1000000US060971502032008,060971502032008,"Block 2008, Block Group 2, Census Tract 1502.03, Sonoma County, California",12,10,2
1000000US060971502032009,060971502032009,"Block 2009, Block Group 2, Census Tract 1502.03, Sonoma County, California",10,10,0
1000000US060971502032010,060971502032010,"Block 2010, Block Group 2, Census Tract 1502.03, Sonoma County, California",3,3,0
1000000US060971502032011,060971502032011,"Block 2011, Block Group 2, Census Tract 1502.03, Sonoma County, California",18,16,2
1000000US060971502032012,060971502032012,"Block 2012, Block Group 2, Census Tract 1502.03, Sonoma County, California",1,1,0
1000000US060971502032013,060971502032013,"Block 2013, Block Group 2, Census Tract 1502.03, Sonoma County, California",7,5,2
1000000US060971502032014,060971502032014,"Block 2014, Block Group 2, Census Tract 1502.03, Sonoma County, California",44,42,2
1000000US060971502032015,060971502032015,"Block 2015, Block Group 2, Census Tract 1502.03, Sonoma County, California",0,0,0
1000000US060971502032016,060971502032016,"Block 2016, Block Group 2, Census Tract 1502.03, Sonoma County, California",7,7,0
1000000US060971502032017,060971502032017,"Block 2017, Block Group 2, Census Tract 1502.03, Sonoma County, California",17,17,0
1000000US060971502032018,060971502032018,"Block 2018, Block Group 2, Census Tract 1502.03, Sonoma County, California",28,23,5
1000000US060971502032019,060971502032019,"Block 2019, Block Group 2, Census Tract 1502.03, Sonoma County, California",33,29,4
1000000US060971502032020,060971502032020,"Block 2020, Block Group 2, Census Tract 1502.03, Sonoma County, California",1,1,0
1000000US060971502032021,060971502032021,"Block 2021, Block Group 2, Census Tract 1502.03, Sonoma County, California",22,21,1
1000000US060971502032022,060971502032022,"Block 2022, Block Group 2, Census Tract 1502.03, Sonoma County, California",0,0,0
1000000US060971502032023,060971502032023,"Block 2023, Block Group 2, Census Tract 1502.03, Sonoma County, California",0,0,0
1000000US060971502032024,060971502032024,"Block 2024, Block Group 2, Census Tract 1502.03, Sonoma County, California",68,63,5
1000000US060971502032025,060971502032025,"Block 2025, Block Group 2, Census Tract 1502.03, Sonoma County, California",0,0,0
1000000US060971502032026,060971502032026,"Block 2026, Block Group 2, Census Tract 1502.03, Sonoma County, California",96,59,37
1000000US060971502032027,060971502032027,"Block 2027, Block Group 2, Census Tract 1502.03, Sonoma County, California",58,46,12
1000000US060971502032028,060971502032028,"Block 2028, Block Group 2, Census Tract 1502.03, Sonoma County, California",26,26,0
1000000US060971502032029,060971502032029,"Block 2029, Block Group 2, Census Tract 1502.03, Sonoma County, California",1,1,0
1000000US060971502033000,060971502033000,"Block 3000, Block Group 3, Census Tract 1502.03, Sonoma County, California",13,13,0
1000000US060971502033001,060971502033001,"Block 3001, Block Group 3, Census Tract 1502.03, Sonoma County, California",7,7,0
1000000US060971502033002,060971502033002,"Block 3002, Block Group 3, Census Tract 1502.03, Sonoma County, California",28,28,0
1000000US060971502033003,060971502033003,"Block 3003, Block Group 3, Census Tract 1502.03, Sonoma County, California",12,12,0
1000000US060971502033004,060971502033004,"Block 3004, Block Group 3, Census Tract 1502.03, Sonoma County, California",161,146,15
1000000US060971502033005,060971502033005,"Block 3005, Block Group 3, Census Tract 1502.03, Sonoma County, California",221,202,19
1000000US060971502033006,060971502033006,"Block 3006, Block Group 3, Census Tract 1502.03, Sonoma County, California",22,22,0
1000000US060971502033007,060971502033007,"Block 3007, Block Group 3, Census Tract 1502.03, Sonoma County, California",9,8,1
1000000US060971502033008,060971502033008,"Block 3008, Block Group 3, Census Tract 1502.03, Sonoma County, California",4,3,1
1000000US060971502033009,060971502033009,"Block 3009, Block Group 3, Census Tract 1502.03, Sonoma County, California",112,98,14
1000000US060971502033010,060971502033010,"Block 3010, Block Group 3, Census Tract 1502.03, Sonoma County, California",57,55,2
1000000US060971502033011,060971502033011,"Block 3011, Block Group 3, Census Tract 1502.03, Sonoma County, California",28,25,3
1000000US060971502033012,060971502033012,"Block 3012, Block Group 3, Census Tract 1502.03, Sonoma County, California",33,27,6
1000000US060971502033013,060971502033013,"Block 3013, Block Group 3, Census Tract 1502.03, Sonoma County, California",0,0,0
1000000US060971502033014,060971502033014,"Block 3014, Block Group 3, Census Tract 1502.03, Sonoma County, California",225,203,22
1000000US060971502041000,060971502041000,"Block 1000, Block Group 1, Census Tract 1502.04, Sonoma County, California",54,51,3
1000000US060971502041001,060971502041001,"Block 1001, Block Group 1, Census Tract 1502.04, Sonoma County, California",20,17,3
1000000US060971502041002,060971502041002,"Block 1002, Block Group 1, Census Tract 1502.04, Sonoma County, California",4,4,0
1000000US060971502041003,060971502041003,"Block 1003, Block Group 1, Census Tract 1502.04, Sonoma County, California",0,0,0
1000000US060971502041004,060971502041004,"Block 1004, Block Group 1, Census Tract 1502.04, Sonoma County, California",1,1,0
1000000US060971502041005,060971502041005,"Block 1005, Block Group 1, Census Tract 1502.04, Sonoma County, California",0,0,0
1000000US060971502041006,060971502041006,"Block 1006, Block Group 1, Census Tract 1502.04, Sonoma County, California",12,12,0
1000000US060971502041007,060971502041007,"Block 1007, Block Group 1, Census Tract 1502.04, Sonoma County, California",2,0,2
1000000US060971502041008,060971502041008,"Block 1008, Block Group 1, Census Tract 1502.04, Sonoma County, California",61,58,3
1000000US060971502041009,060971502041009,"Block 1009, Block Group 1, Census Tract 1502.04, Sonoma County, California",18,14,4
1000000US060971502041010,060971502041010,"Block 1010, Block Group 1, Census Tract 1502.04, Sonoma County, California",19,15,4
1000000US060971502041011,060971502041011,"Block 1011, Block Group 1, Census Tract 1502.04, Sonoma County, California",10,8,2
1000000US060971502041012,060971502041012,"Block 1012, Block Group 1, Census Tract 1502.04, Sonoma County, California",10,6,4
1000000US060971502041013,060971502041013,"Block 1013, Block Group 1, Census Tract 1502.04, Sonoma County, California",23,16,7
1000000US060971502041014,060971502041014,"Block 1014, Block Group 1, Census Tract 1502.04, Sonoma County, California",25,21,4
1000000US060971502041015,060971502041015,"Block 1015, Block Group 1, Census Tract 1502.04, Sonoma County, California",22,21,1
1000000US060971502041016,060971502041016,"Block 1016, Block Group 1, Census Tract 1502.04, Sonoma County, California",28,25,3
1000000US060971502041017,060971502041017,"Block 1017, Block Group 1, Census Tract 1502.04, Sonoma County, California",69,62,7
1000000US060971502041018,060971502041018,"Block 1018, Block Group 1, Census Tract 1502.04, Sonoma County, California",25,25,0
1000000US060971502041019,060971502041019,"Block 1019, Block Group 1, Census Tract 1502.04, Sonoma County, California",25,23,2
1000000US060971502041020,060971502041020,"Block 1020, Block Group 1, Census Tract 1502.04, Sonoma County, California",13,12,1
1000000US060971502041021,060971502041021,"Block 1021, Block Group 1, Census Tract 1502.04, Sonoma County, California",4,3,1
1000000US060971502041022,060971502041022,"Block 1022, Block Group 1, Census Tract 1502.04, Sonoma County, California",21,18,3
1000000US060971502041023,060971502041023,"Block 1023, Block Group 1, Census Tract 1502.04, Sonoma County, California",15,14,1
1000000US060971502041024,060971502041024,"Block 1024, Block Group 1, Census Tract 1502.04, Sonoma County, California",15,11,4
1000000US060971502041025,060971502041025,"Block 1025, Block Group 1, Census Tract 1502.04, Sonoma County, California",16,16,0
1000000US060971502042000,060971502042000,"Block 2000, Block Group 2, Census Tract 1502.04, Sonoma County, California",117,99,18
1000000US060971502042001,060971502042001,"Block 2001, Block Group 2, Census Tract 1502.04, Sonoma County, California",24,23,1
1000000US060971502042002,060971502042002,"Block 2002, Block Group 2, Census Tract 1502.04, Sonoma County, California",135,126,9
1000000US060971502042003,060971502042003,"Block 2003, Block Group 2, Census Tract 1502.04, Sonoma County, California",7,6,1
1000000US060971502042004,060971502042004,"Block 2004, Block Group 2, Census Tract 1502.04, Sonoma County, California",6,6,0
1000000US060971502042005,060971502042005,"Block 2005, Block Group 2, Census Tract 1502.04, Sonoma County, California",6,5,1
1000000US060971502042006,060971502042006,"Block 2006, Block Group 2, Census Tract 1502.04, Sonoma County, California",18,17,1
1000000US060971502042007,060971502042007,"Block 2007, Block Group 2, Census Tract 1502.04, Sonoma County, California",0,0,0
1000000US060971502042008,060971502042008,"Block 2008, Block Group 2, Census Tract 1502.04, Sonoma County, California",24,24,0
1000000US060971502042009,060971502042009,"Block 2009, Block Group 2, Census Tract 1502.04, Sonoma County, California",24,22,2
1000000US060971502042010,060971502042010,"Block 2010, Block Group 2, Census Tract 1502.04, Sonoma County, California",19,17,2
1000000US060971502042011,060971502042011,"Block 2011, Block Group 2, Census Tract 1502.04, Sonoma County, California",21,20,1
1000000US060971502042012,060971502042012,"Block 2012, Block Group 2, Census Tract 1502.04, Sonoma County, California",121,117,4
1000000US060971502042013,060971502042013,"Block 2013, Block Group 2, Census Tract 1502.04, Sonoma County, California",135,124,11
1000000US060971502042014,060971502042014,"Block 2014, Block Group 2, Census Tract 1502.04, Sonoma County, California",41,37,4
1000000US060971502042015,060971502042015,"Block 2015, Block Group 2, Census Tract 1502.04, Sonoma County, California",35,34,1
1000000US060971502043000,060971502043000,"Block 3000, Block Group 3, Census Tract 1502.04, Sonoma County, California",34,28,6
1000000US060971502043001,060971502043001,"Block 3001, Block Group 3, Census Tract 1502.04, Sonoma County, California",19,16,3
1000000US060971502043002,060971502043002,"Block 3002, Block Group 3, Census Tract 1502.04, Sonoma County, California",10,7,3
1000000US060971502043003,060971502043003,"Block 3003, Block Group 3, Census Tract 1502.04, Sonoma County, California",15,13,2
1000000US060971502043004,060971502043004,"Block 3004, Block Group 3, Census Tract 1502.04, Sonoma County, California",0,0,0
1000000US060971502043005,060971502043005,"Block 3005, Block Group 3, Census Tract 1502.04, Sonoma County, California",8,5,3
1000000US060971502043006,060971502043006,"Block 3006, Block Group 3, Census Tract 1502.04, Sonoma County, California",21,19,2
1000000US060971502043007,060971502043007,"Block 3007, Block Group 3, Census Tract 1502.04, Sonoma County, California",21,19,2
1000000US060971502043008,060971502043008,"Block 3008, Block Group 3, Census Tract 1502.04, Sonoma County, California",44,39,5
1000000US060971502043009,060971502043009,"Block 3009, Block Group 3, Census Tract 1502.04, Sonoma County, California",145,129,16
1000000US060971502043010,060971502043010,"Block 3010, Block Group 3, Census Tract 1502.04, Sonoma County, California",5,4,1
1000000US060971502043011,060971502043011,"Block 3011, Block Group 3, Census Tract 1502.04, Sonoma County, California",15,13,2
1000000US060971502043012,060971502043012,"Block 3012, Block Group 3, Census Tract 1502.04, Sonoma County, California",0,0,0
1000000US060971502043013,060971502043013,"Block 3013, Block Group 3, Census Tract 1502.04, Sonoma County, California",41,38,3
1000000US060971502043014,060971502043014,"Block 3014, Block Group 3, Census Tract 1502.04, Sonoma County, California",39,36,3
1000000US060971502043015,060971502043015,"Block 3015, Block Group 3, Census Tract 1502.04, Sonoma County, California",33,27,6
1000000US060971502043016,060971502043016,"Block 3016, Block Group 3, Census Tract 1502.04, Sonoma County, California",0,0,0
1000000US060971502043017,060971502043017,"Block 3017, Block Group 3, Census Tract 1502.04, Sonoma County, California",28,25,3
1000000US060971502043018,060971502043018,"Block 3018, Block Group 3, Census Tract 1502.04, Sonoma County, California",25,23,2
1000000US060971502043019,060971502043019,"Block 3019, Block Group 3, Census Tract 1502.04, Sonoma County, California",24,22,2
1000000US060971502043020,060971502043020,"Block 3020, Block Group 3, Census Tract 1502.04, Sonoma County, California",12,12,0
1000000US060971502043021,060971502043021,"Block 3021, Block Group 3, Census Tract 1502.04, Sonoma County, California",3,3,0
1000000US060971502043022,060971502043022,"Block 3022, Block Group 3, Census Tract 1502.04, Sonoma County, California",15,12,3
1000000US060971502043023,060971502043023,"Block 3023, Block Group 3, Census Tract 1502.04, Sonoma County, California",0,0,0
1000000US060971502043024,060971502043024,"Block 3024, Block Group 3, Census Tract 1502.04, Sonoma County, California",0,0,0
1000000US060971502043025,060971502043025,"Block 3025, Block Group 3, Census Tract 1502.04, Sonoma County, California",0,0,0
1000000US060971502043026,060971502043026,"Block 3026, Block Group 3, Census Tract 1502.04, Sonoma County, California",3,3,0
1000000US060971502043027,060971502043027,"Block 3027, Block Group 3, Census Tract 1502.04, Sonoma County, California",12,11,1
1000000US060971503031000,060971503031000,"Block 1000, Block Group 1, Census Tract 1503.03, Sonoma County, California",0,0,0
1000000US060971503031001,060971503031001,"Block 1001, Block Group 1, Census Tract 1503.03, Sonoma County, California",0,0,0
1000000US060971503031002,060971503031002,"Block 1002, Block Group 1, Census Tract 1503.03, Sonoma County, California",0,0,0
1000000US060971503031003,060971503031003,"Block 1003, Block Group 1, Census Tract 1503.03, Sonoma County, California",0,0,0
1000000US060971503031004,060971503031004,"Block 1004, Block Group 1, Census Tract 1503.03, Sonoma County, California",1,0,1
1000000US060971503031005,060971503031005,"Block 1005, Block Group 1, Census Tract 1503.03, Sonoma County, California",97,78,19
1000000US060971503031006,060971503031006,"Block 1006, Block Group 1, Census Tract 1503.03, Sonoma County, California",16,14,2
1000000US060971503031007,060971503031007,"Block 1007, Block Group 1, Census Tract 1503.03, Sonoma County, California",21,16,5
1000000US060971503031008,060971503031008,"Block 1008, Block Group 1, Census Tract 1503.03, Sonoma County, California",16,12,4
1000000US060971503031009,060971503031009,"Block 1009, Block Group 1, Census Tract 1503.03, Sonoma County, California",18,11,7
1000000US060971503031010,060971503031010,"Block 1010, Block Group 1, Census Tract 1503.03, Sonoma County, California",12,7,5
1000000US060971503031011,060971503031011,"Block 1011, Block Group 1, Census Tract 1503.03, Sonoma County, California",8,8,0
1000000US060971503031012,060971503031012,"Block 1012, Block Group 1, Census Tract 1503.03, Sonoma County, California",0,0,0
1000000US060971503031013,060971503031013,"Block 1013, Block Group 1, Census Tract 1503.03, Sonoma County, California",0,0,0
1000000US060971503031014,060971503031014,"Block 1014, Block Group 1, Census Tract 1503.03, Sonoma County, California",46,42,4
1000000US060971503031015,060971503031015,"Block 1015, Block Group 1, Census Tract 1503.03, Sonoma County, California",0,0,0
1000000US060971503031016,060971503031016,"Block 1016, Block Group 1, Census Tract 1503.03, Sonoma County, California",0,0,0
1000000US060971503031017,060971503031017,"Block 1017, Block Group 1, Census Tract 1503.03, Sonoma County, California",2,2,0
1000000US060971503031018,060971503031018,"Block 1018, Block Group 1, Census Tract 1503.03, Sonoma County, California",9,9,0
1000000US060971503031019,060971503031019,"Block 1019, Block Group 1, Census Tract 1503.03, Sonoma County, California",5,4,1
1000000US060971503031020,060971503031020,"Block 1020, Block Group 1, Census Tract 1503.03, Sonoma County, California",2,2,0
1000000US060971503031021,060971503031021,"Block 1021, Block Group 1, Census Tract 1503.03, Sonoma County, California",10,9,1
1000000US060971503031022,060971503031022,"Block 1022, Block Group 1, Census Tract 1503.03, Sonoma County, California",0,0,0
1000000US060971503031023,060971503031023,"Block 1023, Block Group 1, Census Tract 1503.03, Sonoma County, California",35,31,4
1000000US060971503031024,060971503031024,"Block 1024, Block Group 1, Census Tract 1503.03, Sonoma County, California",0,0,0
1000000US060971503031025,060971503031025,"Block 1025, Block Group 1, Census Tract 1503.03, Sonoma County, California",1,0,1
1000000US060971503031026,060971503031026,"Block 1026, Block Group 1, Census Tract 1503.03, Sonoma County, California",18,15,3
1000000US060971503031027,060971503031027,"Block 1027, Block Group 1, Census Tract 1503.03, Sonoma County, California",43,40,3
1000000US060971503031028,060971503031028,"Block 1028, Block Group 1, Census Tract 1503.03, Sonoma County, California",51,49,2
1000000US060971503031029,060971503031029,"Block 1029, Block Group 1, Census Tract 1503.03, Sonoma County, California",0,0,0
1000000US060971503031030,060971503031030,"Block 1030, Block Group 1, Census Tract 1503.03, Sonoma County, California",0,0,0
1000000US060971503031031,060971503031031,"Block 1031, Block Group 1, Census Tract 1503.03, Sonoma County, California",0,0,0
1000000US060971503031032,060971503031032,"Block 1032, Block Group 1, Census Tract 1503.03, Sonoma County, California",0,0,0
1000000US060971503031033,060971503031033,"Block 1033, Block Group 1, Census Tract 1503.03, Sonoma County, California",16,16,0
1000000US060971503031034,060971503031034,"Block 1034, Block Group 1, Census Tract 1503.03, Sonoma County, California",16,14,2
1000000US060971503031035,060971503031035,"Block 1035, Block Group 1, Census Tract 1503.03, Sonoma County, California",0,0,0
1000000US060971503032000,060971503032000,"Block 2000, Block Group 2, Census Tract 1503.03, Sonoma County, California",5,5,0
1000000US060971503032001,060971503032001,"Block 2001, Block Group 2, Census Tract 1503.03, Sonoma County, California",0,0,0
1000000US060971503032002,060971503032002,"Block 2002, Block Group 2, Census Tract 1503.03, Sonoma County, California",2,2,0
1000000US060971503032003,060971503032003,"Block 2003, Block Group 2, Census Tract 1503.03, Sonoma County, California",0,0,0
1000000US060971503032004,060971503032004,"Block 2004, Block Group 2, Census Tract 1503.03, Sonoma County, California",19,13,6
1000000US060971503032005,060971503032005,"Block 2005, Block Group 2, Census Tract 1503.03, Sonoma County, California",12,7,5
1000000US060971503032006,060971503032006,"Block 2006, Block Group 2, Census Tract 1503.03, Sonoma County, California",35,21,14
1000000US060971503032007,060971503032007,"Block 2007, Block Group 2, Census Tract 1503.03, Sonoma County, California",0,0,0
1000000US060971503032008,060971503032008,"Block 2008, Block Group 2, Census Tract 1503.03, Sonoma County, California",0,0,0
1000000US060971503032009,060971503032009,"Block 2009, Block Group 2, Census Tract 1503.03, Sonoma County, California",0,0,0
1000000US060971503032010,060971503032010,"Block 2010, Block Group 2, Census Tract 1503.03, Sonoma County, California",3,2,1
1000000US060971503032011,060971503032011,"Block 2011, Block Group 2, Census Tract 1503.03, Sonoma County, California",19,12,7
1000000US060971503032012,060971503032012,"Block 2012, Block Group 2, Census Tract 1503.03, Sonoma County, California",0,0,0
1000000US060971503032013,060971503032013,"Block 2013, Block Group 2, Census Tract 1503.03, Sonoma County, California",19,11,8
1000000US060971503032014,060971503032014,"Block 2014, Block Group 2, Census Tract 1503.03, Sonoma County, California",19,17,2
1000000US060971503032015,060971503032015,"Block 2015, Block Group 2, Census Tract 1503.03, Sonoma County, California",16,11,5
1000000US060971503032016,060971503032016,"Block 2016, Block Group 2, Census Tract 1503.03, Sonoma County, California",4,4,0
1000000US060971503032017,060971503032017,"Block 2017, Block Group 2, Census Tract 1503.03, Sonoma County, California",80,71,9
1000000US060971503032018,060971503032018,"Block 2018, Block Group 2, Census Tract 1503.03, Sonoma County, California",6,5,1
1000000US060971503032019,060971503032019,"Block 2019, Block Group 2, Census Tract 1503.03, Sonoma County, California",12,12,0
1000000US060971503032020,060971503032020,"Block 2020, Block Group 2, Census Tract 1503.03, Sonoma County, California",33,29,4
1000000US060971503032021,060971503032021,"Block 2021, Block Group 2, Census Tract 1503.03, Sonoma County, California",33,25,8
1000000US060971503032022,060971503032022,"Block 2022, Block Group 2, Census Tract 1503.03, Sonoma County, California",2,1,1
1000000US060971503032023,060971503032023,"Block 2023, Block Group 2, Census Tract 1503.03, Sonoma County, California",7,4,3
1000000US060971503032024,060971503032024,"Block 2024, Block Group 2, Census Tract 1503.03, Sonoma County, California",1,1,0
1000000US060971503032025,060971503032025,"Block 2025, Block Group 2, Census Tract 1503.03, Sonoma County, California",0,0,0
1000000US060971503032026,060971503032026,"Block 2026, Block Group 2, Census Tract 1503.03, Sonoma County, California",39,30,9
1000000US060971503032027,060971503032027,"Block 2027, Block Group 2, Census Tract 1503.03, Sonoma County, California",12,9,3
1000000US060971503032028,060971503032028,"Block 2028, Block Group 2, Census Tract 1503.03, Sonoma County, California",28,24,4
1000000US060971503032029,060971503032029,"Block 2029, Block Group 2, Census Tract 1503.03, Sonoma County, California",43,38,5
1000000US060971503032030,060971503032030,"Block 2030, Block Group 2, Census Tract 1503.03, Sonoma County, California",10,10,0
1000000US060971503032031,060971503032031,"Block 2031, Block Group 2, Census Tract 1503.03, Sonoma County, California",3,3,0
1000000US060971503032032,060971503032032,"Block 2032, Block Group 2, Census Tract 1503.03, Sonoma County, California",1,1,0
1000000US060971503032033,060971503032033,"Block 2033, Block Group 2, Census Tract 1503.03, Sonoma County, California",82,73,9
1000000US060971503032034,060971503032034,"Block 2034, Block Group 2, Census Tract 1503.03, Sonoma County, California",0,0,0
1000000US060971503032035,060971503032035,"Block 2035, Block Group 2, Census Tract 1503.03, Sonoma County, California",17,17,0
1000000US060971503032036,060971503032036,"Block 2036, Block Group 2, Census Tract 1503.03, Sonoma County, California",20,17,3
1000000US060971503032037,060971503032037,"Block 2037, Block Group 2, Census Tract 1503.03, Sonoma County, California",7,5,2
1000000US060971503032038,060971503032038,"Block 2038, Block Group 2, Census Tract 1503.03, Sonoma County, California",0,0,0
1000000US060971503032039,060971503032039,"Block 2039, Block Group 2, Census Tract 1503.03, Sonoma County, California",0,0,0
1000000US060971503032040,060971503032040,"Block 2040, Block Group 2, Census Tract 1503.03, Sonoma County, California",0,0,0
1000000US060971503032041,060971503032041,"Block 2041, Block Group 2, Census Tract 1503.03, Sonoma County, California",0,0,0
1000000US060971503032042,060971503032042,"Block 2042, Block Group 2, Census Tract 1503.03, Sonoma County, California",0,0,0
1000000US060971503032043,060971503032043,"Block 2043, Block Group 2, Census Tract 1503.03, Sonoma County, California",25,16,9
1000000US060971503032044,060971503032044,"Block 2044, Block Group 2, Census Tract 1503.03, Sonoma County, California",13,12,1
1000000US060971503032045,060971503032045,"Block 2045, Block Group 2, Census Tract 1503.03, Sonoma County, California",6,6,0
1000000US060971503032046,060971503032046,"Block 2046, Block Group 2, Census Tract 1503.03, Sonoma County, California",18,15,3
1000000US060971503032047,060971503032047,"Block 2047, Block Group 2, Census Tract 1503.03, Sonoma County, California",3,3,0
1000000US060971503032048,060971503032048,"Block 2048, Block Group 2, Census Tract 1503.03, Sonoma County, California",3,3,0
1000000US060971503032049,060971503032049,"Block 2049, Block Group 2, Census Tract 1503.03, Sonoma County, California",1,1,0
1000000US060971503032050,060971503032050,"Block 2050, Block Group 2, Census Tract 1503.03, Sonoma County, California",1,1,0
1000000US060971503033000,060971503033000,"Block 3000, Block Group 3, Census Tract 1503.03, Sonoma County, California",9,7,2
1000000US060971503033001,060971503033001,"Block 3001, Block Group 3, Census Tract 1503.03, Sonoma County, California",28,27,1
1000000US060971503033002,060971503033002,"Block 3002, Block Group 3, Census Tract 1503.03, Sonoma County, California",35,30,5
1000000US060971503033003,060971503033003,"Block 3003, Block Group 3, Census Tract 1503.03, Sonoma County, California",32,32,0
1000000US060971503033004,060971503033004,"Block 3004, Block Group 3, Census Tract 1503.03, Sonoma County, California",18,17,1
1000000US060971503033005,060971503033005,"Block 3005, Block Group 3, Census Tract 1503.03, Sonoma County, California",33,32,1
1000000US060971503033006,060971503033006,"Block 3006, Block Group 3, Census Tract 1503.03, Sonoma County, California",37,35,2
1000000US060971503033007,060971503033007,"Block 3007, Block Group 3, Census Tract 1503.03, Sonoma County, California",53,50,3
1000000US060971503033008,060971503033008,"Block 3008, Block Group 3, Census Tract 1503.03, Sonoma County, California",29,25,4
1000000US060971503033009,060971503033009,"Block 3009, Block Group 3, Census Tract 1503.03, Sonoma County, California",27,22,5
1000000US060971503034000,060971503034000,"Block 4000, Block Group 4, Census Tract 1503.03, Sonoma County, California",27,24,3
1000000US060971503034001,060971503034001,"Block 4001, Block Group 4, Census Tract 1503.03, Sonoma County, California",40,36,4
1000000US060971503034002,060971503034002,"Block 4002, Block Group 4, Census Tract 1503.03, Sonoma County, California",1,1,0
1000000US060971503034003,060971503034003,"Block 4003, Block Group 4, Census Tract 1503.03, Sonoma County, California",3,2,1
1000000US060971503034004,060971503034004,"Block 4004, Block Group 4, Census Tract 1503.03, Sonoma County, California",0,0,0
1000000US060971503034005,060971503034005,"Block 4005, Block Group 4, Census Tract 1503.03, Sonoma County, California",8,6,2
1000000US060971503034006,060971503034006,"Block 4006, Block Group 4, Census Tract 1503.03, Sonoma County, California",1,1,0
1000000US060971503034007,060971503034007,"Block 4007, Block Group 4, Census Tract 1503.03, Sonoma County, California",0,0,0
1000000US060971503034008,060971503034008,"Block 4008, Block Group 4, Census Tract 1503.03, Sonoma County, California",6,6,0
1000000US060971503034009,060971503034009,"Block 4009, Block Group 4, Census Tract 1503.03, Sonoma County, California",37,35,2
1000000US060971503034010,060971503034010,"Block 4010, Block Group 4, Census Tract 1503.03, Sonoma County, California",0,0,0
1000000US060971503034011,060971503034011,"Block 4011, Block Group 4, Census Tract 1503.03, Sonoma County, California",47,46,1
1000000US060971503034012,060971503034012,"Block 4012, Block Group 4, Census Tract 1503.03, Sonoma County, California",0,0,0
1000000US060971503034013,060971503034013,"Block 4013, Block Group 4, Census Tract 1503.03, Sonoma County, California",22,19,3
1000000US060971503034014,060971503034014,"Block 4014, Block Group 4, Census Tract 1503.03, Sonoma County, California",202,180,22
1000000US060971503034015,060971503034015,"Block 4015, Block Group 4, Census Tract 1503.03, Sonoma County, California",82,77,5
1000000US060971503034016,060971503034016,"Block 4016, Block Group 4, Census Tract 1503.03, Sonoma County, California",100,90,10
1000000US060971503034017,060971503034017,"Block 4017, Block Group 4, Census Tract 1503.03, Sonoma County, California",40,36,4
1000000US060971503034018,060971503034018,"Block 4018, Block Group 4, Census Tract 1503.03, Sonoma County, California",15,14,1
1000000US060971503034019,060971503034019,"Block 4019, Block Group 4, Census Tract 1503.03, Sonoma County, California",37,33,4
1000000US060971503034020,060971503034020,"Block 4020, Block Group 4, Census Tract 1503.03, Sonoma County, California",23,22,1
1000000US060971503034021,060971503034021,"Block 4021, Block Group 4, Census Tract 1503.03, Sonoma County, California",26,26,0
1000000US060971503034022,060971503034022,"Block 4022, Block Group 4, Census Tract 1503.03, Sonoma County, California",51,49,2
1000000US060971503034023,060971503034023,"Block 4023, Block Group 4, Census Tract 1503.03, Sonoma County, California",32,30,2
1000000US060971503034024,060971503034024,"Block 4024, Block Group 4, Census Tract 1503.03, Sonoma County, California",8,7,1
1000000US060971503034025,060971503034025,"Block 4025, Block Group 4, Census Tract 1503.03, Sonoma County, California",200,178,22
1000000US060971503034026,060971503034026,"Block 4026, Block Group 4, Census Tract 1503.03, Sonoma County, California",13,10,3
1000000US060971503034027,060971503034027,"Block 4027, Block Group 4, Census Tract 1503.03, Sonoma County, California",0,0,0
1000000US060971503034028,060971503034028,"Block 4028, Block Group 4, Census Tract 1503.03, Sonoma County, California",0,0,0
1000000US060971503034029,060971503034029,"Block 4029, Block Group 4, Census Tract 1503.03, Sonoma County, California",1,1,0
1000000US060971503034030,060971503034030,"Block 4030, Block Group 4, Census Tract 1503.03, Sonoma County, California",1,1,0
1000000US060971503034031,060971503034031,"Block 4031, Block Group 4, Census Tract 1503.03, Sonoma County, California",0,0,0
1000000US060971503034032,060971503034032,"Block 4032, Block Group 4, Census Tract 1503.03, Sonoma County, California",0,0,0
1000000US060971503034033,060971503034033,"Block 4033, Block Group 4, Census Tract 1503.03, Sonoma County, California",0,0,0
1000000US060971503034034,060971503034034,"Block 4034, Block Group 4, Census Tract 1503.03, Sonoma County, California",11,10,1
1000000US060971503041000,060971503041000,"Block 1000, Block Group 1, Census Tract 1503.04, Sonoma County, California",160,142,18
1000000US060971503041001,060971503041001,"Block 1001, Block Group 1, Census Tract 1503.04, Sonoma County, California",54,50,4
1000000US060971503041002,060971503041002,"Block 1002, Block Group 1, Census Tract 1503.04, Sonoma County, California",6,6,0
1000000US060971503041003,060971503041003,"Block 1003, Block Group 1, Census Tract 1503.04, Sonoma County, California",18,18,0
1000000US060971503041004,060971503041004,"Block 1004, Block Group 1, Census Tract 1503.04, Sonoma County, California",20,19,1
1000000US060971503041005,060971503041005,"Block 1005, Block Group 1, Census Tract 1503.04, Sonoma County, California",21,20,1
1000000US060971503041006,060971503041006,"Block 1006, Block Group 1, Census Tract 1503.04, Sonoma County, California",19,18,1
1000000US060971503041007,060971503041007,"Block 1007, Block Group 1, Census Tract 1503.04, Sonoma County, California",8,8,0
1000000US060971503041008,060971503041008,"Block 1008, Block Group 1, Census Tract 1503.04, Sonoma County, California",30,28,2
1000000US060971503042000,060971503042000,"Block 2000, Block Group 2, Census Tract 1503.04, Sonoma County, California",119,113,6
1000000US060971503042001,060971503042001,"Block 2001, Block Group 2, Census Tract 1503.04, Sonoma County, California",15,14,1
1000000US060971503042002,060971503042002,"Block 2002, Block Group 2, Census Tract 1503.04, Sonoma County, California",19,19,0
1000000US060971503042003,060971503042003,"Block 2003, Block Group 2, Census Tract 1503.04, Sonoma County, California",38,36,2
1000000US060971503042004,060971503042004,"Block 2004, Block Group 2, Census Tract 1503.04, Sonoma County, California",23,21,2
1000000US060971503042005,060971503042005,"Block 2005, Block Group 2, Census Tract 1503.04, Sonoma County, California",19,15,4
1000000US060971503042006,060971503042006,"Block 2006, Block Group 2, Census Tract 1503.04, Sonoma County, California",11,8,3
1000000US060971503042007,060971503042007,"Block 2007, Block Group 2, Census Tract 1503.04, Sonoma County, California",11,10,1
1000000US060971503042008,060971503042008,"Block 2008, Block Group 2, Census Tract 1503.04, Sonoma County, California",42,38,4
1000000US060971503042009,060971503042009,"Block 2009, Block Group 2, Census Tract 1503.04, Sonoma County, California",11,11,0
1000000US060971503042010,060971503042010,"Block 2010, Block Group 2, Census Tract 1503.04, Sonoma County, California",15,14,1
1000000US060971503042011,060971503042011,"Block 2011, Block Group 2, Census Tract 1503.04, Sonoma County, California",33,33,0
1000000US060971503042012,060971503042012,"Block 2012, Block Group 2, Census Tract 1503.04, Sonoma County, California",10,7,3
1000000US060971503042013,060971503042013,"Block 2013, Block Group 2, Census Tract 1503.04, Sonoma County, California",27,23,4
1000000US060971503042014,060971503042014,"Block 2014, Block Group 2, Census Tract 1503.04, Sonoma County, California",5,5,0
1000000US060971503042015,060971503042015,"Block 2015, Block Group 2, Census Tract 1503.04, Sonoma County, California",17,14,3
1000000US060971503042016,060971503042016,"Block 2016, Block Group 2, Census Tract 1503.04, Sonoma County, California",127,110,17
1000000US060971503042017,060971503042017,"Block 2017, Block Group 2, Census Tract 1503.04, Sonoma County, California",20,16,4
1000000US060971503042018,060971503042018,"Block 2018, Block Group 2, Census Tract 1503.04, Sonoma County, California",10,10,0
1000000US060971503042019,060971503042019,"Block 2019, Block Group 2, Census Tract 1503.04, Sonoma County, California",23,23,0
1000000US060971503042020,060971503042020,"Block 2020, Block Group 2, Census Tract 1503.04, Sonoma County, California",55,54,1
1000000US060971503042021,060971503042021,"Block 2021, Block Group 2, Census Tract 1503.04, Sonoma County, California",17,17,0
1000000US060971503042022,060971503042022,"Block 2022, Block Group 2, Census Tract 1503.04, Sonoma County, California",37,29,8
1000000US060971503042023,060971503042023,"Block 2023, Block Group 2, Census Tract 1503.04, Sonoma County, California",2,2,0
1000000US060971503042024,060971503042024,"Block 2024, Block Group 2, Census Tract 1503.04, Sonoma County, California",17,17,0
1000000US060971503042025,060971503042025,"Block 2025, Block Group 2, Census Tract 1503.04, Sonoma County, California",13,13,0
1000000US060971503042026,060971503042026,"Block 2026, Block Group 2, Census Tract 1503.04, Sonoma County, California",20,20,0
1000000US060971503042027,060971503042027,"Block 2027, Block Group 2, Census Tract 1503.04, Sonoma County, California",41,39,2
1000000US060971503043000,060971503043000,"Block 3000, Block Group 3, Census Tract 1503.04, Sonoma County, California",85,82,3
1000000US060971503043001,060971503043001,"Block 3001, Block Group 3, Census Tract 1503.04, Sonoma County, California",86,84,2
1000000US060971503043002,060971503043002,"Block 3002, Block Group 3, Census Tract 1503.04, Sonoma County, California",30,28,2
1000000US060971503043003,060971503043003,"Block 3003, Block Group 3, Census Tract 1503.04, Sonoma County, California",48,48,0
1000000US060971503043004,060971503043004,"Block 3004, Block Group 3, Census Tract 1503.04, Sonoma County, California",19,19,0
1000000US060971503043005,060971503043005,"Block 3005, Block Group 3, Census Tract 1503.04, Sonoma County, California",27,25,2
1000000US060971503043006,060971503043006,"Block 3006, Block Group 3, Census Tract 1503.04, Sonoma County, California",67,62,5
1000000US060971503043007,060971503043007,"Block 3007, Block Group 3, Census Tract 1503.04, Sonoma County, California",13,13,0
1000000US060971503043008,060971503043008,"Block 3008, Block Group 3, Census Tract 1503.04, Sonoma County, California",12,9,3
1000000US060971503043009,060971503043009,"Block 3009, Block Group 3, Census Tract 1503.04, Sonoma County, California",21,21,0
1000000US060971503043010,060971503043010,"Block 3010, Block Group 3, Census Tract 1503.04, Sonoma County, California",61,55,6
1000000US060971503043011,060971503043011,"Block 3011, Block Group 3, Census Tract 1503.04, Sonoma County, California",21,19,2
1000000US060971503043012,060971503043012,"Block 3012, Block Group 3, Census Tract 1503.04, Sonoma County, California",8,7,1
1000000US060971503043013,060971503043013,"Block 3013, Block Group 3, Census Tract 1503.04, Sonoma County, California",9,7,2
1000000US060971503043014,060971503043014,"Block 3014, Block Group 3, Census Tract 1503.04, Sonoma County, California",14,14,0
1000000US060971503043015,060971503043015,"Block 3015, Block Group 3, Census Tract 1503.04, Sonoma County, California",10,9,1
1000000US060971503043016,060971503043016,"Block 3016, Block Group 3, Census Tract 1503.04, Sonoma County, California",10,10,0
1000000US060971503043017,060971503043017,"Block 3017, Block Group 3, Census Tract 1503.04, Sonoma County, California",6,5,1
1000000US060971503043018,060971503043018,"Block 3018, Block Group 3, Census Tract 1503.04, Sonoma County, California",14,13,1
1000000US060971503043019,060971503043019,"Block 3019, Block Group 3, Census Tract 1503.04, Sonoma County, California",4,3,1
1000000US060971503043020,060971503043020,"Block 3020, Block Group 3, Census Tract 1503.04, Sonoma County, California",17,13,4
1000000US060971503043021,060971503043021,"Block 3021, Block Group 3, Census Tract 1503.04, Sonoma County, California",6,5,1
1000000US060971503043022,060971503043022,"Block 3022, Block Group 3, Census Tract 1503.04, Sonoma County, California",5,5,0
1000000US060971503043023,060971503043023,"Block 3023, Block Group 3, Census Tract 1503.04, Sonoma County, California",20,18,2
1000000US060971503043024,060971503043024,"Block 3024, Block Group 3, Census Tract 1503.04, Sonoma County, California",24,22,2
1000000US060971503044000,060971503044000,"Block 4000, Block Group 4, Census Tract 1503.04, Sonoma County, California",60,56,4
1000000US060971503044001,060971503044001,"Block 4001, Block Group 4, Census Tract 1503.04, Sonoma County, California",8,8,0
1000000US060971503044002,060971503044002,"Block 4002, Block Group 4, Census Tract 1503.04, Sonoma County, California",8,7,1
1000000US060971503044003,060971503044003,"Block 4003, Block Group 4, Census Tract 1503.04, Sonoma County, California",13,13,0
1000000US060971503044004,060971503044004,"Block 4004, Block Group 4, Census Tract 1503.04, Sonoma County, California",14,11,3
1000000US060971503044005,060971503044005,"Block 4005, Block Group 4, Census Tract 1503.04, Sonoma County, California",3,3,0
1000000US060971503044006,060971503044006,"Block 4006, Block Group 4, Census Tract 1503.04, Sonoma County, California",20,18,2
1000000US060971503044007,060971503044007,"Block 4007, Block Group 4, Census Tract 1503.04, Sonoma County, California",10,9,1
1000000US060971503044008,060971503044008,"Block 4008, Block Group 4, Census Tract 1503.04, Sonoma County, California",27,25,2
1000000US060971503044009,060971503044009,"Block 4009, Block Group 4, Census Tract 1503.04, Sonoma County, California",8,8,0
1000000US060971503044010,060971503044010,"Block 4010, Block Group 4, Census Tract 1503.04, Sonoma County, California",9,7,2
1000000US060971503044011,060971503044011,"Block 4011, Block Group 4, Census Tract 1503.04, Sonoma County, California",28,24,4
1000000US060971503044012,060971503044012,"Block 4012, Block Group 4, Census Tract 1503.04, Sonoma County, California",34,29,5
1000000US060971503044013,060971503044013,"Block 4013, Block Group 4, Census Tract 1503.04, Sonoma County, California",9,9,0
1000000US060971503044014,060971503044014,"Block 4014, Block Group 4, Census Tract 1503.04, Sonoma County, California",14,13,1
1000000US060971503044015,060971503044015,"Block 4015, Block Group 4, Census Tract 1503.04, Sonoma County, California",14,14,0
1000000US060971503044016,060971503044016,"Block 4016, Block Group 4, Census Tract 1503.04, Sonoma County, California",15,13,2
1000000US060971503044017,060971503044017,"Block 4017, Block Group 4, Census Tract 1503.04, Sonoma County, California",11,9,2
1000000US060971503044018,060971503044018,"Block 4018, Block Group 4, Census Tract 1503.04, Sonoma County, California",73,70,3
1000000US060971503044019,060971503044019,"Block 4019, Block Group 4, Census Tract 1503.04, Sonoma County, California",2,2,0
1000000US060971503044020,060971503044020,"Block 4020, Block Group 4, Census Tract 1503.04, Sonoma County, California",19,17,2
1000000US060971503044021,060971503044021,"Block 4021, Block Group 4, Census Tract 1503.04, Sonoma County, California",2,1,1
1000000US060971503044022,060971503044022,"Block 4022, Block Group 4, Census Tract 1503.04, Sonoma County, California",64,57,7
1000000US060971503044023,060971503044023,"Block 4023, Block Group 4, Census Tract 1503.04, Sonoma County, California",21,21,0
1000000US060971503044024,060971503044024,"Block 4024, Block Group 4, Census Tract 1503.04, Sonoma County, California",23,21,2
1000000US060971503044025,060971503044025,"Block 4025, Block Group 4, Census Tract 1503.04, Sonoma County, California",33,29,4
1000000US060971503044026,060971503044026,"Block 4026, Block Group 4, Census Tract 1503.04, Sonoma County, California",45,45,0
1000000US060971503044027,060971503044027,"Block 4027, Block Group 4, Census Tract 1503.04, Sonoma County, California",17,16,1
1000000US060971503044028,060971503044028,"Block 4028, Block Group 4, Census Tract 1503.04, Sonoma County, California",19,19,0
1000000US060971503044029,060971503044029,"Block 4029, Block Group 4, Census Tract 1503.04, Sonoma County, California",14,13,1
1000000US060971503044030,060971503044030,"Block 4030, Block Group 4, Census Tract 1503.04, Sonoma County, California",6,6,0
1000000US060971503051000,060971503051000,"Block 1000, Block Group 1, Census Tract 1503.05, Sonoma County, California",2,2,0
1000000US060971503051001,060971503051001,"Block 1001, Block Group 1, Census Tract 1503.05, Sonoma County, California",1,1,0
1000000US060971503051002,060971503051002,"Block 1002, Block Group 1, Census Tract 1503.05, Sonoma County, California",1,1,0
1000000US060971503051003,060971503051003,"Block 1003, Block Group 1, Census Tract 1503.05, Sonoma County, California",53,48,5
1000000US060971503051004,060971503051004,"Block 1004, Block Group 1, Census Tract 1503.05, Sonoma County, California",12,11,1
1000000US060971503051005,060971503051005,"Block 1005, Block Group 1, Census Tract 1503.05, Sonoma County, California",11,9,2
1000000US060971503051006,060971503051006,"Block 1006, Block Group 1, Census Tract 1503.05, Sonoma County, California",15,15,0
1000000US060971503051007,060971503051007,"Block 1007, Block Group 1, Census Tract 1503.05, Sonoma County, California",56,53,3
1000000US060971503051008,060971503051008,"Block 1008, Block Group 1, Census Tract 1503.05, Sonoma County, California",83,80,3
1000000US060971503051009,060971503051009,"Block 1009, Block Group 1, Census Tract 1503.05, Sonoma County, California",17,15,2
1000000US060971503051010,060971503051010,"Block 1010, Block Group 1, Census Tract 1503.05, Sonoma County, California",46,42,4
1000000US060971503052000,060971503052000,"Block 2000, Block Group 2, Census Tract 1503.05, Sonoma County, California",155,148,7
1000000US060971503052001,060971503052001,"Block 2001, Block Group 2, Census Tract 1503.05, Sonoma County, California",11,11,0
1000000US060971503052002,060971503052002,"Block 2002, Block Group 2, Census Tract 1503.05, Sonoma County, California",17,14,3
1000000US060971503052003,060971503052003,"Block 2003, Block Group 2, Census Tract 1503.05, Sonoma County, California",0,0,0
1000000US060971503052004,060971503052004,"Block 2004, Block Group 2, Census Tract 1503.05, Sonoma County, California",5,4,1
1000000US060971503052005,060971503052005,"Block 2005, Block Group 2, Census Tract 1503.05, Sonoma County, California",14,13,1
1000000US060971503052006,060971503052006,"Block 2006, Block Group 2, Census Tract 1503.05, Sonoma County, California",37,35,2
1000000US060971503052007,060971503052007,"Block 2007, Block Group 2, Census Tract 1503.05, Sonoma County, California",140,131,9
1000000US060971503052008,060971503052008,"Block 2008, Block Group 2, Census Tract 1503.05, Sonoma County, California",47,42,5
1000000US060971503052009,060971503052009,"Block 2009, Block Group 2, Census Tract 1503.05, Sonoma County, California",19,18,1
1000000US060971503052010,060971503052010,"Block 2010, Block Group 2, Census Tract 1503.05, Sonoma County, California",49,45,4
1000000US060971503052011,060971503052011,"Block 2011, Block Group 2, Census Tract 1503.05, Sonoma County, California",7,6,1
1000000US060971503052012,060971503052012,"Block 2012, Block Group 2, Census Tract 1503.05, Sonoma County, California",0,0,0
1000000US060971503053000,060971503053000,"Block 3000, Block Group 3, Census Tract 1503.05, Sonoma County, California",29,29,0
1000000US060971503053001,060971503053001,"Block 3001, Block Group 3, Census Tract 1503.05, Sonoma County, California",117,103,14
1000000US060971503053002,060971503053002,"Block 3002, Block Group 3, Census Tract 1503.05, Sonoma County, California",22,19,3
1000000US060971503053003,060971503053003,"Block 3003, Block Group 3, Census Tract 1503.05, Sonoma County, California",30,27,3
1000000US060971503053004,060971503053004,"Block 3004, Block Group 3, Census Tract 1503.05, Sonoma County, California",247,225,22
1000000US060971503053005,060971503053005,"Block 3005, Block Group 3, Census Tract 1503.05, Sonoma County, California",4,3,1
1000000US060971503053006,060971503053006,"Block 3006, Block Group 3, Census Tract 1503.05, Sonoma County, California",46,45,1
1000000US060971503053007,060971503053007,"Block 3007, Block Group 3, Census Tract 1503.05, Sonoma County, California",8,8,0
1000000US060971503053008,060971503053008,"Block 3008, Block Group 3, Census Tract 1503.05, Sonoma County, California",38,36,2
1000000US060971503053009,060971503053009,"Block 3009, Block Group 3, Census Tract 1503.05, Sonoma County, California",30,25,5
1000000US060971503053010,060971503053010,"Block 3010, Block Group 3, Census Tract 1503.05, Sonoma County, California",88,86,2
1000000US060971503053011,060971503053011,"Block 3011, Block Group 3, Census Tract 1503.05, Sonoma County, California",0,0,0
1000000US060971503054000,060971503054000,"Block 4000, Block Group 4, Census Tract 1503.05, Sonoma County, California",16,16,0
1000000US060971503054001,060971503054001,"Block 4001, Block Group 4, Census Tract 1503.05, Sonoma County, California",11,9,2
1000000US060971503054002,060971503054002,"Block 4002, Block Group 4, Census Tract 1503.05, Sonoma County, California",52,49,3
1000000US060971503054003,060971503054003,"Block 4003, Block Group 4, Census Tract 1503.05, Sonoma County, California",42,42,0
1000000US060971503054004,060971503054004,"Block 4004, Block Group 4, Census Tract 1503.05, Sonoma County, California",0,0,0
1000000US060971503054005,060971503054005,"Block 4005, Block Group 4, Census Tract 1503.05, Sonoma County, California",25,21,4
1000000US060971503054006,060971503054006,"Block 4006, Block Group 4, Census Tract 1503.05, Sonoma County, California",10,8,2
1000000US060971503054007,060971503054007,"Block 4007, Block Group 4, Census Tract 1503.05, Sonoma County, California",22,22,0
1000000US060971503054008,060971503054008,"Block 4008, Block Group 4, Census Tract 1503.05, Sonoma County, California",26,26,0
1000000US060971503054009,060971503054009,"Block 4009, Block Group 4, Census Tract 1503.05, Sonoma County, California",32,30,2
1000000US060971503054010,060971503054010,"Block 4010, Block Group 4, Census Tract 1503.05, Sonoma County, California",39,32,7
1000000US060971503054011,060971503054011,"Block 4011, Block Group 4, Census Tract 1503.05, Sonoma County, California",31,24,7
1000000US060971503061000,060971503061000,"Block 1000, Block Group 1, Census Tract 1503.06, Sonoma County, California",18,15,3
1000000US060971503061001,060971503061001,"Block 1001, Block Group 1, Census Tract 1503.06, Sonoma County, California",20,18,2
1000000US060971503061002,060971503061002,"Block 1002, Block Group 1, Census Tract 1503.06, Sonoma County, California",44,42,2
1000000US060971503061003,060971503061003,"Block 1003, Block Group 1, Census Tract 1503.06, Sonoma County, California",14,12,2
1000000US060971503061004,060971503061004,"Block 1004, Block Group 1, Census Tract 1503.06, Sonoma County, California",1,1,0
1000000US060971503061005,060971503061005,"Block 1005, Block Group 1, Census Tract 1503.06, Sonoma County, California",40,38,2
1000000US060971503061006,060971503061006,"Block 1006, Block Group 1, Census Tract 1503.06, Sonoma County, California",18,17,1
1000000US060971503061007,060971503061007,"Block 1007, Block Group 1, Census Tract 1503.06, Sonoma County, California",7,7,0
1000000US060971503061008,060971503061008,"Block 1008, Block Group 1, Census Tract 1503.06, Sonoma County, California",7,7,0
1000000US060971503061009,060971503061009,"Block 1009, Block Group 1, Census Tract 1503.06, Sonoma County, California",17,17,0
1000000US060971503061010,060971503061010,"Block 1010, Block Group 1, Census Tract 1503.06, Sonoma County, California",8,8,0
1000000US060971503061011,060971503061011,"Block 1011, Block Group 1, Census Tract 1503.06, Sonoma County, California",10,9,1
1000000US060971503061012,060971503061012,"Block 1012, Block Group 1, Census Tract 1503.06, Sonoma County, California",28,25,3
1000000US060971503061013,060971503061013,"Block 1013, Block Group 1, Census Tract 1503.06, Sonoma County, California",19,18,1
1000000US060971503061014,060971503061014,"Block 1014, Block Group 1, Census Tract 1503.06, Sonoma County, California",18,16,2
1000000US060971503061015,060971503061015,"Block 1015, Block Group 1, Census Tract 1503.06, Sonoma County, California",12,11,1
1000000US060971503061016,060971503061016,"Block 1016, Block Group 1, Census Tract 1503.06, Sonoma County, California",17,15,2
1000000US060971503061017,060971503061017,"Block 1017, Block Group 1, Census Tract 1503.06, Sonoma County, California",14,14,0
1000000US060971503061018,060971503061018,"Block 1018, Block Group 1, Census Tract 1503.06, Sonoma County, California",17,16,1
1000000US060971503061019,060971503061019,"Block 1019, Block Group 1, Census Tract 1503.06, Sonoma County, California",18,16,2
1000000US060971503061020,060971503061020,"Block 1020, Block Group 1, Census Tract 1503.06, Sonoma County, California",19,19,0
1000000US060971503061021,060971503061021,"Block 1021, Block Group 1, Census Tract 1503.06, Sonoma County, California",4,4,0
1000000US060971503061022,060971503061022,"Block 1022, Block Group 1, Census Tract 1503.06, Sonoma County, California",19,17,2
1000000US060971503061023,060971503061023,"Block 1023, Block Group 1, Census Tract 1503.06, Sonoma County, California",17,16,1
1000000US060971503062000,060971503062000,"Block 2000, Block Group 2, Census Tract 1503.06, Sonoma County, California",177,162,15
1000000US060971503062001,060971503062001,"Block 2001, Block Group 2, Census Tract 1503.06, Sonoma County, California",2,2,0
1000000US060971503062002,060971503062002,"Block 2002, Block Group 2, Census Tract 1503.06, Sonoma County, California",1,0,1
1000000US060971503062003,060971503062003,"Block 2003, Block Group 2, Census Tract 1503.06, Sonoma County, California",45,41,4
1000000US060971503062004,060971503062004,"Block 2004, Block Group 2, Census Tract 1503.06, Sonoma County, California",43,36,7
1000000US060971503062005,060971503062005,"Block 2005, Block Group 2, Census Tract 1503.06, Sonoma County, California",71,63,8
1000000US060971503062006,060971503062006,"Block 2006, Block Group 2, Census Tract 1503.06, Sonoma County, California",22,18,4
1000000US060971503062007,060971503062007,"Block 2007, Block Group 2, Census Tract 1503.06, Sonoma County, California",13,11,2
1000000US060971503062008,060971503062008,"Block 2008, Block Group 2, Census Tract 1503.06, Sonoma County, California",44,37,7
1000000US060971503062009,060971503062009,"Block 2009, Block Group 2, Census Tract 1503.06, Sonoma County, California",12,8,4
1000000US060971503062010,060971503062010,"Block 2010, Block Group 2, Census Tract 1503.06, Sonoma County, California",15,14,1
1000000US060971503062011,060971503062011,"Block 2011, Block Group 2, Census Tract 1503.06, Sonoma County, California",7,7,0
1000000US060971503062012,060971503062012,"Block 2012, Block Group 2, Census Tract 1503.06, Sonoma County, California",25,19,6
1000000US060971503062013,060971503062013,"Block 2013, Block Group 2, Census Tract 1503.06, Sonoma County, California",15,14,1
1000000US060971503062014,060971503062014,"Block 2014, Block Group 2, Census Tract 1503.06, Sonoma County, California",21,20,1
1000000US060971503063000,060971503063000,"Block 3000, Block Group 3, Census Tract 1503.06, Sonoma County, California",0,0,0
1000000US060971503063001,060971503063001,"Block 3001, Block Group 3, Census Tract 1503.06, Sonoma County, California",30,26,4
1000000US060971503063002,060971503063002,"Block 3002, Block Group 3, Census Tract 1503.06, Sonoma County, California",4,1,3
1000000US060971503063003,060971503063003,"Block 3003, Block Group 3, Census Tract 1503.06, Sonoma County, California",6,5,1
1000000US060971503063004,060971503063004,"Block 3004, Block Group 3, Census Tract 1503.06, Sonoma County, California",15,10,5
1000000US060971503063005,060971503063005,"Block 3005, Block Group 3, Census Tract 1503.06, Sonoma County, California",0,0,0
1000000US060971503063006,060971503063006,"Block 3006, Block Group 3, Census Tract 1503.06, Sonoma County, California",188,179,9
1000000US060971503063007,060971503063007,"Block 3007, Block Group 3, Census Tract 1503.06, Sonoma County, California",15,15,0
1000000US060971503063008,060971503063008,"Block 3008, Block Group 3, Census Tract 1503.06, Sonoma County, California",23,23,0
1000000US060971503063009,060971503063009,"Block 3009, Block Group 3, Census Tract 1503.06, Sonoma County, California",68,62,6
1000000US060971503063010,060971503063010,"Block 3010, Block Group 3, Census Tract 1503.06, Sonoma County, California",18,16,2
1000000US060971503063011,060971503063011,"Block 3011, Block Group 3, Census Tract 1503.06, Sonoma County, California",8,8,0
1000000US060971503063012,060971503063012,"Block 3012, Block Group 3, Census Tract 1503.06, Sonoma County, California",21,17,4
1000000US060971503063013,060971503063013,"Block 3013, Block Group 3, Census Tract 1503.06, Sonoma County, California",12,10,2
1000000US060971503063014,060971503063014,"Block 3014, Block Group 3, Census Tract 1503.06, Sonoma County, California",13,13,0
1000000US060971503063015,060971503063015,"Block 3015, Block Group 3, Census Tract 1503.06, Sonoma County, California",144,133,11
1000000US060971503063016,060971503063016,"Block 3016, Block Group 3, Census Tract 1503.06, Sonoma County, California",17,17,0
1000000US060971503063017,060971503063017,"Block 3017, Block Group 3, Census Tract 1503.06, Sonoma County, California",14,13,1
1000000US060971503063018,060971503063018,"Block 3018, Block Group 3, Census Tract 1503.06, Sonoma County, California",70,61,9
1000000US060971503063019,060971503063019,"Block 3019, Block Group 3, Census Tract 1503.06, Sonoma County, California",87,70,17
1000000US060971503063020,060971503063020,"Block 3020, Block Group 3, Census Tract 1503.06, Sonoma County, California",6,6,0
1000000US060971503063021,060971503063021,"Block 3021, Block Group 3, Census Tract 1503.06, Sonoma County, California",48,41,7
1000000US060971503063022,060971503063022,"Block 3022, Block Group 3, Census Tract 1503.06, Sonoma County, California",47,41,6
1000000US060971503063023,060971503063023,"Block 3023, Block Group 3, Census Tract 1503.06, Sonoma County, California",0,0,0
1000000US060971505001000,060971505001000,"Block 1000, Block Group 1, Census Tract 1505, Sonoma County, California",90,78,12
1000000US060971505001001,060971505001001,"Block 1001, Block Group 1, Census Tract 1505, Sonoma County, California",12,10,2
1000000US060971505001002,060971505001002,"Block 1002, Block Group 1, Census Tract 1505, Sonoma County, California",1,1,0
1000000US060971505001003,060971505001003,"Block 1003, Block Group 1, Census Tract 1505, Sonoma County, California",4,2,2
1000000US060971505001004,060971505001004,"Block 1004, Block Group 1, Census Tract 1505, Sonoma County, California",0,0,0
1000000US060971505001005,060971505001005,"Block 1005, Block Group 1, Census Tract 1505, Sonoma County, California",1,0,1
1000000US060971505001006,060971505001006,"Block 1006, Block Group 1, Census Tract 1505, Sonoma County, California",0,0,0
1000000US060971505001007,060971505001007,"Block 1007, Block Group 1, Census Tract 1505, Sonoma County, California",0,0,0
1000000US060971505001008,060971505001008,"Block 1008, Block Group 1, Census Tract 1505, Sonoma County, California",0,0,0
1000000US060971505001009,060971505001009,"Block 1009, Block Group 1, Census Tract 1505, Sonoma County, California",0,0,0
1000000US060971505001010,060971505001010,"Block 1010, Block Group 1, Census Tract 1505, Sonoma County, California",0,0,0
1000000US060971505001011,060971505001011,"Block 1011, Block Group 1, Census Tract 1505, Sonoma County, California",34,29,5
1000000US060971505001012,060971505001012,"Block 1012, Block Group 1, Census Tract 1505, Sonoma County, California",0,0,0
1000000US060971505001013,060971505001013,"Block 1013, Block Group 1, Census Tract 1505, Sonoma County, California",0,0,0
1000000US060971505001014,060971505001014,"Block 1014, Block Group 1, Census Tract 1505, Sonoma County, California",0,0,0
1000000US060971505001015,060971505001015,"Block 1015, Block Group 1, Census Tract 1505, Sonoma County, California",0,0,0
1000000US060971505001016,060971505001016,"Block 1016, Block Group 1, Census Tract 1505, Sonoma County, California",0,0,0
1000000US060971505001017,060971505001017,"Block 1017, Block Group 1, Census Tract 1505, Sonoma County, California",0,0,0
1000000US060971505001018,060971505001018,"Block 1018, Block Group 1, Census Tract 1505, Sonoma County, California",0,0,0
1000000US060971505001019,060971505001019,"Block 1019, Block Group 1, Census Tract 1505, Sonoma County, California",0,0,0
1000000US060971505001020,060971505001020,"Block 1020, Block Group 1, Census Tract 1505, Sonoma County, California",0,0,0
1000000US060971505001021,060971505001021,"Block 1021, Block Group 1, Census Tract 1505, Sonoma County, California",0,0,0
1000000US060971505001022,060971505001022,"Block 1022, Block Group 1, Census Tract 1505, Sonoma County, California",0,0,0
1000000US060971505001023,060971505001023,"Block 1023, Block Group 1, Census Tract 1505, Sonoma County, California",0,0,0
1000000US060971505001024,060971505001024,"Block 1024, Block Group 1, Census Tract 1505, Sonoma County, California",0,0,0
1000000US060971505001025,060971505001025,"Block 1025, Block Group 1, Census Tract 1505, Sonoma County, California",0,0,0
1000000US060971505001026,060971505001026,"Block 1026, Block Group 1, Census Tract 1505, Sonoma County, California",0,0,0
1000000US060971505001027,060971505001027,"Block 1027, Block Group 1, Census Tract 1505, Sonoma County, California",0,0,0
1000000US060971505001028,060971505001028,"Block 1028, Block Group 1, Census Tract 1505, Sonoma County, California",0,0,0
1000000US060971505002000,060971505002000,"Block 2000, Block Group 2, Census Tract 1505, Sonoma County, California",0,0,0
1000000US060971505002001,060971505002001,"Block 2001, Block Group 2, Census Tract 1505, Sonoma County, California",3,3,0
1000000US060971505002002,060971505002002,"Block 2002, Block Group 2, Census Tract 1505, Sonoma County, California",6,5,1
1000000US060971505002003,060971505002003,"Block 2003, Block Group 2, Census Tract 1505, Sonoma County, California",21,16,5
1000000US060971505002004,060971505002004,"Block 2004, Block Group 2, Census Tract 1505, Sonoma County, California",8,7,1
1000000US060971505002005,060971505002005,"Block 2005, Block Group 2, Census Tract 1505, Sonoma County, California",21,19,2
1000000US060971505002006,060971505002006,"Block 2006, Block Group 2, Census Tract 1505, Sonoma County, California",15,15,0
1000000US060971505002007,060971505002007,"Block 2007, Block Group 2, Census Tract 1505, Sonoma County, California",65,61,4
1000000US060971505002008,060971505002008,"Block 2008, Block Group 2, Census Tract 1505, Sonoma County, California",14,13,1
1000000US060971505002009,060971505002009,"Block 2009, Block Group 2, Census Tract 1505, Sonoma County, California",24,24,0
1000000US060971505002010,060971505002010,"Block 2010, Block Group 2, Census Tract 1505, Sonoma County, California",15,15,0
1000000US060971505002011,060971505002011,"Block 2011, Block Group 2, Census Tract 1505, Sonoma County, California",4,4,0
1000000US060971505002012,060971505002012,"Block 2012, Block Group 2, Census Tract 1505, Sonoma County, California",18,17,1
1000000US060971505002013,060971505002013,"Block 2013, Block Group 2, Census Tract 1505, Sonoma County, California",7,5,2
1000000US060971505002014,060971505002014,"Block 2014, Block Group 2, Census Tract 1505, Sonoma County, California",7,4,3
1000000US060971505002015,060971505002015,"Block 2015, Block Group 2, Census Tract 1505, Sonoma County, California",3,3,0
1000000US060971505002016,060971505002016,"Block 2016, Block Group 2, Census Tract 1505, Sonoma County, California",12,10,2
1000000US060971505002017,060971505002017,"Block 2017, Block Group 2, Census Tract 1505, Sonoma County, California",17,15,2
1000000US060971505002018,060971505002018,"Block 2018, Block Group 2, Census Tract 1505, Sonoma County, California",20,20,0
1000000US060971505002019,060971505002019,"Block 2019, Block Group 2, Census Tract 1505, Sonoma County, California",16,14,2
1000000US060971505002020,060971505002020,"Block 2020, Block Group 2, Census Tract 1505, Sonoma County, California",28,26,2
1000000US060971505002021,060971505002021,"Block 2021, Block Group 2, Census Tract 1505, Sonoma County, California",7,7,0
1000000US060971505002022,060971505002022,"Block 2022, Block Group 2, Census Tract 1505, Sonoma County, California",9,7,2
1000000US060971505002023,060971505002023,"Block 2023, Block Group 2, Census Tract 1505, Sonoma County, California",4,3,1
1000000US060971505002024,060971505002024,"Block 2024, Block Group 2, Census Tract 1505, Sonoma County, California",6,2,4
1000000US060971505002025,060971505002025,"Block 2025, Block Group 2, Census Tract 1505, Sonoma County, California",11,8,3
1000000US060971505002026,060971505002026,"Block 2026, Block Group 2, Census Tract 1505, Sonoma County, California",0,0,0
1000000US060971505002027,060971505002027,"Block 2027, Block Group 2, Census Tract 1505, Sonoma County, California",2,2,0
1000000US060971505002028,060971505002028,"Block 2028, Block Group 2, Census Tract 1505, Sonoma County, California",12,11,1
1000000US060971505002029,060971505002029,"Block 2029, Block Group 2, Census Tract 1505, Sonoma County, California",10,7,3
1000000US060971505002030,060971505002030,"Block 2030, Block Group 2, Census Tract 1505, Sonoma County, California",6,5,1
1000000US060971505002031,060971505002031,"Block 2031, Block Group 2, Census Tract 1505, Sonoma County, California",0,0,0
1000000US060971505002032,060971505002032,"Block 2032, Block Group 2, Census Tract 1505, Sonoma County, California",8,7,1
1000000US060971505002033,060971505002033,"Block 2033, Block Group 2, Census Tract 1505, Sonoma County, California",4,4,0
1000000US060971505002034,060971505002034,"Block 2034, Block Group 2, Census Tract 1505, Sonoma County, California",0,0,0
1000000US060971505002035,060971505002035,"Block 2035, Block Group 2, Census Tract 1505, Sonoma County, California",0,0,0
1000000US060971505003000,060971505003000,"Block 3000, Block Group 3, Census Tract 1505, Sonoma County, California",34,20,14
1000000US060971505003001,060971505003001,"Block 3001, Block Group 3, Census Tract 1505, Sonoma County, California",15,13,2
1000000US060971505003002,060971505003002,"Block 3002, Block Group 3, Census Tract 1505, Sonoma County, California",2,1,1
1000000US060971505003003,060971505003003,"Block 3003, Block Group 3, Census Tract 1505, Sonoma County, California",0,0,0
1000000US060971505003004,060971505003004,"Block 3004, Block Group 3, Census Tract 1505, Sonoma County, California",154,109,45
1000000US060971505003005,060971505003005,"Block 3005, Block Group 3, Census Tract 1505, Sonoma County, California",4,3,1
1000000US060971505003006,060971505003006,"Block 3006, Block Group 3, Census Tract 1505, Sonoma County, California",12,11,1
1000000US060971505003007,060971505003007,"Block 3007, Block Group 3, Census Tract 1505, Sonoma County, California",5,4,1
1000000US060971505003008,060971505003008,"Block 3008, Block Group 3, Census Tract 1505, Sonoma County, California",3,2,1
1000000US060971505003009,060971505003009,"Block 3009, Block Group 3, Census Tract 1505, Sonoma County, California",2,1,1
1000000US060971505003010,060971505003010,"Block 3010, Block Group 3, Census Tract 1505, Sonoma County, California",0,0,0
1000000US060971505003011,060971505003011,"Block 3011, Block Group 3, Census Tract 1505, Sonoma County, California",0,0,0
1000000US060971505003012,060971505003012,"Block 3012, Block Group 3, Census Tract 1505, Sonoma County, California",22,17,5
1000000US060971505003013,060971505003013,"Block 3013, Block Group 3, Census Tract 1505, Sonoma County, California",0,0,0
1000000US060971505003014,060971505003014,"Block 3014, Block Group 3, Census Tract 1505, Sonoma County, California",3,2,1
1000000US060971505003015,060971505003015,"Block 3015, Block Group 3, Census Tract 1505, Sonoma County, California",5,5,0
1000000US060971505003016,060971505003016,"Block 3016, Block Group 3, Census Tract 1505, Sonoma County, California",0,0,0
1000000US060971505003017,060971505003017,"Block 3017, Block Group 3, Census Tract 1505, Sonoma County, California",4,4,0
1000000US060971505003018,060971505003018,"Block 3018, Block Group 3, Census Tract 1505, Sonoma County, California",64,46,18
1000000US060971505003019,060971505003019,"Block 3019, Block Group 3, Census Tract 1505, Sonoma County, California",2,2,0
1000000US060971505003020,060971505003020,"Block 3020, Block Group 3, Census Tract 1505, Sonoma County, California",65,48,17
1000000US060971505003021,060971505003021,"Block 3021, Block Group 3, Census Tract 1505, Sonoma County, California",0,0,0
1000000US060971505003022,060971505003022,"Block 3022, Block Group 3, Census Tract 1505, Sonoma County, California",19,17,2
1000000US060971505003023,060971505003023,"Block 3023, Block Group 3, Census Tract 1505, Sonoma County, California",33,27,6
1000000US060971505003024,060971505003024,"Block 3024, Block Group 3, Census Tract 1505, Sonoma County, California",3,2,1
1000000US060971505003025,060971505003025,"Block 3025, Block Group 3, Census Tract 1505, Sonoma County, California",0,0,0
1000000US060971505003026,060971505003026,"Block 3026, Block Group 3, Census Tract 1505, Sonoma County, California",2,1,1
1000000US060971505003027,060971505003027,"Block 3027, Block Group 3, Census Tract 1505, Sonoma County, California",11,11,0
1000000US060971505003028,060971505003028,"Block 3028, Block Group 3, Census Tract 1505, Sonoma County, California",0,0,0
1000000US060971505003029,060971505003029,"Block 3029, Block Group 3, Census Tract 1505, Sonoma County, California",100,93,7
1000000US060971505003030,060971505003030,"Block 3030, Block Group 3, Census Tract 1505, Sonoma County, California",2,2,0
1000000US060971505003031,060971505003031,"Block 3031, Block Group 3, Census Tract 1505, Sonoma County, California",0,0,0
1000000US060971505003032,060971505003032,"Block 3032, Block Group 3, Census Tract 1505, Sonoma County, California",23,16,7
1000000US060971505003033,060971505003033,"Block 3033, Block Group 3, Census Tract 1505, Sonoma County, California",1,1,0
1000000US060971505003034,060971505003034,"Block 3034, Block Group 3, Census Tract 1505, Sonoma County, California",7,5,2
1000000US060971505003035,060971505003035,"Block 3035, Block Group 3, Census Tract 1505, Sonoma County, California",39,19,20
1000000US060971505003036,060971505003036,"Block 3036, Block Group 3, Census Tract 1505, Sonoma County, California",0,0,0
1000000US060971505003037,060971505003037,"Block 3037, Block Group 3, Census Tract 1505, Sonoma County, California",0,0,0
1000000US060971505003038,060971505003038,"Block 3038, Block Group 3, Census Tract 1505, Sonoma County, California",0,0,0
1000000US060971505003039,060971505003039,"Block 3039, Block Group 3, Census Tract 1505, Sonoma County, California",5,3,2
1000000US060971505003040,060971505003040,"Block 3040, Block Group 3, Census Tract 1505, Sonoma County, California",1,1,0
1000000US060971505003041,060971505003041,"Block 3041, Block Group 3, Census Tract 1505, Sonoma County, California",3,2,1
1000000US060971505003042,060971505003042,"Block 3042, Block Group 3, Census Tract 1505, Sonoma County, California",0,0,0
1000000US060971505003043,060971505003043,"Block 3043, Block Group 3, Census Tract 1505, Sonoma County, California",1,0,1
1000000US060971505003044,060971505003044,"Block 3044, Block Group 3, Census Tract 1505, Sonoma County, California",0,0,0
1000000US060971505003045,060971505003045,"Block 3045, Block Group 3, Census Tract 1505, Sonoma County, California",0,0,0
1000000US060971505003046,060971505003046,"Block 3046, Block Group 3, Census Tract 1505, Sonoma County, California",28,23,5
1000000US060971505003047,060971505003047,"Block 3047, Block Group 3, Census Tract 1505, Sonoma County, California",4,4,0
1000000US060971505003048,060971505003048,"Block 3048, Block Group 3, Census Tract 1505, Sonoma County, California",11,10,1
1000000US060971505003049,060971505003049,"Block 3049, Block Group 3, Census Tract 1505, Sonoma County, California",11,9,2
1000000US060971505003050,060971505003050,"Block 3050, Block Group 3, Census Tract 1505, Sonoma County, California",18,14,4
1000000US060971505003051,060971505003051,"Block 3051, Block Group 3, Census Tract 1505, Sonoma County, California",17,17,0
1000000US060971505003052,060971505003052,"Block 3052, Block Group 3, Census Tract 1505, Sonoma County, California",23,20,3
1000000US060971505003053,060971505003053,"Block 3053, Block Group 3, Census Tract 1505, Sonoma County, California",9,7,2
1000000US060971505003054,060971505003054,"Block 3054, Block Group 3, Census Tract 1505, Sonoma County, California",13,11,2
1000000US060971505003055,060971505003055,"Block 3055, Block Group 3, Census Tract 1505, Sonoma County, California",2,1,1
1000000US060971505003056,060971505003056,"Block 3056, Block Group 3, Census Tract 1505, Sonoma County, California",5,5,0
1000000US060971505003057,060971505003057,"Block 3057, Block Group 3, Census Tract 1505, Sonoma County, California",2,1,1
1000000US060971505004000,060971505004000,"Block 4000, Block Group 4, Census Tract 1505, Sonoma County, California",18,15,3
1000000US060971505004001,060971505004001,"Block 4001, Block Group 4, Census Tract 1505, Sonoma County, California",0,0,0
1000000US060971505004002,060971505004002,"Block 4002, Block Group 4, Census Tract 1505, Sonoma County, California",0,0,0
1000000US060971505004003,060971505004003,"Block 4003, Block Group 4, Census Tract 1505, Sonoma County, California",0,0,0
1000000US060971505004004,060971505004004,"Block 4004, Block Group 4, Census Tract 1505, Sonoma County, California",8,5,3
1000000US060971505004005,060971505004005,"Block 4005, Block Group 4, Census Tract 1505, Sonoma County, California",0,0,0
1000000US060971505004006,060971505004006,"Block 4006, Block Group 4, Census Tract 1505, Sonoma County, California",5,3,2
1000000US060971505004007,060971505004007,"Block 4007, Block Group 4, Census Tract 1505, Sonoma County, California",0,0,0
1000000US060971505004008,060971505004008,"Block 4008, Block Group 4, Census Tract 1505, Sonoma County, California",0,0,0
1000000US060971505004009,060971505004009,"Block 4009, Block Group 4, Census Tract 1505, Sonoma County, California",3,1,2
1000000US060971505004010,060971505004010,"Block 4010, Block Group 4, Census Tract 1505, Sonoma County, California",79,56,23
1000000US060971505004011,060971505004011,"Block 4011, Block Group 4, Census Tract 1505, Sonoma County, California",0,0,0
1000000US060971505004012,060971505004012,"Block 4012, Block Group 4, Census Tract 1505, Sonoma County, California",0,0,0
1000000US060971505004013,060971505004013,"Block 4013, Block Group 4, Census Tract 1505, Sonoma County, California",0,0,0
1000000US060971505004014,060971505004014,"Block 4014, Block Group 4, Census Tract 1505, Sonoma County, California",4,3,1
1000000US060971505004015,060971505004015,"Block 4015, Block Group 4, Census Tract 1505, Sonoma County, California",10,9,1
1000000US060971505004016,060971505004016,"Block 4016, Block Group 4, Census Tract 1505, Sonoma County, California",6,6,0
1000000US060971505004017,060971505004017,"Block 4017, Block Group 4, Census Tract 1505, Sonoma County, California",7,6,1
1000000US060971505004018,060971505004018,"Block 4018, Block Group 4, Census Tract 1505, Sonoma County, California",1,0,1
1000000US060971505004019,060971505004019,"Block 4019, Block Group 4, Census Tract 1505, Sonoma County, California",64,48,16
1000000US060971505004020,060971505004020,"Block 4020, Block Group 4, Census Tract 1505, Sonoma County, California",0,0,0
1000000US060971505004021,060971505004021,"Block 4021, Block Group 4, Census Tract 1505, Sonoma County, California",0,0,0
1000000US060971505004022,060971505004022,"Block 4022, Block Group 4, Census Tract 1505, Sonoma County, California",0,0,0
1000000US060971505004023,060971505004023,"Block 4023, Block Group 4, Census Tract 1505, Sonoma County, California",1,0,1
1000000US060971505004024,060971505004024,"Block 4024, Block Group 4, Census Tract 1505, Sonoma County, California",1,1,0
1000000US060971505004025,060971505004025,"Block 4025, Block Group 4, Census Tract 1505, Sonoma County, California",2,2,0
1000000US060971505004026,060971505004026,"Block 4026, Block Group 4, Census Tract 1505, Sonoma County, California",0,0,0
1000000US060971505004027,060971505004027,"Block 4027, Block Group 4, Census Tract 1505, Sonoma County, California",12,5,7
1000000US060971505004028,060971505004028,"Block 4028, Block Group 4, Census Tract 1505, Sonoma County, California",6,2,4
1000000US060971505004029,060971505004029,"Block 4029, Block Group 4, Census Tract 1505, Sonoma County, California",74,58,16
1000000US060971505004030,060971505004030,"Block 4030, Block Group 4, Census Tract 1505, Sonoma County, California",3,3,0
1000000US060971505004031,060971505004031,"Block 4031, Block Group 4, Census Tract 1505, Sonoma County, California",1,0,1
1000000US060971505004032,060971505004032,"Block 4032, Block Group 4, Census Tract 1505, Sonoma County, California",1,1,0
1000000US060971505004033,060971505004033,"Block 4033, Block Group 4, Census Tract 1505, Sonoma County, California",0,0,0
1000000US060971505004034,060971505004034,"Block 4034, Block Group 4, Census Tract 1505, Sonoma County, California",0,0,0
1000000US060971505004035,060971505004035,"Block 4035, Block Group 4, Census Tract 1505, Sonoma County, California",3,3,0
1000000US060971505004036,060971505004036,"Block 4036, Block Group 4, Census Tract 1505, Sonoma County, California",3,3,0
1000000US060971505004037,060971505004037,"Block 4037, Block Group 4, Census Tract 1505, Sonoma County, California",2,2,0
1000000US060971505004038,060971505004038,"Block 4038, Block Group 4, Census Tract 1505, Sonoma County, California",2,1,1
1000000US060971505004039,060971505004039,"Block 4039, Block Group 4, Census Tract 1505, Sonoma County, California",2,1,1
1000000US060971505004040,060971505004040,"Block 4040, Block Group 4, Census Tract 1505, Sonoma County, California",0,0,0
1000000US060971505004041,060971505004041,"Block 4041, Block Group 4, Census Tract 1505, Sonoma County, California",1,1,0
1000000US060971505004042,060971505004042,"Block 4042, Block Group 4, Census Tract 1505, Sonoma County, California",0,0,0
1000000US060971505004043,060971505004043,"Block 4043, Block Group 4, Census Tract 1505, Sonoma County, California",6,6,0
1000000US060971505004044,060971505004044,"Block 4044, Block Group 4, Census Tract 1505, Sonoma County, California",42,35,7
1000000US060971505004045,060971505004045,"Block 4045, Block Group 4, Census Tract 1505, Sonoma County, California",9,2,7
1000000US060971505004046,060971505004046,"Block 4046, Block Group 4, Census Tract 1505, Sonoma County, California",0,0,0
1000000US060971505005000,060971505005000,"Block 5000, Block Group 5, Census Tract 1505, Sonoma County, California",107,101,6
1000000US060971505005001,060971505005001,"Block 5001, Block Group 5, Census Tract 1505, Sonoma County, California",0,0,0
1000000US060971505005002,060971505005002,"Block 5002, Block Group 5, Census Tract 1505, Sonoma County, California",42,39,3
1000000US060971505005003,060971505005003,"Block 5003, Block Group 5, Census Tract 1505, Sonoma County, California",19,18,1
1000000US060971505005004,060971505005004,"Block 5004, Block Group 5, Census Tract 1505, Sonoma County, California",206,176,30
1000000US060971505005005,060971505005005,"Block 5005, Block Group 5, Census Tract 1505, Sonoma County, California",12,12,0
1000000US060971505005006,060971505005006,"Block 5006, Block Group 5, Census Tract 1505, Sonoma County, California",19,17,2
1000000US060971505006000,060971505006000,"Block 6000, Block Group 6, Census Tract 1505, Sonoma County, California",24,21,3
1000000US060971505006001,060971505006001,"Block 6001, Block Group 6, Census Tract 1505, Sonoma County, California",3,2,1
1000000US060971505006002,060971505006002,"Block 6002, Block Group 6, Census Tract 1505, Sonoma County, California",34,32,2
1000000US060971505006003,060971505006003,"Block 6003, Block Group 6, Census Tract 1505, Sonoma County, California",24,22,2
1000000US060971505006004,060971505006004,"Block 6004, Block Group 6, Census Tract 1505, Sonoma County, California",3,3,0
1000000US060971505006005,060971505006005,"Block 6005, Block Group 6, Census Tract 1505, Sonoma County, California",77,64,13
1000000US060971505006006,060971505006006,"Block 6006, Block Group 6, Census Tract 1505, Sonoma County, California",1,1,0
1000000US060971505006007,060971505006007,"Block 6007, Block Group 6, Census Tract 1505, Sonoma County, California",9,8,1
1000000US060971505006008,060971505006008,"Block 6008, Block Group 6, Census Tract 1505, Sonoma County, California",15,13,2
1000000US060971505006009,060971505006009,"Block 6009, Block Group 6, Census Tract 1505, Sonoma County, California",13,13,0
1000000US060971505006010,060971505006010,"Block 6010, Block Group 6, Census Tract 1505, Sonoma County, California",138,116,22
1000000US060971505006011,060971505006011,"Block 6011, Block Group 6, Census Tract 1505, Sonoma County, California",1,1,0
1000000US060971505006012,060971505006012,"Block 6012, Block Group 6, Census Tract 1505, Sonoma County, California",2,2,0
1000000US060971505006013,060971505006013,"Block 6013, Block Group 6, Census Tract 1505, Sonoma County, California",9,7,2
1000000US060971505006014,060971505006014,"Block 6014, Block Group 6, Census Tract 1505, Sonoma County, California",6,5,1
1000000US060971505006015,060971505006015,"Block 6015, Block Group 6, Census Tract 1505, Sonoma County, California",14,12,2
1000000US060971505006016,060971505006016,"Block 6016, Block Group 6, Census Tract 1505, Sonoma County, California",16,13,3
1000000US060971505006017,060971505006017,"Block 6017, Block Group 6, Census Tract 1505, Sonoma County, California",0,0,0
1000000US060971505006018,060971505006018,"Block 6018, Block Group 6, Census Tract 1505, Sonoma County, California",1,1,0
1000000US060971505006019,060971505006019,"Block 6019, Block Group 6, Census Tract 1505, Sonoma County, California",31,28,3
1000000US060971505006020,060971505006020,"Block 6020, Block Group 6, Census Tract 1505, Sonoma County, California",0,0,0
1000000US060971506011000,060971506011000,"Block 1000, Block Group 1, Census Tract 1506.01, Sonoma County, California",27,27,0
1000000US060971506011001,060971506011001,"Block 1001, Block Group 1, Census Tract 1506.01, Sonoma County, California",38,36,2
1000000US060971506011002,060971506011002,"Block 1002, Block Group 1, Census Tract 1506.01, Sonoma County, California",51,49,2
1000000US060971506011003,060971506011003,"Block 1003, Block Group 1, Census Tract 1506.01, Sonoma County, California",32,31,1
1000000US060971506011004,060971506011004,"Block 1004, Block Group 1, Census Tract 1506.01, Sonoma County, California",22,22,0
1000000US060971506011005,060971506011005,"Block 1005, Block Group 1, Census Tract 1506.01, Sonoma County, California",28,28,0
1000000US060971506011006,060971506011006,"Block 1006, Block Group 1, Census Tract 1506.01, Sonoma County, California",1,1,0
1000000US060971506011007,060971506011007,"Block 1007, Block Group 1, Census Tract 1506.01, Sonoma County, California",33,31,2
1000000US060971506011008,060971506011008,"Block 1008, Block Group 1, Census Tract 1506.01, Sonoma County, California",32,32,0
1000000US060971506011009,060971506011009,"Block 1009, Block Group 1, Census Tract 1506.01, Sonoma County, California",37,37,0
1000000US060971506011010,060971506011010,"Block 1010, Block Group 1, Census Tract 1506.01, Sonoma County, California",98,96,2
1000000US060971506011011,060971506011011,"Block 1011, Block Group 1, Census Tract 1506.01, Sonoma County, California",39,39,0
1000000US060971506012000,060971506012000,"Block 2000, Block Group 2, Census Tract 1506.01, Sonoma County, California",46,46,0
1000000US060971506012001,060971506012001,"Block 2001, Block Group 2, Census Tract 1506.01, Sonoma County, California",60,59,1
1000000US060971506012002,060971506012002,"Block 2002, Block Group 2, Census Tract 1506.01, Sonoma County, California",13,13,0
1000000US060971506012003,060971506012003,"Block 2003, Block Group 2, Census Tract 1506.01, Sonoma County, California",11,11,0
1000000US060971506012004,060971506012004,"Block 2004, Block Group 2, Census Tract 1506.01, Sonoma County, California",72,67,5
1000000US060971506012005,060971506012005,"Block 2005, Block Group 2, Census Tract 1506.01, Sonoma County, California",55,54,1
1000000US060971506012006,060971506012006,"Block 2006, Block Group 2, Census Tract 1506.01, Sonoma County, California",34,33,1
1000000US060971506013000,060971506013000,"Block 3000, Block Group 3, Census Tract 1506.01, Sonoma County, California",327,280,47
1000000US060971506013001,060971506013001,"Block 3001, Block Group 3, Census Tract 1506.01, Sonoma County, California",26,26,0
1000000US060971506013002,060971506013002,"Block 3002, Block Group 3, Census Tract 1506.01, Sonoma County, California",27,26,1
1000000US060971506013003,060971506013003,"Block 3003, Block Group 3, Census Tract 1506.01, Sonoma County, California",0,0,0
1000000US060971506013004,060971506013004,"Block 3004, Block Group 3, Census Tract 1506.01, Sonoma County, California",28,28,0
1000000US060971506013005,060971506013005,"Block 3005, Block Group 3, Census Tract 1506.01, Sonoma County, California",0,0,0
1000000US060971506014000,060971506014000,"Block 4000, Block Group 4, Census Tract 1506.01, Sonoma County, California",20,19,1
1000000US060971506014001,060971506014001,"Block 4001, Block Group 4, Census Tract 1506.01, Sonoma County, California",19,18,1
1000000US060971506014002,060971506014002,"Block 4002, Block Group 4, Census Tract 1506.01, Sonoma County, California",9,9,0
1000000US060971506014003,060971506014003,"Block 4003, Block Group 4, Census Tract 1506.01, Sonoma County, California",88,87,1
1000000US060971506014004,060971506014004,"Block 4004, Block Group 4, Census Tract 1506.01, Sonoma County, California",61,60,1
1000000US060971506014005,060971506014005,"Block 4005, Block Group 4, Census Tract 1506.01, Sonoma County, California",12,12,0
1000000US060971506014006,060971506014006,"Block 4006, Block Group 4, Census Tract 1506.01, Sonoma County, California",13,12,1
1000000US060971506014007,060971506014007,"Block 4007, Block Group 4, Census Tract 1506.01, Sonoma County, California",0,0,0
1000000US060971506014008,060971506014008,"Block 4008, Block Group 4, Census Tract 1506.01, Sonoma County, California",0,0,0
1000000US060971506014009,060971506014009,"Block 4009, Block Group 4, Census Tract 1506.01, Sonoma County, California",35,34,1
1000000US060971506014010,060971506014010,"Block 4010, Block Group 4, Census Tract 1506.01, Sonoma County, California",0,0,0
1000000US060971506014011,060971506014011,"Block 4011, Block Group 4, Census Tract 1506.01, Sonoma County, California",0,0,0
1000000US060971506014012,060971506014012,"Block 4012, Block Group 4, Census Tract 1506.01, Sonoma County, California",0,0,0
1000000US060971506014013,060971506014013,"Block 4013, Block Group 4, Census Tract 1506.01, Sonoma County, California",0,0,0
1000000US060971506014014,060971506014014,"Block 4014, Block Group 4, Census Tract 1506.01, Sonoma County, California",0,0,0
1000000US060971506021000,060971506021000,"Block 1000, Block Group 1, Census Tract 1506.02, Sonoma County, California",4,3,1
1000000US060971506021001,060971506021001,"Block 1001, Block Group 1, Census Tract 1506.02, Sonoma County, California",54,49,5
1000000US060971506021002,060971506021002,"Block 1002, Block Group 1, Census Tract 1506.02, Sonoma County, California",20,18,2
1000000US060971506021003,060971506021003,"Block 1003, Block Group 1, Census Tract 1506.02, Sonoma County, California",22,22,0
1000000US060971506021004,060971506021004,"Block 1004, Block Group 1, Census Tract 1506.02, Sonoma County, California",16,16,0
1000000US060971506021005,060971506021005,"Block 1005, Block Group 1, Census Tract 1506.02, Sonoma County, California",19,18,1
1000000US060971506021006,060971506021006,"Block 1006, Block Group 1, Census Tract 1506.02, Sonoma County, California",27,27,0
1000000US060971506021007,060971506021007,"Block 1007, Block Group 1, Census Tract 1506.02, Sonoma County, California",31,31,0
1000000US060971506021008,060971506021008,"Block 1008, Block Group 1, Census Tract 1506.02, Sonoma County, California",12,11,1
1000000US060971506021009,060971506021009,"Block 1009, Block Group 1, Census Tract 1506.02, Sonoma County, California",18,18,0
1000000US060971506021010,060971506021010,"Block 1010, Block Group 1, Census Tract 1506.02, Sonoma County, California",55,53,2
1000000US060971506021011,060971506021011,"Block 1011, Block Group 1, Census Tract 1506.02, Sonoma County, California",74,74,0
1000000US060971506021012,060971506021012,"Block 1012, Block Group 1, Census Tract 1506.02, Sonoma County, California",12,11,1
1000000US060971506021013,060971506021013,"Block 1013, Block Group 1, Census Tract 1506.02, Sonoma County, California",8,8,0
1000000US060971506021014,060971506021014,"Block 1014, Block Group 1, Census Tract 1506.02, Sonoma County, California",50,50,0
1000000US060971506021015,060971506021015,"Block 1015, Block Group 1, Census Tract 1506.02, Sonoma County, California",7,6,1
1000000US060971506022000,060971506022000,"Block 2000, Block Group 2, Census Tract 1506.02, Sonoma County, California",66,65,1
1000000US060971506022001,060971506022001,"Block 2001, Block Group 2, Census Tract 1506.02, Sonoma County, California",24,22,2
1000000US060971506022002,060971506022002,"Block 2002, Block Group 2, Census Tract 1506.02, Sonoma County, California",48,48,0
1000000US060971506022003,060971506022003,"Block 2003, Block Group 2, Census Tract 1506.02, Sonoma County, California",36,35,1
1000000US060971506022004,060971506022004,"Block 2004, Block Group 2, Census Tract 1506.02, Sonoma County, California",35,35,0
1000000US060971506022005,060971506022005,"Block 2005, Block Group 2, Census Tract 1506.02, Sonoma County, California",28,26,2
1000000US060971506022006,060971506022006,"Block 2006, Block Group 2, Census Tract 1506.02, Sonoma County, California",0,0,0
1000000US060971506023000,060971506023000,"Block 3000, Block Group 3, Census Tract 1506.02, Sonoma County, California",22,22,0
1000000US060971506023001,060971506023001,"Block 3001, Block Group 3, Census Tract 1506.02, Sonoma County, California",21,20,1
1000000US060971506023002,060971506023002,"Block 3002, Block Group 3, Census Tract 1506.02, Sonoma County, California",22,22,0
1000000US060971506023003,060971506023003,"Block 3003, Block Group 3, Census Tract 1506.02, Sonoma County, California",10,10,0
1000000US060971506023004,060971506023004,"Block 3004, Block Group 3, Census Tract 1506.02, Sonoma County, California",26,25,1
1000000US060971506023005,060971506023005,"Block 3005, Block Group 3, Census Tract 1506.02, Sonoma County, California",38,38,0
1000000US060971506023006,060971506023006,"Block 3006, Block Group 3, Census Tract 1506.02, Sonoma County, California",26,26,0
1000000US060971506023007,060971506023007,"Block 3007, Block Group 3, Census Tract 1506.02, Sonoma County, California",68,65,3
1000000US060971506023008,060971506023008,"Block 3008, Block Group 3, Census Tract 1506.02, Sonoma County, California",30,28,2
1000000US060971506023009,060971506023009,"Block 3009, Block Group 3, Census Tract 1506.02, Sonoma County, California",41,40,1
1000000US060971506023010,060971506023010,"Block 3010, Block Group 3, Census Tract 1506.02, Sonoma County, California",36,35,1
1000000US060971506023011,060971506023011,"Block 3011, Block Group 3, Census Tract 1506.02, Sonoma County, California",23,22,1
1000000US060971506023012,060971506023012,"Block 3012, Block Group 3, Census Tract 1506.02, Sonoma County, California",24,21,3
1000000US060971506023013,060971506023013,"Block 3013, Block Group 3, Census Tract 1506.02, Sonoma County, California",14,14,0
1000000US060971506023014,060971506023014,"Block 3014, Block Group 3, Census Tract 1506.02, Sonoma County, California",39,39,0
1000000US060971506023015,060971506023015,"Block 3015, Block Group 3, Census Tract 1506.02, Sonoma County, California",31,30,1
1000000US060971506024000,060971506024000,"Block 4000, Block Group 4, Census Tract 1506.02, Sonoma County, California",47,47,0
1000000US060971506024001,060971506024001,"Block 4001, Block Group 4, Census Tract 1506.02, Sonoma County, California",25,25,0
1000000US060971506024002,060971506024002,"Block 4002, Block Group 4, Census Tract 1506.02, Sonoma County, California",49,48,1
1000000US060971506024003,060971506024003,"Block 4003, Block Group 4, Census Tract 1506.02, Sonoma County, California",31,31,0
1000000US060971506024004,060971506024004,"Block 4004, Block Group 4, Census Tract 1506.02, Sonoma County, California",54,53,1
1000000US060971506024005,060971506024005,"Block 4005, Block Group 4, Census Tract 1506.02, Sonoma County, California",38,38,0
1000000US060971506024006,060971506024006,"Block 4006, Block Group 4, Census Tract 1506.02, Sonoma County, California",37,35,2
1000000US060971506024007,060971506024007,"Block 4007, Block Group 4, Census Tract 1506.02, Sonoma County, California",32,32,0
1000000US060971506024008,060971506024008,"Block 4008, Block Group 4, Census Tract 1506.02, Sonoma County, California",45,45,0
1000000US060971506024009,060971506024009,"Block 4009, Block Group 4, Census Tract 1506.02, Sonoma County, California",15,15,0
1000000US060971506024010,060971506024010,"Block 4010, Block Group 4, Census Tract 1506.02, Sonoma County, California",0,0,0
1000000US060971506024011,060971506024011,"Block 4011, Block Group 4, Census Tract 1506.02, Sonoma County, California",0,0,0
1000000US060971506024012,060971506024012,"Block 4012, Block Group 4, Census Tract 1506.02, Sonoma County, California",27,27,0
1000000US060971506024013,060971506024013,"Block 4013, Block Group 4, Census Tract 1506.02, Sonoma County, California",0,0,0
1000000US060971506024014,060971506024014,"Block 4014, Block Group 4, Census Tract 1506.02, Sonoma County, California",0,0,0
1000000US060971506024015,060971506024015,"Block 4015, Block Group 4, Census Tract 1506.02, Sonoma County, California",20,20,0
1000000US060971506031000,060971506031000,"Block 1000, Block Group 1, Census Tract 1506.03, Sonoma County, California",50,50,0
1000000US060971506031001,060971506031001,"Block 1001, Block Group 1, Census Tract 1506.03, Sonoma County, California",0,0,0
1000000US060971506031002,060971506031002,"Block 1002, Block Group 1, Census Tract 1506.03, Sonoma County, California",22,22,0
1000000US060971506031003,060971506031003,"Block 1003, Block Group 1, Census Tract 1506.03, Sonoma County, California",0,0,0
1000000US060971506031004,060971506031004,"Block 1004, Block Group 1, Census Tract 1506.03, Sonoma County, California",0,0,0
1000000US060971506031005,060971506031005,"Block 1005, Block Group 1, Census Tract 1506.03, Sonoma County, California",19,18,1
1000000US060971506031006,060971506031006,"Block 1006, Block Group 1, Census Tract 1506.03, Sonoma County, California",0,0,0
1000000US060971506031007,060971506031007,"Block 1007, Block Group 1, Census Tract 1506.03, Sonoma County, California",23,21,2
1000000US060971506031008,060971506031008,"Block 1008, Block Group 1, Census Tract 1506.03, Sonoma County, California",16,16,0
1000000US060971506031009,060971506031009,"Block 1009, Block Group 1, Census Tract 1506.03, Sonoma County, California",21,19,2
1000000US060971506031010,060971506031010,"Block 1010, Block Group 1, Census Tract 1506.03, Sonoma County, California",28,26,2
1000000US060971506031011,060971506031011,"Block 1011, Block Group 1, Census Tract 1506.03, Sonoma County, California",28,28,0
1000000US060971506031012,060971506031012,"Block 1012, Block Group 1, Census Tract 1506.03, Sonoma County, California",32,31,1
1000000US060971506031013,060971506031013,"Block 1013, Block Group 1, Census Tract 1506.03, Sonoma County, California",105,103,2
1000000US060971506031014,060971506031014,"Block 1014, Block Group 1, Census Tract 1506.03, Sonoma County, California",27,26,1
1000000US060971506031015,060971506031015,"Block 1015, Block Group 1, Census Tract 1506.03, Sonoma County, California",240,227,13
1000000US060971506031016,060971506031016,"Block 1016, Block Group 1, Census Tract 1506.03, Sonoma County, California",39,37,2
1000000US060971506031017,060971506031017,"Block 1017, Block Group 1, Census Tract 1506.03, Sonoma County, California",14,14,0
1000000US060971506031018,060971506031018,"Block 1018, Block Group 1, Census Tract 1506.03, Sonoma County, California",25,22,3
1000000US060971506031019,060971506031019,"Block 1019, Block Group 1, Census Tract 1506.03, Sonoma County, California",29,29,0
1000000US060971506031020,060971506031020,"Block 1020, Block Group 1, Census Tract 1506.03, Sonoma County, California",23,22,1
1000000US060971506031021,060971506031021,"Block 1021, Block Group 1, Census Tract 1506.03, Sonoma County, California",23,22,1
1000000US060971506031022,060971506031022,"Block 1022, Block Group 1, Census Tract 1506.03, Sonoma County, California",23,22,1
1000000US060971506031023,060971506031023,"Block 1023, Block Group 1, Census Tract 1506.03, Sonoma County, California",22,21,1
1000000US060971506031024,060971506031024,"Block 1024, Block Group 1, Census Tract 1506.03, Sonoma County, California",0,0,0
1000000US060971506031025,060971506031025,"Block 1025, Block Group 1, Census Tract 1506.03, Sonoma County, California",16,16,0
1000000US060971506032000,060971506032000,"Block 2000, Block Group 2, Census Tract 1506.03, Sonoma County, California",86,81,5
1000000US060971506032001,060971506032001,"Block 2001, Block Group 2, Census Tract 1506.03, Sonoma County, California",0,0,0
1000000US060971506032002,060971506032002,"Block 2002, Block Group 2, Census Tract 1506.03, Sonoma County, California",2,2,0
1000000US060971506032003,060971506032003,"Block 2003, Block Group 2, Census Tract 1506.03, Sonoma County, California",22,21,1
1000000US060971506032004,060971506032004,"Block 2004, Block Group 2, Census Tract 1506.03, Sonoma County, California",44,43,1
1000000US060971506032005,060971506032005,"Block 2005, Block Group 2, Census Tract 1506.03, Sonoma County, California",22,21,1
1000000US060971506032006,060971506032006,"Block 2006, Block Group 2, Census Tract 1506.03, Sonoma County, California",0,0,0
1000000US060971506032007,060971506032007,"Block 2007, Block Group 2, Census Tract 1506.03, Sonoma County, California",0,0,0
1000000US060971506032008,060971506032008,"Block 2008, Block Group 2, Census Tract 1506.03, Sonoma County, California",7,7,0
1000000US060971506032009,060971506032009,"Block 2009, Block Group 2, Census Tract 1506.03, Sonoma County, California",31,30,1
1000000US060971506032010,060971506032010,"Block 2010, Block Group 2, Census Tract 1506.03, Sonoma County, California",25,24,1
1000000US060971506032011,060971506032011,"Block 2011, Block Group 2, Census Tract 1506.03, Sonoma County, California",24,23,1
1000000US060971506033000,060971506033000,"Block 3000, Block Group 3, Census Tract 1506.03, Sonoma County, California",22,22,0
1000000US060971506033001,060971506033001,"Block 3001, Block Group 3, Census Tract 1506.03, Sonoma County, California",24,24,0
1000000US060971506033002,060971506033002,"Block 3002, Block Group 3, Census Tract 1506.03, Sonoma County, California",22,20,2
1000000US060971506033003,060971506033003,"Block 3003, Block Group 3, Census Tract 1506.03, Sonoma County, California",14,13,1
1000000US060971506033004,060971506033004,"Block 3004, Block Group 3, Census Tract 1506.03, Sonoma County, California",16,15,1
1000000US060971506033005,060971506033005,"Block 3005, Block Group 3, Census Tract 1506.03, Sonoma County, California",36,35,1
1000000US060971506033006,060971506033006,"Block 3006, Block Group 3, Census Tract 1506.03, Sonoma County, California",15,14,1
1000000US060971506033007,060971506033007,"Block 3007, Block Group 3, Census Tract 1506.03, Sonoma County, California",36,35,1
1000000US060971506033008,060971506033008,"Block 3008, Block Group 3, Census Tract 1506.03, Sonoma County, California",18,18,0
1000000US060971506033009,060971506033009,"Block 3009, Block Group 3, Census Tract 1506.03, Sonoma County, California",18,18,0
1000000US060971506033010,060971506033010,"Block 3010, Block Group 3, Census Tract 1506.03, Sonoma County, California",18,18,0
1000000US060971506034000,060971506034000,"Block 4000, Block Group 4, Census Tract 1506.03, Sonoma County, California",5,5,0
1000000US060971506034001,060971506034001,"Block 4001, Block Group 4, Census Tract 1506.03, Sonoma County, California",5,5,0
1000000US060971506034002,060971506034002,"Block 4002, Block Group 4, Census Tract 1506.03, Sonoma County, California",17,17,0
1000000US060971506034003,060971506034003,"Block 4003, Block Group 4, Census Tract 1506.03, Sonoma County, California",0,0,0
1000000US060971506034004,060971506034004,"Block 4004, Block Group 4, Census Tract 1506.03, Sonoma County, California",11,11,0
1000000US060971506034005,060971506034005,"Block 4005, Block Group 4, Census Tract 1506.03, Sonoma County, California",14,13,1
1000000US060971506034006,060971506034006,"Block 4006, Block Group 4, Census Tract 1506.03, Sonoma County, California",0,0,0
1000000US060971506034007,060971506034007,"Block 4007, Block Group 4, Census Tract 1506.03, Sonoma County, California",1,1,0
1000000US060971506034008,060971506034008,"Block 4008, Block Group 4, Census Tract 1506.03, Sonoma County, California",49,49,0
1000000US060971506034009,060971506034009,"Block 4009, Block Group 4, Census Tract 1506.03, Sonoma County, California",11,11,0
1000000US060971506034010,060971506034010,"Block 4010, Block Group 4, Census Tract 1506.03, Sonoma County, California",11,10,1
1000000US060971506034011,060971506034011,"Block 4011, Block Group 4, Census Tract 1506.03, Sonoma County, California",50,49,1
1000000US060971506034012,060971506034012,"Block 4012, Block Group 4, Census Tract 1506.03, Sonoma County, California",22,21,1
1000000US060971506034013,060971506034013,"Block 4013, Block Group 4, Census Tract 1506.03, Sonoma County, California",225,196,29
1000000US060971506034014,060971506034014,"Block 4014, Block Group 4, Census Tract 1506.03, Sonoma County, California",24,22,2
1000000US060971506034015,060971506034015,"Block 4015, Block Group 4, Census Tract 1506.03, Sonoma County, California",18,16,2
1000000US060971506034016,060971506034016,"Block 4016, Block Group 4, Census Tract 1506.03, Sonoma County, California",24,21,3
1000000US060971506034017,060971506034017,"Block 4017, Block Group 4, Census Tract 1506.03, Sonoma County, California",32,29,3
1000000US060971506034018,060971506034018,"Block 4018, Block Group 4, Census Tract 1506.03, Sonoma County, California",21,20,1
1000000US060971506034019,060971506034019,"Block 4019, Block Group 4, Census Tract 1506.03, Sonoma County, California",38,37,1
1000000US060971506034020,060971506034020,"Block 4020, Block Group 4, Census Tract 1506.03, Sonoma County, California",3,3,0
1000000US060971506034021,060971506034021,"Block 4021, Block Group 4, Census Tract 1506.03, Sonoma County, California",29,29,0
1000000US060971506034022,060971506034022,"Block 4022, Block Group 4, Census Tract 1506.03, Sonoma County, California",29,29,0
1000000US060971506034023,060971506034023,"Block 4023, Block Group 4, Census Tract 1506.03, Sonoma County, California",7,7,0
1000000US060971506035000,060971506035000,"Block 5000, Block Group 5, Census Tract 1506.03, Sonoma County, California",28,27,1
1000000US060971506035001,060971506035001,"Block 5001, Block Group 5, Census Tract 1506.03, Sonoma County, California",25,25,0
1000000US060971506035002,060971506035002,"Block 5002, Block Group 5, Census Tract 1506.03, Sonoma County, California",43,42,1
1000000US060971506035003,060971506035003,"Block 5003, Block Group 5, Census Tract 1506.03, Sonoma County, California",21,21,0
1000000US060971506035004,060971506035004,"Block 5004, Block Group 5, Census Tract 1506.03, Sonoma County, California",15,15,0
1000000US060971506035005,060971506035005,"Block 5005, Block Group 5, Census Tract 1506.03, Sonoma County, California",0,0,0
1000000US060971506035006,060971506035006,"Block 5006, Block Group 5, Census Tract 1506.03, Sonoma County, California",0,0,0
1000000US060971506035007,060971506035007,"Block 5007, Block Group 5, Census Tract 1506.03, Sonoma County, California",32,27,5
1000000US060971506035008,060971506035008,"Block 5008, Block Group 5, Census Tract 1506.03, Sonoma County, California",23,23,0
1000000US060971506035009,060971506035009,"Block 5009, Block Group 5, Census Tract 1506.03, Sonoma County, California",94,58,36
1000000US060971506035010,060971506035010,"Block 5010, Block Group 5, Census Tract 1506.03, Sonoma County, California",32,24,8
1000000US060971506035011,060971506035011,"Block 5011, Block Group 5, Census Tract 1506.03, Sonoma County, California",32,32,0
1000000US060971506035012,060971506035012,"Block 5012, Block Group 5, Census Tract 1506.03, Sonoma County, California",24,22,2
1000000US060971506035013,060971506035013,"Block 5013, Block Group 5, Census Tract 1506.03, Sonoma County, California",0,0,0
1000000US060971506035014,060971506035014,"Block 5014, Block Group 5, Census Tract 1506.03, Sonoma County, California",0,0,0
1000000US060971506035015,060971506035015,"Block 5015, Block Group 5, Census Tract 1506.03, Sonoma County, California",0,0,0
1000000US060971506035016,060971506035016,"Block 5016, Block Group 5, Census Tract 1506.03, Sonoma County, California",0,0,0
1000000US060971506035017,060971506035017,"Block 5017, Block Group 5, Census Tract 1506.03, Sonoma County, California",0,0,0
1000000US060971506035018,060971506035018,"Block 5018, Block Group 5, Census Tract 1506.03, Sonoma County, California",32,27,5
1000000US060971506035019,060971506035019,"Block 5019, Block Group 5, Census Tract 1506.03, Sonoma County, California",0,0,0
1000000US060971506036000,060971506036000,"Block 6000, Block Group 6, Census Tract 1506.03, Sonoma County, California",34,31,3
1000000US060971506036001,060971506036001,"Block 6001, Block Group 6, Census Tract 1506.03, Sonoma County, California",60,59,1
1000000US060971506036002,060971506036002,"Block 6002, Block Group 6, Census Tract 1506.03, Sonoma County, California",16,16,0
1000000US060971506036003,060971506036003,"Block 6003, Block Group 6, Census Tract 1506.03, Sonoma County, California",20,20,0
1000000US060971506036004,060971506036004,"Block 6004, Block Group 6, Census Tract 1506.03, Sonoma County, California",27,27,0
1000000US060971506036005,060971506036005,"Block 6005, Block Group 6, Census Tract 1506.03, Sonoma County, California",26,25,1
1000000US060971506036006,060971506036006,"Block 6006, Block Group 6, Census Tract 1506.03, Sonoma County, California",36,34,2
1000000US060971506036007,060971506036007,"Block 6007, Block Group 6, Census Tract 1506.03, Sonoma County, California",21,21,0
1000000US060971506036008,060971506036008,"Block 6008, Block Group 6, Census Tract 1506.03, Sonoma County, California",21,21,0
1000000US060971506036009,060971506036009,"Block 6009, Block Group 6, Census Tract 1506.03, Sonoma County, California",34,32,2
1000000US060971506036010,060971506036010,"Block 6010, Block Group 6, Census Tract 1506.03, Sonoma County, California",27,26,1
1000000US060971506036011,060971506036011,"Block 6011, Block Group 6, Census Tract 1506.03, Sonoma County, California",27,26,1
1000000US060971506036012,060971506036012,"Block 6012, Block Group 6, Census Tract 1506.03, Sonoma County, California",16,15,1
1000000US060971506071000,060971506071000,"Block 1000, Block Group 1, Census Tract 1506.07, Sonoma County, California",11,11,0
1000000US060971506071001,060971506071001,"Block 1001, Block Group 1, Census Tract 1506.07, Sonoma County, California",33,32,1
1000000US060971506071002,060971506071002,"Block 1002, Block Group 1, Census Tract 1506.07, Sonoma County, California",32,30,2
1000000US060971506071003,060971506071003,"Block 1003, Block Group 1, Census Tract 1506.07, Sonoma County, California",15,15,0
1000000US060971506071004,060971506071004,"Block 1004, Block Group 1, Census Tract 1506.07, Sonoma County, California",37,37,0
1000000US060971506071005,060971506071005,"Block 1005, Block Group 1, Census Tract 1506.07, Sonoma County, California",27,26,1
1000000US060971506071006,060971506071006,"Block 1006, Block Group 1, Census Tract 1506.07, Sonoma County, California",28,28,0
1000000US060971506071007,060971506071007,"Block 1007, Block Group 1, Census Tract 1506.07, Sonoma County, California",9,9,0
1000000US060971506071008,060971506071008,"Block 1008, Block Group 1, Census Tract 1506.07, Sonoma County, California",17,17,0
1000000US060971506071009,060971506071009,"Block 1009, Block Group 1, Census Tract 1506.07, Sonoma County, California",56,55,1
1000000US060971506071010,060971506071010,"Block 1010, Block Group 1, Census Tract 1506.07, Sonoma County, California",15,15,0
1000000US060971506071011,060971506071011,"Block 1011, Block Group 1, Census Tract 1506.07, Sonoma County, California",15,15,0
1000000US060971506071012,060971506071012,"Block 1012, Block Group 1, Census Tract 1506.07, Sonoma County, California",66,66,0
1000000US060971506071013,060971506071013,"Block 1013, Block Group 1, Census Tract 1506.07, Sonoma County, California",0,0,0
1000000US060971506072000,060971506072000,"Block 2000, Block Group 2, Census Tract 1506.07, Sonoma County, California",50,46,4
1000000US060971506072001,060971506072001,"Block 2001, Block Group 2, Census Tract 1506.07, Sonoma County, California",24,23,1
1000000US060971506072002,060971506072002,"Block 2002, Block Group 2, Census Tract 1506.07, Sonoma County, California",0,0,0
1000000US060971506072003,060971506072003,"Block 2003, Block Group 2, Census Tract 1506.07, Sonoma County, California",2,2,0
1000000US060971506072004,060971506072004,"Block 2004, Block Group 2, Census Tract 1506.07, Sonoma County, California",2,2,0
1000000US060971506072005,060971506072005,"Block 2005, Block Group 2, Census Tract 1506.07, Sonoma County, California",35,35,0
1000000US060971506072006,060971506072006,"Block 2006, Block Group 2, Census Tract 1506.07, Sonoma County, California",4,4,0
1000000US060971506072007,060971506072007,"Block 2007, Block Group 2, Census Tract 1506.07, Sonoma County, California",2,2,0
1000000US060971506072008,060971506072008,"Block 2008, Block Group 2, Census Tract 1506.07, Sonoma County, California",0,0,0
1000000US060971506072009,060971506072009,"Block 2009, Block Group 2, Census Tract 1506.07, Sonoma County, California",0,0,0
1000000US060971506072010,060971506072010,"Block 2010, Block Group 2, Census Tract 1506.07, Sonoma County, California",82,78,4
1000000US060971506072011,060971506072011,"Block 2011, Block Group 2, Census Tract 1506.07, Sonoma County, California",34,32,2
1000000US060971506072012,060971506072012,"Block 2012, Block Group 2, Census Tract 1506.07, Sonoma County, California",1,1,0
1000000US060971506072013,060971506072013,"Block 2013, Block Group 2, Census Tract 1506.07, Sonoma County, California",0,0,0
1000000US060971506072014,060971506072014,"Block 2014, Block Group 2, Census Tract 1506.07, Sonoma County, California",0,0,0
1000000US060971506072015,060971506072015,"Block 2015, Block Group 2, Census Tract 1506.07, Sonoma County, California",4,4,0
1000000US060971506072016,060971506072016,"Block 2016, Block Group 2, Census Tract 1506.07, Sonoma County, California",0,0,0
1000000US060971506072017,060971506072017,"Block 2017, Block Group 2, Census Tract 1506.07, Sonoma County, California",0,0,0
1000000US060971506072018,060971506072018,"Block 2018, Block Group 2, Census Tract 1506.07, Sonoma County, California",0,0,0
1000000US060971506072019,060971506072019,"Block 2019, Block Group 2, Census Tract 1506.07, Sonoma County, California",4,4,0
1000000US060971506072020,060971506072020,"Block 2020, Block Group 2, Census Tract 1506.07, Sonoma County, California",0,0,0
1000000US060971506072021,060971506072021,"Block 2021, Block Group 2, Census Tract 1506.07, Sonoma County, California",0,0,0
1000000US060971506072022,060971506072022,"Block 2022, Block Group 2, Census Tract 1506.07, Sonoma County, California",0,0,0
1000000US060971506072023,060971506072023,"Block 2023, Block Group 2, Census Tract 1506.07, Sonoma County, California",0,0,0
1000000US060971506072024,060971506072024,"Block 2024, Block Group 2, Census Tract 1506.07, Sonoma County, California",0,0,0
1000000US060971506072025,060971506072025,"Block 2025, Block Group 2, Census Tract 1506.07, Sonoma County, California",0,0,0
1000000US060971506072026,060971506072026,"Block 2026, Block Group 2, Census Tract 1506.07, Sonoma County, California",0,0,0
1000000US060971506072027,060971506072027,"Block 2027, Block Group 2, Census Tract 1506.07, Sonoma County, California",0,0,0
1000000US060971506072028,060971506072028,"Block 2028, Block Group 2, Census Tract 1506.07, Sonoma County, California",0,0,0
1000000US060971506072029,060971506072029,"Block 2029, Block Group 2, Census Tract 1506.07, Sonoma County, California",0,0,0
1000000US060971506072030,060971506072030,"Block 2030, Block Group 2, Census Tract 1506.07, Sonoma County, California",0,0,0
1000000US060971506072031,060971506072031,"Block 2031, Block Group 2, Census Tract 1506.07, Sonoma County, California",0,0,0
1000000US060971506072032,060971506072032,"Block 2032, Block Group 2, Census Tract 1506.07, Sonoma County, California",0,0,0
1000000US060971506072033,060971506072033,"Block 2033, Block Group 2, Census Tract 1506.07, Sonoma County, California",0,0,0
1000000US060971506073000,060971506073000,"Block 3000, Block Group 3, Census Tract 1506.07, Sonoma County, California",67,58,9
1000000US060971506073001,060971506073001,"Block 3001, Block Group 3, Census Tract 1506.07, Sonoma County, California",44,43,1
1000000US060971506073002,060971506073002,"Block 3002, Block Group 3, Census Tract 1506.07, Sonoma County, California",16,15,1
1000000US060971506073003,060971506073003,"Block 3003, Block Group 3, Census Tract 1506.07, Sonoma County, California",37,37,0
1000000US060971506073004,060971506073004,"Block 3004, Block Group 3, Census Tract 1506.07, Sonoma County, California",12,12,0
1000000US060971506073005,060971506073005,"Block 3005, Block Group 3, Census Tract 1506.07, Sonoma County, California",12,12,0
1000000US060971506073006,060971506073006,"Block 3006, Block Group 3, Census Tract 1506.07, Sonoma County, California",0,0,0
1000000US060971506073007,060971506073007,"Block 3007, Block Group 3, Census Tract 1506.07, Sonoma County, California",5,4,1
1000000US060971506073008,060971506073008,"Block 3008, Block Group 3, Census Tract 1506.07, Sonoma County, California",0,0,0
1000000US060971506073009,060971506073009,"Block 3009, Block Group 3, Census Tract 1506.07, Sonoma County, California",0,0,0
1000000US060971506073010,060971506073010,"Block 3010, Block Group 3, Census Tract 1506.07, Sonoma County, California",0,0,0
1000000US060971506073011,060971506073011,"Block 3011, Block Group 3, Census Tract 1506.07, Sonoma County, California",100,96,4
1000000US060971506073012,060971506073012,"Block 3012, Block Group 3, Census Tract 1506.07, Sonoma County, California",13,12,1
1000000US060971506073013,060971506073013,"Block 3013, Block Group 3, Census Tract 1506.07, Sonoma County, California",15,15,0
1000000US060971506073014,060971506073014,"Block 3014, Block Group 3, Census Tract 1506.07, Sonoma County, California",5,5,0
1000000US060971506073015,060971506073015,"Block 3015, Block Group 3, Census Tract 1506.07, Sonoma County, California",110,106,4
1000000US060971506073016,060971506073016,"Block 3016, Block Group 3, Census Tract 1506.07, Sonoma County, California",13,13,0
1000000US060971506073017,060971506073017,"Block 3017, Block Group 3, Census Tract 1506.07, Sonoma County, California",31,30,1
1000000US060971506073018,060971506073018,"Block 3018, Block Group 3, Census Tract 1506.07, Sonoma County, California",96,94,2
1000000US060971506073019,060971506073019,"Block 3019, Block Group 3, Census Tract 1506.07, Sonoma County, California",8,8,0
1000000US060971506073020,060971506073020,"Block 3020, Block Group 3, Census Tract 1506.07, Sonoma County, California",0,0,0
1000000US060971506073021,060971506073021,"Block 3021, Block Group 3, Census Tract 1506.07, Sonoma County, California",9,9,0
1000000US060971506073022,060971506073022,"Block 3022, Block Group 3, Census Tract 1506.07, Sonoma County, California",24,24,0
1000000US060971506073023,060971506073023,"Block 3023, Block Group 3, Census Tract 1506.07, Sonoma County, California",30,29,1
1000000US060971506073024,060971506073024,"Block 3024, Block Group 3, Census Tract 1506.07, Sonoma County, California",10,10,0
1000000US060971506073025,060971506073025,"Block 3025, Block Group 3, Census Tract 1506.07, Sonoma County, California",0,0,0
1000000US060971506073026,060971506073026,"Block 3026, Block Group 3, Census Tract 1506.07, Sonoma County, California",79,79,0
1000000US060971506073027,060971506073027,"Block 3027, Block Group 3, Census Tract 1506.07, Sonoma County, California",87,84,3
1000000US060971506073028,060971506073028,"Block 3028, Block Group 3, Census Tract 1506.07, Sonoma County, California",0,0,0
1000000US060971506073029,060971506073029,"Block 3029, Block Group 3, Census Tract 1506.07, Sonoma County, California",4,4,0
1000000US060971506073030,060971506073030,"Block 3030, Block Group 3, Census Tract 1506.07, Sonoma County, California",0,0,0
1000000US060971506073031,060971506073031,"Block 3031, Block Group 3, Census Tract 1506.07, Sonoma County, California",0,0,0
1000000US060971506073032,060971506073032,"Block 3032, Block Group 3, Census Tract 1506.07, Sonoma County, California",0,0,0
1000000US060971506073033,060971506073033,"Block 3033, Block Group 3, Census Tract 1506.07, Sonoma County, California",0,0,0
1000000US060971506073034,060971506073034,"Block 3034, Block Group 3, Census Tract 1506.07, Sonoma County, California",0,0,0
1000000US060971506073035,060971506073035,"Block 3035, Block Group 3, Census Tract 1506.07, Sonoma County, California",0,0,0
1000000US060971506073036,060971506073036,"Block 3036, Block Group 3, Census Tract 1506.07, Sonoma County, California",30,27,3
1000000US060971506073037,060971506073037,"Block 3037, Block Group 3, Census Tract 1506.07, Sonoma County, California",0,0,0
1000000US060971506073038,060971506073038,"Block 3038, Block Group 3, Census Tract 1506.07, Sonoma County, California",0,0,0
1000000US060971506073039,060971506073039,"Block 3039, Block Group 3, Census Tract 1506.07, Sonoma County, California",13,13,0
1000000US060971506073040,060971506073040,"Block 3040, Block Group 3, Census Tract 1506.07, Sonoma County, California",0,0,0
1000000US060971506073041,060971506073041,"Block 3041, Block Group 3, Census Tract 1506.07, Sonoma County, California",31,31,0
1000000US060971506073042,060971506073042,"Block 3042, Block Group 3, Census Tract 1506.07, Sonoma County, California",4,4,0
1000000US060971506073043,060971506073043,"Block 3043, Block Group 3, Census Tract 1506.07, Sonoma County, California",6,6,0
1000000US060971506073044,060971506073044,"Block 3044, Block Group 3, Census Tract 1506.07, Sonoma County, California",71,68,3
1000000US060971506073045,060971506073045,"Block 3045, Block Group 3, Census Tract 1506.07, Sonoma County, California",16,13,3
1000000US060971506073046,060971506073046,"Block 3046, Block Group 3, Census Tract 1506.07, Sonoma County, California",23,19,4
1000000US060971506073047,060971506073047,"Block 3047, Block Group 3, Census Tract 1506.07, Sonoma County, California",42,35,7
1000000US060971506073048,060971506073048,"Block 3048, Block Group 3, Census Tract 1506.07, Sonoma County, California",13,13,0
1000000US060971506073049,060971506073049,"Block 3049, Block Group 3, Census Tract 1506.07, Sonoma County, California",21,20,1
1000000US060971506073050,060971506073050,"Block 3050, Block Group 3, Census Tract 1506.07, Sonoma County, California",22,21,1
1000000US060971506073051,060971506073051,"Block 3051, Block Group 3, Census Tract 1506.07, Sonoma County, California",0,0,0
1000000US060971506073052,060971506073052,"Block 3052, Block Group 3, Census Tract 1506.07, Sonoma County, California",14,14,0
1000000US060971506073053,060971506073053,"Block 3053, Block Group 3, Census Tract 1506.07, Sonoma County, California",8,8,0
1000000US060971506073054,060971506073054,"Block 3054, Block Group 3, Census Tract 1506.07, Sonoma County, California",0,0,0
1000000US060971506073055,060971506073055,"Block 3055, Block Group 3, Census Tract 1506.07, Sonoma County, California",14,14,0
1000000US060971506073056,060971506073056,"Block 3056, Block Group 3, Census Tract 1506.07, Sonoma County, California",21,17,4
1000000US060971506073057,060971506073057,"Block 3057, Block Group 3, Census Tract 1506.07, Sonoma County, California",17,17,0
1000000US060971506073058,060971506073058,"Block 3058, Block Group 3, Census Tract 1506.07, Sonoma County, California",19,17,2
1000000US060971506073059,060971506073059,"Block 3059, Block Group 3, Census Tract 1506.07, Sonoma County, California",13,13,0
1000000US060971506073060,060971506073060,"Block 3060, Block Group 3, Census Tract 1506.07, Sonoma County, California",0,0,0
1000000US060971506073061,060971506073061,"Block 3061, Block Group 3, Census Tract 1506.07, Sonoma County, California",0,0,0
1000000US060971506073062,060971506073062,"Block 3062, Block Group 3, Census Tract 1506.07, Sonoma County, California",1,1,0
1000000US060971506073063,060971506073063,"Block 3063, Block Group 3, Census Tract 1506.07, Sonoma County, California",24,24,0
1000000US060971506073064,060971506073064,"Block 3064, Block Group 3, Census Tract 1506.07, Sonoma County, California",20,19,1
1000000US060971506073065,060971506073065,"Block 3065, Block Group 3, Census Tract 1506.07, Sonoma County, California",0,0,0
1000000US060971506091000,060971506091000,"Block 1000, Block Group 1, Census Tract 1506.09, Sonoma County, California",89,88,1
1000000US060971506091001,060971506091001,"Block 1001, Block Group 1, Census Tract 1506.09, Sonoma County, California",25,25,0
1000000US060971506091002,060971506091002,"Block 1002, Block Group 1, Census Tract 1506.09, Sonoma County, California",0,0,0
1000000US060971506091003,060971506091003,"Block 1003, Block Group 1, Census Tract 1506.09, Sonoma County, California",24,22,2
1000000US060971506091004,060971506091004,"Block 1004, Block Group 1, Census Tract 1506.09, Sonoma County, California",0,0,0
1000000US060971506091005,060971506091005,"Block 1005, Block Group 1, Census Tract 1506.09, Sonoma County, California",28,27,1
1000000US060971506091006,060971506091006,"Block 1006, Block Group 1, Census Tract 1506.09, Sonoma County, California",91,90,1
1000000US060971506091007,060971506091007,"Block 1007, Block Group 1, Census Tract 1506.09, Sonoma County, California",95,94,1
1000000US060971506091008,060971506091008,"Block 1008, Block Group 1, Census Tract 1506.09, Sonoma County, California",18,15,3
1000000US060971506091009,060971506091009,"Block 1009, Block Group 1, Census Tract 1506.09, Sonoma County, California",19,18,1
1000000US060971506091010,060971506091010,"Block 1010, Block Group 1, Census Tract 1506.09, Sonoma County, California",38,37,1
1000000US060971506091011,060971506091011,"Block 1011, Block Group 1, Census Tract 1506.09, Sonoma County, California",0,0,0
1000000US060971506091012,060971506091012,"Block 1012, Block Group 1, Census Tract 1506.09, Sonoma County, California",75,74,1
1000000US060971506091013,060971506091013,"Block 1013, Block Group 1, Census Tract 1506.09, Sonoma County, California",79,74,5
1000000US060971506091014,060971506091014,"Block 1014, Block Group 1, Census Tract 1506.09, Sonoma County, California",6,6,0
1000000US060971506091015,060971506091015,"Block 1015, Block Group 1, Census Tract 1506.09, Sonoma County, California",53,51,2
1000000US060971506091016,060971506091016,"Block 1016, Block Group 1, Census Tract 1506.09, Sonoma County, California",0,0,0
1000000US060971506092000,060971506092000,"Block 2000, Block Group 2, Census Tract 1506.09, Sonoma County, California",4,4,0
1000000US060971506092001,060971506092001,"Block 2001, Block Group 2, Census Tract 1506.09, Sonoma County, California",0,0,0
1000000US060971506092002,060971506092002,"Block 2002, Block Group 2, Census Tract 1506.09, Sonoma County, California",0,0,0
1000000US060971506092003,060971506092003,"Block 2003, Block Group 2, Census Tract 1506.09, Sonoma County, California",90,86,4
1000000US060971506092004,060971506092004,"Block 2004, Block Group 2, Census Tract 1506.09, Sonoma County, California",31,31,0
1000000US060971506092005,060971506092005,"Block 2005, Block Group 2, Census Tract 1506.09, Sonoma County, California",0,0,0
1000000US060971506092006,060971506092006,"Block 2006, Block Group 2, Census Tract 1506.09, Sonoma County, California",0,0,0
1000000US060971506092007,060971506092007,"Block 2007, Block Group 2, Census Tract 1506.09, Sonoma County, California",2,1,1
1000000US060971506092008,060971506092008,"Block 2008, Block Group 2, Census Tract 1506.09, Sonoma County, California",3,3,0
1000000US060971506092009,060971506092009,"Block 2009, Block Group 2, Census Tract 1506.09, Sonoma County, California",34,32,2
1000000US060971506092010,060971506092010,"Block 2010, Block Group 2, Census Tract 1506.09, Sonoma County, California",0,0,0
1000000US060971506092011,060971506092011,"Block 2011, Block Group 2, Census Tract 1506.09, Sonoma County, California",50,46,4
1000000US060971506092012,060971506092012,"Block 2012, Block Group 2, Census Tract 1506.09, Sonoma County, California",18,17,1
1000000US060971506092013,060971506092013,"Block 2013, Block Group 2, Census Tract 1506.09, Sonoma County, California",31,29,2
1000000US060971506092014,060971506092014,"Block 2014, Block Group 2, Census Tract 1506.09, Sonoma County, California",34,33,1
1000000US060971506092015,060971506092015,"Block 2015, Block Group 2, Census Tract 1506.09, Sonoma County, California",15,14,1
1000000US060971506092016,060971506092016,"Block 2016, Block Group 2, Census Tract 1506.09, Sonoma County, California",9,9,0
1000000US060971506092017,060971506092017,"Block 2017, Block Group 2, Census Tract 1506.09, Sonoma County, California",1,1,0
1000000US060971506092018,060971506092018,"Block 2018, Block Group 2, Census Tract 1506.09, Sonoma County, California",0,0,0
1000000US060971506092019,060971506092019,"Block 2019, Block Group 2, Census Tract 1506.09, Sonoma County, California",0,0,0
1000000US060971506092020,060971506092020,"Block 2020, Block Group 2, Census Tract 1506.09, Sonoma County, California",145,145,0
1000000US060971506092021,060971506092021,"Block 2021, Block Group 2, Census Tract 1506.09, Sonoma County, California",13,12,1
1000000US060971506092022,060971506092022,"Block 2022, Block Group 2, Census Tract 1506.09, Sonoma County, California",0,0,0
1000000US060971506092023,060971506092023,"Block 2023, Block Group 2, Census Tract 1506.09, Sonoma County, California",16,16,0
1000000US060971506092024,060971506092024,"Block 2024, Block Group 2, Census Tract 1506.09, Sonoma County, California",24,24,0
1000000US060971506092025,060971506092025,"Block 2025, Block Group 2, Census Tract 1506.09, Sonoma County, California",0,0,0
1000000US060971506092026,060971506092026,"Block 2026, Block Group 2, Census Tract 1506.09, Sonoma County, California",0,0,0
1000000US060971506092027,060971506092027,"Block 2027, Block Group 2, Census Tract 1506.09, Sonoma County, California",0,0,0
1000000US060971506092028,060971506092028,"Block 2028, Block Group 2, Census Tract 1506.09, Sonoma County, California",0,0,0
1000000US060971506092029,060971506092029,"Block 2029, Block Group 2, Census Tract 1506.09, Sonoma County, California",0,0,0
1000000US060971506092030,060971506092030,"Block 2030, Block Group 2, Census Tract 1506.09, Sonoma County, California",0,0,0
1000000US060971506092031,060971506092031,"Block 2031, Block Group 2, Census Tract 1506.09, Sonoma County, California",0,0,0
1000000US060971506092032,060971506092032,"Block 2032, Block Group 2, Census Tract 1506.09, Sonoma County, California",0,0,0
1000000US060971506092033,060971506092033,"Block 2033, Block Group 2, Census Tract 1506.09, Sonoma County, California",0,0,0
1000000US060971506092034,060971506092034,"Block 2034, Block Group 2, Census Tract 1506.09, Sonoma County, California",1,0,1
1000000US060971506093000,060971506093000,"Block 3000, Block Group 3, Census Tract 1506.09, Sonoma County, California",243,235,8
1000000US060971506093001,060971506093001,"Block 3001, Block Group 3, Census Tract 1506.09, Sonoma County, California",21,20,1
1000000US060971506093002,060971506093002,"Block 3002, Block Group 3, Census Tract 1506.09, Sonoma County, California",27,26,1
1000000US060971506093003,060971506093003,"Block 3003, Block Group 3, Census Tract 1506.09, Sonoma County, California",20,19,1
1000000US060971506093004,060971506093004,"Block 3004, Block Group 3, Census Tract 1506.09, Sonoma County, California",6,6,0
1000000US060971506093005,060971506093005,"Block 3005, Block Group 3, Census Tract 1506.09, Sonoma County, California",8,7,1
1000000US060971506093006,060971506093006,"Block 3006, Block Group 3, Census Tract 1506.09, Sonoma County, California",97,93,4
1000000US060971506093007,060971506093007,"Block 3007, Block Group 3, Census Tract 1506.09, Sonoma County, California",0,0,0
1000000US060971506094000,060971506094000,"Block 4000, Block Group 4, Census Tract 1506.09, Sonoma County, California",34,34,0
1000000US060971506094001,060971506094001,"Block 4001, Block Group 4, Census Tract 1506.09, Sonoma County, California",57,55,2
1000000US060971506094002,060971506094002,"Block 4002, Block Group 4, Census Tract 1506.09, Sonoma County, California",48,44,4
1000000US060971506094003,060971506094003,"Block 4003, Block Group 4, Census Tract 1506.09, Sonoma County, California",0,0,0
1000000US060971506094004,060971506094004,"Block 4004, Block Group 4, Census Tract 1506.09, Sonoma County, California",34,34,0
1000000US060971506094005,060971506094005,"Block 4005, Block Group 4, Census Tract 1506.09, Sonoma County, California",2,2,0
1000000US060971506094006,060971506094006,"Block 4006, Block Group 4, Census Tract 1506.09, Sonoma County, California",19,19,0
1000000US060971506094007,060971506094007,"Block 4007, Block Group 4, Census Tract 1506.09, Sonoma County, California",54,51,3
1000000US060971506094008,060971506094008,"Block 4008, Block Group 4, Census Tract 1506.09, Sonoma County, California",0,0,0
1000000US060971506094009,060971506094009,"Block 4009, Block Group 4, Census Tract 1506.09, Sonoma County, California",73,71,2
1000000US060971506094010,060971506094010,"Block 4010, Block Group 4, Census Tract 1506.09, Sonoma County, California",28,26,2
1000000US060971506094011,060971506094011,"Block 4011, Block Group 4, Census Tract 1506.09, Sonoma County, California",10,9,1
1000000US060971506094012,060971506094012,"Block 4012, Block Group 4, Census Tract 1506.09, Sonoma County, California",0,0,0
1000000US060971506101000,060971506101000,"Block 1000, Block Group 1, Census Tract 1506.10, Sonoma County, California",18,17,1
1000000US060971506101001,060971506101001,"Block 1001, Block Group 1, Census Tract 1506.10, Sonoma County, California",0,0,0
1000000US060971506101002,060971506101002,"Block 1002, Block Group 1, Census Tract 1506.10, Sonoma County, California",50,48,2
1000000US060971506101003,060971506101003,"Block 1003, Block Group 1, Census Tract 1506.10, Sonoma County, California",68,67,1
1000000US060971506101004,060971506101004,"Block 1004, Block Group 1, Census Tract 1506.10, Sonoma County, California",27,27,0
1000000US060971506101005,060971506101005,"Block 1005, Block Group 1, Census Tract 1506.10, Sonoma County, California",50,48,2
1000000US060971506101006,060971506101006,"Block 1006, Block Group 1, Census Tract 1506.10, Sonoma County, California",0,0,0
1000000US060971506101007,060971506101007,"Block 1007, Block Group 1, Census Tract 1506.10, Sonoma County, California",82,79,3
1000000US060971506101008,060971506101008,"Block 1008, Block Group 1, Census Tract 1506.10, Sonoma County, California",28,27,1
1000000US060971506101009,060971506101009,"Block 1009, Block Group 1, Census Tract 1506.10, Sonoma County, California",38,37,1
1000000US060971506101010,060971506101010,"Block 1010, Block Group 1, Census Tract 1506.10, Sonoma County, California",50,50,0
1000000US060971506102000,060971506102000,"Block 2000, Block Group 2, Census Tract 1506.10, Sonoma County, California",1,1,0
1000000US060971506102001,060971506102001,"Block 2001, Block Group 2, Census Tract 1506.10, Sonoma County, California",36,35,1
1000000US060971506102002,060971506102002,"Block 2002, Block Group 2, Census Tract 1506.10, Sonoma County, California",16,16,0
1000000US060971506102003,060971506102003,"Block 2003, Block Group 2, Census Tract 1506.10, Sonoma County, California",13,11,2
1000000US060971506102004,060971506102004,"Block 2004, Block Group 2, Census Tract 1506.10, Sonoma County, California",29,29,0
1000000US060971506102005,060971506102005,"Block 2005, Block Group 2, Census Tract 1506.10, Sonoma County, California",35,35,0
1000000US060971506102006,060971506102006,"Block 2006, Block Group 2, Census Tract 1506.10, Sonoma County, California",25,25,0
1000000US060971506102007,060971506102007,"Block 2007, Block Group 2, Census Tract 1506.10, Sonoma County, California",4,3,1
1000000US060971506102008,060971506102008,"Block 2008, Block Group 2, Census Tract 1506.10, Sonoma County, California",26,26,0
1000000US060971506102009,060971506102009,"Block 2009, Block Group 2, Census Tract 1506.10, Sonoma County, California",36,35,1
1000000US060971506102010,060971506102010,"Block 2010, Block Group 2, Census Tract 1506.10, Sonoma County, California",128,126,2
1000000US060971506102011,060971506102011,"Block 2011, Block Group 2, Census Tract 1506.10, Sonoma County, California",0,0,0
1000000US060971506102012,060971506102012,"Block 2012, Block Group 2, Census Tract 1506.10, Sonoma County, California",59,58,1
1000000US060971506102013,060971506102013,"Block 2013, Block Group 2, Census Tract 1506.10, Sonoma County, California",35,35,0
1000000US060971506102014,060971506102014,"Block 2014, Block Group 2, Census Tract 1506.10, Sonoma County, California",14,14,0
1000000US060971506102015,060971506102015,"Block 2015, Block Group 2, Census Tract 1506.10, Sonoma County, California",58,56,2
1000000US060971506102016,060971506102016,"Block 2016, Block Group 2, Census Tract 1506.10, Sonoma County, California",0,0,0
1000000US060971506102017,060971506102017,"Block 2017, Block Group 2, Census Tract 1506.10, Sonoma County, California",0,0,0
1000000US060971506102018,060971506102018,"Block 2018, Block Group 2, Census Tract 1506.10, Sonoma County, California",43,42,1
1000000US060971506102019,060971506102019,"Block 2019, Block Group 2, Census Tract 1506.10, Sonoma County, California",0,0,0
1000000US060971506102020,060971506102020,"Block 2020, Block Group 2, Census Tract 1506.10, Sonoma County, California",0,0,0
1000000US060971506102021,060971506102021,"Block 2021, Block Group 2, Census Tract 1506.10, Sonoma County, California",60,59,1
1000000US060971506102022,060971506102022,"Block 2022, Block Group 2, Census Tract 1506.10, Sonoma County, California",13,13,0
1000000US060971506102023,060971506102023,"Block 2023, Block Group 2, Census Tract 1506.10, Sonoma County, California",25,25,0
1000000US060971506102024,060971506102024,"Block 2024, Block Group 2, Census Tract 1506.10, Sonoma County, California",12,11,1
1000000US060971506102025,060971506102025,"Block 2025, Block Group 2, Census Tract 1506.10, Sonoma County, California",56,56,0
1000000US060971506103000,060971506103000,"Block 3000, Block Group 3, Census Tract 1506.10, Sonoma County, California",31,31,0
1000000US060971506103001,060971506103001,"Block 3001, Block Group 3, Census Tract 1506.10, Sonoma County, California",12,12,0
1000000US060971506103002,060971506103002,"Block 3002, Block Group 3, Census Tract 1506.10, Sonoma County, California",44,44,0
1000000US060971506103003,060971506103003,"Block 3003, Block Group 3, Census Tract 1506.10, Sonoma County, California",62,60,2
1000000US060971506103004,060971506103004,"Block 3004, Block Group 3, Census Tract 1506.10, Sonoma County, California",22,22,0
1000000US060971506103005,060971506103005,"Block 3005, Block Group 3, Census Tract 1506.10, Sonoma County, California",15,15,0
1000000US060971506103006,060971506103006,"Block 3006, Block Group 3, Census Tract 1506.10, Sonoma County, California",17,17,0
1000000US060971506103007,060971506103007,"Block 3007, Block Group 3, Census Tract 1506.10, Sonoma County, California",0,0,0
1000000US060971506103008,060971506103008,"Block 3008, Block Group 3, Census Tract 1506.10, Sonoma County, California",64,62,2
1000000US060971506111000,060971506111000,"Block 1000, Block Group 1, Census Tract 1506.11, Sonoma County, California",89,87,2
1000000US060971506111001,060971506111001,"Block 1001, Block Group 1, Census Tract 1506.11, Sonoma County, California",16,15,1
1000000US060971506111002,060971506111002,"Block 1002, Block Group 1, Census Tract 1506.11, Sonoma County, California",36,35,1
1000000US060971506111003,060971506111003,"Block 1003, Block Group 1, Census Tract 1506.11, Sonoma County, California",279,268,11
1000000US060971506111004,060971506111004,"Block 1004, Block Group 1, Census Tract 1506.11, Sonoma County, California",179,163,16
1000000US060971506111005,060971506111005,"Block 1005, Block Group 1, Census Tract 1506.11, Sonoma County, California",0,0,0
1000000US060971506111006,060971506111006,"Block 1006, Block Group 1, Census Tract 1506.11, Sonoma County, California",13,13,0
1000000US060971506111007,060971506111007,"Block 1007, Block Group 1, Census Tract 1506.11, Sonoma County, California",43,43,0
1000000US060971506111008,060971506111008,"Block 1008, Block Group 1, Census Tract 1506.11, Sonoma County, California",21,19,2
1000000US060971506111009,060971506111009,"Block 1009, Block Group 1, Census Tract 1506.11, Sonoma County, California",1,1,0
1000000US060971506111010,060971506111010,"Block 1010, Block Group 1, Census Tract 1506.11, Sonoma County, California",32,31,1
1000000US060971506111011,060971506111011,"Block 1011, Block Group 1, Census Tract 1506.11, Sonoma County, California",55,53,2
1000000US060971506111012,060971506111012,"Block 1012, Block Group 1, Census Tract 1506.11, Sonoma County, California",14,14,0
1000000US060971506111013,060971506111013,"Block 1013, Block Group 1, Census Tract 1506.11, Sonoma County, California",0,0,0
1000000US060971506111014,060971506111014,"Block 1014, Block Group 1, Census Tract 1506.11, Sonoma County, California",37,37,0
1000000US060971506111015,060971506111015,"Block 1015, Block Group 1, Census Tract 1506.11, Sonoma County, California",32,31,1
1000000US060971506111016,060971506111016,"Block 1016, Block Group 1, Census Tract 1506.11, Sonoma County, California",46,44,2
1000000US060971506111017,060971506111017,"Block 1017, Block Group 1, Census Tract 1506.11, Sonoma County, California",0,0,0
1000000US060971506111018,060971506111018,"Block 1018, Block Group 1, Census Tract 1506.11, Sonoma County, California",10,10,0
1000000US060971506111019,060971506111019,"Block 1019, Block Group 1, Census Tract 1506.11, Sonoma County, California",22,21,1
1000000US060971506111020,060971506111020,"Block 1020, Block Group 1, Census Tract 1506.11, Sonoma County, California",24,23,1
1000000US060971506111021,060971506111021,"Block 1021, Block Group 1, Census Tract 1506.11, Sonoma County, California",0,0,0
1000000US060971506111022,060971506111022,"Block 1022, Block Group 1, Census Tract 1506.11, Sonoma County, California",0,0,0
1000000US060971506111023,060971506111023,"Block 1023, Block Group 1, Census Tract 1506.11, Sonoma County, California",79,73,6
1000000US060971506112000,060971506112000,"Block 2000, Block Group 2, Census Tract 1506.11, Sonoma County, California",0,0,0
1000000US060971506112001,060971506112001,"Block 2001, Block Group 2, Census Tract 1506.11, Sonoma County, California",1,1,0
1000000US060971506112002,060971506112002,"Block 2002, Block Group 2, Census Tract 1506.11, Sonoma County, California",9,9,0
1000000US060971506112003,060971506112003,"Block 2003, Block Group 2, Census Tract 1506.11, Sonoma County, California",0,0,0
1000000US060971506112004,060971506112004,"Block 2004, Block Group 2, Census Tract 1506.11, Sonoma County, California",168,165,3
1000000US060971506112005,060971506112005,"Block 2005, Block Group 2, Census Tract 1506.11, Sonoma County, California",0,0,0
1000000US060971506112006,060971506112006,"Block 2006, Block Group 2, Census Tract 1506.11, Sonoma County, California",2,2,0
1000000US060971506112007,060971506112007,"Block 2007, Block Group 2, Census Tract 1506.11, Sonoma County, California",0,0,0
1000000US060971506112008,060971506112008,"Block 2008, Block Group 2, Census Tract 1506.11, Sonoma County, California",91,88,3
1000000US060971506112009,060971506112009,"Block 2009, Block Group 2, Census Tract 1506.11, Sonoma County, California",0,0,0
1000000US060971506112010,060971506112010,"Block 2010, Block Group 2, Census Tract 1506.11, Sonoma County, California",0,0,0
1000000US060971506112011,060971506112011,"Block 2011, Block Group 2, Census Tract 1506.11, Sonoma County, California",0,0,0
1000000US060971506112012,060971506112012,"Block 2012, Block Group 2, Census Tract 1506.11, Sonoma County, California",50,48,2
1000000US060971506112013,060971506112013,"Block 2013, Block Group 2, Census Tract 1506.11, Sonoma County, California",0,0,0
1000000US060971506112014,060971506112014,"Block 2014, Block Group 2, Census Tract 1506.11, Sonoma County, California",0,0,0
1000000US060971506112015,060971506112015,"Block 2015, Block Group 2, Census Tract 1506.11, Sonoma County, California",0,0,0
1000000US060971506112016,060971506112016,"Block 2016, Block Group 2, Census Tract 1506.11, Sonoma County, California",0,0,0
1000000US060971506112017,060971506112017,"Block 2017, Block Group 2, Census Tract 1506.11, Sonoma County, California",0,0,0
1000000US060971506113000,060971506113000,"Block 3000, Block Group 3, Census Tract 1506.11, Sonoma County, California",19,16,3
1000000US060971506113001,060971506113001,"Block 3001, Block Group 3, Census Tract 1506.11, Sonoma County, California",8,6,2
1000000US060971506113002,060971506113002,"Block 3002, Block Group 3, Census Tract 1506.11, Sonoma County, California",8,7,1
1000000US060971506113003,060971506113003,"Block 3003, Block Group 3, Census Tract 1506.11, Sonoma County, California",24,22,2
1000000US060971506113004,060971506113004,"Block 3004, Block Group 3, Census Tract 1506.11, Sonoma County, California",10,10,0
1000000US060971506113005,060971506113005,"Block 3005, Block Group 3, Census Tract 1506.11, Sonoma County, California",14,12,2
1000000US060971506113006,060971506113006,"Block 3006, Block Group 3, Census Tract 1506.11, Sonoma County, California",0,0,0
1000000US060971506113007,060971506113007,"Block 3007, Block Group 3, Census Tract 1506.11, Sonoma County, California",0,0,0
1000000US060971506113008,060971506113008,"Block 3008, Block Group 3, Census Tract 1506.11, Sonoma County, California",10,10,0
1000000US060971506113009,060971506113009,"Block 3009, Block Group 3, Census Tract 1506.11, Sonoma County, California",38,37,1
1000000US060971506113010,060971506113010,"Block 3010, Block Group 3, Census Tract 1506.11, Sonoma County, California",0,0,0
1000000US060971506113011,060971506113011,"Block 3011, Block Group 3, Census Tract 1506.11, Sonoma County, California",9,8,1
1000000US060971506113012,060971506113012,"Block 3012, Block Group 3, Census Tract 1506.11, Sonoma County, California",0,0,0
1000000US060971506113013,060971506113013,"Block 3013, Block Group 3, Census Tract 1506.11, Sonoma County, California",20,20,0
1000000US060971506121000,060971506121000,"Block 1000, Block Group 1, Census Tract 1506.12, Sonoma County, California",17,15,2
1000000US060971506121001,060971506121001,"Block 1001, Block Group 1, Census Tract 1506.12, Sonoma County, California",1,1,0
1000000US060971506121002,060971506121002,"Block 1002, Block Group 1, Census Tract 1506.12, Sonoma County, California",51,51,0
1000000US060971506121003,060971506121003,"Block 1003, Block Group 1, Census Tract 1506.12, Sonoma County, California",44,44,0
1000000US060971506121004,060971506121004,"Block 1004, Block Group 1, Census Tract 1506.12, Sonoma County, California",11,11,0
1000000US060971506121005,060971506121005,"Block 1005, Block Group 1, Census Tract 1506.12, Sonoma County, California",51,51,0
1000000US060971506121006,060971506121006,"Block 1006, Block Group 1, Census Tract 1506.12, Sonoma County, California",23,21,2
1000000US060971506121007,060971506121007,"Block 1007, Block Group 1, Census Tract 1506.12, Sonoma County, California",25,25,0
1000000US060971506121008,060971506121008,"Block 1008, Block Group 1, Census Tract 1506.12, Sonoma County, California",10,10,0
1000000US060971506121009,060971506121009,"Block 1009, Block Group 1, Census Tract 1506.12, Sonoma County, California",27,27,0
1000000US060971506121010,060971506121010,"Block 1010, Block Group 1, Census Tract 1506.12, Sonoma County, California",11,11,0
1000000US060971506121011,060971506121011,"Block 1011, Block Group 1, Census Tract 1506.12, Sonoma County, California",20,19,1
1000000US060971506121012,060971506121012,"Block 1012, Block Group 1, Census Tract 1506.12, Sonoma County, California",82,81,1
1000000US060971506121013,060971506121013,"Block 1013, Block Group 1, Census Tract 1506.12, Sonoma County, California",18,18,0
1000000US060971506121014,060971506121014,"Block 1014, Block Group 1, Census Tract 1506.12, Sonoma County, California",60,58,2
1000000US060971506121015,060971506121015,"Block 1015, Block Group 1, Census Tract 1506.12, Sonoma County, California",16,16,0
1000000US060971506121016,060971506121016,"Block 1016, Block Group 1, Census Tract 1506.12, Sonoma County, California",52,47,5
1000000US060971506121017,060971506121017,"Block 1017, Block Group 1, Census Tract 1506.12, Sonoma County, California",46,46,0
1000000US060971506121018,060971506121018,"Block 1018, Block Group 1, Census Tract 1506.12, Sonoma County, California",13,13,0
1000000US060971506121019,060971506121019,"Block 1019, Block Group 1, Census Tract 1506.12, Sonoma County, California",27,27,0
1000000US060971506121020,060971506121020,"Block 1020, Block Group 1, Census Tract 1506.12, Sonoma County, California",37,36,1
1000000US060971506121021,060971506121021,"Block 1021, Block Group 1, Census Tract 1506.12, Sonoma County, California",32,31,1
1000000US060971506121022,060971506121022,"Block 1022, Block Group 1, Census Tract 1506.12, Sonoma County, California",28,28,0
1000000US060971506121023,060971506121023,"Block 1023, Block Group 1, Census Tract 1506.12, Sonoma County, California",23,23,0
1000000US060971506121024,060971506121024,"Block 1024, Block Group 1, Census Tract 1506.12, Sonoma County, California",23,23,0
1000000US060971506121025,060971506121025,"Block 1025, Block Group 1, Census Tract 1506.12, Sonoma County, California",14,14,0
1000000US060971506121026,060971506121026,"Block 1026, Block Group 1, Census Tract 1506.12, Sonoma County, California",62,61,1
1000000US060971506121027,060971506121027,"Block 1027, Block Group 1, Census Tract 1506.12, Sonoma County, California",48,46,2
1000000US060971506121028,060971506121028,"Block 1028, Block Group 1, Census Tract 1506.12, Sonoma County, California",18,18,0
1000000US060971506121029,060971506121029,"Block 1029, Block Group 1, Census Tract 1506.12, Sonoma County, California",22,21,1
1000000US060971506121030,060971506121030,"Block 1030, Block Group 1, Census Tract 1506.12, Sonoma County, California",16,15,1
1000000US060971506121031,060971506121031,"Block 1031, Block Group 1, Census Tract 1506.12, Sonoma County, California",0,0,0
1000000US060971506121032,060971506121032,"Block 1032, Block Group 1, Census Tract 1506.12, Sonoma County, California",0,0,0
1000000US060971506121033,060971506121033,"Block 1033, Block Group 1, Census Tract 1506.12, Sonoma County, California",10,10,0
1000000US060971506121034,060971506121034,"Block 1034, Block Group 1, Census Tract 1506.12, Sonoma County, California",27,27,0
1000000US060971506121035,060971506121035,"Block 1035, Block Group 1, Census Tract 1506.12, Sonoma County, California",10,10,0
1000000US060971506121036,060971506121036,"Block 1036, Block Group 1, Census Tract 1506.12, Sonoma County, California",22,22,0
1000000US060971506121037,060971506121037,"Block 1037, Block Group 1, Census Tract 1506.12, Sonoma County, California",0,0,0
1000000US060971506122000,060971506122000,"Block 2000, Block Group 2, Census Tract 1506.12, Sonoma County, California",51,47,4
1000000US060971506122001,060971506122001,"Block 2001, Block Group 2, Census Tract 1506.12, Sonoma County, California",6,6,0
1000000US060971506122002,060971506122002,"Block 2002, Block Group 2, Census Tract 1506.12, Sonoma County, California",6,6,0
1000000US060971506122003,060971506122003,"Block 2003, Block Group 2, Census Tract 1506.12, Sonoma County, California",0,0,0
1000000US060971506122004,060971506122004,"Block 2004, Block Group 2, Census Tract 1506.12, Sonoma County, California",1,1,0
1000000US060971506122005,060971506122005,"Block 2005, Block Group 2, Census Tract 1506.12, Sonoma County, California",0,0,0
1000000US060971506122006,060971506122006,"Block 2006, Block Group 2, Census Tract 1506.12, Sonoma County, California",9,9,0
1000000US060971506122007,060971506122007,"Block 2007, Block Group 2, Census Tract 1506.12, Sonoma County, California",0,0,0
1000000US060971506122008,060971506122008,"Block 2008, Block Group 2, Census Tract 1506.12, Sonoma County, California",0,0,0
1000000US060971506122009,060971506122009,"Block 2009, Block Group 2, Census Tract 1506.12, Sonoma County, California",0,0,0
1000000US060971506122010,060971506122010,"Block 2010, Block Group 2, Census Tract 1506.12, Sonoma County, California",0,0,0
1000000US060971506122011,060971506122011,"Block 2011, Block Group 2, Census Tract 1506.12, Sonoma County, California",0,0,0
1000000US060971506122012,060971506122012,"Block 2012, Block Group 2, Census Tract 1506.12, Sonoma County, California",18,16,2
1000000US060971506122013,060971506122013,"Block 2013, Block Group 2, Census Tract 1506.12, Sonoma County, California",1,1,0
1000000US060971506122014,060971506122014,"Block 2014, Block Group 2, Census Tract 1506.12, Sonoma County, California",0,0,0
1000000US060971506122015,060971506122015,"Block 2015, Block Group 2, Census Tract 1506.12, Sonoma County, California",0,0,0
1000000US060971506122016,060971506122016,"Block 2016, Block Group 2, Census Tract 1506.12, Sonoma County, California",22,19,3
1000000US060971506122017,060971506122017,"Block 2017, Block Group 2, Census Tract 1506.12, Sonoma County, California",0,0,0
1000000US060971506122018,060971506122018,"Block 2018, Block Group 2, Census Tract 1506.12, Sonoma County, California",0,0,0
1000000US060971506122019,060971506122019,"Block 2019, Block Group 2, Census Tract 1506.12, Sonoma County, California",7,7,0
1000000US060971506122020,060971506122020,"Block 2020, Block Group 2, Census Tract 1506.12, Sonoma County, California",1,1,0
1000000US060971506122021,060971506122021,"Block 2021, Block Group 2, Census Tract 1506.12, Sonoma County, California",2,2,0
1000000US060971506122022,060971506122022,"Block 2022, Block Group 2, Census Tract 1506.12, Sonoma County, California",6,5,1
1000000US060971506122023,060971506122023,"Block 2023, Block Group 2, Census Tract 1506.12, Sonoma County, California",0,0,0
1000000US060971506122024,060971506122024,"Block 2024, Block Group 2, Census Tract 1506.12, Sonoma County, California",31,22,9
1000000US060971506122025,060971506122025,"Block 2025, Block Group 2, Census Tract 1506.12, Sonoma County, California",2,1,1
1000000US060971506122026,060971506122026,"Block 2026, Block Group 2, Census Tract 1506.12, Sonoma County, California",0,0,0
1000000US060971506122027,060971506122027,"Block 2027, Block Group 2, Census Tract 1506.12, Sonoma County, California",0,0,0
1000000US060971506122028,060971506122028,"Block 2028, Block Group 2, Census Tract 1506.12, Sonoma County, California",0,0,0
1000000US060971506122029,060971506122029,"Block 2029, Block Group 2, Census Tract 1506.12, Sonoma County, California",1,1,0
1000000US060971506122030,060971506122030,"Block 2030, Block Group 2, Census Tract 1506.12, Sonoma County, California",1,1,0
1000000US060971506122031,060971506122031,"Block 2031, Block Group 2, Census Tract 1506.12, Sonoma County, California",1,1,0
1000000US060971506122032,060971506122032,"Block 2032, Block Group 2, Census Tract 1506.12, Sonoma County, California",16,16,0
1000000US060971506122033,060971506122033,"Block 2033, Block Group 2, Census Tract 1506.12, Sonoma County, California",33,27,6
1000000US060971506122034,060971506122034,"Block 2034, Block Group 2, Census Tract 1506.12, Sonoma County, California",0,0,0
1000000US060971506122035,060971506122035,"Block 2035, Block Group 2, Census Tract 1506.12, Sonoma County, California",11,10,1
1000000US060971506122036,060971506122036,"Block 2036, Block Group 2, Census Tract 1506.12, Sonoma County, California",10,10,0
1000000US060971506122037,060971506122037,"Block 2037, Block Group 2, Census Tract 1506.12, Sonoma County, California",11,10,1
1000000US060971506122038,060971506122038,"Block 2038, Block Group 2, Census Tract 1506.12, Sonoma County, California",1,1,0
1000000US060971506122039,060971506122039,"Block 2039, Block Group 2, Census Tract 1506.12, Sonoma County, California",0,0,0
1000000US060971506122040,060971506122040,"Block 2040, Block Group 2, Census Tract 1506.12, Sonoma County, California",1,1,0
1000000US060971506122041,060971506122041,"Block 2041, Block Group 2, Census Tract 1506.12, Sonoma County, California",4,4,0
1000000US060971506122042,060971506122042,"Block 2042, Block Group 2, Census Tract 1506.12, Sonoma County, California",0,0,0
1000000US060971506122043,060971506122043,"Block 2043, Block Group 2, Census Tract 1506.12, Sonoma County, California",3,3,0
1000000US060971506122044,060971506122044,"Block 2044, Block Group 2, Census Tract 1506.12, Sonoma County, California",27,26,1
1000000US060971506122045,060971506122045,"Block 2045, Block Group 2, Census Tract 1506.12, Sonoma County, California",6,4,2
1000000US060971506122046,060971506122046,"Block 2046, Block Group 2, Census Tract 1506.12, Sonoma County, California",37,28,9
1000000US060971506122047,060971506122047,"Block 2047, Block Group 2, Census Tract 1506.12, Sonoma County, California",0,0,0
1000000US060971506122048,060971506122048,"Block 2048, Block Group 2, Census Tract 1506.12, Sonoma County, California",0,0,0
1000000US060971506122049,060971506122049,"Block 2049, Block Group 2, Census Tract 1506.12, Sonoma County, California",0,0,0
1000000US060971506122050,060971506122050,"Block 2050, Block Group 2, Census Tract 1506.12, Sonoma County, California",0,0,0
1000000US060971506122051,060971506122051,"Block 2051, Block Group 2, Census Tract 1506.12, Sonoma County, California",0,0,0
1000000US060971506122052,060971506122052,"Block 2052, Block Group 2, Census Tract 1506.12, Sonoma County, California",0,0,0
1000000US060971506122053,060971506122053,"Block 2053, Block Group 2, Census Tract 1506.12, Sonoma County, California",0,0,0
1000000US060971506122054,060971506122054,"Block 2054, Block Group 2, Census Tract 1506.12, Sonoma County, California",0,0,0
1000000US060971506122055,060971506122055,"Block 2055, Block Group 2, Census Tract 1506.12, Sonoma County, California",0,0,0
1000000US060971506122056,060971506122056,"Block 2056, Block Group 2, Census Tract 1506.12, Sonoma County, California",1,1,0
1000000US060971506122057,060971506122057,"Block 2057, Block Group 2, Census Tract 1506.12, Sonoma County, California",0,0,0
1000000US060971506122058,060971506122058,"Block 2058, Block Group 2, Census Tract 1506.12, Sonoma County, California",0,0,0
1000000US060971506122059,060971506122059,"Block 2059, Block Group 2, Census Tract 1506.12, Sonoma County, California",0,0,0
1000000US060971506122060,060971506122060,"Block 2060, Block Group 2, Census Tract 1506.12, Sonoma County, California",0,0,0
1000000US060971506122061,060971506122061,"Block 2061, Block Group 2, Census Tract 1506.12, Sonoma County, California",0,0,0
1000000US060971506122062,060971506122062,"Block 2062, Block Group 2, Census Tract 1506.12, Sonoma County, California",0,0,0
1000000US060971506122063,060971506122063,"Block 2063, Block Group 2, Census Tract 1506.12, Sonoma County, California",0,0,0
1000000US060971506122064,060971506122064,"Block 2064, Block Group 2, Census Tract 1506.12, Sonoma County, California",0,0,0
1000000US060971506122065,060971506122065,"Block 2065, Block Group 2, Census Tract 1506.12, Sonoma County, California",239,219,20
1000000US060971506122066,060971506122066,"Block 2066, Block Group 2, Census Tract 1506.12, Sonoma County, California",0,0,0
1000000US060971506122067,060971506122067,"Block 2067, Block Group 2, Census Tract 1506.12, Sonoma County, California",1,1,0
1000000US060971506122068,060971506122068,"Block 2068, Block Group 2, Census Tract 1506.12, Sonoma County, California",0,0,0
1000000US060971506122069,060971506122069,"Block 2069, Block Group 2, Census Tract 1506.12, Sonoma County, California",0,0,0
1000000US060971506122070,060971506122070,"Block 2070, Block Group 2, Census Tract 1506.12, Sonoma County, California",0,0,0
1000000US060971506122071,060971506122071,"Block 2071, Block Group 2, Census Tract 1506.12, Sonoma County, California",0,0,0
1000000US060971506122072,060971506122072,"Block 2072, Block Group 2, Census Tract 1506.12, Sonoma County, California",0,0,0
1000000US060971506122073,060971506122073,"Block 2073, Block Group 2, Census Tract 1506.12, Sonoma County, California",0,0,0
1000000US060971506122074,060971506122074,"Block 2074, Block Group 2, Census Tract 1506.12, Sonoma County, California",0,0,0
1000000US060971506122075,060971506122075,"Block 2075, Block Group 2, Census Tract 1506.12, Sonoma County, California",0,0,0
1000000US060971506122076,060971506122076,"Block 2076, Block Group 2, Census Tract 1506.12, Sonoma County, California",0,0,0
1000000US060971506122077,060971506122077,"Block 2077, Block Group 2, Census Tract 1506.12, Sonoma County, California",0,0,0
1000000US060971506122078,060971506122078,"Block 2078, Block Group 2, Census Tract 1506.12, Sonoma County, California",0,0,0
1000000US060971506122079,060971506122079,"Block 2079, Block Group 2, Census Tract 1506.12, Sonoma County, California",0,0,0
1000000US060971506122080,060971506122080,"Block 2080, Block Group 2, Census Tract 1506.12, Sonoma County, California",0,0,0
1000000US060971506122081,060971506122081,"Block 2081, Block Group 2, Census Tract 1506.12, Sonoma County, California",0,0,0
1000000US060971506122082,060971506122082,"Block 2082, Block Group 2, Census Tract 1506.12, Sonoma County, California",1,0,1
1000000US060971506122083,060971506122083,"Block 2083, Block Group 2, Census Tract 1506.12, Sonoma County, California",0,0,0
1000000US060971506122084,060971506122084,"Block 2084, Block Group 2, Census Tract 1506.12, Sonoma County, California",1,1,0
1000000US060971506122085,060971506122085,"Block 2085, Block Group 2, Census Tract 1506.12, Sonoma County, California",0,0,0
1000000US060971506122086,060971506122086,"Block 2086, Block Group 2, Census Tract 1506.12, Sonoma County, California",0,0,0
1000000US060971506122087,060971506122087,"Block 2087, Block Group 2, Census Tract 1506.12, Sonoma County, California",0,0,0
1000000US060971506122088,060971506122088,"Block 2088, Block Group 2, Census Tract 1506.12, Sonoma County, California",0,0,0
1000000US060971506122089,060971506122089,"Block 2089, Block Group 2, Census Tract 1506.12, Sonoma County, California",0,0,0
1000000US060971506122090,060971506122090,"Block 2090, Block Group 2, Census Tract 1506.12, Sonoma County, California",0,0,0
1000000US060971506122091,060971506122091,"Block 2091, Block Group 2, Census Tract 1506.12, Sonoma County, California",0,0,0
1000000US060971506122092,060971506122092,"Block 2092, Block Group 2, Census Tract 1506.12, Sonoma County, California",11,8,3
1000000US060971506122093,060971506122093,"Block 2093, Block Group 2, Census Tract 1506.12, Sonoma County, California",0,0,0
1000000US060971506122094,060971506122094,"Block 2094, Block Group 2, Census Tract 1506.12, Sonoma County, California",0,0,0
1000000US060971506122095,060971506122095,"Block 2095, Block Group 2, Census Tract 1506.12, Sonoma County, California",0,0,0
1000000US060971506122096,060971506122096,"Block 2096, Block Group 2, Census Tract 1506.12, Sonoma County, California",0,0,0
1000000US060971506122097,060971506122097,"Block 2097, Block Group 2, Census Tract 1506.12, Sonoma County, California",0,0,0
1000000US060971506122098,060971506122098,"Block 2098, Block Group 2, Census Tract 1506.12, Sonoma County, California",0,0,0
1000000US060971506122099,060971506122099,"Block 2099, Block Group 2, Census Tract 1506.12, Sonoma County, California",0,0,0
1000000US060971506122100,060971506122100,"Block 2100, Block Group 2, Census Tract 1506.12, Sonoma County, California",0,0,0
1000000US060971506122101,060971506122101,"Block 2101, Block Group 2, Census Tract 1506.12, Sonoma County, California",2,1,1
1000000US060971506122102,060971506122102,"Block 2102, Block Group 2, Census Tract 1506.12, Sonoma County, California",0,0,0
1000000US060971506122103,060971506122103,"Block 2103, Block Group 2, Census Tract 1506.12, Sonoma County, California",0,0,0
1000000US060971506122104,060971506122104,"Block 2104, Block Group 2, Census Tract 1506.12, Sonoma County, California",0,0,0
1000000US060971506122105,060971506122105,"Block 2105, Block Group 2, Census Tract 1506.12, Sonoma County, California",0,0,0
1000000US060971506122106,060971506122106,"Block 2106, Block Group 2, Census Tract 1506.12, Sonoma County, California",0,0,0
1000000US060971506122107,060971506122107,"Block 2107, Block Group 2, Census Tract 1506.12, Sonoma County, California",7,7,0
1000000US060971506122108,060971506122108,"Block 2108, Block Group 2, Census Tract 1506.12, Sonoma County, California",0,0,0
1000000US060971506122109,060971506122109,"Block 2109, Block Group 2, Census Tract 1506.12, Sonoma County, California",0,0,0
1000000US060971506122110,060971506122110,"Block 2110, Block Group 2, Census Tract 1506.12, Sonoma County, California",0,0,0
1000000US060971506122111,060971506122111,"Block 2111, Block Group 2, Census Tract 1506.12, Sonoma County, California",12,12,0
1000000US060971506122112,060971506122112,"Block 2112, Block Group 2, Census Tract 1506.12, Sonoma County, California",11,7,4
1000000US060971506122113,060971506122113,"Block 2113, Block Group 2, Census Tract 1506.12, Sonoma County, California",9,7,2
1000000US060971506122114,060971506122114,"Block 2114, Block Group 2, Census Tract 1506.12, Sonoma County, California",0,0,0
1000000US060971506122115,060971506122115,"Block 2115, Block Group 2, Census Tract 1506.12, Sonoma County, California",17,14,3
1000000US060971506122116,060971506122116,"Block 2116, Block Group 2, Census Tract 1506.12, Sonoma County, California",2,0,2
1000000US060971506122117,060971506122117,"Block 2117, Block Group 2, Census Tract 1506.12, Sonoma County, California",0,0,0
1000000US060971506122118,060971506122118,"Block 2118, Block Group 2, Census Tract 1506.12, Sonoma County, California",40,39,1
1000000US060971506122119,060971506122119,"Block 2119, Block Group 2, Census Tract 1506.12, Sonoma County, California",0,0,0
1000000US060971506122120,060971506122120,"Block 2120, Block Group 2, Census Tract 1506.12, Sonoma County, California",1,1,0
1000000US060971506122121,060971506122121,"Block 2121, Block Group 2, Census Tract 1506.12, Sonoma County, California",0,0,0
1000000US060971506122122,060971506122122,"Block 2122, Block Group 2, Census Tract 1506.12, Sonoma County, California",0,0,0
1000000US060971506122123,060971506122123,"Block 2123, Block Group 2, Census Tract 1506.12, Sonoma County, California",1,1,0
1000000US060971506122124,060971506122124,"Block 2124, Block Group 2, Census Tract 1506.12, Sonoma County, California",0,0,0
1000000US060971506122125,060971506122125,"Block 2125, Block Group 2, Census Tract 1506.12, Sonoma County, California",1,1,0
1000000US060971506122126,060971506122126,"Block 2126, Block Group 2, Census Tract 1506.12, Sonoma County, California",0,0,0
1000000US060971506122127,060971506122127,"Block 2127, Block Group 2, Census Tract 1506.12, Sonoma County, California",7,6,1
1000000US060971506122128,060971506122128,"Block 2128, Block Group 2, Census Tract 1506.12, Sonoma County, California",0,0,0
1000000US060971506122129,060971506122129,"Block 2129, Block Group 2, Census Tract 1506.12, Sonoma County, California",0,0,0
1000000US060971506122130,060971506122130,"Block 2130, Block Group 2, Census Tract 1506.12, Sonoma County, California",1,1,0
1000000US060971506122131,060971506122131,"Block 2131, Block Group 2, Census Tract 1506.12, Sonoma County, California",0,0,0
1000000US060971506122132,060971506122132,"Block 2132, Block Group 2, Census Tract 1506.12, Sonoma County, California",0,0,0
1000000US060971506122133,060971506122133,"Block 2133, Block Group 2, Census Tract 1506.12, Sonoma County, California",0,0,0
1000000US060971506122134,060971506122134,"Block 2134, Block Group 2, Census Tract 1506.12, Sonoma County, California",0,0,0
1000000US060971506122135,060971506122135,"Block 2135, Block Group 2, Census Tract 1506.12, Sonoma County, California",2,2,0
1000000US060971506122136,060971506122136,"Block 2136, Block Group 2, Census Tract 1506.12, Sonoma County, California",0,0,0
1000000US060971506122137,060971506122137,"Block 2137, Block Group 2, Census Tract 1506.12, Sonoma County, California",3,3,0
1000000US060971506122138,060971506122138,"Block 2138, Block Group 2, Census Tract 1506.12, Sonoma County, California",0,0,0
1000000US060971506122139,060971506122139,"Block 2139, Block Group 2, Census Tract 1506.12, Sonoma County, California",0,0,0
1000000US060971506122140,060971506122140,"Block 2140, Block Group 2, Census Tract 1506.12, Sonoma County, California",2,2,0
1000000US060971506122141,060971506122141,"Block 2141, Block Group 2, Census Tract 1506.12, Sonoma County, California",0,0,0
1000000US060971506122142,060971506122142,"Block 2142, Block Group 2, Census Tract 1506.12, Sonoma County, California",0,0,0
1000000US060971506122143,060971506122143,"Block 2143, Block Group 2, Census Tract 1506.12, Sonoma County, California",0,0,0
1000000US060971506122144,060971506122144,"Block 2144, Block Group 2, Census Tract 1506.12, Sonoma County, California",0,0,0
1000000US060971506122145,060971506122145,"Block 2145, Block Group 2, Census Tract 1506.12, Sonoma County, California",0,0,0
1000000US060971506122146,060971506122146,"Block 2146, Block Group 2, Census Tract 1506.12, Sonoma County, California",0,0,0
1000000US060971506122147,060971506122147,"Block 2147, Block Group 2, Census Tract 1506.12, Sonoma County, California",1,1,0
1000000US060971506122148,060971506122148,"Block 2148, Block Group 2, Census Tract 1506.12, Sonoma County, California",10,10,0
1000000US060971506122149,060971506122149,"Block 2149, Block Group 2, Census Tract 1506.12, Sonoma County, California",0,0,0
1000000US060971506122150,060971506122150,"Block 2150, Block Group 2, Census Tract 1506.12, Sonoma County, California",0,0,0
1000000US060971506122151,060971506122151,"Block 2151, Block Group 2, Census Tract 1506.12, Sonoma County, California",0,0,0
1000000US060971506122152,060971506122152,"Block 2152, Block Group 2, Census Tract 1506.12, Sonoma County, California",0,0,0
1000000US060971506122153,060971506122153,"Block 2153, Block Group 2, Census Tract 1506.12, Sonoma County, California",0,0,0
1000000US060971506122154,060971506122154,"Block 2154, Block Group 2, Census Tract 1506.12, Sonoma County, California",0,0,0
1000000US060971506122155,060971506122155,"Block 2155, Block Group 2, Census Tract 1506.12, Sonoma County, California",0,0,0
1000000US060971506122156,060971506122156,"Block 2156, Block Group 2, Census Tract 1506.12, Sonoma County, California",0,0,0
1000000US060971506122157,060971506122157,"Block 2157, Block Group 2, Census Tract 1506.12, Sonoma County, California",0,0,0
1000000US060971506122158,060971506122158,"Block 2158, Block Group 2, Census Tract 1506.12, Sonoma County, California",0,0,0
1000000US060971506122159,060971506122159,"Block 2159, Block Group 2, Census Tract 1506.12, Sonoma County, California",0,0,0
1000000US060971506122160,060971506122160,"Block 2160, Block Group 2, Census Tract 1506.12, Sonoma County, California",0,0,0
1000000US060971506122161,060971506122161,"Block 2161, Block Group 2, Census Tract 1506.12, Sonoma County, California",0,0,0
1000000US060971506122162,060971506122162,"Block 2162, Block Group 2, Census Tract 1506.12, Sonoma County, California",0,0,0
1000000US060971506122163,060971506122163,"Block 2163, Block Group 2, Census Tract 1506.12, Sonoma County, California",0,0,0
1000000US060971506122164,060971506122164,"Block 2164, Block Group 2, Census Tract 1506.12, Sonoma County, California",0,0,0
1000000US060971506122165,060971506122165,"Block 2165, Block Group 2, Census Tract 1506.12, Sonoma County, California",0,0,0
1000000US060971506122166,060971506122166,"Block 2166, Block Group 2, Census Tract 1506.12, Sonoma County, California",0,0,0
1000000US060971506122167,060971506122167,"Block 2167, Block Group 2, Census Tract 1506.12, Sonoma County, California",0,0,0
1000000US060971506122168,060971506122168,"Block 2168, Block Group 2, Census Tract 1506.12, Sonoma County, California",0,0,0
1000000US060971506122169,060971506122169,"Block 2169, Block Group 2, Census Tract 1506.12, Sonoma County, California",3,3,0
1000000US060971506122170,060971506122170,"Block 2170, Block Group 2, Census Tract 1506.12, Sonoma County, California",2,2,0
1000000US060971506122171,060971506122171,"Block 2171, Block Group 2, Census Tract 1506.12, Sonoma County, California",0,0,0
1000000US060971506122172,060971506122172,"Block 2172, Block Group 2, Census Tract 1506.12, Sonoma County, California",0,0,0
1000000US060971506122173,060971506122173,"Block 2173, Block Group 2, Census Tract 1506.12, Sonoma County, California",0,0,0
1000000US060971506122174,060971506122174,"Block 2174, Block Group 2, Census Tract 1506.12, Sonoma County, California",0,0,0
1000000US060971506122175,060971506122175,"Block 2175, Block Group 2, Census Tract 1506.12, Sonoma County, California",0,0,0
1000000US060971506122176,060971506122176,"Block 2176, Block Group 2, Census Tract 1506.12, Sonoma County, California",0,0,0
1000000US060971506122177,060971506122177,"Block 2177, Block Group 2, Census Tract 1506.12, Sonoma County, California",0,0,0
1000000US060971506122178,060971506122178,"Block 2178, Block Group 2, Census Tract 1506.12, Sonoma County, California",0,0,0
1000000US060971506122179,060971506122179,"Block 2179, Block Group 2, Census Tract 1506.12, Sonoma County, California",0,0,0
1000000US060971506122180,060971506122180,"Block 2180, Block Group 2, Census Tract 1506.12, Sonoma County, California",0,0,0
1000000US060971506122181,060971506122181,"Block 2181, Block Group 2, Census Tract 1506.12, Sonoma County, California",0,0,0
1000000US060971506122182,060971506122182,"Block 2182, Block Group 2, Census Tract 1506.12, Sonoma County, California",0,0,0
1000000US060971506122183,060971506122183,"Block 2183, Block Group 2, Census Tract 1506.12, Sonoma County, California",0,0,0
1000000US060971506122184,060971506122184,"Block 2184, Block Group 2, Census Tract 1506.12, Sonoma County, California",0,0,0
1000000US060971506122185,060971506122185,"Block 2185, Block Group 2, Census Tract 1506.12, Sonoma County, California",0,0,0
1000000US060971506122186,060971506122186,"Block 2186, Block Group 2, Census Tract 1506.12, Sonoma County, California",0,0,0
1000000US060971506122187,060971506122187,"Block 2187, Block Group 2, Census Tract 1506.12, Sonoma County, California",0,0,0
1000000US060971506122188,060971506122188,"Block 2188, Block Group 2, Census Tract 1506.12, Sonoma County, California",0,0,0
1000000US060971506122189,060971506122189,"Block 2189, Block Group 2, Census Tract 1506.12, Sonoma County, California",0,0,0
1000000US060971506122190,060971506122190,"Block 2190, Block Group 2, Census Tract 1506.12, Sonoma County, California",0,0,0
1000000US060971506122191,060971506122191,"Block 2191, Block Group 2, Census Tract 1506.12, Sonoma County, California",0,0,0
1000000US060971506122192,060971506122192,"Block 2192, Block Group 2, Census Tract 1506.12, Sonoma County, California",0,0,0
1000000US060971506122193,060971506122193,"Block 2193, Block Group 2, Census Tract 1506.12, Sonoma County, California",0,0,0
1000000US060971506122194,060971506122194,"Block 2194, Block Group 2, Census Tract 1506.12, Sonoma County, California",0,0,0
1000000US060971506122195,060971506122195,"Block 2195, Block Group 2, Census Tract 1506.12, Sonoma County, California",0,0,0
1000000US060971506122196,060971506122196,"Block 2196, Block Group 2, Census Tract 1506.12, Sonoma County, California",0,0,0
1000000US060971506122197,060971506122197,"Block 2197, Block Group 2, Census Tract 1506.12, Sonoma County, California",0,0,0
1000000US060971506122198,060971506122198,"Block 2198, Block Group 2, Census Tract 1506.12, Sonoma County, California",0,0,0
1000000US060971506122199,060971506122199,"Block 2199, Block Group 2, Census Tract 1506.12, Sonoma County, California",0,0,0
1000000US060971506122200,060971506122200,"Block 2200, Block Group 2, Census Tract 1506.12, Sonoma County, California",0,0,0
1000000US060971506122201,060971506122201,"Block 2201, Block Group 2, Census Tract 1506.12, Sonoma County, California",0,0,0
1000000US060971506122202,060971506122202,"Block 2202, Block Group 2, Census Tract 1506.12, Sonoma County, California",2,2,0
1000000US060971506122203,060971506122203,"Block 2203, Block Group 2, Census Tract 1506.12, Sonoma County, California",0,0,0
1000000US060971506122204,060971506122204,"Block 2204, Block Group 2, Census Tract 1506.12, Sonoma County, California",0,0,0
1000000US060971506122205,060971506122205,"Block 2205, Block Group 2, Census Tract 1506.12, Sonoma County, California",0,0,0
1000000US060971506122206,060971506122206,"Block 2206, Block Group 2, Census Tract 1506.12, Sonoma County, California",0,0,0
1000000US060971506122207,060971506122207,"Block 2207, Block Group 2, Census Tract 1506.12, Sonoma County, California",0,0,0
1000000US060971506122208,060971506122208,"Block 2208, Block Group 2, Census Tract 1506.12, Sonoma County, California",0,0,0
1000000US060971506122209,060971506122209,"Block 2209, Block Group 2, Census Tract 1506.12, Sonoma County, California",0,0,0
1000000US060971506122210,060971506122210,"Block 2210, Block Group 2, Census Tract 1506.12, Sonoma County, California",0,0,0
1000000US060971506122211,060971506122211,"Block 2211, Block Group 2, Census Tract 1506.12, Sonoma County, California",0,0,0
1000000US060971506122212,060971506122212,"Block 2212, Block Group 2, Census Tract 1506.12, Sonoma County, California",0,0,0
1000000US060971506122213,060971506122213,"Block 2213, Block Group 2, Census Tract 1506.12, Sonoma County, California",0,0,0
1000000US060971506122214,060971506122214,"Block 2214, Block Group 2, Census Tract 1506.12, Sonoma County, California",0,0,0
1000000US060971506122215,060971506122215,"Block 2215, Block Group 2, Census Tract 1506.12, Sonoma County, California",0,0,0
1000000US060971506122216,060971506122216,"Block 2216, Block Group 2, Census Tract 1506.12, Sonoma County, California",0,0,0
1000000US060971506122217,060971506122217,"Block 2217, Block Group 2, Census Tract 1506.12, Sonoma County, California",0,0,0
1000000US060971506122218,060971506122218,"Block 2218, Block Group 2, Census Tract 1506.12, Sonoma County, California",0,0,0
1000000US060971506122219,060971506122219,"Block 2219, Block Group 2, Census Tract 1506.12, Sonoma County, California",0,0,0
1000000US060971506122220,060971506122220,"Block 2220, Block Group 2, Census Tract 1506.12, Sonoma County, California",0,0,0
1000000US060971506122221,060971506122221,"Block 2221, Block Group 2, Census Tract 1506.12, Sonoma County, California",0,0,0
1000000US060971506122222,060971506122222,"Block 2222, Block Group 2, Census Tract 1506.12, Sonoma County, California",0,0,0
1000000US060971506122223,060971506122223,"Block 2223, Block Group 2, Census Tract 1506.12, Sonoma County, California",0,0,0
1000000US060971506122224,060971506122224,"Block 2224, Block Group 2, Census Tract 1506.12, Sonoma County, California",0,0,0
1000000US060971506122225,060971506122225,"Block 2225, Block Group 2, Census Tract 1506.12, Sonoma County, California",0,0,0
1000000US060971506122226,060971506122226,"Block 2226, Block Group 2, Census Tract 1506.12, Sonoma County, California",0,0,0
1000000US060971506122227,060971506122227,"Block 2227, Block Group 2, Census Tract 1506.12, Sonoma County, California",0,0,0
1000000US060971506122228,060971506122228,"Block 2228, Block Group 2, Census Tract 1506.12, Sonoma County, California",0,0,0
1000000US060971506122229,060971506122229,"Block 2229, Block Group 2, Census Tract 1506.12, Sonoma County, California",0,0,0
1000000US060971506122230,060971506122230,"Block 2230, Block Group 2, Census Tract 1506.12, Sonoma County, California",0,0,0
1000000US060971506122231,060971506122231,"Block 2231, Block Group 2, Census Tract 1506.12, Sonoma County, California",0,0,0
1000000US060971506122232,060971506122232,"Block 2232, Block Group 2, Census Tract 1506.12, Sonoma County, California",0,0,0
1000000US060971506122233,060971506122233,"Block 2233, Block Group 2, Census Tract 1506.12, Sonoma County, California",0,0,0
1000000US060971506122234,060971506122234,"Block 2234, Block Group 2, Census Tract 1506.12, Sonoma County, California",0,0,0
1000000US060971507011000,060971507011000,"Block 1000, Block Group 1, Census Tract 1507.01, Sonoma County, California",0,0,0
1000000US060971507011001,060971507011001,"Block 1001, Block Group 1, Census Tract 1507.01, Sonoma County, California",0,0,0
1000000US060971507011002,060971507011002,"Block 1002, Block Group 1, Census Tract 1507.01, Sonoma County, California",1,1,0
1000000US060971507011003,060971507011003,"Block 1003, Block Group 1, Census Tract 1507.01, Sonoma County, California",0,0,0
1000000US060971507011004,060971507011004,"Block 1004, Block Group 1, Census Tract 1507.01, Sonoma County, California",31,29,2
1000000US060971507011005,060971507011005,"Block 1005, Block Group 1, Census Tract 1507.01, Sonoma County, California",50,47,3
1000000US060971507011006,060971507011006,"Block 1006, Block Group 1, Census Tract 1507.01, Sonoma County, California",139,133,6
1000000US060971507011007,060971507011007,"Block 1007, Block Group 1, Census Tract 1507.01, Sonoma County, California",12,12,0
1000000US060971507011008,060971507011008,"Block 1008, Block Group 1, Census Tract 1507.01, Sonoma County, California",1,1,0
1000000US060971507011009,060971507011009,"Block 1009, Block Group 1, Census Tract 1507.01, Sonoma County, California",4,4,0
1000000US060971507011010,060971507011010,"Block 1010, Block Group 1, Census Tract 1507.01, Sonoma County, California",2,2,0
1000000US060971507011011,060971507011011,"Block 1011, Block Group 1, Census Tract 1507.01, Sonoma County, California",0,0,0
1000000US060971507011012,060971507011012,"Block 1012, Block Group 1, Census Tract 1507.01, Sonoma County, California",28,24,4
1000000US060971507011013,060971507011013,"Block 1013, Block Group 1, Census Tract 1507.01, Sonoma County, California",1,1,0
1000000US060971507011014,060971507011014,"Block 1014, Block Group 1, Census Tract 1507.01, Sonoma County, California",0,0,0
1000000US060971507011015,060971507011015,"Block 1015, Block Group 1, Census Tract 1507.01, Sonoma County, California",0,0,0
1000000US060971507011016,060971507011016,"Block 1016, Block Group 1, Census Tract 1507.01, Sonoma County, California",0,0,0
1000000US060971507011017,060971507011017,"Block 1017, Block Group 1, Census Tract 1507.01, Sonoma County, California",0,0,0
1000000US060971507011018,060971507011018,"Block 1018, Block Group 1, Census Tract 1507.01, Sonoma County, California",0,0,0
1000000US060971507011019,060971507011019,"Block 1019, Block Group 1, Census Tract 1507.01, Sonoma County, California",17,16,1
1000000US060971507011020,060971507011020,"Block 1020, Block Group 1, Census Tract 1507.01, Sonoma County, California",76,70,6
1000000US060971507011021,060971507011021,"Block 1021, Block Group 1, Census Tract 1507.01, Sonoma County, California",26,23,3
1000000US060971507011022,060971507011022,"Block 1022, Block Group 1, Census Tract 1507.01, Sonoma County, California",41,39,2
1000000US060971507011023,060971507011023,"Block 1023, Block Group 1, Census Tract 1507.01, Sonoma County, California",66,58,8
1000000US060971507011024,060971507011024,"Block 1024, Block Group 1, Census Tract 1507.01, Sonoma County, California",16,14,2
1000000US060971507011025,060971507011025,"Block 1025, Block Group 1, Census Tract 1507.01, Sonoma County, California",6,4,2
1000000US060971507011026,060971507011026,"Block 1026, Block Group 1, Census Tract 1507.01, Sonoma County, California",0,0,0
1000000US060971507011027,060971507011027,"Block 1027, Block Group 1, Census Tract 1507.01, Sonoma County, California",0,0,0
1000000US060971507011028,060971507011028,"Block 1028, Block Group 1, Census Tract 1507.01, Sonoma County, California",0,0,0
1000000US060971507011029,060971507011029,"Block 1029, Block Group 1, Census Tract 1507.01, Sonoma County, California",0,0,0
1000000US060971507011030,060971507011030,"Block 1030, Block Group 1, Census Tract 1507.01, Sonoma County, California",0,0,0
1000000US060971507011031,060971507011031,"Block 1031, Block Group 1, Census Tract 1507.01, Sonoma County, California",0,0,0
1000000US060971507011032,060971507011032,"Block 1032, Block Group 1, Census Tract 1507.01, Sonoma County, California",0,0,0
1000000US060971507011033,060971507011033,"Block 1033, Block Group 1, Census Tract 1507.01, Sonoma County, California",0,0,0
1000000US060971507011034,060971507011034,"Block 1034, Block Group 1, Census Tract 1507.01, Sonoma County, California",0,0,0
1000000US060971507011035,060971507011035,"Block 1035, Block Group 1, Census Tract 1507.01, Sonoma County, California",0,0,0
1000000US060971507012000,060971507012000,"Block 2000, Block Group 2, Census Tract 1507.01, Sonoma County, California",0,0,0
1000000US060971507012001,060971507012001,"Block 2001, Block Group 2, Census Tract 1507.01, Sonoma County, California",0,0,0
1000000US060971507012002,060971507012002,"Block 2002, Block Group 2, Census Tract 1507.01, Sonoma County, California",0,0,0
1000000US060971507012003,060971507012003,"Block 2003, Block Group 2, Census Tract 1507.01, Sonoma County, California",3,3,0
1000000US060971507012004,060971507012004,"Block 2004, Block Group 2, Census Tract 1507.01, Sonoma County, California",0,0,0
1000000US060971507012005,060971507012005,"Block 2005, Block Group 2, Census Tract 1507.01, Sonoma County, California",75,71,4
1000000US060971507012006,060971507012006,"Block 2006, Block Group 2, Census Tract 1507.01, Sonoma County, California",4,4,0
1000000US060971507012007,060971507012007,"Block 2007, Block Group 2, Census Tract 1507.01, Sonoma County, California",14,14,0
1000000US060971507012008,060971507012008,"Block 2008, Block Group 2, Census Tract 1507.01, Sonoma County, California",0,0,0
1000000US060971507012009,060971507012009,"Block 2009, Block Group 2, Census Tract 1507.01, Sonoma County, California",31,27,4
1000000US060971507012010,060971507012010,"Block 2010, Block Group 2, Census Tract 1507.01, Sonoma County, California",28,26,2
1000000US060971507012011,060971507012011,"Block 2011, Block Group 2, Census Tract 1507.01, Sonoma County, California",74,70,4
1000000US060971507012012,060971507012012,"Block 2012, Block Group 2, Census Tract 1507.01, Sonoma County, California",112,107,5
1000000US060971507012013,060971507012013,"Block 2013, Block Group 2, Census Tract 1507.01, Sonoma County, California",162,148,14
1000000US060971507012014,060971507012014,"Block 2014, Block Group 2, Census Tract 1507.01, Sonoma County, California",11,10,1
1000000US060971507012015,060971507012015,"Block 2015, Block Group 2, Census Tract 1507.01, Sonoma County, California",7,6,1
1000000US060971507012016,060971507012016,"Block 2016, Block Group 2, Census Tract 1507.01, Sonoma County, California",0,0,0
1000000US060971507012017,060971507012017,"Block 2017, Block Group 2, Census Tract 1507.01, Sonoma County, California",24,24,0
1000000US060971507012018,060971507012018,"Block 2018, Block Group 2, Census Tract 1507.01, Sonoma County, California",25,22,3
1000000US060971507012019,060971507012019,"Block 2019, Block Group 2, Census Tract 1507.01, Sonoma County, California",26,23,3
1000000US060971507012020,060971507012020,"Block 2020, Block Group 2, Census Tract 1507.01, Sonoma County, California",22,22,0
1000000US060971507012021,060971507012021,"Block 2021, Block Group 2, Census Tract 1507.01, Sonoma County, California",18,18,0
1000000US060971507012022,060971507012022,"Block 2022, Block Group 2, Census Tract 1507.01, Sonoma County, California",24,23,1
1000000US060971507012023,060971507012023,"Block 2023, Block Group 2, Census Tract 1507.01, Sonoma County, California",43,40,3
1000000US060971507012024,060971507012024,"Block 2024, Block Group 2, Census Tract 1507.01, Sonoma County, California",17,17,0
1000000US060971507012025,060971507012025,"Block 2025, Block Group 2, Census Tract 1507.01, Sonoma County, California",0,0,0
1000000US060971507012026,060971507012026,"Block 2026, Block Group 2, Census Tract 1507.01, Sonoma County, California",0,0,0
1000000US060971507012027,060971507012027,"Block 2027, Block Group 2, Census Tract 1507.01, Sonoma County, California",11,11,0
1000000US060971507013000,060971507013000,"Block 3000, Block Group 3, Census Tract 1507.01, Sonoma County, California",0,0,0
1000000US060971507013001,060971507013001,"Block 3001, Block Group 3, Census Tract 1507.01, Sonoma County, California",0,0,0
1000000US060971507013002,060971507013002,"Block 3002, Block Group 3, Census Tract 1507.01, Sonoma County, California",0,0,0
1000000US060971507013003,060971507013003,"Block 3003, Block Group 3, Census Tract 1507.01, Sonoma County, California",5,4,1
1000000US060971507013004,060971507013004,"Block 3004, Block Group 3, Census Tract 1507.01, Sonoma County, California",0,0,0
1000000US060971507013005,060971507013005,"Block 3005, Block Group 3, Census Tract 1507.01, Sonoma County, California",0,0,0
1000000US060971507013006,060971507013006,"Block 3006, Block Group 3, Census Tract 1507.01, Sonoma County, California",0,0,0
1000000US060971507013007,060971507013007,"Block 3007, Block Group 3, Census Tract 1507.01, Sonoma County, California",0,0,0
1000000US060971507013008,060971507013008,"Block 3008, Block Group 3, Census Tract 1507.01, Sonoma County, California",0,0,0
1000000US060971507013009,060971507013009,"Block 3009, Block Group 3, Census Tract 1507.01, Sonoma County, California",8,8,0
1000000US060971507013010,060971507013010,"Block 3010, Block Group 3, Census Tract 1507.01, Sonoma County, California",0,0,0
1000000US060971507013011,060971507013011,"Block 3011, Block Group 3, Census Tract 1507.01, Sonoma County, California",14,14,0
1000000US060971507013012,060971507013012,"Block 3012, Block Group 3, Census Tract 1507.01, Sonoma County, California",0,0,0
1000000US060971507013013,060971507013013,"Block 3013, Block Group 3, Census Tract 1507.01, Sonoma County, California",0,0,0
1000000US060971507013014,060971507013014,"Block 3014, Block Group 3, Census Tract 1507.01, Sonoma County, California",0,0,0
1000000US060971507013015,060971507013015,"Block 3015, Block Group 3, Census Tract 1507.01, Sonoma County, California",43,35,8
1000000US060971507013016,060971507013016,"Block 3016, Block Group 3, Census Tract 1507.01, Sonoma County, California",0,0,0
1000000US060971507013017,060971507013017,"Block 3017, Block Group 3, Census Tract 1507.01, Sonoma County, California",0,0,0
1000000US060971507013018,060971507013018,"Block 3018, Block Group 3, Census Tract 1507.01, Sonoma County, California",0,0,0
1000000US060971507013019,060971507013019,"Block 3019, Block Group 3, Census Tract 1507.01, Sonoma County, California",56,52,4
1000000US060971507013020,060971507013020,"Block 3020, Block Group 3, Census Tract 1507.01, Sonoma County, California",0,0,0
1000000US060971507013021,060971507013021,"Block 3021, Block Group 3, Census Tract 1507.01, Sonoma County, California",0,0,0
1000000US060971507013022,060971507013022,"Block 3022, Block Group 3, Census Tract 1507.01, Sonoma County, California",90,81,9
1000000US060971507013023,060971507013023,"Block 3023, Block Group 3, Census Tract 1507.01, Sonoma County, California",5,5,0
1000000US060971507013024,060971507013024,"Block 3024, Block Group 3, Census Tract 1507.01, Sonoma County, California",29,24,5
1000000US060971507013025,060971507013025,"Block 3025, Block Group 3, Census Tract 1507.01, Sonoma County, California",0,0,0
1000000US060971507013026,060971507013026,"Block 3026, Block Group 3, Census Tract 1507.01, Sonoma County, California",6,6,0
1000000US060971507013027,060971507013027,"Block 3027, Block Group 3, Census Tract 1507.01, Sonoma County, California",20,20,0
1000000US060971507013028,060971507013028,"Block 3028, Block Group 3, Census Tract 1507.01, Sonoma County, California",0,0,0
1000000US060971507013029,060971507013029,"Block 3029, Block Group 3, Census Tract 1507.01, Sonoma County, California",0,0,0
1000000US060971507013030,060971507013030,"Block 3030, Block Group 3, Census Tract 1507.01, Sonoma County, California",8,7,1
1000000US060971507013031,060971507013031,"Block 3031, Block Group 3, Census Tract 1507.01, Sonoma County, California",13,10,3
1000000US060971507013032,060971507013032,"Block 3032, Block Group 3, Census Tract 1507.01, Sonoma County, California",0,0,0
1000000US060971507013033,060971507013033,"Block 3033, Block Group 3, Census Tract 1507.01, Sonoma County, California",19,19,0
1000000US060971507013034,060971507013034,"Block 3034, Block Group 3, Census Tract 1507.01, Sonoma County, California",3,2,1
1000000US060971507013035,060971507013035,"Block 3035, Block Group 3, Census Tract 1507.01, Sonoma County, California",21,18,3
1000000US060971507013036,060971507013036,"Block 3036, Block Group 3, Census Tract 1507.01, Sonoma County, California",49,48,1
1000000US060971507013037,060971507013037,"Block 3037, Block Group 3, Census Tract 1507.01, Sonoma County, California",26,24,2
1000000US060971507013038,060971507013038,"Block 3038, Block Group 3, Census Tract 1507.01, Sonoma County, California",27,27,0
1000000US060971507013039,060971507013039,"Block 3039, Block Group 3, Census Tract 1507.01, Sonoma County, California",0,0,0
1000000US060971507013040,060971507013040,"Block 3040, Block Group 3, Census Tract 1507.01, Sonoma County, California",44,40,4
1000000US060971507013041,060971507013041,"Block 3041, Block Group 3, Census Tract 1507.01, Sonoma County, California",32,28,4
1000000US060971507013042,060971507013042,"Block 3042, Block Group 3, Census Tract 1507.01, Sonoma County, California",35,33,2
1000000US060971507014000,060971507014000,"Block 4000, Block Group 4, Census Tract 1507.01, Sonoma County, California",100,97,3
1000000US060971507014001,060971507014001,"Block 4001, Block Group 4, Census Tract 1507.01, Sonoma County, California",24,23,1
1000000US060971507014002,060971507014002,"Block 4002, Block Group 4, Census Tract 1507.01, Sonoma County, California",12,12,0
1000000US060971507014003,060971507014003,"Block 4003, Block Group 4, Census Tract 1507.01, Sonoma County, California",13,11,2
1000000US060971507014004,060971507014004,"Block 4004, Block Group 4, Census Tract 1507.01, Sonoma County, California",72,67,5
1000000US060971507014005,060971507014005,"Block 4005, Block Group 4, Census Tract 1507.01, Sonoma County, California",17,16,1
1000000US060971507014006,060971507014006,"Block 4006, Block Group 4, Census Tract 1507.01, Sonoma County, California",21,20,1
1000000US060971507014007,060971507014007,"Block 4007, Block Group 4, Census Tract 1507.01, Sonoma County, California",57,54,3
1000000US060971507014008,060971507014008,"Block 4008, Block Group 4, Census Tract 1507.01, Sonoma County, California",4,4,0
1000000US060971507014009,060971507014009,"Block 4009, Block Group 4, Census Tract 1507.01, Sonoma County, California",24,23,1
1000000US060971507021000,060971507021000,"Block 1000, Block Group 1, Census Tract 1507.02, Sonoma County, California",104,95,9
1000000US060971507021001,060971507021001,"Block 1001, Block Group 1, Census Tract 1507.02, Sonoma County, California",22,20,2
1000000US060971507021002,060971507021002,"Block 1002, Block Group 1, Census Tract 1507.02, Sonoma County, California",0,0,0
1000000US060971507021003,060971507021003,"Block 1003, Block Group 1, Census Tract 1507.02, Sonoma County, California",0,0,0
1000000US060971507021004,060971507021004,"Block 1004, Block Group 1, Census Tract 1507.02, Sonoma County, California",1,1,0
1000000US060971507021005,060971507021005,"Block 1005, Block Group 1, Census Tract 1507.02, Sonoma County, California",1,1,0
1000000US060971507021006,060971507021006,"Block 1006, Block Group 1, Census Tract 1507.02, Sonoma County, California",0,0,0
1000000US060971507021007,060971507021007,"Block 1007, Block Group 1, Census Tract 1507.02, Sonoma County, California",1,1,0
1000000US060971507021008,060971507021008,"Block 1008, Block Group 1, Census Tract 1507.02, Sonoma County, California",137,132,5
1000000US060971507021009,060971507021009,"Block 1009, Block Group 1, Census Tract 1507.02, Sonoma County, California",2,2,0
1000000US060971507021010,060971507021010,"Block 1010, Block Group 1, Census Tract 1507.02, Sonoma County, California",5,5,0
1000000US060971507021011,060971507021011,"Block 1011, Block Group 1, Census Tract 1507.02, Sonoma County, California",19,19,0
1000000US060971507021012,060971507021012,"Block 1012, Block Group 1, Census Tract 1507.02, Sonoma County, California",0,0,0
1000000US060971507021013,060971507021013,"Block 1013, Block Group 1, Census Tract 1507.02, Sonoma County, California",128,125,3
1000000US060971507021014,060971507021014,"Block 1014, Block Group 1, Census Tract 1507.02, Sonoma County, California",20,19,1
1000000US060971507021015,060971507021015,"Block 1015, Block Group 1, Census Tract 1507.02, Sonoma County, California",12,12,0
1000000US060971507021016,060971507021016,"Block 1016, Block Group 1, Census Tract 1507.02, Sonoma County, California",6,6,0
1000000US060971507021017,060971507021017,"Block 1017, Block Group 1, Census Tract 1507.02, Sonoma County, California",2,2,0
1000000US060971507021018,060971507021018,"Block 1018, Block Group 1, Census Tract 1507.02, Sonoma County, California",8,6,2
1000000US060971507021019,060971507021019,"Block 1019, Block Group 1, Census Tract 1507.02, Sonoma County, California",0,0,0
1000000US060971507021020,060971507021020,"Block 1020, Block Group 1, Census Tract 1507.02, Sonoma County, California",2,1,1
1000000US060971507021021,060971507021021,"Block 1021, Block Group 1, Census Tract 1507.02, Sonoma County, California",6,6,0
1000000US060971507021022,060971507021022,"Block 1022, Block Group 1, Census Tract 1507.02, Sonoma County, California",13,12,1
1000000US060971507022000,060971507022000,"Block 2000, Block Group 2, Census Tract 1507.02, Sonoma County, California",128,124,4
1000000US060971507022001,060971507022001,"Block 2001, Block Group 2, Census Tract 1507.02, Sonoma County, California",44,40,4
1000000US060971507022002,060971507022002,"Block 2002, Block Group 2, Census Tract 1507.02, Sonoma County, California",17,16,1
1000000US060971507022003,060971507022003,"Block 2003, Block Group 2, Census Tract 1507.02, Sonoma County, California",113,111,2
1000000US060971507022004,060971507022004,"Block 2004, Block Group 2, Census Tract 1507.02, Sonoma County, California",23,23,0
1000000US060971507022005,060971507022005,"Block 2005, Block Group 2, Census Tract 1507.02, Sonoma County, California",27,25,2
1000000US060971507022006,060971507022006,"Block 2006, Block Group 2, Census Tract 1507.02, Sonoma County, California",10,10,0
1000000US060971507023000,060971507023000,"Block 3000, Block Group 3, Census Tract 1507.02, Sonoma County, California",158,151,7
1000000US060971507023001,060971507023001,"Block 3001, Block Group 3, Census Tract 1507.02, Sonoma County, California",119,112,7
1000000US060971507023002,060971507023002,"Block 3002, Block Group 3, Census Tract 1507.02, Sonoma County, California",4,4,0
1000000US060971507023003,060971507023003,"Block 3003, Block Group 3, Census Tract 1507.02, Sonoma County, California",22,20,2
1000000US060971507023004,060971507023004,"Block 3004, Block Group 3, Census Tract 1507.02, Sonoma County, California",176,176,0
1000000US060971507023005,060971507023005,"Block 3005, Block Group 3, Census Tract 1507.02, Sonoma County, California",0,0,0
1000000US060971507023006,060971507023006,"Block 3006, Block Group 3, Census Tract 1507.02, Sonoma County, California",2,2,0
1000000US060971507023007,060971507023007,"Block 3007, Block Group 3, Census Tract 1507.02, Sonoma County, California",6,6,0
1000000US060971507023008,060971507023008,"Block 3008, Block Group 3, Census Tract 1507.02, Sonoma County, California",11,9,2
1000000US060971507023009,060971507023009,"Block 3009, Block Group 3, Census Tract 1507.02, Sonoma County, California",2,2,0
1000000US060971507023010,060971507023010,"Block 3010, Block Group 3, Census Tract 1507.02, Sonoma County, California",0,0,0
1000000US060971507023011,060971507023011,"Block 3011, Block Group 3, Census Tract 1507.02, Sonoma County, California",36,36,0
1000000US060971507023012,060971507023012,"Block 3012, Block Group 3, Census Tract 1507.02, Sonoma County, California",18,18,0
1000000US060971507024000,060971507024000,"Block 4000, Block Group 4, Census Tract 1507.02, Sonoma County, California",76,73,3
1000000US060971507024001,060971507024001,"Block 4001, Block Group 4, Census Tract 1507.02, Sonoma County, California",2,2,0
1000000US060971507024002,060971507024002,"Block 4002, Block Group 4, Census Tract 1507.02, Sonoma County, California",39,37,2
1000000US060971507024003,060971507024003,"Block 4003, Block Group 4, Census Tract 1507.02, Sonoma County, California",65,65,0
1000000US060971507024004,060971507024004,"Block 4004, Block Group 4, Census Tract 1507.02, Sonoma County, California",28,28,0
1000000US060971507024005,060971507024005,"Block 4005, Block Group 4, Census Tract 1507.02, Sonoma County, California",32,31,1
1000000US060971507024006,060971507024006,"Block 4006, Block Group 4, Census Tract 1507.02, Sonoma County, California",21,21,0
1000000US060971507024007,060971507024007,"Block 4007, Block Group 4, Census Tract 1507.02, Sonoma County, California",153,149,4
1000000US060971508001000,060971508001000,"Block 1000, Block Group 1, Census Tract 1508, Sonoma County, California",66,62,4
1000000US060971508001001,060971508001001,"Block 1001, Block Group 1, Census Tract 1508, Sonoma County, California",24,21,3
1000000US060971508001002,060971508001002,"Block 1002, Block Group 1, Census Tract 1508, Sonoma County, California",111,103,8
1000000US060971508001003,060971508001003,"Block 1003, Block Group 1, Census Tract 1508, Sonoma County, California",75,74,1
1000000US060971508001004,060971508001004,"Block 1004, Block Group 1, Census Tract 1508, Sonoma County, California",8,8,0
1000000US060971508001005,060971508001005,"Block 1005, Block Group 1, Census Tract 1508, Sonoma County, California",30,27,3
1000000US060971508001006,060971508001006,"Block 1006, Block Group 1, Census Tract 1508, Sonoma County, California",0,0,0
1000000US060971508001007,060971508001007,"Block 1007, Block Group 1, Census Tract 1508, Sonoma County, California",14,13,1
1000000US060971508001008,060971508001008,"Block 1008, Block Group 1, Census Tract 1508, Sonoma County, California",14,12,2
1000000US060971508001009,060971508001009,"Block 1009, Block Group 1, Census Tract 1508, Sonoma County, California",19,19,0
1000000US060971508001010,060971508001010,"Block 1010, Block Group 1, Census Tract 1508, Sonoma County, California",18,18,0
1000000US060971508001011,060971508001011,"Block 1011, Block Group 1, Census Tract 1508, Sonoma County, California",24,24,0
1000000US060971508002000,060971508002000,"Block 2000, Block Group 2, Census Tract 1508, Sonoma County, California",52,50,2
1000000US060971508002001,060971508002001,"Block 2001, Block Group 2, Census Tract 1508, Sonoma County, California",39,35,4
1000000US060971508002002,060971508002002,"Block 2002, Block Group 2, Census Tract 1508, Sonoma County, California",40,38,2
1000000US060971508002003,060971508002003,"Block 2003, Block Group 2, Census Tract 1508, Sonoma County, California",17,17,0
1000000US060971508002004,060971508002004,"Block 2004, Block Group 2, Census Tract 1508, Sonoma County, California",45,41,4
1000000US060971508002005,060971508002005,"Block 2005, Block Group 2, Census Tract 1508, Sonoma County, California",37,34,3
1000000US060971508002006,060971508002006,"Block 2006, Block Group 2, Census Tract 1508, Sonoma County, California",168,158,10
1000000US060971508002007,060971508002007,"Block 2007, Block Group 2, Census Tract 1508, Sonoma County, California",46,42,4
1000000US060971508002008,060971508002008,"Block 2008, Block Group 2, Census Tract 1508, Sonoma County, California",64,59,5
1000000US060971508003000,060971508003000,"Block 3000, Block Group 3, Census Tract 1508, Sonoma County, California",6,6,0
1000000US060971508003001,060971508003001,"Block 3001, Block Group 3, Census Tract 1508, Sonoma County, California",0,0,0
1000000US060971508003002,060971508003002,"Block 3002, Block Group 3, Census Tract 1508, Sonoma County, California",16,14,2
1000000US060971508003003,060971508003003,"Block 3003, Block Group 3, Census Tract 1508, Sonoma County, California",1,1,0
1000000US060971508003004,060971508003004,"Block 3004, Block Group 3, Census Tract 1508, Sonoma County, California",58,56,2
1000000US060971508003005,060971508003005,"Block 3005, Block Group 3, Census Tract 1508, Sonoma County, California",43,40,3
1000000US060971508003006,060971508003006,"Block 3006, Block Group 3, Census Tract 1508, Sonoma County, California",20,20,0
1000000US060971508003007,060971508003007,"Block 3007, Block Group 3, Census Tract 1508, Sonoma County, California",27,24,3
1000000US060971508003008,060971508003008,"Block 3008, Block Group 3, Census Tract 1508, Sonoma County, California",28,25,3
1000000US060971508003009,060971508003009,"Block 3009, Block Group 3, Census Tract 1508, Sonoma County, California",32,32,0
1000000US060971508003010,060971508003010,"Block 3010, Block Group 3, Census Tract 1508, Sonoma County, California",0,0,0
1000000US060971508003011,060971508003011,"Block 3011, Block Group 3, Census Tract 1508, Sonoma County, California",16,15,1
1000000US060971508003012,060971508003012,"Block 3012, Block Group 3, Census Tract 1508, Sonoma County, California",21,19,2
1000000US060971508003013,060971508003013,"Block 3013, Block Group 3, Census Tract 1508, Sonoma County, California",29,29,0
1000000US060971508003014,060971508003014,"Block 3014, Block Group 3, Census Tract 1508, Sonoma County, California",46,46,0
1000000US060971508003015,060971508003015,"Block 3015, Block Group 3, Census Tract 1508, Sonoma County, California",5,4,1
1000000US060971508003016,060971508003016,"Block 3016, Block Group 3, Census Tract 1508, Sonoma County, California",25,25,0
1000000US060971508004000,060971508004000,"Block 4000, Block Group 4, Census Tract 1508, Sonoma County, California",0,0,0
1000000US060971508004001,060971508004001,"Block 4001, Block Group 4, Census Tract 1508, Sonoma County, California",15,13,2
1000000US060971508004002,060971508004002,"Block 4002, Block Group 4, Census Tract 1508, Sonoma County, California",43,40,3
1000000US060971508004003,060971508004003,"Block 4003, Block Group 4, Census Tract 1508, Sonoma County, California",289,278,11
1000000US060971508004004,060971508004004,"Block 4004, Block Group 4, Census Tract 1508, Sonoma County, California",21,19,2
1000000US060971508004005,060971508004005,"Block 4005, Block Group 4, Census Tract 1508, Sonoma County, California",22,22,0
1000000US060971508004006,060971508004006,"Block 4006, Block Group 4, Census Tract 1508, Sonoma County, California",8,8,0
1000000US060971508004007,060971508004007,"Block 4007, Block Group 4, Census Tract 1508, Sonoma County, California",8,8,0
1000000US060971508004008,060971508004008,"Block 4008, Block Group 4, Census Tract 1508, Sonoma County, California",27,27,0
1000000US060971508004009,060971508004009,"Block 4009, Block Group 4, Census Tract 1508, Sonoma County, California",45,43,2
1000000US060971508004010,060971508004010,"Block 4010, Block Group 4, Census Tract 1508, Sonoma County, California",10,10,0
1000000US060971508004011,060971508004011,"Block 4011, Block Group 4, Census Tract 1508, Sonoma County, California",23,22,1
1000000US060971508004012,060971508004012,"Block 4012, Block Group 4, Census Tract 1508, Sonoma County, California",45,44,1
1000000US060971508004013,060971508004013,"Block 4013, Block Group 4, Census Tract 1508, Sonoma County, California",0,0,0
1000000US060971508004014,060971508004014,"Block 4014, Block Group 4, Census Tract 1508, Sonoma County, California",17,17,0
1000000US060971508004015,060971508004015,"Block 4015, Block Group 4, Census Tract 1508, Sonoma County, California",0,0,0
1000000US060971508004016,060971508004016,"Block 4016, Block Group 4, Census Tract 1508, Sonoma County, California",0,0,0
1000000US060971508004017,060971508004017,"Block 4017, Block Group 4, Census Tract 1508, Sonoma County, California",29,29,0
1000000US060971508004018,060971508004018,"Block 4018, Block Group 4, Census Tract 1508, Sonoma County, California",0,0,0
1000000US060971508004019,060971508004019,"Block 4019, Block Group 4, Census Tract 1508, Sonoma County, California",0,0,0
1000000US060971508004020,060971508004020,"Block 4020, Block Group 4, Census Tract 1508, Sonoma County, California",13,13,0
1000000US060971508004021,060971508004021,"Block 4021, Block Group 4, Census Tract 1508, Sonoma County, California",0,0,0
1000000US060971508004022,060971508004022,"Block 4022, Block Group 4, Census Tract 1508, Sonoma County, California",9,9,0
1000000US060971508004023,060971508004023,"Block 4023, Block Group 4, Census Tract 1508, Sonoma County, California",3,2,1
1000000US060971508004024,060971508004024,"Block 4024, Block Group 4, Census Tract 1508, Sonoma County, California",12,10,2
1000000US060971508004025,060971508004025,"Block 4025, Block Group 4, Census Tract 1508, Sonoma County, California",1,1,0
1000000US060971508004026,060971508004026,"Block 4026, Block Group 4, Census Tract 1508, Sonoma County, California",0,0,0
1000000US060971508004027,060971508004027,"Block 4027, Block Group 4, Census Tract 1508, Sonoma County, California",4,4,0
1000000US060971508004028,060971508004028,"Block 4028, Block Group 4, Census Tract 1508, Sonoma County, California",6,5,1
1000000US060971508004029,060971508004029,"Block 4029, Block Group 4, Census Tract 1508, Sonoma County, California",21,20,1
1000000US060971508004030,060971508004030,"Block 4030, Block Group 4, Census Tract 1508, Sonoma County, California",43,39,4
1000000US060971508004031,060971508004031,"Block 4031, Block Group 4, Census Tract 1508, Sonoma County, California",46,44,2
1000000US060971508004032,060971508004032,"Block 4032, Block Group 4, Census Tract 1508, Sonoma County, California",23,23,0
1000000US060971508004033,060971508004033,"Block 4033, Block Group 4, Census Tract 1508, Sonoma County, California",0,0,0
1000000US060971508004034,060971508004034,"Block 4034, Block Group 4, Census Tract 1508, Sonoma County, California",4,4,0
1000000US060971509011000,060971509011000,"Block 1000, Block Group 1, Census Tract 1509.01, Sonoma County, California",0,0,0
1000000US060971509011001,060971509011001,"Block 1001, Block Group 1, Census Tract 1509.01, Sonoma County, California",4,4,0
1000000US060971509011002,060971509011002,"Block 1002, Block Group 1, Census Tract 1509.01, Sonoma County, California",0,0,0
1000000US060971509011003,060971509011003,"Block 1003, Block Group 1, Census Tract 1509.01, Sonoma County, California",1,1,0
1000000US060971509011004,060971509011004,"Block 1004, Block Group 1, Census Tract 1509.01, Sonoma County, California",10,10,0
1000000US060971509011005,060971509011005,"Block 1005, Block Group 1, Census Tract 1509.01, Sonoma County, California",31,29,2
1000000US060971509011006,060971509011006,"Block 1006, Block Group 1, Census Tract 1509.01, Sonoma County, California",14,12,2
1000000US060971509011007,060971509011007,"Block 1007, Block Group 1, Census Tract 1509.01, Sonoma County, California",12,11,1
1000000US060971509011008,060971509011008,"Block 1008, Block Group 1, Census Tract 1509.01, Sonoma County, California",19,19,0
1000000US060971509011009,060971509011009,"Block 1009, Block Group 1, Census Tract 1509.01, Sonoma County, California",44,40,4
1000000US060971509011010,060971509011010,"Block 1010, Block Group 1, Census Tract 1509.01, Sonoma County, California",35,34,1
1000000US060971509011011,060971509011011,"Block 1011, Block Group 1, Census Tract 1509.01, Sonoma County, California",18,17,1
1000000US060971509011012,060971509011012,"Block 1012, Block Group 1, Census Tract 1509.01, Sonoma County, California",0,0,0
1000000US060971509011013,060971509011013,"Block 1013, Block Group 1, Census Tract 1509.01, Sonoma County, California",122,94,28
1000000US060971509011014,060971509011014,"Block 1014, Block Group 1, Census Tract 1509.01, Sonoma County, California",25,25,0
1000000US060971509011015,060971509011015,"Block 1015, Block Group 1, Census Tract 1509.01, Sonoma County, California",21,21,0
1000000US060971509011016,060971509011016,"Block 1016, Block Group 1, Census Tract 1509.01, Sonoma County, California",16,15,1
1000000US060971509011017,060971509011017,"Block 1017, Block Group 1, Census Tract 1509.01, Sonoma County, California",21,21,0
1000000US060971509011018,060971509011018,"Block 1018, Block Group 1, Census Tract 1509.01, Sonoma County, California",15,14,1
1000000US060971509011019,060971509011019,"Block 1019, Block Group 1, Census Tract 1509.01, Sonoma County, California",0,0,0
1000000US060971509011020,060971509011020,"Block 1020, Block Group 1, Census Tract 1509.01, Sonoma County, California",0,0,0
1000000US060971509011021,060971509011021,"Block 1021, Block Group 1, Census Tract 1509.01, Sonoma County, California",0,0,0
1000000US060971509011022,060971509011022,"Block 1022, Block Group 1, Census Tract 1509.01, Sonoma County, California",0,0,0
1000000US060971509011023,060971509011023,"Block 1023, Block Group 1, Census Tract 1509.01, Sonoma County, California",81,79,2
1000000US060971509011024,060971509011024,"Block 1024, Block Group 1, Census Tract 1509.01, Sonoma County, California",1,1,0
1000000US060971509012000,060971509012000,"Block 2000, Block Group 2, Census Tract 1509.01, Sonoma County, California",14,14,0
1000000US060971509012001,060971509012001,"Block 2001, Block Group 2, Census Tract 1509.01, Sonoma County, California",24,24,0
1000000US060971509012002,060971509012002,"Block 2002, Block Group 2, Census Tract 1509.01, Sonoma County, California",29,28,1
1000000US060971509012003,060971509012003,"Block 2003, Block Group 2, Census Tract 1509.01, Sonoma County, California",64,60,4
1000000US060971509012004,060971509012004,"Block 2004, Block Group 2, Census Tract 1509.01, Sonoma County, California",8,8,0
1000000US060971509012005,060971509012005,"Block 2005, Block Group 2, Census Tract 1509.01, Sonoma County, California",0,0,0
1000000US060971509012006,060971509012006,"Block 2006, Block Group 2, Census Tract 1509.01, Sonoma County, California",16,14,2
1000000US060971509012007,060971509012007,"Block 2007, Block Group 2, Census Tract 1509.01, Sonoma County, California",37,37,0
1000000US060971509012008,060971509012008,"Block 2008, Block Group 2, Census Tract 1509.01, Sonoma County, California",6,6,0
1000000US060971509012009,060971509012009,"Block 2009, Block Group 2, Census Tract 1509.01, Sonoma County, California",56,54,2
1000000US060971509012010,060971509012010,"Block 2010, Block Group 2, Census Tract 1509.01, Sonoma County, California",6,6,0
1000000US060971509012011,060971509012011,"Block 2011, Block Group 2, Census Tract 1509.01, Sonoma County, California",45,43,2
1000000US060971509012012,060971509012012,"Block 2012, Block Group 2, Census Tract 1509.01, Sonoma County, California",26,25,1
1000000US060971509012013,060971509012013,"Block 2013, Block Group 2, Census Tract 1509.01, Sonoma County, California",6,6,0
1000000US060971509013000,060971509013000,"Block 3000, Block Group 3, Census Tract 1509.01, Sonoma County, California",159,153,6
1000000US060971509013001,060971509013001,"Block 3001, Block Group 3, Census Tract 1509.01, Sonoma County, California",16,15,1
1000000US060971509013002,060971509013002,"Block 3002, Block Group 3, Census Tract 1509.01, Sonoma County, California",17,17,0
1000000US060971509013003,060971509013003,"Block 3003, Block Group 3, Census Tract 1509.01, Sonoma County, California",22,22,0
1000000US060971509013004,060971509013004,"Block 3004, Block Group 3, Census Tract 1509.01, Sonoma County, California",31,29,2
1000000US060971509013005,060971509013005,"Block 3005, Block Group 3, Census Tract 1509.01, Sonoma County, California",96,92,4
1000000US060971509013006,060971509013006,"Block 3006, Block Group 3, Census Tract 1509.01, Sonoma County, California",46,45,1
1000000US060971509013007,060971509013007,"Block 3007, Block Group 3, Census Tract 1509.01, Sonoma County, California",47,47,0
1000000US060971509013008,060971509013008,"Block 3008, Block Group 3, Census Tract 1509.01, Sonoma County, California",11,11,0
1000000US060971509013009,060971509013009,"Block 3009, Block Group 3, Census Tract 1509.01, Sonoma County, California",0,0,0
1000000US060971509014000,060971509014000,"Block 4000, Block Group 4, Census Tract 1509.01, Sonoma County, California",0,0,0
1000000US060971509014001,060971509014001,"Block 4001, Block Group 4, Census Tract 1509.01, Sonoma County, California",0,0,0
1000000US060971509014002,060971509014002,"Block 4002, Block Group 4, Census Tract 1509.01, Sonoma County, California",135,129,6
1000000US060971509014003,060971509014003,"Block 4003, Block Group 4, Census Tract 1509.01, Sonoma County, California",23,22,1
1000000US060971509014004,060971509014004,"Block 4004, Block Group 4, Census Tract 1509.01, Sonoma County, California",33,31,2
1000000US060971509014005,060971509014005,"Block 4005, Block Group 4, Census Tract 1509.01, Sonoma County, California",36,34,2
1000000US060971509014006,060971509014006,"Block 4006, Block Group 4, Census Tract 1509.01, Sonoma County, California",11,10,1
1000000US060971509014007,060971509014007,"Block 4007, Block Group 4, Census Tract 1509.01, Sonoma County, California",36,36,0
1000000US060971509014008,060971509014008,"Block 4008, Block Group 4, Census Tract 1509.01, Sonoma County, California",11,11,0
1000000US060971509015000,060971509015000,"Block 5000, Block Group 5, Census Tract 1509.01, Sonoma County, California",0,0,0
1000000US060971509015001,060971509015001,"Block 5001, Block Group 5, Census Tract 1509.01, Sonoma County, California",0,0,0
1000000US060971509015002,060971509015002,"Block 5002, Block Group 5, Census Tract 1509.01, Sonoma County, California",0,0,0
1000000US060971509015003,060971509015003,"Block 5003, Block Group 5, Census Tract 1509.01, Sonoma County, California",0,0,0
1000000US060971509015004,060971509015004,"Block 5004, Block Group 5, Census Tract 1509.01, Sonoma County, California",6,6,0
1000000US060971509015005,060971509015005,"Block 5005, Block Group 5, Census Tract 1509.01, Sonoma County, California",0,0,0
1000000US060971509015006,060971509015006,"Block 5006, Block Group 5, Census Tract 1509.01, Sonoma County, California",0,0,0
1000000US060971509015007,060971509015007,"Block 5007, Block Group 5, Census Tract 1509.01, Sonoma County, California",4,4,0
1000000US060971509015008,060971509015008,"Block 5008, Block Group 5, Census Tract 1509.01, Sonoma County, California",6,6,0
1000000US060971509015009,060971509015009,"Block 5009, Block Group 5, Census Tract 1509.01, Sonoma County, California",4,3,1
1000000US060971509015010,060971509015010,"Block 5010, Block Group 5, Census Tract 1509.01, Sonoma County, California",0,0,0
1000000US060971509015011,060971509015011,"Block 5011, Block Group 5, Census Tract 1509.01, Sonoma County, California",8,6,2
1000000US060971509015012,060971509015012,"Block 5012, Block Group 5, Census Tract 1509.01, Sonoma County, California",9,7,2
1000000US060971509015013,060971509015013,"Block 5013, Block Group 5, Census Tract 1509.01, Sonoma County, California",2,2,0
1000000US060971509015014,060971509015014,"Block 5014, Block Group 5, Census Tract 1509.01, Sonoma County, California",39,39,0
1000000US060971509015015,060971509015015,"Block 5015, Block Group 5, Census Tract 1509.01, Sonoma County, California",16,15,1
1000000US060971509015016,060971509015016,"Block 5016, Block Group 5, Census Tract 1509.01, Sonoma County, California",8,8,0
1000000US060971509015017,060971509015017,"Block 5017, Block Group 5, Census Tract 1509.01, Sonoma County, California",0,0,0
1000000US060971509015018,060971509015018,"Block 5018, Block Group 5, Census Tract 1509.01, Sonoma County, California",28,28,0
1000000US060971509015019,060971509015019,"Block 5019, Block Group 5, Census Tract 1509.01, Sonoma County, California",231,221,10
1000000US060971509015020,060971509015020,"Block 5020, Block Group 5, Census Tract 1509.01, Sonoma County, California",0,0,0
1000000US060971509015021,060971509015021,"Block 5021, Block Group 5, Census Tract 1509.01, Sonoma County, California",8,8,0
1000000US060971509015022,060971509015022,"Block 5022, Block Group 5, Census Tract 1509.01, Sonoma County, California",1,1,0
1000000US060971509015023,060971509015023,"Block 5023, Block Group 5, Census Tract 1509.01, Sonoma County, California",18,18,0
1000000US060971509015024,060971509015024,"Block 5024, Block Group 5, Census Tract 1509.01, Sonoma County, California",17,15,2
1000000US060971509015025,060971509015025,"Block 5025, Block Group 5, Census Tract 1509.01, Sonoma County, California",29,28,1
1000000US060971509015026,060971509015026,"Block 5026, Block Group 5, Census Tract 1509.01, Sonoma County, California",0,0,0
1000000US060971509015027,060971509015027,"Block 5027, Block Group 5, Census Tract 1509.01, Sonoma County, California",0,0,0
1000000US060971509015028,060971509015028,"Block 5028, Block Group 5, Census Tract 1509.01, Sonoma County, California",0,0,0
1000000US060971509015029,060971509015029,"Block 5029, Block Group 5, Census Tract 1509.01, Sonoma County, California",11,11,0
1000000US060971509015030,060971509015030,"Block 5030, Block Group 5, Census Tract 1509.01, Sonoma County, California",15,12,3
1000000US060971509015031,060971509015031,"Block 5031, Block Group 5, Census Tract 1509.01, Sonoma County, California",12,12,0
1000000US060971509015032,060971509015032,"Block 5032, Block Group 5, Census Tract 1509.01, Sonoma County, California",38,36,2
1000000US060971509015033,060971509015033,"Block 5033, Block Group 5, Census Tract 1509.01, Sonoma County, California",14,13,1
1000000US060971509015034,060971509015034,"Block 5034, Block Group 5, Census Tract 1509.01, Sonoma County, California",11,11,0
1000000US060971509015035,060971509015035,"Block 5035, Block Group 5, Census Tract 1509.01, Sonoma County, California",12,12,0
1000000US060971509021000,060971509021000,"Block 1000, Block Group 1, Census Tract 1509.02, Sonoma County, California",0,0,0
1000000US060971509021001,060971509021001,"Block 1001, Block Group 1, Census Tract 1509.02, Sonoma County, California",0,0,0
1000000US060971509021002,060971509021002,"Block 1002, Block Group 1, Census Tract 1509.02, Sonoma County, California",0,0,0
1000000US060971509021003,060971509021003,"Block 1003, Block Group 1, Census Tract 1509.02, Sonoma County, California",0,0,0
1000000US060971509021004,060971509021004,"Block 1004, Block Group 1, Census Tract 1509.02, Sonoma County, California",106,99,7
1000000US060971509021005,060971509021005,"Block 1005, Block Group 1, Census Tract 1509.02, Sonoma County, California",1,1,0
1000000US060971509021006,060971509021006,"Block 1006, Block Group 1, Census Tract 1509.02, Sonoma County, California",3,3,0
1000000US060971509021007,060971509021007,"Block 1007, Block Group 1, Census Tract 1509.02, Sonoma County, California",0,0,0
1000000US060971509021008,060971509021008,"Block 1008, Block Group 1, Census Tract 1509.02, Sonoma County, California",0,0,0
1000000US060971509021009,060971509021009,"Block 1009, Block Group 1, Census Tract 1509.02, Sonoma County, California",96,94,2
1000000US060971509021010,060971509021010,"Block 1010, Block Group 1, Census Tract 1509.02, Sonoma County, California",9,9,0
1000000US060971509021011,060971509021011,"Block 1011, Block Group 1, Census Tract 1509.02, Sonoma County, California",0,0,0
1000000US060971509021012,060971509021012,"Block 1012, Block Group 1, Census Tract 1509.02, Sonoma County, California",0,0,0
1000000US060971509021013,060971509021013,"Block 1013, Block Group 1, Census Tract 1509.02, Sonoma County, California",0,0,0
1000000US060971509021014,060971509021014,"Block 1014, Block Group 1, Census Tract 1509.02, Sonoma County, California",89,85,4
1000000US060971509021015,060971509021015,"Block 1015, Block Group 1, Census Tract 1509.02, Sonoma County, California",16,16,0
1000000US060971509021016,060971509021016,"Block 1016, Block Group 1, Census Tract 1509.02, Sonoma County, California",1,1,0
1000000US060971509021017,060971509021017,"Block 1017, Block Group 1, Census Tract 1509.02, Sonoma County, California",0,0,0
1000000US060971509021018,060971509021018,"Block 1018, Block Group 1, Census Tract 1509.02, Sonoma County, California",54,51,3
1000000US060971509021019,060971509021019,"Block 1019, Block Group 1, Census Tract 1509.02, Sonoma County, California",12,12,0
1000000US060971509021020,060971509021020,"Block 1020, Block Group 1, Census Tract 1509.02, Sonoma County, California",11,11,0
1000000US060971509021021,060971509021021,"Block 1021, Block Group 1, Census Tract 1509.02, Sonoma County, California",5,5,0
1000000US060971509021022,060971509021022,"Block 1022, Block Group 1, Census Tract 1509.02, Sonoma County, California",50,49,1
1000000US060971509021023,060971509021023,"Block 1023, Block Group 1, Census Tract 1509.02, Sonoma County, California",6,5,1
1000000US060971509022000,060971509022000,"Block 2000, Block Group 2, Census Tract 1509.02, Sonoma County, California",59,58,1
1000000US060971509022001,060971509022001,"Block 2001, Block Group 2, Census Tract 1509.02, Sonoma County, California",23,23,0
1000000US060971509022002,060971509022002,"Block 2002, Block Group 2, Census Tract 1509.02, Sonoma County, California",97,91,6
1000000US060971509022003,060971509022003,"Block 2003, Block Group 2, Census Tract 1509.02, Sonoma County, California",13,13,0
1000000US060971509022004,060971509022004,"Block 2004, Block Group 2, Census Tract 1509.02, Sonoma County, California",0,0,0
1000000US060971509022005,060971509022005,"Block 2005, Block Group 2, Census Tract 1509.02, Sonoma County, California",50,47,3
1000000US060971509022006,060971509022006,"Block 2006, Block Group 2, Census Tract 1509.02, Sonoma County, California",84,83,1
1000000US060971509022007,060971509022007,"Block 2007, Block Group 2, Census Tract 1509.02, Sonoma County, California",29,28,1
1000000US060971509023000,060971509023000,"Block 3000, Block Group 3, Census Tract 1509.02, Sonoma County, California",194,185,9
1000000US060971509023001,060971509023001,"Block 3001, Block Group 3, Census Tract 1509.02, Sonoma County, California",2,2,0
1000000US060971509023002,060971509023002,"Block 3002, Block Group 3, Census Tract 1509.02, Sonoma County, California",28,27,1
1000000US060971509023003,060971509023003,"Block 3003, Block Group 3, Census Tract 1509.02, Sonoma County, California",44,43,1
1000000US060971509023004,060971509023004,"Block 3004, Block Group 3, Census Tract 1509.02, Sonoma County, California",13,13,0
1000000US060971509023005,060971509023005,"Block 3005, Block Group 3, Census Tract 1509.02, Sonoma County, California",39,37,2
1000000US060971509024000,060971509024000,"Block 4000, Block Group 4, Census Tract 1509.02, Sonoma County, California",9,9,0
1000000US060971509024001,060971509024001,"Block 4001, Block Group 4, Census Tract 1509.02, Sonoma County, California",18,18,0
1000000US060971509024002,060971509024002,"Block 4002, Block Group 4, Census Tract 1509.02, Sonoma County, California",24,23,1
1000000US060971509024003,060971509024003,"Block 4003, Block Group 4, Census Tract 1509.02, Sonoma County, California",16,15,1
1000000US060971509024004,060971509024004,"Block 4004, Block Group 4, Census Tract 1509.02, Sonoma County, California",9,8,1
1000000US060971509024005,060971509024005,"Block 4005, Block Group 4, Census Tract 1509.02, Sonoma County, California",16,15,1
1000000US060971509024006,060971509024006,"Block 4006, Block Group 4, Census Tract 1509.02, Sonoma County, California",13,12,1
1000000US060971509024007,060971509024007,"Block 4007, Block Group 4, Census Tract 1509.02, Sonoma County, California",35,32,3
1000000US060971509024008,060971509024008,"Block 4008, Block Group 4, Census Tract 1509.02, Sonoma County, California",38,38,0
1000000US060971509024009,060971509024009,"Block 4009, Block Group 4, Census Tract 1509.02, Sonoma County, California",30,28,2
1000000US060971509024010,060971509024010,"Block 4010, Block Group 4, Census Tract 1509.02, Sonoma County, California",36,35,1
1000000US060971509024011,060971509024011,"Block 4011, Block Group 4, Census Tract 1509.02, Sonoma County, California",3,2,1
1000000US060971509024012,060971509024012,"Block 4012, Block Group 4, Census Tract 1509.02, Sonoma County, California",22,22,0
1000000US060971509024013,060971509024013,"Block 4013, Block Group 4, Census Tract 1509.02, Sonoma County, California",47,43,4
1000000US060971509024014,060971509024014,"Block 4014, Block Group 4, Census Tract 1509.02, Sonoma County, California",0,0,0
1000000US060971509024015,060971509024015,"Block 4015, Block Group 4, Census Tract 1509.02, Sonoma County, California",7,5,2
1000000US060971509024016,060971509024016,"Block 4016, Block Group 4, Census Tract 1509.02, Sonoma County, California",0,0,0
1000000US060971509024017,060971509024017,"Block 4017, Block Group 4, Census Tract 1509.02, Sonoma County, California",0,0,0
1000000US060971510001000,060971510001000,"Block 1000, Block Group 1, Census Tract 1510, Sonoma County, California",8,8,0
1000000US060971510001001,060971510001001,"Block 1001, Block Group 1, Census Tract 1510, Sonoma County, California",38,37,1
1000000US060971510001002,060971510001002,"Block 1002, Block Group 1, Census Tract 1510, Sonoma County, California",0,0,0
1000000US060971510001003,060971510001003,"Block 1003, Block Group 1, Census Tract 1510, Sonoma County, California",64,58,6
1000000US060971510001004,060971510001004,"Block 1004, Block Group 1, Census Tract 1510, Sonoma County, California",60,56,4
1000000US060971510001005,060971510001005,"Block 1005, Block Group 1, Census Tract 1510, Sonoma County, California",0,0,0
1000000US060971510001006,060971510001006,"Block 1006, Block Group 1, Census Tract 1510, Sonoma County, California",0,0,0
1000000US060971510001007,060971510001007,"Block 1007, Block Group 1, Census Tract 1510, Sonoma County, California",0,0,0
1000000US060971510001008,060971510001008,"Block 1008, Block Group 1, Census Tract 1510, Sonoma County, California",0,0,0
1000000US060971510001009,060971510001009,"Block 1009, Block Group 1, Census Tract 1510, Sonoma County, California",4,4,0
1000000US060971510001010,060971510001010,"Block 1010, Block Group 1, Census Tract 1510, Sonoma County, California",17,17,0
1000000US060971510001011,060971510001011,"Block 1011, Block Group 1, Census Tract 1510, Sonoma County, California",41,41,0
1000000US060971510001012,060971510001012,"Block 1012, Block Group 1, Census Tract 1510, Sonoma County, California",50,47,3
1000000US060971510001013,060971510001013,"Block 1013, Block Group 1, Census Tract 1510, Sonoma County, California",154,141,13
1000000US060971510001014,060971510001014,"Block 1014, Block Group 1, Census Tract 1510, Sonoma County, California",4,4,0
1000000US060971510001015,060971510001015,"Block 1015, Block Group 1, Census Tract 1510, Sonoma County, California",0,0,0
1000000US060971510001016,060971510001016,"Block 1016, Block Group 1, Census Tract 1510, Sonoma County, California",5,5,0
1000000US060971510001017,060971510001017,"Block 1017, Block Group 1, Census Tract 1510, Sonoma County, California",0,0,0
1000000US060971510001018,060971510001018,"Block 1018, Block Group 1, Census Tract 1510, Sonoma County, California",0,0,0
1000000US060971510001019,060971510001019,"Block 1019, Block Group 1, Census Tract 1510, Sonoma County, California",0,0,0
1000000US060971510001020,060971510001020,"Block 1020, Block Group 1, Census Tract 1510, Sonoma County, California",0,0,0
1000000US060971510001021,060971510001021,"Block 1021, Block Group 1, Census Tract 1510, Sonoma County, California",0,0,0
1000000US060971510001022,060971510001022,"Block 1022, Block Group 1, Census Tract 1510, Sonoma County, California",0,0,0
1000000US060971510001023,060971510001023,"Block 1023, Block Group 1, Census Tract 1510, Sonoma County, California",0,0,0
1000000US060971510001024,060971510001024,"Block 1024, Block Group 1, Census Tract 1510, Sonoma County, California",0,0,0
1000000US060971510001025,060971510001025,"Block 1025, Block Group 1, Census Tract 1510, Sonoma County, California",0,0,0
1000000US060971510001026,060971510001026,"Block 1026, Block Group 1, Census Tract 1510, Sonoma County, California",0,0,0
1000000US060971510001027,060971510001027,"Block 1027, Block Group 1, Census Tract 1510, Sonoma County, California",0,0,0
1000000US060971510001028,060971510001028,"Block 1028, Block Group 1, Census Tract 1510, Sonoma County, California",0,0,0
1000000US060971510001029,060971510001029,"Block 1029, Block Group 1, Census Tract 1510, Sonoma County, California",0,0,0
1000000US060971510001030,060971510001030,"Block 1030, Block Group 1, Census Tract 1510, Sonoma County, California",0,0,0
1000000US060971510001031,060971510001031,"Block 1031, Block Group 1, Census Tract 1510, Sonoma County, California",0,0,0
1000000US060971510001032,060971510001032,"Block 1032, Block Group 1, Census Tract 1510, Sonoma County, California",0,0,0
1000000US060971510001033,060971510001033,"Block 1033, Block Group 1, Census Tract 1510, Sonoma County, California",12,12,0
1000000US060971510001034,060971510001034,"Block 1034, Block Group 1, Census Tract 1510, Sonoma County, California",0,0,0
1000000US060971510001035,060971510001035,"Block 1035, Block Group 1, Census Tract 1510, Sonoma County, California",0,0,0
1000000US060971510001036,060971510001036,"Block 1036, Block Group 1, Census Tract 1510, Sonoma County, California",1,1,0
1000000US060971510001037,060971510001037,"Block 1037, Block Group 1, Census Tract 1510, Sonoma County, California",0,0,0
1000000US060971510001038,060971510001038,"Block 1038, Block Group 1, Census Tract 1510, Sonoma County, California",3,2,1
1000000US060971510001039,060971510001039,"Block 1039, Block Group 1, Census Tract 1510, Sonoma County, California",0,0,0
1000000US060971510001040,060971510001040,"Block 1040, Block Group 1, Census Tract 1510, Sonoma County, California",0,0,0
1000000US060971510001041,060971510001041,"Block 1041, Block Group 1, Census Tract 1510, Sonoma County, California",0,0,0
1000000US060971510002000,060971510002000,"Block 2000, Block Group 2, Census Tract 1510, Sonoma County, California",0,0,0
1000000US060971510002001,060971510002001,"Block 2001, Block Group 2, Census Tract 1510, Sonoma County, California",0,0,0
1000000US060971510002002,060971510002002,"Block 2002, Block Group 2, Census Tract 1510, Sonoma County, California",137,132,5
1000000US060971510002003,060971510002003,"Block 2003, Block Group 2, Census Tract 1510, Sonoma County, California",0,0,0
1000000US060971510002004,060971510002004,"Block 2004, Block Group 2, Census Tract 1510, Sonoma County, California",72,63,9
1000000US060971510002005,060971510002005,"Block 2005, Block Group 2, Census Tract 1510, Sonoma County, California",38,38,0
1000000US060971510002006,060971510002006,"Block 2006, Block Group 2, Census Tract 1510, Sonoma County, California",1,1,0
1000000US060971510002007,060971510002007,"Block 2007, Block Group 2, Census Tract 1510, Sonoma County, California",74,70,4
1000000US060971510002008,060971510002008,"Block 2008, Block Group 2, Census Tract 1510, Sonoma County, California",125,117,8
1000000US060971510002009,060971510002009,"Block 2009, Block Group 2, Census Tract 1510, Sonoma County, California",33,33,0
1000000US060971510003000,060971510003000,"Block 3000, Block Group 3, Census Tract 1510, Sonoma County, California",18,16,2
1000000US060971510003001,060971510003001,"Block 3001, Block Group 3, Census Tract 1510, Sonoma County, California",10,10,0
1000000US060971510003002,060971510003002,"Block 3002, Block Group 3, Census Tract 1510, Sonoma County, California",23,21,2
1000000US060971510003003,060971510003003,"Block 3003, Block Group 3, Census Tract 1510, Sonoma County, California",0,0,0
1000000US060971510003004,060971510003004,"Block 3004, Block Group 3, Census Tract 1510, Sonoma County, California",6,6,0
1000000US060971510003005,060971510003005,"Block 3005, Block Group 3, Census Tract 1510, Sonoma County, California",69,64,5
1000000US060971510003006,060971510003006,"Block 3006, Block Group 3, Census Tract 1510, Sonoma County, California",0,0,0
1000000US060971510003007,060971510003007,"Block 3007, Block Group 3, Census Tract 1510, Sonoma County, California",0,0,0
1000000US060971510003008,060971510003008,"Block 3008, Block Group 3, Census Tract 1510, Sonoma County, California",46,45,1
1000000US060971510003009,060971510003009,"Block 3009, Block Group 3, Census Tract 1510, Sonoma County, California",1,1,0
1000000US060971510003010,060971510003010,"Block 3010, Block Group 3, Census Tract 1510, Sonoma County, California",0,0,0
1000000US060971510003011,060971510003011,"Block 3011, Block Group 3, Census Tract 1510, Sonoma County, California",0,0,0
1000000US060971510003012,060971510003012,"Block 3012, Block Group 3, Census Tract 1510, Sonoma County, California",103,93,10
1000000US060971510003013,060971510003013,"Block 3013, Block Group 3, Census Tract 1510, Sonoma County, California",34,29,5
1000000US060971510003014,060971510003014,"Block 3014, Block Group 3, Census Tract 1510, Sonoma County, California",11,11,0
1000000US060971510003015,060971510003015,"Block 3015, Block Group 3, Census Tract 1510, Sonoma County, California",101,94,7
1000000US060971510003016,060971510003016,"Block 3016, Block Group 3, Census Tract 1510, Sonoma County, California",16,14,2
1000000US060971510003017,060971510003017,"Block 3017, Block Group 3, Census Tract 1510, Sonoma County, California",59,56,3
1000000US060971510003018,060971510003018,"Block 3018, Block Group 3, Census Tract 1510, Sonoma County, California",43,38,5
1000000US060971511001000,060971511001000,"Block 1000, Block Group 1, Census Tract 1511, Sonoma County, California",46,40,6
1000000US060971511001001,060971511001001,"Block 1001, Block Group 1, Census Tract 1511, Sonoma County, California",15,14,1
1000000US060971511001002,060971511001002,"Block 1002, Block Group 1, Census Tract 1511, Sonoma County, California",52,51,1
1000000US060971511001003,060971511001003,"Block 1003, Block Group 1, Census Tract 1511, Sonoma County, California",21,20,1
1000000US060971511001004,060971511001004,"Block 1004, Block Group 1, Census Tract 1511, Sonoma County, California",26,26,0
1000000US060971511001005,060971511001005,"Block 1005, Block Group 1, Census Tract 1511, Sonoma County, California",3,3,0
1000000US060971511001006,060971511001006,"Block 1006, Block Group 1, Census Tract 1511, Sonoma County, California",115,110,5
1000000US060971511001007,060971511001007,"Block 1007, Block Group 1, Census Tract 1511, Sonoma County, California",0,0,0
1000000US060971511001008,060971511001008,"Block 1008, Block Group 1, Census Tract 1511, Sonoma County, California",40,39,1
1000000US060971511001009,060971511001009,"Block 1009, Block Group 1, Census Tract 1511, Sonoma County, California",2,2,0
1000000US060971511001010,060971511001010,"Block 1010, Block Group 1, Census Tract 1511, Sonoma County, California",2,2,0
1000000US060971511001011,060971511001011,"Block 1011, Block Group 1, Census Tract 1511, Sonoma County, California",21,19,2
1000000US060971511001012,060971511001012,"Block 1012, Block Group 1, Census Tract 1511, Sonoma County, California",12,8,4
1000000US060971511001013,060971511001013,"Block 1013, Block Group 1, Census Tract 1511, Sonoma County, California",7,7,0
1000000US060971511001014,060971511001014,"Block 1014, Block Group 1, Census Tract 1511, Sonoma County, California",0,0,0
1000000US060971511001015,060971511001015,"Block 1015, Block Group 1, Census Tract 1511, Sonoma County, California",2,2,0
1000000US060971511001016,060971511001016,"Block 1016, Block Group 1, Census Tract 1511, Sonoma County, California",5,5,0
1000000US060971511001017,060971511001017,"Block 1017, Block Group 1, Census Tract 1511, Sonoma County, California",5,4,1
1000000US060971511001018,060971511001018,"Block 1018, Block Group 1, Census Tract 1511, Sonoma County, California",25,23,2
1000000US060971511001019,060971511001019,"Block 1019, Block Group 1, Census Tract 1511, Sonoma County, California",0,0,0
1000000US060971511001020,060971511001020,"Block 1020, Block Group 1, Census Tract 1511, Sonoma County, California",44,36,8
1000000US060971511001021,060971511001021,"Block 1021, Block Group 1, Census Tract 1511, Sonoma County, California",0,0,0
1000000US060971511001022,060971511001022,"Block 1022, Block Group 1, Census Tract 1511, Sonoma County, California",0,0,0
1000000US060971511001023,060971511001023,"Block 1023, Block Group 1, Census Tract 1511, Sonoma County, California",0,0,0
1000000US060971511001024,060971511001024,"Block 1024, Block Group 1, Census Tract 1511, Sonoma County, California",0,0,0
1000000US060971511001025,060971511001025,"Block 1025, Block Group 1, Census Tract 1511, Sonoma County, California",1,1,0
1000000US060971511001026,060971511001026,"Block 1026, Block Group 1, Census Tract 1511, Sonoma County, California",2,2,0
1000000US060971511001027,060971511001027,"Block 1027, Block Group 1, Census Tract 1511, Sonoma County, California",0,0,0
1000000US060971511001028,060971511001028,"Block 1028, Block Group 1, Census Tract 1511, Sonoma County, California",8,4,4
1000000US060971511001029,060971511001029,"Block 1029, Block Group 1, Census Tract 1511, Sonoma County, California",0,0,0
1000000US060971511001030,060971511001030,"Block 1030, Block Group 1, Census Tract 1511, Sonoma County, California",29,23,6
1000000US060971511001031,060971511001031,"Block 1031, Block Group 1, Census Tract 1511, Sonoma County, California",1,1,0
1000000US060971511001032,060971511001032,"Block 1032, Block Group 1, Census Tract 1511, Sonoma County, California",0,0,0
1000000US060971511001033,060971511001033,"Block 1033, Block Group 1, Census Tract 1511, Sonoma County, California",1,1,0
1000000US060971511001034,060971511001034,"Block 1034, Block Group 1, Census Tract 1511, Sonoma County, California",0,0,0
1000000US060971511001035,060971511001035,"Block 1035, Block Group 1, Census Tract 1511, Sonoma County, California",2,2,0
1000000US060971511001036,060971511001036,"Block 1036, Block Group 1, Census Tract 1511, Sonoma County, California",0,0,0
1000000US060971511001037,060971511001037,"Block 1037, Block Group 1, Census Tract 1511, Sonoma County, California",0,0,0
1000000US060971511001038,060971511001038,"Block 1038, Block Group 1, Census Tract 1511, Sonoma County, California",0,0,0
1000000US060971511001039,060971511001039,"Block 1039, Block Group 1, Census Tract 1511, Sonoma County, California",0,0,0
1000000US060971511001040,060971511001040,"Block 1040, Block Group 1, Census Tract 1511, Sonoma County, California",2,2,0
1000000US060971511001041,060971511001041,"Block 1041, Block Group 1, Census Tract 1511, Sonoma County, California",0,0,0
1000000US060971511001042,060971511001042,"Block 1042, Block Group 1, Census Tract 1511, Sonoma County, California",5,5,0
1000000US060971511001043,060971511001043,"Block 1043, Block Group 1, Census Tract 1511, Sonoma County, California",7,7,0
1000000US060971511001044,060971511001044,"Block 1044, Block Group 1, Census Tract 1511, Sonoma County, California",0,0,0
1000000US060971511001045,060971511001045,"Block 1045, Block Group 1, Census Tract 1511, Sonoma County, California",0,0,0
1000000US060971511001046,060971511001046,"Block 1046, Block Group 1, Census Tract 1511, Sonoma County, California",0,0,0
1000000US060971511001047,060971511001047,"Block 1047, Block Group 1, Census Tract 1511, Sonoma County, California",0,0,0
1000000US060971511001048,060971511001048,"Block 1048, Block Group 1, Census Tract 1511, Sonoma County, California",0,0,0
1000000US060971511001049,060971511001049,"Block 1049, Block Group 1, Census Tract 1511, Sonoma County, California",0,0,0
1000000US060971511001050,060971511001050,"Block 1050, Block Group 1, Census Tract 1511, Sonoma County, California",60,55,5
1000000US060971511001051,060971511001051,"Block 1051, Block Group 1, Census Tract 1511, Sonoma County, California",0,0,0
1000000US060971511001052,060971511001052,"Block 1052, Block Group 1, Census Tract 1511, Sonoma County, California",0,0,0
1000000US060971511001053,060971511001053,"Block 1053, Block Group 1, Census Tract 1511, Sonoma County, California",20,18,2
1000000US060971511001054,060971511001054,"Block 1054, Block Group 1, Census Tract 1511, Sonoma County, California",14,11,3
1000000US060971511001055,060971511001055,"Block 1055, Block Group 1, Census Tract 1511, Sonoma County, California",0,0,0
1000000US060971511001056,060971511001056,"Block 1056, Block Group 1, Census Tract 1511, Sonoma County, California",0,0,0
1000000US060971511001057,060971511001057,"Block 1057, Block Group 1, Census Tract 1511, Sonoma County, California",0,0,0
1000000US060971511001058,060971511001058,"Block 1058, Block Group 1, Census Tract 1511, Sonoma County, California",0,0,0
1000000US060971511001059,060971511001059,"Block 1059, Block Group 1, Census Tract 1511, Sonoma County, California",12,11,1
1000000US060971511001060,060971511001060,"Block 1060, Block Group 1, Census Tract 1511, Sonoma County, California",8,8,0
1000000US060971511001061,060971511001061,"Block 1061, Block Group 1, Census Tract 1511, Sonoma County, California",0,0,0
1000000US060971511001062,060971511001062,"Block 1062, Block Group 1, Census Tract 1511, Sonoma County, California",2,2,0
1000000US060971511001063,060971511001063,"Block 1063, Block Group 1, Census Tract 1511, Sonoma County, California",1,1,0
1000000US060971511001064,060971511001064,"Block 1064, Block Group 1, Census Tract 1511, Sonoma County, California",0,0,0
1000000US060971511001065,060971511001065,"Block 1065, Block Group 1, Census Tract 1511, Sonoma County, California",0,0,0
1000000US060971511001066,060971511001066,"Block 1066, Block Group 1, Census Tract 1511, Sonoma County, California",0,0,0
1000000US060971511001067,060971511001067,"Block 1067, Block Group 1, Census Tract 1511, Sonoma County, California",0,0,0
1000000US060971511001068,060971511001068,"Block 1068, Block Group 1, Census Tract 1511, Sonoma County, California",17,13,4
1000000US060971511001069,060971511001069,"Block 1069, Block Group 1, Census Tract 1511, Sonoma County, California",0,0,0
1000000US060971511001070,060971511001070,"Block 1070, Block Group 1, Census Tract 1511, Sonoma County, California",1,1,0
1000000US060971511001071,060971511001071,"Block 1071, Block Group 1, Census Tract 1511, Sonoma County, California",3,3,0
1000000US060971511001072,060971511001072,"Block 1072, Block Group 1, Census Tract 1511, Sonoma County, California",0,0,0
1000000US060971511001073,060971511001073,"Block 1073, Block Group 1, Census Tract 1511, Sonoma County, California",1,0,1
1000000US060971511002000,060971511002000,"Block 2000, Block Group 2, Census Tract 1511, Sonoma County, California",24,23,1
1000000US060971511002001,060971511002001,"Block 2001, Block Group 2, Census Tract 1511, Sonoma County, California",92,91,1
1000000US060971511002002,060971511002002,"Block 2002, Block Group 2, Census Tract 1511, Sonoma County, California",158,152,6
1000000US060971511002003,060971511002003,"Block 2003, Block Group 2, Census Tract 1511, Sonoma County, California",6,5,1
1000000US060971511002004,060971511002004,"Block 2004, Block Group 2, Census Tract 1511, Sonoma County, California",4,4,0
1000000US060971511002005,060971511002005,"Block 2005, Block Group 2, Census Tract 1511, Sonoma County, California",0,0,0
1000000US060971511002006,060971511002006,"Block 2006, Block Group 2, Census Tract 1511, Sonoma County, California",38,35,3
1000000US060971511002007,060971511002007,"Block 2007, Block Group 2, Census Tract 1511, Sonoma County, California",0,0,0
1000000US060971511002008,060971511002008,"Block 2008, Block Group 2, Census Tract 1511, Sonoma County, California",1,1,0
1000000US060971511002009,060971511002009,"Block 2009, Block Group 2, Census Tract 1511, Sonoma County, California",43,38,5
1000000US060971511002010,060971511002010,"Block 2010, Block Group 2, Census Tract 1511, Sonoma County, California",153,148,5
1000000US060971511002011,060971511002011,"Block 2011, Block Group 2, Census Tract 1511, Sonoma County, California",67,62,5
1000000US060971511002012,060971511002012,"Block 2012, Block Group 2, Census Tract 1511, Sonoma County, California",77,71,6
1000000US060971511002013,060971511002013,"Block 2013, Block Group 2, Census Tract 1511, Sonoma County, California",5,5,0
1000000US060971511002014,060971511002014,"Block 2014, Block Group 2, Census Tract 1511, Sonoma County, California",41,37,4
1000000US060971511002015,060971511002015,"Block 2015, Block Group 2, Census Tract 1511, Sonoma County, California",115,111,4
1000000US060971511002016,060971511002016,"Block 2016, Block Group 2, Census Tract 1511, Sonoma County, California",9,8,1
1000000US060971511003000,060971511003000,"Block 3000, Block Group 3, Census Tract 1511, Sonoma County, California",109,104,5
1000000US060971511003001,060971511003001,"Block 3001, Block Group 3, Census Tract 1511, Sonoma County, California",201,180,21
1000000US060971511003002,060971511003002,"Block 3002, Block Group 3, Census Tract 1511, Sonoma County, California",9,9,0
1000000US060971511003003,060971511003003,"Block 3003, Block Group 3, Census Tract 1511, Sonoma County, California",21,16,5
1000000US060971511003004,060971511003004,"Block 3004, Block Group 3, Census Tract 1511, Sonoma County, California",33,33,0
1000000US060971511003005,060971511003005,"Block 3005, Block Group 3, Census Tract 1511, Sonoma County, California",0,0,0
1000000US060971511003006,060971511003006,"Block 3006, Block Group 3, Census Tract 1511, Sonoma County, California",0,0,0
1000000US060971511003007,060971511003007,"Block 3007, Block Group 3, Census Tract 1511, Sonoma County, California",19,15,4
1000000US060971511003008,060971511003008,"Block 3008, Block Group 3, Census Tract 1511, Sonoma County, California",13,12,1
1000000US060971511003009,060971511003009,"Block 3009, Block Group 3, Census Tract 1511, Sonoma County, California",0,0,0
1000000US060971511003010,060971511003010,"Block 3010, Block Group 3, Census Tract 1511, Sonoma County, California",0,0,0
1000000US060971511003011,060971511003011,"Block 3011, Block Group 3, Census Tract 1511, Sonoma County, California",0,0,0
1000000US060971511003012,060971511003012,"Block 3012, Block Group 3, Census Tract 1511, Sonoma County, California",0,0,0
1000000US060971511003013,060971511003013,"Block 3013, Block Group 3, Census Tract 1511, Sonoma County, California",0,0,0
1000000US060971511003014,060971511003014,"Block 3014, Block Group 3, Census Tract 1511, Sonoma County, California",0,0,0
1000000US060971511003015,060971511003015,"Block 3015, Block Group 3, Census Tract 1511, Sonoma County, California",59,54,5
1000000US060971511003016,060971511003016,"Block 3016, Block Group 3, Census Tract 1511, Sonoma County, California",15,14,1
1000000US060971511003017,060971511003017,"Block 3017, Block Group 3, Census Tract 1511, Sonoma County, California",0,0,0
1000000US060971511003018,060971511003018,"Block 3018, Block Group 3, Census Tract 1511, Sonoma County, California",0,0,0
1000000US060971512011000,060971512011000,"Block 1000, Block Group 1, Census Tract 1512.01, Sonoma County, California",0,0,0
1000000US060971512011001,060971512011001,"Block 1001, Block Group 1, Census Tract 1512.01, Sonoma County, California",0,0,0
1000000US060971512011002,060971512011002,"Block 1002, Block Group 1, Census Tract 1512.01, Sonoma County, California",0,0,0
1000000US060971512011003,060971512011003,"Block 1003, Block Group 1, Census Tract 1512.01, Sonoma County, California",4,4,0
1000000US060971512011004,060971512011004,"Block 1004, Block Group 1, Census Tract 1512.01, Sonoma County, California",12,8,4
1000000US060971512011005,060971512011005,"Block 1005, Block Group 1, Census Tract 1512.01, Sonoma County, California",0,0,0
1000000US060971512011006,060971512011006,"Block 1006, Block Group 1, Census Tract 1512.01, Sonoma County, California",0,0,0
1000000US060971512011007,060971512011007,"Block 1007, Block Group 1, Census Tract 1512.01, Sonoma County, California",0,0,0
1000000US060971512011008,060971512011008,"Block 1008, Block Group 1, Census Tract 1512.01, Sonoma County, California",0,0,0
1000000US060971512011009,060971512011009,"Block 1009, Block Group 1, Census Tract 1512.01, Sonoma County, California",0,0,0
1000000US060971512011010,060971512011010,"Block 1010, Block Group 1, Census Tract 1512.01, Sonoma County, California",0,0,0
1000000US060971512011011,060971512011011,"Block 1011, Block Group 1, Census Tract 1512.01, Sonoma County, California",0,0,0
1000000US060971512011012,060971512011012,"Block 1012, Block Group 1, Census Tract 1512.01, Sonoma County, California",0,0,0
1000000US060971512011013,060971512011013,"Block 1013, Block Group 1, Census Tract 1512.01, Sonoma County, California",0,0,0
1000000US060971512011014,060971512011014,"Block 1014, Block Group 1, Census Tract 1512.01, Sonoma County, California",0,0,0
1000000US060971512011015,060971512011015,"Block 1015, Block Group 1, Census Tract 1512.01, Sonoma County, California",1,1,0
1000000US060971512011016,060971512011016,"Block 1016, Block Group 1, Census Tract 1512.01, Sonoma County, California",0,0,0
1000000US060971512011017,060971512011017,"Block 1017, Block Group 1, Census Tract 1512.01, Sonoma County, California",0,0,0
1000000US060971512011018,060971512011018,"Block 1018, Block Group 1, Census Tract 1512.01, Sonoma County, California",329,311,18
1000000US060971512011019,060971512011019,"Block 1019, Block Group 1, Census Tract 1512.01, Sonoma County, California",29,27,2
1000000US060971512011020,060971512011020,"Block 1020, Block Group 1, Census Tract 1512.01, Sonoma County, California",22,21,1
1000000US060971512011021,060971512011021,"Block 1021, Block Group 1, Census Tract 1512.01, Sonoma County, California",0,0,0
1000000US060971512011022,060971512011022,"Block 1022, Block Group 1, Census Tract 1512.01, Sonoma County, California",0,0,0
1000000US060971512011023,060971512011023,"Block 1023, Block Group 1, Census Tract 1512.01, Sonoma County, California",129,124,5
1000000US060971512011024,060971512011024,"Block 1024, Block Group 1, Census Tract 1512.01, Sonoma County, California",20,17,3
1000000US060971512011025,060971512011025,"Block 1025, Block Group 1, Census Tract 1512.01, Sonoma County, California",0,0,0
1000000US060971512011026,060971512011026,"Block 1026, Block Group 1, Census Tract 1512.01, Sonoma County, California",0,0,0
1000000US060971512011027,060971512011027,"Block 1027, Block Group 1, Census Tract 1512.01, Sonoma County, California",0,0,0
1000000US060971512011028,060971512011028,"Block 1028, Block Group 1, Census Tract 1512.01, Sonoma County, California",0,0,0
1000000US060971512011029,060971512011029,"Block 1029, Block Group 1, Census Tract 1512.01, Sonoma County, California",0,0,0
1000000US060971512011030,060971512011030,"Block 1030, Block Group 1, Census Tract 1512.01, Sonoma County, California",0,0,0
1000000US060971512011031,060971512011031,"Block 1031, Block Group 1, Census Tract 1512.01, Sonoma County, California",0,0,0
1000000US060971512011032,060971512011032,"Block 1032, Block Group 1, Census Tract 1512.01, Sonoma County, California",0,0,0
1000000US060971512011033,060971512011033,"Block 1033, Block Group 1, Census Tract 1512.01, Sonoma County, California",0,0,0
1000000US060971512011034,060971512011034,"Block 1034, Block Group 1, Census Tract 1512.01, Sonoma County, California",44,43,1
1000000US060971512011035,060971512011035,"Block 1035, Block Group 1, Census Tract 1512.01, Sonoma County, California",0,0,0
1000000US060971512011036,060971512011036,"Block 1036, Block Group 1, Census Tract 1512.01, Sonoma County, California",0,0,0
1000000US060971512011037,060971512011037,"Block 1037, Block Group 1, Census Tract 1512.01, Sonoma County, California",0,0,0
1000000US060971512012000,060971512012000,"Block 2000, Block Group 2, Census Tract 1512.01, Sonoma County, California",0,0,0
1000000US060971512012001,060971512012001,"Block 2001, Block Group 2, Census Tract 1512.01, Sonoma County, California",65,62,3
1000000US060971512012002,060971512012002,"Block 2002, Block Group 2, Census Tract 1512.01, Sonoma County, California",25,24,1
1000000US060971512012003,060971512012003,"Block 2003, Block Group 2, Census Tract 1512.01, Sonoma County, California",74,72,2
1000000US060971512012004,060971512012004,"Block 2004, Block Group 2, Census Tract 1512.01, Sonoma County, California",0,0,0
1000000US060971512012005,060971512012005,"Block 2005, Block Group 2, Census Tract 1512.01, Sonoma County, California",2,2,0
1000000US060971512012006,060971512012006,"Block 2006, Block Group 2, Census Tract 1512.01, Sonoma County, California",35,34,1
1000000US060971512012007,060971512012007,"Block 2007, Block Group 2, Census Tract 1512.01, Sonoma County, California",3,3,0
1000000US060971512012008,060971512012008,"Block 2008, Block Group 2, Census Tract 1512.01, Sonoma County, California",0,0,0
1000000US060971512012009,060971512012009,"Block 2009, Block Group 2, Census Tract 1512.01, Sonoma County, California",0,0,0
1000000US060971512012010,060971512012010,"Block 2010, Block Group 2, Census Tract 1512.01, Sonoma County, California",0,0,0
1000000US060971512012011,060971512012011,"Block 2011, Block Group 2, Census Tract 1512.01, Sonoma County, California",0,0,0
1000000US060971512012012,060971512012012,"Block 2012, Block Group 2, Census Tract 1512.01, Sonoma County, California",23,23,0
1000000US060971512012013,060971512012013,"Block 2013, Block Group 2, Census Tract 1512.01, Sonoma County, California",13,11,2
1000000US060971512012014,060971512012014,"Block 2014, Block Group 2, Census Tract 1512.01, Sonoma County, California",0,0,0
1000000US060971512012015,060971512012015,"Block 2015, Block Group 2, Census Tract 1512.01, Sonoma County, California",12,9,3
1000000US060971512012016,060971512012016,"Block 2016, Block Group 2, Census Tract 1512.01, Sonoma County, California",41,38,3
1000000US060971512012017,060971512012017,"Block 2017, Block Group 2, Census Tract 1512.01, Sonoma County, California",17,16,1
1000000US060971512012018,060971512012018,"Block 2018, Block Group 2, Census Tract 1512.01, Sonoma County, California",3,3,0
1000000US060971512012019,060971512012019,"Block 2019, Block Group 2, Census Tract 1512.01, Sonoma County, California",2,1,1
1000000US060971512012020,060971512012020,"Block 2020, Block Group 2, Census Tract 1512.01, Sonoma County, California",0,0,0
1000000US060971512012021,060971512012021,"Block 2021, Block Group 2, Census Tract 1512.01, Sonoma County, California",0,0,0
1000000US060971512012022,060971512012022,"Block 2022, Block Group 2, Census Tract 1512.01, Sonoma County, California",7,7,0
1000000US060971512012023,060971512012023,"Block 2023, Block Group 2, Census Tract 1512.01, Sonoma County, California",0,0,0
1000000US060971512012024,060971512012024,"Block 2024, Block Group 2, Census Tract 1512.01, Sonoma County, California",0,0,0
1000000US060971512012025,060971512012025,"Block 2025, Block Group 2, Census Tract 1512.01, Sonoma County, California",0,0,0
1000000US060971512012026,060971512012026,"Block 2026, Block Group 2, Census Tract 1512.01, Sonoma County, California",12,11,1
1000000US060971512012027,060971512012027,"Block 2027, Block Group 2, Census Tract 1512.01, Sonoma County, California",4,4,0
1000000US060971512012028,060971512012028,"Block 2028, Block Group 2, Census Tract 1512.01, Sonoma County, California",20,18,2
1000000US060971512012029,060971512012029,"Block 2029, Block Group 2, Census Tract 1512.01, Sonoma County, California",0,0,0
1000000US060971512012030,060971512012030,"Block 2030, Block Group 2, Census Tract 1512.01, Sonoma County, California",0,0,0
1000000US060971512012031,060971512012031,"Block 2031, Block Group 2, Census Tract 1512.01, Sonoma County, California",0,0,0
1000000US060971512012032,060971512012032,"Block 2032, Block Group 2, Census Tract 1512.01, Sonoma County, California",0,0,0
1000000US060971512012033,060971512012033,"Block 2033, Block Group 2, Census Tract 1512.01, Sonoma County, California",0,0,0
1000000US060971512012034,060971512012034,"Block 2034, Block Group 2, Census Tract 1512.01, Sonoma County, California",0,0,0
1000000US060971512012035,060971512012035,"Block 2035, Block Group 2, Census Tract 1512.01, Sonoma County, California",30,28,2
1000000US060971512012036,060971512012036,"Block 2036, Block Group 2, Census Tract 1512.01, Sonoma County, California",0,0,0
1000000US060971512012037,060971512012037,"Block 2037, Block Group 2, Census Tract 1512.01, Sonoma County, California",0,0,0
1000000US060971512012038,060971512012038,"Block 2038, Block Group 2, Census Tract 1512.01, Sonoma County, California",0,0,0
1000000US060971512012039,060971512012039,"Block 2039, Block Group 2, Census Tract 1512.01, Sonoma County, California",0,0,0
1000000US060971512012040,060971512012040,"Block 2040, Block Group 2, Census Tract 1512.01, Sonoma County, California",0,0,0
1000000US060971512012041,060971512012041,"Block 2041, Block Group 2, Census Tract 1512.01, Sonoma County, California",0,0,0
1000000US060971512012042,060971512012042,"Block 2042, Block Group 2, Census Tract 1512.01, Sonoma County, California",0,0,0
1000000US060971512012043,060971512012043,"Block 2043, Block Group 2, Census Tract 1512.01, Sonoma County, California",0,0,0
1000000US060971512012044,060971512012044,"Block 2044, Block Group 2, Census Tract 1512.01, Sonoma County, California",0,0,0
1000000US060971512012045,060971512012045,"Block 2045, Block Group 2, Census Tract 1512.01, Sonoma County, California",0,0,0
1000000US060971512012046,060971512012046,"Block 2046, Block Group 2, Census Tract 1512.01, Sonoma County, California",0,0,0
1000000US060971512012047,060971512012047,"Block 2047, Block Group 2, Census Tract 1512.01, Sonoma County, California",0,0,0
1000000US060971512012048,060971512012048,"Block 2048, Block Group 2, Census Tract 1512.01, Sonoma County, California",0,0,0
1000000US060971512012049,060971512012049,"Block 2049, Block Group 2, Census Tract 1512.01, Sonoma County, California",0,0,0
1000000US060971512012050,060971512012050,"Block 2050, Block Group 2, Census Tract 1512.01, Sonoma County, California",0,0,0
1000000US060971512013000,060971512013000,"Block 3000, Block Group 3, Census Tract 1512.01, Sonoma County, California",81,73,8
1000000US060971512013001,060971512013001,"Block 3001, Block Group 3, Census Tract 1512.01, Sonoma County, California",2,2,0
1000000US060971512013002,060971512013002,"Block 3002, Block Group 3, Census Tract 1512.01, Sonoma County, California",5,5,0
1000000US060971512013003,060971512013003,"Block 3003, Block Group 3, Census Tract 1512.01, Sonoma County, California",2,2,0
1000000US060971512013004,060971512013004,"Block 3004, Block Group 3, Census Tract 1512.01, Sonoma County, California",14,13,1
1000000US060971512013005,060971512013005,"Block 3005, Block Group 3, Census Tract 1512.01, Sonoma County, California",14,11,3
1000000US060971512013006,060971512013006,"Block 3006, Block Group 3, Census Tract 1512.01, Sonoma County, California",79,75,4
1000000US060971512013007,060971512013007,"Block 3007, Block Group 3, Census Tract 1512.01, Sonoma County, California",50,49,1
1000000US060971512013008,060971512013008,"Block 3008, Block Group 3, Census Tract 1512.01, Sonoma County, California",3,3,0
1000000US060971512013009,060971512013009,"Block 3009, Block Group 3, Census Tract 1512.01, Sonoma County, California",38,32,6
1000000US060971512013010,060971512013010,"Block 3010, Block Group 3, Census Tract 1512.01, Sonoma County, California",11,9,2
1000000US060971512013011,060971512013011,"Block 3011, Block Group 3, Census Tract 1512.01, Sonoma County, California",29,28,1
1000000US060971512013012,060971512013012,"Block 3012, Block Group 3, Census Tract 1512.01, Sonoma County, California",17,16,1
1000000US060971512013013,060971512013013,"Block 3013, Block Group 3, Census Tract 1512.01, Sonoma County, California",13,13,0
1000000US060971512013014,060971512013014,"Block 3014, Block Group 3, Census Tract 1512.01, Sonoma County, California",13,12,1
1000000US060971512013015,060971512013015,"Block 3015, Block Group 3, Census Tract 1512.01, Sonoma County, California",0,0,0
1000000US060971512013016,060971512013016,"Block 3016, Block Group 3, Census Tract 1512.01, Sonoma County, California",9,8,1
1000000US060971512013017,060971512013017,"Block 3017, Block Group 3, Census Tract 1512.01, Sonoma County, California",32,31,1
1000000US060971512013018,060971512013018,"Block 3018, Block Group 3, Census Tract 1512.01, Sonoma County, California",30,29,1
1000000US060971512013019,060971512013019,"Block 3019, Block Group 3, Census Tract 1512.01, Sonoma County, California",0,0,0
1000000US060971512013020,060971512013020,"Block 3020, Block Group 3, Census Tract 1512.01, Sonoma County, California",15,15,0
1000000US060971512013021,060971512013021,"Block 3021, Block Group 3, Census Tract 1512.01, Sonoma County, California",0,0,0
1000000US060971512014000,060971512014000,"Block 4000, Block Group 4, Census Tract 1512.01, Sonoma County, California",15,14,1
1000000US060971512014001,060971512014001,"Block 4001, Block Group 4, Census Tract 1512.01, Sonoma County, California",0,0,0
1000000US060971512014002,060971512014002,"Block 4002, Block Group 4, Census Tract 1512.01, Sonoma County, California",82,75,7
1000000US060971512014003,060971512014003,"Block 4003, Block Group 4, Census Tract 1512.01, Sonoma County, California",2,2,0
1000000US060971512014004,060971512014004,"Block 4004, Block Group 4, Census Tract 1512.01, Sonoma County, California",10,7,3
1000000US060971512014005,060971512014005,"Block 4005, Block Group 4, Census Tract 1512.01, Sonoma County, California",1,1,0
1000000US060971512014006,060971512014006,"Block 4006, Block Group 4, Census Tract 1512.01, Sonoma County, California",0,0,0
1000000US060971512014007,060971512014007,"Block 4007, Block Group 4, Census Tract 1512.01, Sonoma County, California",0,0,0
1000000US060971512014008,060971512014008,"Block 4008, Block Group 4, Census Tract 1512.01, Sonoma County, California",0,0,0
1000000US060971512014009,060971512014009,"Block 4009, Block Group 4, Census Tract 1512.01, Sonoma County, California",1,1,0
1000000US060971512014010,060971512014010,"Block 4010, Block Group 4, Census Tract 1512.01, Sonoma County, California",0,0,0
1000000US060971512014011,060971512014011,"Block 4011, Block Group 4, Census Tract 1512.01, Sonoma County, California",216,196,20
1000000US060971512014012,060971512014012,"Block 4012, Block Group 4, Census Tract 1512.01, Sonoma County, California",35,30,5
1000000US060971512014013,060971512014013,"Block 4013, Block Group 4, Census Tract 1512.01, Sonoma County, California",55,49,6
1000000US060971512014014,060971512014014,"Block 4014, Block Group 4, Census Tract 1512.01, Sonoma County, California",50,46,4
1000000US060971512014015,060971512014015,"Block 4015, Block Group 4, Census Tract 1512.01, Sonoma County, California",0,0,0
1000000US060971512014016,060971512014016,"Block 4016, Block Group 4, Census Tract 1512.01, Sonoma County, California",8,8,0
1000000US060971512014017,060971512014017,"Block 4017, Block Group 4, Census Tract 1512.01, Sonoma County, California",0,0,0
1000000US060971512014018,060971512014018,"Block 4018, Block Group 4, Census Tract 1512.01, Sonoma County, California",0,0,0
1000000US060971512014019,060971512014019,"Block 4019, Block Group 4, Census Tract 1512.01, Sonoma County, California",0,0,0
1000000US060971512014020,060971512014020,"Block 4020, Block Group 4, Census Tract 1512.01, Sonoma County, California",8,8,0
1000000US060971512014021,060971512014021,"Block 4021, Block Group 4, Census Tract 1512.01, Sonoma County, California",4,3,1
1000000US060971512014022,060971512014022,"Block 4022, Block Group 4, Census Tract 1512.01, Sonoma County, California",41,38,3
1000000US060971512014023,060971512014023,"Block 4023, Block Group 4, Census Tract 1512.01, Sonoma County, California",136,129,7
1000000US060971512014024,060971512014024,"Block 4024, Block Group 4, Census Tract 1512.01, Sonoma County, California",0,0,0
1000000US060971512014025,060971512014025,"Block 4025, Block Group 4, Census Tract 1512.01, Sonoma County, California",0,0,0
1000000US060971512014026,060971512014026,"Block 4026, Block Group 4, Census Tract 1512.01, Sonoma County, California",8,8,0
1000000US060971512014027,060971512014027,"Block 4027, Block Group 4, Census Tract 1512.01, Sonoma County, California",0,0,0
1000000US060971512014028,060971512014028,"Block 4028, Block Group 4, Census Tract 1512.01, Sonoma County, California",5,5,0
1000000US060971512014029,060971512014029,"Block 4029, Block Group 4, Census Tract 1512.01, Sonoma County, California",0,0,0
1000000US060971512014030,060971512014030,"Block 4030, Block Group 4, Census Tract 1512.01, Sonoma County, California",0,0,0
1000000US060971512014031,060971512014031,"Block 4031, Block Group 4, Census Tract 1512.01, Sonoma County, California",0,0,0
1000000US060971512014032,060971512014032,"Block 4032, Block Group 4, Census Tract 1512.01, Sonoma County, California",4,1,3
1000000US060971512014033,060971512014033,"Block 4033, Block Group 4, Census Tract 1512.01, Sonoma County, California",8,8,0
1000000US060971512014034,060971512014034,"Block 4034, Block Group 4, Census Tract 1512.01, Sonoma County, California",0,0,0
1000000US060971512014035,060971512014035,"Block 4035, Block Group 4, Census Tract 1512.01, Sonoma County, California",0,0,0
1000000US060971512014036,060971512014036,"Block 4036, Block Group 4, Census Tract 1512.01, Sonoma County, California",50,45,5
1000000US060971512014037,060971512014037,"Block 4037, Block Group 4, Census Tract 1512.01, Sonoma County, California",13,12,1
1000000US060971512014038,060971512014038,"Block 4038, Block Group 4, Census Tract 1512.01, Sonoma County, California",16,15,1
1000000US060971512014039,060971512014039,"Block 4039, Block Group 4, Census Tract 1512.01, Sonoma County, California",44,41,3
1000000US060971512014040,060971512014040,"Block 4040, Block Group 4, Census Tract 1512.01, Sonoma County, California",0,0,0
1000000US060971512014041,060971512014041,"Block 4041, Block Group 4, Census Tract 1512.01, Sonoma County, California",12,11,1
1000000US060971512015000,060971512015000,"Block 5000, Block Group 5, Census Tract 1512.01, Sonoma County, California",0,0,0
1000000US060971512015001,060971512015001,"Block 5001, Block Group 5, Census Tract 1512.01, Sonoma County, California",0,0,0
1000000US060971512015002,060971512015002,"Block 5002, Block Group 5, Census Tract 1512.01, Sonoma County, California",344,334,10
1000000US060971512015003,060971512015003,"Block 5003, Block Group 5, Census Tract 1512.01, Sonoma County, California",20,19,1
1000000US060971512015004,060971512015004,"Block 5004, Block Group 5, Census Tract 1512.01, Sonoma County, California",51,49,2
1000000US060971512015005,060971512015005,"Block 5005, Block Group 5, Census Tract 1512.01, Sonoma County, California",35,34,1
1000000US060971512015006,060971512015006,"Block 5006, Block Group 5, Census Tract 1512.01, Sonoma County, California",32,29,3
1000000US060971512015007,060971512015007,"Block 5007, Block Group 5, Census Tract 1512.01, Sonoma County, California",20,20,0
1000000US060971512015008,060971512015008,"Block 5008, Block Group 5, Census Tract 1512.01, Sonoma County, California",14,14,0
1000000US060971512015009,060971512015009,"Block 5009, Block Group 5, Census Tract 1512.01, Sonoma County, California",8,8,0
1000000US060971512015010,060971512015010,"Block 5010, Block Group 5, Census Tract 1512.01, Sonoma County, California",18,17,1
1000000US060971512015011,060971512015011,"Block 5011, Block Group 5, Census Tract 1512.01, Sonoma County, California",8,8,0
1000000US060971512015012,060971512015012,"Block 5012, Block Group 5, Census Tract 1512.01, Sonoma County, California",6,6,0
1000000US060971512015013,060971512015013,"Block 5013, Block Group 5, Census Tract 1512.01, Sonoma County, California",40,39,1
1000000US060971512015014,060971512015014,"Block 5014, Block Group 5, Census Tract 1512.01, Sonoma County, California",8,8,0
1000000US060971512015015,060971512015015,"Block 5015, Block Group 5, Census Tract 1512.01, Sonoma County, California",33,33,0
1000000US060971512015016,060971512015016,"Block 5016, Block Group 5, Census Tract 1512.01, Sonoma County, California",4,3,1
1000000US060971512015017,060971512015017,"Block 5017, Block Group 5, Census Tract 1512.01, Sonoma County, California",0,0,0
1000000US060971512015018,060971512015018,"Block 5018, Block Group 5, Census Tract 1512.01, Sonoma County, California",0,0,0
1000000US060971512015019,060971512015019,"Block 5019, Block Group 5, Census Tract 1512.01, Sonoma County, California",0,0,0
1000000US060971512015020,060971512015020,"Block 5020, Block Group 5, Census Tract 1512.01, Sonoma County, California",0,0,0
1000000US060971512015021,060971512015021,"Block 5021, Block Group 5, Census Tract 1512.01, Sonoma County, California",0,0,0
1000000US060971512015022,060971512015022,"Block 5022, Block Group 5, Census Tract 1512.01, Sonoma County, California",0,0,0
1000000US060971512015023,060971512015023,"Block 5023, Block Group 5, Census Tract 1512.01, Sonoma County, California",0,0,0
1000000US060971512015024,060971512015024,"Block 5024, Block Group 5, Census Tract 1512.01, Sonoma County, California",0,0,0
1000000US060971512015025,060971512015025,"Block 5025, Block Group 5, Census Tract 1512.01, Sonoma County, California",0,0,0
1000000US060971512015026,060971512015026,"Block 5026, Block Group 5, Census Tract 1512.01, Sonoma County, California",0,0,0
1000000US060971512015027,060971512015027,"Block 5027, Block Group 5, Census Tract 1512.01, Sonoma County, California",0,0,0
1000000US060971512015028,060971512015028,"Block 5028, Block Group 5, Census Tract 1512.01, Sonoma County, California",0,0,0
1000000US060971512015029,060971512015029,"Block 5029, Block Group 5, Census Tract 1512.01, Sonoma County, California",2,2,0
1000000US060971512015030,060971512015030,"Block 5030, Block Group 5, Census Tract 1512.01, Sonoma County, California",0,0,0
1000000US060971512015031,060971512015031,"Block 5031, Block Group 5, Census Tract 1512.01, Sonoma County, California",0,0,0
1000000US060971512015032,060971512015032,"Block 5032, Block Group 5, Census Tract 1512.01, Sonoma County, California",0,0,0
1000000US060971512015033,060971512015033,"Block 5033, Block Group 5, Census Tract 1512.01, Sonoma County, California",4,4,0
1000000US060971512015034,060971512015034,"Block 5034, Block Group 5, Census Tract 1512.01, Sonoma County, California",3,3,0
1000000US060971512015035,060971512015035,"Block 5035, Block Group 5, Census Tract 1512.01, Sonoma County, California",15,13,2
1000000US060971512015036,060971512015036,"Block 5036, Block Group 5, Census Tract 1512.01, Sonoma County, California",5,5,0
1000000US060971512015037,060971512015037,"Block 5037, Block Group 5, Census Tract 1512.01, Sonoma County, California",14,10,4
1000000US060971512015038,060971512015038,"Block 5038, Block Group 5, Census Tract 1512.01, Sonoma County, California",1,1,0
1000000US060971512015039,060971512015039,"Block 5039, Block Group 5, Census Tract 1512.01, Sonoma County, California",10,7,3
1000000US060971512015040,060971512015040,"Block 5040, Block Group 5, Census Tract 1512.01, Sonoma County, California",7,7,0
1000000US060971512015041,060971512015041,"Block 5041, Block Group 5, Census Tract 1512.01, Sonoma County, California",13,12,1
1000000US060971512015042,060971512015042,"Block 5042, Block Group 5, Census Tract 1512.01, Sonoma County, California",5,5,0
1000000US060971512015043,060971512015043,"Block 5043, Block Group 5, Census Tract 1512.01, Sonoma County, California",0,0,0
1000000US060971512015044,060971512015044,"Block 5044, Block Group 5, Census Tract 1512.01, Sonoma County, California",11,9,2
1000000US060971512015045,060971512015045,"Block 5045, Block Group 5, Census Tract 1512.01, Sonoma County, California",5,5,0
1000000US060971512015046,060971512015046,"Block 5046, Block Group 5, Census Tract 1512.01, Sonoma County, California",0,0,0
1000000US060971512015047,060971512015047,"Block 5047, Block Group 5, Census Tract 1512.01, Sonoma County, California",0,0,0
1000000US060971512015048,060971512015048,"Block 5048, Block Group 5, Census Tract 1512.01, Sonoma County, California",0,0,0
1000000US060971512031000,060971512031000,"Block 1000, Block Group 1, Census Tract 1512.03, Sonoma County, California",181,166,15
1000000US060971512031001,060971512031001,"Block 1001, Block Group 1, Census Tract 1512.03, Sonoma County, California",63,57,6
1000000US060971512031002,060971512031002,"Block 1002, Block Group 1, Census Tract 1512.03, Sonoma County, California",0,0,0
1000000US060971512031003,060971512031003,"Block 1003, Block Group 1, Census Tract 1512.03, Sonoma County, California",26,25,1
1000000US060971512031004,060971512031004,"Block 1004, Block Group 1, Census Tract 1512.03, Sonoma County, California",100,99,1
1000000US060971512031005,060971512031005,"Block 1005, Block Group 1, Census Tract 1512.03, Sonoma County, California",40,40,0
1000000US060971512031006,060971512031006,"Block 1006, Block Group 1, Census Tract 1512.03, Sonoma County, California",41,41,0
1000000US060971512032000,060971512032000,"Block 2000, Block Group 2, Census Tract 1512.03, Sonoma County, California",94,92,2
1000000US060971512032001,060971512032001,"Block 2001, Block Group 2, Census Tract 1512.03, Sonoma County, California",102,98,4
1000000US060971512032002,060971512032002,"Block 2002, Block Group 2, Census Tract 1512.03, Sonoma County, California",32,31,1
1000000US060971512032003,060971512032003,"Block 2003, Block Group 2, Census Tract 1512.03, Sonoma County, California",15,15,0
1000000US060971512032004,060971512032004,"Block 2004, Block Group 2, Census Tract 1512.03, Sonoma County, California",15,13,2
1000000US060971512032005,060971512032005,"Block 2005, Block Group 2, Census Tract 1512.03, Sonoma County, California",9,9,0
1000000US060971512032006,060971512032006,"Block 2006, Block Group 2, Census Tract 1512.03, Sonoma County, California",50,49,1
1000000US060971512032007,060971512032007,"Block 2007, Block Group 2, Census Tract 1512.03, Sonoma County, California",42,39,3
1000000US060971512032008,060971512032008,"Block 2008, Block Group 2, Census Tract 1512.03, Sonoma County, California",13,13,0
1000000US060971512032009,060971512032009,"Block 2009, Block Group 2, Census Tract 1512.03, Sonoma County, California",13,12,1
1000000US060971512032010,060971512032010,"Block 2010, Block Group 2, Census Tract 1512.03, Sonoma County, California",12,10,2
1000000US060971512032011,060971512032011,"Block 2011, Block Group 2, Census Tract 1512.03, Sonoma County, California",10,9,1
1000000US060971512032012,060971512032012,"Block 2012, Block Group 2, Census Tract 1512.03, Sonoma County, California",35,34,1
1000000US060971512032013,060971512032013,"Block 2013, Block Group 2, Census Tract 1512.03, Sonoma County, California",23,23,0
1000000US060971512033000,060971512033000,"Block 3000, Block Group 3, Census Tract 1512.03, Sonoma County, California",53,51,2
1000000US060971512033001,060971512033001,"Block 3001, Block Group 3, Census Tract 1512.03, Sonoma County, California",68,63,5
1000000US060971512033002,060971512033002,"Block 3002, Block Group 3, Census Tract 1512.03, Sonoma County, California",16,16,0
1000000US060971512033003,060971512033003,"Block 3003, Block Group 3, Census Tract 1512.03, Sonoma County, California",36,34,2
1000000US060971512033004,060971512033004,"Block 3004, Block Group 3, Census Tract 1512.03, Sonoma County, California",54,51,3
1000000US060971512033005,060971512033005,"Block 3005, Block Group 3, Census Tract 1512.03, Sonoma County, California",32,32,0
1000000US060971512033006,060971512033006,"Block 3006, Block Group 3, Census Tract 1512.03, Sonoma County, California",35,33,2
1000000US060971512033007,060971512033007,"Block 3007, Block Group 3, Census Tract 1512.03, Sonoma County, California",17,16,1
1000000US060971512033008,060971512033008,"Block 3008, Block Group 3, Census Tract 1512.03, Sonoma County, California",30,29,1
1000000US060971512033009,060971512033009,"Block 3009, Block Group 3, Census Tract 1512.03, Sonoma County, California",20,20,0
1000000US060971512033010,060971512033010,"Block 3010, Block Group 3, Census Tract 1512.03, Sonoma County, California",6,6,0
1000000US060971512033011,060971512033011,"Block 3011, Block Group 3, Census Tract 1512.03, Sonoma County, California",39,38,1
1000000US060971512033012,060971512033012,"Block 3012, Block Group 3, Census Tract 1512.03, Sonoma County, California",10,10,0
1000000US060971512033013,060971512033013,"Block 3013, Block Group 3, Census Tract 1512.03, Sonoma County, California",16,15,1
1000000US060971512034000,060971512034000,"Block 4000, Block Group 4, Census Tract 1512.03, Sonoma County, California",26,25,1
1000000US060971512034001,060971512034001,"Block 4001, Block Group 4, Census Tract 1512.03, Sonoma County, California",69,67,2
1000000US060971512034002,060971512034002,"Block 4002, Block Group 4, Census Tract 1512.03, Sonoma County, California",1,1,0
1000000US060971512034003,060971512034003,"Block 4003, Block Group 4, Census Tract 1512.03, Sonoma County, California",36,35,1
1000000US060971512034004,060971512034004,"Block 4004, Block Group 4, Census Tract 1512.03, Sonoma County, California",11,7,4
1000000US060971512034005,060971512034005,"Block 4005, Block Group 4, Census Tract 1512.03, Sonoma County, California",11,9,2
1000000US060971512034006,060971512034006,"Block 4006, Block Group 4, Census Tract 1512.03, Sonoma County, California",125,119,6
1000000US060971512034007,060971512034007,"Block 4007, Block Group 4, Census Tract 1512.03, Sonoma County, California",24,24,0
1000000US060971512034008,060971512034008,"Block 4008, Block Group 4, Census Tract 1512.03, Sonoma County, California",13,13,0
1000000US060971512034009,060971512034009,"Block 4009, Block Group 4, Census Tract 1512.03, Sonoma County, California",53,53,0
1000000US060971512034010,060971512034010,"Block 4010, Block Group 4, Census Tract 1512.03, Sonoma County, California",19,18,1
1000000US060971512034011,060971512034011,"Block 4011, Block Group 4, Census Tract 1512.03, Sonoma County, California",22,22,0
1000000US060971512034012,060971512034012,"Block 4012, Block Group 4, Census Tract 1512.03, Sonoma County, California",13,12,1
1000000US060971512034013,060971512034013,"Block 4013, Block Group 4, Census Tract 1512.03, Sonoma County, California",60,59,1
1000000US060971512034014,060971512034014,"Block 4014, Block Group 4, Census Tract 1512.03, Sonoma County, California",99,98,1
1000000US060971512034015,060971512034015,"Block 4015, Block Group 4, Census Tract 1512.03, Sonoma County, California",5,5,0
1000000US060971512034016,060971512034016,"Block 4016, Block Group 4, Census Tract 1512.03, Sonoma County, California",12,12,0
1000000US060971512034017,060971512034017,"Block 4017, Block Group 4, Census Tract 1512.03, Sonoma County, California",16,15,1
1000000US060971512034018,060971512034018,"Block 4018, Block Group 4, Census Tract 1512.03, Sonoma County, California",54,53,1
1000000US060971512034019,060971512034019,"Block 4019, Block Group 4, Census Tract 1512.03, Sonoma County, California",9,9,0
1000000US060971512034020,060971512034020,"Block 4020, Block Group 4, Census Tract 1512.03, Sonoma County, California",34,31,3
1000000US060971512041000,060971512041000,"Block 1000, Block Group 1, Census Tract 1512.04, Sonoma County, California",108,99,9
1000000US060971512041001,060971512041001,"Block 1001, Block Group 1, Census Tract 1512.04, Sonoma County, California",9,7,2
1000000US060971512041002,060971512041002,"Block 1002, Block Group 1, Census Tract 1512.04, Sonoma County, California",3,3,0
1000000US060971512041003,060971512041003,"Block 1003, Block Group 1, Census Tract 1512.04, Sonoma County, California",8,8,0
1000000US060971512041004,060971512041004,"Block 1004, Block Group 1, Census Tract 1512.04, Sonoma County, California",31,31,0
1000000US060971512041005,060971512041005,"Block 1005, Block Group 1, Census Tract 1512.04, Sonoma County, California",51,48,3
1000000US060971512041006,060971512041006,"Block 1006, Block Group 1, Census Tract 1512.04, Sonoma County, California",57,53,4
1000000US060971512041007,060971512041007,"Block 1007, Block Group 1, Census Tract 1512.04, Sonoma County, California",82,77,5
1000000US060971512041008,060971512041008,"Block 1008, Block Group 1, Census Tract 1512.04, Sonoma County, California",1,1,0
1000000US060971512041009,060971512041009,"Block 1009, Block Group 1, Census Tract 1512.04, Sonoma County, California",13,13,0
1000000US060971512041010,060971512041010,"Block 1010, Block Group 1, Census Tract 1512.04, Sonoma County, California",16,14,2
1000000US060971512041011,060971512041011,"Block 1011, Block Group 1, Census Tract 1512.04, Sonoma County, California",10,10,0
1000000US060971512041012,060971512041012,"Block 1012, Block Group 1, Census Tract 1512.04, Sonoma County, California",3,3,0
1000000US060971512041013,060971512041013,"Block 1013, Block Group 1, Census Tract 1512.04, Sonoma County, California",29,27,2
1000000US060971512041014,060971512041014,"Block 1014, Block Group 1, Census Tract 1512.04, Sonoma County, California",60,58,2
1000000US060971512041015,060971512041015,"Block 1015, Block Group 1, Census Tract 1512.04, Sonoma County, California",86,86,0
1000000US060971512041016,060971512041016,"Block 1016, Block Group 1, Census Tract 1512.04, Sonoma County, California",10,10,0
1000000US060971512041017,060971512041017,"Block 1017, Block Group 1, Census Tract 1512.04, Sonoma County, California",0,0,0
1000000US060971512041018,060971512041018,"Block 1018, Block Group 1, Census Tract 1512.04, Sonoma County, California",0,0,0
1000000US060971512041019,060971512041019,"Block 1019, Block Group 1, Census Tract 1512.04, Sonoma County, California",0,0,0
1000000US060971512041020,060971512041020,"Block 1020, Block Group 1, Census Tract 1512.04, Sonoma County, California",6,6,0
1000000US060971512041021,060971512041021,"Block 1021, Block Group 1, Census Tract 1512.04, Sonoma County, California",53,50,3
1000000US060971512041022,060971512041022,"Block 1022, Block Group 1, Census Tract 1512.04, Sonoma County, California",41,38,3
1000000US060971512041023,060971512041023,"Block 1023, Block Group 1, Census Tract 1512.04, Sonoma County, California",2,2,0
1000000US060971512042000,060971512042000,"Block 2000, Block Group 2, Census Tract 1512.04, Sonoma County, California",1,0,1
1000000US060971512042001,060971512042001,"Block 2001, Block Group 2, Census Tract 1512.04, Sonoma County, California",121,116,5
1000000US060971512042002,060971512042002,"Block 2002, Block Group 2, Census Tract 1512.04, Sonoma County, California",75,66,9
1000000US060971512042003,060971512042003,"Block 2003, Block Group 2, Census Tract 1512.04, Sonoma County, California",61,60,1
1000000US060971512042004,060971512042004,"Block 2004, Block Group 2, Census Tract 1512.04, Sonoma County, California",8,8,0
1000000US060971512042005,060971512042005,"Block 2005, Block Group 2, Census Tract 1512.04, Sonoma County, California",182,176,6
1000000US060971512042006,060971512042006,"Block 2006, Block Group 2, Census Tract 1512.04, Sonoma County, California",5,5,0
1000000US060971512042007,060971512042007,"Block 2007, Block Group 2, Census Tract 1512.04, Sonoma County, California",4,4,0
1000000US060971512042008,060971512042008,"Block 2008, Block Group 2, Census Tract 1512.04, Sonoma County, California",18,16,2
1000000US060971512042009,060971512042009,"Block 2009, Block Group 2, Census Tract 1512.04, Sonoma County, California",12,12,0
1000000US060971512042010,060971512042010,"Block 2010, Block Group 2, Census Tract 1512.04, Sonoma County, California",1,1,0
1000000US060971512042011,060971512042011,"Block 2011, Block Group 2, Census Tract 1512.04, Sonoma County, California",17,17,0
1000000US060971512042012,060971512042012,"Block 2012, Block Group 2, Census Tract 1512.04, Sonoma County, California",17,17,0
1000000US060971512042013,060971512042013,"Block 2013, Block Group 2, Census Tract 1512.04, Sonoma County, California",5,5,0
1000000US060971512042014,060971512042014,"Block 2014, Block Group 2, Census Tract 1512.04, Sonoma County, California",0,0,0
1000000US060971512042015,060971512042015,"Block 2015, Block Group 2, Census Tract 1512.04, Sonoma County, California",0,0,0
1000000US060971512042016,060971512042016,"Block 2016, Block Group 2, Census Tract 1512.04, Sonoma County, California",7,7,0
1000000US060971512043000,060971512043000,"Block 3000, Block Group 3, Census Tract 1512.04, Sonoma County, California",174,163,11
1000000US060971512043001,060971512043001,"Block 3001, Block Group 3, Census Tract 1512.04, Sonoma County, California",9,9,0
1000000US060971512043002,060971512043002,"Block 3002, Block Group 3, Census Tract 1512.04, Sonoma County, California",11,10,1
1000000US060971512043003,060971512043003,"Block 3003, Block Group 3, Census Tract 1512.04, Sonoma County, California",0,0,0
1000000US060971512043004,060971512043004,"Block 3004, Block Group 3, Census Tract 1512.04, Sonoma County, California",0,0,0
1000000US060971512043005,060971512043005,"Block 3005, Block Group 3, Census Tract 1512.04, Sonoma County, California",0,0,0
1000000US060971512043006,060971512043006,"Block 3006, Block Group 3, Census Tract 1512.04, Sonoma County, California",0,0,0
1000000US060971512043007,060971512043007,"Block 3007, Block Group 3, Census Tract 1512.04, Sonoma County, California",0,0,0
1000000US060971512043008,060971512043008,"Block 3008, Block Group 3, Census Tract 1512.04, Sonoma County, California",34,33,1
1000000US060971512043009,060971512043009,"Block 3009, Block Group 3, Census Tract 1512.04, Sonoma County, California",4,3,1
1000000US060971512043010,060971512043010,"Block 3010, Block Group 3, Census Tract 1512.04, Sonoma County, California",0,0,0
1000000US060971512043011,060971512043011,"Block 3011, Block Group 3, Census Tract 1512.04, Sonoma County, California",16,15,1
1000000US060971512043012,060971512043012,"Block 3012, Block Group 3, Census Tract 1512.04, Sonoma County, California",45,41,4
1000000US060971512043013,060971512043013,"Block 3013, Block Group 3, Census Tract 1512.04, Sonoma County, California",12,10,2
1000000US060971512043014,060971512043014,"Block 3014, Block Group 3, Census Tract 1512.04, Sonoma County, California",11,11,0
1000000US060971512043015,060971512043015,"Block 3015, Block Group 3, Census Tract 1512.04, Sonoma County, California",0,0,0
1000000US060971512043016,060971512043016,"Block 3016, Block Group 3, Census Tract 1512.04, Sonoma County, California",17,15,2
1000000US060971513011000,060971513011000,"Block 1000, Block Group 1, Census Tract 1513.01, Sonoma County, California",155,152,3
1000000US060971513011001,060971513011001,"Block 1001, Block Group 1, Census Tract 1513.01, Sonoma County, California",38,37,1
1000000US060971513011002,060971513011002,"Block 1002, Block Group 1, Census Tract 1513.01, Sonoma County, California",15,14,1
1000000US060971513011003,060971513011003,"Block 1003, Block Group 1, Census Tract 1513.01, Sonoma County, California",24,24,0
1000000US060971513011004,060971513011004,"Block 1004, Block Group 1, Census Tract 1513.01, Sonoma County, California",38,37,1
1000000US060971513011005,060971513011005,"Block 1005, Block Group 1, Census Tract 1513.01, Sonoma County, California",32,31,1
1000000US060971513011006,060971513011006,"Block 1006, Block Group 1, Census Tract 1513.01, Sonoma County, California",13,12,1
1000000US060971513011007,060971513011007,"Block 1007, Block Group 1, Census Tract 1513.01, Sonoma County, California",29,29,0
1000000US060971513011008,060971513011008,"Block 1008, Block Group 1, Census Tract 1513.01, Sonoma County, California",38,38,0
1000000US060971513011009,060971513011009,"Block 1009, Block Group 1, Census Tract 1513.01, Sonoma County, California",30,27,3
1000000US060971513011010,060971513011010,"Block 1010, Block Group 1, Census Tract 1513.01, Sonoma County, California",6,6,0
1000000US060971513011011,060971513011011,"Block 1011, Block Group 1, Census Tract 1513.01, Sonoma County, California",148,142,6
1000000US060971513011012,060971513011012,"Block 1012, Block Group 1, Census Tract 1513.01, Sonoma County, California",19,16,3
1000000US060971513011013,060971513011013,"Block 1013, Block Group 1, Census Tract 1513.01, Sonoma County, California",37,34,3
1000000US060971513012000,060971513012000,"Block 2000, Block Group 2, Census Tract 1513.01, Sonoma County, California",63,60,3
1000000US060971513012001,060971513012001,"Block 2001, Block Group 2, Census Tract 1513.01, Sonoma County, California",9,9,0
1000000US060971513012002,060971513012002,"Block 2002, Block Group 2, Census Tract 1513.01, Sonoma County, California",147,140,7
1000000US060971513012003,060971513012003,"Block 2003, Block Group 2, Census Tract 1513.01, Sonoma County, California",45,44,1
1000000US060971513012004,060971513012004,"Block 2004, Block Group 2, Census Tract 1513.01, Sonoma County, California",24,23,1
1000000US060971513012005,060971513012005,"Block 2005, Block Group 2, Census Tract 1513.01, Sonoma County, California",26,26,0
1000000US060971513012006,060971513012006,"Block 2006, Block Group 2, Census Tract 1513.01, Sonoma County, California",41,40,1
1000000US060971513012007,060971513012007,"Block 2007, Block Group 2, Census Tract 1513.01, Sonoma County, California",12,12,0
1000000US060971513012008,060971513012008,"Block 2008, Block Group 2, Census Tract 1513.01, Sonoma County, California",32,30,2
1000000US060971513013000,060971513013000,"Block 3000, Block Group 3, Census Tract 1513.01, Sonoma County, California",0,0,0
1000000US060971513013001,060971513013001,"Block 3001, Block Group 3, Census Tract 1513.01, Sonoma County, California",123,116,7
1000000US060971513013002,060971513013002,"Block 3002, Block Group 3, Census Tract 1513.01, Sonoma County, California",303,289,14
1000000US060971513013003,060971513013003,"Block 3003, Block Group 3, Census Tract 1513.01, Sonoma County, California",15,13,2
1000000US060971513013004,060971513013004,"Block 3004, Block Group 3, Census Tract 1513.01, Sonoma County, California",0,0,0
1000000US060971513013005,060971513013005,"Block 3005, Block Group 3, Census Tract 1513.01, Sonoma County, California",14,13,1
1000000US060971513013006,060971513013006,"Block 3006, Block Group 3, Census Tract 1513.01, Sonoma County, California",0,0,0
1000000US060971513013007,060971513013007,"Block 3007, Block Group 3, Census Tract 1513.01, Sonoma County, California",8,8,0
1000000US060971513013008,060971513013008,"Block 3008, Block Group 3, Census Tract 1513.01, Sonoma County, California",10,10,0
1000000US060971513013009,060971513013009,"Block 3009, Block Group 3, Census Tract 1513.01, Sonoma County, California",16,14,2
1000000US060971513013010,060971513013010,"Block 3010, Block Group 3, Census Tract 1513.01, Sonoma County, California",44,42,2
1000000US060971513013011,060971513013011,"Block 3011, Block Group 3, Census Tract 1513.01, Sonoma County, California",1,1,0
1000000US060971513013012,060971513013012,"Block 3012, Block Group 3, Census Tract 1513.01, Sonoma County, California",51,49,2
1000000US060971513013013,060971513013013,"Block 3013, Block Group 3, Census Tract 1513.01, Sonoma County, California",17,17,0
1000000US060971513013014,060971513013014,"Block 3014, Block Group 3, Census Tract 1513.01, Sonoma County, California",0,0,0
1000000US060971513013015,060971513013015,"Block 3015, Block Group 3, Census Tract 1513.01, Sonoma County, California",3,2,1
1000000US060971513013016,060971513013016,"Block 3016, Block Group 3, Census Tract 1513.01, Sonoma County, California",0,0,0
1000000US060971513013017,060971513013017,"Block 3017, Block Group 3, Census Tract 1513.01, Sonoma County, California",0,0,0
1000000US060971513013018,060971513013018,"Block 3018, Block Group 3, Census Tract 1513.01, Sonoma County, California",25,23,2
1000000US060971513051000,060971513051000,"Block 1000, Block Group 1, Census Tract 1513.05, Sonoma County, California",56,56,0
1000000US060971513051001,060971513051001,"Block 1001, Block Group 1, Census Tract 1513.05, Sonoma County, California",0,0,0
1000000US060971513051002,060971513051002,"Block 1002, Block Group 1, Census Tract 1513.05, Sonoma County, California",0,0,0
1000000US060971513051003,060971513051003,"Block 1003, Block Group 1, Census Tract 1513.05, Sonoma County, California",0,0,0
1000000US060971513051004,060971513051004,"Block 1004, Block Group 1, Census Tract 1513.05, Sonoma County, California",0,0,0
1000000US060971513051005,060971513051005,"Block 1005, Block Group 1, Census Tract 1513.05, Sonoma County, California",76,71,5
1000000US060971513051006,060971513051006,"Block 1006, Block Group 1, Census Tract 1513.05, Sonoma County, California",0,0,0
1000000US060971513051007,060971513051007,"Block 1007, Block Group 1, Census Tract 1513.05, Sonoma County, California",0,0,0
1000000US060971513051008,060971513051008,"Block 1008, Block Group 1, Census Tract 1513.05, Sonoma County, California",0,0,0
1000000US060971513051009,060971513051009,"Block 1009, Block Group 1, Census Tract 1513.05, Sonoma County, California",0,0,0
1000000US060971513051010,060971513051010,"Block 1010, Block Group 1, Census Tract 1513.05, Sonoma County, California",0,0,0
1000000US060971513051011,060971513051011,"Block 1011, Block Group 1, Census Tract 1513.05, Sonoma County, California",0,0,0
1000000US060971513051012,060971513051012,"Block 1012, Block Group 1, Census Tract 1513.05, Sonoma County, California",0,0,0
1000000US060971513051013,060971513051013,"Block 1013, Block Group 1, Census Tract 1513.05, Sonoma County, California",0,0,0
1000000US060971513051014,060971513051014,"Block 1014, Block Group 1, Census Tract 1513.05, Sonoma County, California",0,0,0
1000000US060971513051015,060971513051015,"Block 1015, Block Group 1, Census Tract 1513.05, Sonoma County, California",0,0,0
1000000US060971513051016,060971513051016,"Block 1016, Block Group 1, Census Tract 1513.05, Sonoma County, California",0,0,0
1000000US060971513051017,060971513051017,"Block 1017, Block Group 1, Census Tract 1513.05, Sonoma County, California",0,0,0
1000000US060971513051018,060971513051018,"Block 1018, Block Group 1, Census Tract 1513.05, Sonoma County, California",0,0,0
1000000US060971513051019,060971513051019,"Block 1019, Block Group 1, Census Tract 1513.05, Sonoma County, California",0,0,0
1000000US060971513051020,060971513051020,"Block 1020, Block Group 1, Census Tract 1513.05, Sonoma County, California",230,224,6
1000000US060971513051021,060971513051021,"Block 1021, Block Group 1, Census Tract 1513.05, Sonoma County, California",0,0,0
1000000US060971513051022,060971513051022,"Block 1022, Block Group 1, Census Tract 1513.05, Sonoma County, California",0,0,0
1000000US060971513051023,060971513051023,"Block 1023, Block Group 1, Census Tract 1513.05, Sonoma County, California",283,264,19
1000000US060971513051024,060971513051024,"Block 1024, Block Group 1, Census Tract 1513.05, Sonoma County, California",0,0,0
1000000US060971513051025,060971513051025,"Block 1025, Block Group 1, Census Tract 1513.05, Sonoma County, California",0,0,0
1000000US060971513051026,060971513051026,"Block 1026, Block Group 1, Census Tract 1513.05, Sonoma County, California",0,0,0
1000000US060971513051027,060971513051027,"Block 1027, Block Group 1, Census Tract 1513.05, Sonoma County, California",0,0,0
1000000US060971513051028,060971513051028,"Block 1028, Block Group 1, Census Tract 1513.05, Sonoma County, California",0,0,0
1000000US060971513051029,060971513051029,"Block 1029, Block Group 1, Census Tract 1513.05, Sonoma County, California",172,170,2
1000000US060971513051030,060971513051030,"Block 1030, Block Group 1, Census Tract 1513.05, Sonoma County, California",0,0,0
1000000US060971513051031,060971513051031,"Block 1031, Block Group 1, Census Tract 1513.05, Sonoma County, California",0,0,0
1000000US060971513051032,060971513051032,"Block 1032, Block Group 1, Census Tract 1513.05, Sonoma County, California",233,227,6
1000000US060971513051033,060971513051033,"Block 1033, Block Group 1, Census Tract 1513.05, Sonoma County, California",0,0,0
1000000US060971513052000,060971513052000,"Block 2000, Block Group 2, Census Tract 1513.05, Sonoma County, California",0,0,0
1000000US060971513052001,060971513052001,"Block 2001, Block Group 2, Census Tract 1513.05, Sonoma County, California",27,27,0
1000000US060971513052002,060971513052002,"Block 2002, Block Group 2, Census Tract 1513.05, Sonoma County, California",51,49,2
1000000US060971513052003,060971513052003,"Block 2003, Block Group 2, Census Tract 1513.05, Sonoma County, California",39,38,1
1000000US060971513052004,060971513052004,"Block 2004, Block Group 2, Census Tract 1513.05, Sonoma County, California",34,31,3
1000000US060971513052005,060971513052005,"Block 2005, Block Group 2, Census Tract 1513.05, Sonoma County, California",49,48,1
1000000US060971513052006,060971513052006,"Block 2006, Block Group 2, Census Tract 1513.05, Sonoma County, California",29,26,3
1000000US060971513052007,060971513052007,"Block 2007, Block Group 2, Census Tract 1513.05, Sonoma County, California",0,0,0
1000000US060971513052008,060971513052008,"Block 2008, Block Group 2, Census Tract 1513.05, Sonoma County, California",0,0,0
1000000US060971513052009,060971513052009,"Block 2009, Block Group 2, Census Tract 1513.05, Sonoma County, California",0,0,0
1000000US060971513052010,060971513052010,"Block 2010, Block Group 2, Census Tract 1513.05, Sonoma County, California",0,0,0
1000000US060971513052011,060971513052011,"Block 2011, Block Group 2, Census Tract 1513.05, Sonoma County, California",0,0,0
1000000US060971513053000,060971513053000,"Block 3000, Block Group 3, Census Tract 1513.05, Sonoma County, California",335,312,23
1000000US060971513053001,060971513053001,"Block 3001, Block Group 3, Census Tract 1513.05, Sonoma County, California",0,0,0
1000000US060971513053002,060971513053002,"Block 3002, Block Group 3, Census Tract 1513.05, Sonoma County, California",0,0,0
1000000US060971513053003,060971513053003,"Block 3003, Block Group 3, Census Tract 1513.05, Sonoma County, California",0,0,0
1000000US060971513053004,060971513053004,"Block 3004, Block Group 3, Census Tract 1513.05, Sonoma County, California",0,0,0
1000000US060971513053005,060971513053005,"Block 3005, Block Group 3, Census Tract 1513.05, Sonoma County, California",17,17,0
1000000US060971513053006,060971513053006,"Block 3006, Block Group 3, Census Tract 1513.05, Sonoma County, California",39,38,1
1000000US060971513053007,060971513053007,"Block 3007, Block Group 3, Census Tract 1513.05, Sonoma County, California",50,46,4
1000000US060971513053008,060971513053008,"Block 3008, Block Group 3, Census Tract 1513.05, Sonoma County, California",43,41,2
1000000US060971513053009,060971513053009,"Block 3009, Block Group 3, Census Tract 1513.05, Sonoma County, California",42,41,1
1000000US060971513053010,060971513053010,"Block 3010, Block Group 3, Census Tract 1513.05, Sonoma County, California",47,46,1
1000000US060971513053011,060971513053011,"Block 3011, Block Group 3, Census Tract 1513.05, Sonoma County, California",34,33,1
1000000US060971513053012,060971513053012,"Block 3012, Block Group 3, Census Tract 1513.05, Sonoma County, California",31,31,0
1000000US060971513054000,060971513054000,"Block 4000, Block Group 4, Census Tract 1513.05, Sonoma County, California",0,0,0
1000000US060971513054001,060971513054001,"Block 4001, Block Group 4, Census Tract 1513.05, Sonoma County, California",0,0,0
1000000US060971513054002,060971513054002,"Block 4002, Block Group 4, Census Tract 1513.05, Sonoma County, California",42,38,4
1000000US060971513054003,060971513054003,"Block 4003, Block Group 4, Census Tract 1513.05, Sonoma County, California",201,184,17
1000000US060971513054004,060971513054004,"Block 4004, Block Group 4, Census Tract 1513.05, Sonoma County, California",67,64,3
1000000US060971513054005,060971513054005,"Block 4005, Block Group 4, Census Tract 1513.05, Sonoma County, California",111,109,2
1000000US060971513054006,060971513054006,"Block 4006, Block Group 4, Census Tract 1513.05, Sonoma County, California",20,20,0
1000000US060971513054007,060971513054007,"Block 4007, Block Group 4, Census Tract 1513.05, Sonoma County, California",21,20,1
1000000US060971513061000,060971513061000,"Block 1000, Block Group 1, Census Tract 1513.06, Sonoma County, California",93,91,2
1000000US060971513061001,060971513061001,"Block 1001, Block Group 1, Census Tract 1513.06, Sonoma County, California",42,42,0
1000000US060971513061002,060971513061002,"Block 1002, Block Group 1, Census Tract 1513.06, Sonoma County, California",23,23,0
1000000US060971513061003,060971513061003,"Block 1003, Block Group 1, Census Tract 1513.06, Sonoma County, California",31,31,0
1000000US060971513061004,060971513061004,"Block 1004, Block Group 1, Census Tract 1513.06, Sonoma County, California",0,0,0
1000000US060971513062000,060971513062000,"Block 2000, Block Group 2, Census Tract 1513.06, Sonoma County, California",47,44,3
1000000US060971513062001,060971513062001,"Block 2001, Block Group 2, Census Tract 1513.06, Sonoma County, California",23,23,0
1000000US060971513062002,060971513062002,"Block 2002, Block Group 2, Census Tract 1513.06, Sonoma County, California",22,22,0
1000000US060971513062003,060971513062003,"Block 2003, Block Group 2, Census Tract 1513.06, Sonoma County, California",0,0,0
1000000US060971513062004,060971513062004,"Block 2004, Block Group 2, Census Tract 1513.06, Sonoma County, California",54,46,8
1000000US060971513062005,060971513062005,"Block 2005, Block Group 2, Census Tract 1513.06, Sonoma County, California",127,119,8
1000000US060971513062006,060971513062006,"Block 2006, Block Group 2, Census Tract 1513.06, Sonoma County, California",28,25,3
1000000US060971513062007,060971513062007,"Block 2007, Block Group 2, Census Tract 1513.06, Sonoma County, California",0,0,0
1000000US060971513062008,060971513062008,"Block 2008, Block Group 2, Census Tract 1513.06, Sonoma County, California",78,73,5
1000000US060971513062009,060971513062009,"Block 2009, Block Group 2, Census Tract 1513.06, Sonoma County, California",0,0,0
1000000US060971513063000,060971513063000,"Block 3000, Block Group 3, Census Tract 1513.06, Sonoma County, California",45,44,1
1000000US060971513063001,060971513063001,"Block 3001, Block Group 3, Census Tract 1513.06, Sonoma County, California",0,0,0
1000000US060971513063002,060971513063002,"Block 3002, Block Group 3, Census Tract 1513.06, Sonoma County, California",136,130,6
1000000US060971513063003,060971513063003,"Block 3003, Block Group 3, Census Tract 1513.06, Sonoma County, California",119,111,8
1000000US060971513063004,060971513063004,"Block 3004, Block Group 3, Census Tract 1513.06, Sonoma County, California",27,26,1
1000000US060971513063005,060971513063005,"Block 3005, Block Group 3, Census Tract 1513.06, Sonoma County, California",72,68,4
1000000US060971513063006,060971513063006,"Block 3006, Block Group 3, Census Tract 1513.06, Sonoma County, California",15,15,0
1000000US060971513063007,060971513063007,"Block 3007, Block Group 3, Census Tract 1513.06, Sonoma County, California",0,0,0
1000000US060971513063008,060971513063008,"Block 3008, Block Group 3, Census Tract 1513.06, Sonoma County, California",0,0,0
1000000US060971513063009,060971513063009,"Block 3009, Block Group 3, Census Tract 1513.06, Sonoma County, California",0,0,0
1000000US060971513064000,060971513064000,"Block 4000, Block Group 4, Census Tract 1513.06, Sonoma County, California",145,134,11
1000000US060971513064001,060971513064001,"Block 4001, Block Group 4, Census Tract 1513.06, Sonoma County, California",25,24,1
1000000US060971513064002,060971513064002,"Block 4002, Block Group 4, Census Tract 1513.06, Sonoma County, California",25,24,1
1000000US060971513064003,060971513064003,"Block 4003, Block Group 4, Census Tract 1513.06, Sonoma County, California",151,145,6
1000000US060971513064004,060971513064004,"Block 4004, Block Group 4, Census Tract 1513.06, Sonoma County, California",0,0,0
1000000US060971513064005,060971513064005,"Block 4005, Block Group 4, Census Tract 1513.06, Sonoma County, California",0,0,0
1000000US060971513064006,060971513064006,"Block 4006, Block Group 4, Census Tract 1513.06, Sonoma County, California",20,20,0
1000000US060971513064007,060971513064007,"Block 4007, Block Group 4, Census Tract 1513.06, Sonoma County, California",24,24,0
1000000US060971513064008,060971513064008,"Block 4008, Block Group 4, Census Tract 1513.06, Sonoma County, California",270,255,15
1000000US060971513064009,060971513064009,"Block 4009, Block Group 4, Census Tract 1513.06, Sonoma County, California",0,0,0
1000000US060971513071000,060971513071000,"Block 1000, Block Group 1, Census Tract 1513.07, Sonoma County, California",0,0,0
1000000US060971513071001,060971513071001,"Block 1001, Block Group 1, Census Tract 1513.07, Sonoma County, California",75,73,2
1000000US060971513071002,060971513071002,"Block 1002, Block Group 1, Census Tract 1513.07, Sonoma County, California",44,41,3
1000000US060971513071003,060971513071003,"Block 1003, Block Group 1, Census Tract 1513.07, Sonoma County, California",0,0,0
1000000US060971513071004,060971513071004,"Block 1004, Block Group 1, Census Tract 1513.07, Sonoma County, California",59,59,0
1000000US060971513071005,060971513071005,"Block 1005, Block Group 1, Census Tract 1513.07, Sonoma County, California",41,41,0
1000000US060971513071006,060971513071006,"Block 1006, Block Group 1, Census Tract 1513.07, Sonoma County, California",0,0,0
1000000US060971513071007,060971513071007,"Block 1007, Block Group 1, Census Tract 1513.07, Sonoma County, California",0,0,0
1000000US060971513071008,060971513071008,"Block 1008, Block Group 1, Census Tract 1513.07, Sonoma County, California",407,389,18
1000000US060971513071009,060971513071009,"Block 1009, Block Group 1, Census Tract 1513.07, Sonoma County, California",14,14,0
1000000US060971513071010,060971513071010,"Block 1010, Block Group 1, Census Tract 1513.07, Sonoma County, California",0,0,0
1000000US060971513072000,060971513072000,"Block 2000, Block Group 2, Census Tract 1513.07, Sonoma County, California",26,24,2
1000000US060971513072001,060971513072001,"Block 2001, Block Group 2, Census Tract 1513.07, Sonoma County, California",82,76,6
1000000US060971513072002,060971513072002,"Block 2002, Block Group 2, Census Tract 1513.07, Sonoma County, California",32,31,1
1000000US060971513072003,060971513072003,"Block 2003, Block Group 2, Census Tract 1513.07, Sonoma County, California",0,0,0
1000000US060971513072004,060971513072004,"Block 2004, Block Group 2, Census Tract 1513.07, Sonoma County, California",0,0,0
1000000US060971513072005,060971513072005,"Block 2005, Block Group 2, Census Tract 1513.07, Sonoma County, California",0,0,0
1000000US060971513072006,060971513072006,"Block 2006, Block Group 2, Census Tract 1513.07, Sonoma County, California",0,0,0
1000000US060971513072007,060971513072007,"Block 2007, Block Group 2, Census Tract 1513.07, Sonoma County, California",0,0,0
1000000US060971513072008,060971513072008,"Block 2008, Block Group 2, Census Tract 1513.07, Sonoma County, California",0,0,0
1000000US060971513072009,060971513072009,"Block 2009, Block Group 2, Census Tract 1513.07, Sonoma County, California",136,134,2
1000000US060971513072010,060971513072010,"Block 2010, Block Group 2, Census Tract 1513.07, Sonoma County, California",45,43,2
1000000US060971513072011,060971513072011,"Block 2011, Block Group 2, Census Tract 1513.07, Sonoma County, California",19,19,0
1000000US060971513072012,060971513072012,"Block 2012, Block Group 2, Census Tract 1513.07, Sonoma County, California",0,0,0
1000000US060971513072013,060971513072013,"Block 2013, Block Group 2, Census Tract 1513.07, Sonoma County, California",23,22,1
1000000US060971513072014,060971513072014,"Block 2014, Block Group 2, Census Tract 1513.07, Sonoma County, California",0,0,0
1000000US060971513072015,060971513072015,"Block 2015, Block Group 2, Census Tract 1513.07, Sonoma County, California",0,0,0
1000000US060971513072016,060971513072016,"Block 2016, Block Group 2, Census Tract 1513.07, Sonoma County, California",5,5,0
1000000US060971513072017,060971513072017,"Block 2017, Block Group 2, Census Tract 1513.07, Sonoma County, California",0,0,0
1000000US060971513072018,060971513072018,"Block 2018, Block Group 2, Census Tract 1513.07, Sonoma County, California",0,0,0
1000000US060971513072019,060971513072019,"Block 2019, Block Group 2, Census Tract 1513.07, Sonoma County, California",0,0,0
1000000US060971513072020,060971513072020,"Block 2020, Block Group 2, Census Tract 1513.07, Sonoma County, California",0,0,0
1000000US060971513073000,060971513073000,"Block 3000, Block Group 3, Census Tract 1513.07, Sonoma County, California",104,99,5
1000000US060971513073001,060971513073001,"Block 3001, Block Group 3, Census Tract 1513.07, Sonoma County, California",19,19,0
1000000US060971513073002,060971513073002,"Block 3002, Block Group 3, Census Tract 1513.07, Sonoma County, California",0,0,0
1000000US060971513073003,060971513073003,"Block 3003, Block Group 3, Census Tract 1513.07, Sonoma County, California",0,0,0
1000000US060971513073004,060971513073004,"Block 3004, Block Group 3, Census Tract 1513.07, Sonoma County, California",64,61,3
1000000US060971513073005,060971513073005,"Block 3005, Block Group 3, Census Tract 1513.07, Sonoma County, California",139,138,1
1000000US060971513073006,060971513073006,"Block 3006, Block Group 3, Census Tract 1513.07, Sonoma County, California",82,77,5
1000000US060971513073007,060971513073007,"Block 3007, Block Group 3, Census Tract 1513.07, Sonoma County, California",5,4,1
1000000US060971513073008,060971513073008,"Block 3008, Block Group 3, Census Tract 1513.07, Sonoma County, California",23,23,0
1000000US060971513073009,060971513073009,"Block 3009, Block Group 3, Census Tract 1513.07, Sonoma County, California",0,0,0
1000000US060971513073010,060971513073010,"Block 3010, Block Group 3, Census Tract 1513.07, Sonoma County, California",0,0,0
1000000US060971513073011,060971513073011,"Block 3011, Block Group 3, Census Tract 1513.07, Sonoma County, California",17,15,2
1000000US060971513073012,060971513073012,"Block 3012, Block Group 3, Census Tract 1513.07, Sonoma County, California",12,10,2
1000000US060971513073013,060971513073013,"Block 3013, Block Group 3, Census Tract 1513.07, Sonoma County, California",0,0,0
1000000US060971513074000,060971513074000,"Block 4000, Block Group 4, Census Tract 1513.07, Sonoma County, California",25,25,0
1000000US060971513074001,060971513074001,"Block 4001, Block Group 4, Census Tract 1513.07, Sonoma County, California",130,127,3
1000000US060971513074002,060971513074002,"Block 4002, Block Group 4, Census Tract 1513.07, Sonoma County, California",83,79,4
1000000US060971513074003,060971513074003,"Block 4003, Block Group 4, Census Tract 1513.07, Sonoma County, California",9,9,0
1000000US060971513074004,060971513074004,"Block 4004, Block Group 4, Census Tract 1513.07, Sonoma County, California",9,9,0
1000000US060971513074005,060971513074005,"Block 4005, Block Group 4, Census Tract 1513.07, Sonoma County, California",0,0,0
1000000US060971513074006,060971513074006,"Block 4006, Block Group 4, Census Tract 1513.07, Sonoma County, California",9,9,0
1000000US060971513074007,060971513074007,"Block 4007, Block Group 4, Census Tract 1513.07, Sonoma County, California",0,0,0
1000000US060971513074008,060971513074008,"Block 4008, Block Group 4, Census Tract 1513.07, Sonoma County, California",188,150,38
1000000US060971513074009,060971513074009,"Block 4009, Block Group 4, Census Tract 1513.07, Sonoma County, California",33,31,2
1000000US060971513074010,060971513074010,"Block 4010, Block Group 4, Census Tract 1513.07, Sonoma County, California",0,0,0
1000000US060971513074011,060971513074011,"Block 4011, Block Group 4, Census Tract 1513.07, Sonoma County, California",10,5,5
1000000US060971513074012,060971513074012,"Block 4012, Block Group 4, Census Tract 1513.07, Sonoma County, California",0,0,0
1000000US060971513074013,060971513074013,"Block 4013, Block Group 4, Census Tract 1513.07, Sonoma County, California",0,0,0
1000000US060971513074014,060971513074014,"Block 4014, Block Group 4, Census Tract 1513.07, Sonoma County, California",0,0,0
1000000US060971513074015,060971513074015,"Block 4015, Block Group 4, Census Tract 1513.07, Sonoma County, California",16,9,7
1000000US060971513081000,060971513081000,"Block 1000, Block Group 1, Census Tract 1513.08, Sonoma County, California",27,26,1
1000000US060971513081001,060971513081001,"Block 1001, Block Group 1, Census Tract 1513.08, Sonoma County, California",2,2,0
1000000US060971513081002,060971513081002,"Block 1002, Block Group 1, Census Tract 1513.08, Sonoma County, California",0,0,0
1000000US060971513081003,060971513081003,"Block 1003, Block Group 1, Census Tract 1513.08, Sonoma County, California",36,34,2
1000000US060971513081004,060971513081004,"Block 1004, Block Group 1, Census Tract 1513.08, Sonoma County, California",20,20,0
1000000US060971513081005,060971513081005,"Block 1005, Block Group 1, Census Tract 1513.08, Sonoma County, California",12,12,0
1000000US060971513081006,060971513081006,"Block 1006, Block Group 1, Census Tract 1513.08, Sonoma County, California",27,26,1
1000000US060971513081007,060971513081007,"Block 1007, Block Group 1, Census Tract 1513.08, Sonoma County, California",21,21,0
1000000US060971513081008,060971513081008,"Block 1008, Block Group 1, Census Tract 1513.08, Sonoma County, California",35,34,1
1000000US060971513081009,060971513081009,"Block 1009, Block Group 1, Census Tract 1513.08, Sonoma County, California",9,9,0
1000000US060971513081010,060971513081010,"Block 1010, Block Group 1, Census Tract 1513.08, Sonoma County, California",48,47,1
1000000US060971513081011,060971513081011,"Block 1011, Block Group 1, Census Tract 1513.08, Sonoma County, California",1,1,0
1000000US060971513081012,060971513081012,"Block 1012, Block Group 1, Census Tract 1513.08, Sonoma County, California",0,0,0
1000000US060971513081013,060971513081013,"Block 1013, Block Group 1, Census Tract 1513.08, Sonoma County, California",10,10,0
1000000US060971513081014,060971513081014,"Block 1014, Block Group 1, Census Tract 1513.08, Sonoma County, California",42,41,1
1000000US060971513082000,060971513082000,"Block 2000, Block Group 2, Census Tract 1513.08, Sonoma County, California",39,37,2
1000000US060971513082001,060971513082001,"Block 2001, Block Group 2, Census Tract 1513.08, Sonoma County, California",25,23,2
1000000US060971513082002,060971513082002,"Block 2002, Block Group 2, Census Tract 1513.08, Sonoma County, California",39,39,0
1000000US060971513082003,060971513082003,"Block 2003, Block Group 2, Census Tract 1513.08, Sonoma County, California",625,589,36
1000000US060971513082004,060971513082004,"Block 2004, Block Group 2, Census Tract 1513.08, Sonoma County, California",29,27,2
1000000US060971513082005,060971513082005,"Block 2005, Block Group 2, Census Tract 1513.08, Sonoma County, California",8,7,1
1000000US060971513082006,060971513082006,"Block 2006, Block Group 2, Census Tract 1513.08, Sonoma County, California",21,21,0
1000000US060971513082007,060971513082007,"Block 2007, Block Group 2, Census Tract 1513.08, Sonoma County, California",15,15,0
1000000US060971513083000,060971513083000,"Block 3000, Block Group 3, Census Tract 1513.08, Sonoma County, California",52,46,6
1000000US060971513083001,060971513083001,"Block 3001, Block Group 3, Census Tract 1513.08, Sonoma County, California",146,137,9
1000000US060971513083002,060971513083002,"Block 3002, Block Group 3, Census Tract 1513.08, Sonoma County, California",1,1,0
1000000US060971513083003,060971513083003,"Block 3003, Block Group 3, Census Tract 1513.08, Sonoma County, California",108,95,13
1000000US060971513083004,060971513083004,"Block 3004, Block Group 3, Census Tract 1513.08, Sonoma County, California",0,0,0
1000000US060971513084000,060971513084000,"Block 4000, Block Group 4, Census Tract 1513.08, Sonoma County, California",0,0,0
1000000US060971513084001,060971513084001,"Block 4001, Block Group 4, Census Tract 1513.08, Sonoma County, California",35,33,2
1000000US060971513084002,060971513084002,"Block 4002, Block Group 4, Census Tract 1513.08, Sonoma County, California",103,102,1
1000000US060971513084003,060971513084003,"Block 4003, Block Group 4, Census Tract 1513.08, Sonoma County, California",0,0,0
1000000US060971513084004,060971513084004,"Block 4004, Block Group 4, Census Tract 1513.08, Sonoma County, California",0,0,0
1000000US060971513084005,060971513084005,"Block 4005, Block Group 4, Census Tract 1513.08, Sonoma County, California",17,17,0
1000000US060971513084006,060971513084006,"Block 4006, Block Group 4, Census Tract 1513.08, Sonoma County, California",61,59,2
1000000US060971513085000,060971513085000,"Block 5000, Block Group 5, Census Tract 1513.08, Sonoma County, California",2,2,0
1000000US060971513085001,060971513085001,"Block 5001, Block Group 5, Census Tract 1513.08, Sonoma County, California",102,99,3
1000000US060971513085002,060971513085002,"Block 5002, Block Group 5, Census Tract 1513.08, Sonoma County, California",17,16,1
1000000US060971513085003,060971513085003,"Block 5003, Block Group 5, Census Tract 1513.08, Sonoma County, California",219,206,13
1000000US060971513085004,060971513085004,"Block 5004, Block Group 5, Census Tract 1513.08, Sonoma County, California",12,12,0
1000000US060971513085005,060971513085005,"Block 5005, Block Group 5, Census Tract 1513.08, Sonoma County, California",30,30,0
1000000US060971513085006,060971513085006,"Block 5006, Block Group 5, Census Tract 1513.08, Sonoma County, California",0,0,0
1000000US060971513085007,060971513085007,"Block 5007, Block Group 5, Census Tract 1513.08, Sonoma County, California",0,0,0
1000000US060971513085008,060971513085008,"Block 5008, Block Group 5, Census Tract 1513.08, Sonoma County, California",0,0,0
1000000US060971513085009,060971513085009,"Block 5009, Block Group 5, Census Tract 1513.08, Sonoma County, California",0,0,0
1000000US060971513085010,060971513085010,"Block 5010, Block Group 5, Census Tract 1513.08, Sonoma County, California",14,14,0
1000000US060971513085011,060971513085011,"Block 5011, Block Group 5, Census Tract 1513.08, Sonoma County, California",1,1,0
1000000US060971513085012,060971513085012,"Block 5012, Block Group 5, Census Tract 1513.08, Sonoma County, California",0,0,0
1000000US060971513085013,060971513085013,"Block 5013, Block Group 5, Census Tract 1513.08, Sonoma County, California",0,0,0
1000000US060971513085014,060971513085014,"Block 5014, Block Group 5, Census Tract 1513.08, Sonoma County, California",0,0,0
1000000US060971513085015,060971513085015,"Block 5015, Block Group 5, Census Tract 1513.08, Sonoma County, California",0,0,0
1000000US060971513085016,060971513085016,"Block 5016, Block Group 5, Census Tract 1513.08, Sonoma County, California",0,0,0
1000000US060971513085017,060971513085017,"Block 5017, Block Group 5, Census Tract 1513.08, Sonoma County, California",12,12,0
1000000US060971513085018,060971513085018,"Block 5018, Block Group 5, Census Tract 1513.08, Sonoma County, California",45,45,0
1000000US060971513085019,060971513085019,"Block 5019, Block Group 5, Census Tract 1513.08, Sonoma County, California",0,0,0
1000000US060971513085020,060971513085020,"Block 5020, Block Group 5, Census Tract 1513.08, Sonoma County, California",0,0,0
1000000US060971513085021,060971513085021,"Block 5021, Block Group 5, Census Tract 1513.08, Sonoma County, California",0,0,0
1000000US060971513085022,060971513085022,"Block 5022, Block Group 5, Census Tract 1513.08, Sonoma County, California",47,45,2
1000000US060971513085023,060971513085023,"Block 5023, Block Group 5, Census Tract 1513.08, Sonoma County, California",50,49,1
1000000US060971513091000,060971513091000,"Block 1000, Block Group 1, Census Tract 1513.09, Sonoma County, California",51,44,7
1000000US060971513091001,060971513091001,"Block 1001, Block Group 1, Census Tract 1513.09, Sonoma County, California",12,10,2
1000000US060971513091002,060971513091002,"Block 1002, Block Group 1, Census Tract 1513.09, Sonoma County, California",1,1,0
1000000US060971513091003,060971513091003,"Block 1003, Block Group 1, Census Tract 1513.09, Sonoma County, California",95,82,13
1000000US060971513091004,060971513091004,"Block 1004, Block Group 1, Census Tract 1513.09, Sonoma County, California",13,10,3
1000000US060971513091005,060971513091005,"Block 1005, Block Group 1, Census Tract 1513.09, Sonoma County, California",2,2,0
1000000US060971513091006,060971513091006,"Block 1006, Block Group 1, Census Tract 1513.09, Sonoma County, California",1,1,0
1000000US060971513091007,060971513091007,"Block 1007, Block Group 1, Census Tract 1513.09, Sonoma County, California",1,1,0
1000000US060971513091008,060971513091008,"Block 1008, Block Group 1, Census Tract 1513.09, Sonoma County, California",0,0,0
1000000US060971513091009,060971513091009,"Block 1009, Block Group 1, Census Tract 1513.09, Sonoma County, California",0,0,0
1000000US060971513091010,060971513091010,"Block 1010, Block Group 1, Census Tract 1513.09, Sonoma County, California",0,0,0
1000000US060971513091011,060971513091011,"Block 1011, Block Group 1, Census Tract 1513.09, Sonoma County, California",5,4,1
1000000US060971513091012,060971513091012,"Block 1012, Block Group 1, Census Tract 1513.09, Sonoma County, California",5,5,0
1000000US060971513091013,060971513091013,"Block 1013, Block Group 1, Census Tract 1513.09, Sonoma County, California",13,13,0
1000000US060971513091014,060971513091014,"Block 1014, Block Group 1, Census Tract 1513.09, Sonoma County, California",1,1,0
1000000US060971513091015,060971513091015,"Block 1015, Block Group 1, Census Tract 1513.09, Sonoma County, California",3,3,0
1000000US060971513091016,060971513091016,"Block 1016, Block Group 1, Census Tract 1513.09, Sonoma County, California",8,8,0
1000000US060971513091017,060971513091017,"Block 1017, Block Group 1, Census Tract 1513.09, Sonoma County, California",2,2,0
1000000US060971513091018,060971513091018,"Block 1018, Block Group 1, Census Tract 1513.09, Sonoma County, California",34,31,3
1000000US060971513091019,060971513091019,"Block 1019, Block Group 1, Census Tract 1513.09, Sonoma County, California",21,19,2
1000000US060971513091020,060971513091020,"Block 1020, Block Group 1, Census Tract 1513.09, Sonoma County, California",57,45,12
1000000US060971513091021,060971513091021,"Block 1021, Block Group 1, Census Tract 1513.09, Sonoma County, California",72,72,0
1000000US060971513091022,060971513091022,"Block 1022, Block Group 1, Census Tract 1513.09, Sonoma County, California",16,16,0
1000000US060971513091023,060971513091023,"Block 1023, Block Group 1, Census Tract 1513.09, Sonoma County, California",13,13,0
1000000US060971513091024,060971513091024,"Block 1024, Block Group 1, Census Tract 1513.09, Sonoma County, California",8,7,1
1000000US060971513091025,060971513091025,"Block 1025, Block Group 1, Census Tract 1513.09, Sonoma County, California",2,2,0
1000000US060971513091026,060971513091026,"Block 1026, Block Group 1, Census Tract 1513.09, Sonoma County, California",0,0,0
1000000US060971513092000,060971513092000,"Block 2000, Block Group 2, Census Tract 1513.09, Sonoma County, California",26,23,3
1000000US060971513092001,060971513092001,"Block 2001, Block Group 2, Census Tract 1513.09, Sonoma County, California",0,0,0
1000000US060971513092002,060971513092002,"Block 2002, Block Group 2, Census Tract 1513.09, Sonoma County, California",5,5,0
1000000US060971513092003,060971513092003,"Block 2003, Block Group 2, Census Tract 1513.09, Sonoma County, California",84,84,0
1000000US060971513092004,060971513092004,"Block 2004, Block Group 2, Census Tract 1513.09, Sonoma County, California",12,9,3
1000000US060971513092005,060971513092005,"Block 2005, Block Group 2, Census Tract 1513.09, Sonoma County, California",26,26,0
1000000US060971513092006,060971513092006,"Block 2006, Block Group 2, Census Tract 1513.09, Sonoma County, California",0,0,0
1000000US060971513092007,060971513092007,"Block 2007, Block Group 2, Census Tract 1513.09, Sonoma County, California",44,41,3
1000000US060971513092008,060971513092008,"Block 2008, Block Group 2, Census Tract 1513.09, Sonoma County, California",31,30,1
1000000US060971513092009,060971513092009,"Block 2009, Block Group 2, Census Tract 1513.09, Sonoma County, California",61,60,1
1000000US060971513092010,060971513092010,"Block 2010, Block Group 2, Census Tract 1513.09, Sonoma County, California",60,60,0
1000000US060971513092011,060971513092011,"Block 2011, Block Group 2, Census Tract 1513.09, Sonoma County, California",42,40,2
1000000US060971513092012,060971513092012,"Block 2012, Block Group 2, Census Tract 1513.09, Sonoma County, California",318,302,16
1000000US060971513092013,060971513092013,"Block 2013, Block Group 2, Census Tract 1513.09, Sonoma County, California",17,16,1
1000000US060971513092014,060971513092014,"Block 2014, Block Group 2, Census Tract 1513.09, Sonoma County, California",0,0,0
1000000US060971513092015,060971513092015,"Block 2015, Block Group 2, Census Tract 1513.09, Sonoma County, California",0,0,0
1000000US060971513092016,060971513092016,"Block 2016, Block Group 2, Census Tract 1513.09, Sonoma County, California",3,3,0
1000000US060971513092017,060971513092017,"Block 2017, Block Group 2, Census Tract 1513.09, Sonoma County, California",0,0,0
1000000US060971513092018,060971513092018,"Block 2018, Block Group 2, Census Tract 1513.09, Sonoma County, California",78,77,1
1000000US060971513092019,060971513092019,"Block 2019, Block Group 2, Census Tract 1513.09, Sonoma County, California",114,110,4
1000000US060971513092020,060971513092020,"Block 2020, Block Group 2, Census Tract 1513.09, Sonoma County, California",0,0,0
1000000US060971513093000,060971513093000,"Block 3000, Block Group 3, Census Tract 1513.09, Sonoma County, California",7,7,0
1000000US060971513093001,060971513093001,"Block 3001, Block Group 3, Census Tract 1513.09, Sonoma County, California",2,2,0
1000000US060971513093002,060971513093002,"Block 3002, Block Group 3, Census Tract 1513.09, Sonoma County, California",7,7,0
1000000US060971513093003,060971513093003,"Block 3003, Block Group 3, Census Tract 1513.09, Sonoma County, California",10,8,2
1000000US060971513093004,060971513093004,"Block 3004, Block Group 3, Census Tract 1513.09, Sonoma County, California",1,1,0
1000000US060971513093005,060971513093005,"Block 3005, Block Group 3, Census Tract 1513.09, Sonoma County, California",0,0,0
1000000US060971513093006,060971513093006,"Block 3006, Block Group 3, Census Tract 1513.09, Sonoma County, California",0,0,0
1000000US060971513093007,060971513093007,"Block 3007, Block Group 3, Census Tract 1513.09, Sonoma County, California",158,142,16
1000000US060971513093008,060971513093008,"Block 3008, Block Group 3, Census Tract 1513.09, Sonoma County, California",0,0,0
1000000US060971513093009,060971513093009,"Block 3009, Block Group 3, Census Tract 1513.09, Sonoma County, California",55,50,5
1000000US060971513093010,060971513093010,"Block 3010, Block Group 3, Census Tract 1513.09, Sonoma County, California",0,0,0
1000000US060971513093011,060971513093011,"Block 3011, Block Group 3, Census Tract 1513.09, Sonoma County, California",0,0,0
1000000US060971513093012,060971513093012,"Block 3012, Block Group 3, Census Tract 1513.09, Sonoma County, California",0,0,0
1000000US060971513093013,060971513093013,"Block 3013, Block Group 3, Census Tract 1513.09, Sonoma County, California",7,7,0
1000000US060971513093014,060971513093014,"Block 3014, Block Group 3, Census Tract 1513.09, Sonoma County, California",39,38,1
1000000US060971513093015,060971513093015,"Block 3015, Block Group 3, Census Tract 1513.09, Sonoma County, California",1,1,0
1000000US060971513093016,060971513093016,"Block 3016, Block Group 3, Census Tract 1513.09, Sonoma County, California",67,67,0
1000000US060971513093017,060971513093017,"Block 3017, Block Group 3, Census Tract 1513.09, Sonoma County, California",0,0,0
1000000US060971513093018,060971513093018,"Block 3018, Block Group 3, Census Tract 1513.09, Sonoma County, California",0,0,0
1000000US060971513093019,060971513093019,"Block 3019, Block Group 3, Census Tract 1513.09, Sonoma County, California",122,106,16
1000000US060971513093020,060971513093020,"Block 3020, Block Group 3, Census Tract 1513.09, Sonoma County, California",0,0,0
1000000US060971513093021,060971513093021,"Block 3021, Block Group 3, Census Tract 1513.09, Sonoma County, California",95,93,2
1000000US060971513093022,060971513093022,"Block 3022, Block Group 3, Census Tract 1513.09, Sonoma County, California",0,0,0
1000000US060971513093023,060971513093023,"Block 3023, Block Group 3, Census Tract 1513.09, Sonoma County, California",22,20,2
1000000US060971513093024,060971513093024,"Block 3024, Block Group 3, Census Tract 1513.09, Sonoma County, California",9,8,1
1000000US060971513093025,060971513093025,"Block 3025, Block Group 3, Census Tract 1513.09, Sonoma County, California",28,26,2
1000000US060971513093026,060971513093026,"Block 3026, Block Group 3, Census Tract 1513.09, Sonoma County, California",0,0,0
1000000US060971513093027,060971513093027,"Block 3027, Block Group 3, Census Tract 1513.09, Sonoma County, California",0,0,0
1000000US060971513093028,060971513093028,"Block 3028, Block Group 3, Census Tract 1513.09, Sonoma County, California",0,0,0
1000000US060971513093029,060971513093029,"Block 3029, Block Group 3, Census Tract 1513.09, Sonoma County, California",0,0,0
1000000US060971513093030,060971513093030,"Block 3030, Block Group 3, Census Tract 1513.09, Sonoma County, California",0,0,0
1000000US060971513101000,060971513101000,"Block 1000, Block Group 1, Census Tract 1513.10, Sonoma County, California",28,27,1
1000000US060971513101001,060971513101001,"Block 1001, Block Group 1, Census Tract 1513.10, Sonoma County, California",204,196,8
1000000US060971513101002,060971513101002,"Block 1002, Block Group 1, Census Tract 1513.10, Sonoma County, California",46,44,2
1000000US060971513101003,060971513101003,"Block 1003, Block Group 1, Census Tract 1513.10, Sonoma County, California",0,0,0
1000000US060971513101004,060971513101004,"Block 1004, Block Group 1, Census Tract 1513.10, Sonoma County, California",0,0,0
1000000US060971513101005,060971513101005,"Block 1005, Block Group 1, Census Tract 1513.10, Sonoma County, California",0,0,0
1000000US060971513102000,060971513102000,"Block 2000, Block Group 2, Census Tract 1513.10, Sonoma County, California",257,244,13
1000000US060971513102001,060971513102001,"Block 2001, Block Group 2, Census Tract 1513.10, Sonoma County, California",112,110,2
1000000US060971513102002,060971513102002,"Block 2002, Block Group 2, Census Tract 1513.10, Sonoma County, California",36,35,1
1000000US060971513102003,060971513102003,"Block 2003, Block Group 2, Census Tract 1513.10, Sonoma County, California",27,25,2
1000000US060971513102004,060971513102004,"Block 2004, Block Group 2, Census Tract 1513.10, Sonoma County, California",16,15,1
1000000US060971513102005,060971513102005,"Block 2005, Block Group 2, Census Tract 1513.10, Sonoma County, California",9,9,0
1000000US060971513102006,060971513102006,"Block 2006, Block Group 2, Census Tract 1513.10, Sonoma County, California",0,0,0
1000000US060971513102007,060971513102007,"Block 2007, Block Group 2, Census Tract 1513.10, Sonoma County, California",2,2,0
1000000US060971513102008,060971513102008,"Block 2008, Block Group 2, Census Tract 1513.10, Sonoma County, California",1,1,0
1000000US060971513102009,060971513102009,"Block 2009, Block Group 2, Census Tract 1513.10, Sonoma County, California",54,51,3
1000000US060971513102010,060971513102010,"Block 2010, Block Group 2, Census Tract 1513.10, Sonoma County, California",2,2,0
1000000US060971513103000,060971513103000,"Block 3000, Block Group 3, Census Tract 1513.10, Sonoma County, California",0,0,0
1000000US060971513103001,060971513103001,"Block 3001, Block Group 3, Census Tract 1513.10, Sonoma County, California",0,0,0
1000000US060971513103002,060971513103002,"Block 3002, Block Group 3, Census Tract 1513.10, Sonoma County, California",0,0,0
1000000US060971513103003,060971513103003,"Block 3003, Block Group 3, Census Tract 1513.10, Sonoma County, California",51,49,2
1000000US060971513103004,060971513103004,"Block 3004, Block Group 3, Census Tract 1513.10, Sonoma County, California",12,11,1
1000000US060971513103005,060971513103005,"Block 3005, Block Group 3, Census Tract 1513.10, Sonoma County, California",26,26,0
1000000US060971513103006,060971513103006,"Block 3006, Block Group 3, Census Tract 1513.10, Sonoma County, California",183,177,6
1000000US060971513103007,060971513103007,"Block 3007, Block Group 3, Census Tract 1513.10, Sonoma County, California",0,0,0
1000000US060971513103008,060971513103008,"Block 3008, Block Group 3, Census Tract 1513.10, Sonoma County, California",0,0,0
1000000US060971513103009,060971513103009,"Block 3009, Block Group 3, Census Tract 1513.10, Sonoma County, California",98,93,5
1000000US060971513103010,060971513103010,"Block 3010, Block Group 3, Census Tract 1513.10, Sonoma County, California",89,86,3
1000000US060971513103011,060971513103011,"Block 3011, Block Group 3, Census Tract 1513.10, Sonoma County, California",27,25,2
1000000US060971513103012,060971513103012,"Block 3012, Block Group 3, Census Tract 1513.10, Sonoma County, California",0,0,0
1000000US060971513103013,060971513103013,"Block 3013, Block Group 3, Census Tract 1513.10, Sonoma County, California",0,0,0
1000000US060971513104000,060971513104000,"Block 4000, Block Group 4, Census Tract 1513.10, Sonoma County, California",0,0,0
1000000US060971513104001,060971513104001,"Block 4001, Block Group 4, Census Tract 1513.10, Sonoma County, California",10,9,1
1000000US060971513104002,060971513104002,"Block 4002, Block Group 4, Census Tract 1513.10, Sonoma County, California",0,0,0
1000000US060971513104003,060971513104003,"Block 4003, Block Group 4, Census Tract 1513.10, Sonoma County, California",0,0,0
1000000US060971513104004,060971513104004,"Block 4004, Block Group 4, Census Tract 1513.10, Sonoma County, California",0,0,0
1000000US060971513104005,060971513104005,"Block 4005, Block Group 4, Census Tract 1513.10, Sonoma County, California",0,0,0
1000000US060971513104006,060971513104006,"Block 4006, Block Group 4, Census Tract 1513.10, Sonoma County, California",0,0,0
1000000US060971513104007,060971513104007,"Block 4007, Block Group 4, Census Tract 1513.10, Sonoma County, California",0,0,0
1000000US060971513104008,060971513104008,"Block 4008, Block Group 4, Census Tract 1513.10, Sonoma County, California",0,0,0
1000000US060971513104009,060971513104009,"Block 4009, Block Group 4, Census Tract 1513.10, Sonoma County, California",108,104,4
1000000US060971513104010,060971513104010,"Block 4010, Block Group 4, Census Tract 1513.10, Sonoma County, California",29,28,1
1000000US060971513104011,060971513104011,"Block 4011, Block Group 4, Census Tract 1513.10, Sonoma County, California",20,19,1
1000000US060971513104012,060971513104012,"Block 4012, Block Group 4, Census Tract 1513.10, Sonoma County, California",0,0,0
1000000US060971513104013,060971513104013,"Block 4013, Block Group 4, Census Tract 1513.10, Sonoma County, California",0,0,0
1000000US060971513104014,060971513104014,"Block 4014, Block Group 4, Census Tract 1513.10, Sonoma County, California",0,0,0
1000000US060971513104015,060971513104015,"Block 4015, Block Group 4, Census Tract 1513.10, Sonoma County, California",25,25,0
1000000US060971513104016,060971513104016,"Block 4016, Block Group 4, Census Tract 1513.10, Sonoma County, California",42,41,1
1000000US060971513104017,060971513104017,"Block 4017, Block Group 4, Census Tract 1513.10, Sonoma County, California",0,0,0
1000000US060971513104018,060971513104018,"Block 4018, Block Group 4, Census Tract 1513.10, Sonoma County, California",0,0,0
1000000US060971513104019,060971513104019,"Block 4019, Block Group 4, Census Tract 1513.10, Sonoma County, California",0,0,0
1000000US060971513104020,060971513104020,"Block 4020, Block Group 4, Census Tract 1513.10, Sonoma County, California",0,0,0
1000000US060971513104021,060971513104021,"Block 4021, Block Group 4, Census Tract 1513.10, Sonoma County, California",0,0,0
1000000US060971513104022,060971513104022,"Block 4022, Block Group 4, Census Tract 1513.10, Sonoma County, California",0,0,0
1000000US060971513104023,060971513104023,"Block 4023, Block Group 4, Census Tract 1513.10, Sonoma County, California",0,0,0
1000000US060971513104024,060971513104024,"Block 4024, Block Group 4, Census Tract 1513.10, Sonoma County, California",0,0,0
1000000US060971513111000,060971513111000,"Block 1000, Block Group 1, Census Tract 1513.11, Sonoma County, California",0,0,0
1000000US060971513111001,060971513111001,"Block 1001, Block Group 1, Census Tract 1513.11, Sonoma County, California",202,195,7
1000000US060971513111002,060971513111002,"Block 1002, Block Group 1, Census Tract 1513.11, Sonoma County, California",18,18,0
1000000US060971513111003,060971513111003,"Block 1003, Block Group 1, Census Tract 1513.11, Sonoma County, California",0,0,0
1000000US060971513111004,060971513111004,"Block 1004, Block Group 1, Census Tract 1513.11, Sonoma County, California",0,0,0
1000000US060971513111005,060971513111005,"Block 1005, Block Group 1, Census Tract 1513.11, Sonoma County, California",1,1,0
1000000US060971513111006,060971513111006,"Block 1006, Block Group 1, Census Tract 1513.11, Sonoma County, California",32,32,0
1000000US060971513111007,060971513111007,"Block 1007, Block Group 1, Census Tract 1513.11, Sonoma County, California",0,0,0
1000000US060971513111008,060971513111008,"Block 1008, Block Group 1, Census Tract 1513.11, Sonoma County, California",18,18,0
1000000US060971513111009,060971513111009,"Block 1009, Block Group 1, Census Tract 1513.11, Sonoma County, California",0,0,0
1000000US060971513111010,060971513111010,"Block 1010, Block Group 1, Census Tract 1513.11, Sonoma County, California",0,0,0
1000000US060971513111011,060971513111011,"Block 1011, Block Group 1, Census Tract 1513.11, Sonoma County, California",18,18,0
1000000US060971513111012,060971513111012,"Block 1012, Block Group 1, Census Tract 1513.11, Sonoma County, California",0,0,0
1000000US060971513111013,060971513111013,"Block 1013, Block Group 1, Census Tract 1513.11, Sonoma County, California",36,35,1
1000000US060971513111014,060971513111014,"Block 1014, Block Group 1, Census Tract 1513.11, Sonoma County, California",18,18,0
1000000US060971513111015,060971513111015,"Block 1015, Block Group 1, Census Tract 1513.11, Sonoma County, California",41,40,1
1000000US060971513111016,060971513111016,"Block 1016, Block Group 1, Census Tract 1513.11, Sonoma County, California",26,23,3
1000000US060971513111017,060971513111017,"Block 1017, Block Group 1, Census Tract 1513.11, Sonoma County, California",0,0,0
1000000US060971513111018,060971513111018,"Block 1018, Block Group 1, Census Tract 1513.11, Sonoma County, California",1,1,0
1000000US060971513111019,060971513111019,"Block 1019, Block Group 1, Census Tract 1513.11, Sonoma County, California",0,0,0
1000000US060971513111020,060971513111020,"Block 1020, Block Group 1, Census Tract 1513.11, Sonoma County, California",21,19,2
1000000US060971513111021,060971513111021,"Block 1021, Block Group 1, Census Tract 1513.11, Sonoma County, California",36,32,4
1000000US060971513111022,060971513111022,"Block 1022, Block Group 1, Census Tract 1513.11, Sonoma County, California",0,0,0
1000000US060971513111023,060971513111023,"Block 1023, Block Group 1, Census Tract 1513.11, Sonoma County, California",0,0,0
1000000US060971513111024,060971513111024,"Block 1024, Block Group 1, Census Tract 1513.11, Sonoma County, California",0,0,0
1000000US060971513111025,060971513111025,"Block 1025, Block Group 1, Census Tract 1513.11, Sonoma County, California",0,0,0
1000000US060971513111026,060971513111026,"Block 1026, Block Group 1, Census Tract 1513.11, Sonoma County, California",0,0,0
1000000US060971513111027,060971513111027,"Block 1027, Block Group 1, Census Tract 1513.11, Sonoma County, California",0,0,0
1000000US060971513111028,060971513111028,"Block 1028, Block Group 1, Census Tract 1513.11, Sonoma County, California",0,0,0
1000000US060971513111029,060971513111029,"Block 1029, Block Group 1, Census Tract 1513.11, Sonoma County, California",0,0,0
1000000US060971513111030,060971513111030,"Block 1030, Block Group 1, Census Tract 1513.11, Sonoma County, California",0,0,0
1000000US060971513111031,060971513111031,"Block 1031, Block Group 1, Census Tract 1513.11, Sonoma County, California",0,0,0
1000000US060971513112000,060971513112000,"Block 2000, Block Group 2, Census Tract 1513.11, Sonoma County, California",0,0,0
1000000US060971513112001,060971513112001,"Block 2001, Block Group 2, Census Tract 1513.11, Sonoma County, California",489,478,11
1000000US060971513112002,060971513112002,"Block 2002, Block Group 2, Census Tract 1513.11, Sonoma County, California",0,0,0
1000000US060971513112003,060971513112003,"Block 2003, Block Group 2, Census Tract 1513.11, Sonoma County, California",0,0,0
1000000US060971513112004,060971513112004,"Block 2004, Block Group 2, Census Tract 1513.11, Sonoma County, California",60,58,2
1000000US060971513113000,060971513113000,"Block 3000, Block Group 3, Census Tract 1513.11, Sonoma County, California",95,95,0
1000000US060971513113001,060971513113001,"Block 3001, Block Group 3, Census Tract 1513.11, Sonoma County, California",28,27,1
1000000US060971513113002,060971513113002,"Block 3002, Block Group 3, Census Tract 1513.11, Sonoma County, California",120,116,4
1000000US060971513113003,060971513113003,"Block 3003, Block Group 3, Census Tract 1513.11, Sonoma County, California",440,410,30
1000000US060971513113004,060971513113004,"Block 3004, Block Group 3, Census Tract 1513.11, Sonoma County, California",0,0,0
1000000US060971513113005,060971513113005,"Block 3005, Block Group 3, Census Tract 1513.11, Sonoma County, California",38,35,3
1000000US060971513114000,060971513114000,"Block 4000, Block Group 4, Census Tract 1513.11, Sonoma County, California",125,124,1
1000000US060971513114001,060971513114001,"Block 4001, Block Group 4, Census Tract 1513.11, Sonoma County, California",22,20,2
1000000US060971513114002,060971513114002,"Block 4002, Block Group 4, Census Tract 1513.11, Sonoma County, California",0,0,0
1000000US060971513114003,060971513114003,"Block 4003, Block Group 4, Census Tract 1513.11, Sonoma County, California",70,68,2
1000000US060971513114004,060971513114004,"Block 4004, Block Group 4, Census Tract 1513.11, Sonoma County, California",78,73,5
1000000US060971513114005,060971513114005,"Block 4005, Block Group 4, Census Tract 1513.11, Sonoma County, California",64,63,1
1000000US060971513115000,060971513115000,"Block 5000, Block Group 5, Census Tract 1513.11, Sonoma County, California",32,30,2
1000000US060971513115001,060971513115001,"Block 5001, Block Group 5, Census Tract 1513.11, Sonoma County, California",80,78,2
1000000US060971513115002,060971513115002,"Block 5002, Block Group 5, Census Tract 1513.11, Sonoma County, California",25,23,2
1000000US060971513115003,060971513115003,"Block 5003, Block Group 5, Census Tract 1513.11, Sonoma County, California",17,17,0
1000000US060971513115004,060971513115004,"Block 5004, Block Group 5, Census Tract 1513.11, Sonoma County, California",22,21,1
1000000US060971513115005,060971513115005,"Block 5005, Block Group 5, Census Tract 1513.11, Sonoma County, California",46,44,2
1000000US060971513115006,060971513115006,"Block 5006, Block Group 5, Census Tract 1513.11, Sonoma County, California",4,4,0
1000000US060971513115007,060971513115007,"Block 5007, Block Group 5, Census Tract 1513.11, Sonoma County, California",13,12,1
1000000US060971513115008,060971513115008,"Block 5008, Block Group 5, Census Tract 1513.11, Sonoma County, California",0,0,0
1000000US060971513115009,060971513115009,"Block 5009, Block Group 5, Census Tract 1513.11, Sonoma County, California",0,0,0
1000000US060971513115010,060971513115010,"Block 5010, Block Group 5, Census Tract 1513.11, Sonoma County, California",0,0,0
1000000US060971513115011,060971513115011,"Block 5011, Block Group 5, Census Tract 1513.11, Sonoma County, California",0,0,0
1000000US060971513115012,060971513115012,"Block 5012, Block Group 5, Census Tract 1513.11, Sonoma County, California",0,0,0
1000000US060971513115013,060971513115013,"Block 5013, Block Group 5, Census Tract 1513.11, Sonoma County, California",0,0,0
1000000US060971513115014,060971513115014,"Block 5014, Block Group 5, Census Tract 1513.11, Sonoma County, California",0,0,0
1000000US060971513115015,060971513115015,"Block 5015, Block Group 5, Census Tract 1513.11, Sonoma County, California",94,94,0
1000000US060971514011000,060971514011000,"Block 1000, Block Group 1, Census Tract 1514.01, Sonoma County, California",0,0,0
1000000US060971514011001,060971514011001,"Block 1001, Block Group 1, Census Tract 1514.01, Sonoma County, California",1,1,0
1000000US060971514011002,060971514011002,"Block 1002, Block Group 1, Census Tract 1514.01, Sonoma County, California",11,11,0
1000000US060971514011003,060971514011003,"Block 1003, Block Group 1, Census Tract 1514.01, Sonoma County, California",53,49,4
1000000US060971514011004,060971514011004,"Block 1004, Block Group 1, Census Tract 1514.01, Sonoma County, California",0,0,0
1000000US060971514011005,060971514011005,"Block 1005, Block Group 1, Census Tract 1514.01, Sonoma County, California",37,36,1
1000000US060971514011006,060971514011006,"Block 1006, Block Group 1, Census Tract 1514.01, Sonoma County, California",19,19,0
1000000US060971514011007,060971514011007,"Block 1007, Block Group 1, Census Tract 1514.01, Sonoma County, California",9,8,1
1000000US060971514011008,060971514011008,"Block 1008, Block Group 1, Census Tract 1514.01, Sonoma County, California",0,0,0
1000000US060971514011009,060971514011009,"Block 1009, Block Group 1, Census Tract 1514.01, Sonoma County, California",0,0,0
1000000US060971514011010,060971514011010,"Block 1010, Block Group 1, Census Tract 1514.01, Sonoma County, California",0,0,0
1000000US060971514011011,060971514011011,"Block 1011, Block Group 1, Census Tract 1514.01, Sonoma County, California",33,32,1
1000000US060971514011012,060971514011012,"Block 1012, Block Group 1, Census Tract 1514.01, Sonoma County, California",0,0,0
1000000US060971514011013,060971514011013,"Block 1013, Block Group 1, Census Tract 1514.01, Sonoma County, California",0,0,0
1000000US060971514011014,060971514011014,"Block 1014, Block Group 1, Census Tract 1514.01, Sonoma County, California",126,112,14
1000000US060971514011015,060971514011015,"Block 1015, Block Group 1, Census Tract 1514.01, Sonoma County, California",24,22,2
1000000US060971514011016,060971514011016,"Block 1016, Block Group 1, Census Tract 1514.01, Sonoma County, California",0,0,0
1000000US060971514011017,060971514011017,"Block 1017, Block Group 1, Census Tract 1514.01, Sonoma County, California",1,1,0
1000000US060971514011018,060971514011018,"Block 1018, Block Group 1, Census Tract 1514.01, Sonoma County, California",0,0,0
1000000US060971514011019,060971514011019,"Block 1019, Block Group 1, Census Tract 1514.01, Sonoma County, California",0,0,0
1000000US060971514011020,060971514011020,"Block 1020, Block Group 1, Census Tract 1514.01, Sonoma County, California",6,5,1
1000000US060971514011021,060971514011021,"Block 1021, Block Group 1, Census Tract 1514.01, Sonoma County, California",0,0,0
1000000US060971514011022,060971514011022,"Block 1022, Block Group 1, Census Tract 1514.01, Sonoma County, California",23,22,1
1000000US060971514011023,060971514011023,"Block 1023, Block Group 1, Census Tract 1514.01, Sonoma County, California",74,71,3
1000000US060971514011024,060971514011024,"Block 1024, Block Group 1, Census Tract 1514.01, Sonoma County, California",4,3,1
1000000US060971514011025,060971514011025,"Block 1025, Block Group 1, Census Tract 1514.01, Sonoma County, California",49,48,1
1000000US060971514011026,060971514011026,"Block 1026, Block Group 1, Census Tract 1514.01, Sonoma County, California",56,51,5
1000000US060971514011027,060971514011027,"Block 1027, Block Group 1, Census Tract 1514.01, Sonoma County, California",35,32,3
1000000US060971514011028,060971514011028,"Block 1028, Block Group 1, Census Tract 1514.01, Sonoma County, California",8,5,3
1000000US060971514011029,060971514011029,"Block 1029, Block Group 1, Census Tract 1514.01, Sonoma County, California",19,19,0
1000000US060971514011030,060971514011030,"Block 1030, Block Group 1, Census Tract 1514.01, Sonoma County, California",10,8,2
1000000US060971514011031,060971514011031,"Block 1031, Block Group 1, Census Tract 1514.01, Sonoma County, California",2,2,0
1000000US060971514011032,060971514011032,"Block 1032, Block Group 1, Census Tract 1514.01, Sonoma County, California",1,1,0
1000000US060971514011033,060971514011033,"Block 1033, Block Group 1, Census Tract 1514.01, Sonoma County, California",1,1,0
1000000US060971514011034,060971514011034,"Block 1034, Block Group 1, Census Tract 1514.01, Sonoma County, California",41,41,0
1000000US060971514011035,060971514011035,"Block 1035, Block Group 1, Census Tract 1514.01, Sonoma County, California",0,0,0
1000000US060971514011036,060971514011036,"Block 1036, Block Group 1, Census Tract 1514.01, Sonoma County, California",7,7,0
1000000US060971514011037,060971514011037,"Block 1037, Block Group 1, Census Tract 1514.01, Sonoma County, California",2,1,1
1000000US060971514011038,060971514011038,"Block 1038, Block Group 1, Census Tract 1514.01, Sonoma County, California",1,0,1
1000000US060971514011039,060971514011039,"Block 1039, Block Group 1, Census Tract 1514.01, Sonoma County, California",5,4,1
1000000US060971514011040,060971514011040,"Block 1040, Block Group 1, Census Tract 1514.01, Sonoma County, California",1,1,0
1000000US060971514011041,060971514011041,"Block 1041, Block Group 1, Census Tract 1514.01, Sonoma County, California",1,1,0
1000000US060971514011042,060971514011042,"Block 1042, Block Group 1, Census Tract 1514.01, Sonoma County, California",12,10,2
1000000US060971514011043,060971514011043,"Block 1043, Block Group 1, Census Tract 1514.01, Sonoma County, California",0,0,0
1000000US060971514011044,060971514011044,"Block 1044, Block Group 1, Census Tract 1514.01, Sonoma County, California",0,0,0
1000000US060971514011045,060971514011045,"Block 1045, Block Group 1, Census Tract 1514.01, Sonoma County, California",0,0,0
1000000US060971514011046,060971514011046,"Block 1046, Block Group 1, Census Tract 1514.01, Sonoma County, California",0,0,0
1000000US060971514011047,060971514011047,"Block 1047, Block Group 1, Census Tract 1514.01, Sonoma County, California",27,23,4
1000000US060971514011048,060971514011048,"Block 1048, Block Group 1, Census Tract 1514.01, Sonoma County, California",20,19,1
1000000US060971514011049,060971514011049,"Block 1049, Block Group 1, Census Tract 1514.01, Sonoma County, California",1,1,0
1000000US060971514011050,060971514011050,"Block 1050, Block Group 1, Census Tract 1514.01, Sonoma County, California",0,0,0
1000000US060971514011051,060971514011051,"Block 1051, Block Group 1, Census Tract 1514.01, Sonoma County, California",0,0,0
1000000US060971514011052,060971514011052,"Block 1052, Block Group 1, Census Tract 1514.01, Sonoma County, California",30,27,3
1000000US060971514011053,060971514011053,"Block 1053, Block Group 1, Census Tract 1514.01, Sonoma County, California",16,14,2
1000000US060971514011054,060971514011054,"Block 1054, Block Group 1, Census Tract 1514.01, Sonoma County, California",35,30,5
1000000US060971514011055,060971514011055,"Block 1055, Block Group 1, Census Tract 1514.01, Sonoma County, California",0,0,0
1000000US060971514011056,060971514011056,"Block 1056, Block Group 1, Census Tract 1514.01, Sonoma County, California",7,6,1
1000000US060971514011057,060971514011057,"Block 1057, Block Group 1, Census Tract 1514.01, Sonoma County, California",27,26,1
1000000US060971514011058,060971514011058,"Block 1058, Block Group 1, Census Tract 1514.01, Sonoma County, California",38,35,3
1000000US060971514011059,060971514011059,"Block 1059, Block Group 1, Census Tract 1514.01, Sonoma County, California",19,17,2
1000000US060971514011060,060971514011060,"Block 1060, Block Group 1, Census Tract 1514.01, Sonoma County, California",22,22,0
1000000US060971514011061,060971514011061,"Block 1061, Block Group 1, Census Tract 1514.01, Sonoma County, California",10,10,0
1000000US060971514011062,060971514011062,"Block 1062, Block Group 1, Census Tract 1514.01, Sonoma County, California",10,10,0
1000000US060971514011063,060971514011063,"Block 1063, Block Group 1, Census Tract 1514.01, Sonoma County, California",10,9,1
1000000US060971514011064,060971514011064,"Block 1064, Block Group 1, Census Tract 1514.01, Sonoma County, California",10,9,1
1000000US060971514011065,060971514011065,"Block 1065, Block Group 1, Census Tract 1514.01, Sonoma County, California",10,9,1
1000000US060971514011066,060971514011066,"Block 1066, Block Group 1, Census Tract 1514.01, Sonoma County, California",29,27,2
1000000US060971514011067,060971514011067,"Block 1067, Block Group 1, Census Tract 1514.01, Sonoma County, California",17,17,0
1000000US060971514011068,060971514011068,"Block 1068, Block Group 1, Census Tract 1514.01, Sonoma County, California",18,17,1
1000000US060971514011069,060971514011069,"Block 1069, Block Group 1, Census Tract 1514.01, Sonoma County, California",25,25,0
1000000US060971514011070,060971514011070,"Block 1070, Block Group 1, Census Tract 1514.01, Sonoma County, California",3,0,3
1000000US060971514011071,060971514011071,"Block 1071, Block Group 1, Census Tract 1514.01, Sonoma County, California",12,11,1
1000000US060971514011072,060971514011072,"Block 1072, Block Group 1, Census Tract 1514.01, Sonoma County, California",16,16,0
1000000US060971514011073,060971514011073,"Block 1073, Block Group 1, Census Tract 1514.01, Sonoma County, California",79,78,1
1000000US060971514011074,060971514011074,"Block 1074, Block Group 1, Census Tract 1514.01, Sonoma County, California",16,15,1
1000000US060971514011075,060971514011075,"Block 1075, Block Group 1, Census Tract 1514.01, Sonoma County, California",18,18,0
1000000US060971514011076,060971514011076,"Block 1076, Block Group 1, Census Tract 1514.01, Sonoma County, California",16,16,0
1000000US060971514011077,060971514011077,"Block 1077, Block Group 1, Census Tract 1514.01, Sonoma County, California",14,12,2
1000000US060971514011078,060971514011078,"Block 1078, Block Group 1, Census Tract 1514.01, Sonoma County, California",13,13,0
1000000US060971514011079,060971514011079,"Block 1079, Block Group 1, Census Tract 1514.01, Sonoma County, California",16,13,3
1000000US060971514011080,060971514011080,"Block 1080, Block Group 1, Census Tract 1514.01, Sonoma County, California",53,50,3
1000000US060971514011081,060971514011081,"Block 1081, Block Group 1, Census Tract 1514.01, Sonoma County, California",6,4,2
1000000US060971514011082,060971514011082,"Block 1082, Block Group 1, Census Tract 1514.01, Sonoma County, California",3,1,2
1000000US060971514011083,060971514011083,"Block 1083, Block Group 1, Census Tract 1514.01, Sonoma County, California",11,9,2
1000000US060971514011084,060971514011084,"Block 1084, Block Group 1, Census Tract 1514.01, Sonoma County, California",0,0,0
1000000US060971514011085,060971514011085,"Block 1085, Block Group 1, Census Tract 1514.01, Sonoma County, California",4,4,0
1000000US060971514011086,060971514011086,"Block 1086, Block Group 1, Census Tract 1514.01, Sonoma County, California",19,19,0
1000000US060971514011087,060971514011087,"Block 1087, Block Group 1, Census Tract 1514.01, Sonoma County, California",21,20,1
1000000US060971514011088,060971514011088,"Block 1088, Block Group 1, Census Tract 1514.01, Sonoma County, California",8,5,3
1000000US060971514011089,060971514011089,"Block 1089, Block Group 1, Census Tract 1514.01, Sonoma County, California",1,1,0
1000000US060971514012000,060971514012000,"Block 2000, Block Group 2, Census Tract 1514.01, Sonoma County, California",0,0,0
1000000US060971514012001,060971514012001,"Block 2001, Block Group 2, Census Tract 1514.01, Sonoma County, California",0,0,0
1000000US060971514012002,060971514012002,"Block 2002, Block Group 2, Census Tract 1514.01, Sonoma County, California",0,0,0
1000000US060971514012003,060971514012003,"Block 2003, Block Group 2, Census Tract 1514.01, Sonoma County, California",0,0,0
1000000US060971514012004,060971514012004,"Block 2004, Block Group 2, Census Tract 1514.01, Sonoma County, California",0,0,0
1000000US060971514012005,060971514012005,"Block 2005, Block Group 2, Census Tract 1514.01, Sonoma County, California",0,0,0
1000000US060971514012006,060971514012006,"Block 2006, Block Group 2, Census Tract 1514.01, Sonoma County, California",0,0,0
1000000US060971514012007,060971514012007,"Block 2007, Block Group 2, Census Tract 1514.01, Sonoma County, California",0,0,0
1000000US060971514012008,060971514012008,"Block 2008, Block Group 2, Census Tract 1514.01, Sonoma County, California",0,0,0
1000000US060971514012009,060971514012009,"Block 2009, Block Group 2, Census Tract 1514.01, Sonoma County, California",0,0,0
1000000US060971514012010,060971514012010,"Block 2010, Block Group 2, Census Tract 1514.01, Sonoma County, California",54,52,2
1000000US060971514012011,060971514012011,"Block 2011, Block Group 2, Census Tract 1514.01, Sonoma County, California",0,0,0
1000000US060971514012012,060971514012012,"Block 2012, Block Group 2, Census Tract 1514.01, Sonoma County, California",0,0,0
1000000US060971514012013,060971514012013,"Block 2013, Block Group 2, Census Tract 1514.01, Sonoma County, California",0,0,0
1000000US060971514012014,060971514012014,"Block 2014, Block Group 2, Census Tract 1514.01, Sonoma County, California",24,24,0
1000000US060971514012015,060971514012015,"Block 2015, Block Group 2, Census Tract 1514.01, Sonoma County, California",36,33,3
1000000US060971514012016,060971514012016,"Block 2016, Block Group 2, Census Tract 1514.01, Sonoma County, California",18,18,0
1000000US060971514012017,060971514012017,"Block 2017, Block Group 2, Census Tract 1514.01, Sonoma County, California",5,5,0
1000000US060971514012018,060971514012018,"Block 2018, Block Group 2, Census Tract 1514.01, Sonoma County, California",13,12,1
1000000US060971514012019,060971514012019,"Block 2019, Block Group 2, Census Tract 1514.01, Sonoma County, California",22,21,1
1000000US060971514012020,060971514012020,"Block 2020, Block Group 2, Census Tract 1514.01, Sonoma County, California",27,27,0
1000000US060971514012021,060971514012021,"Block 2021, Block Group 2, Census Tract 1514.01, Sonoma County, California",15,14,1
1000000US060971514012022,060971514012022,"Block 2022, Block Group 2, Census Tract 1514.01, Sonoma County, California",22,18,4
1000000US060971514012023,060971514012023,"Block 2023, Block Group 2, Census Tract 1514.01, Sonoma County, California",182,174,8
1000000US060971514012024,060971514012024,"Block 2024, Block Group 2, Census Tract 1514.01, Sonoma County, California",20,18,2
1000000US060971514012025,060971514012025,"Block 2025, Block Group 2, Census Tract 1514.01, Sonoma County, California",13,12,1
1000000US060971514012026,060971514012026,"Block 2026, Block Group 2, Census Tract 1514.01, Sonoma County, California",25,25,0
1000000US060971514012027,060971514012027,"Block 2027, Block Group 2, Census Tract 1514.01, Sonoma County, California",20,16,4
1000000US060971514012028,060971514012028,"Block 2028, Block Group 2, Census Tract 1514.01, Sonoma County, California",26,25,1
1000000US060971514012029,060971514012029,"Block 2029, Block Group 2, Census Tract 1514.01, Sonoma County, California",8,6,2
1000000US060971514012030,060971514012030,"Block 2030, Block Group 2, Census Tract 1514.01, Sonoma County, California",6,6,0
1000000US060971514012031,060971514012031,"Block 2031, Block Group 2, Census Tract 1514.01, Sonoma County, California",82,73,9
1000000US060971514012032,060971514012032,"Block 2032, Block Group 2, Census Tract 1514.01, Sonoma County, California",5,5,0
1000000US060971514013000,060971514013000,"Block 3000, Block Group 3, Census Tract 1514.01, Sonoma County, California",32,31,1
1000000US060971514013001,060971514013001,"Block 3001, Block Group 3, Census Tract 1514.01, Sonoma County, California",81,75,6
1000000US060971514013002,060971514013002,"Block 3002, Block Group 3, Census Tract 1514.01, Sonoma County, California",7,6,1
1000000US060971514013003,060971514013003,"Block 3003, Block Group 3, Census Tract 1514.01, Sonoma County, California",16,16,0
1000000US060971514013004,060971514013004,"Block 3004, Block Group 3, Census Tract 1514.01, Sonoma County, California",8,8,0
1000000US060971514013005,060971514013005,"Block 3005, Block Group 3, Census Tract 1514.01, Sonoma County, California",49,48,1
1000000US060971514013006,060971514013006,"Block 3006, Block Group 3, Census Tract 1514.01, Sonoma County, California",14,11,3
1000000US060971514013007,060971514013007,"Block 3007, Block Group 3, Census Tract 1514.01, Sonoma County, California",44,42,2
1000000US060971514013008,060971514013008,"Block 3008, Block Group 3, Census Tract 1514.01, Sonoma County, California",32,30,2
1000000US060971514013009,060971514013009,"Block 3009, Block Group 3, Census Tract 1514.01, Sonoma County, California",10,10,0
1000000US060971514013010,060971514013010,"Block 3010, Block Group 3, Census Tract 1514.01, Sonoma County, California",31,30,1
1000000US060971514013011,060971514013011,"Block 3011, Block Group 3, Census Tract 1514.01, Sonoma County, California",8,8,0
1000000US060971514021000,060971514021000,"Block 1000, Block Group 1, Census Tract 1514.02, Sonoma County, California",25,23,2
1000000US060971514021001,060971514021001,"Block 1001, Block Group 1, Census Tract 1514.02, Sonoma County, California",16,15,1
1000000US060971514021002,060971514021002,"Block 1002, Block Group 1, Census Tract 1514.02, Sonoma County, California",333,278,55
1000000US060971514021003,060971514021003,"Block 1003, Block Group 1, Census Tract 1514.02, Sonoma County, California",44,44,0
1000000US060971514021004,060971514021004,"Block 1004, Block Group 1, Census Tract 1514.02, Sonoma County, California",21,13,8
1000000US060971514021005,060971514021005,"Block 1005, Block Group 1, Census Tract 1514.02, Sonoma County, California",23,23,0
1000000US060971514021006,060971514021006,"Block 1006, Block Group 1, Census Tract 1514.02, Sonoma County, California",1,1,0
1000000US060971514021007,060971514021007,"Block 1007, Block Group 1, Census Tract 1514.02, Sonoma County, California",22,21,1
1000000US060971514021008,060971514021008,"Block 1008, Block Group 1, Census Tract 1514.02, Sonoma County, California",0,0,0
1000000US060971514021009,060971514021009,"Block 1009, Block Group 1, Census Tract 1514.02, Sonoma County, California",83,80,3
1000000US060971514021010,060971514021010,"Block 1010, Block Group 1, Census Tract 1514.02, Sonoma County, California",0,0,0
1000000US060971514021011,060971514021011,"Block 1011, Block Group 1, Census Tract 1514.02, Sonoma County, California",0,0,0
1000000US060971514021012,060971514021012,"Block 1012, Block Group 1, Census Tract 1514.02, Sonoma County, California",0,0,0
1000000US060971514021013,060971514021013,"Block 1013, Block Group 1, Census Tract 1514.02, Sonoma County, California",0,0,0
1000000US060971514021014,060971514021014,"Block 1014, Block Group 1, Census Tract 1514.02, Sonoma County, California",0,0,0
1000000US060971514021015,060971514021015,"Block 1015, Block Group 1, Census Tract 1514.02, Sonoma County, California",67,57,10
1000000US060971514021016,060971514021016,"Block 1016, Block Group 1, Census Tract 1514.02, Sonoma County, California",34,32,2
1000000US060971514021017,060971514021017,"Block 1017, Block Group 1, Census Tract 1514.02, Sonoma County, California",0,0,0
1000000US060971514021018,060971514021018,"Block 1018, Block Group 1, Census Tract 1514.02, Sonoma County, California",0,0,0
1000000US060971514021019,060971514021019,"Block 1019, Block Group 1, Census Tract 1514.02, Sonoma County, California",0,0,0
1000000US060971514021020,060971514021020,"Block 1020, Block Group 1, Census Tract 1514.02, Sonoma County, California",0,0,0
1000000US060971514021021,060971514021021,"Block 1021, Block Group 1, Census Tract 1514.02, Sonoma County, California",87,74,13
1000000US060971514021022,060971514021022,"Block 1022, Block Group 1, Census Tract 1514.02, Sonoma County, California",53,52,1
1000000US060971514021023,060971514021023,"Block 1023, Block Group 1, Census Tract 1514.02, Sonoma County, California",26,26,0
1000000US060971514021024,060971514021024,"Block 1024, Block Group 1, Census Tract 1514.02, Sonoma County, California",0,0,0
1000000US060971514021025,060971514021025,"Block 1025, Block Group 1, Census Tract 1514.02, Sonoma County, California",0,0,0
1000000US060971514021026,060971514021026,"Block 1026, Block Group 1, Census Tract 1514.02, Sonoma County, California",0,0,0
1000000US060971514021027,060971514021027,"Block 1027, Block Group 1, Census Tract 1514.02, Sonoma County, California",0,0,0
1000000US060971514021028,060971514021028,"Block 1028, Block Group 1, Census Tract 1514.02, Sonoma County, California",0,0,0
1000000US060971514021029,060971514021029,"Block 1029, Block Group 1, Census Tract 1514.02, Sonoma County, California",8,8,0
1000000US060971514021030,060971514021030,"Block 1030, Block Group 1, Census Tract 1514.02, Sonoma County, California",0,0,0
1000000US060971514021031,060971514021031,"Block 1031, Block Group 1, Census Tract 1514.02, Sonoma County, California",0,0,0
1000000US060971514021032,060971514021032,"Block 1032, Block Group 1, Census Tract 1514.02, Sonoma County, California",0,0,0
1000000US060971514021033,060971514021033,"Block 1033, Block Group 1, Census Tract 1514.02, Sonoma County, California",2,1,1
1000000US060971514021034,060971514021034,"Block 1034, Block Group 1, Census Tract 1514.02, Sonoma County, California",0,0,0
1000000US060971514021035,060971514021035,"Block 1035, Block Group 1, Census Tract 1514.02, Sonoma County, California",15,13,2
1000000US060971514021036,060971514021036,"Block 1036, Block Group 1, Census Tract 1514.02, Sonoma County, California",0,0,0
1000000US060971514022000,060971514022000,"Block 2000, Block Group 2, Census Tract 1514.02, Sonoma County, California",0,0,0
1000000US060971514022001,060971514022001,"Block 2001, Block Group 2, Census Tract 1514.02, Sonoma County, California",0,0,0
1000000US060971514022002,060971514022002,"Block 2002, Block Group 2, Census Tract 1514.02, Sonoma County, California",29,25,4
1000000US060971514022003,060971514022003,"Block 2003, Block Group 2, Census Tract 1514.02, Sonoma County, California",0,0,0
1000000US060971514022004,060971514022004,"Block 2004, Block Group 2, Census Tract 1514.02, Sonoma County, California",0,0,0
1000000US060971514022005,060971514022005,"Block 2005, Block Group 2, Census Tract 1514.02, Sonoma County, California",0,0,0
1000000US060971514022006,060971514022006,"Block 2006, Block Group 2, Census Tract 1514.02, Sonoma County, California",29,28,1
1000000US060971514022007,060971514022007,"Block 2007, Block Group 2, Census Tract 1514.02, Sonoma County, California",0,0,0
1000000US060971514022008,060971514022008,"Block 2008, Block Group 2, Census Tract 1514.02, Sonoma County, California",0,0,0
1000000US060971514022009,060971514022009,"Block 2009, Block Group 2, Census Tract 1514.02, Sonoma County, California",0,0,0
1000000US060971514022010,060971514022010,"Block 2010, Block Group 2, Census Tract 1514.02, Sonoma County, California",0,0,0
1000000US060971514022011,060971514022011,"Block 2011, Block Group 2, Census Tract 1514.02, Sonoma County, California",62,60,2
1000000US060971514022012,060971514022012,"Block 2012, Block Group 2, Census Tract 1514.02, Sonoma County, California",4,4,0
1000000US060971514022013,060971514022013,"Block 2013, Block Group 2, Census Tract 1514.02, Sonoma County, California",16,16,0
1000000US060971514022014,060971514022014,"Block 2014, Block Group 2, Census Tract 1514.02, Sonoma County, California",19,17,2
1000000US060971514022015,060971514022015,"Block 2015, Block Group 2, Census Tract 1514.02, Sonoma County, California",85,83,2
1000000US060971514022016,060971514022016,"Block 2016, Block Group 2, Census Tract 1514.02, Sonoma County, California",9,8,1
1000000US060971514022017,060971514022017,"Block 2017, Block Group 2, Census Tract 1514.02, Sonoma County, California",0,0,0
1000000US060971514022018,060971514022018,"Block 2018, Block Group 2, Census Tract 1514.02, Sonoma County, California",0,0,0
1000000US060971514022019,060971514022019,"Block 2019, Block Group 2, Census Tract 1514.02, Sonoma County, California",59,59,0
1000000US060971514022020,060971514022020,"Block 2020, Block Group 2, Census Tract 1514.02, Sonoma County, California",24,23,1
1000000US060971514022021,060971514022021,"Block 2021, Block Group 2, Census Tract 1514.02, Sonoma County, California",14,12,2
1000000US060971514022022,060971514022022,"Block 2022, Block Group 2, Census Tract 1514.02, Sonoma County, California",12,12,0
1000000US060971514022023,060971514022023,"Block 2023, Block Group 2, Census Tract 1514.02, Sonoma County, California",26,26,0
1000000US060971514022024,060971514022024,"Block 2024, Block Group 2, Census Tract 1514.02, Sonoma County, California",94,88,6
1000000US060971514022025,060971514022025,"Block 2025, Block Group 2, Census Tract 1514.02, Sonoma County, California",49,47,2
1000000US060971514022026,060971514022026,"Block 2026, Block Group 2, Census Tract 1514.02, Sonoma County, California",53,51,2
1000000US060971514022027,060971514022027,"Block 2027, Block Group 2, Census Tract 1514.02, Sonoma County, California",218,184,34
1000000US060971514022028,060971514022028,"Block 2028, Block Group 2, Census Tract 1514.02, Sonoma County, California",0,0,0
1000000US060971514022029,060971514022029,"Block 2029, Block Group 2, Census Tract 1514.02, Sonoma County, California",20,20,0
1000000US060971514023000,060971514023000,"Block 3000, Block Group 3, Census Tract 1514.02, Sonoma County, California",409,383,26
1000000US060971514023001,060971514023001,"Block 3001, Block Group 3, Census Tract 1514.02, Sonoma County, California",36,36,0
1000000US060971514023002,060971514023002,"Block 3002, Block Group 3, Census Tract 1514.02, Sonoma County, California",21,17,4
1000000US060971514023003,060971514023003,"Block 3003, Block Group 3, Census Tract 1514.02, Sonoma County, California",18,17,1
1000000US060971514023004,060971514023004,"Block 3004, Block Group 3, Census Tract 1514.02, Sonoma County, California",20,19,1
1000000US060971514023005,060971514023005,"Block 3005, Block Group 3, Census Tract 1514.02, Sonoma County, California",0,0,0
1000000US060971514023006,060971514023006,"Block 3006, Block Group 3, Census Tract 1514.02, Sonoma County, California",0,0,0
1000000US060971514023007,060971514023007,"Block 3007, Block Group 3, Census Tract 1514.02, Sonoma County, California",194,191,3
1000000US060971514023008,060971514023008,"Block 3008, Block Group 3, Census Tract 1514.02, Sonoma County, California",18,18,0
1000000US060971514023009,060971514023009,"Block 3009, Block Group 3, Census Tract 1514.02, Sonoma County, California",18,18,0
1000000US060971514023010,060971514023010,"Block 3010, Block Group 3, Census Tract 1514.02, Sonoma County, California",0,0,0
1000000US060971514023011,060971514023011,"Block 3011, Block Group 3, Census Tract 1514.02, Sonoma County, California",27,24,3
1000000US060971514023012,060971514023012,"Block 3012, Block Group 3, Census Tract 1514.02, Sonoma County, California",32,29,3
1000000US060971514023013,060971514023013,"Block 3013, Block Group 3, Census Tract 1514.02, Sonoma County, California",22,21,1
1000000US060971514023014,060971514023014,"Block 3014, Block Group 3, Census Tract 1514.02, Sonoma County, California",35,34,1
1000000US060971514023015,060971514023015,"Block 3015, Block Group 3, Census Tract 1514.02, Sonoma County, California",60,57,3
1000000US060971514023016,060971514023016,"Block 3016, Block Group 3, Census Tract 1514.02, Sonoma County, California",16,13,3
1000000US060971514023017,060971514023017,"Block 3017, Block Group 3, Census Tract 1514.02, Sonoma County, California",26,21,5
1000000US060971514023018,060971514023018,"Block 3018, Block Group 3, Census Tract 1514.02, Sonoma County, California",0,0,0
1000000US060971514023019,060971514023019,"Block 3019, Block Group 3, Census Tract 1514.02, Sonoma County, California",11,11,0
1000000US060971514023020,060971514023020,"Block 3020, Block Group 3, Census Tract 1514.02, Sonoma County, California",2,2,0
1000000US060971514024000,060971514024000,"Block 4000, Block Group 4, Census Tract 1514.02, Sonoma County, California",10,10,0
1000000US060971514024001,060971514024001,"Block 4001, Block Group 4, Census Tract 1514.02, Sonoma County, California",26,23,3
1000000US060971514024002,060971514024002,"Block 4002, Block Group 4, Census Tract 1514.02, Sonoma County, California",27,26,1
1000000US060971514024003,060971514024003,"Block 4003, Block Group 4, Census Tract 1514.02, Sonoma County, California",7,7,0
1000000US060971514024004,060971514024004,"Block 4004, Block Group 4, Census Tract 1514.02, Sonoma County, California",0,0,0
1000000US060971514024005,060971514024005,"Block 4005, Block Group 4, Census Tract 1514.02, Sonoma County, California",18,18,0
1000000US060971514024006,060971514024006,"Block 4006, Block Group 4, Census Tract 1514.02, Sonoma County, California",15,14,1
1000000US060971514024007,060971514024007,"Block 4007, Block Group 4, Census Tract 1514.02, Sonoma County, California",36,35,1
1000000US060971514024008,060971514024008,"Block 4008, Block Group 4, Census Tract 1514.02, Sonoma County, California",16,16,0
1000000US060971514024009,060971514024009,"Block 4009, Block Group 4, Census Tract 1514.02, Sonoma County, California",14,14,0
1000000US060971514024010,060971514024010,"Block 4010, Block Group 4, Census Tract 1514.02, Sonoma County, California",0,0,0
1000000US060971514024011,060971514024011,"Block 4011, Block Group 4, Census Tract 1514.02, Sonoma County, California",5,5,0
1000000US060971514024012,060971514024012,"Block 4012, Block Group 4, Census Tract 1514.02, Sonoma County, California",11,9,2
1000000US060971514024013,060971514024013,"Block 4013, Block Group 4, Census Tract 1514.02, Sonoma County, California",0,0,0
1000000US060971514024014,060971514024014,"Block 4014, Block Group 4, Census Tract 1514.02, Sonoma County, California",1,1,0
1000000US060971514024015,060971514024015,"Block 4015, Block Group 4, Census Tract 1514.02, Sonoma County, California",0,0,0
1000000US060971514024016,060971514024016,"Block 4016, Block Group 4, Census Tract 1514.02, Sonoma County, California",9,9,0
1000000US060971514024017,060971514024017,"Block 4017, Block Group 4, Census Tract 1514.02, Sonoma County, California",4,4,0
1000000US060971514024018,060971514024018,"Block 4018, Block Group 4, Census Tract 1514.02, Sonoma County, California",11,10,1
1000000US060971514024019,060971514024019,"Block 4019, Block Group 4, Census Tract 1514.02, Sonoma County, California",8,8,0
1000000US060971514024020,060971514024020,"Block 4020, Block Group 4, Census Tract 1514.02, Sonoma County, California",23,23,0
1000000US060971514024021,060971514024021,"Block 4021, Block Group 4, Census Tract 1514.02, Sonoma County, California",37,33,4
1000000US060971514024022,060971514024022,"Block 4022, Block Group 4, Census Tract 1514.02, Sonoma County, California",10,10,0
1000000US060971514024023,060971514024023,"Block 4023, Block Group 4, Census Tract 1514.02, Sonoma County, California",2,2,0
1000000US060971514024024,060971514024024,"Block 4024, Block Group 4, Census Tract 1514.02, Sonoma County, California",0,0,0
1000000US060971514024025,060971514024025,"Block 4025, Block Group 4, Census Tract 1514.02, Sonoma County, California",8,7,1
1000000US060971514024026,060971514024026,"Block 4026, Block Group 4, Census Tract 1514.02, Sonoma County, California",2,2,0
1000000US060971514024027,060971514024027,"Block 4027, Block Group 4, Census Tract 1514.02, Sonoma County, California",0,0,0
1000000US060971514024028,060971514024028,"Block 4028, Block Group 4, Census Tract 1514.02, Sonoma County, California",0,0,0
1000000US060971514024029,060971514024029,"Block 4029, Block Group 4, Census Tract 1514.02, Sonoma County, California",0,0,0
1000000US060971514025000,060971514025000,"Block 5000, Block Group 5, Census Tract 1514.02, Sonoma County, California",149,140,9
1000000US060971514025001,060971514025001,"Block 5001, Block Group 5, Census Tract 1514.02, Sonoma County, California",0,0,0
1000000US060971514025002,060971514025002,"Block 5002, Block Group 5, Census Tract 1514.02, Sonoma County, California",0,0,0
1000000US060971514025003,060971514025003,"Block 5003, Block Group 5, Census Tract 1514.02, Sonoma County, California",92,89,3
1000000US060971514025004,060971514025004,"Block 5004, Block Group 5, Census Tract 1514.02, Sonoma County, California",0,0,0
1000000US060971514025005,060971514025005,"Block 5005, Block Group 5, Census Tract 1514.02, Sonoma County, California",53,52,1
1000000US060971514025006,060971514025006,"Block 5006, Block Group 5, Census Tract 1514.02, Sonoma County, California",113,109,4
1000000US060971514025007,060971514025007,"Block 5007, Block Group 5, Census Tract 1514.02, Sonoma County, California",35,30,5
1000000US060971514025008,060971514025008,"Block 5008, Block Group 5, Census Tract 1514.02, Sonoma County, California",12,11,1
1000000US060971514025009,060971514025009,"Block 5009, Block Group 5, Census Tract 1514.02, Sonoma County, California",45,41,4
1000000US060971514025010,060971514025010,"Block 5010, Block Group 5, Census Tract 1514.02, Sonoma County, California",10,10,0
1000000US060971514025011,060971514025011,"Block 5011, Block Group 5, Census Tract 1514.02, Sonoma County, California",10,10,0
1000000US060971514025012,060971514025012,"Block 5012, Block Group 5, Census Tract 1514.02, Sonoma County, California",11,10,1
1000000US060971514025013,060971514025013,"Block 5013, Block Group 5, Census Tract 1514.02, Sonoma County, California",0,0,0
1000000US060971514025014,060971514025014,"Block 5014, Block Group 5, Census Tract 1514.02, Sonoma County, California",0,0,0
1000000US060971514025015,060971514025015,"Block 5015, Block Group 5, Census Tract 1514.02, Sonoma County, California",0,0,0
1000000US060971514025016,060971514025016,"Block 5016, Block Group 5, Census Tract 1514.02, Sonoma County, California",9,9,0
1000000US060971514025017,060971514025017,"Block 5017, Block Group 5, Census Tract 1514.02, Sonoma County, California",16,16,0
1000000US060971514025018,060971514025018,"Block 5018, Block Group 5, Census Tract 1514.02, Sonoma County, California",16,15,1
1000000US060971514025019,060971514025019,"Block 5019, Block Group 5, Census Tract 1514.02, Sonoma County, California",0,0,0
1000000US060971514025020,060971514025020,"Block 5020, Block Group 5, Census Tract 1514.02, Sonoma County, California",0,0,0
1000000US060971514025021,060971514025021,"Block 5021, Block Group 5, Census Tract 1514.02, Sonoma County, California",0,0,0
1000000US060971515021000,060971515021000,"Block 1000, Block Group 1, Census Tract 1515.02, Sonoma County, California",128,118,10
1000000US060971515021001,060971515021001,"Block 1001, Block Group 1, Census Tract 1515.02, Sonoma County, California",8,7,1
1000000US060971515021002,060971515021002,"Block 1002, Block Group 1, Census Tract 1515.02, Sonoma County, California",11,10,1
1000000US060971515021003,060971515021003,"Block 1003, Block Group 1, Census Tract 1515.02, Sonoma County, California",12,11,1
1000000US060971515021004,060971515021004,"Block 1004, Block Group 1, Census Tract 1515.02, Sonoma County, California",4,4,0
1000000US060971515021005,060971515021005,"Block 1005, Block Group 1, Census Tract 1515.02, Sonoma County, California",16,16,0
1000000US060971515021006,060971515021006,"Block 1006, Block Group 1, Census Tract 1515.02, Sonoma County, California",31,27,4
1000000US060971515021007,060971515021007,"Block 1007, Block Group 1, Census Tract 1515.02, Sonoma County, California",5,4,1
1000000US060971515021008,060971515021008,"Block 1008, Block Group 1, Census Tract 1515.02, Sonoma County, California",2,2,0
1000000US060971515021009,060971515021009,"Block 1009, Block Group 1, Census Tract 1515.02, Sonoma County, California",3,3,0
1000000US060971515021010,060971515021010,"Block 1010, Block Group 1, Census Tract 1515.02, Sonoma County, California",88,85,3
1000000US060971515021011,060971515021011,"Block 1011, Block Group 1, Census Tract 1515.02, Sonoma County, California",0,0,0
1000000US060971515021012,060971515021012,"Block 1012, Block Group 1, Census Tract 1515.02, Sonoma County, California",0,0,0
1000000US060971515021013,060971515021013,"Block 1013, Block Group 1, Census Tract 1515.02, Sonoma County, California",138,126,12
1000000US060971515021014,060971515021014,"Block 1014, Block Group 1, Census Tract 1515.02, Sonoma County, California",8,5,3
1000000US060971515021015,060971515021015,"Block 1015, Block Group 1, Census Tract 1515.02, Sonoma County, California",0,0,0
1000000US060971515021016,060971515021016,"Block 1016, Block Group 1, Census Tract 1515.02, Sonoma County, California",51,50,1
1000000US060971515021017,060971515021017,"Block 1017, Block Group 1, Census Tract 1515.02, Sonoma County, California",0,0,0
1000000US060971515021018,060971515021018,"Block 1018, Block Group 1, Census Tract 1515.02, Sonoma County, California",0,0,0
1000000US060971515021019,060971515021019,"Block 1019, Block Group 1, Census Tract 1515.02, Sonoma County, California",90,78,12
1000000US060971515021020,060971515021020,"Block 1020, Block Group 1, Census Tract 1515.02, Sonoma County, California",58,57,1
1000000US060971515021021,060971515021021,"Block 1021, Block Group 1, Census Tract 1515.02, Sonoma County, California",13,13,0
1000000US060971515021022,060971515021022,"Block 1022, Block Group 1, Census Tract 1515.02, Sonoma County, California",24,22,2
1000000US060971515021023,060971515021023,"Block 1023, Block Group 1, Census Tract 1515.02, Sonoma County, California",4,4,0
1000000US060971515021024,060971515021024,"Block 1024, Block Group 1, Census Tract 1515.02, Sonoma County, California",12,10,2
1000000US060971515021025,060971515021025,"Block 1025, Block Group 1, Census Tract 1515.02, Sonoma County, California",69,69,0
1000000US060971515021026,060971515021026,"Block 1026, Block Group 1, Census Tract 1515.02, Sonoma County, California",0,0,0
1000000US060971515021027,060971515021027,"Block 1027, Block Group 1, Census Tract 1515.02, Sonoma County, California",0,0,0
1000000US060971515021028,060971515021028,"Block 1028, Block Group 1, Census Tract 1515.02, Sonoma County, California",8,8,0
1000000US060971515021029,060971515021029,"Block 1029, Block Group 1, Census Tract 1515.02, Sonoma County, California",13,11,2
1000000US060971515022000,060971515022000,"Block 2000, Block Group 2, Census Tract 1515.02, Sonoma County, California",12,12,0
1000000US060971515022001,060971515022001,"Block 2001, Block Group 2, Census Tract 1515.02, Sonoma County, California",11,9,2
1000000US060971515022002,060971515022002,"Block 2002, Block Group 2, Census Tract 1515.02, Sonoma County, California",1,1,0
1000000US060971515022003,060971515022003,"Block 2003, Block Group 2, Census Tract 1515.02, Sonoma County, California",1,1,0
1000000US060971515022004,060971515022004,"Block 2004, Block Group 2, Census Tract 1515.02, Sonoma County, California",16,15,1
1000000US060971515022005,060971515022005,"Block 2005, Block Group 2, Census Tract 1515.02, Sonoma County, California",1,1,0
1000000US060971515022006,060971515022006,"Block 2006, Block Group 2, Census Tract 1515.02, Sonoma County, California",32,32,0
1000000US060971515022007,060971515022007,"Block 2007, Block Group 2, Census Tract 1515.02, Sonoma County, California",14,14,0
1000000US060971515022008,060971515022008,"Block 2008, Block Group 2, Census Tract 1515.02, Sonoma County, California",98,93,5
1000000US060971515022009,060971515022009,"Block 2009, Block Group 2, Census Tract 1515.02, Sonoma County, California",16,16,0
1000000US060971515022010,060971515022010,"Block 2010, Block Group 2, Census Tract 1515.02, Sonoma County, California",16,14,2
1000000US060971515022011,060971515022011,"Block 2011, Block Group 2, Census Tract 1515.02, Sonoma County, California",0,0,0
1000000US060971515022012,060971515022012,"Block 2012, Block Group 2, Census Tract 1515.02, Sonoma County, California",0,0,0
1000000US060971515022013,060971515022013,"Block 2013, Block Group 2, Census Tract 1515.02, Sonoma County, California",0,0,0
1000000US060971515022014,060971515022014,"Block 2014, Block Group 2, Census Tract 1515.02, Sonoma County, California",0,0,0
1000000US060971515022015,060971515022015,"Block 2015, Block Group 2, Census Tract 1515.02, Sonoma County, California",0,0,0
1000000US060971515022016,060971515022016,"Block 2016, Block Group 2, Census Tract 1515.02, Sonoma County, California",50,47,3
1000000US060971515022017,060971515022017,"Block 2017, Block Group 2, Census Tract 1515.02, Sonoma County, California",1,1,0
1000000US060971515022018,060971515022018,"Block 2018, Block Group 2, Census Tract 1515.02, Sonoma County, California",0,0,0
1000000US060971515022019,060971515022019,"Block 2019, Block Group 2, Census Tract 1515.02, Sonoma County, California",2,2,0
1000000US060971515022020,060971515022020,"Block 2020, Block Group 2, Census Tract 1515.02, Sonoma County, California",0,0,0
1000000US060971515022021,060971515022021,"Block 2021, Block Group 2, Census Tract 1515.02, Sonoma County, California",12,12,0
1000000US060971515022022,060971515022022,"Block 2022, Block Group 2, Census Tract 1515.02, Sonoma County, California",0,0,0
1000000US060971515022023,060971515022023,"Block 2023, Block Group 2, Census Tract 1515.02, Sonoma County, California",1,1,0
1000000US060971515022024,060971515022024,"Block 2024, Block Group 2, Census Tract 1515.02, Sonoma County, California",0,0,0
1000000US060971515022025,060971515022025,"Block 2025, Block Group 2, Census Tract 1515.02, Sonoma County, California",0,0,0
1000000US060971515022026,060971515022026,"Block 2026, Block Group 2, Census Tract 1515.02, Sonoma County, California",0,0,0
1000000US060971515022027,060971515022027,"Block 2027, Block Group 2, Census Tract 1515.02, Sonoma County, California",2,2,0
1000000US060971515022028,060971515022028,"Block 2028, Block Group 2, Census Tract 1515.02, Sonoma County, California",3,3,0
1000000US060971515022029,060971515022029,"Block 2029, Block Group 2, Census Tract 1515.02, Sonoma County, California",0,0,0
1000000US060971515022030,060971515022030,"Block 2030, Block Group 2, Census Tract 1515.02, Sonoma County, California",0,0,0
1000000US060971515022031,060971515022031,"Block 2031, Block Group 2, Census Tract 1515.02, Sonoma County, California",0,0,0
1000000US060971515022032,060971515022032,"Block 2032, Block Group 2, Census Tract 1515.02, Sonoma County, California",0,0,0
1000000US060971515022033,060971515022033,"Block 2033, Block Group 2, Census Tract 1515.02, Sonoma County, California",1,1,0
1000000US060971515022034,060971515022034,"Block 2034, Block Group 2, Census Tract 1515.02, Sonoma County, California",0,0,0
1000000US060971515023000,060971515023000,"Block 3000, Block Group 3, Census Tract 1515.02, Sonoma County, California",17,17,0
1000000US060971515023001,060971515023001,"Block 3001, Block Group 3, Census Tract 1515.02, Sonoma County, California",0,0,0
1000000US060971515023002,060971515023002,"Block 3002, Block Group 3, Census Tract 1515.02, Sonoma County, California",2,2,0
1000000US060971515023003,060971515023003,"Block 3003, Block Group 3, Census Tract 1515.02, Sonoma County, California",0,0,0
1000000US060971515023004,060971515023004,"Block 3004, Block Group 3, Census Tract 1515.02, Sonoma County, California",37,29,8
1000000US060971515023005,060971515023005,"Block 3005, Block Group 3, Census Tract 1515.02, Sonoma County, California",2,2,0
1000000US060971515023006,060971515023006,"Block 3006, Block Group 3, Census Tract 1515.02, Sonoma County, California",1,1,0
1000000US060971515023007,060971515023007,"Block 3007, Block Group 3, Census Tract 1515.02, Sonoma County, California",5,5,0
1000000US060971515023008,060971515023008,"Block 3008, Block Group 3, Census Tract 1515.02, Sonoma County, California",5,4,1
1000000US060971515023009,060971515023009,"Block 3009, Block Group 3, Census Tract 1515.02, Sonoma County, California",48,42,6
1000000US060971515023010,060971515023010,"Block 3010, Block Group 3, Census Tract 1515.02, Sonoma County, California",24,22,2
1000000US060971515023011,060971515023011,"Block 3011, Block Group 3, Census Tract 1515.02, Sonoma County, California",0,0,0
1000000US060971515023012,060971515023012,"Block 3012, Block Group 3, Census Tract 1515.02, Sonoma County, California",53,51,2
1000000US060971515023013,060971515023013,"Block 3013, Block Group 3, Census Tract 1515.02, Sonoma County, California",1,1,0
1000000US060971515023014,060971515023014,"Block 3014, Block Group 3, Census Tract 1515.02, Sonoma County, California",28,25,3
1000000US060971515023015,060971515023015,"Block 3015, Block Group 3, Census Tract 1515.02, Sonoma County, California",1,1,0
1000000US060971515023016,060971515023016,"Block 3016, Block Group 3, Census Tract 1515.02, Sonoma County, California",2,2,0
1000000US060971515023017,060971515023017,"Block 3017, Block Group 3, Census Tract 1515.02, Sonoma County, California",1,1,0
1000000US060971515023018,060971515023018,"Block 3018, Block Group 3, Census Tract 1515.02, Sonoma County, California",1,1,0
1000000US060971515023019,060971515023019,"Block 3019, Block Group 3, Census Tract 1515.02, Sonoma County, California",0,0,0
1000000US060971515023020,060971515023020,"Block 3020, Block Group 3, Census Tract 1515.02, Sonoma County, California",62,58,4
1000000US060971515023021,060971515023021,"Block 3021, Block Group 3, Census Tract 1515.02, Sonoma County, California",30,27,3
1000000US060971515023022,060971515023022,"Block 3022, Block Group 3, Census Tract 1515.02, Sonoma County, California",7,6,1
1000000US060971515023023,060971515023023,"Block 3023, Block Group 3, Census Tract 1515.02, Sonoma County, California",0,0,0
1000000US060971515023024,060971515023024,"Block 3024, Block Group 3, Census Tract 1515.02, Sonoma County, California",2,2,0
1000000US060971515023025,060971515023025,"Block 3025, Block Group 3, Census Tract 1515.02, Sonoma County, California",0,0,0
1000000US060971515023026,060971515023026,"Block 3026, Block Group 3, Census Tract 1515.02, Sonoma County, California",1,1,0
1000000US060971515023027,060971515023027,"Block 3027, Block Group 3, Census Tract 1515.02, Sonoma County, California",8,8,0
1000000US060971515023028,060971515023028,"Block 3028, Block Group 3, Census Tract 1515.02, Sonoma County, California",6,5,1
1000000US060971515024000,060971515024000,"Block 4000, Block Group 4, Census Tract 1515.02, Sonoma County, California",166,162,4
1000000US060971515024001,060971515024001,"Block 4001, Block Group 4, Census Tract 1515.02, Sonoma County, California",21,21,0
1000000US060971515024002,060971515024002,"Block 4002, Block Group 4, Census Tract 1515.02, Sonoma County, California",49,47,2
1000000US060971515024003,060971515024003,"Block 4003, Block Group 4, Census Tract 1515.02, Sonoma County, California",12,11,1
1000000US060971515024004,060971515024004,"Block 4004, Block Group 4, Census Tract 1515.02, Sonoma County, California",25,25,0
1000000US060971515024005,060971515024005,"Block 4005, Block Group 4, Census Tract 1515.02, Sonoma County, California",9,9,0
1000000US060971515024006,060971515024006,"Block 4006, Block Group 4, Census Tract 1515.02, Sonoma County, California",7,7,0
1000000US060971515025000,060971515025000,"Block 5000, Block Group 5, Census Tract 1515.02, Sonoma County, California",134,124,10
1000000US060971515025001,060971515025001,"Block 5001, Block Group 5, Census Tract 1515.02, Sonoma County, California",144,132,12
1000000US060971515025002,060971515025002,"Block 5002, Block Group 5, Census Tract 1515.02, Sonoma County, California",58,54,4
1000000US060971515025003,060971515025003,"Block 5003, Block Group 5, Census Tract 1515.02, Sonoma County, California",29,28,1
1000000US060971515025004,060971515025004,"Block 5004, Block Group 5, Census Tract 1515.02, Sonoma County, California",11,11,0
1000000US060971515025005,060971515025005,"Block 5005, Block Group 5, Census Tract 1515.02, Sonoma County, California",20,19,1
1000000US060971515025006,060971515025006,"Block 5006, Block Group 5, Census Tract 1515.02, Sonoma County, California",23,23,0
1000000US060971515025007,060971515025007,"Block 5007, Block Group 5, Census Tract 1515.02, Sonoma County, California",31,30,1
1000000US060971515025008,060971515025008,"Block 5008, Block Group 5, Census Tract 1515.02, Sonoma County, California",12,12,0
1000000US060971515026000,060971515026000,"Block 6000, Block Group 6, Census Tract 1515.02, Sonoma County, California",334,304,30
1000000US060971515026001,060971515026001,"Block 6001, Block Group 6, Census Tract 1515.02, Sonoma County, California",52,52,0
1000000US060971515026002,060971515026002,"Block 6002, Block Group 6, Census Tract 1515.02, Sonoma County, California",214,195,19
1000000US060971515026003,060971515026003,"Block 6003, Block Group 6, Census Tract 1515.02, Sonoma County, California",14,13,1
1000000US060971515026004,060971515026004,"Block 6004, Block Group 6, Census Tract 1515.02, Sonoma County, California",18,18,0
1000000US060971515026005,060971515026005,"Block 6005, Block Group 6, Census Tract 1515.02, Sonoma County, California",175,166,9
1000000US060971515026006,060971515026006,"Block 6006, Block Group 6, Census Tract 1515.02, Sonoma County, California",94,86,8
1000000US060971515026007,060971515026007,"Block 6007, Block Group 6, Census Tract 1515.02, Sonoma County, California",14,14,0
1000000US060971515026008,060971515026008,"Block 6008, Block Group 6, Census Tract 1515.02, Sonoma County, California",13,12,1
1000000US060971515026009,060971515026009,"Block 6009, Block Group 6, Census Tract 1515.02, Sonoma County, California",4,4,0
1000000US060971515026010,060971515026010,"Block 6010, Block Group 6, Census Tract 1515.02, Sonoma County, California",19,18,1
1000000US060971515026011,060971515026011,"Block 6011, Block Group 6, Census Tract 1515.02, Sonoma County, California",0,0,0
1000000US060971515026012,060971515026012,"Block 6012, Block Group 6, Census Tract 1515.02, Sonoma County, California",1,1,0
1000000US060971515026013,060971515026013,"Block 6013, Block Group 6, Census Tract 1515.02, Sonoma County, California",0,0,0
1000000US060971515031000,060971515031000,"Block 1000, Block Group 1, Census Tract 1515.03, Sonoma County, California",157,152,5
1000000US060971515031001,060971515031001,"Block 1001, Block Group 1, Census Tract 1515.03, Sonoma County, California",0,0,0
1000000US060971515031002,060971515031002,"Block 1002, Block Group 1, Census Tract 1515.03, Sonoma County, California",0,0,0
1000000US060971515031003,060971515031003,"Block 1003, Block Group 1, Census Tract 1515.03, Sonoma County, California",0,0,0
1000000US060971515031004,060971515031004,"Block 1004, Block Group 1, Census Tract 1515.03, Sonoma County, California",0,0,0
1000000US060971515031005,060971515031005,"Block 1005, Block Group 1, Census Tract 1515.03, Sonoma County, California",0,0,0
1000000US060971515031006,060971515031006,"Block 1006, Block Group 1, Census Tract 1515.03, Sonoma County, California",169,161,8
1000000US060971515031007,060971515031007,"Block 1007, Block Group 1, Census Tract 1515.03, Sonoma County, California",14,13,1
1000000US060971515031008,060971515031008,"Block 1008, Block Group 1, Census Tract 1515.03, Sonoma County, California",25,23,2
1000000US060971515031009,060971515031009,"Block 1009, Block Group 1, Census Tract 1515.03, Sonoma County, California",0,0,0
1000000US060971515031010,060971515031010,"Block 1010, Block Group 1, Census Tract 1515.03, Sonoma County, California",10,10,0
1000000US060971515031011,060971515031011,"Block 1011, Block Group 1, Census Tract 1515.03, Sonoma County, California",11,11,0
1000000US060971515031012,060971515031012,"Block 1012, Block Group 1, Census Tract 1515.03, Sonoma County, California",21,20,1
1000000US060971515031013,060971515031013,"Block 1013, Block Group 1, Census Tract 1515.03, Sonoma County, California",0,0,0
1000000US060971515031014,060971515031014,"Block 1014, Block Group 1, Census Tract 1515.03, Sonoma County, California",0,0,0
1000000US060971515031015,060971515031015,"Block 1015, Block Group 1, Census Tract 1515.03, Sonoma County, California",54,53,1
1000000US060971515031016,060971515031016,"Block 1016, Block Group 1, Census Tract 1515.03, Sonoma County, California",18,17,1
1000000US060971515031017,060971515031017,"Block 1017, Block Group 1, Census Tract 1515.03, Sonoma County, California",54,54,0
1000000US060971515031018,060971515031018,"Block 1018, Block Group 1, Census Tract 1515.03, Sonoma County, California",9,7,2
1000000US060971515031019,060971515031019,"Block 1019, Block Group 1, Census Tract 1515.03, Sonoma County, California",0,0,0
1000000US060971515032000,060971515032000,"Block 2000, Block Group 2, Census Tract 1515.03, Sonoma County, California",60,57,3
1000000US060971515032001,060971515032001,"Block 2001, Block Group 2, Census Tract 1515.03, Sonoma County, California",65,65,0
1000000US060971515032002,060971515032002,"Block 2002, Block Group 2, Census Tract 1515.03, Sonoma County, California",37,36,1
1000000US060971515032003,060971515032003,"Block 2003, Block Group 2, Census Tract 1515.03, Sonoma County, California",80,79,1
1000000US060971515032004,060971515032004,"Block 2004, Block Group 2, Census Tract 1515.03, Sonoma County, California",34,31,3
1000000US060971515032005,060971515032005,"Block 2005, Block Group 2, Census Tract 1515.03, Sonoma County, California",51,51,0
1000000US060971515032006,060971515032006,"Block 2006, Block Group 2, Census Tract 1515.03, Sonoma County, California",39,38,1
1000000US060971515033000,060971515033000,"Block 3000, Block Group 3, Census Tract 1515.03, Sonoma County, California",0,0,0
1000000US060971515033001,060971515033001,"Block 3001, Block Group 3, Census Tract 1515.03, Sonoma County, California",0,0,0
1000000US060971515033002,060971515033002,"Block 3002, Block Group 3, Census Tract 1515.03, Sonoma County, California",0,0,0
1000000US060971515033003,060971515033003,"Block 3003, Block Group 3, Census Tract 1515.03, Sonoma County, California",0,0,0
1000000US060971515033004,060971515033004,"Block 3004, Block Group 3, Census Tract 1515.03, Sonoma County, California",0,0,0
1000000US060971515033005,060971515033005,"Block 3005, Block Group 3, Census Tract 1515.03, Sonoma County, California",0,0,0
1000000US060971515033006,060971515033006,"Block 3006, Block Group 3, Census Tract 1515.03, Sonoma County, California",0,0,0
1000000US060971515033007,060971515033007,"Block 3007, Block Group 3, Census Tract 1515.03, Sonoma County, California",32,31,1
1000000US060971515033008,060971515033008,"Block 3008, Block Group 3, Census Tract 1515.03, Sonoma County, California",0,0,0
1000000US060971515033009,060971515033009,"Block 3009, Block Group 3, Census Tract 1515.03, Sonoma County, California",0,0,0
1000000US060971515033010,060971515033010,"Block 3010, Block Group 3, Census Tract 1515.03, Sonoma County, California",0,0,0
1000000US060971515033011,060971515033011,"Block 3011, Block Group 3, Census Tract 1515.03, Sonoma County, California",0,0,0
1000000US060971515033012,060971515033012,"Block 3012, Block Group 3, Census Tract 1515.03, Sonoma County, California",0,0,0
1000000US060971515033013,060971515033013,"Block 3013, Block Group 3, Census Tract 1515.03, Sonoma County, California",37,35,2
1000000US060971515033014,060971515033014,"Block 3014, Block Group 3, Census Tract 1515.03, Sonoma County, California",0,0,0
1000000US060971515033015,060971515033015,"Block 3015, Block Group 3, Census Tract 1515.03, Sonoma County, California",0,0,0
1000000US060971515033016,060971515033016,"Block 3016, Block Group 3, Census Tract 1515.03, Sonoma County, California",0,0,0
1000000US060971515033017,060971515033017,"Block 3017, Block Group 3, Census Tract 1515.03, Sonoma County, California",48,46,2
1000000US060971515033018,060971515033018,"Block 3018, Block Group 3, Census Tract 1515.03, Sonoma County, California",18,18,0
1000000US060971515033019,060971515033019,"Block 3019, Block Group 3, Census Tract 1515.03, Sonoma County, California",135,132,3
1000000US060971515033020,060971515033020,"Block 3020, Block Group 3, Census Tract 1515.03, Sonoma County, California",81,79,2
1000000US060971515033021,060971515033021,"Block 3021, Block Group 3, Census Tract 1515.03, Sonoma County, California",32,30,2
1000000US060971515033022,060971515033022,"Block 3022, Block Group 3, Census Tract 1515.03, Sonoma County, California",19,19,0
1000000US060971515033023,060971515033023,"Block 3023, Block Group 3, Census Tract 1515.03, Sonoma County, California",54,53,1
1000000US060971515033024,060971515033024,"Block 3024, Block Group 3, Census Tract 1515.03, Sonoma County, California",7,7,0
1000000US060971515033025,060971515033025,"Block 3025, Block Group 3, Census Tract 1515.03, Sonoma County, California",6,6,0
1000000US060971515033026,060971515033026,"Block 3026, Block Group 3, Census Tract 1515.03, Sonoma County, California",5,5,0
1000000US060971515033027,060971515033027,"Block 3027, Block Group 3, Census Tract 1515.03, Sonoma County, California",3,3,0
1000000US060971515033028,060971515033028,"Block 3028, Block Group 3, Census Tract 1515.03, Sonoma County, California",4,4,0
1000000US060971515033029,060971515033029,"Block 3029, Block Group 3, Census Tract 1515.03, Sonoma County, California",26,25,1
1000000US060971515033030,060971515033030,"Block 3030, Block Group 3, Census Tract 1515.03, Sonoma County, California",23,22,1
1000000US060971515033031,060971515033031,"Block 3031, Block Group 3, Census Tract 1515.03, Sonoma County, California",3,3,0
1000000US060971515033032,060971515033032,"Block 3032, Block Group 3, Census Tract 1515.03, Sonoma County, California",13,13,0
1000000US060971515033033,060971515033033,"Block 3033, Block Group 3, Census Tract 1515.03, Sonoma County, California",0,0,0
1000000US060971515033034,060971515033034,"Block 3034, Block Group 3, Census Tract 1515.03, Sonoma County, California",0,0,0
1000000US060971515033035,060971515033035,"Block 3035, Block Group 3, Census Tract 1515.03, Sonoma County, California",4,4,0
1000000US060971515033036,060971515033036,"Block 3036, Block Group 3, Census Tract 1515.03, Sonoma County, California",0,0,0
1000000US060971515033037,060971515033037,"Block 3037, Block Group 3, Census Tract 1515.03, Sonoma County, California",0,0,0
1000000US060971515033038,060971515033038,"Block 3038, Block Group 3, Census Tract 1515.03, Sonoma County, California",0,0,0
1000000US060971515033039,060971515033039,"Block 3039, Block Group 3, Census Tract 1515.03, Sonoma County, California",0,0,0
1000000US060971515041000,060971515041000,"Block 1000, Block Group 1, Census Tract 1515.04, Sonoma County, California",13,13,0
1000000US060971515041001,060971515041001,"Block 1001, Block Group 1, Census Tract 1515.04, Sonoma County, California",118,110,8
1000000US060971515041002,060971515041002,"Block 1002, Block Group 1, Census Tract 1515.04, Sonoma County, California",17,17,0
1000000US060971515041003,060971515041003,"Block 1003, Block Group 1, Census Tract 1515.04, Sonoma County, California",24,24,0
1000000US060971515041004,060971515041004,"Block 1004, Block Group 1, Census Tract 1515.04, Sonoma County, California",22,21,1
1000000US060971515041005,060971515041005,"Block 1005, Block Group 1, Census Tract 1515.04, Sonoma County, California",21,21,0
1000000US060971515041006,060971515041006,"Block 1006, Block Group 1, Census Tract 1515.04, Sonoma County, California",38,36,2
1000000US060971515041007,060971515041007,"Block 1007, Block Group 1, Census Tract 1515.04, Sonoma County, California",24,24,0
1000000US060971515041008,060971515041008,"Block 1008, Block Group 1, Census Tract 1515.04, Sonoma County, California",38,37,1
1000000US060971515041009,060971515041009,"Block 1009, Block Group 1, Census Tract 1515.04, Sonoma County, California",6,6,0
1000000US060971515041010,060971515041010,"Block 1010, Block Group 1, Census Tract 1515.04, Sonoma County, California",12,12,0
1000000US060971515041011,060971515041011,"Block 1011, Block Group 1, Census Tract 1515.04, Sonoma County, California",21,21,0
1000000US060971515041012,060971515041012,"Block 1012, Block Group 1, Census Tract 1515.04, Sonoma County, California",79,77,2
1000000US060971515041013,060971515041013,"Block 1013, Block Group 1, Census Tract 1515.04, Sonoma County, California",29,28,1
1000000US060971515041014,060971515041014,"Block 1014, Block Group 1, Census Tract 1515.04, Sonoma County, California",13,13,0
1000000US060971515042000,060971515042000,"Block 2000, Block Group 2, Census Tract 1515.04, Sonoma County, California",15,15,0
1000000US060971515042001,060971515042001,"Block 2001, Block Group 2, Census Tract 1515.04, Sonoma County, California",24,23,1
1000000US060971515042002,060971515042002,"Block 2002, Block Group 2, Census Tract 1515.04, Sonoma County, California",19,16,3
1000000US060971515042003,060971515042003,"Block 2003, Block Group 2, Census Tract 1515.04, Sonoma County, California",16,16,0
1000000US060971515042004,060971515042004,"Block 2004, Block Group 2, Census Tract 1515.04, Sonoma County, California",20,20,0
1000000US060971515042005,060971515042005,"Block 2005, Block Group 2, Census Tract 1515.04, Sonoma County, California",16,15,1
1000000US060971515042006,060971515042006,"Block 2006, Block Group 2, Census Tract 1515.04, Sonoma County, California",17,17,0
1000000US060971515042007,060971515042007,"Block 2007, Block Group 2, Census Tract 1515.04, Sonoma County, California",17,17,0
1000000US060971515042008,060971515042008,"Block 2008, Block Group 2, Census Tract 1515.04, Sonoma County, California",18,18,0
1000000US060971515042009,060971515042009,"Block 2009, Block Group 2, Census Tract 1515.04, Sonoma County, California",60,56,4
1000000US060971515042010,060971515042010,"Block 2010, Block Group 2, Census Tract 1515.04, Sonoma County, California",16,14,2
1000000US060971515042011,060971515042011,"Block 2011, Block Group 2, Census Tract 1515.04, Sonoma County, California",45,45,0
1000000US060971515042012,060971515042012,"Block 2012, Block Group 2, Census Tract 1515.04, Sonoma County, California",23,21,2
1000000US060971515042013,060971515042013,"Block 2013, Block Group 2, Census Tract 1515.04, Sonoma County, California",21,20,1
1000000US060971515042014,060971515042014,"Block 2014, Block Group 2, Census Tract 1515.04, Sonoma County, California",87,84,3
1000000US060971515042015,060971515042015,"Block 2015, Block Group 2, Census Tract 1515.04, Sonoma County, California",16,16,0
1000000US060971515042016,060971515042016,"Block 2016, Block Group 2, Census Tract 1515.04, Sonoma County, California",16,16,0
1000000US060971515042017,060971515042017,"Block 2017, Block Group 2, Census Tract 1515.04, Sonoma County, California",20,19,1
1000000US060971515043000,060971515043000,"Block 3000, Block Group 3, Census Tract 1515.04, Sonoma County, California",105,104,1
1000000US060971515043001,060971515043001,"Block 3001, Block Group 3, Census Tract 1515.04, Sonoma County, California",38,37,1
1000000US060971515043002,060971515043002,"Block 3002, Block Group 3, Census Tract 1515.04, Sonoma County, California",9,9,0
1000000US060971515043003,060971515043003,"Block 3003, Block Group 3, Census Tract 1515.04, Sonoma County, California",21,21,0
1000000US060971515043004,060971515043004,"Block 3004, Block Group 3, Census Tract 1515.04, Sonoma County, California",8,8,0
1000000US060971515043005,060971515043005,"Block 3005, Block Group 3, Census Tract 1515.04, Sonoma County, California",18,18,0
1000000US060971515043006,060971515043006,"Block 3006, Block Group 3, Census Tract 1515.04, Sonoma County, California",23,22,1
1000000US060971515043007,060971515043007,"Block 3007, Block Group 3, Census Tract 1515.04, Sonoma County, California",17,16,1
1000000US060971515043008,060971515043008,"Block 3008, Block Group 3, Census Tract 1515.04, Sonoma County, California",10,10,0
1000000US060971515043009,060971515043009,"Block 3009, Block Group 3, Census Tract 1515.04, Sonoma County, California",30,29,1
1000000US060971515043010,060971515043010,"Block 3010, Block Group 3, Census Tract 1515.04, Sonoma County, California",9,8,1
1000000US060971515043011,060971515043011,"Block 3011, Block Group 3, Census Tract 1515.04, Sonoma County, California",38,36,2
1000000US060971515043012,060971515043012,"Block 3012, Block Group 3, Census Tract 1515.04, Sonoma County, California",11,11,0
1000000US060971515043013,060971515043013,"Block 3013, Block Group 3, Census Tract 1515.04, Sonoma County, California",7,7,0
1000000US060971515043014,060971515043014,"Block 3014, Block Group 3, Census Tract 1515.04, Sonoma County, California",41,40,1
1000000US060971515043015,060971515043015,"Block 3015, Block Group 3, Census Tract 1515.04, Sonoma County, California",0,0,0
1000000US060971515043016,060971515043016,"Block 3016, Block Group 3, Census Tract 1515.04, Sonoma County, California",47,46,1
1000000US060971515043017,060971515043017,"Block 3017, Block Group 3, Census Tract 1515.04, Sonoma County, California",9,9,0
1000000US060971515043018,060971515043018,"Block 3018, Block Group 3, Census Tract 1515.04, Sonoma County, California",21,21,0
1000000US060971516011000,060971516011000,"Block 1000, Block Group 1, Census Tract 1516.01, Sonoma County, California",185,172,13
1000000US060971516011001,060971516011001,"Block 1001, Block Group 1, Census Tract 1516.01, Sonoma County, California",16,15,1
1000000US060971516011002,060971516011002,"Block 1002, Block Group 1, Census Tract 1516.01, Sonoma County, California",55,52,3
1000000US060971516011003,060971516011003,"Block 1003, Block Group 1, Census Tract 1516.01, Sonoma County, California",18,18,0
1000000US060971516011004,060971516011004,"Block 1004, Block Group 1, Census Tract 1516.01, Sonoma County, California",19,19,0
1000000US060971516011005,060971516011005,"Block 1005, Block Group 1, Census Tract 1516.01, Sonoma County, California",63,58,5
1000000US060971516011006,060971516011006,"Block 1006, Block Group 1, Census Tract 1516.01, Sonoma County, California",57,53,4
1000000US060971516011007,060971516011007,"Block 1007, Block Group 1, Census Tract 1516.01, Sonoma County, California",32,31,1
1000000US060971516012000,060971516012000,"Block 2000, Block Group 2, Census Tract 1516.01, Sonoma County, California",2,1,1
1000000US060971516012001,060971516012001,"Block 2001, Block Group 2, Census Tract 1516.01, Sonoma County, California",0,0,0
1000000US060971516012002,060971516012002,"Block 2002, Block Group 2, Census Tract 1516.01, Sonoma County, California",2,1,1
1000000US060971516012003,060971516012003,"Block 2003, Block Group 2, Census Tract 1516.01, Sonoma County, California",0,0,0
1000000US060971516012004,060971516012004,"Block 2004, Block Group 2, Census Tract 1516.01, Sonoma County, California",0,0,0
1000000US060971516012005,060971516012005,"Block 2005, Block Group 2, Census Tract 1516.01, Sonoma County, California",137,125,12
1000000US060971516012006,060971516012006,"Block 2006, Block Group 2, Census Tract 1516.01, Sonoma County, California",0,0,0
1000000US060971516012007,060971516012007,"Block 2007, Block Group 2, Census Tract 1516.01, Sonoma County, California",1,1,0
1000000US060971516012008,060971516012008,"Block 2008, Block Group 2, Census Tract 1516.01, Sonoma County, California",0,0,0
1000000US060971516012009,060971516012009,"Block 2009, Block Group 2, Census Tract 1516.01, Sonoma County, California",0,0,0
1000000US060971516012010,060971516012010,"Block 2010, Block Group 2, Census Tract 1516.01, Sonoma County, California",9,9,0
1000000US060971516012011,060971516012011,"Block 2011, Block Group 2, Census Tract 1516.01, Sonoma County, California",0,0,0
1000000US060971516012012,060971516012012,"Block 2012, Block Group 2, Census Tract 1516.01, Sonoma County, California",0,0,0
1000000US060971516012013,060971516012013,"Block 2013, Block Group 2, Census Tract 1516.01, Sonoma County, California",0,0,0
1000000US060971516012014,060971516012014,"Block 2014, Block Group 2, Census Tract 1516.01, Sonoma County, California",43,31,12
1000000US060971516012015,060971516012015,"Block 2015, Block Group 2, Census Tract 1516.01, Sonoma County, California",0,0,0
1000000US060971516012016,060971516012016,"Block 2016, Block Group 2, Census Tract 1516.01, Sonoma County, California",5,4,1
1000000US060971516012017,060971516012017,"Block 2017, Block Group 2, Census Tract 1516.01, Sonoma County, California",0,0,0
1000000US060971516012018,060971516012018,"Block 2018, Block Group 2, Census Tract 1516.01, Sonoma County, California",0,0,0
1000000US060971516012019,060971516012019,"Block 2019, Block Group 2, Census Tract 1516.01, Sonoma County, California",0,0,0
1000000US060971516012020,060971516012020,"Block 2020, Block Group 2, Census Tract 1516.01, Sonoma County, California",0,0,0
1000000US060971516012021,060971516012021,"Block 2021, Block Group 2, Census Tract 1516.01, Sonoma County, California",0,0,0
1000000US060971516012022,060971516012022,"Block 2022, Block Group 2, Census Tract 1516.01, Sonoma County, California",0,0,0
1000000US060971516012023,060971516012023,"Block 2023, Block Group 2, Census Tract 1516.01, Sonoma County, California",0,0,0
1000000US060971516012024,060971516012024,"Block 2024, Block Group 2, Census Tract 1516.01, Sonoma County, California",4,1,3
1000000US060971516012025,060971516012025,"Block 2025, Block Group 2, Census Tract 1516.01, Sonoma County, California",0,0,0
1000000US060971516012026,060971516012026,"Block 2026, Block Group 2, Census Tract 1516.01, Sonoma County, California",0,0,0
1000000US060971516012027,060971516012027,"Block 2027, Block Group 2, Census Tract 1516.01, Sonoma County, California",0,0,0
1000000US060971516012028,060971516012028,"Block 2028, Block Group 2, Census Tract 1516.01, Sonoma County, California",0,0,0
1000000US060971516012029,060971516012029,"Block 2029, Block Group 2, Census Tract 1516.01, Sonoma County, California",0,0,0
1000000US060971516012030,060971516012030,"Block 2030, Block Group 2, Census Tract 1516.01, Sonoma County, California",0,0,0
1000000US060971516012031,060971516012031,"Block 2031, Block Group 2, Census Tract 1516.01, Sonoma County, California",0,0,0
1000000US060971516012032,060971516012032,"Block 2032, Block Group 2, Census Tract 1516.01, Sonoma County, California",0,0,0
1000000US060971516012033,060971516012033,"Block 2033, Block Group 2, Census Tract 1516.01, Sonoma County, California",0,0,0
1000000US060971516012034,060971516012034,"Block 2034, Block Group 2, Census Tract 1516.01, Sonoma County, California",13,11,2
1000000US060971516012035,060971516012035,"Block 2035, Block Group 2, Census Tract 1516.01, Sonoma County, California",0,0,0
1000000US060971516012036,060971516012036,"Block 2036, Block Group 2, Census Tract 1516.01, Sonoma County, California",2,2,0
1000000US060971516012037,060971516012037,"Block 2037, Block Group 2, Census Tract 1516.01, Sonoma County, California",0,0,0
1000000US060971516012038,060971516012038,"Block 2038, Block Group 2, Census Tract 1516.01, Sonoma County, California",104,95,9
1000000US060971516012039,060971516012039,"Block 2039, Block Group 2, Census Tract 1516.01, Sonoma County, California",9,6,3
1000000US060971516012040,060971516012040,"Block 2040, Block Group 2, Census Tract 1516.01, Sonoma County, California",19,16,3
1000000US060971516012041,060971516012041,"Block 2041, Block Group 2, Census Tract 1516.01, Sonoma County, California",14,12,2
1000000US060971516012042,060971516012042,"Block 2042, Block Group 2, Census Tract 1516.01, Sonoma County, California",1,1,0
1000000US060971516012043,060971516012043,"Block 2043, Block Group 2, Census Tract 1516.01, Sonoma County, California",0,0,0
1000000US060971516012044,060971516012044,"Block 2044, Block Group 2, Census Tract 1516.01, Sonoma County, California",45,42,3
1000000US060971516012045,060971516012045,"Block 2045, Block Group 2, Census Tract 1516.01, Sonoma County, California",248,223,25
1000000US060971516012046,060971516012046,"Block 2046, Block Group 2, Census Tract 1516.01, Sonoma County, California",15,15,0
1000000US060971516012047,060971516012047,"Block 2047, Block Group 2, Census Tract 1516.01, Sonoma County, California",24,23,1
1000000US060971516012048,060971516012048,"Block 2048, Block Group 2, Census Tract 1516.01, Sonoma County, California",12,11,1
1000000US060971516012049,060971516012049,"Block 2049, Block Group 2, Census Tract 1516.01, Sonoma County, California",2,1,1
1000000US060971516012050,060971516012050,"Block 2050, Block Group 2, Census Tract 1516.01, Sonoma County, California",0,0,0
1000000US060971516012051,060971516012051,"Block 2051, Block Group 2, Census Tract 1516.01, Sonoma County, California",0,0,0
1000000US060971516013000,060971516013000,"Block 3000, Block Group 3, Census Tract 1516.01, Sonoma County, California",20,20,0
1000000US060971516013001,060971516013001,"Block 3001, Block Group 3, Census Tract 1516.01, Sonoma County, California",28,26,2
1000000US060971516013002,060971516013002,"Block 3002, Block Group 3, Census Tract 1516.01, Sonoma County, California",25,24,1
1000000US060971516013003,060971516013003,"Block 3003, Block Group 3, Census Tract 1516.01, Sonoma County, California",127,117,10
1000000US060971516013004,060971516013004,"Block 3004, Block Group 3, Census Tract 1516.01, Sonoma County, California",10,9,1
1000000US060971516013005,060971516013005,"Block 3005, Block Group 3, Census Tract 1516.01, Sonoma County, California",2,1,1
1000000US060971516013006,060971516013006,"Block 3006, Block Group 3, Census Tract 1516.01, Sonoma County, California",261,224,37
1000000US060971516013007,060971516013007,"Block 3007, Block Group 3, Census Tract 1516.01, Sonoma County, California",27,23,4
1000000US060971516013008,060971516013008,"Block 3008, Block Group 3, Census Tract 1516.01, Sonoma County, California",19,18,1
1000000US060971516013009,060971516013009,"Block 3009, Block Group 3, Census Tract 1516.01, Sonoma County, California",21,20,1
1000000US060971516013010,060971516013010,"Block 3010, Block Group 3, Census Tract 1516.01, Sonoma County, California",45,42,3
1000000US060971516013011,060971516013011,"Block 3011, Block Group 3, Census Tract 1516.01, Sonoma County, California",9,6,3
1000000US060971516013012,060971516013012,"Block 3012, Block Group 3, Census Tract 1516.01, Sonoma County, California",132,118,14
1000000US060971516013013,060971516013013,"Block 3013, Block Group 3, Census Tract 1516.01, Sonoma County, California",3,3,0
1000000US060971516013014,060971516013014,"Block 3014, Block Group 3, Census Tract 1516.01, Sonoma County, California",21,16,5
1000000US060971516013015,060971516013015,"Block 3015, Block Group 3, Census Tract 1516.01, Sonoma County, California",18,17,1
1000000US060971516021000,060971516021000,"Block 1000, Block Group 1, Census Tract 1516.02, Sonoma County, California",48,36,12
1000000US060971516021001,060971516021001,"Block 1001, Block Group 1, Census Tract 1516.02, Sonoma County, California",1,1,0
1000000US060971516021002,060971516021002,"Block 1002, Block Group 1, Census Tract 1516.02, Sonoma County, California",16,13,3
1000000US060971516021003,060971516021003,"Block 1003, Block Group 1, Census Tract 1516.02, Sonoma County, California",52,45,7
1000000US060971516021004,060971516021004,"Block 1004, Block Group 1, Census Tract 1516.02, Sonoma County, California",227,214,13
1000000US060971516021005,060971516021005,"Block 1005, Block Group 1, Census Tract 1516.02, Sonoma County, California",3,3,0
1000000US060971516021006,060971516021006,"Block 1006, Block Group 1, Census Tract 1516.02, Sonoma County, California",7,7,0
1000000US060971516021007,060971516021007,"Block 1007, Block Group 1, Census Tract 1516.02, Sonoma County, California",0,0,0
1000000US060971516021008,060971516021008,"Block 1008, Block Group 1, Census Tract 1516.02, Sonoma County, California",6,3,3
1000000US060971516021009,060971516021009,"Block 1009, Block Group 1, Census Tract 1516.02, Sonoma County, California",67,65,2
1000000US060971516021010,060971516021010,"Block 1010, Block Group 1, Census Tract 1516.02, Sonoma County, California",5,5,0
1000000US060971516021011,060971516021011,"Block 1011, Block Group 1, Census Tract 1516.02, Sonoma County, California",85,64,21
1000000US060971516021012,060971516021012,"Block 1012, Block Group 1, Census Tract 1516.02, Sonoma County, California",44,30,14
1000000US060971516021013,060971516021013,"Block 1013, Block Group 1, Census Tract 1516.02, Sonoma County, California",4,3,1
1000000US060971516021014,060971516021014,"Block 1014, Block Group 1, Census Tract 1516.02, Sonoma County, California",21,21,0
1000000US060971516021015,060971516021015,"Block 1015, Block Group 1, Census Tract 1516.02, Sonoma County, California",12,5,7
1000000US060971516021016,060971516021016,"Block 1016, Block Group 1, Census Tract 1516.02, Sonoma County, California",0,0,0
1000000US060971516021017,060971516021017,"Block 1017, Block Group 1, Census Tract 1516.02, Sonoma County, California",15,8,7
1000000US060971516021018,060971516021018,"Block 1018, Block Group 1, Census Tract 1516.02, Sonoma County, California",15,15,0
1000000US060971516021019,060971516021019,"Block 1019, Block Group 1, Census Tract 1516.02, Sonoma County, California",0,0,0
1000000US060971516021020,060971516021020,"Block 1020, Block Group 1, Census Tract 1516.02, Sonoma County, California",32,27,5
1000000US060971516021021,060971516021021,"Block 1021, Block Group 1, Census Tract 1516.02, Sonoma County, California",4,4,0
1000000US060971516021022,060971516021022,"Block 1022, Block Group 1, Census Tract 1516.02, Sonoma County, California",4,3,1
1000000US060971516021023,060971516021023,"Block 1023, Block Group 1, Census Tract 1516.02, Sonoma County, California",0,0,0
1000000US060971516021024,060971516021024,"Block 1024, Block Group 1, Census Tract 1516.02, Sonoma County, California",31,22,9
1000000US060971516021025,060971516021025,"Block 1025, Block Group 1, Census Tract 1516.02, Sonoma County, California",0,0,0
1000000US060971516021026,060971516021026,"Block 1026, Block Group 1, Census Tract 1516.02, Sonoma County, California",1,1,0
1000000US060971516021027,060971516021027,"Block 1027, Block Group 1, Census Tract 1516.02, Sonoma County, California",1,1,0
1000000US060971516021028,060971516021028,"Block 1028, Block Group 1, Census Tract 1516.02, Sonoma County, California",0,0,0
1000000US060971516021029,060971516021029,"Block 1029, Block Group 1, Census Tract 1516.02, Sonoma County, California",0,0,0
1000000US060971516021030,060971516021030,"Block 1030, Block Group 1, Census Tract 1516.02, Sonoma County, California",0,0,0
1000000US060971516021031,060971516021031,"Block 1031, Block Group 1, Census Tract 1516.02, Sonoma County, California",0,0,0
1000000US060971516022000,060971516022000,"Block 2000, Block Group 2, Census Tract 1516.02, Sonoma County, California",30,28,2
1000000US060971516022001,060971516022001,"Block 2001, Block Group 2, Census Tract 1516.02, Sonoma County, California",24,23,1
1000000US060971516022002,060971516022002,"Block 2002, Block Group 2, Census Tract 1516.02, Sonoma County, California",17,17,0
1000000US060971516022003,060971516022003,"Block 2003, Block Group 2, Census Tract 1516.02, Sonoma County, California",376,344,32
1000000US060971516022004,060971516022004,"Block 2004, Block Group 2, Census Tract 1516.02, Sonoma County, California",21,20,1
1000000US060971516022005,060971516022005,"Block 2005, Block Group 2, Census Tract 1516.02, Sonoma County, California",23,23,0
1000000US060971516022006,060971516022006,"Block 2006, Block Group 2, Census Tract 1516.02, Sonoma County, California",7,5,2
1000000US060971516022007,060971516022007,"Block 2007, Block Group 2, Census Tract 1516.02, Sonoma County, California",13,13,0
1000000US060971516022008,060971516022008,"Block 2008, Block Group 2, Census Tract 1516.02, Sonoma County, California",28,26,2
1000000US060971516022009,060971516022009,"Block 2009, Block Group 2, Census Tract 1516.02, Sonoma County, California",27,23,4
1000000US060971516022010,060971516022010,"Block 2010, Block Group 2, Census Tract 1516.02, Sonoma County, California",22,21,1
1000000US060971516022011,060971516022011,"Block 2011, Block Group 2, Census Tract 1516.02, Sonoma County, California",13,13,0
1000000US060971516022012,060971516022012,"Block 2012, Block Group 2, Census Tract 1516.02, Sonoma County, California",13,13,0
1000000US060971516023000,060971516023000,"Block 3000, Block Group 3, Census Tract 1516.02, Sonoma County, California",0,0,0
1000000US060971516023001,060971516023001,"Block 3001, Block Group 3, Census Tract 1516.02, Sonoma County, California",30,29,1
1000000US060971516023002,060971516023002,"Block 3002, Block Group 3, Census Tract 1516.02, Sonoma County, California",78,73,5
1000000US060971516023003,060971516023003,"Block 3003, Block Group 3, Census Tract 1516.02, Sonoma County, California",0,0,0
1000000US060971516023004,060971516023004,"Block 3004, Block Group 3, Census Tract 1516.02, Sonoma County, California",2,2,0
1000000US060971516023005,060971516023005,"Block 3005, Block Group 3, Census Tract 1516.02, Sonoma County, California",6,6,0
1000000US060971516023006,060971516023006,"Block 3006, Block Group 3, Census Tract 1516.02, Sonoma County, California",23,18,5
1000000US060971516023007,060971516023007,"Block 3007, Block Group 3, Census Tract 1516.02, Sonoma County, California",6,4,2
1000000US060971516023008,060971516023008,"Block 3008, Block Group 3, Census Tract 1516.02, Sonoma County, California",2,2,0
1000000US060971516023009,060971516023009,"Block 3009, Block Group 3, Census Tract 1516.02, Sonoma County, California",7,5,2
1000000US060971516023010,060971516023010,"Block 3010, Block Group 3, Census Tract 1516.02, Sonoma County, California",0,0,0
1000000US060971516023011,060971516023011,"Block 3011, Block Group 3, Census Tract 1516.02, Sonoma County, California",0,0,0
1000000US060971516023012,060971516023012,"Block 3012, Block Group 3, Census Tract 1516.02, Sonoma County, California",1,1,0
1000000US060971516023013,060971516023013,"Block 3013, Block Group 3, Census Tract 1516.02, Sonoma County, California",12,10,2
1000000US060971516023014,060971516023014,"Block 3014, Block Group 3, Census Tract 1516.02, Sonoma County, California",144,127,17
1000000US060971516023015,060971516023015,"Block 3015, Block Group 3, Census Tract 1516.02, Sonoma County, California",13,8,5
1000000US060971516023016,060971516023016,"Block 3016, Block Group 3, Census Tract 1516.02, Sonoma County, California",12,11,1
1000000US060971516023017,060971516023017,"Block 3017, Block Group 3, Census Tract 1516.02, Sonoma County, California",16,13,3
1000000US060971516023018,060971516023018,"Block 3018, Block Group 3, Census Tract 1516.02, Sonoma County, California",46,43,3
1000000US060971516023019,060971516023019,"Block 3019, Block Group 3, Census Tract 1516.02, Sonoma County, California",5,3,2
1000000US060971516023020,060971516023020,"Block 3020, Block Group 3, Census Tract 1516.02, Sonoma County, California",0,0,0
1000000US060971516023021,060971516023021,"Block 3021, Block Group 3, Census Tract 1516.02, Sonoma County, California",0,0,0
1000000US060971516023022,060971516023022,"Block 3022, Block Group 3, Census Tract 1516.02, Sonoma County, California",0,0,0
1000000US060971516023023,060971516023023,"Block 3023, Block Group 3, Census Tract 1516.02, Sonoma County, California",0,0,0
1000000US060971516023024,060971516023024,"Block 3024, Block Group 3, Census Tract 1516.02, Sonoma County, California",0,0,0
1000000US060971516023025,060971516023025,"Block 3025, Block Group 3, Census Tract 1516.02, Sonoma County, California",0,0,0
1000000US060971516023026,060971516023026,"Block 3026, Block Group 3, Census Tract 1516.02, Sonoma County, California",0,0,0
1000000US060971516023027,060971516023027,"Block 3027, Block Group 3, Census Tract 1516.02, Sonoma County, California",34,32,2
1000000US060971516023028,060971516023028,"Block 3028, Block Group 3, Census Tract 1516.02, Sonoma County, California",8,7,1
1000000US060971516023029,060971516023029,"Block 3029, Block Group 3, Census Tract 1516.02, Sonoma County, California",0,0,0
1000000US060971516023030,060971516023030,"Block 3030, Block Group 3, Census Tract 1516.02, Sonoma County, California",0,0,0
1000000US060971516023031,060971516023031,"Block 3031, Block Group 3, Census Tract 1516.02, Sonoma County, California",0,0,0
1000000US060971516023032,060971516023032,"Block 3032, Block Group 3, Census Tract 1516.02, Sonoma County, California",0,0,0
1000000US060971516023033,060971516023033,"Block 3033, Block Group 3, Census Tract 1516.02, Sonoma County, California",0,0,0
1000000US060971516023034,060971516023034,"Block 3034, Block Group 3, Census Tract 1516.02, Sonoma County, California",0,0,0
1000000US060971516023035,060971516023035,"Block 3035, Block Group 3, Census Tract 1516.02, Sonoma County, California",0,0,0
1000000US060971516023036,060971516023036,"Block 3036, Block Group 3, Census Tract 1516.02, Sonoma County, California",0,0,0
1000000US060971516023037,060971516023037,"Block 3037, Block Group 3, Census Tract 1516.02, Sonoma County, California",0,0,0
1000000US060971516023038,060971516023038,"Block 3038, Block Group 3, Census Tract 1516.02, Sonoma County, California",0,0,0
1000000US060971516023039,060971516023039,"Block 3039, Block Group 3, Census Tract 1516.02, Sonoma County, California",0,0,0
1000000US060971516023040,060971516023040,"Block 3040, Block Group 3, Census Tract 1516.02, Sonoma County, California",0,0,0
1000000US060971516023041,060971516023041,"Block 3041, Block Group 3, Census Tract 1516.02, Sonoma County, California",0,0,0
1000000US060971516023042,060971516023042,"Block 3042, Block Group 3, Census Tract 1516.02, Sonoma County, California",0,0,0
1000000US060971516023043,060971516023043,"Block 3043, Block Group 3, Census Tract 1516.02, Sonoma County, California",0,0,0
1000000US060971516023044,060971516023044,"Block 3044, Block Group 3, Census Tract 1516.02, Sonoma County, California",0,0,0
1000000US060971516023045,060971516023045,"Block 3045, Block Group 3, Census Tract 1516.02, Sonoma County, California",0,0,0
1000000US060971516023046,060971516023046,"Block 3046, Block Group 3, Census Tract 1516.02, Sonoma County, California",0,0,0
1000000US060971516023047,060971516023047,"Block 3047, Block Group 3, Census Tract 1516.02, Sonoma County, California",0,0,0
1000000US060971516023048,060971516023048,"Block 3048, Block Group 3, Census Tract 1516.02, Sonoma County, California",0,0,0
1000000US060971516023049,060971516023049,"Block 3049, Block Group 3, Census Tract 1516.02, Sonoma County, California",0,0,0
1000000US060971516023050,060971516023050,"Block 3050, Block Group 3, Census Tract 1516.02, Sonoma County, California",0,0,0
1000000US060971516023051,060971516023051,"Block 3051, Block Group 3, Census Tract 1516.02, Sonoma County, California",0,0,0
1000000US060971516023052,060971516023052,"Block 3052, Block Group 3, Census Tract 1516.02, Sonoma County, California",0,0,0
1000000US060971516023053,060971516023053,"Block 3053, Block Group 3, Census Tract 1516.02, Sonoma County, California",0,0,0
1000000US060971516023054,060971516023054,"Block 3054, Block Group 3, Census Tract 1516.02, Sonoma County, California",0,0,0
1000000US060971516023055,060971516023055,"Block 3055, Block Group 3, Census Tract 1516.02, Sonoma County, California",0,0,0
1000000US060971516023056,060971516023056,"Block 3056, Block Group 3, Census Tract 1516.02, Sonoma County, California",0,0,0
1000000US060971516023057,060971516023057,"Block 3057, Block Group 3, Census Tract 1516.02, Sonoma County, California",0,0,0
1000000US060971516023058,060971516023058,"Block 3058, Block Group 3, Census Tract 1516.02, Sonoma County, California",3,3,0
1000000US060971516023059,060971516023059,"Block 3059, Block Group 3, Census Tract 1516.02, Sonoma County, California",22,21,1
1000000US060971516023060,060971516023060,"Block 3060, Block Group 3, Census Tract 1516.02, Sonoma County, California",0,0,0
1000000US060971516023061,060971516023061,"Block 3061, Block Group 3, Census Tract 1516.02, Sonoma County, California",3,3,0
1000000US060971516023062,060971516023062,"Block 3062, Block Group 3, Census Tract 1516.02, Sonoma County, California",6,6,0
1000000US060971516023063,060971516023063,"Block 3063, Block Group 3, Census Tract 1516.02, Sonoma County, California",6,6,0
1000000US060971516023064,060971516023064,"Block 3064, Block Group 3, Census Tract 1516.02, Sonoma County, California",8,7,1
1000000US060971516023065,060971516023065,"Block 3065, Block Group 3, Census Tract 1516.02, Sonoma County, California",10,8,2
1000000US060971516023066,060971516023066,"Block 3066, Block Group 3, Census Tract 1516.02, Sonoma County, California",254,229,25
1000000US060971516023067,060971516023067,"Block 3067, Block Group 3, Census Tract 1516.02, Sonoma County, California",19,19,0
1000000US060971516023068,060971516023068,"Block 3068, Block Group 3, Census Tract 1516.02, Sonoma County, California",0,0,0
1000000US060971516023069,060971516023069,"Block 3069, Block Group 3, Census Tract 1516.02, Sonoma County, California",16,15,1
1000000US060971516023070,060971516023070,"Block 3070, Block Group 3, Census Tract 1516.02, Sonoma County, California",9,8,1
1000000US060971516023071,060971516023071,"Block 3071, Block Group 3, Census Tract 1516.02, Sonoma County, California",0,0,0
1000000US060971516023072,060971516023072,"Block 3072, Block Group 3, Census Tract 1516.02, Sonoma County, California",0,0,0
1000000US060971516023073,060971516023073,"Block 3073, Block Group 3, Census Tract 1516.02, Sonoma County, California",0,0,0
1000000US060971516023074,060971516023074,"Block 3074, Block Group 3, Census Tract 1516.02, Sonoma County, California",0,0,0
1000000US060971516023075,060971516023075,"Block 3075, Block Group 3, Census Tract 1516.02, Sonoma County, California",0,0,0
1000000US060971516023076,060971516023076,"Block 3076, Block Group 3, Census Tract 1516.02, Sonoma County, California",0,0,0
1000000US060971516023077,060971516023077,"Block 3077, Block Group 3, Census Tract 1516.02, Sonoma County, California",0,0,0
1000000US060971516023078,060971516023078,"Block 3078, Block Group 3, Census Tract 1516.02, Sonoma County, California",0,0,0
1000000US060971516023079,060971516023079,"Block 3079, Block Group 3, Census Tract 1516.02, Sonoma County, California",0,0,0
1000000US060971516023080,060971516023080,"Block 3080, Block Group 3, Census Tract 1516.02, Sonoma County, California",0,0,0
1000000US060971516023081,060971516023081,"Block 3081, Block Group 3, Census Tract 1516.02, Sonoma County, California",0,0,0
1000000US060971516023082,060971516023082,"Block 3082, Block Group 3, Census Tract 1516.02, Sonoma County, California",0,0,0
1000000US060971517001000,060971517001000,"Block 1000, Block Group 1, Census Tract 1517, Sonoma County, California",230,215,15
1000000US060971517001001,060971517001001,"Block 1001, Block Group 1, Census Tract 1517, Sonoma County, California",18,18,0
1000000US060971517001002,060971517001002,"Block 1002, Block Group 1, Census Tract 1517, Sonoma County, California",15,14,1
1000000US060971517001003,060971517001003,"Block 1003, Block Group 1, Census Tract 1517, Sonoma County, California",27,26,1
1000000US060971517002000,060971517002000,"Block 2000, Block Group 2, Census Tract 1517, Sonoma County, California",1,1,0
1000000US060971517002001,060971517002001,"Block 2001, Block Group 2, Census Tract 1517, Sonoma County, California",45,43,2
1000000US060971517002002,060971517002002,"Block 2002, Block Group 2, Census Tract 1517, Sonoma County, California",9,8,1
1000000US060971517002003,060971517002003,"Block 2003, Block Group 2, Census Tract 1517, Sonoma County, California",0,0,0
1000000US060971517002004,060971517002004,"Block 2004, Block Group 2, Census Tract 1517, Sonoma County, California",0,0,0
1000000US060971517002005,060971517002005,"Block 2005, Block Group 2, Census Tract 1517, Sonoma County, California",0,0,0
1000000US060971517002006,060971517002006,"Block 2006, Block Group 2, Census Tract 1517, Sonoma County, California",0,0,0
1000000US060971517002007,060971517002007,"Block 2007, Block Group 2, Census Tract 1517, Sonoma County, California",7,7,0
1000000US060971517002008,060971517002008,"Block 2008, Block Group 2, Census Tract 1517, Sonoma County, California",70,66,4
1000000US060971517002009,060971517002009,"Block 2009, Block Group 2, Census Tract 1517, Sonoma County, California",0,0,0
1000000US060971517002010,060971517002010,"Block 2010, Block Group 2, Census Tract 1517, Sonoma County, California",17,17,0
1000000US060971517002011,060971517002011,"Block 2011, Block Group 2, Census Tract 1517, Sonoma County, California",0,0,0
1000000US060971517002012,060971517002012,"Block 2012, Block Group 2, Census Tract 1517, Sonoma County, California",0,0,0
1000000US060971517002013,060971517002013,"Block 2013, Block Group 2, Census Tract 1517, Sonoma County, California",0,0,0
1000000US060971517002014,060971517002014,"Block 2014, Block Group 2, Census Tract 1517, Sonoma County, California",1,1,0
1000000US060971517002015,060971517002015,"Block 2015, Block Group 2, Census Tract 1517, Sonoma County, California",0,0,0
1000000US060971517002016,060971517002016,"Block 2016, Block Group 2, Census Tract 1517, Sonoma County, California",0,0,0
1000000US060971517002017,060971517002017,"Block 2017, Block Group 2, Census Tract 1517, Sonoma County, California",0,0,0
1000000US060971517002018,060971517002018,"Block 2018, Block Group 2, Census Tract 1517, Sonoma County, California",0,0,0
1000000US060971517002019,060971517002019,"Block 2019, Block Group 2, Census Tract 1517, Sonoma County, California",0,0,0
1000000US060971517002020,060971517002020,"Block 2020, Block Group 2, Census Tract 1517, Sonoma County, California",0,0,0
1000000US060971517002021,060971517002021,"Block 2021, Block Group 2, Census Tract 1517, Sonoma County, California",0,0,0
1000000US060971517002022,060971517002022,"Block 2022, Block Group 2, Census Tract 1517, Sonoma County, California",0,0,0
1000000US060971517002023,060971517002023,"Block 2023, Block Group 2, Census Tract 1517, Sonoma County, California",0,0,0
1000000US060971517002024,060971517002024,"Block 2024, Block Group 2, Census Tract 1517, Sonoma County, California",0,0,0
1000000US060971517002025,060971517002025,"Block 2025, Block Group 2, Census Tract 1517, Sonoma County, California",0,0,0
1000000US060971517002026,060971517002026,"Block 2026, Block Group 2, Census Tract 1517, Sonoma County, California",0,0,0
1000000US060971517002027,060971517002027,"Block 2027, Block Group 2, Census Tract 1517, Sonoma County, California",0,0,0
1000000US060971517002028,060971517002028,"Block 2028, Block Group 2, Census Tract 1517, Sonoma County, California",0,0,0
1000000US060971517002029,060971517002029,"Block 2029, Block Group 2, Census Tract 1517, Sonoma County, California",0,0,0
1000000US060971517002030,060971517002030,"Block 2030, Block Group 2, Census Tract 1517, Sonoma County, California",172,167,5
1000000US060971517002031,060971517002031,"Block 2031, Block Group 2, Census Tract 1517, Sonoma County, California",0,0,0
1000000US060971517002032,060971517002032,"Block 2032, Block Group 2, Census Tract 1517, Sonoma County, California",60,59,1
1000000US060971517002033,060971517002033,"Block 2033, Block Group 2, Census Tract 1517, Sonoma County, California",0,0,0
1000000US060971517003000,060971517003000,"Block 3000, Block Group 3, Census Tract 1517, Sonoma County, California",203,188,15
1000000US060971517003001,060971517003001,"Block 3001, Block Group 3, Census Tract 1517, Sonoma County, California",138,124,14
1000000US060971517003002,060971517003002,"Block 3002, Block Group 3, Census Tract 1517, Sonoma County, California",18,18,0
1000000US060971517003003,060971517003003,"Block 3003, Block Group 3, Census Tract 1517, Sonoma County, California",33,33,0
1000000US060971517003004,060971517003004,"Block 3004, Block Group 3, Census Tract 1517, Sonoma County, California",33,33,0
1000000US060971517003005,060971517003005,"Block 3005, Block Group 3, Census Tract 1517, Sonoma County, California",22,21,1
1000000US060971517003006,060971517003006,"Block 3006, Block Group 3, Census Tract 1517, Sonoma County, California",94,92,2
1000000US060971517004000,060971517004000,"Block 4000, Block Group 4, Census Tract 1517, Sonoma County, California",25,24,1
1000000US060971517004001,060971517004001,"Block 4001, Block Group 4, Census Tract 1517, Sonoma County, California",34,34,0
1000000US060971517004002,060971517004002,"Block 4002, Block Group 4, Census Tract 1517, Sonoma County, California",14,12,2
1000000US060971517004003,060971517004003,"Block 4003, Block Group 4, Census Tract 1517, Sonoma County, California",11,11,0
1000000US060971517004004,060971517004004,"Block 4004, Block Group 4, Census Tract 1517, Sonoma County, California",17,17,0
1000000US060971517004005,060971517004005,"Block 4005, Block Group 4, Census Tract 1517, Sonoma County, California",18,17,1
1000000US060971517004006,060971517004006,"Block 4006, Block Group 4, Census Tract 1517, Sonoma County, California",18,18,0
1000000US060971517004007,060971517004007,"Block 4007, Block Group 4, Census Tract 1517, Sonoma County, California",48,44,4
1000000US060971517004008,060971517004008,"Block 4008, Block Group 4, Census Tract 1517, Sonoma County, California",3,3,0
1000000US060971517004009,060971517004009,"Block 4009, Block Group 4, Census Tract 1517, Sonoma County, California",68,64,4
1000000US060971517004010,060971517004010,"Block 4010, Block Group 4, Census Tract 1517, Sonoma County, California",46,41,5
1000000US060971517004011,060971517004011,"Block 4011, Block Group 4, Census Tract 1517, Sonoma County, California",49,46,3
1000000US060971517004012,060971517004012,"Block 4012, Block Group 4, Census Tract 1517, Sonoma County, California",28,27,1
1000000US060971517004013,060971517004013,"Block 4013, Block Group 4, Census Tract 1517, Sonoma County, California",9,9,0
1000000US060971517004014,060971517004014,"Block 4014, Block Group 4, Census Tract 1517, Sonoma County, California",29,29,0
1000000US060971517004015,060971517004015,"Block 4015, Block Group 4, Census Tract 1517, Sonoma County, California",60,56,4
1000000US060971517004016,060971517004016,"Block 4016, Block Group 4, Census Tract 1517, Sonoma County, California",39,38,1
1000000US060971517004017,060971517004017,"Block 4017, Block Group 4, Census Tract 1517, Sonoma County, California",51,49,2
1000000US060971517004018,060971517004018,"Block 4018, Block Group 4, Census Tract 1517, Sonoma County, California",11,11,0
1000000US060971517004019,060971517004019,"Block 4019, Block Group 4, Census Tract 1517, Sonoma County, California",32,29,3
1000000US060971517004020,060971517004020,"Block 4020, Block Group 4, Census Tract 1517, Sonoma County, California",114,98,16
1000000US060971517004021,060971517004021,"Block 4021, Block Group 4, Census Tract 1517, Sonoma County, California",53,50,3
1000000US060971517005000,060971517005000,"Block 5000, Block Group 5, Census Tract 1517, Sonoma County, California",21,21,0
1000000US060971517005001,060971517005001,"Block 5001, Block Group 5, Census Tract 1517, Sonoma County, California",16,16,0
1000000US060971517005002,060971517005002,"Block 5002, Block Group 5, Census Tract 1517, Sonoma County, California",42,40,2
1000000US060971517005003,060971517005003,"Block 5003, Block Group 5, Census Tract 1517, Sonoma County, California",16,15,1
1000000US060971517005004,060971517005004,"Block 5004, Block Group 5, Census Tract 1517, Sonoma County, California",14,12,2
1000000US060971517005005,060971517005005,"Block 5005, Block Group 5, Census Tract 1517, Sonoma County, California",23,22,1
1000000US060971517005006,060971517005006,"Block 5006, Block Group 5, Census Tract 1517, Sonoma County, California",17,16,1
1000000US060971517005007,060971517005007,"Block 5007, Block Group 5, Census Tract 1517, Sonoma County, California",345,324,21
1000000US060971517005008,060971517005008,"Block 5008, Block Group 5, Census Tract 1517, Sonoma County, California",10,10,0
1000000US060971517005009,060971517005009,"Block 5009, Block Group 5, Census Tract 1517, Sonoma County, California",31,30,1
1000000US060971517005010,060971517005010,"Block 5010, Block Group 5, Census Tract 1517, Sonoma County, California",12,12,0
1000000US060971517005011,060971517005011,"Block 5011, Block Group 5, Census Tract 1517, Sonoma County, California",1,1,0
1000000US060971517005012,060971517005012,"Block 5012, Block Group 5, Census Tract 1517, Sonoma County, California",0,0,0
1000000US060971517005013,060971517005013,"Block 5013, Block Group 5, Census Tract 1517, Sonoma County, California",5,5,0
1000000US060971517005014,060971517005014,"Block 5014, Block Group 5, Census Tract 1517, Sonoma County, California",19,17,2
1000000US060971517005015,060971517005015,"Block 5015, Block Group 5, Census Tract 1517, Sonoma County, California",12,11,1
1000000US060971517005016,060971517005016,"Block 5016, Block Group 5, Census Tract 1517, Sonoma County, California",0,0,0
1000000US060971517005017,060971517005017,"Block 5017, Block Group 5, Census Tract 1517, Sonoma County, California",0,0,0
1000000US060971517005018,060971517005018,"Block 5018, Block Group 5, Census Tract 1517, Sonoma County, California",0,0,0
1000000US060971517006000,060971517006000,"Block 6000, Block Group 6, Census Tract 1517, Sonoma County, California",295,267,28
1000000US060971517006001,060971517006001,"Block 6001, Block Group 6, Census Tract 1517, Sonoma County, California",0,0,0
1000000US060971517006002,060971517006002,"Block 6002, Block Group 6, Census Tract 1517, Sonoma County, California",1,1,0
1000000US060971517006003,060971517006003,"Block 6003, Block Group 6, Census Tract 1517, Sonoma County, California",9,8,1
1000000US060971517006004,060971517006004,"Block 6004, Block Group 6, Census Tract 1517, Sonoma County, California",27,26,1
1000000US060971517006005,060971517006005,"Block 6005, Block Group 6, Census Tract 1517, Sonoma County, California",3,2,1
1000000US060971517006006,060971517006006,"Block 6006, Block Group 6, Census Tract 1517, Sonoma County, California",1,1,0
1000000US060971517006007,060971517006007,"Block 6007, Block Group 6, Census Tract 1517, Sonoma County, California",0,0,0
1000000US060971517006008,060971517006008,"Block 6008, Block Group 6, Census Tract 1517, Sonoma County, California",100,98,2
1000000US060971517006009,060971517006009,"Block 6009, Block Group 6, Census Tract 1517, Sonoma County, California",78,78,0
1000000US060971517006010,060971517006010,"Block 6010, Block Group 6, Census Tract 1517, Sonoma County, California",0,0,0
1000000US060971517006011,060971517006011,"Block 6011, Block Group 6, Census Tract 1517, Sonoma County, California",6,4,2
1000000US060971517006012,060971517006012,"Block 6012, Block Group 6, Census Tract 1517, Sonoma County, California",1,1,0
1000000US060971518001000,060971518001000,"Block 1000, Block Group 1, Census Tract 1518, Sonoma County, California",62,58,4
1000000US060971518001001,060971518001001,"Block 1001, Block Group 1, Census Tract 1518, Sonoma County, California",133,125,8
1000000US060971518001002,060971518001002,"Block 1002, Block Group 1, Census Tract 1518, Sonoma County, California",23,21,2
1000000US060971518001003,060971518001003,"Block 1003, Block Group 1, Census Tract 1518, Sonoma County, California",22,20,2
1000000US060971518001004,060971518001004,"Block 1004, Block Group 1, Census Tract 1518, Sonoma County, California",12,12,0
1000000US060971518001005,060971518001005,"Block 1005, Block Group 1, Census Tract 1518, Sonoma County, California",42,42,0
1000000US060971518001006,060971518001006,"Block 1006, Block Group 1, Census Tract 1518, Sonoma County, California",53,50,3
1000000US060971518001007,060971518001007,"Block 1007, Block Group 1, Census Tract 1518, Sonoma County, California",23,22,1
1000000US060971518001008,060971518001008,"Block 1008, Block Group 1, Census Tract 1518, Sonoma County, California",21,20,1
1000000US060971518001009,060971518001009,"Block 1009, Block Group 1, Census Tract 1518, Sonoma County, California",10,8,2
1000000US060971518001010,060971518001010,"Block 1010, Block Group 1, Census Tract 1518, Sonoma County, California",19,18,1
1000000US060971518001011,060971518001011,"Block 1011, Block Group 1, Census Tract 1518, Sonoma County, California",22,22,0
1000000US060971518001012,060971518001012,"Block 1012, Block Group 1, Census Tract 1518, Sonoma County, California",23,22,1
1000000US060971518001013,060971518001013,"Block 1013, Block Group 1, Census Tract 1518, Sonoma County, California",16,16,0
1000000US060971518001014,060971518001014,"Block 1014, Block Group 1, Census Tract 1518, Sonoma County, California",8,7,1
1000000US060971518001015,060971518001015,"Block 1015, Block Group 1, Census Tract 1518, Sonoma County, California",4,4,0
1000000US060971518001016,060971518001016,"Block 1016, Block Group 1, Census Tract 1518, Sonoma County, California",7,7,0
1000000US060971518001017,060971518001017,"Block 1017, Block Group 1, Census Tract 1518, Sonoma County, California",7,6,1
1000000US060971518001018,060971518001018,"Block 1018, Block Group 1, Census Tract 1518, Sonoma County, California",18,15,3
1000000US060971518001019,060971518001019,"Block 1019, Block Group 1, Census Tract 1518, Sonoma County, California",9,9,0
1000000US060971518001020,060971518001020,"Block 1020, Block Group 1, Census Tract 1518, Sonoma County, California",0,0,0
1000000US060971518002000,060971518002000,"Block 2000, Block Group 2, Census Tract 1518, Sonoma County, California",36,36,0
1000000US060971518002001,060971518002001,"Block 2001, Block Group 2, Census Tract 1518, Sonoma County, California",38,38,0
1000000US060971518002002,060971518002002,"Block 2002, Block Group 2, Census Tract 1518, Sonoma County, California",38,38,0
1000000US060971518002003,060971518002003,"Block 2003, Block Group 2, Census Tract 1518, Sonoma County, California",19,18,1
1000000US060971518002004,060971518002004,"Block 2004, Block Group 2, Census Tract 1518, Sonoma County, California",29,29,0
1000000US060971518002005,060971518002005,"Block 2005, Block Group 2, Census Tract 1518, Sonoma County, California",20,19,1
1000000US060971518002006,060971518002006,"Block 2006, Block Group 2, Census Tract 1518, Sonoma County, California",28,28,0
1000000US060971518002007,060971518002007,"Block 2007, Block Group 2, Census Tract 1518, Sonoma County, California",29,28,1
1000000US060971518002008,060971518002008,"Block 2008, Block Group 2, Census Tract 1518, Sonoma County, California",27,25,2
1000000US060971518002009,060971518002009,"Block 2009, Block Group 2, Census Tract 1518, Sonoma County, California",32,30,2
1000000US060971518002010,060971518002010,"Block 2010, Block Group 2, Census Tract 1518, Sonoma County, California",27,25,2
1000000US060971518003000,060971518003000,"Block 3000, Block Group 3, Census Tract 1518, Sonoma County, California",28,27,1
1000000US060971518003001,060971518003001,"Block 3001, Block Group 3, Census Tract 1518, Sonoma County, California",40,39,1
1000000US060971518003002,060971518003002,"Block 3002, Block Group 3, Census Tract 1518, Sonoma County, California",24,24,0
1000000US060971518003003,060971518003003,"Block 3003, Block Group 3, Census Tract 1518, Sonoma County, California",27,27,0
1000000US060971518003004,060971518003004,"Block 3004, Block Group 3, Census Tract 1518, Sonoma County, California",28,28,0
1000000US060971518003005,060971518003005,"Block 3005, Block Group 3, Census Tract 1518, Sonoma County, California",9,9,0
1000000US060971518003006,060971518003006,"Block 3006, Block Group 3, Census Tract 1518, Sonoma County, California",12,10,2
1000000US060971518003007,060971518003007,"Block 3007, Block Group 3, Census Tract 1518, Sonoma County, California",35,34,1
1000000US060971518003008,060971518003008,"Block 3008, Block Group 3, Census Tract 1518, Sonoma County, California",15,15,0
1000000US060971518003009,060971518003009,"Block 3009, Block Group 3, Census Tract 1518, Sonoma County, California",12,10,2
1000000US060971518003010,060971518003010,"Block 3010, Block Group 3, Census Tract 1518, Sonoma County, California",0,0,0
1000000US060971518003011,060971518003011,"Block 3011, Block Group 3, Census Tract 1518, Sonoma County, California",0,0,0
1000000US060971518003012,060971518003012,"Block 3012, Block Group 3, Census Tract 1518, Sonoma County, California",30,28,2
1000000US060971518003013,060971518003013,"Block 3013, Block Group 3, Census Tract 1518, Sonoma County, California",28,28,0
1000000US060971518003014,060971518003014,"Block 3014, Block Group 3, Census Tract 1518, Sonoma County, California",26,25,1
1000000US060971518003015,060971518003015,"Block 3015, Block Group 3, Census Tract 1518, Sonoma County, California",43,42,1
1000000US060971518003016,060971518003016,"Block 3016, Block Group 3, Census Tract 1518, Sonoma County, California",36,33,3
1000000US060971518004000,060971518004000,"Block 4000, Block Group 4, Census Tract 1518, Sonoma County, California",31,31,0
1000000US060971518004001,060971518004001,"Block 4001, Block Group 4, Census Tract 1518, Sonoma County, California",13,13,0
1000000US060971518004002,060971518004002,"Block 4002, Block Group 4, Census Tract 1518, Sonoma County, California",8,7,1
1000000US060971518004003,060971518004003,"Block 4003, Block Group 4, Census Tract 1518, Sonoma County, California",27,26,1
1000000US060971518004004,060971518004004,"Block 4004, Block Group 4, Census Tract 1518, Sonoma County, California",14,12,2
1000000US060971518004005,060971518004005,"Block 4005, Block Group 4, Census Tract 1518, Sonoma County, California",19,16,3
1000000US060971518004006,060971518004006,"Block 4006, Block Group 4, Census Tract 1518, Sonoma County, California",75,73,2
1000000US060971518004007,060971518004007,"Block 4007, Block Group 4, Census Tract 1518, Sonoma County, California",0,0,0
1000000US060971518004008,060971518004008,"Block 4008, Block Group 4, Census Tract 1518, Sonoma County, California",67,67,0
1000000US060971518004009,060971518004009,"Block 4009, Block Group 4, Census Tract 1518, Sonoma County, California",18,17,1
1000000US060971518004010,060971518004010,"Block 4010, Block Group 4, Census Tract 1518, Sonoma County, California",1,1,0
1000000US060971518004011,060971518004011,"Block 4011, Block Group 4, Census Tract 1518, Sonoma County, California",17,17,0
1000000US060971518004012,060971518004012,"Block 4012, Block Group 4, Census Tract 1518, Sonoma County, California",125,118,7
1000000US060971518004013,060971518004013,"Block 4013, Block Group 4, Census Tract 1518, Sonoma County, California",13,13,0
1000000US060971518004014,060971518004014,"Block 4014, Block Group 4, Census Tract 1518, Sonoma County, California",20,18,2
1000000US060971518004015,060971518004015,"Block 4015, Block Group 4, Census Tract 1518, Sonoma County, California",32,30,2
1000000US060971518004016,060971518004016,"Block 4016, Block Group 4, Census Tract 1518, Sonoma County, California",45,43,2
1000000US060971518004017,060971518004017,"Block 4017, Block Group 4, Census Tract 1518, Sonoma County, California",0,0,0
1000000US060971518004018,060971518004018,"Block 4018, Block Group 4, Census Tract 1518, Sonoma County, California",90,88,2
1000000US060971518004019,060971518004019,"Block 4019, Block Group 4, Census Tract 1518, Sonoma County, California",38,38,0
1000000US060971518004020,060971518004020,"Block 4020, Block Group 4, Census Tract 1518, Sonoma County, California",37,35,2
1000000US060971518004021,060971518004021,"Block 4021, Block Group 4, Census Tract 1518, Sonoma County, California",0,0,0
1000000US060971518004022,060971518004022,"Block 4022, Block Group 4, Census Tract 1518, Sonoma County, California",0,0,0
1000000US060971518004023,060971518004023,"Block 4023, Block Group 4, Census Tract 1518, Sonoma County, California",0,0,0
1000000US060971518005000,060971518005000,"Block 5000, Block Group 5, Census Tract 1518, Sonoma County, California",31,30,1
1000000US060971518005001,060971518005001,"Block 5001, Block Group 5, Census Tract 1518, Sonoma County, California",0,0,0
1000000US060971518005002,060971518005002,"Block 5002, Block Group 5, Census Tract 1518, Sonoma County, California",0,0,0
1000000US060971518005003,060971518005003,"Block 5003, Block Group 5, Census Tract 1518, Sonoma County, California",32,30,2
1000000US060971518005004,060971518005004,"Block 5004, Block Group 5, Census Tract 1518, Sonoma County, California",32,31,1
1000000US060971518005005,060971518005005,"Block 5005, Block Group 5, Census Tract 1518, Sonoma County, California",33,31,2
1000000US060971518005006,060971518005006,"Block 5006, Block Group 5, Census Tract 1518, Sonoma County, California",0,0,0
1000000US060971518005007,060971518005007,"Block 5007, Block Group 5, Census Tract 1518, Sonoma County, California",0,0,0
1000000US060971518005008,060971518005008,"Block 5008, Block Group 5, Census Tract 1518, Sonoma County, California",0,0,0
1000000US060971518005009,060971518005009,"Block 5009, Block Group 5, Census Tract 1518, Sonoma County, California",0,0,0
1000000US060971518005010,060971518005010,"Block 5010, Block Group 5, Census Tract 1518, Sonoma County, California",32,30,2
1000000US060971518005011,060971518005011,"Block 5011, Block Group 5, Census Tract 1518, Sonoma County, California",45,36,9
1000000US060971518005012,060971518005012,"Block 5012, Block Group 5, Census Tract 1518, Sonoma County, California",47,42,5
1000000US060971518005013,060971518005013,"Block 5013, Block Group 5, Census Tract 1518, Sonoma County, California",0,0,0
1000000US060971518005014,060971518005014,"Block 5014, Block Group 5, Census Tract 1518, Sonoma County, California",0,0,0
1000000US060971518005015,060971518005015,"Block 5015, Block Group 5, Census Tract 1518, Sonoma County, California",29,28,1
1000000US060971518005016,060971518005016,"Block 5016, Block Group 5, Census Tract 1518, Sonoma County, California",20,18,2
1000000US060971518005017,060971518005017,"Block 5017, Block Group 5, Census Tract 1518, Sonoma County, California",0,0,0
1000000US060971519001000,060971519001000,"Block 1000, Block Group 1, Census Tract 1519, Sonoma County, California",88,81,7
1000000US060971519001001,060971519001001,"Block 1001, Block Group 1, Census Tract 1519, Sonoma County, California",42,40,2
1000000US060971519001002,060971519001002,"Block 1002, Block Group 1, Census Tract 1519, Sonoma County, California",69,62,7
1000000US060971519001003,060971519001003,"Block 1003, Block Group 1, Census Tract 1519, Sonoma County, California",78,73,5
1000000US060971519002000,060971519002000,"Block 2000, Block Group 2, Census Tract 1519, Sonoma County, California",63,59,4
1000000US060971519002001,060971519002001,"Block 2001, Block Group 2, Census Tract 1519, Sonoma County, California",57,54,3
1000000US060971519002002,060971519002002,"Block 2002, Block Group 2, Census Tract 1519, Sonoma County, California",41,38,3
1000000US060971519002003,060971519002003,"Block 2003, Block Group 2, Census Tract 1519, Sonoma County, California",168,130,38
1000000US060971519002004,060971519002004,"Block 2004, Block Group 2, Census Tract 1519, Sonoma County, California",0,0,0
1000000US060971519002005,060971519002005,"Block 2005, Block Group 2, Census Tract 1519, Sonoma County, California",0,0,0
1000000US060971519002006,060971519002006,"Block 2006, Block Group 2, Census Tract 1519, Sonoma County, California",0,0,0
1000000US060971519003000,060971519003000,"Block 3000, Block Group 3, Census Tract 1519, Sonoma County, California",36,32,4
1000000US060971519003001,060971519003001,"Block 3001, Block Group 3, Census Tract 1519, Sonoma County, California",48,48,0
1000000US060971519003002,060971519003002,"Block 3002, Block Group 3, Census Tract 1519, Sonoma County, California",34,33,1
1000000US060971519003003,060971519003003,"Block 3003, Block Group 3, Census Tract 1519, Sonoma County, California",37,37,0
1000000US060971519003004,060971519003004,"Block 3004, Block Group 3, Census Tract 1519, Sonoma County, California",36,35,1
1000000US060971519003005,060971519003005,"Block 3005, Block Group 3, Census Tract 1519, Sonoma County, California",36,32,4
1000000US060971519003006,060971519003006,"Block 3006, Block Group 3, Census Tract 1519, Sonoma County, California",32,31,1
1000000US060971519003007,060971519003007,"Block 3007, Block Group 3, Census Tract 1519, Sonoma County, California",41,38,3
1000000US060971519003008,060971519003008,"Block 3008, Block Group 3, Census Tract 1519, Sonoma County, California",16,16,0
1000000US060971519003009,060971519003009,"Block 3009, Block Group 3, Census Tract 1519, Sonoma County, California",0,0,0
1000000US060971519003010,060971519003010,"Block 3010, Block Group 3, Census Tract 1519, Sonoma County, California",0,0,0
1000000US060971519003011,060971519003011,"Block 3011, Block Group 3, Census Tract 1519, Sonoma County, California",27,26,1
1000000US060971519004000,060971519004000,"Block 4000, Block Group 4, Census Tract 1519, Sonoma County, California",0,0,0
1000000US060971519004001,060971519004001,"Block 4001, Block Group 4, Census Tract 1519, Sonoma County, California",166,155,11
1000000US060971519004002,060971519004002,"Block 4002, Block Group 4, Census Tract 1519, Sonoma County, California",13,13,0
1000000US060971519004003,060971519004003,"Block 4003, Block Group 4, Census Tract 1519, Sonoma County, California",56,52,4
1000000US060971519004004,060971519004004,"Block 4004, Block Group 4, Census Tract 1519, Sonoma County, California",70,65,5
1000000US060971519004005,060971519004005,"Block 4005, Block Group 4, Census Tract 1519, Sonoma County, California",31,28,3
1000000US060971519004006,060971519004006,"Block 4006, Block Group 4, Census Tract 1519, Sonoma County, California",24,23,1
1000000US060971519004007,060971519004007,"Block 4007, Block Group 4, Census Tract 1519, Sonoma County, California",21,17,4
1000000US060971519004008,060971519004008,"Block 4008, Block Group 4, Census Tract 1519, Sonoma County, California",0,0,0
1000000US060971519004009,060971519004009,"Block 4009, Block Group 4, Census Tract 1519, Sonoma County, California",12,11,1
1000000US060971519004010,060971519004010,"Block 4010, Block Group 4, Census Tract 1519, Sonoma County, California",30,29,1
1000000US060971519004011,060971519004011,"Block 4011, Block Group 4, Census Tract 1519, Sonoma County, California",20,19,1
1000000US060971519004012,060971519004012,"Block 4012, Block Group 4, Census Tract 1519, Sonoma County, California",0,0,0
1000000US060971519004013,060971519004013,"Block 4013, Block Group 4, Census Tract 1519, Sonoma County, California",34,34,0
1000000US060971519004014,060971519004014,"Block 4014, Block Group 4, Census Tract 1519, Sonoma County, California",16,16,0
1000000US060971520001000,060971520001000,"Block 1000, Block Group 1, Census Tract 1520, Sonoma County, California",48,43,5
1000000US060971520001001,060971520001001,"Block 1001, Block Group 1, Census Tract 1520, Sonoma County, California",0,0,0
1000000US060971520001002,060971520001002,"Block 1002, Block Group 1, Census Tract 1520, Sonoma County, California",12,12,0
1000000US060971520001003,060971520001003,"Block 1003, Block Group 1, Census Tract 1520, Sonoma County, California",13,12,1
1000000US060971520001004,060971520001004,"Block 1004, Block Group 1, Census Tract 1520, Sonoma County, California",0,0,0
1000000US060971520001005,060971520001005,"Block 1005, Block Group 1, Census Tract 1520, Sonoma County, California",7,7,0
1000000US060971520001006,060971520001006,"Block 1006, Block Group 1, Census Tract 1520, Sonoma County, California",36,34,2
1000000US060971520001007,060971520001007,"Block 1007, Block Group 1, Census Tract 1520, Sonoma County, California",0,0,0
1000000US060971520001008,060971520001008,"Block 1008, Block Group 1, Census Tract 1520, Sonoma County, California",0,0,0
1000000US060971520001009,060971520001009,"Block 1009, Block Group 1, Census Tract 1520, Sonoma County, California",0,0,0
1000000US060971520001010,060971520001010,"Block 1010, Block Group 1, Census Tract 1520, Sonoma County, California",0,0,0
1000000US060971520001011,060971520001011,"Block 1011, Block Group 1, Census Tract 1520, Sonoma County, California",23,20,3
1000000US060971520001012,060971520001012,"Block 1012, Block Group 1, Census Tract 1520, Sonoma County, California",92,84,8
1000000US060971520001013,060971520001013,"Block 1013, Block Group 1, Census Tract 1520, Sonoma County, California",0,0,0
1000000US060971520001014,060971520001014,"Block 1014, Block Group 1, Census Tract 1520, Sonoma County, California",42,39,3
1000000US060971520001015,060971520001015,"Block 1015, Block Group 1, Census Tract 1520, Sonoma County, California",87,79,8
1000000US060971520001016,060971520001016,"Block 1016, Block Group 1, Census Tract 1520, Sonoma County, California",0,0,0
1000000US060971520001017,060971520001017,"Block 1017, Block Group 1, Census Tract 1520, Sonoma County, California",41,39,2
1000000US060971520001018,060971520001018,"Block 1018, Block Group 1, Census Tract 1520, Sonoma County, California",34,33,1
1000000US060971520001019,060971520001019,"Block 1019, Block Group 1, Census Tract 1520, Sonoma County, California",17,16,1
1000000US060971520001020,060971520001020,"Block 1020, Block Group 1, Census Tract 1520, Sonoma County, California",0,0,0
1000000US060971520001021,060971520001021,"Block 1021, Block Group 1, Census Tract 1520, Sonoma County, California",0,0,0
1000000US060971520001022,060971520001022,"Block 1022, Block Group 1, Census Tract 1520, Sonoma County, California",0,0,0
1000000US060971520001023,060971520001023,"Block 1023, Block Group 1, Census Tract 1520, Sonoma County, California",37,33,4
1000000US060971520001024,060971520001024,"Block 1024, Block Group 1, Census Tract 1520, Sonoma County, California",0,0,0
1000000US060971520001025,060971520001025,"Block 1025, Block Group 1, Census Tract 1520, Sonoma County, California",0,0,0
1000000US060971520001026,060971520001026,"Block 1026, Block Group 1, Census Tract 1520, Sonoma County, California",0,0,0
1000000US060971520001027,060971520001027,"Block 1027, Block Group 1, Census Tract 1520, Sonoma County, California",0,0,0
1000000US060971520001028,060971520001028,"Block 1028, Block Group 1, Census Tract 1520, Sonoma County, California",0,0,0
1000000US060971520001029,060971520001029,"Block 1029, Block Group 1, Census Tract 1520, Sonoma County, California",82,78,4
1000000US060971520001030,060971520001030,"Block 1030, Block Group 1, Census Tract 1520, Sonoma County, California",0,0,0
1000000US060971520001031,060971520001031,"Block 1031, Block Group 1, Census Tract 1520, Sonoma County, California",0,0,0
1000000US060971520001032,060971520001032,"Block 1032, Block Group 1, Census Tract 1520, Sonoma County, California",0,0,0
1000000US060971520001033,060971520001033,"Block 1033, Block Group 1, Census Tract 1520, Sonoma County, California",8,5,3
1000000US060971520001034,060971520001034,"Block 1034, Block Group 1, Census Tract 1520, Sonoma County, California",0,0,0
1000000US060971520001035,060971520001035,"Block 1035, Block Group 1, Census Tract 1520, Sonoma County, California",0,0,0
1000000US060971520001036,060971520001036,"Block 1036, Block Group 1, Census Tract 1520, Sonoma County, California",0,0,0
1000000US060971520001037,060971520001037,"Block 1037, Block Group 1, Census Tract 1520, Sonoma County, California",0,0,0
1000000US060971520001038,060971520001038,"Block 1038, Block Group 1, Census Tract 1520, Sonoma County, California",0,0,0
1000000US060971520001039,060971520001039,"Block 1039, Block Group 1, Census Tract 1520, Sonoma County, California",0,0,0
1000000US060971520001040,060971520001040,"Block 1040, Block Group 1, Census Tract 1520, Sonoma County, California",0,0,0
1000000US060971520001041,060971520001041,"Block 1041, Block Group 1, Census Tract 1520, Sonoma County, California",0,0,0
1000000US060971520001042,060971520001042,"Block 1042, Block Group 1, Census Tract 1520, Sonoma County, California",0,0,0
1000000US060971520001043,060971520001043,"Block 1043, Block Group 1, Census Tract 1520, Sonoma County, California",0,0,0
1000000US060971520001044,060971520001044,"Block 1044, Block Group 1, Census Tract 1520, Sonoma County, California",0,0,0
1000000US060971520001045,060971520001045,"Block 1045, Block Group 1, Census Tract 1520, Sonoma County, California",0,0,0
1000000US060971520001046,060971520001046,"Block 1046, Block Group 1, Census Tract 1520, Sonoma County, California",0,0,0
1000000US060971520001047,060971520001047,"Block 1047, Block Group 1, Census Tract 1520, Sonoma County, California",0,0,0
1000000US060971520001048,060971520001048,"Block 1048, Block Group 1, Census Tract 1520, Sonoma County, California",0,0,0
1000000US060971520001049,060971520001049,"Block 1049, Block Group 1, Census Tract 1520, Sonoma County, California",0,0,0
1000000US060971520001050,060971520001050,"Block 1050, Block Group 1, Census Tract 1520, Sonoma County, California",0,0,0
1000000US060971520001051,060971520001051,"Block 1051, Block Group 1, Census Tract 1520, Sonoma County, California",0,0,0
1000000US060971520001052,060971520001052,"Block 1052, Block Group 1, Census Tract 1520, Sonoma County, California",0,0,0
1000000US060971520001053,060971520001053,"Block 1053, Block Group 1, Census Tract 1520, Sonoma County, California",0,0,0
1000000US060971520001054,060971520001054,"Block 1054, Block Group 1, Census Tract 1520, Sonoma County, California",0,0,0
1000000US060971520001055,060971520001055,"Block 1055, Block Group 1, Census Tract 1520, Sonoma County, California",0,0,0
1000000US060971520001056,060971520001056,"Block 1056, Block Group 1, Census Tract 1520, Sonoma County, California",0,0,0
1000000US060971520002000,060971520002000,"Block 2000, Block Group 2, Census Tract 1520, Sonoma County, California",28,25,3
1000000US060971520002001,060971520002001,"Block 2001, Block Group 2, Census Tract 1520, Sonoma County, California",0,0,0
1000000US060971520002002,060971520002002,"Block 2002, Block Group 2, Census Tract 1520, Sonoma County, California",1,1,0
1000000US060971520002003,060971520002003,"Block 2003, Block Group 2, Census Tract 1520, Sonoma County, California",19,18,1
1000000US060971520002004,060971520002004,"Block 2004, Block Group 2, Census Tract 1520, Sonoma County, California",2,2,0
1000000US060971520002005,060971520002005,"Block 2005, Block Group 2, Census Tract 1520, Sonoma County, California",1,1,0
1000000US060971520002006,060971520002006,"Block 2006, Block Group 2, Census Tract 1520, Sonoma County, California",9,9,0
1000000US060971520002007,060971520002007,"Block 2007, Block Group 2, Census Tract 1520, Sonoma County, California",23,20,3
1000000US060971520002008,060971520002008,"Block 2008, Block Group 2, Census Tract 1520, Sonoma County, California",17,15,2
1000000US060971520002009,060971520002009,"Block 2009, Block Group 2, Census Tract 1520, Sonoma County, California",16,15,1
1000000US060971520002010,060971520002010,"Block 2010, Block Group 2, Census Tract 1520, Sonoma County, California",16,16,0
1000000US060971520002011,060971520002011,"Block 2011, Block Group 2, Census Tract 1520, Sonoma County, California",13,10,3
1000000US060971520002012,060971520002012,"Block 2012, Block Group 2, Census Tract 1520, Sonoma County, California",18,16,2
1000000US060971520002013,060971520002013,"Block 2013, Block Group 2, Census Tract 1520, Sonoma County, California",49,46,3
1000000US060971520002014,060971520002014,"Block 2014, Block Group 2, Census Tract 1520, Sonoma County, California",67,64,3
1000000US060971520002015,060971520002015,"Block 2015, Block Group 2, Census Tract 1520, Sonoma County, California",0,0,0
1000000US060971520002016,060971520002016,"Block 2016, Block Group 2, Census Tract 1520, Sonoma County, California",3,3,0
1000000US060971520002017,060971520002017,"Block 2017, Block Group 2, Census Tract 1520, Sonoma County, California",1,0,1
1000000US060971520002018,060971520002018,"Block 2018, Block Group 2, Census Tract 1520, Sonoma County, California",6,6,0
1000000US060971520002019,060971520002019,"Block 2019, Block Group 2, Census Tract 1520, Sonoma County, California",19,19,0
1000000US060971520002020,060971520002020,"Block 2020, Block Group 2, Census Tract 1520, Sonoma County, California",155,150,5
1000000US060971520002021,060971520002021,"Block 2021, Block Group 2, Census Tract 1520, Sonoma County, California",10,10,0
1000000US060971521001000,060971521001000,"Block 1000, Block Group 1, Census Tract 1521, Sonoma County, California",24,24,0
1000000US060971521001001,060971521001001,"Block 1001, Block Group 1, Census Tract 1521, Sonoma County, California",24,19,5
1000000US060971521001002,060971521001002,"Block 1002, Block Group 1, Census Tract 1521, Sonoma County, California",14,13,1
1000000US060971521001003,060971521001003,"Block 1003, Block Group 1, Census Tract 1521, Sonoma County, California",15,13,2
1000000US060971521001004,060971521001004,"Block 1004, Block Group 1, Census Tract 1521, Sonoma County, California",18,11,7
1000000US060971521001005,060971521001005,"Block 1005, Block Group 1, Census Tract 1521, Sonoma County, California",26,20,6
1000000US060971521001006,060971521001006,"Block 1006, Block Group 1, Census Tract 1521, Sonoma County, California",3,3,0
1000000US060971521001007,060971521001007,"Block 1007, Block Group 1, Census Tract 1521, Sonoma County, California",24,19,5
1000000US060971521001008,060971521001008,"Block 1008, Block Group 1, Census Tract 1521, Sonoma County, California",8,7,1
1000000US060971521001009,060971521001009,"Block 1009, Block Group 1, Census Tract 1521, Sonoma County, California",0,0,0
1000000US060971521001010,060971521001010,"Block 1010, Block Group 1, Census Tract 1521, Sonoma County, California",0,0,0
1000000US060971521001011,060971521001011,"Block 1011, Block Group 1, Census Tract 1521, Sonoma County, California",0,0,0
1000000US060971521001012,060971521001012,"Block 1012, Block Group 1, Census Tract 1521, Sonoma County, California",81,59,22
1000000US060971521001013,060971521001013,"Block 1013, Block Group 1, Census Tract 1521, Sonoma County, California",0,0,0
1000000US060971521001014,060971521001014,"Block 1014, Block Group 1, Census Tract 1521, Sonoma County, California",0,0,0
1000000US060971521001015,060971521001015,"Block 1015, Block Group 1, Census Tract 1521, Sonoma County, California",0,0,0
1000000US060971521001016,060971521001016,"Block 1016, Block Group 1, Census Tract 1521, Sonoma County, California",0,0,0
1000000US060971521001017,060971521001017,"Block 1017, Block Group 1, Census Tract 1521, Sonoma County, California",0,0,0
1000000US060971521001018,060971521001018,"Block 1018, Block Group 1, Census Tract 1521, Sonoma County, California",1,1,0
1000000US060971521001019,060971521001019,"Block 1019, Block Group 1, Census Tract 1521, Sonoma County, California",0,0,0
1000000US060971521001020,060971521001020,"Block 1020, Block Group 1, Census Tract 1521, Sonoma County, California",0,0,0
1000000US060971521001021,060971521001021,"Block 1021, Block Group 1, Census Tract 1521, Sonoma County, California",1,1,0
1000000US060971521001022,060971521001022,"Block 1022, Block Group 1, Census Tract 1521, Sonoma County, California",11,10,1
1000000US060971521001023,060971521001023,"Block 1023, Block Group 1, Census Tract 1521, Sonoma County, California",0,0,0
1000000US060971521001024,060971521001024,"Block 1024, Block Group 1, Census Tract 1521, Sonoma County, California",0,0,0
1000000US060971521001025,060971521001025,"Block 1025, Block Group 1, Census Tract 1521, Sonoma County, California",0,0,0
1000000US060971521001026,060971521001026,"Block 1026, Block Group 1, Census Tract 1521, Sonoma County, California",0,0,0
1000000US060971521001027,060971521001027,"Block 1027, Block Group 1, Census Tract 1521, Sonoma County, California",0,0,0
1000000US060971521001028,060971521001028,"Block 1028, Block Group 1, Census Tract 1521, Sonoma County, California",0,0,0
1000000US060971521001029,060971521001029,"Block 1029, Block Group 1, Census Tract 1521, Sonoma County, California",0,0,0
1000000US060971521001030,060971521001030,"Block 1030, Block Group 1, Census Tract 1521, Sonoma County, California",0,0,0
1000000US060971521001031,060971521001031,"Block 1031, Block Group 1, Census Tract 1521, Sonoma County, California",6,6,0
1000000US060971521001032,060971521001032,"Block 1032, Block Group 1, Census Tract 1521, Sonoma County, California",10,9,1
1000000US060971521001033,060971521001033,"Block 1033, Block Group 1, Census Tract 1521, Sonoma County, California",36,36,0
1000000US060971521001034,060971521001034,"Block 1034, Block Group 1, Census Tract 1521, Sonoma County, California",16,14,2
1000000US060971521001035,060971521001035,"Block 1035, Block Group 1, Census Tract 1521, Sonoma County, California",18,17,1
1000000US060971521001036,060971521001036,"Block 1036, Block Group 1, Census Tract 1521, Sonoma County, California",14,13,1
1000000US060971521001037,060971521001037,"Block 1037, Block Group 1, Census Tract 1521, Sonoma County, California",42,41,1
1000000US060971521001038,060971521001038,"Block 1038, Block Group 1, Census Tract 1521, Sonoma County, California",8,8,0
1000000US060971521001039,060971521001039,"Block 1039, Block Group 1, Census Tract 1521, Sonoma County, California",0,0,0
1000000US060971521001040,060971521001040,"Block 1040, Block Group 1, Census Tract 1521, Sonoma County, California",0,0,0
1000000US060971521002000,060971521002000,"Block 2000, Block Group 2, Census Tract 1521, Sonoma County, California",100,96,4
1000000US060971521002001,060971521002001,"Block 2001, Block Group 2, Census Tract 1521, Sonoma County, California",26,25,1
1000000US060971521002002,060971521002002,"Block 2002, Block Group 2, Census Tract 1521, Sonoma County, California",11,9,2
1000000US060971521002003,060971521002003,"Block 2003, Block Group 2, Census Tract 1521, Sonoma County, California",43,42,1
1000000US060971521002004,060971521002004,"Block 2004, Block Group 2, Census Tract 1521, Sonoma County, California",22,20,2
1000000US060971521002005,060971521002005,"Block 2005, Block Group 2, Census Tract 1521, Sonoma County, California",10,10,0
1000000US060971521002006,060971521002006,"Block 2006, Block Group 2, Census Tract 1521, Sonoma County, California",0,0,0
1000000US060971521002007,060971521002007,"Block 2007, Block Group 2, Census Tract 1521, Sonoma County, California",10,10,0
1000000US060971521002008,060971521002008,"Block 2008, Block Group 2, Census Tract 1521, Sonoma County, California",0,0,0
1000000US060971521002009,060971521002009,"Block 2009, Block Group 2, Census Tract 1521, Sonoma County, California",0,0,0
1000000US060971521002010,060971521002010,"Block 2010, Block Group 2, Census Tract 1521, Sonoma County, California",0,0,0
1000000US060971521002011,060971521002011,"Block 2011, Block Group 2, Census Tract 1521, Sonoma County, California",0,0,0
1000000US060971521002012,060971521002012,"Block 2012, Block Group 2, Census Tract 1521, Sonoma County, California",20,20,0
1000000US060971521002013,060971521002013,"Block 2013, Block Group 2, Census Tract 1521, Sonoma County, California",0,0,0
1000000US060971521002014,060971521002014,"Block 2014, Block Group 2, Census Tract 1521, Sonoma County, California",0,0,0
1000000US060971521002015,060971521002015,"Block 2015, Block Group 2, Census Tract 1521, Sonoma County, California",0,0,0
1000000US060971521002016,060971521002016,"Block 2016, Block Group 2, Census Tract 1521, Sonoma County, California",1,1,0
1000000US060971521002017,060971521002017,"Block 2017, Block Group 2, Census Tract 1521, Sonoma County, California",7,6,1
1000000US060971521002018,060971521002018,"Block 2018, Block Group 2, Census Tract 1521, Sonoma County, California",20,17,3
1000000US060971521002019,060971521002019,"Block 2019, Block Group 2, Census Tract 1521, Sonoma County, California",17,15,2
1000000US060971521002020,060971521002020,"Block 2020, Block Group 2, Census Tract 1521, Sonoma County, California",16,15,1
1000000US060971521002021,060971521002021,"Block 2021, Block Group 2, Census Tract 1521, Sonoma County, California",9,9,0
1000000US060971521002022,060971521002022,"Block 2022, Block Group 2, Census Tract 1521, Sonoma County, California",0,0,0
1000000US060971521002023,060971521002023,"Block 2023, Block Group 2, Census Tract 1521, Sonoma County, California",0,0,0
1000000US060971521003000,060971521003000,"Block 3000, Block Group 3, Census Tract 1521, Sonoma County, California",68,64,4
1000000US060971521003001,060971521003001,"Block 3001, Block Group 3, Census Tract 1521, Sonoma County, California",53,50,3
1000000US060971521003002,060971521003002,"Block 3002, Block Group 3, Census Tract 1521, Sonoma County, California",52,51,1
1000000US060971521003003,060971521003003,"Block 3003, Block Group 3, Census Tract 1521, Sonoma County, California",55,50,5
1000000US060971521003004,060971521003004,"Block 3004, Block Group 3, Census Tract 1521, Sonoma County, California",43,41,2
1000000US060971521003005,060971521003005,"Block 3005, Block Group 3, Census Tract 1521, Sonoma County, California",44,41,3
1000000US060971521003006,060971521003006,"Block 3006, Block Group 3, Census Tract 1521, Sonoma County, California",31,31,0
1000000US060971521003007,060971521003007,"Block 3007, Block Group 3, Census Tract 1521, Sonoma County, California",37,33,4
1000000US060971521003008,060971521003008,"Block 3008, Block Group 3, Census Tract 1521, Sonoma County, California",21,21,0
1000000US060971522011000,060971522011000,"Block 1000, Block Group 1, Census Tract 1522.01, Sonoma County, California",0,0,0
1000000US060971522011001,060971522011001,"Block 1001, Block Group 1, Census Tract 1522.01, Sonoma County, California",18,17,1
1000000US060971522011002,060971522011002,"Block 1002, Block Group 1, Census Tract 1522.01, Sonoma County, California",13,12,1
1000000US060971522011003,060971522011003,"Block 1003, Block Group 1, Census Tract 1522.01, Sonoma County, California",83,76,7
1000000US060971522011004,060971522011004,"Block 1004, Block Group 1, Census Tract 1522.01, Sonoma County, California",6,6,0
1000000US060971522011005,060971522011005,"Block 1005, Block Group 1, Census Tract 1522.01, Sonoma County, California",18,18,0
1000000US060971522011006,060971522011006,"Block 1006, Block Group 1, Census Tract 1522.01, Sonoma County, California",16,16,0
1000000US060971522011007,060971522011007,"Block 1007, Block Group 1, Census Tract 1522.01, Sonoma County, California",9,9,0
1000000US060971522011008,060971522011008,"Block 1008, Block Group 1, Census Tract 1522.01, Sonoma County, California",16,16,0
1000000US060971522011009,060971522011009,"Block 1009, Block Group 1, Census Tract 1522.01, Sonoma County, California",25,24,1
1000000US060971522011010,060971522011010,"Block 1010, Block Group 1, Census Tract 1522.01, Sonoma County, California",37,36,1
1000000US060971522011011,060971522011011,"Block 1011, Block Group 1, Census Tract 1522.01, Sonoma County, California",40,39,1
1000000US060971522011012,060971522011012,"Block 1012, Block Group 1, Census Tract 1522.01, Sonoma County, California",64,63,1
1000000US060971522011013,060971522011013,"Block 1013, Block Group 1, Census Tract 1522.01, Sonoma County, California",11,11,0
1000000US060971522011014,060971522011014,"Block 1014, Block Group 1, Census Tract 1522.01, Sonoma County, California",68,63,5
1000000US060971522011015,060971522011015,"Block 1015, Block Group 1, Census Tract 1522.01, Sonoma County, California",17,17,0
1000000US060971522012000,060971522012000,"Block 2000, Block Group 2, Census Tract 1522.01, Sonoma County, California",17,17,0
1000000US060971522012001,060971522012001,"Block 2001, Block Group 2, Census Tract 1522.01, Sonoma County, California",17,17,0
1000000US060971522012002,060971522012002,"Block 2002, Block Group 2, Census Tract 1522.01, Sonoma County, California",19,18,1
1000000US060971522012003,060971522012003,"Block 2003, Block Group 2, Census Tract 1522.01, Sonoma County, California",27,23,4
1000000US060971522012004,060971522012004,"Block 2004, Block Group 2, Census Tract 1522.01, Sonoma County, California",28,25,3
1000000US060971522012005,060971522012005,"Block 2005, Block Group 2, Census Tract 1522.01, Sonoma County, California",15,14,1
1000000US060971522012006,060971522012006,"Block 2006, Block Group 2, Census Tract 1522.01, Sonoma County, California",34,34,0
1000000US060971522012007,060971522012007,"Block 2007, Block Group 2, Census Tract 1522.01, Sonoma County, California",34,31,3
1000000US060971522012008,060971522012008,"Block 2008, Block Group 2, Census Tract 1522.01, Sonoma County, California",62,57,5
1000000US060971522012009,060971522012009,"Block 2009, Block Group 2, Census Tract 1522.01, Sonoma County, California",35,35,0
1000000US060971522012010,060971522012010,"Block 2010, Block Group 2, Census Tract 1522.01, Sonoma County, California",18,16,2
1000000US060971522012011,060971522012011,"Block 2011, Block Group 2, Census Tract 1522.01, Sonoma County, California",39,38,1
1000000US060971522012012,060971522012012,"Block 2012, Block Group 2, Census Tract 1522.01, Sonoma County, California",41,40,1
1000000US060971522012013,060971522012013,"Block 2013, Block Group 2, Census Tract 1522.01, Sonoma County, California",27,27,0
1000000US060971522012014,060971522012014,"Block 2014, Block Group 2, Census Tract 1522.01, Sonoma County, California",44,43,1
1000000US060971522012015,060971522012015,"Block 2015, Block Group 2, Census Tract 1522.01, Sonoma County, California",9,9,0
1000000US060971522012016,060971522012016,"Block 2016, Block Group 2, Census Tract 1522.01, Sonoma County, California",20,18,2
1000000US060971522013000,060971522013000,"Block 3000, Block Group 3, Census Tract 1522.01, Sonoma County, California",11,10,1
1000000US060971522013001,060971522013001,"Block 3001, Block Group 3, Census Tract 1522.01, Sonoma County, California",29,26,3
1000000US060971522013002,060971522013002,"Block 3002, Block Group 3, Census Tract 1522.01, Sonoma County, California",31,29,2
1000000US060971522013003,060971522013003,"Block 3003, Block Group 3, Census Tract 1522.01, Sonoma County, California",40,37,3
1000000US060971522013004,060971522013004,"Block 3004, Block Group 3, Census Tract 1522.01, Sonoma County, California",14,14,0
1000000US060971522013005,060971522013005,"Block 3005, Block Group 3, Census Tract 1522.01, Sonoma County, California",8,8,0
1000000US060971522013006,060971522013006,"Block 3006, Block Group 3, Census Tract 1522.01, Sonoma County, California",16,16,0
1000000US060971522013007,060971522013007,"Block 3007, Block Group 3, Census Tract 1522.01, Sonoma County, California",10,10,0
1000000US060971522013008,060971522013008,"Block 3008, Block Group 3, Census Tract 1522.01, Sonoma County, California",188,177,11
1000000US060971522013009,060971522013009,"Block 3009, Block Group 3, Census Tract 1522.01, Sonoma County, California",25,23,2
1000000US060971522013010,060971522013010,"Block 3010, Block Group 3, Census Tract 1522.01, Sonoma County, California",25,24,1
1000000US060971522013011,060971522013011,"Block 3011, Block Group 3, Census Tract 1522.01, Sonoma County, California",24,24,0
1000000US060971522013012,060971522013012,"Block 3012, Block Group 3, Census Tract 1522.01, Sonoma County, California",17,17,0
1000000US060971522013013,060971522013013,"Block 3013, Block Group 3, Census Tract 1522.01, Sonoma County, California",10,10,0
1000000US060971522013014,060971522013014,"Block 3014, Block Group 3, Census Tract 1522.01, Sonoma County, California",24,24,0
1000000US060971522013015,060971522013015,"Block 3015, Block Group 3, Census Tract 1522.01, Sonoma County, California",31,31,0
1000000US060971522014000,060971522014000,"Block 4000, Block Group 4, Census Tract 1522.01, Sonoma County, California",46,45,1
1000000US060971522014001,060971522014001,"Block 4001, Block Group 4, Census Tract 1522.01, Sonoma County, California",55,53,2
1000000US060971522014002,060971522014002,"Block 4002, Block Group 4, Census Tract 1522.01, Sonoma County, California",126,121,5
1000000US060971522014003,060971522014003,"Block 4003, Block Group 4, Census Tract 1522.01, Sonoma County, California",93,87,6
1000000US060971522014004,060971522014004,"Block 4004, Block Group 4, Census Tract 1522.01, Sonoma County, California",35,31,4
1000000US060971522014005,060971522014005,"Block 4005, Block Group 4, Census Tract 1522.01, Sonoma County, California",17,14,3
1000000US060971522014006,060971522014006,"Block 4006, Block Group 4, Census Tract 1522.01, Sonoma County, California",13,12,1
1000000US060971522021000,060971522021000,"Block 1000, Block Group 1, Census Tract 1522.02, Sonoma County, California",0,0,0
1000000US060971522021001,060971522021001,"Block 1001, Block Group 1, Census Tract 1522.02, Sonoma County, California",7,7,0
1000000US060971522021002,060971522021002,"Block 1002, Block Group 1, Census Tract 1522.02, Sonoma County, California",0,0,0
1000000US060971522021003,060971522021003,"Block 1003, Block Group 1, Census Tract 1522.02, Sonoma County, California",75,71,4
1000000US060971522021004,060971522021004,"Block 1004, Block Group 1, Census Tract 1522.02, Sonoma County, California",3,3,0
1000000US060971522021005,060971522021005,"Block 1005, Block Group 1, Census Tract 1522.02, Sonoma County, California",0,0,0
1000000US060971522021006,060971522021006,"Block 1006, Block Group 1, Census Tract 1522.02, Sonoma County, California",35,35,0
1000000US060971522021007,060971522021007,"Block 1007, Block Group 1, Census Tract 1522.02, Sonoma County, California",25,24,1
1000000US060971522021008,060971522021008,"Block 1008, Block Group 1, Census Tract 1522.02, Sonoma County, California",41,39,2
1000000US060971522021009,060971522021009,"Block 1009, Block Group 1, Census Tract 1522.02, Sonoma County, California",21,21,0
1000000US060971522021010,060971522021010,"Block 1010, Block Group 1, Census Tract 1522.02, Sonoma County, California",11,10,1
1000000US060971522021011,060971522021011,"Block 1011, Block Group 1, Census Tract 1522.02, Sonoma County, California",3,3,0
1000000US060971522021012,060971522021012,"Block 1012, Block Group 1, Census Tract 1522.02, Sonoma County, California",38,36,2
1000000US060971522021013,060971522021013,"Block 1013, Block Group 1, Census Tract 1522.02, Sonoma County, California",17,17,0
1000000US060971522021014,060971522021014,"Block 1014, Block Group 1, Census Tract 1522.02, Sonoma County, California",5,5,0
1000000US060971522021015,060971522021015,"Block 1015, Block Group 1, Census Tract 1522.02, Sonoma County, California",2,1,1
1000000US060971522021016,060971522021016,"Block 1016, Block Group 1, Census Tract 1522.02, Sonoma County, California",28,27,1
1000000US060971522022000,060971522022000,"Block 2000, Block Group 2, Census Tract 1522.02, Sonoma County, California",39,38,1
1000000US060971522022001,060971522022001,"Block 2001, Block Group 2, Census Tract 1522.02, Sonoma County, California",140,134,6
1000000US060971522022002,060971522022002,"Block 2002, Block Group 2, Census Tract 1522.02, Sonoma County, California",20,18,2
1000000US060971522022003,060971522022003,"Block 2003, Block Group 2, Census Tract 1522.02, Sonoma County, California",32,32,0
1000000US060971522022004,060971522022004,"Block 2004, Block Group 2, Census Tract 1522.02, Sonoma County, California",0,0,0
1000000US060971522022005,060971522022005,"Block 2005, Block Group 2, Census Tract 1522.02, Sonoma County, California",11,11,0
1000000US060971522022006,060971522022006,"Block 2006, Block Group 2, Census Tract 1522.02, Sonoma County, California",0,0,0
1000000US060971522022007,060971522022007,"Block 2007, Block Group 2, Census Tract 1522.02, Sonoma County, California",19,19,0
1000000US060971522022008,060971522022008,"Block 2008, Block Group 2, Census Tract 1522.02, Sonoma County, California",4,4,0
1000000US060971522022009,060971522022009,"Block 2009, Block Group 2, Census Tract 1522.02, Sonoma County, California",235,216,19
1000000US060971522022010,060971522022010,"Block 2010, Block Group 2, Census Tract 1522.02, Sonoma County, California",16,14,2
1000000US060971522022011,060971522022011,"Block 2011, Block Group 2, Census Tract 1522.02, Sonoma County, California",4,4,0
1000000US060971522022012,060971522022012,"Block 2012, Block Group 2, Census Tract 1522.02, Sonoma County, California",7,7,0
1000000US060971522022013,060971522022013,"Block 2013, Block Group 2, Census Tract 1522.02, Sonoma County, California",76,69,7
1000000US060971522022014,060971522022014,"Block 2014, Block Group 2, Census Tract 1522.02, Sonoma County, California",78,76,2
1000000US060971522022015,060971522022015,"Block 2015, Block Group 2, Census Tract 1522.02, Sonoma County, California",38,33,5
1000000US060971522022016,060971522022016,"Block 2016, Block Group 2, Census Tract 1522.02, Sonoma County, California",14,14,0
1000000US060971522022017,060971522022017,"Block 2017, Block Group 2, Census Tract 1522.02, Sonoma County, California",25,24,1
1000000US060971522022018,060971522022018,"Block 2018, Block Group 2, Census Tract 1522.02, Sonoma County, California",236,218,18
1000000US060971522022019,060971522022019,"Block 2019, Block Group 2, Census Tract 1522.02, Sonoma County, California",62,58,4
1000000US060971522022020,060971522022020,"Block 2020, Block Group 2, Census Tract 1522.02, Sonoma County, California",0,0,0
1000000US060971522022021,060971522022021,"Block 2021, Block Group 2, Census Tract 1522.02, Sonoma County, California",0,0,0
1000000US060971522022022,060971522022022,"Block 2022, Block Group 2, Census Tract 1522.02, Sonoma County, California",6,4,2
1000000US060971522022023,060971522022023,"Block 2023, Block Group 2, Census Tract 1522.02, Sonoma County, California",0,0,0
1000000US060971522022024,060971522022024,"Block 2024, Block Group 2, Census Tract 1522.02, Sonoma County, California",17,14,3
1000000US060971522023000,060971522023000,"Block 3000, Block Group 3, Census Tract 1522.02, Sonoma County, California",0,0,0
1000000US060971522023001,060971522023001,"Block 3001, Block Group 3, Census Tract 1522.02, Sonoma County, California",148,141,7
1000000US060971522023002,060971522023002,"Block 3002, Block Group 3, Census Tract 1522.02, Sonoma County, California",20,19,1
1000000US060971522023003,060971522023003,"Block 3003, Block Group 3, Census Tract 1522.02, Sonoma County, California",17,17,0
1000000US060971522023004,060971522023004,"Block 3004, Block Group 3, Census Tract 1522.02, Sonoma County, California",9,8,1
1000000US060971522023005,060971522023005,"Block 3005, Block Group 3, Census Tract 1522.02, Sonoma County, California",134,129,5
1000000US060971522023006,060971522023006,"Block 3006, Block Group 3, Census Tract 1522.02, Sonoma County, California",21,21,0
1000000US060971522023007,060971522023007,"Block 3007, Block Group 3, Census Tract 1522.02, Sonoma County, California",83,80,3
1000000US060971522023008,060971522023008,"Block 3008, Block Group 3, Census Tract 1522.02, Sonoma County, California",40,37,3
1000000US060971522023009,060971522023009,"Block 3009, Block Group 3, Census Tract 1522.02, Sonoma County, California",0,0,0
1000000US060971522023010,060971522023010,"Block 3010, Block Group 3, Census Tract 1522.02, Sonoma County, California",21,21,0
1000000US060971522023011,060971522023011,"Block 3011, Block Group 3, Census Tract 1522.02, Sonoma County, California",14,13,1
1000000US060971522023012,060971522023012,"Block 3012, Block Group 3, Census Tract 1522.02, Sonoma County, California",50,48,2
1000000US060971522023013,060971522023013,"Block 3013, Block Group 3, Census Tract 1522.02, Sonoma County, California",13,12,1
1000000US060971522024000,060971522024000,"Block 4000, Block Group 4, Census Tract 1522.02, Sonoma County, California",11,9,2
1000000US060971522024001,060971522024001,"Block 4001, Block Group 4, Census Tract 1522.02, Sonoma County, California",1,1,0
1000000US060971522024002,060971522024002,"Block 4002, Block Group 4, Census Tract 1522.02, Sonoma County, California",7,7,0
1000000US060971522024003,060971522024003,"Block 4003, Block Group 4, Census Tract 1522.02, Sonoma County, California",3,3,0
1000000US060971522024004,060971522024004,"Block 4004, Block Group 4, Census Tract 1522.02, Sonoma County, California",14,13,1
1000000US060971522024005,060971522024005,"Block 4005, Block Group 4, Census Tract 1522.02, Sonoma County, California",0,0,0
1000000US060971522024006,060971522024006,"Block 4006, Block Group 4, Census Tract 1522.02, Sonoma County, California",197,182,15
1000000US060971522024007,060971522024007,"Block 4007, Block Group 4, Census Tract 1522.02, Sonoma County, California",0,0,0
1000000US060971522024008,060971522024008,"Block 4008, Block Group 4, Census Tract 1522.02, Sonoma County, California",31,30,1
1000000US060971522024009,060971522024009,"Block 4009, Block Group 4, Census Tract 1522.02, Sonoma County, California",65,62,3
1000000US060971522024010,060971522024010,"Block 4010, Block Group 4, Census Tract 1522.02, Sonoma County, California",66,62,4
1000000US060971522024011,060971522024011,"Block 4011, Block Group 4, Census Tract 1522.02, Sonoma County, California",10,10,0
1000000US060971522024012,060971522024012,"Block 4012, Block Group 4, Census Tract 1522.02, Sonoma County, California",36,33,3
1000000US060971522024013,060971522024013,"Block 4013, Block Group 4, Census Tract 1522.02, Sonoma County, California",7,7,0
1000000US060971522024014,060971522024014,"Block 4014, Block Group 4, Census Tract 1522.02, Sonoma County, California",10,10,0
1000000US060971522024015,060971522024015,"Block 4015, Block Group 4, Census Tract 1522.02, Sonoma County, California",17,16,1
1000000US060971522024016,060971522024016,"Block 4016, Block Group 4, Census Tract 1522.02, Sonoma County, California",1,1,0
1000000US060971522025000,060971522025000,"Block 5000, Block Group 5, Census Tract 1522.02, Sonoma County, California",27,23,4
1000000US060971522025001,060971522025001,"Block 5001, Block Group 5, Census Tract 1522.02, Sonoma County, California",300,284,16
1000000US060971522025002,060971522025002,"Block 5002, Block Group 5, Census Tract 1522.02, Sonoma County, California",0,0,0
1000000US060971522025003,060971522025003,"Block 5003, Block Group 5, Census Tract 1522.02, Sonoma County, California",0,0,0
1000000US060971522025004,060971522025004,"Block 5004, Block Group 5, Census Tract 1522.02, Sonoma County, California",16,16,0
1000000US060971522025005,060971522025005,"Block 5005, Block Group 5, Census Tract 1522.02, Sonoma County, California",0,0,0
1000000US060971522025006,060971522025006,"Block 5006, Block Group 5, Census Tract 1522.02, Sonoma County, California",57,54,3
1000000US060971522025007,060971522025007,"Block 5007, Block Group 5, Census Tract 1522.02, Sonoma County, California",2,1,1
1000000US060971522025008,060971522025008,"Block 5008, Block Group 5, Census Tract 1522.02, Sonoma County, California",15,13,2
1000000US060971522025009,060971522025009,"Block 5009, Block Group 5, Census Tract 1522.02, Sonoma County, California",18,15,3
1000000US060971522025010,060971522025010,"Block 5010, Block Group 5, Census Tract 1522.02, Sonoma County, California",12,11,1
1000000US060971522025011,060971522025011,"Block 5011, Block Group 5, Census Tract 1522.02, Sonoma County, California",0,0,0
1000000US060971522025012,060971522025012,"Block 5012, Block Group 5, Census Tract 1522.02, Sonoma County, California",1,1,0
1000000US060971522025013,060971522025013,"Block 5013, Block Group 5, Census Tract 1522.02, Sonoma County, California",10,9,1
1000000US060971522025014,060971522025014,"Block 5014, Block Group 5, Census Tract 1522.02, Sonoma County, California",58,49,9
1000000US060971522025015,060971522025015,"Block 5015, Block Group 5, Census Tract 1522.02, Sonoma County, California",84,83,1
1000000US060971522025016,060971522025016,"Block 5016, Block Group 5, Census Tract 1522.02, Sonoma County, California",3,1,2
1000000US060971522025017,060971522025017,"Block 5017, Block Group 5, Census Tract 1522.02, Sonoma County, California",0,0,0
1000000US060971522025018,060971522025018,"Block 5018, Block Group 5, Census Tract 1522.02, Sonoma County, California",0,0,0
1000000US060971522025019,060971522025019,"Block 5019, Block Group 5, Census Tract 1522.02, Sonoma County, California",13,12,1
1000000US060971522031000,060971522031000,"Block 1000, Block Group 1, Census Tract 1522.03, Sonoma County, California",9,8,1
1000000US060971522031001,060971522031001,"Block 1001, Block Group 1, Census Tract 1522.03, Sonoma County, California",0,0,0
1000000US060971522031002,060971522031002,"Block 1002, Block Group 1, Census Tract 1522.03, Sonoma County, California",9,9,0
1000000US060971522031003,060971522031003,"Block 1003, Block Group 1, Census Tract 1522.03, Sonoma County, California",21,19,2
1000000US060971522031004,060971522031004,"Block 1004, Block Group 1, Census Tract 1522.03, Sonoma County, California",64,59,5
1000000US060971522031005,060971522031005,"Block 1005, Block Group 1, Census Tract 1522.03, Sonoma County, California",61,58,3
1000000US060971522031006,060971522031006,"Block 1006, Block Group 1, Census Tract 1522.03, Sonoma County, California",10,10,0
1000000US060971522031007,060971522031007,"Block 1007, Block Group 1, Census Tract 1522.03, Sonoma County, California",8,7,1
1000000US060971522031008,060971522031008,"Block 1008, Block Group 1, Census Tract 1522.03, Sonoma County, California",19,19,0
1000000US060971522031009,060971522031009,"Block 1009, Block Group 1, Census Tract 1522.03, Sonoma County, California",11,11,0
1000000US060971522031010,060971522031010,"Block 1010, Block Group 1, Census Tract 1522.03, Sonoma County, California",13,13,0
1000000US060971522031011,060971522031011,"Block 1011, Block Group 1, Census Tract 1522.03, Sonoma County, California",13,12,1
1000000US060971522031012,060971522031012,"Block 1012, Block Group 1, Census Tract 1522.03, Sonoma County, California",0,0,0
1000000US060971522031013,060971522031013,"Block 1013, Block Group 1, Census Tract 1522.03, Sonoma County, California",5,5,0
1000000US060971522031014,060971522031014,"Block 1014, Block Group 1, Census Tract 1522.03, Sonoma County, California",8,8,0
1000000US060971522031015,060971522031015,"Block 1015, Block Group 1, Census Tract 1522.03, Sonoma County, California",8,8,0
1000000US060971522031016,060971522031016,"Block 1016, Block Group 1, Census Tract 1522.03, Sonoma County, California",10,10,0
1000000US060971522031017,060971522031017,"Block 1017, Block Group 1, Census Tract 1522.03, Sonoma County, California",12,11,1
1000000US060971522031018,060971522031018,"Block 1018, Block Group 1, Census Tract 1522.03, Sonoma County, California",16,16,0
1000000US060971522031019,060971522031019,"Block 1019, Block Group 1, Census Tract 1522.03, Sonoma County, California",18,17,1
1000000US060971522031020,060971522031020,"Block 1020, Block Group 1, Census Tract 1522.03, Sonoma County, California",14,13,1
1000000US060971522031021,060971522031021,"Block 1021, Block Group 1, Census Tract 1522.03, Sonoma County, California",11,11,0
1000000US060971522031022,060971522031022,"Block 1022, Block Group 1, Census Tract 1522.03, Sonoma County, California",16,16,0
1000000US060971522031023,060971522031023,"Block 1023, Block Group 1, Census Tract 1522.03, Sonoma County, California",10,10,0
1000000US060971522031024,060971522031024,"Block 1024, Block Group 1, Census Tract 1522.03, Sonoma County, California",9,9,0
1000000US060971522032000,060971522032000,"Block 2000, Block Group 2, Census Tract 1522.03, Sonoma County, California",33,32,1
1000000US060971522032001,060971522032001,"Block 2001, Block Group 2, Census Tract 1522.03, Sonoma County, California",32,32,0
1000000US060971522032002,060971522032002,"Block 2002, Block Group 2, Census Tract 1522.03, Sonoma County, California",49,48,1
1000000US060971522032003,060971522032003,"Block 2003, Block Group 2, Census Tract 1522.03, Sonoma County, California",18,17,1
1000000US060971522032004,060971522032004,"Block 2004, Block Group 2, Census Tract 1522.03, Sonoma County, California",22,20,2
1000000US060971522032005,060971522032005,"Block 2005, Block Group 2, Census Tract 1522.03, Sonoma County, California",21,20,1
1000000US060971522032006,060971522032006,"Block 2006, Block Group 2, Census Tract 1522.03, Sonoma County, California",20,20,0
1000000US060971522032007,060971522032007,"Block 2007, Block Group 2, Census Tract 1522.03, Sonoma County, California",20,20,0
1000000US060971522032008,060971522032008,"Block 2008, Block Group 2, Census Tract 1522.03, Sonoma County, California",14,14,0
1000000US060971522032009,060971522032009,"Block 2009, Block Group 2, Census Tract 1522.03, Sonoma County, California",19,19,0
1000000US060971522032010,060971522032010,"Block 2010, Block Group 2, Census Tract 1522.03, Sonoma County, California",18,18,0
1000000US060971522032011,060971522032011,"Block 2011, Block Group 2, Census Tract 1522.03, Sonoma County, California",18,18,0
1000000US060971522032012,060971522032012,"Block 2012, Block Group 2, Census Tract 1522.03, Sonoma County, California",24,23,1
1000000US060971522032013,060971522032013,"Block 2013, Block Group 2, Census Tract 1522.03, Sonoma County, California",21,19,2
1000000US060971522032014,060971522032014,"Block 2014, Block Group 2, Census Tract 1522.03, Sonoma County, California",19,17,2
1000000US060971522032015,060971522032015,"Block 2015, Block Group 2, Census Tract 1522.03, Sonoma County, California",12,12,0
1000000US060971522032016,060971522032016,"Block 2016, Block Group 2, Census Tract 1522.03, Sonoma County, California",18,17,1
1000000US060971522032017,060971522032017,"Block 2017, Block Group 2, Census Tract 1522.03, Sonoma County, California",43,38,5
1000000US060971522033000,060971522033000,"Block 3000, Block Group 3, Census Tract 1522.03, Sonoma County, California",15,14,1
1000000US060971522033001,060971522033001,"Block 3001, Block Group 3, Census Tract 1522.03, Sonoma County, California",4,4,0
1000000US060971522033002,060971522033002,"Block 3002, Block Group 3, Census Tract 1522.03, Sonoma County, California",24,24,0
1000000US060971522033003,060971522033003,"Block 3003, Block Group 3, Census Tract 1522.03, Sonoma County, California",2,2,0
1000000US060971522033004,060971522033004,"Block 3004, Block Group 3, Census Tract 1522.03, Sonoma County, California",19,17,2
1000000US060971522033005,060971522033005,"Block 3005, Block Group 3, Census Tract 1522.03, Sonoma County, California",11,11,0
1000000US060971522033006,060971522033006,"Block 3006, Block Group 3, Census Tract 1522.03, Sonoma County, California",12,11,1
1000000US060971522033007,060971522033007,"Block 3007, Block Group 3, Census Tract 1522.03, Sonoma County, California",9,8,1
1000000US060971522033008,060971522033008,"Block 3008, Block Group 3, Census Tract 1522.03, Sonoma County, California",9,9,0
1000000US060971522033009,060971522033009,"Block 3009, Block Group 3, Census Tract 1522.03, Sonoma County, California",2,1,1
1000000US060971522033010,060971522033010,"Block 3010, Block Group 3, Census Tract 1522.03, Sonoma County, California",161,151,10
1000000US060971522033011,060971522033011,"Block 3011, Block Group 3, Census Tract 1522.03, Sonoma County, California",0,0,0
1000000US060971522033012,060971522033012,"Block 3012, Block Group 3, Census Tract 1522.03, Sonoma County, California",25,23,2
1000000US060971522033013,060971522033013,"Block 3013, Block Group 3, Census Tract 1522.03, Sonoma County, California",25,23,2
1000000US060971522033014,060971522033014,"Block 3014, Block Group 3, Census Tract 1522.03, Sonoma County, California",12,10,2
1000000US060971522033015,060971522033015,"Block 3015, Block Group 3, Census Tract 1522.03, Sonoma County, California",14,12,2
1000000US060971522033016,060971522033016,"Block 3016, Block Group 3, Census Tract 1522.03, Sonoma County, California",0,0,0
1000000US060971522033017,060971522033017,"Block 3017, Block Group 3, Census Tract 1522.03, Sonoma County, California",17,17,0
1000000US060971522033018,060971522033018,"Block 3018, Block Group 3, Census Tract 1522.03, Sonoma County, California",0,0,0
1000000US060971522033019,060971522033019,"Block 3019, Block Group 3, Census Tract 1522.03, Sonoma County, California",17,17,0
1000000US060971522033020,060971522033020,"Block 3020, Block Group 3, Census Tract 1522.03, Sonoma County, California",186,182,4
1000000US060971522034000,060971522034000,"Block 4000, Block Group 4, Census Tract 1522.03, Sonoma County, California",22,22,0
1000000US060971522034001,060971522034001,"Block 4001, Block Group 4, Census Tract 1522.03, Sonoma County, California",1,1,0
1000000US060971522034002,060971522034002,"Block 4002, Block Group 4, Census Tract 1522.03, Sonoma County, California",15,13,2
1000000US060971522034003,060971522034003,"Block 4003, Block Group 4, Census Tract 1522.03, Sonoma County, California",16,15,1
1000000US060971522034004,060971522034004,"Block 4004, Block Group 4, Census Tract 1522.03, Sonoma County, California",24,22,2
1000000US060971522034005,060971522034005,"Block 4005, Block Group 4, Census Tract 1522.03, Sonoma County, California",15,15,0
1000000US060971522034006,060971522034006,"Block 4006, Block Group 4, Census Tract 1522.03, Sonoma County, California",27,24,3
1000000US060971522034007,060971522034007,"Block 4007, Block Group 4, Census Tract 1522.03, Sonoma County, California",18,17,1
1000000US060971522034008,060971522034008,"Block 4008, Block Group 4, Census Tract 1522.03, Sonoma County, California",20,18,2
1000000US060971522034009,060971522034009,"Block 4009, Block Group 4, Census Tract 1522.03, Sonoma County, California",62,60,2
1000000US060971522034010,060971522034010,"Block 4010, Block Group 4, Census Tract 1522.03, Sonoma County, California",56,54,2
1000000US060971522034011,060971522034011,"Block 4011, Block Group 4, Census Tract 1522.03, Sonoma County, California",9,9,0
1000000US060971522034012,060971522034012,"Block 4012, Block Group 4, Census Tract 1522.03, Sonoma County, California",66,64,2
1000000US060971522034013,060971522034013,"Block 4013, Block Group 4, Census Tract 1522.03, Sonoma County, California",13,13,0
1000000US060971522034014,060971522034014,"Block 4014, Block Group 4, Census Tract 1522.03, Sonoma County, California",38,37,1
1000000US060971522034015,060971522034015,"Block 4015, Block Group 4, Census Tract 1522.03, Sonoma County, California",51,49,2
1000000US060971522034016,060971522034016,"Block 4016, Block Group 4, Census Tract 1522.03, Sonoma County, California",0,0,0
1000000US060971522034017,060971522034017,"Block 4017, Block Group 4, Census Tract 1522.03, Sonoma County, California",19,17,2
1000000US060971522034018,060971522034018,"Block 4018, Block Group 4, Census Tract 1522.03, Sonoma County, California",12,10,2
1000000US060971522034019,060971522034019,"Block 4019, Block Group 4, Census Tract 1522.03, Sonoma County, California",4,3,1
1000000US060971522034020,060971522034020,"Block 4020, Block Group 4, Census Tract 1522.03, Sonoma County, California",79,72,7
1000000US060971523001000,060971523001000,"Block 1000, Block Group 1, Census Tract 1523, Sonoma County, California",197,188,9
1000000US060971523001001,060971523001001,"Block 1001, Block Group 1, Census Tract 1523, Sonoma County, California",19,18,1
1000000US060971523001002,060971523001002,"Block 1002, Block Group 1, Census Tract 1523, Sonoma County, California",32,31,1
1000000US060971523001003,060971523001003,"Block 1003, Block Group 1, Census Tract 1523, Sonoma County, California",21,21,0
1000000US060971523001004,060971523001004,"Block 1004, Block Group 1, Census Tract 1523, Sonoma County, California",4,4,0
1000000US060971523001005,060971523001005,"Block 1005, Block Group 1, Census Tract 1523, Sonoma County, California",13,13,0
1000000US060971523001006,060971523001006,"Block 1006, Block Group 1, Census Tract 1523, Sonoma County, California",10,10,0
1000000US060971523001007,060971523001007,"Block 1007, Block Group 1, Census Tract 1523, Sonoma County, California",11,11,0
1000000US060971523001008,060971523001008,"Block 1008, Block Group 1, Census Tract 1523, Sonoma County, California",22,21,1
1000000US060971523001009,060971523001009,"Block 1009, Block Group 1, Census Tract 1523, Sonoma County, California",37,37,0
1000000US060971523001010,060971523001010,"Block 1010, Block Group 1, Census Tract 1523, Sonoma County, California",0,0,0
1000000US060971523001011,060971523001011,"Block 1011, Block Group 1, Census Tract 1523, Sonoma County, California",123,113,10
1000000US060971523001012,060971523001012,"Block 1012, Block Group 1, Census Tract 1523, Sonoma County, California",0,0,0
1000000US060971523001013,060971523001013,"Block 1013, Block Group 1, Census Tract 1523, Sonoma County, California",0,0,0
1000000US060971523001014,060971523001014,"Block 1014, Block Group 1, Census Tract 1523, Sonoma County, California",10,10,0
1000000US060971523001015,060971523001015,"Block 1015, Block Group 1, Census Tract 1523, Sonoma County, California",36,35,1
1000000US060971523001016,060971523001016,"Block 1016, Block Group 1, Census Tract 1523, Sonoma County, California",6,6,0
1000000US060971523001017,060971523001017,"Block 1017, Block Group 1, Census Tract 1523, Sonoma County, California",31,29,2
1000000US060971523001018,060971523001018,"Block 1018, Block Group 1, Census Tract 1523, Sonoma County, California",26,25,1
1000000US060971523001019,060971523001019,"Block 1019, Block Group 1, Census Tract 1523, Sonoma County, California",18,17,1
1000000US060971523002000,060971523002000,"Block 2000, Block Group 2, Census Tract 1523, Sonoma County, California",9,9,0
1000000US060971523002001,060971523002001,"Block 2001, Block Group 2, Census Tract 1523, Sonoma County, California",12,10,2
1000000US060971523002002,060971523002002,"Block 2002, Block Group 2, Census Tract 1523, Sonoma County, California",88,82,6
1000000US060971523002003,060971523002003,"Block 2003, Block Group 2, Census Tract 1523, Sonoma County, California",24,24,0
1000000US060971523002004,060971523002004,"Block 2004, Block Group 2, Census Tract 1523, Sonoma County, California",17,17,0
1000000US060971523002005,060971523002005,"Block 2005, Block Group 2, Census Tract 1523, Sonoma County, California",1,1,0
1000000US060971523002006,060971523002006,"Block 2006, Block Group 2, Census Tract 1523, Sonoma County, California",1,1,0
1000000US060971523002007,060971523002007,"Block 2007, Block Group 2, Census Tract 1523, Sonoma County, California",2,2,0
1000000US060971523002008,060971523002008,"Block 2008, Block Group 2, Census Tract 1523, Sonoma County, California",12,12,0
1000000US060971523002009,060971523002009,"Block 2009, Block Group 2, Census Tract 1523, Sonoma County, California",10,10,0
1000000US060971523002010,060971523002010,"Block 2010, Block Group 2, Census Tract 1523, Sonoma County, California",10,10,0
1000000US060971523002011,060971523002011,"Block 2011, Block Group 2, Census Tract 1523, Sonoma County, California",27,26,1
1000000US060971523002012,060971523002012,"Block 2012, Block Group 2, Census Tract 1523, Sonoma County, California",25,23,2
1000000US060971523002013,060971523002013,"Block 2013, Block Group 2, Census Tract 1523, Sonoma County, California",108,103,5
1000000US060971523002014,060971523002014,"Block 2014, Block Group 2, Census Tract 1523, Sonoma County, California",0,0,0
1000000US060971523002015,060971523002015,"Block 2015, Block Group 2, Census Tract 1523, Sonoma County, California",0,0,0
1000000US060971523002016,060971523002016,"Block 2016, Block Group 2, Census Tract 1523, Sonoma County, California",0,0,0
1000000US060971523002017,060971523002017,"Block 2017, Block Group 2, Census Tract 1523, Sonoma County, California",0,0,0
1000000US060971523002018,060971523002018,"Block 2018, Block Group 2, Census Tract 1523, Sonoma County, California",0,0,0
1000000US060971523002019,060971523002019,"Block 2019, Block Group 2, Census Tract 1523, Sonoma County, California",10,10,0
1000000US060971523002020,060971523002020,"Block 2020, Block Group 2, Census Tract 1523, Sonoma County, California",19,19,0
1000000US060971523002021,060971523002021,"Block 2021, Block Group 2, Census Tract 1523, Sonoma County, California",9,8,1
1000000US060971523002022,060971523002022,"Block 2022, Block Group 2, Census Tract 1523, Sonoma County, California",3,3,0
1000000US060971523002023,060971523002023,"Block 2023, Block Group 2, Census Tract 1523, Sonoma County, California",1,1,0
1000000US060971523002024,060971523002024,"Block 2024, Block Group 2, Census Tract 1523, Sonoma County, California",0,0,0
1000000US060971523002025,060971523002025,"Block 2025, Block Group 2, Census Tract 1523, Sonoma County, California",20,17,3
1000000US060971523002026,060971523002026,"Block 2026, Block Group 2, Census Tract 1523, Sonoma County, California",23,23,0
1000000US060971523002027,060971523002027,"Block 2027, Block Group 2, Census Tract 1523, Sonoma County, California",2,2,0
1000000US060971523002028,060971523002028,"Block 2028, Block Group 2, Census Tract 1523, Sonoma County, California",0,0,0
1000000US060971523002029,060971523002029,"Block 2029, Block Group 2, Census Tract 1523, Sonoma County, California",0,0,0
1000000US060971523003000,060971523003000,"Block 3000, Block Group 3, Census Tract 1523, Sonoma County, California",31,31,0
1000000US060971523003001,060971523003001,"Block 3001, Block Group 3, Census Tract 1523, Sonoma County, California",9,9,0
1000000US060971523003002,060971523003002,"Block 3002, Block Group 3, Census Tract 1523, Sonoma County, California",32,30,2
1000000US060971523003003,060971523003003,"Block 3003, Block Group 3, Census Tract 1523, Sonoma County, California",3,3,0
1000000US060971523003004,060971523003004,"Block 3004, Block Group 3, Census Tract 1523, Sonoma County, California",2,2,0
1000000US060971523003005,060971523003005,"Block 3005, Block Group 3, Census Tract 1523, Sonoma County, California",0,0,0
1000000US060971523003006,060971523003006,"Block 3006, Block Group 3, Census Tract 1523, Sonoma County, California",12,10,2
1000000US060971523003007,060971523003007,"Block 3007, Block Group 3, Census Tract 1523, Sonoma County, California",3,3,0
1000000US060971523003008,060971523003008,"Block 3008, Block Group 3, Census Tract 1523, Sonoma County, California",5,5,0
1000000US060971523003009,060971523003009,"Block 3009, Block Group 3, Census Tract 1523, Sonoma County, California",64,60,4
1000000US060971523003010,060971523003010,"Block 3010, Block Group 3, Census Tract 1523, Sonoma County, California",17,15,2
1000000US060971523003011,060971523003011,"Block 3011, Block Group 3, Census Tract 1523, Sonoma County, California",17,16,1
1000000US060971523003012,060971523003012,"Block 3012, Block Group 3, Census Tract 1523, Sonoma County, California",80,78,2
1000000US060971523003013,060971523003013,"Block 3013, Block Group 3, Census Tract 1523, Sonoma County, California",45,42,3
1000000US060971523003014,060971523003014,"Block 3014, Block Group 3, Census Tract 1523, Sonoma County, California",49,49,0
1000000US060971523003015,060971523003015,"Block 3015, Block Group 3, Census Tract 1523, Sonoma County, California",10,10,0
1000000US060971523003016,060971523003016,"Block 3016, Block Group 3, Census Tract 1523, Sonoma County, California",15,15,0
1000000US060971523003017,060971523003017,"Block 3017, Block Group 3, Census Tract 1523, Sonoma County, California",41,38,3
1000000US060971523003018,060971523003018,"Block 3018, Block Group 3, Census Tract 1523, Sonoma County, California",20,19,1
1000000US060971523003019,060971523003019,"Block 3019, Block Group 3, Census Tract 1523, Sonoma County, California",20,20,0
1000000US060971523003020,060971523003020,"Block 3020, Block Group 3, Census Tract 1523, Sonoma County, California",26,25,1
1000000US060971523003021,060971523003021,"Block 3021, Block Group 3, Census Tract 1523, Sonoma County, California",16,16,0
1000000US060971523003022,060971523003022,"Block 3022, Block Group 3, Census Tract 1523, Sonoma County, California",15,15,0
1000000US060971523003023,060971523003023,"Block 3023, Block Group 3, Census Tract 1523, Sonoma County, California",6,5,1
1000000US060971523003024,060971523003024,"Block 3024, Block Group 3, Census Tract 1523, Sonoma County, California",15,14,1
1000000US060971523003025,060971523003025,"Block 3025, Block Group 3, Census Tract 1523, Sonoma County, California",38,37,1
1000000US060971523003026,060971523003026,"Block 3026, Block Group 3, Census Tract 1523, Sonoma County, California",0,0,0
1000000US060971523003027,060971523003027,"Block 3027, Block Group 3, Census Tract 1523, Sonoma County, California",0,0,0
1000000US060971523003028,060971523003028,"Block 3028, Block Group 3, Census Tract 1523, Sonoma County, California",1,1,0
1000000US060971523003029,060971523003029,"Block 3029, Block Group 3, Census Tract 1523, Sonoma County, California",0,0,0
1000000US060971523004000,060971523004000,"Block 4000, Block Group 4, Census Tract 1523, Sonoma County, California",16,13,3
1000000US060971523004001,060971523004001,"Block 4001, Block Group 4, Census Tract 1523, Sonoma County, California",12,12,0
1000000US060971523004002,060971523004002,"Block 4002, Block Group 4, Census Tract 1523, Sonoma County, California",14,14,0
1000000US060971523004003,060971523004003,"Block 4003, Block Group 4, Census Tract 1523, Sonoma County, California",17,17,0
1000000US060971523004004,060971523004004,"Block 4004, Block Group 4, Census Tract 1523, Sonoma County, California",17,17,0
1000000US060971523004005,060971523004005,"Block 4005, Block Group 4, Census Tract 1523, Sonoma County, California",20,20,0
1000000US060971523004006,060971523004006,"Block 4006, Block Group 4, Census Tract 1523, Sonoma County, California",9,8,1
1000000US060971523004007,060971523004007,"Block 4007, Block Group 4, Census Tract 1523, Sonoma County, California",17,17,0
1000000US060971523004008,060971523004008,"Block 4008, Block Group 4, Census Tract 1523, Sonoma County, California",18,18,0
1000000US060971523004009,060971523004009,"Block 4009, Block Group 4, Census Tract 1523, Sonoma County, California",54,53,1
1000000US060971523004010,060971523004010,"Block 4010, Block Group 4, Census Tract 1523, Sonoma County, California",10,9,1
1000000US060971523004011,060971523004011,"Block 4011, Block Group 4, Census Tract 1523, Sonoma County, California",12,12,0
1000000US060971523004012,060971523004012,"Block 4012, Block Group 4, Census Tract 1523, Sonoma County, California",10,9,1
1000000US060971523004013,060971523004013,"Block 4013, Block Group 4, Census Tract 1523, Sonoma County, California",11,10,1
1000000US060971523004014,060971523004014,"Block 4014, Block Group 4, Census Tract 1523, Sonoma County, California",11,11,0
1000000US060971523004015,060971523004015,"Block 4015, Block Group 4, Census Tract 1523, Sonoma County, California",49,46,3
1000000US060971523004016,060971523004016,"Block 4016, Block Group 4, Census Tract 1523, Sonoma County, California",12,12,0
1000000US060971523004017,060971523004017,"Block 4017, Block Group 4, Census Tract 1523, Sonoma County, California",10,10,0
1000000US060971523004018,060971523004018,"Block 4018, Block Group 4, Census Tract 1523, Sonoma County, California",8,7,1
1000000US060971524001000,060971524001000,"Block 1000, Block Group 1, Census Tract 1524, Sonoma County, California",0,0,0
1000000US060971524001001,060971524001001,"Block 1001, Block Group 1, Census Tract 1524, Sonoma County, California",0,0,0
1000000US060971524001002,060971524001002,"Block 1002, Block Group 1, Census Tract 1524, Sonoma County, California",0,0,0
1000000US060971524001003,060971524001003,"Block 1003, Block Group 1, Census Tract 1524, Sonoma County, California",28,26,2
1000000US060971524001004,060971524001004,"Block 1004, Block Group 1, Census Tract 1524, Sonoma County, California",6,6,0
1000000US060971524001005,060971524001005,"Block 1005, Block Group 1, Census Tract 1524, Sonoma County, California",2,2,0
1000000US060971524001006,060971524001006,"Block 1006, Block Group 1, Census Tract 1524, Sonoma County, California",0,0,0
1000000US060971524001007,060971524001007,"Block 1007, Block Group 1, Census Tract 1524, Sonoma County, California",56,54,2
1000000US060971524001008,060971524001008,"Block 1008, Block Group 1, Census Tract 1524, Sonoma County, California",14,14,0
1000000US060971524001009,060971524001009,"Block 1009, Block Group 1, Census Tract 1524, Sonoma County, California",12,12,0
1000000US060971524001010,060971524001010,"Block 1010, Block Group 1, Census Tract 1524, Sonoma County, California",275,196,79
1000000US060971524001011,060971524001011,"Block 1011, Block Group 1, Census Tract 1524, Sonoma County, California",0,0,0
1000000US060971524001012,060971524001012,"Block 1012, Block Group 1, Census Tract 1524, Sonoma County, California",9,7,2
1000000US060971524001013,060971524001013,"Block 1013, Block Group 1, Census Tract 1524, Sonoma County, California",13,13,0
1000000US060971524001014,060971524001014,"Block 1014, Block Group 1, Census Tract 1524, Sonoma County, California",12,12,0
1000000US060971524001015,060971524001015,"Block 1015, Block Group 1, Census Tract 1524, Sonoma County, California",60,56,4
1000000US060971524001016,060971524001016,"Block 1016, Block Group 1, Census Tract 1524, Sonoma County, California",30,28,2
1000000US060971524001017,060971524001017,"Block 1017, Block Group 1, Census Tract 1524, Sonoma County, California",47,47,0
1000000US060971524001018,060971524001018,"Block 1018, Block Group 1, Census Tract 1524, Sonoma County, California",0,0,0
1000000US060971524001019,060971524001019,"Block 1019, Block Group 1, Census Tract 1524, Sonoma County, California",29,29,0
1000000US060971524001020,060971524001020,"Block 1020, Block Group 1, Census Tract 1524, Sonoma County, California",1,1,0
1000000US060971524001021,060971524001021,"Block 1021, Block Group 1, Census Tract 1524, Sonoma County, California",138,134,4
1000000US060971524001022,060971524001022,"Block 1022, Block Group 1, Census Tract 1524, Sonoma County, California",20,20,0
1000000US060971524001023,060971524001023,"Block 1023, Block Group 1, Census Tract 1524, Sonoma County, California",0,0,0
1000000US060971524001024,060971524001024,"Block 1024, Block Group 1, Census Tract 1524, Sonoma County, California",12,12,0
1000000US060971524001025,060971524001025,"Block 1025, Block Group 1, Census Tract 1524, Sonoma County, California",0,0,0
1000000US060971524001026,060971524001026,"Block 1026, Block Group 1, Census Tract 1524, Sonoma County, California",14,11,3
1000000US060971524001027,060971524001027,"Block 1027, Block Group 1, Census Tract 1524, Sonoma County, California",0,0,0
1000000US060971524001028,060971524001028,"Block 1028, Block Group 1, Census Tract 1524, Sonoma County, California",0,0,0
1000000US060971524001029,060971524001029,"Block 1029, Block Group 1, Census Tract 1524, Sonoma County, California",8,8,0
1000000US060971524001030,060971524001030,"Block 1030, Block Group 1, Census Tract 1524, Sonoma County, California",168,155,13
1000000US060971524001031,060971524001031,"Block 1031, Block Group 1, Census Tract 1524, Sonoma County, California",0,0,0
1000000US060971524001032,060971524001032,"Block 1032, Block Group 1, Census Tract 1524, Sonoma County, California",0,0,0
1000000US060971524001033,060971524001033,"Block 1033, Block Group 1, Census Tract 1524, Sonoma County, California",0,0,0
1000000US060971524001034,060971524001034,"Block 1034, Block Group 1, Census Tract 1524, Sonoma County, California",38,38,0
1000000US060971524001035,060971524001035,"Block 1035, Block Group 1, Census Tract 1524, Sonoma County, California",20,17,3
1000000US060971524001036,060971524001036,"Block 1036, Block Group 1, Census Tract 1524, Sonoma County, California",8,7,1
1000000US060971524001037,060971524001037,"Block 1037, Block Group 1, Census Tract 1524, Sonoma County, California",12,10,2
1000000US060971524002000,060971524002000,"Block 2000, Block Group 2, Census Tract 1524, Sonoma County, California",144,139,5
1000000US060971524002001,060971524002001,"Block 2001, Block Group 2, Census Tract 1524, Sonoma County, California",2,2,0
1000000US060971524002002,060971524002002,"Block 2002, Block Group 2, Census Tract 1524, Sonoma County, California",1,1,0
1000000US060971524002003,060971524002003,"Block 2003, Block Group 2, Census Tract 1524, Sonoma County, California",4,3,1
1000000US060971524002004,060971524002004,"Block 2004, Block Group 2, Census Tract 1524, Sonoma County, California",7,6,1
1000000US060971524002005,060971524002005,"Block 2005, Block Group 2, Census Tract 1524, Sonoma County, California",9,9,0
1000000US060971524002006,060971524002006,"Block 2006, Block Group 2, Census Tract 1524, Sonoma County, California",65,63,2
1000000US060971524002007,060971524002007,"Block 2007, Block Group 2, Census Tract 1524, Sonoma County, California",7,6,1
1000000US060971524002008,060971524002008,"Block 2008, Block Group 2, Census Tract 1524, Sonoma County, California",70,69,1
1000000US060971524002009,060971524002009,"Block 2009, Block Group 2, Census Tract 1524, Sonoma County, California",1,1,0
1000000US060971524002010,060971524002010,"Block 2010, Block Group 2, Census Tract 1524, Sonoma County, California",0,0,0
1000000US060971524002011,060971524002011,"Block 2011, Block Group 2, Census Tract 1524, Sonoma County, California",0,0,0
1000000US060971524002012,060971524002012,"Block 2012, Block Group 2, Census Tract 1524, Sonoma County, California",77,72,5
1000000US060971524002013,060971524002013,"Block 2013, Block Group 2, Census Tract 1524, Sonoma County, California",0,0,0
1000000US060971524002014,060971524002014,"Block 2014, Block Group 2, Census Tract 1524, Sonoma County, California",22,22,0
1000000US060971524002015,060971524002015,"Block 2015, Block Group 2, Census Tract 1524, Sonoma County, California",3,3,0
1000000US060971524002016,060971524002016,"Block 2016, Block Group 2, Census Tract 1524, Sonoma County, California",27,26,1
1000000US060971524002017,060971524002017,"Block 2017, Block Group 2, Census Tract 1524, Sonoma County, California",8,7,1
1000000US060971524002018,060971524002018,"Block 2018, Block Group 2, Census Tract 1524, Sonoma County, California",2,2,0
1000000US060971524002019,060971524002019,"Block 2019, Block Group 2, Census Tract 1524, Sonoma County, California",69,63,6
1000000US060971524002020,060971524002020,"Block 2020, Block Group 2, Census Tract 1524, Sonoma County, California",18,16,2
1000000US060971524002021,060971524002021,"Block 2021, Block Group 2, Census Tract 1524, Sonoma County, California",9,9,0
1000000US060971524002022,060971524002022,"Block 2022, Block Group 2, Census Tract 1524, Sonoma County, California",5,5,0
1000000US060971524002023,060971524002023,"Block 2023, Block Group 2, Census Tract 1524, Sonoma County, California",0,0,0
1000000US060971524002024,060971524002024,"Block 2024, Block Group 2, Census Tract 1524, Sonoma County, California",0,0,0
1000000US060971524002025,060971524002025,"Block 2025, Block Group 2, Census Tract 1524, Sonoma County, California",54,51,3
1000000US060971524002026,060971524002026,"Block 2026, Block Group 2, Census Tract 1524, Sonoma County, California",22,22,0
1000000US060971524002027,060971524002027,"Block 2027, Block Group 2, Census Tract 1524, Sonoma County, California",7,7,0
1000000US060971524002028,060971524002028,"Block 2028, Block Group 2, Census Tract 1524, Sonoma County, California",16,15,1
1000000US060971524002029,060971524002029,"Block 2029, Block Group 2, Census Tract 1524, Sonoma County, California",34,32,2
1000000US060971524002030,060971524002030,"Block 2030, Block Group 2, Census Tract 1524, Sonoma County, California",52,48,4
1000000US060971524002031,060971524002031,"Block 2031, Block Group 2, Census Tract 1524, Sonoma County, California",13,12,1
1000000US060971524002032,060971524002032,"Block 2032, Block Group 2, Census Tract 1524, Sonoma County, California",7,7,0
1000000US060971524002033,060971524002033,"Block 2033, Block Group 2, Census Tract 1524, Sonoma County, California",16,15,1
1000000US060971524002034,060971524002034,"Block 2034, Block Group 2, Census Tract 1524, Sonoma County, California",0,0,0
1000000US060971524003000,060971524003000,"Block 3000, Block Group 3, Census Tract 1524, Sonoma County, California",40,39,1
1000000US060971524003001,060971524003001,"Block 3001, Block Group 3, Census Tract 1524, Sonoma County, California",0,0,0
1000000US060971524003002,060971524003002,"Block 3002, Block Group 3, Census Tract 1524, Sonoma County, California",55,50,5
1000000US060971524003003,060971524003003,"Block 3003, Block Group 3, Census Tract 1524, Sonoma County, California",8,8,0
1000000US060971524003004,060971524003004,"Block 3004, Block Group 3, Census Tract 1524, Sonoma County, California",29,20,9
1000000US060971524003005,060971524003005,"Block 3005, Block Group 3, Census Tract 1524, Sonoma County, California",0,0,0
1000000US060971524003006,060971524003006,"Block 3006, Block Group 3, Census Tract 1524, Sonoma County, California",0,0,0
1000000US060971524003007,060971524003007,"Block 3007, Block Group 3, Census Tract 1524, Sonoma County, California",35,34,1
1000000US060971524003008,060971524003008,"Block 3008, Block Group 3, Census Tract 1524, Sonoma County, California",0,0,0
1000000US060971524003009,060971524003009,"Block 3009, Block Group 3, Census Tract 1524, Sonoma County, California",3,3,0
1000000US060971524003010,060971524003010,"Block 3010, Block Group 3, Census Tract 1524, Sonoma County, California",15,15,0
1000000US060971524003011,060971524003011,"Block 3011, Block Group 3, Census Tract 1524, Sonoma County, California",0,0,0
1000000US060971524003012,060971524003012,"Block 3012, Block Group 3, Census Tract 1524, Sonoma County, California",55,53,2
1000000US060971524003013,060971524003013,"Block 3013, Block Group 3, Census Tract 1524, Sonoma County, California",0,0,0
1000000US060971524003014,060971524003014,"Block 3014, Block Group 3, Census Tract 1524, Sonoma County, California",0,0,0
1000000US060971524003015,060971524003015,"Block 3015, Block Group 3, Census Tract 1524, Sonoma County, California",0,0,0
1000000US060971524003016,060971524003016,"Block 3016, Block Group 3, Census Tract 1524, Sonoma County, California",296,263,33
1000000US060971524003017,060971524003017,"Block 3017, Block Group 3, Census Tract 1524, Sonoma County, California",0,0,0
1000000US060971524003018,060971524003018,"Block 3018, Block Group 3, Census Tract 1524, Sonoma County, California",57,49,8
1000000US060971524003019,060971524003019,"Block 3019, Block Group 3, Census Tract 1524, Sonoma County, California",19,12,7
1000000US060971524003020,060971524003020,"Block 3020, Block Group 3, Census Tract 1524, Sonoma County, California",0,0,0
1000000US060971524003021,060971524003021,"Block 3021, Block Group 3, Census Tract 1524, Sonoma County, California",0,0,0
1000000US060971524003022,060971524003022,"Block 3022, Block Group 3, Census Tract 1524, Sonoma County, California",1,1,0
1000000US060971524003023,060971524003023,"Block 3023, Block Group 3, Census Tract 1524, Sonoma County, California",4,4,0
1000000US060971524003024,060971524003024,"Block 3024, Block Group 3, Census Tract 1524, Sonoma County, California",12,10,2
1000000US060971524003025,060971524003025,"Block 3025, Block Group 3, Census Tract 1524, Sonoma County, California",49,46,3
1000000US060971524003026,060971524003026,"Block 3026, Block Group 3, Census Tract 1524, Sonoma County, California",0,0,0
1000000US060971524003027,060971524003027,"Block 3027, Block Group 3, Census Tract 1524, Sonoma County, California",0,0,0
1000000US060971524003028,060971524003028,"Block 3028, Block Group 3, Census Tract 1524, Sonoma County, California",8,8,0
1000000US060971524003029,060971524003029,"Block 3029, Block Group 3, Census Tract 1524, Sonoma County, California",3,3,0
1000000US060971524003030,060971524003030,"Block 3030, Block Group 3, Census Tract 1524, Sonoma County, California",1,1,0
1000000US060971524003031,060971524003031,"Block 3031, Block Group 3, Census Tract 1524, Sonoma County, California",0,0,0
1000000US060971524003032,060971524003032,"Block 3032, Block Group 3, Census Tract 1524, Sonoma County, California",7,7,0
1000000US060971524003033,060971524003033,"Block 3033, Block Group 3, Census Tract 1524, Sonoma County, California",9,9,0
1000000US060971524003034,060971524003034,"Block 3034, Block Group 3, Census Tract 1524, Sonoma County, California",9,8,1
1000000US060971524003035,060971524003035,"Block 3035, Block Group 3, Census Tract 1524, Sonoma County, California",32,31,1
1000000US060971524003036,060971524003036,"Block 3036, Block Group 3, Census Tract 1524, Sonoma County, California",1,1,0
1000000US060971524003037,060971524003037,"Block 3037, Block Group 3, Census Tract 1524, Sonoma County, California",0,0,0
1000000US060971524003038,060971524003038,"Block 3038, Block Group 3, Census Tract 1524, Sonoma County, California",0,0,0
1000000US060971524003039,060971524003039,"Block 3039, Block Group 3, Census Tract 1524, Sonoma County, California",0,0,0
1000000US060971524003040,060971524003040,"Block 3040, Block Group 3, Census Tract 1524, Sonoma County, California",2,2,0
1000000US060971524003041,060971524003041,"Block 3041, Block Group 3, Census Tract 1524, Sonoma County, California",2,2,0
1000000US060971524003042,060971524003042,"Block 3042, Block Group 3, Census Tract 1524, Sonoma County, California",0,0,0
1000000US060971524003043,060971524003043,"Block 3043, Block Group 3, Census Tract 1524, Sonoma County, California",0,0,0
1000000US060971524003044,060971524003044,"Block 3044, Block Group 3, Census Tract 1524, Sonoma County, California",195,164,31
1000000US060971524003045,060971524003045,"Block 3045, Block Group 3, Census Tract 1524, Sonoma County, California",0,0,0
1000000US060971524003046,060971524003046,"Block 3046, Block Group 3, Census Tract 1524, Sonoma County, California",0,0,0
1000000US060971524003047,060971524003047,"Block 3047, Block Group 3, Census Tract 1524, Sonoma County, California",0,0,0
1000000US060971524003048,060971524003048,"Block 3048, Block Group 3, Census Tract 1524, Sonoma County, California",0,0,0
1000000US060971524003049,060971524003049,"Block 3049, Block Group 3, Census Tract 1524, Sonoma County, California",0,0,0
1000000US060971524003050,060971524003050,"Block 3050, Block Group 3, Census Tract 1524, Sonoma County, California",0,0,0
1000000US060971524003051,060971524003051,"Block 3051, Block Group 3, Census Tract 1524, Sonoma County, California",0,0,0
1000000US060971524003052,060971524003052,"Block 3052, Block Group 3, Census Tract 1524, Sonoma County, California",0,0,0
1000000US060971524003053,060971524003053,"Block 3053, Block Group 3, Census Tract 1524, Sonoma County, California",5,5,0
1000000US060971524003054,060971524003054,"Block 3054, Block Group 3, Census Tract 1524, Sonoma County, California",1,1,0
1000000US060971524003055,060971524003055,"Block 3055, Block Group 3, Census Tract 1524, Sonoma County, California",2,1,1
1000000US060971524003056,060971524003056,"Block 3056, Block Group 3, Census Tract 1524, Sonoma County, California",0,0,0
1000000US060971524003057,060971524003057,"Block 3057, Block Group 3, Census Tract 1524, Sonoma County, California",0,0,0
1000000US060971524003058,060971524003058,"Block 3058, Block Group 3, Census Tract 1524, Sonoma County, California",0,0,0
1000000US060971524003059,060971524003059,"Block 3059, Block Group 3, Census Tract 1524, Sonoma County, California",0,0,0
1000000US060971524003060,060971524003060,"Block 3060, Block Group 3, Census Tract 1524, Sonoma County, California",0,0,0
1000000US060971524003061,060971524003061,"Block 3061, Block Group 3, Census Tract 1524, Sonoma County, California",0,0,0
1000000US060971524003062,060971524003062,"Block 3062, Block Group 3, Census Tract 1524, Sonoma County, California",0,0,0
1000000US060971524003063,060971524003063,"Block 3063, Block Group 3, Census Tract 1524, Sonoma County, California",0,0,0
1000000US060971524004000,060971524004000,"Block 4000, Block Group 4, Census Tract 1524, Sonoma County, California",302,294,8
1000000US060971524004001,060971524004001,"Block 4001, Block Group 4, Census Tract 1524, Sonoma County, California",26,25,1
1000000US060971524004002,060971524004002,"Block 4002, Block Group 4, Census Tract 1524, Sonoma County, California",9,9,0
1000000US060971524004003,060971524004003,"Block 4003, Block Group 4, Census Tract 1524, Sonoma County, California",72,69,3
1000000US060971524004004,060971524004004,"Block 4004, Block Group 4, Census Tract 1524, Sonoma County, California",3,3,0
1000000US060971524004005,060971524004005,"Block 4005, Block Group 4, Census Tract 1524, Sonoma County, California",11,11,0
1000000US060971524004006,060971524004006,"Block 4006, Block Group 4, Census Tract 1524, Sonoma County, California",9,9,0
1000000US060971524004007,060971524004007,"Block 4007, Block Group 4, Census Tract 1524, Sonoma County, California",23,22,1
1000000US060971524004008,060971524004008,"Block 4008, Block Group 4, Census Tract 1524, Sonoma County, California",86,83,3
1000000US060971524004009,060971524004009,"Block 4009, Block Group 4, Census Tract 1524, Sonoma County, California",11,11,0
1000000US060971524004010,060971524004010,"Block 4010, Block Group 4, Census Tract 1524, Sonoma County, California",8,7,1
1000000US060971524004011,060971524004011,"Block 4011, Block Group 4, Census Tract 1524, Sonoma County, California",5,5,0
1000000US060971524004012,060971524004012,"Block 4012, Block Group 4, Census Tract 1524, Sonoma County, California",63,62,1
1000000US060971524004013,060971524004013,"Block 4013, Block Group 4, Census Tract 1524, Sonoma County, California",0,0,0
1000000US060971524004014,060971524004014,"Block 4014, Block Group 4, Census Tract 1524, Sonoma County, California",0,0,0
1000000US060971524004015,060971524004015,"Block 4015, Block Group 4, Census Tract 1524, Sonoma County, California",7,7,0
1000000US060971524004016,060971524004016,"Block 4016, Block Group 4, Census Tract 1524, Sonoma County, California",0,0,0
1000000US060971524004017,060971524004017,"Block 4017, Block Group 4, Census Tract 1524, Sonoma County, California",61,56,5
1000000US060971524004018,060971524004018,"Block 4018, Block Group 4, Census Tract 1524, Sonoma County, California",14,14,0
1000000US060971524004019,060971524004019,"Block 4019, Block Group 4, Census Tract 1524, Sonoma County, California",7,6,1
1000000US060971524004020,060971524004020,"Block 4020, Block Group 4, Census Tract 1524, Sonoma County, California",37,36,1
1000000US060971524004021,060971524004021,"Block 4021, Block Group 4, Census Tract 1524, Sonoma County, California",92,88,4
1000000US060971524004022,060971524004022,"Block 4022, Block Group 4, Census Tract 1524, Sonoma County, California",0,0,0
1000000US060971524004023,060971524004023,"Block 4023, Block Group 4, Census Tract 1524, Sonoma County, California",14,13,1
1000000US060971524004024,060971524004024,"Block 4024, Block Group 4, Census Tract 1524, Sonoma County, California",13,13,0
1000000US060971524004025,060971524004025,"Block 4025, Block Group 4, Census Tract 1524, Sonoma County, California",9,8,1
1000000US060971524004026,060971524004026,"Block 4026, Block Group 4, Census Tract 1524, Sonoma County, California",0,0,0
1000000US060971524004027,060971524004027,"Block 4027, Block Group 4, Census Tract 1524, Sonoma County, California",0,0,0
1000000US060971524004028,060971524004028,"Block 4028, Block Group 4, Census Tract 1524, Sonoma County, California",19,17,2
1000000US060971524004029,060971524004029,"Block 4029, Block Group 4, Census Tract 1524, Sonoma County, California",22,20,2
1000000US060971524004030,060971524004030,"Block 4030, Block Group 4, Census Tract 1524, Sonoma County, California",6,6,0
1000000US060971524004031,060971524004031,"Block 4031, Block Group 4, Census Tract 1524, Sonoma County, California",4,4,0
1000000US060971524004032,060971524004032,"Block 4032, Block Group 4, Census Tract 1524, Sonoma County, California",22,22,0
1000000US060971524004033,060971524004033,"Block 4033, Block Group 4, Census Tract 1524, Sonoma County, California",6,6,0
1000000US060971524004034,060971524004034,"Block 4034, Block Group 4, Census Tract 1524, Sonoma County, California",1,1,0
1000000US060971524004035,060971524004035,"Block 4035, Block Group 4, Census Tract 1524, Sonoma County, California",0,0,0
1000000US060971524004036,060971524004036,"Block 4036, Block Group 4, Census Tract 1524, Sonoma County, California",2,2,0
1000000US060971524004037,060971524004037,"Block 4037, Block Group 4, Census Tract 1524, Sonoma County, California",0,0,0
1000000US060971524004038,060971524004038,"Block 4038, Block Group 4, Census Tract 1524, Sonoma County, California",5,5,0
1000000US060971524005000,060971524005000,"Block 5000, Block Group 5, Census Tract 1524, Sonoma County, California",2,2,0
1000000US060971524005001,060971524005001,"Block 5001, Block Group 5, Census Tract 1524, Sonoma County, California",57,53,4
1000000US060971524005002,060971524005002,"Block 5002, Block Group 5, Census Tract 1524, Sonoma County, California",0,0,0
1000000US060971524005003,060971524005003,"Block 5003, Block Group 5, Census Tract 1524, Sonoma County, California",7,6,1
1000000US060971524005004,060971524005004,"Block 5004, Block Group 5, Census Tract 1524, Sonoma County, California",21,17,4
1000000US060971524005005,060971524005005,"Block 5005, Block Group 5, Census Tract 1524, Sonoma County, California",115,113,2
1000000US060971524005006,060971524005006,"Block 5006, Block Group 5, Census Tract 1524, Sonoma County, California",0,0,0
1000000US060971524005007,060971524005007,"Block 5007, Block Group 5, Census Tract 1524, Sonoma County, California",0,0,0
1000000US060971524005008,060971524005008,"Block 5008, Block Group 5, Census Tract 1524, Sonoma County, California",0,0,0
1000000US060971524005009,060971524005009,"Block 5009, Block Group 5, Census Tract 1524, Sonoma County, California",0,0,0
1000000US060971524005010,060971524005010,"Block 5010, Block Group 5, Census Tract 1524, Sonoma County, California",0,0,0
1000000US060971524005011,060971524005011,"Block 5011, Block Group 5, Census Tract 1524, Sonoma County, California",0,0,0
1000000US060971524005012,060971524005012,"Block 5012, Block Group 5, Census Tract 1524, Sonoma County, California",60,59,1
1000000US060971524005013,060971524005013,"Block 5013, Block Group 5, Census Tract 1524, Sonoma County, California",0,0,0
1000000US060971524005014,060971524005014,"Block 5014, Block Group 5, Census Tract 1524, Sonoma County, California",0,0,0
1000000US060971524005015,060971524005015,"Block 5015, Block Group 5, Census Tract 1524, Sonoma County, California",0,0,0
1000000US060971524005016,060971524005016,"Block 5016, Block Group 5, Census Tract 1524, Sonoma County, California",16,14,2
1000000US060971524005017,060971524005017,"Block 5017, Block Group 5, Census Tract 1524, Sonoma County, California",0,0,0
1000000US060971524005018,060971524005018,"Block 5018, Block Group 5, Census Tract 1524, Sonoma County, California",0,0,0
1000000US060971524005019,060971524005019,"Block 5019, Block Group 5, Census Tract 1524, Sonoma County, California",12,12,0
1000000US060971524005020,060971524005020,"Block 5020, Block Group 5, Census Tract 1524, Sonoma County, California",0,0,0
1000000US060971524005021,060971524005021,"Block 5021, Block Group 5, Census Tract 1524, Sonoma County, California",100,94,6
1000000US060971524005022,060971524005022,"Block 5022, Block Group 5, Census Tract 1524, Sonoma County, California",0,0,0
1000000US060971524005023,060971524005023,"Block 5023, Block Group 5, Census Tract 1524, Sonoma County, California",15,15,0
1000000US060971524005024,060971524005024,"Block 5024, Block Group 5, Census Tract 1524, Sonoma County, California",3,3,0
1000000US060971524005025,060971524005025,"Block 5025, Block Group 5, Census Tract 1524, Sonoma County, California",0,0,0
1000000US060971524005026,060971524005026,"Block 5026, Block Group 5, Census Tract 1524, Sonoma County, California",0,0,0
1000000US060971524005027,060971524005027,"Block 5027, Block Group 5, Census Tract 1524, Sonoma County, California",0,0,0
1000000US060971524005028,060971524005028,"Block 5028, Block Group 5, Census Tract 1524, Sonoma County, California",36,36,0
1000000US060971524005029,060971524005029,"Block 5029, Block Group 5, Census Tract 1524, Sonoma County, California",16,14,2
1000000US060971524005030,060971524005030,"Block 5030, Block Group 5, Census Tract 1524, Sonoma County, California",31,30,1
1000000US060971524005031,060971524005031,"Block 5031, Block Group 5, Census Tract 1524, Sonoma County, California",9,9,0
1000000US060971524005032,060971524005032,"Block 5032, Block Group 5, Census Tract 1524, Sonoma County, California",23,23,0
1000000US060971524005033,060971524005033,"Block 5033, Block Group 5, Census Tract 1524, Sonoma County, California",32,32,0
1000000US060971524005034,060971524005034,"Block 5034, Block Group 5, Census Tract 1524, Sonoma County, California",4,4,0
1000000US060971524005035,060971524005035,"Block 5035, Block Group 5, Census Tract 1524, Sonoma County, California",0,0,0
1000000US060971524005036,060971524005036,"Block 5036, Block Group 5, Census Tract 1524, Sonoma County, California",18,18,0
1000000US060971524005037,060971524005037,"Block 5037, Block Group 5, Census Tract 1524, Sonoma County, California",0,0,0
1000000US060971524005038,060971524005038,"Block 5038, Block Group 5, Census Tract 1524, Sonoma County, California",0,0,0
1000000US060971524005039,060971524005039,"Block 5039, Block Group 5, Census Tract 1524, Sonoma County, California",2,1,1
1000000US060971524005040,060971524005040,"Block 5040, Block Group 5, Census Tract 1524, Sonoma County, California",0,0,0
1000000US060971524005041,060971524005041,"Block 5041, Block Group 5, Census Tract 1524, Sonoma County, California",8,8,0
1000000US060971524005042,060971524005042,"Block 5042, Block Group 5, Census Tract 1524, Sonoma County, California",91,86,5
1000000US060971524005043,060971524005043,"Block 5043, Block Group 5, Census Tract 1524, Sonoma County, California",11,10,1
1000000US060971524005044,060971524005044,"Block 5044, Block Group 5, Census Tract 1524, Sonoma County, California",0,0,0
1000000US060971524005045,060971524005045,"Block 5045, Block Group 5, Census Tract 1524, Sonoma County, California",0,0,0
1000000US060971524005046,060971524005046,"Block 5046, Block Group 5, Census Tract 1524, Sonoma County, California",0,0,0
1000000US060971524005047,060971524005047,"Block 5047, Block Group 5, Census Tract 1524, Sonoma County, California",14,14,0
1000000US060971524005048,060971524005048,"Block 5048, Block Group 5, Census Tract 1524, Sonoma County, California",0,0,0
1000000US060971524005049,060971524005049,"Block 5049, Block Group 5, Census Tract 1524, Sonoma County, California",0,0,0
1000000US060971524005050,060971524005050,"Block 5050, Block Group 5, Census Tract 1524, Sonoma County, California",0,0,0
1000000US060971524005051,060971524005051,"Block 5051, Block Group 5, Census Tract 1524, Sonoma County, California",22,20,2
1000000US060971524005052,060971524005052,"Block 5052, Block Group 5, Census Tract 1524, Sonoma County, California",0,0,0
1000000US060971525011000,060971525011000,"Block 1000, Block Group 1, Census Tract 1525.01, Sonoma County, California",0,0,0
1000000US060971525011001,060971525011001,"Block 1001, Block Group 1, Census Tract 1525.01, Sonoma County, California",8,7,1
1000000US060971525011002,060971525011002,"Block 1002, Block Group 1, Census Tract 1525.01, Sonoma County, California",48,45,3
1000000US060971525011003,060971525011003,"Block 1003, Block Group 1, Census Tract 1525.01, Sonoma County, California",0,0,0
1000000US060971525011004,060971525011004,"Block 1004, Block Group 1, Census Tract 1525.01, Sonoma County, California",4,3,1
1000000US060971525011005,060971525011005,"Block 1005, Block Group 1, Census Tract 1525.01, Sonoma County, California",10,10,0
1000000US060971525011006,060971525011006,"Block 1006, Block Group 1, Census Tract 1525.01, Sonoma County, California",61,60,1
1000000US060971525011007,060971525011007,"Block 1007, Block Group 1, Census Tract 1525.01, Sonoma County, California",26,22,4
1000000US060971525011008,060971525011008,"Block 1008, Block Group 1, Census Tract 1525.01, Sonoma County, California",1,1,0
1000000US060971525011009,060971525011009,"Block 1009, Block Group 1, Census Tract 1525.01, Sonoma County, California",16,16,0
1000000US060971525011010,060971525011010,"Block 1010, Block Group 1, Census Tract 1525.01, Sonoma County, California",14,14,0
1000000US060971525011011,060971525011011,"Block 1011, Block Group 1, Census Tract 1525.01, Sonoma County, California",85,80,5
1000000US060971525011012,060971525011012,"Block 1012, Block Group 1, Census Tract 1525.01, Sonoma County, California",100,97,3
1000000US060971525011013,060971525011013,"Block 1013, Block Group 1, Census Tract 1525.01, Sonoma County, California",3,3,0
1000000US060971525011014,060971525011014,"Block 1014, Block Group 1, Census Tract 1525.01, Sonoma County, California",15,14,1
1000000US060971525011015,060971525011015,"Block 1015, Block Group 1, Census Tract 1525.01, Sonoma County, California",36,33,3
1000000US060971525011016,060971525011016,"Block 1016, Block Group 1, Census Tract 1525.01, Sonoma County, California",121,116,5
1000000US060971525011017,060971525011017,"Block 1017, Block Group 1, Census Tract 1525.01, Sonoma County, California",22,20,2
1000000US060971525011018,060971525011018,"Block 1018, Block Group 1, Census Tract 1525.01, Sonoma County, California",9,9,0
1000000US060971525011019,060971525011019,"Block 1019, Block Group 1, Census Tract 1525.01, Sonoma County, California",2,2,0
1000000US060971525011020,060971525011020,"Block 1020, Block Group 1, Census Tract 1525.01, Sonoma County, California",0,0,0
1000000US060971525011021,060971525011021,"Block 1021, Block Group 1, Census Tract 1525.01, Sonoma County, California",217,210,7
1000000US060971525011022,060971525011022,"Block 1022, Block Group 1, Census Tract 1525.01, Sonoma County, California",0,0,0
1000000US060971525012000,060971525012000,"Block 2000, Block Group 2, Census Tract 1525.01, Sonoma County, California",30,29,1
1000000US060971525012001,060971525012001,"Block 2001, Block Group 2, Census Tract 1525.01, Sonoma County, California",25,25,0
1000000US060971525012002,060971525012002,"Block 2002, Block Group 2, Census Tract 1525.01, Sonoma County, California",224,215,9
1000000US060971525012003,060971525012003,"Block 2003, Block Group 2, Census Tract 1525.01, Sonoma County, California",20,18,2
1000000US060971525012004,060971525012004,"Block 2004, Block Group 2, Census Tract 1525.01, Sonoma County, California",3,3,0
1000000US060971525012005,060971525012005,"Block 2005, Block Group 2, Census Tract 1525.01, Sonoma County, California",0,0,0
1000000US060971525012006,060971525012006,"Block 2006, Block Group 2, Census Tract 1525.01, Sonoma County, California",0,0,0
1000000US060971525012007,060971525012007,"Block 2007, Block Group 2, Census Tract 1525.01, Sonoma County, California",208,202,6
1000000US060971525012008,060971525012008,"Block 2008, Block Group 2, Census Tract 1525.01, Sonoma County, California",18,17,1
1000000US060971525012009,060971525012009,"Block 2009, Block Group 2, Census Tract 1525.01, Sonoma County, California",20,16,4
1000000US060971525013000,060971525013000,"Block 3000, Block Group 3, Census Tract 1525.01, Sonoma County, California",101,98,3
1000000US060971525013001,060971525013001,"Block 3001, Block Group 3, Census Tract 1525.01, Sonoma County, California",10,9,1
1000000US060971525013002,060971525013002,"Block 3002, Block Group 3, Census Tract 1525.01, Sonoma County, California",24,23,1
1000000US060971525013003,060971525013003,"Block 3003, Block Group 3, Census Tract 1525.01, Sonoma County, California",11,10,1
1000000US060971525013004,060971525013004,"Block 3004, Block Group 3, Census Tract 1525.01, Sonoma County, California",18,18,0
1000000US060971525013005,060971525013005,"Block 3005, Block Group 3, Census Tract 1525.01, Sonoma County, California",173,163,10
1000000US060971525013006,060971525013006,"Block 3006, Block Group 3, Census Tract 1525.01, Sonoma County, California",9,9,0
1000000US060971525013007,060971525013007,"Block 3007, Block Group 3, Census Tract 1525.01, Sonoma County, California",24,22,2
1000000US060971525013008,060971525013008,"Block 3008, Block Group 3, Census Tract 1525.01, Sonoma County, California",2,2,0
1000000US060971525013009,060971525013009,"Block 3009, Block Group 3, Census Tract 1525.01, Sonoma County, California",35,29,6
1000000US060971525013010,060971525013010,"Block 3010, Block Group 3, Census Tract 1525.01, Sonoma County, California",0,0,0
1000000US060971525013011,060971525013011,"Block 3011, Block Group 3, Census Tract 1525.01, Sonoma County, California",0,0,0
1000000US060971525021000,060971525021000,"Block 1000, Block Group 1, Census Tract 1525.02, Sonoma County, California",8,8,0
1000000US060971525021001,060971525021001,"Block 1001, Block Group 1, Census Tract 1525.02, Sonoma County, California",80,78,2
1000000US060971525021002,060971525021002,"Block 1002, Block Group 1, Census Tract 1525.02, Sonoma County, California",45,44,1
1000000US060971525021003,060971525021003,"Block 1003, Block Group 1, Census Tract 1525.02, Sonoma County, California",102,99,3
1000000US060971525021004,060971525021004,"Block 1004, Block Group 1, Census Tract 1525.02, Sonoma County, California",99,92,7
1000000US060971525021005,060971525021005,"Block 1005, Block Group 1, Census Tract 1525.02, Sonoma County, California",23,22,1
1000000US060971525021006,060971525021006,"Block 1006, Block Group 1, Census Tract 1525.02, Sonoma County, California",0,0,0
1000000US060971525021007,060971525021007,"Block 1007, Block Group 1, Census Tract 1525.02, Sonoma County, California",0,0,0
1000000US060971525021008,060971525021008,"Block 1008, Block Group 1, Census Tract 1525.02, Sonoma County, California",0,0,0
1000000US060971525021009,060971525021009,"Block 1009, Block Group 1, Census Tract 1525.02, Sonoma County, California",2,2,0
1000000US060971525021010,060971525021010,"Block 1010, Block Group 1, Census Tract 1525.02, Sonoma County, California",0,0,0
1000000US060971525021011,060971525021011,"Block 1011, Block Group 1, Census Tract 1525.02, Sonoma County, California",44,44,0
1000000US060971525021012,060971525021012,"Block 1012, Block Group 1, Census Tract 1525.02, Sonoma County, California",13,13,0
1000000US060971525021013,060971525021013,"Block 1013, Block Group 1, Census Tract 1525.02, Sonoma County, California",0,0,0
1000000US060971525021014,060971525021014,"Block 1014, Block Group 1, Census Tract 1525.02, Sonoma County, California",0,0,0
1000000US060971525021015,060971525021015,"Block 1015, Block Group 1, Census Tract 1525.02, Sonoma County, California",36,35,1
1000000US060971525021016,060971525021016,"Block 1016, Block Group 1, Census Tract 1525.02, Sonoma County, California",26,25,1
1000000US060971525021017,060971525021017,"Block 1017, Block Group 1, Census Tract 1525.02, Sonoma County, California",22,21,1
1000000US060971525021018,060971525021018,"Block 1018, Block Group 1, Census Tract 1525.02, Sonoma County, California",47,46,1
1000000US060971525021019,060971525021019,"Block 1019, Block Group 1, Census Tract 1525.02, Sonoma County, California",0,0,0
1000000US060971525022000,060971525022000,"Block 2000, Block Group 2, Census Tract 1525.02, Sonoma County, California",70,55,15
1000000US060971525022001,060971525022001,"Block 2001, Block Group 2, Census Tract 1525.02, Sonoma County, California",61,59,2
1000000US060971525022002,060971525022002,"Block 2002, Block Group 2, Census Tract 1525.02, Sonoma County, California",87,75,12
1000000US060971525022003,060971525022003,"Block 2003, Block Group 2, Census Tract 1525.02, Sonoma County, California",63,59,4
1000000US060971525022004,060971525022004,"Block 2004, Block Group 2, Census Tract 1525.02, Sonoma County, California",75,70,5
1000000US060971525022005,060971525022005,"Block 2005, Block Group 2, Census Tract 1525.02, Sonoma County, California",27,24,3
1000000US060971525022006,060971525022006,"Block 2006, Block Group 2, Census Tract 1525.02, Sonoma County, California",5,5,0
1000000US060971525022007,060971525022007,"Block 2007, Block Group 2, Census Tract 1525.02, Sonoma County, California",152,137,15
1000000US060971525022008,060971525022008,"Block 2008, Block Group 2, Census Tract 1525.02, Sonoma County, California",10,10,0
1000000US060971525022009,060971525022009,"Block 2009, Block Group 2, Census Tract 1525.02, Sonoma County, California",26,25,1
1000000US060971525022010,060971525022010,"Block 2010, Block Group 2, Census Tract 1525.02, Sonoma County, California",10,10,0
1000000US060971525022011,060971525022011,"Block 2011, Block Group 2, Census Tract 1525.02, Sonoma County, California",1,1,0
1000000US060971525022012,060971525022012,"Block 2012, Block Group 2, Census Tract 1525.02, Sonoma County, California",1,1,0
1000000US060971525022013,060971525022013,"Block 2013, Block Group 2, Census Tract 1525.02, Sonoma County, California",4,3,1
1000000US060971525022014,060971525022014,"Block 2014, Block Group 2, Census Tract 1525.02, Sonoma County, California",9,9,0
1000000US060971525022015,060971525022015,"Block 2015, Block Group 2, Census Tract 1525.02, Sonoma County, California",4,4,0
1000000US060971525022016,060971525022016,"Block 2016, Block Group 2, Census Tract 1525.02, Sonoma County, California",16,13,3
1000000US060971525022017,060971525022017,"Block 2017, Block Group 2, Census Tract 1525.02, Sonoma County, California",3,3,0
1000000US060971525022018,060971525022018,"Block 2018, Block Group 2, Census Tract 1525.02, Sonoma County, California",2,2,0
1000000US060971525022019,060971525022019,"Block 2019, Block Group 2, Census Tract 1525.02, Sonoma County, California",5,5,0
1000000US060971525022020,060971525022020,"Block 2020, Block Group 2, Census Tract 1525.02, Sonoma County, California",2,1,1
1000000US060971525022021,060971525022021,"Block 2021, Block Group 2, Census Tract 1525.02, Sonoma County, California",4,4,0
1000000US060971525022022,060971525022022,"Block 2022, Block Group 2, Census Tract 1525.02, Sonoma County, California",4,4,0
1000000US060971525023000,060971525023000,"Block 3000, Block Group 3, Census Tract 1525.02, Sonoma County, California",148,141,7
1000000US060971525023001,060971525023001,"Block 3001, Block Group 3, Census Tract 1525.02, Sonoma County, California",36,33,3
1000000US060971525023002,060971525023002,"Block 3002, Block Group 3, Census Tract 1525.02, Sonoma County, California",0,0,0
1000000US060971525023003,060971525023003,"Block 3003, Block Group 3, Census Tract 1525.02, Sonoma County, California",35,35,0
1000000US060971525023004,060971525023004,"Block 3004, Block Group 3, Census Tract 1525.02, Sonoma County, California",23,23,0
1000000US060971525023005,060971525023005,"Block 3005, Block Group 3, Census Tract 1525.02, Sonoma County, California",16,16,0
1000000US060971525023006,060971525023006,"Block 3006, Block Group 3, Census Tract 1525.02, Sonoma County, California",30,30,0
1000000US060971525023007,060971525023007,"Block 3007, Block Group 3, Census Tract 1525.02, Sonoma County, California",37,35,2
1000000US060971525023008,060971525023008,"Block 3008, Block Group 3, Census Tract 1525.02, Sonoma County, California",12,12,0
1000000US060971525023009,060971525023009,"Block 3009, Block Group 3, Census Tract 1525.02, Sonoma County, California",35,35,0
1000000US060971525023010,060971525023010,"Block 3010, Block Group 3, Census Tract 1525.02, Sonoma County, California",1,1,0
1000000US060971525023011,060971525023011,"Block 3011, Block Group 3, Census Tract 1525.02, Sonoma County, California",13,12,1
1000000US060971526001000,060971526001000,"Block 1000, Block Group 1, Census Tract 1526, Sonoma County, California",185,168,17
1000000US060971526001001,060971526001001,"Block 1001, Block Group 1, Census Tract 1526, Sonoma County, California",0,0,0
1000000US060971526001002,060971526001002,"Block 1002, Block Group 1, Census Tract 1526, Sonoma County, California",0,0,0
1000000US060971526001003,060971526001003,"Block 1003, Block Group 1, Census Tract 1526, Sonoma County, California",0,0,0
1000000US060971526001004,060971526001004,"Block 1004, Block Group 1, Census Tract 1526, Sonoma County, California",0,0,0
1000000US060971526001005,060971526001005,"Block 1005, Block Group 1, Census Tract 1526, Sonoma County, California",0,0,0
1000000US060971526001006,060971526001006,"Block 1006, Block Group 1, Census Tract 1526, Sonoma County, California",3,3,0
1000000US060971526001007,060971526001007,"Block 1007, Block Group 1, Census Tract 1526, Sonoma County, California",25,22,3
1000000US060971526001008,060971526001008,"Block 1008, Block Group 1, Census Tract 1526, Sonoma County, California",6,6,0
1000000US060971526001009,060971526001009,"Block 1009, Block Group 1, Census Tract 1526, Sonoma County, California",0,0,0
1000000US060971526001010,060971526001010,"Block 1010, Block Group 1, Census Tract 1526, Sonoma County, California",1,1,0
1000000US060971526001011,060971526001011,"Block 1011, Block Group 1, Census Tract 1526, Sonoma County, California",6,3,3
1000000US060971526001012,060971526001012,"Block 1012, Block Group 1, Census Tract 1526, Sonoma County, California",56,46,10
1000000US060971526001013,060971526001013,"Block 1013, Block Group 1, Census Tract 1526, Sonoma County, California",48,41,7
1000000US060971526001014,060971526001014,"Block 1014, Block Group 1, Census Tract 1526, Sonoma County, California",5,5,0
1000000US060971526001015,060971526001015,"Block 1015, Block Group 1, Census Tract 1526, Sonoma County, California",2,1,1
1000000US060971526001016,060971526001016,"Block 1016, Block Group 1, Census Tract 1526, Sonoma County, California",1,0,1
1000000US060971526001017,060971526001017,"Block 1017, Block Group 1, Census Tract 1526, Sonoma County, California",0,0,0
1000000US060971526001018,060971526001018,"Block 1018, Block Group 1, Census Tract 1526, Sonoma County, California",126,122,4
1000000US060971526001019,060971526001019,"Block 1019, Block Group 1, Census Tract 1526, Sonoma County, California",80,72,8
1000000US060971526001020,060971526001020,"Block 1020, Block Group 1, Census Tract 1526, Sonoma County, California",2,2,0
1000000US060971526001021,060971526001021,"Block 1021, Block Group 1, Census Tract 1526, Sonoma County, California",0,0,0
1000000US060971526001022,060971526001022,"Block 1022, Block Group 1, Census Tract 1526, Sonoma County, California",2,2,0
1000000US060971526001023,060971526001023,"Block 1023, Block Group 1, Census Tract 1526, Sonoma County, California",0,0,0
1000000US060971526001024,060971526001024,"Block 1024, Block Group 1, Census Tract 1526, Sonoma County, California",0,0,0
1000000US060971526001025,060971526001025,"Block 1025, Block Group 1, Census Tract 1526, Sonoma County, California",1,1,0
1000000US060971526001026,060971526001026,"Block 1026, Block Group 1, Census Tract 1526, Sonoma County, California",1,1,0
1000000US060971526001027,060971526001027,"Block 1027, Block Group 1, Census Tract 1526, Sonoma County, California",32,30,2
1000000US060971526001028,060971526001028,"Block 1028, Block Group 1, Census Tract 1526, Sonoma County, California",0,0,0
1000000US060971526001029,060971526001029,"Block 1029, Block Group 1, Census Tract 1526, Sonoma County, California",4,3,1
1000000US060971526001030,060971526001030,"Block 1030, Block Group 1, Census Tract 1526, Sonoma County, California",1,1,0
1000000US060971526001031,060971526001031,"Block 1031, Block Group 1, Census Tract 1526, Sonoma County, California",30,27,3
1000000US060971526001032,060971526001032,"Block 1032, Block Group 1, Census Tract 1526, Sonoma County, California",0,0,0
1000000US060971526001033,060971526001033,"Block 1033, Block Group 1, Census Tract 1526, Sonoma County, California",3,3,0
1000000US060971526001034,060971526001034,"Block 1034, Block Group 1, Census Tract 1526, Sonoma County, California",5,5,0
1000000US060971526001035,060971526001035,"Block 1035, Block Group 1, Census Tract 1526, Sonoma County, California",0,0,0
1000000US060971526001036,060971526001036,"Block 1036, Block Group 1, Census Tract 1526, Sonoma County, California",2,2,0
1000000US060971526001037,060971526001037,"Block 1037, Block Group 1, Census Tract 1526, Sonoma County, California",0,0,0
1000000US060971526001038,060971526001038,"Block 1038, Block Group 1, Census Tract 1526, Sonoma County, California",0,0,0
1000000US060971526002000,060971526002000,"Block 2000, Block Group 2, Census Tract 1526, Sonoma County, California",25,25,0
1000000US060971526002001,060971526002001,"Block 2001, Block Group 2, Census Tract 1526, Sonoma County, California",0,0,0
1000000US060971526002002,060971526002002,"Block 2002, Block Group 2, Census Tract 1526, Sonoma County, California",5,4,1
1000000US060971526002003,060971526002003,"Block 2003, Block Group 2, Census Tract 1526, Sonoma County, California",5,5,0
1000000US060971526002004,060971526002004,"Block 2004, Block Group 2, Census Tract 1526, Sonoma County, California",3,3,0
1000000US060971526002005,060971526002005,"Block 2005, Block Group 2, Census Tract 1526, Sonoma County, California",20,18,2
1000000US060971526002006,060971526002006,"Block 2006, Block Group 2, Census Tract 1526, Sonoma County, California",28,25,3
1000000US060971526002007,060971526002007,"Block 2007, Block Group 2, Census Tract 1526, Sonoma County, California",16,15,1
1000000US060971526002008,060971526002008,"Block 2008, Block Group 2, Census Tract 1526, Sonoma County, California",0,0,0
1000000US060971526002009,060971526002009,"Block 2009, Block Group 2, Census Tract 1526, Sonoma County, California",2,1,1
1000000US060971526002010,060971526002010,"Block 2010, Block Group 2, Census Tract 1526, Sonoma County, California",35,34,1
1000000US060971526002011,060971526002011,"Block 2011, Block Group 2, Census Tract 1526, Sonoma County, California",0,0,0
1000000US060971526002012,060971526002012,"Block 2012, Block Group 2, Census Tract 1526, Sonoma County, California",0,0,0
1000000US060971526002013,060971526002013,"Block 2013, Block Group 2, Census Tract 1526, Sonoma County, California",0,0,0
1000000US060971526002014,060971526002014,"Block 2014, Block Group 2, Census Tract 1526, Sonoma County, California",0,0,0
1000000US060971526002015,060971526002015,"Block 2015, Block Group 2, Census Tract 1526, Sonoma County, California",0,0,0
1000000US060971526002016,060971526002016,"Block 2016, Block Group 2, Census Tract 1526, Sonoma County, California",6,4,2
1000000US060971526002017,060971526002017,"Block 2017, Block Group 2, Census Tract 1526, Sonoma County, California",3,3,0
1000000US060971526002018,060971526002018,"Block 2018, Block Group 2, Census Tract 1526, Sonoma County, California",111,111,0
1000000US060971526002019,060971526002019,"Block 2019, Block Group 2, Census Tract 1526, Sonoma County, California",0,0,0
1000000US060971526002020,060971526002020,"Block 2020, Block Group 2, Census Tract 1526, Sonoma County, California",0,0,0
1000000US060971526002021,060971526002021,"Block 2021, Block Group 2, Census Tract 1526, Sonoma County, California",70,69,1
1000000US060971526002022,060971526002022,"Block 2022, Block Group 2, Census Tract 1526, Sonoma County, California",4,3,1
1000000US060971526002023,060971526002023,"Block 2023, Block Group 2, Census Tract 1526, Sonoma County, California",122,119,3
1000000US060971526002024,060971526002024,"Block 2024, Block Group 2, Census Tract 1526, Sonoma County, California",1,1,0
1000000US060971526002025,060971526002025,"Block 2025, Block Group 2, Census Tract 1526, Sonoma County, California",0,0,0
1000000US060971526002026,060971526002026,"Block 2026, Block Group 2, Census Tract 1526, Sonoma County, California",0,0,0
1000000US060971526002027,060971526002027,"Block 2027, Block Group 2, Census Tract 1526, Sonoma County, California",0,0,0
1000000US060971526002028,060971526002028,"Block 2028, Block Group 2, Census Tract 1526, Sonoma County, California",0,0,0
1000000US060971526002029,060971526002029,"Block 2029, Block Group 2, Census Tract 1526, Sonoma County, California",5,5,0
1000000US060971526002030,060971526002030,"Block 2030, Block Group 2, Census Tract 1526, Sonoma County, California",5,5,0
1000000US060971526002031,060971526002031,"Block 2031, Block Group 2, Census Tract 1526, Sonoma County, California",92,90,2
1000000US060971526002032,060971526002032,"Block 2032, Block Group 2, Census Tract 1526, Sonoma County, California",25,23,2
1000000US060971526002033,060971526002033,"Block 2033, Block Group 2, Census Tract 1526, Sonoma County, California",72,68,4
1000000US060971526002034,060971526002034,"Block 2034, Block Group 2, Census Tract 1526, Sonoma County, California",18,18,0
1000000US060971526002035,060971526002035,"Block 2035, Block Group 2, Census Tract 1526, Sonoma County, California",17,17,0
1000000US060971526002036,060971526002036,"Block 2036, Block Group 2, Census Tract 1526, Sonoma County, California",20,18,2
1000000US060971526002037,060971526002037,"Block 2037, Block Group 2, Census Tract 1526, Sonoma County, California",10,10,0
1000000US060971526002038,060971526002038,"Block 2038, Block Group 2, Census Tract 1526, Sonoma County, California",20,20,0
1000000US060971526002039,060971526002039,"Block 2039, Block Group 2, Census Tract 1526, Sonoma County, California",42,39,3
1000000US060971526002040,060971526002040,"Block 2040, Block Group 2, Census Tract 1526, Sonoma County, California",24,24,0
1000000US060971526002041,060971526002041,"Block 2041, Block Group 2, Census Tract 1526, Sonoma County, California",32,31,1
1000000US060971526002042,060971526002042,"Block 2042, Block Group 2, Census Tract 1526, Sonoma County, California",21,21,0
1000000US060971526002043,060971526002043,"Block 2043, Block Group 2, Census Tract 1526, Sonoma County, California",38,38,0
1000000US060971526002044,060971526002044,"Block 2044, Block Group 2, Census Tract 1526, Sonoma County, California",19,17,2
1000000US060971526002045,060971526002045,"Block 2045, Block Group 2, Census Tract 1526, Sonoma County, California",30,29,1
1000000US060971526002046,060971526002046,"Block 2046, Block Group 2, Census Tract 1526, Sonoma County, California",0,0,0
1000000US060971526002047,060971526002047,"Block 2047, Block Group 2, Census Tract 1526, Sonoma County, California",4,4,0
1000000US060971526003000,060971526003000,"Block 3000, Block Group 3, Census Tract 1526, Sonoma County, California",58,54,4
1000000US060971526003001,060971526003001,"Block 3001, Block Group 3, Census Tract 1526, Sonoma County, California",28,28,0
1000000US060971526003002,060971526003002,"Block 3002, Block Group 3, Census Tract 1526, Sonoma County, California",16,16,0
1000000US060971526003003,060971526003003,"Block 3003, Block Group 3, Census Tract 1526, Sonoma County, California",20,20,0
1000000US060971526003004,060971526003004,"Block 3004, Block Group 3, Census Tract 1526, Sonoma County, California",27,27,0
1000000US060971526003005,060971526003005,"Block 3005, Block Group 3, Census Tract 1526, Sonoma County, California",12,11,1
1000000US060971526003006,060971526003006,"Block 3006, Block Group 3, Census Tract 1526, Sonoma County, California",33,30,3
1000000US060971526003007,060971526003007,"Block 3007, Block Group 3, Census Tract 1526, Sonoma County, California",47,43,4
1000000US060971526003008,060971526003008,"Block 3008, Block Group 3, Census Tract 1526, Sonoma County, California",63,60,3
1000000US060971526003009,060971526003009,"Block 3009, Block Group 3, Census Tract 1526, Sonoma County, California",9,9,0
1000000US060971526003010,060971526003010,"Block 3010, Block Group 3, Census Tract 1526, Sonoma County, California",0,0,0
1000000US060971526003011,060971526003011,"Block 3011, Block Group 3, Census Tract 1526, Sonoma County, California",0,0,0
1000000US060971526003012,060971526003012,"Block 3012, Block Group 3, Census Tract 1526, Sonoma County, California",20,18,2
1000000US060971526003013,060971526003013,"Block 3013, Block Group 3, Census Tract 1526, Sonoma County, California",72,72,0
1000000US060971526004000,060971526004000,"Block 4000, Block Group 4, Census Tract 1526, Sonoma County, California",50,48,2
1000000US060971526004001,060971526004001,"Block 4001, Block Group 4, Census Tract 1526, Sonoma County, California",39,38,1
1000000US060971526004002,060971526004002,"Block 4002, Block Group 4, Census Tract 1526, Sonoma County, California",9,9,0
1000000US060971526004003,060971526004003,"Block 4003, Block Group 4, Census Tract 1526, Sonoma County, California",0,0,0
1000000US060971526004004,060971526004004,"Block 4004, Block Group 4, Census Tract 1526, Sonoma County, California",52,52,0
1000000US060971526004005,060971526004005,"Block 4005, Block Group 4, Census Tract 1526, Sonoma County, California",0,0,0
1000000US060971526004006,060971526004006,"Block 4006, Block Group 4, Census Tract 1526, Sonoma County, California",51,48,3
1000000US060971526004007,060971526004007,"Block 4007, Block Group 4, Census Tract 1526, Sonoma County, California",32,32,0
1000000US060971526004008,060971526004008,"Block 4008, Block Group 4, Census Tract 1526, Sonoma County, California",35,35,0
1000000US060971526004009,060971526004009,"Block 4009, Block Group 4, Census Tract 1526, Sonoma County, California",12,12,0
1000000US060971526004010,060971526004010,"Block 4010, Block Group 4, Census Tract 1526, Sonoma County, California",57,55,2
1000000US060971526004011,060971526004011,"Block 4011, Block Group 4, Census Tract 1526, Sonoma County, California",43,43,0
1000000US060971526004012,060971526004012,"Block 4012, Block Group 4, Census Tract 1526, Sonoma County, California",44,44,0
1000000US060971526004013,060971526004013,"Block 4013, Block Group 4, Census Tract 1526, Sonoma County, California",46,46,0
1000000US060971526004014,060971526004014,"Block 4014, Block Group 4, Census Tract 1526, Sonoma County, California",28,28,0
1000000US060971526004015,060971526004015,"Block 4015, Block Group 4, Census Tract 1526, Sonoma County, California",18,18,0
1000000US060971526004016,060971526004016,"Block 4016, Block Group 4, Census Tract 1526, Sonoma County, California",0,0,0
1000000US060971526005000,060971526005000,"Block 5000, Block Group 5, Census Tract 1526, Sonoma County, California",59,42,17
1000000US060971526005001,060971526005001,"Block 5001, Block Group 5, Census Tract 1526, Sonoma County, California",0,0,0
1000000US060971526005002,060971526005002,"Block 5002, Block Group 5, Census Tract 1526, Sonoma County, California",3,3,0
1000000US060971526005003,060971526005003,"Block 5003, Block Group 5, Census Tract 1526, Sonoma County, California",21,5,16
1000000US060971526005004,060971526005004,"Block 5004, Block Group 5, Census Tract 1526, Sonoma County, California",25,19,6
1000000US060971526005005,060971526005005,"Block 5005, Block Group 5, Census Tract 1526, Sonoma County, California",0,0,0
1000000US060971526005006,060971526005006,"Block 5006, Block Group 5, Census Tract 1526, Sonoma County, California",8,8,0
1000000US060971526005007,060971526005007,"Block 5007, Block Group 5, Census Tract 1526, Sonoma County, California",1,0,1
1000000US060971526005008,060971526005008,"Block 5008, Block Group 5, Census Tract 1526, Sonoma County, California",4,4,0
1000000US060971526005009,060971526005009,"Block 5009, Block Group 5, Census Tract 1526, Sonoma County, California",1,0,1
1000000US060971526005010,060971526005010,"Block 5010, Block Group 5, Census Tract 1526, Sonoma County, California",0,0,0
1000000US060971526005011,060971526005011,"Block 5011, Block Group 5, Census Tract 1526, Sonoma County, California",0,0,0
1000000US060971526005012,060971526005012,"Block 5012, Block Group 5, Census Tract 1526, Sonoma County, California",0,0,0
1000000US060971526005013,060971526005013,"Block 5013, Block Group 5, Census Tract 1526, Sonoma County, California",18,11,7
1000000US060971526005014,060971526005014,"Block 5014, Block Group 5, Census Tract 1526, Sonoma County, California",0,0,0
1000000US060971526005015,060971526005015,"Block 5015, Block Group 5, Census Tract 1526, Sonoma County, California",0,0,0
1000000US060971526005016,060971526005016,"Block 5016, Block Group 5, Census Tract 1526, Sonoma County, California",4,4,0
1000000US060971526005017,060971526005017,"Block 5017, Block Group 5, Census Tract 1526, Sonoma County, California",3,2,1
1000000US060971526005018,060971526005018,"Block 5018, Block Group 5, Census Tract 1526, Sonoma County, California",3,3,0
1000000US060971526005019,060971526005019,"Block 5019, Block Group 5, Census Tract 1526, Sonoma County, California",0,0,0
1000000US060971526005020,060971526005020,"Block 5020, Block Group 5, Census Tract 1526, Sonoma County, California",24,20,4
1000000US060971526005021,060971526005021,"Block 5021, Block Group 5, Census Tract 1526, Sonoma County, California",4,2,2
1000000US060971526005022,060971526005022,"Block 5022, Block Group 5, Census Tract 1526, Sonoma County, California",23,13,10
1000000US060971526005023,060971526005023,"Block 5023, Block Group 5, Census Tract 1526, Sonoma County, California",0,0,0
1000000US060971526005024,060971526005024,"Block 5024, Block Group 5, Census Tract 1526, Sonoma County, California",2,2,0
1000000US060971526005025,060971526005025,"Block 5025, Block Group 5, Census Tract 1526, Sonoma County, California",0,0,0
1000000US060971526005026,060971526005026,"Block 5026, Block Group 5, Census Tract 1526, Sonoma County, California",10,8,2
1000000US060971526005027,060971526005027,"Block 5027, Block Group 5, Census Tract 1526, Sonoma County, California",51,40,11
1000000US060971526005028,060971526005028,"Block 5028, Block Group 5, Census Tract 1526, Sonoma County, California",0,0,0
1000000US060971526005029,060971526005029,"Block 5029, Block Group 5, Census Tract 1526, Sonoma County, California",0,0,0
1000000US060971526005030,060971526005030,"Block 5030, Block Group 5, Census Tract 1526, Sonoma County, California",0,0,0
1000000US060971526005031,060971526005031,"Block 5031, Block Group 5, Census Tract 1526, Sonoma County, California",0,0,0
1000000US060971526005032,060971526005032,"Block 5032, Block Group 5, Census Tract 1526, Sonoma County, California",6,2,4
1000000US060971526005033,060971526005033,"Block 5033, Block Group 5, Census Tract 1526, Sonoma County, California",20,16,4
1000000US060971526005034,060971526005034,"Block 5034, Block Group 5, Census Tract 1526, Sonoma County, California",40,35,5
1000000US060971526005035,060971526005035,"Block 5035, Block Group 5, Census Tract 1526, Sonoma County, California",2,2,0
1000000US060971526005036,060971526005036,"Block 5036, Block Group 5, Census Tract 1526, Sonoma County, California",1,1,0
1000000US060971526005037,060971526005037,"Block 5037, Block Group 5, Census Tract 1526, Sonoma County, California",3,3,0
1000000US060971526005038,060971526005038,"Block 5038, Block Group 5, Census Tract 1526, Sonoma County, California",1,1,0
1000000US060971526005039,060971526005039,"Block 5039, Block Group 5, Census Tract 1526, Sonoma County, California",50,29,21
1000000US060971526005040,060971526005040,"Block 5040, Block Group 5, Census Tract 1526, Sonoma County, California",0,0,0
1000000US060971526005041,060971526005041,"Block 5041, Block Group 5, Census Tract 1526, Sonoma County, California",4,3,1
1000000US060971526005042,060971526005042,"Block 5042, Block Group 5, Census Tract 1526, Sonoma County, California",7,6,1
1000000US060971526005043,060971526005043,"Block 5043, Block Group 5, Census Tract 1526, Sonoma County, California",0,0,0
1000000US060971526005044,060971526005044,"Block 5044, Block Group 5, Census Tract 1526, Sonoma County, California",0,0,0
1000000US060971526005045,060971526005045,"Block 5045, Block Group 5, Census Tract 1526, Sonoma County, California",0,0,0
1000000US060971526005046,060971526005046,"Block 5046, Block Group 5, Census Tract 1526, Sonoma County, California",6,3,3
1000000US060971526005047,060971526005047,"Block 5047, Block Group 5, Census Tract 1526, Sonoma County, California",2,1,1
1000000US060971526005048,060971526005048,"Block 5048, Block Group 5, Census Tract 1526, Sonoma County, California",0,0,0
1000000US060971526005049,060971526005049,"Block 5049, Block Group 5, Census Tract 1526, Sonoma County, California",0,0,0
1000000US060971526005050,060971526005050,"Block 5050, Block Group 5, Census Tract 1526, Sonoma County, California",0,0,0
1000000US060971526005051,060971526005051,"Block 5051, Block Group 5, Census Tract 1526, Sonoma County, California",0,0,0
1000000US060971526005052,060971526005052,"Block 5052, Block Group 5, Census Tract 1526, Sonoma County, California",2,2,0
1000000US060971526005053,060971526005053,"Block 5053, Block Group 5, Census Tract 1526, Sonoma County, California",21,12,9
1000000US060971526005054,060971526005054,"Block 5054, Block Group 5, Census Tract 1526, Sonoma County, California",5,4,1
1000000US060971526005055,060971526005055,"Block 5055, Block Group 5, Census Tract 1526, Sonoma County, California",25,23,2
1000000US060971526005056,060971526005056,"Block 5056, Block Group 5, Census Tract 1526, Sonoma County, California",2,2,0
1000000US060971526005057,060971526005057,"Block 5057, Block Group 5, Census Tract 1526, Sonoma County, California",4,4,0
1000000US060971526005058,060971526005058,"Block 5058, Block Group 5, Census Tract 1526, Sonoma County, California",2,1,1
1000000US060971526005059,060971526005059,"Block 5059, Block Group 5, Census Tract 1526, Sonoma County, California",17,14,3
1000000US060971526005060,060971526005060,"Block 5060, Block Group 5, Census Tract 1526, Sonoma County, California",4,4,0
1000000US060971526005061,060971526005061,"Block 5061, Block Group 5, Census Tract 1526, Sonoma County, California",0,0,0
1000000US060971526005062,060971526005062,"Block 5062, Block Group 5, Census Tract 1526, Sonoma County, California",0,0,0
1000000US060971526005063,060971526005063,"Block 5063, Block Group 5, Census Tract 1526, Sonoma County, California",34,28,6
1000000US060971526005064,060971526005064,"Block 5064, Block Group 5, Census Tract 1526, Sonoma County, California",18,14,4
1000000US060971526005065,060971526005065,"Block 5065, Block Group 5, Census Tract 1526, Sonoma County, California",0,0,0
1000000US060971526005066,060971526005066,"Block 5066, Block Group 5, Census Tract 1526, Sonoma County, California",0,0,0
1000000US060971526005067,060971526005067,"Block 5067, Block Group 5, Census Tract 1526, Sonoma County, California",0,0,0
1000000US060971526005068,060971526005068,"Block 5068, Block Group 5, Census Tract 1526, Sonoma County, California",2,2,0
1000000US060971526005069,060971526005069,"Block 5069, Block Group 5, Census Tract 1526, Sonoma County, California",0,0,0
1000000US060971526005070,060971526005070,"Block 5070, Block Group 5, Census Tract 1526, Sonoma County, California",3,3,0
1000000US060971526005071,060971526005071,"Block 5071, Block Group 5, Census Tract 1526, Sonoma County, California",7,6,1
1000000US060971526005072,060971526005072,"Block 5072, Block Group 5, Census Tract 1526, Sonoma County, California",0,0,0
1000000US060971526005073,060971526005073,"Block 5073, Block Group 5, Census Tract 1526, Sonoma County, California",8,7,1
1000000US060971526005074,060971526005074,"Block 5074, Block Group 5, Census Tract 1526, Sonoma County, California",0,0,0
1000000US060971526005075,060971526005075,"Block 5075, Block Group 5, Census Tract 1526, Sonoma County, California",0,0,0
1000000US060971526005076,060971526005076,"Block 5076, Block Group 5, Census Tract 1526, Sonoma County, California",14,13,1
1000000US060971526005077,060971526005077,"Block 5077, Block Group 5, Census Tract 1526, Sonoma County, California",17,15,2
1000000US060971526005078,060971526005078,"Block 5078, Block Group 5, Census Tract 1526, Sonoma County, California",21,19,2
1000000US060971526005079,060971526005079,"Block 5079, Block Group 5, Census Tract 1526, Sonoma County, California",2,2,0
1000000US060971526005080,060971526005080,"Block 5080, Block Group 5, Census Tract 1526, Sonoma County, California",0,0,0
1000000US060971526005081,060971526005081,"Block 5081, Block Group 5, Census Tract 1526, Sonoma County, California",0,0,0
1000000US060971526005082,060971526005082,"Block 5082, Block Group 5, Census Tract 1526, Sonoma County, California",0,0,0
1000000US060971526005083,060971526005083,"Block 5083, Block Group 5, Census Tract 1526, Sonoma County, California",0,0,0
1000000US060971526005084,060971526005084,"Block 5084, Block Group 5, Census Tract 1526, Sonoma County, California",7,6,1
1000000US060971526005085,060971526005085,"Block 5085, Block Group 5, Census Tract 1526, Sonoma County, California",0,0,0
1000000US060971526005086,060971526005086,"Block 5086, Block Group 5, Census Tract 1526, Sonoma County, California",0,0,0
1000000US060971526005087,060971526005087,"Block 5087, Block Group 5, Census Tract 1526, Sonoma County, California",1,1,0
1000000US060971526005088,060971526005088,"Block 5088, Block Group 5, Census Tract 1526, Sonoma County, California",5,5,0
1000000US060971526005089,060971526005089,"Block 5089, Block Group 5, Census Tract 1526, Sonoma County, California",12,10,2
1000000US060971526005090,060971526005090,"Block 5090, Block Group 5, Census Tract 1526, Sonoma County, California",0,0,0
1000000US060971526005091,060971526005091,"Block 5091, Block Group 5, Census Tract 1526, Sonoma County, California",0,0,0
1000000US060971526005092,060971526005092,"Block 5092, Block Group 5, Census Tract 1526, Sonoma County, California",0,0,0
1000000US060971526005093,060971526005093,"Block 5093, Block Group 5, Census Tract 1526, Sonoma County, California",94,87,7
1000000US060971526005094,060971526005094,"Block 5094, Block Group 5, Census Tract 1526, Sonoma County, California",29,29,0
1000000US060971526005095,060971526005095,"Block 5095, Block Group 5, Census Tract 1526, Sonoma County, California",0,0,0
1000000US060971526005096,060971526005096,"Block 5096, Block Group 5, Census Tract 1526, Sonoma County, California",4,4,0
1000000US060971526005097,060971526005097,"Block 5097, Block Group 5, Census Tract 1526, Sonoma County, California",0,0,0
1000000US060971526006000,060971526006000,"Block 6000, Block Group 6, Census Tract 1526, Sonoma County, California",23,21,2
1000000US060971526006001,060971526006001,"Block 6001, Block Group 6, Census Tract 1526, Sonoma County, California",13,13,0
1000000US060971526006002,060971526006002,"Block 6002, Block Group 6, Census Tract 1526, Sonoma County, California",40,40,0
1000000US060971526006003,060971526006003,"Block 6003, Block Group 6, Census Tract 1526, Sonoma County, California",20,20,0
1000000US060971526006004,060971526006004,"Block 6004, Block Group 6, Census Tract 1526, Sonoma County, California",26,26,0
1000000US060971526006005,060971526006005,"Block 6005, Block Group 6, Census Tract 1526, Sonoma County, California",22,20,2
1000000US060971526006006,060971526006006,"Block 6006, Block Group 6, Census Tract 1526, Sonoma County, California",38,38,0
1000000US060971526006007,060971526006007,"Block 6007, Block Group 6, Census Tract 1526, Sonoma County, California",15,15,0
1000000US060971526006008,060971526006008,"Block 6008, Block Group 6, Census Tract 1526, Sonoma County, California",16,15,1
1000000US060971526006009,060971526006009,"Block 6009, Block Group 6, Census Tract 1526, Sonoma County, California",16,15,1
1000000US060971526006010,060971526006010,"Block 6010, Block Group 6, Census Tract 1526, Sonoma County, California",28,27,1
1000000US060971527011000,060971527011000,"Block 1000, Block Group 1, Census Tract 1527.01, Sonoma County, California",5,4,1
1000000US060971527011001,060971527011001,"Block 1001, Block Group 1, Census Tract 1527.01, Sonoma County, California",1,1,0
1000000US060971527011002,060971527011002,"Block 1002, Block Group 1, Census Tract 1527.01, Sonoma County, California",80,57,23
1000000US060971527011003,060971527011003,"Block 1003, Block Group 1, Census Tract 1527.01, Sonoma County, California",2,1,1
1000000US060971527011004,060971527011004,"Block 1004, Block Group 1, Census Tract 1527.01, Sonoma County, California",0,0,0
1000000US060971527011005,060971527011005,"Block 1005, Block Group 1, Census Tract 1527.01, Sonoma County, California",0,0,0
1000000US060971527011006,060971527011006,"Block 1006, Block Group 1, Census Tract 1527.01, Sonoma County, California",1,1,0
1000000US060971527011007,060971527011007,"Block 1007, Block Group 1, Census Tract 1527.01, Sonoma County, California",0,0,0
1000000US060971527011008,060971527011008,"Block 1008, Block Group 1, Census Tract 1527.01, Sonoma County, California",0,0,0
1000000US060971527011009,060971527011009,"Block 1009, Block Group 1, Census Tract 1527.01, Sonoma County, California",7,2,5
1000000US060971527011010,060971527011010,"Block 1010, Block Group 1, Census Tract 1527.01, Sonoma County, California",1,1,0
1000000US060971527011011,060971527011011,"Block 1011, Block Group 1, Census Tract 1527.01, Sonoma County, California",21,20,1
1000000US060971527011012,060971527011012,"Block 1012, Block Group 1, Census Tract 1527.01, Sonoma County, California",0,0,0
1000000US060971527011013,060971527011013,"Block 1013, Block Group 1, Census Tract 1527.01, Sonoma County, California",1,1,0
1000000US060971527011014,060971527011014,"Block 1014, Block Group 1, Census Tract 1527.01, Sonoma County, California",263,249,14
1000000US060971527011015,060971527011015,"Block 1015, Block Group 1, Census Tract 1527.01, Sonoma County, California",0,0,0
1000000US060971527011016,060971527011016,"Block 1016, Block Group 1, Census Tract 1527.01, Sonoma County, California",2,2,0
1000000US060971527011017,060971527011017,"Block 1017, Block Group 1, Census Tract 1527.01, Sonoma County, California",9,8,1
1000000US060971527011018,060971527011018,"Block 1018, Block Group 1, Census Tract 1527.01, Sonoma County, California",0,0,0
1000000US060971527011019,060971527011019,"Block 1019, Block Group 1, Census Tract 1527.01, Sonoma County, California",12,11,1
1000000US060971527011020,060971527011020,"Block 1020, Block Group 1, Census Tract 1527.01, Sonoma County, California",28,25,3
1000000US060971527011021,060971527011021,"Block 1021, Block Group 1, Census Tract 1527.01, Sonoma County, California",40,40,0
1000000US060971527011022,060971527011022,"Block 1022, Block Group 1, Census Tract 1527.01, Sonoma County, California",3,2,1
1000000US060971527011023,060971527011023,"Block 1023, Block Group 1, Census Tract 1527.01, Sonoma County, California",6,6,0
1000000US060971527011024,060971527011024,"Block 1024, Block Group 1, Census Tract 1527.01, Sonoma County, California",53,51,2
1000000US060971527011025,060971527011025,"Block 1025, Block Group 1, Census Tract 1527.01, Sonoma County, California",0,0,0
1000000US060971527011026,060971527011026,"Block 1026, Block Group 1, Census Tract 1527.01, Sonoma County, California",0,0,0
1000000US060971527011027,060971527011027,"Block 1027, Block Group 1, Census Tract 1527.01, Sonoma County, California",1,0,1
1000000US060971527012000,060971527012000,"Block 2000, Block Group 2, Census Tract 1527.01, Sonoma County, California",36,35,1
1000000US060971527012001,060971527012001,"Block 2001, Block Group 2, Census Tract 1527.01, Sonoma County, California",106,101,5
1000000US060971527012002,060971527012002,"Block 2002, Block Group 2, Census Tract 1527.01, Sonoma County, California",25,25,0
1000000US060971527012003,060971527012003,"Block 2003, Block Group 2, Census Tract 1527.01, Sonoma County, California",140,130,10
1000000US060971527012004,060971527012004,"Block 2004, Block Group 2, Census Tract 1527.01, Sonoma County, California",21,18,3
1000000US060971527012005,060971527012005,"Block 2005, Block Group 2, Census Tract 1527.01, Sonoma County, California",16,16,0
1000000US060971527013000,060971527013000,"Block 3000, Block Group 3, Census Tract 1527.01, Sonoma County, California",51,51,0
1000000US060971527013001,060971527013001,"Block 3001, Block Group 3, Census Tract 1527.01, Sonoma County, California",215,211,4
1000000US060971527013002,060971527013002,"Block 3002, Block Group 3, Census Tract 1527.01, Sonoma County, California",25,25,0
1000000US060971527013003,060971527013003,"Block 3003, Block Group 3, Census Tract 1527.01, Sonoma County, California",31,30,1
1000000US060971527013004,060971527013004,"Block 3004, Block Group 3, Census Tract 1527.01, Sonoma County, California",25,22,3
1000000US060971527013005,060971527013005,"Block 3005, Block Group 3, Census Tract 1527.01, Sonoma County, California",49,47,2
1000000US060971527014000,060971527014000,"Block 4000, Block Group 4, Census Tract 1527.01, Sonoma County, California",0,0,0
1000000US060971527014001,060971527014001,"Block 4001, Block Group 4, Census Tract 1527.01, Sonoma County, California",176,163,13
1000000US060971527014002,060971527014002,"Block 4002, Block Group 4, Census Tract 1527.01, Sonoma County, California",65,65,0
1000000US060971527014003,060971527014003,"Block 4003, Block Group 4, Census Tract 1527.01, Sonoma County, California",101,94,7
1000000US060971527014004,060971527014004,"Block 4004, Block Group 4, Census Tract 1527.01, Sonoma County, California",8,8,0
1000000US060971527014005,060971527014005,"Block 4005, Block Group 4, Census Tract 1527.01, Sonoma County, California",7,6,1
1000000US060971527014006,060971527014006,"Block 4006, Block Group 4, Census Tract 1527.01, Sonoma County, California",8,7,1
1000000US060971527014007,060971527014007,"Block 4007, Block Group 4, Census Tract 1527.01, Sonoma County, California",14,14,0
1000000US060971527015000,060971527015000,"Block 5000, Block Group 5, Census Tract 1527.01, Sonoma County, California",0,0,0
1000000US060971527015001,060971527015001,"Block 5001, Block Group 5, Census Tract 1527.01, Sonoma County, California",213,196,17
1000000US060971527015002,060971527015002,"Block 5002, Block Group 5, Census Tract 1527.01, Sonoma County, California",35,31,4
1000000US060971527015003,060971527015003,"Block 5003, Block Group 5, Census Tract 1527.01, Sonoma County, California",54,50,4
1000000US060971527015004,060971527015004,"Block 5004, Block Group 5, Census Tract 1527.01, Sonoma County, California",5,4,1
1000000US060971527015005,060971527015005,"Block 5005, Block Group 5, Census Tract 1527.01, Sonoma County, California",22,20,2
1000000US060971527015006,060971527015006,"Block 5006, Block Group 5, Census Tract 1527.01, Sonoma County, California",0,0,0
1000000US060971527015007,060971527015007,"Block 5007, Block Group 5, Census Tract 1527.01, Sonoma County, California",19,18,1
1000000US060971527015008,060971527015008,"Block 5008, Block Group 5, Census Tract 1527.01, Sonoma County, California",13,12,1
1000000US060971527015009,060971527015009,"Block 5009, Block Group 5, Census Tract 1527.01, Sonoma County, California",0,0,0
1000000US060971527015010,060971527015010,"Block 5010, Block Group 5, Census Tract 1527.01, Sonoma County, California",0,0,0
1000000US060971527015011,060971527015011,"Block 5011, Block Group 5, Census Tract 1527.01, Sonoma County, California",0,0,0
1000000US060971527015012,060971527015012,"Block 5012, Block Group 5, Census Tract 1527.01, Sonoma County, California",25,25,0
1000000US060971527015013,060971527015013,"Block 5013, Block Group 5, Census Tract 1527.01, Sonoma County, California",37,35,2
1000000US060971527015014,060971527015014,"Block 5014, Block Group 5, Census Tract 1527.01, Sonoma County, California",83,81,2
1000000US060971527015015,060971527015015,"Block 5015, Block Group 5, Census Tract 1527.01, Sonoma County, California",0,0,0
1000000US060971527015016,060971527015016,"Block 5016, Block Group 5, Census Tract 1527.01, Sonoma County, California",0,0,0
1000000US060971527015017,060971527015017,"Block 5017, Block Group 5, Census Tract 1527.01, Sonoma County, California",9,7,2
1000000US060971527015018,060971527015018,"Block 5018, Block Group 5, Census Tract 1527.01, Sonoma County, California",52,50,2
1000000US060971527021000,060971527021000,"Block 1000, Block Group 1, Census Tract 1527.02, Sonoma County, California",1,1,0
1000000US060971527021001,060971527021001,"Block 1001, Block Group 1, Census Tract 1527.02, Sonoma County, California",0,0,0
1000000US060971527021002,060971527021002,"Block 1002, Block Group 1, Census Tract 1527.02, Sonoma County, California",2,1,1
1000000US060971527021003,060971527021003,"Block 1003, Block Group 1, Census Tract 1527.02, Sonoma County, California",8,7,1
1000000US060971527021004,060971527021004,"Block 1004, Block Group 1, Census Tract 1527.02, Sonoma County, California",10,10,0
1000000US060971527021005,060971527021005,"Block 1005, Block Group 1, Census Tract 1527.02, Sonoma County, California",15,14,1
1000000US060971527021006,060971527021006,"Block 1006, Block Group 1, Census Tract 1527.02, Sonoma County, California",0,0,0
1000000US060971527021007,060971527021007,"Block 1007, Block Group 1, Census Tract 1527.02, Sonoma County, California",0,0,0
1000000US060971527021008,060971527021008,"Block 1008, Block Group 1, Census Tract 1527.02, Sonoma County, California",0,0,0
1000000US060971527021009,060971527021009,"Block 1009, Block Group 1, Census Tract 1527.02, Sonoma County, California",0,0,0
1000000US060971527021010,060971527021010,"Block 1010, Block Group 1, Census Tract 1527.02, Sonoma County, California",0,0,0
1000000US060971527021011,060971527021011,"Block 1011, Block Group 1, Census Tract 1527.02, Sonoma County, California",6,4,2
1000000US060971527021012,060971527021012,"Block 1012, Block Group 1, Census Tract 1527.02, Sonoma County, California",0,0,0
1000000US060971527021013,060971527021013,"Block 1013, Block Group 1, Census Tract 1527.02, Sonoma County, California",0,0,0
1000000US060971527021014,060971527021014,"Block 1014, Block Group 1, Census Tract 1527.02, Sonoma County, California",0,0,0
1000000US060971527021015,060971527021015,"Block 1015, Block Group 1, Census Tract 1527.02, Sonoma County, California",0,0,0
1000000US060971527021016,060971527021016,"Block 1016, Block Group 1, Census Tract 1527.02, Sonoma County, California",0,0,0
1000000US060971527021017,060971527021017,"Block 1017, Block Group 1, Census Tract 1527.02, Sonoma County, California",2,2,0
1000000US060971527021018,060971527021018,"Block 1018, Block Group 1, Census Tract 1527.02, Sonoma County, California",0,0,0
1000000US060971527021019,060971527021019,"Block 1019, Block Group 1, Census Tract 1527.02, Sonoma County, California",0,0,0
1000000US060971527021020,060971527021020,"Block 1020, Block Group 1, Census Tract 1527.02, Sonoma County, California",0,0,0
1000000US060971527021021,060971527021021,"Block 1021, Block Group 1, Census Tract 1527.02, Sonoma County, California",0,0,0
1000000US060971527021022,060971527021022,"Block 1022, Block Group 1, Census Tract 1527.02, Sonoma County, California",0,0,0
1000000US060971527021023,060971527021023,"Block 1023, Block Group 1, Census Tract 1527.02, Sonoma County, California",18,17,1
1000000US060971527021024,060971527021024,"Block 1024, Block Group 1, Census Tract 1527.02, Sonoma County, California",3,3,0
1000000US060971527021025,060971527021025,"Block 1025, Block Group 1, Census Tract 1527.02, Sonoma County, California",6,5,1
1000000US060971527021026,060971527021026,"Block 1026, Block Group 1, Census Tract 1527.02, Sonoma County, California",0,0,0
1000000US060971527021027,060971527021027,"Block 1027, Block Group 1, Census Tract 1527.02, Sonoma County, California",0,0,0
1000000US060971527021028,060971527021028,"Block 1028, Block Group 1, Census Tract 1527.02, Sonoma County, California",7,5,2
1000000US060971527021029,060971527021029,"Block 1029, Block Group 1, Census Tract 1527.02, Sonoma County, California",0,0,0
1000000US060971527021030,060971527021030,"Block 1030, Block Group 1, Census Tract 1527.02, Sonoma County, California",21,21,0
1000000US060971527021031,060971527021031,"Block 1031, Block Group 1, Census Tract 1527.02, Sonoma County, California",0,0,0
1000000US060971527021032,060971527021032,"Block 1032, Block Group 1, Census Tract 1527.02, Sonoma County, California",2,2,0
1000000US060971527021033,060971527021033,"Block 1033, Block Group 1, Census Tract 1527.02, Sonoma County, California",0,0,0
1000000US060971527021034,060971527021034,"Block 1034, Block Group 1, Census Tract 1527.02, Sonoma County, California",5,5,0
1000000US060971527021035,060971527021035,"Block 1035, Block Group 1, Census Tract 1527.02, Sonoma County, California",0,0,0
1000000US060971527022000,060971527022000,"Block 2000, Block Group 2, Census Tract 1527.02, Sonoma County, California",19,19,0
1000000US060971527022001,060971527022001,"Block 2001, Block Group 2, Census Tract 1527.02, Sonoma County, California",359,343,16
1000000US060971527022002,060971527022002,"Block 2002, Block Group 2, Census Tract 1527.02, Sonoma County, California",0,0,0
1000000US060971527022003,060971527022003,"Block 2003, Block Group 2, Census Tract 1527.02, Sonoma County, California",9,9,0
1000000US060971527022004,060971527022004,"Block 2004, Block Group 2, Census Tract 1527.02, Sonoma County, California",46,46,0
1000000US060971527022005,060971527022005,"Block 2005, Block Group 2, Census Tract 1527.02, Sonoma County, California",109,101,8
1000000US060971527022006,060971527022006,"Block 2006, Block Group 2, Census Tract 1527.02, Sonoma County, California",0,0,0
1000000US060971527022007,060971527022007,"Block 2007, Block Group 2, Census Tract 1527.02, Sonoma County, California",0,0,0
1000000US060971527022008,060971527022008,"Block 2008, Block Group 2, Census Tract 1527.02, Sonoma County, California",0,0,0
1000000US060971527022009,060971527022009,"Block 2009, Block Group 2, Census Tract 1527.02, Sonoma County, California",1,1,0
1000000US060971527022010,060971527022010,"Block 2010, Block Group 2, Census Tract 1527.02, Sonoma County, California",0,0,0
1000000US060971527022011,060971527022011,"Block 2011, Block Group 2, Census Tract 1527.02, Sonoma County, California",0,0,0
1000000US060971527022012,060971527022012,"Block 2012, Block Group 2, Census Tract 1527.02, Sonoma County, California",0,0,0
1000000US060971527022013,060971527022013,"Block 2013, Block Group 2, Census Tract 1527.02, Sonoma County, California",1,0,1
1000000US060971527022014,060971527022014,"Block 2014, Block Group 2, Census Tract 1527.02, Sonoma County, California",0,0,0
1000000US060971527022015,060971527022015,"Block 2015, Block Group 2, Census Tract 1527.02, Sonoma County, California",0,0,0
1000000US060971527022016,060971527022016,"Block 2016, Block Group 2, Census Tract 1527.02, Sonoma County, California",0,0,0
1000000US060971527022017,060971527022017,"Block 2017, Block Group 2, Census Tract 1527.02, Sonoma County, California",0,0,0
1000000US060971527022018,060971527022018,"Block 2018, Block Group 2, Census Tract 1527.02, Sonoma County, California",0,0,0
1000000US060971527022019,060971527022019,"Block 2019, Block Group 2, Census Tract 1527.02, Sonoma County, California",0,0,0
1000000US060971527022020,060971527022020,"Block 2020, Block Group 2, Census Tract 1527.02, Sonoma County, California",0,0,0
1000000US060971527022021,060971527022021,"Block 2021, Block Group 2, Census Tract 1527.02, Sonoma County, California",0,0,0
1000000US060971527022022,060971527022022,"Block 2022, Block Group 2, Census Tract 1527.02, Sonoma County, California",0,0,0
1000000US060971527022023,060971527022023,"Block 2023, Block Group 2, Census Tract 1527.02, Sonoma County, California",0,0,0
1000000US060971527023000,060971527023000,"Block 3000, Block Group 3, Census Tract 1527.02, Sonoma County, California",70,70,0
1000000US060971527023001,060971527023001,"Block 3001, Block Group 3, Census Tract 1527.02, Sonoma County, California",39,38,1
1000000US060971527023002,060971527023002,"Block 3002, Block Group 3, Census Tract 1527.02, Sonoma County, California",5,5,0
1000000US060971527023003,060971527023003,"Block 3003, Block Group 3, Census Tract 1527.02, Sonoma County, California",47,46,1
1000000US060971527023004,060971527023004,"Block 3004, Block Group 3, Census Tract 1527.02, Sonoma County, California",18,18,0
1000000US060971527023005,060971527023005,"Block 3005, Block Group 3, Census Tract 1527.02, Sonoma County, California",38,37,1
1000000US060971527023006,060971527023006,"Block 3006, Block Group 3, Census Tract 1527.02, Sonoma County, California",36,35,1
1000000US060971527023007,060971527023007,"Block 3007, Block Group 3, Census Tract 1527.02, Sonoma County, California",52,52,0
1000000US060971527023008,060971527023008,"Block 3008, Block Group 3, Census Tract 1527.02, Sonoma County, California",15,15,0
1000000US060971527024000,060971527024000,"Block 4000, Block Group 4, Census Tract 1527.02, Sonoma County, California",0,0,0
1000000US060971527024001,060971527024001,"Block 4001, Block Group 4, Census Tract 1527.02, Sonoma County, California",0,0,0
1000000US060971527024002,060971527024002,"Block 4002, Block Group 4, Census Tract 1527.02, Sonoma County, California",0,0,0
1000000US060971527024003,060971527024003,"Block 4003, Block Group 4, Census Tract 1527.02, Sonoma County, California",3,3,0
1000000US060971527024004,060971527024004,"Block 4004, Block Group 4, Census Tract 1527.02, Sonoma County, California",0,0,0
1000000US060971527024005,060971527024005,"Block 4005, Block Group 4, Census Tract 1527.02, Sonoma County, California",0,0,0
1000000US060971527024006,060971527024006,"Block 4006, Block Group 4, Census Tract 1527.02, Sonoma County, California",0,0,0
1000000US060971527024007,060971527024007,"Block 4007, Block Group 4, Census Tract 1527.02, Sonoma County, California",0,0,0
1000000US060971527024008,060971527024008,"Block 4008, Block Group 4, Census Tract 1527.02, Sonoma County, California",0,0,0
1000000US060971527024009,060971527024009,"Block 4009, Block Group 4, Census Tract 1527.02, Sonoma County, California",1,1,0
1000000US060971527024010,060971527024010,"Block 4010, Block Group 4, Census Tract 1527.02, Sonoma County, California",0,0,0
1000000US060971527024011,060971527024011,"Block 4011, Block Group 4, Census Tract 1527.02, Sonoma County, California",0,0,0
1000000US060971527024012,060971527024012,"Block 4012, Block Group 4, Census Tract 1527.02, Sonoma County, California",0,0,0
1000000US060971527024013,060971527024013,"Block 4013, Block Group 4, Census Tract 1527.02, Sonoma County, California",118,110,8
1000000US060971527024014,060971527024014,"Block 4014, Block Group 4, Census Tract 1527.02, Sonoma County, California",74,69,5
1000000US060971527024015,060971527024015,"Block 4015, Block Group 4, Census Tract 1527.02, Sonoma County, California",20,20,0
1000000US060971527024016,060971527024016,"Block 4016, Block Group 4, Census Tract 1527.02, Sonoma County, California",94,91,3
1000000US060971527024017,060971527024017,"Block 4017, Block Group 4, Census Tract 1527.02, Sonoma County, California",0,0,0
1000000US060971527024018,060971527024018,"Block 4018, Block Group 4, Census Tract 1527.02, Sonoma County, California",0,0,0
1000000US060971527024019,060971527024019,"Block 4019, Block Group 4, Census Tract 1527.02, Sonoma County, California",0,0,0
1000000US060971527024020,060971527024020,"Block 4020, Block Group 4, Census Tract 1527.02, Sonoma County, California",0,0,0
1000000US060971527024021,060971527024021,"Block 4021, Block Group 4, Census Tract 1527.02, Sonoma County, California",1,1,0
1000000US060971527024022,060971527024022,"Block 4022, Block Group 4, Census Tract 1527.02, Sonoma County, California",0,0,0
1000000US060971527024023,060971527024023,"Block 4023, Block Group 4, Census Tract 1527.02, Sonoma County, California",0,0,0
1000000US060971527024024,060971527024024,"Block 4024, Block Group 4, Census Tract 1527.02, Sonoma County, California",0,0,0
1000000US060971527024025,060971527024025,"Block 4025, Block Group 4, Census Tract 1527.02, Sonoma County, California",0,0,0
1000000US060971527024026,060971527024026,"Block 4026, Block Group 4, Census Tract 1527.02, Sonoma County, California",57,56,1
1000000US060971527024027,060971527024027,"Block 4027, Block Group 4, Census Tract 1527.02, Sonoma County, California",82,79,3
1000000US060971527024028,060971527024028,"Block 4028, Block Group 4, Census Tract 1527.02, Sonoma County, California",13,11,2
1000000US060971527024029,060971527024029,"Block 4029, Block Group 4, Census Tract 1527.02, Sonoma County, California",46,44,2
1000000US060971527024030,060971527024030,"Block 4030, Block Group 4, Census Tract 1527.02, Sonoma County, California",12,12,0
1000000US060971527024031,060971527024031,"Block 4031, Block Group 4, Census Tract 1527.02, Sonoma County, California",26,26,0
1000000US060971527024032,060971527024032,"Block 4032, Block Group 4, Census Tract 1527.02, Sonoma County, California",38,37,1
1000000US060971527024033,060971527024033,"Block 4033, Block Group 4, Census Tract 1527.02, Sonoma County, California",6,6,0
1000000US060971527024034,060971527024034,"Block 4034, Block Group 4, Census Tract 1527.02, Sonoma County, California",0,0,0
1000000US060971527024035,060971527024035,"Block 4035, Block Group 4, Census Tract 1527.02, Sonoma County, California",0,0,0
1000000US060971527024036,060971527024036,"Block 4036, Block Group 4, Census Tract 1527.02, Sonoma County, California",0,0,0
1000000US060971527024037,060971527024037,"Block 4037, Block Group 4, Census Tract 1527.02, Sonoma County, California",0,0,0
1000000US060971527024038,060971527024038,"Block 4038, Block Group 4, Census Tract 1527.02, Sonoma County, California",5,4,1
1000000US060971527024039,060971527024039,"Block 4039, Block Group 4, Census Tract 1527.02, Sonoma County, California",0,0,0
1000000US060971527024040,060971527024040,"Block 4040, Block Group 4, Census Tract 1527.02, Sonoma County, California",0,0,0
1000000US060971527024041,060971527024041,"Block 4041, Block Group 4, Census Tract 1527.02, Sonoma County, California",0,0,0
1000000US060971527024042,060971527024042,"Block 4042, Block Group 4, Census Tract 1527.02, Sonoma County, California",0,0,0
1000000US060971527024043,060971527024043,"Block 4043, Block Group 4, Census Tract 1527.02, Sonoma County, California",0,0,0
1000000US060971527024044,060971527024044,"Block 4044, Block Group 4, Census Tract 1527.02, Sonoma County, California",0,0,0
1000000US060971527024045,060971527024045,"Block 4045, Block Group 4, Census Tract 1527.02, Sonoma County, California",0,0,0
1000000US060971527024046,060971527024046,"Block 4046, Block Group 4, Census Tract 1527.02, Sonoma County, California",16,16,0
1000000US060971527024047,060971527024047,"Block 4047, Block Group 4, Census Tract 1527.02, Sonoma County, California",186,173,13
1000000US060971527024048,060971527024048,"Block 4048, Block Group 4, Census Tract 1527.02, Sonoma County, California",14,14,0
1000000US060971527024049,060971527024049,"Block 4049, Block Group 4, Census Tract 1527.02, Sonoma County, California",0,0,0
1000000US060971527024050,060971527024050,"Block 4050, Block Group 4, Census Tract 1527.02, Sonoma County, California",8,8,0
1000000US060971527024051,060971527024051,"Block 4051, Block Group 4, Census Tract 1527.02, Sonoma County, California",0,0,0
1000000US060971527025000,060971527025000,"Block 5000, Block Group 5, Census Tract 1527.02, Sonoma County, California",35,34,1
1000000US060971527025001,060971527025001,"Block 5001, Block Group 5, Census Tract 1527.02, Sonoma County, California",37,37,0
1000000US060971527025002,060971527025002,"Block 5002, Block Group 5, Census Tract 1527.02, Sonoma County, California",35,33,2
1000000US060971527025003,060971527025003,"Block 5003, Block Group 5, Census Tract 1527.02, Sonoma County, California",26,24,2
1000000US060971527025004,060971527025004,"Block 5004, Block Group 5, Census Tract 1527.02, Sonoma County, California",8,8,0
1000000US060971527025005,060971527025005,"Block 5005, Block Group 5, Census Tract 1527.02, Sonoma County, California",27,27,0
1000000US060971527025006,060971527025006,"Block 5006, Block Group 5, Census Tract 1527.02, Sonoma County, California",16,16,0
1000000US060971527025007,060971527025007,"Block 5007, Block Group 5, Census Tract 1527.02, Sonoma County, California",17,16,1
1000000US060971527025008,060971527025008,"Block 5008, Block Group 5, Census Tract 1527.02, Sonoma County, California",0,0,0
1000000US060971527025009,060971527025009,"Block 5009, Block Group 5, Census Tract 1527.02, Sonoma County, California",0,0,0
1000000US060971527025010,060971527025010,"Block 5010, Block Group 5, Census Tract 1527.02, Sonoma County, California",0,0,0
1000000US060971527025011,060971527025011,"Block 5011, Block Group 5, Census Tract 1527.02, Sonoma County, California",0,0,0
1000000US060971527025012,060971527025012,"Block 5012, Block Group 5, Census Tract 1527.02, Sonoma County, California",0,0,0
1000000US060971528011000,060971528011000,"Block 1000, Block Group 1, Census Tract 1528.01, Sonoma County, California",44,43,1
1000000US060971528011001,060971528011001,"Block 1001, Block Group 1, Census Tract 1528.01, Sonoma County, California",15,14,1
1000000US060971528011002,060971528011002,"Block 1002, Block Group 1, Census Tract 1528.01, Sonoma County, California",5,5,0
1000000US060971528011003,060971528011003,"Block 1003, Block Group 1, Census Tract 1528.01, Sonoma County, California",14,12,2
1000000US060971528011004,060971528011004,"Block 1004, Block Group 1, Census Tract 1528.01, Sonoma County, California",4,4,0
1000000US060971528011005,060971528011005,"Block 1005, Block Group 1, Census Tract 1528.01, Sonoma County, California",6,5,1
1000000US060971528011006,060971528011006,"Block 1006, Block Group 1, Census Tract 1528.01, Sonoma County, California",0,0,0
1000000US060971528011007,060971528011007,"Block 1007, Block Group 1, Census Tract 1528.01, Sonoma County, California",6,4,2
1000000US060971528011008,060971528011008,"Block 1008, Block Group 1, Census Tract 1528.01, Sonoma County, California",1,1,0
1000000US060971528011009,060971528011009,"Block 1009, Block Group 1, Census Tract 1528.01, Sonoma County, California",0,0,0
1000000US060971528011010,060971528011010,"Block 1010, Block Group 1, Census Tract 1528.01, Sonoma County, California",190,186,4
1000000US060971528011011,060971528011011,"Block 1011, Block Group 1, Census Tract 1528.01, Sonoma County, California",68,67,1
1000000US060971528011012,060971528011012,"Block 1012, Block Group 1, Census Tract 1528.01, Sonoma County, California",23,23,0
1000000US060971528011013,060971528011013,"Block 1013, Block Group 1, Census Tract 1528.01, Sonoma County, California",7,6,1
1000000US060971528011014,060971528011014,"Block 1014, Block Group 1, Census Tract 1528.01, Sonoma County, California",14,13,1
1000000US060971528011015,060971528011015,"Block 1015, Block Group 1, Census Tract 1528.01, Sonoma County, California",2,2,0
1000000US060971528011016,060971528011016,"Block 1016, Block Group 1, Census Tract 1528.01, Sonoma County, California",0,0,0
1000000US060971528011017,060971528011017,"Block 1017, Block Group 1, Census Tract 1528.01, Sonoma County, California",0,0,0
1000000US060971528011018,060971528011018,"Block 1018, Block Group 1, Census Tract 1528.01, Sonoma County, California",0,0,0
1000000US060971528011019,060971528011019,"Block 1019, Block Group 1, Census Tract 1528.01, Sonoma County, California",0,0,0
1000000US060971528011020,060971528011020,"Block 1020, Block Group 1, Census Tract 1528.01, Sonoma County, California",0,0,0
1000000US060971528011021,060971528011021,"Block 1021, Block Group 1, Census Tract 1528.01, Sonoma County, California",0,0,0
1000000US060971528011022,060971528011022,"Block 1022, Block Group 1, Census Tract 1528.01, Sonoma County, California",0,0,0
1000000US060971528011023,060971528011023,"Block 1023, Block Group 1, Census Tract 1528.01, Sonoma County, California",0,0,0
1000000US060971528011024,060971528011024,"Block 1024, Block Group 1, Census Tract 1528.01, Sonoma County, California",0,0,0
1000000US060971528011025,060971528011025,"Block 1025, Block Group 1, Census Tract 1528.01, Sonoma County, California",0,0,0
1000000US060971528011026,060971528011026,"Block 1026, Block Group 1, Census Tract 1528.01, Sonoma County, California",48,46,2
1000000US060971528011027,060971528011027,"Block 1027, Block Group 1, Census Tract 1528.01, Sonoma County, California",20,19,1
1000000US060971528011028,060971528011028,"Block 1028, Block Group 1, Census Tract 1528.01, Sonoma County, California",10,10,0
1000000US060971528011029,060971528011029,"Block 1029, Block Group 1, Census Tract 1528.01, Sonoma County, California",26,25,1
1000000US060971528011030,060971528011030,"Block 1030, Block Group 1, Census Tract 1528.01, Sonoma County, California",0,0,0
1000000US060971528011031,060971528011031,"Block 1031, Block Group 1, Census Tract 1528.01, Sonoma County, California",14,14,0
1000000US060971528011032,060971528011032,"Block 1032, Block Group 1, Census Tract 1528.01, Sonoma County, California",0,0,0
1000000US060971528011033,060971528011033,"Block 1033, Block Group 1, Census Tract 1528.01, Sonoma County, California",14,13,1
1000000US060971528011034,060971528011034,"Block 1034, Block Group 1, Census Tract 1528.01, Sonoma County, California",10,10,0
1000000US060971528012000,060971528012000,"Block 2000, Block Group 2, Census Tract 1528.01, Sonoma County, California",1,1,0
1000000US060971528012001,060971528012001,"Block 2001, Block Group 2, Census Tract 1528.01, Sonoma County, California",4,3,1
1000000US060971528012002,060971528012002,"Block 2002, Block Group 2, Census Tract 1528.01, Sonoma County, California",17,16,1
1000000US060971528012003,060971528012003,"Block 2003, Block Group 2, Census Tract 1528.01, Sonoma County, California",146,145,1
1000000US060971528012004,060971528012004,"Block 2004, Block Group 2, Census Tract 1528.01, Sonoma County, California",45,45,0
1000000US060971528012005,060971528012005,"Block 2005, Block Group 2, Census Tract 1528.01, Sonoma County, California",95,94,1
1000000US060971528012006,060971528012006,"Block 2006, Block Group 2, Census Tract 1528.01, Sonoma County, California",17,17,0
1000000US060971528012007,060971528012007,"Block 2007, Block Group 2, Census Tract 1528.01, Sonoma County, California",11,11,0
1000000US060971528012008,060971528012008,"Block 2008, Block Group 2, Census Tract 1528.01, Sonoma County, California",55,53,2
1000000US060971528012009,060971528012009,"Block 2009, Block Group 2, Census Tract 1528.01, Sonoma County, California",18,17,1
1000000US060971528012010,060971528012010,"Block 2010, Block Group 2, Census Tract 1528.01, Sonoma County, California",42,40,2
1000000US060971528012011,060971528012011,"Block 2011, Block Group 2, Census Tract 1528.01, Sonoma County, California",8,8,0
1000000US060971528013000,060971528013000,"Block 3000, Block Group 3, Census Tract 1528.01, Sonoma County, California",16,14,2
1000000US060971528013001,060971528013001,"Block 3001, Block Group 3, Census Tract 1528.01, Sonoma County, California",0,0,0
1000000US060971528013002,060971528013002,"Block 3002, Block Group 3, Census Tract 1528.01, Sonoma County, California",50,50,0
1000000US060971528013003,060971528013003,"Block 3003, Block Group 3, Census Tract 1528.01, Sonoma County, California",1,1,0
1000000US060971528013004,060971528013004,"Block 3004, Block Group 3, Census Tract 1528.01, Sonoma County, California",98,96,2
1000000US060971528013005,060971528013005,"Block 3005, Block Group 3, Census Tract 1528.01, Sonoma County, California",13,13,0
1000000US060971528013006,060971528013006,"Block 3006, Block Group 3, Census Tract 1528.01, Sonoma County, California",55,55,0
1000000US060971528013007,060971528013007,"Block 3007, Block Group 3, Census Tract 1528.01, Sonoma County, California",0,0,0
1000000US060971528013008,060971528013008,"Block 3008, Block Group 3, Census Tract 1528.01, Sonoma County, California",16,15,1
1000000US060971528013009,060971528013009,"Block 3009, Block Group 3, Census Tract 1528.01, Sonoma County, California",23,23,0
1000000US060971528013010,060971528013010,"Block 3010, Block Group 3, Census Tract 1528.01, Sonoma County, California",26,26,0
1000000US060971528013011,060971528013011,"Block 3011, Block Group 3, Census Tract 1528.01, Sonoma County, California",51,50,1
1000000US060971528013012,060971528013012,"Block 3012, Block Group 3, Census Tract 1528.01, Sonoma County, California",31,31,0
1000000US060971528013013,060971528013013,"Block 3013, Block Group 3, Census Tract 1528.01, Sonoma County, California",8,8,0
1000000US060971528013014,060971528013014,"Block 3014, Block Group 3, Census Tract 1528.01, Sonoma County, California",27,27,0
1000000US060971528014000,060971528014000,"Block 4000, Block Group 4, Census Tract 1528.01, Sonoma County, California",9,8,1
1000000US060971528014001,060971528014001,"Block 4001, Block Group 4, Census Tract 1528.01, Sonoma County, California",98,94,4
1000000US060971528014002,060971528014002,"Block 4002, Block Group 4, Census Tract 1528.01, Sonoma County, California",27,27,0
1000000US060971528014003,060971528014003,"Block 4003, Block Group 4, Census Tract 1528.01, Sonoma County, California",53,51,2
1000000US060971528014004,060971528014004,"Block 4004, Block Group 4, Census Tract 1528.01, Sonoma County, California",19,19,0
1000000US060971528014005,060971528014005,"Block 4005, Block Group 4, Census Tract 1528.01, Sonoma County, California",10,10,0
1000000US060971528015000,060971528015000,"Block 5000, Block Group 5, Census Tract 1528.01, Sonoma County, California",13,13,0
1000000US060971528015001,060971528015001,"Block 5001, Block Group 5, Census Tract 1528.01, Sonoma County, California",24,22,2
1000000US060971528015002,060971528015002,"Block 5002, Block Group 5, Census Tract 1528.01, Sonoma County, California",48,47,1
1000000US060971528015003,060971528015003,"Block 5003, Block Group 5, Census Tract 1528.01, Sonoma County, California",39,39,0
1000000US060971528015004,060971528015004,"Block 5004, Block Group 5, Census Tract 1528.01, Sonoma County, California",40,40,0
1000000US060971528015005,060971528015005,"Block 5005, Block Group 5, Census Tract 1528.01, Sonoma County, California",52,52,0
1000000US060971528015006,060971528015006,"Block 5006, Block Group 5, Census Tract 1528.01, Sonoma County, California",19,19,0
1000000US060971528015007,060971528015007,"Block 5007, Block Group 5, Census Tract 1528.01, Sonoma County, California",33,32,1
1000000US060971528015008,060971528015008,"Block 5008, Block Group 5, Census Tract 1528.01, Sonoma County, California",49,49,0
1000000US060971528015009,060971528015009,"Block 5009, Block Group 5, Census Tract 1528.01, Sonoma County, California",0,0,0
1000000US060971528015010,060971528015010,"Block 5010, Block Group 5, Census Tract 1528.01, Sonoma County, California",4,4,0
1000000US060971528015011,060971528015011,"Block 5011, Block Group 5, Census Tract 1528.01, Sonoma County, California",28,27,1
1000000US060971528015012,060971528015012,"Block 5012, Block Group 5, Census Tract 1528.01, Sonoma County, California",4,4,0
1000000US060971528015013,060971528015013,"Block 5013, Block Group 5, Census Tract 1528.01, Sonoma County, California",33,33,0
1000000US060971528015014,060971528015014,"Block 5014, Block Group 5, Census Tract 1528.01, Sonoma County, California",0,0,0
1000000US060971528015015,060971528015015,"Block 5015, Block Group 5, Census Tract 1528.01, Sonoma County, California",0,0,0
1000000US060971528015016,060971528015016,"Block 5016, Block Group 5, Census Tract 1528.01, Sonoma County, California",0,0,0
1000000US060971528021000,060971528021000,"Block 1000, Block Group 1, Census Tract 1528.02, Sonoma County, California",0,0,0
1000000US060971528021001,060971528021001,"Block 1001, Block Group 1, Census Tract 1528.02, Sonoma County, California",0,0,0
1000000US060971528021002,060971528021002,"Block 1002, Block Group 1, Census Tract 1528.02, Sonoma County, California",0,0,0
1000000US060971528021003,060971528021003,"Block 1003, Block Group 1, Census Tract 1528.02, Sonoma County, California",0,0,0
1000000US060971528021004,060971528021004,"Block 1004, Block Group 1, Census Tract 1528.02, Sonoma County, California",206,201,5
1000000US060971528021005,060971528021005,"Block 1005, Block Group 1, Census Tract 1528.02, Sonoma County, California",310,282,28
1000000US060971528022000,060971528022000,"Block 2000, Block Group 2, Census Tract 1528.02, Sonoma County, California",13,13,0
1000000US060971528022001,060971528022001,"Block 2001, Block Group 2, Census Tract 1528.02, Sonoma County, California",216,199,17
1000000US060971528022002,060971528022002,"Block 2002, Block Group 2, Census Tract 1528.02, Sonoma County, California",247,236,11
1000000US060971528022003,060971528022003,"Block 2003, Block Group 2, Census Tract 1528.02, Sonoma County, California",64,59,5
1000000US060971528022004,060971528022004,"Block 2004, Block Group 2, Census Tract 1528.02, Sonoma County, California",29,25,4
1000000US060971528022005,060971528022005,"Block 2005, Block Group 2, Census Tract 1528.02, Sonoma County, California",0,0,0
1000000US060971528022006,060971528022006,"Block 2006, Block Group 2, Census Tract 1528.02, Sonoma County, California",0,0,0
1000000US060971528022007,060971528022007,"Block 2007, Block Group 2, Census Tract 1528.02, Sonoma County, California",79,72,7
1000000US060971528022008,060971528022008,"Block 2008, Block Group 2, Census Tract 1528.02, Sonoma County, California",97,92,5
1000000US060971528022009,060971528022009,"Block 2009, Block Group 2, Census Tract 1528.02, Sonoma County, California",249,177,72
1000000US060971528022010,060971528022010,"Block 2010, Block Group 2, Census Tract 1528.02, Sonoma County, California",0,0,0
1000000US060971528022011,060971528022011,"Block 2011, Block Group 2, Census Tract 1528.02, Sonoma County, California",0,0,0
1000000US060971528022012,060971528022012,"Block 2012, Block Group 2, Census Tract 1528.02, Sonoma County, California",0,0,0
1000000US060971528023000,060971528023000,"Block 3000, Block Group 3, Census Tract 1528.02, Sonoma County, California",0,0,0
1000000US060971528023001,060971528023001,"Block 3001, Block Group 3, Census Tract 1528.02, Sonoma County, California",0,0,0
1000000US060971528023002,060971528023002,"Block 3002, Block Group 3, Census Tract 1528.02, Sonoma County, California",79,76,3
1000000US060971528023003,060971528023003,"Block 3003, Block Group 3, Census Tract 1528.02, Sonoma County, California",160,153,7
1000000US060971528023004,060971528023004,"Block 3004, Block Group 3, Census Tract 1528.02, Sonoma County, California",53,50,3
1000000US060971528023005,060971528023005,"Block 3005, Block Group 3, Census Tract 1528.02, Sonoma County, California",8,8,0
1000000US060971528023006,060971528023006,"Block 3006, Block Group 3, Census Tract 1528.02, Sonoma County, California",84,82,2
1000000US060971528023007,060971528023007,"Block 3007, Block Group 3, Census Tract 1528.02, Sonoma County, California",19,18,1
1000000US060971528023008,060971528023008,"Block 3008, Block Group 3, Census Tract 1528.02, Sonoma County, California",0,0,0
1000000US060971528023009,060971528023009,"Block 3009, Block Group 3, Census Tract 1528.02, Sonoma County, California",0,0,0
1000000US060971528024000,060971528024000,"Block 4000, Block Group 4, Census Tract 1528.02, Sonoma County, California",18,17,1
1000000US060971528024001,060971528024001,"Block 4001, Block Group 4, Census Tract 1528.02, Sonoma County, California",38,37,1
1000000US060971528024002,060971528024002,"Block 4002, Block Group 4, Census Tract 1528.02, Sonoma County, California",0,0,0
1000000US060971528024003,060971528024003,"Block 4003, Block Group 4, Census Tract 1528.02, Sonoma County, California",0,0,0
1000000US060971528024004,060971528024004,"Block 4004, Block Group 4, Census Tract 1528.02, Sonoma County, California",0,0,0
1000000US060971528024005,060971528024005,"Block 4005, Block Group 4, Census Tract 1528.02, Sonoma County, California",30,29,1
1000000US060971528024006,060971528024006,"Block 4006, Block Group 4, Census Tract 1528.02, Sonoma County, California",18,18,0
1000000US060971528024007,060971528024007,"Block 4007, Block Group 4, Census Tract 1528.02, Sonoma County, California",0,0,0
1000000US060971528024008,060971528024008,"Block 4008, Block Group 4, Census Tract 1528.02, Sonoma County, California",272,266,6
1000000US060971528024009,060971528024009,"Block 4009, Block Group 4, Census Tract 1528.02, Sonoma County, California",36,33,3
1000000US060971528024010,060971528024010,"Block 4010, Block Group 4, Census Tract 1528.02, Sonoma County, California",127,118,9
1000000US060971528024011,060971528024011,"Block 4011, Block Group 4, Census Tract 1528.02, Sonoma County, California",29,27,2
1000000US060971528024012,060971528024012,"Block 4012, Block Group 4, Census Tract 1528.02, Sonoma County, California",4,4,0
1000000US060971528025000,060971528025000,"Block 5000, Block Group 5, Census Tract 1528.02, Sonoma County, California",54,53,1
1000000US060971528025001,060971528025001,"Block 5001, Block Group 5, Census Tract 1528.02, Sonoma County, California",128,119,9
1000000US060971528025002,060971528025002,"Block 5002, Block Group 5, Census Tract 1528.02, Sonoma County, California",69,60,9
1000000US060971528025003,060971528025003,"Block 5003, Block Group 5, Census Tract 1528.02, Sonoma County, California",86,73,13
1000000US060971528025004,060971528025004,"Block 5004, Block Group 5, Census Tract 1528.02, Sonoma County, California",20,20,0
1000000US060971528025005,060971528025005,"Block 5005, Block Group 5, Census Tract 1528.02, Sonoma County, California",48,43,5
1000000US060971528025006,060971528025006,"Block 5006, Block Group 5, Census Tract 1528.02, Sonoma County, California",92,85,7
1000000US060971529031000,060971529031000,"Block 1000, Block Group 1, Census Tract 1529.03, Sonoma County, California",17,16,1
1000000US060971529031001,060971529031001,"Block 1001, Block Group 1, Census Tract 1529.03, Sonoma County, California",5,5,0
1000000US060971529031002,060971529031002,"Block 1002, Block Group 1, Census Tract 1529.03, Sonoma County, California",8,8,0
1000000US060971529031003,060971529031003,"Block 1003, Block Group 1, Census Tract 1529.03, Sonoma County, California",5,5,0
1000000US060971529031004,060971529031004,"Block 1004, Block Group 1, Census Tract 1529.03, Sonoma County, California",33,32,1
1000000US060971529031005,060971529031005,"Block 1005, Block Group 1, Census Tract 1529.03, Sonoma County, California",114,112,2
1000000US060971529031006,060971529031006,"Block 1006, Block Group 1, Census Tract 1529.03, Sonoma County, California",13,13,0
1000000US060971529031007,060971529031007,"Block 1007, Block Group 1, Census Tract 1529.03, Sonoma County, California",28,28,0
1000000US060971529031008,060971529031008,"Block 1008, Block Group 1, Census Tract 1529.03, Sonoma County, California",75,71,4
1000000US060971529031009,060971529031009,"Block 1009, Block Group 1, Census Tract 1529.03, Sonoma County, California",0,0,0
1000000US060971529031010,060971529031010,"Block 1010, Block Group 1, Census Tract 1529.03, Sonoma County, California",19,19,0
1000000US060971529032000,060971529032000,"Block 2000, Block Group 2, Census Tract 1529.03, Sonoma County, California",231,224,7
1000000US060971529032001,060971529032001,"Block 2001, Block Group 2, Census Tract 1529.03, Sonoma County, California",34,34,0
1000000US060971529032002,060971529032002,"Block 2002, Block Group 2, Census Tract 1529.03, Sonoma County, California",22,22,0
1000000US060971529032003,060971529032003,"Block 2003, Block Group 2, Census Tract 1529.03, Sonoma County, California",27,25,2
1000000US060971529032004,060971529032004,"Block 2004, Block Group 2, Census Tract 1529.03, Sonoma County, California",129,119,10
1000000US060971529032005,060971529032005,"Block 2005, Block Group 2, Census Tract 1529.03, Sonoma County, California",0,0,0
1000000US060971529032006,060971529032006,"Block 2006, Block Group 2, Census Tract 1529.03, Sonoma County, California",15,14,1
1000000US060971529032007,060971529032007,"Block 2007, Block Group 2, Census Tract 1529.03, Sonoma County, California",14,14,0
1000000US060971529032008,060971529032008,"Block 2008, Block Group 2, Census Tract 1529.03, Sonoma County, California",0,0,0
1000000US060971529032009,060971529032009,"Block 2009, Block Group 2, Census Tract 1529.03, Sonoma County, California",62,62,0
1000000US060971529032010,060971529032010,"Block 2010, Block Group 2, Census Tract 1529.03, Sonoma County, California",34,34,0
1000000US060971529032011,060971529032011,"Block 2011, Block Group 2, Census Tract 1529.03, Sonoma County, California",90,84,6
1000000US060971529032012,060971529032012,"Block 2012, Block Group 2, Census Tract 1529.03, Sonoma County, California",70,67,3
1000000US060971529032013,060971529032013,"Block 2013, Block Group 2, Census Tract 1529.03, Sonoma County, California",4,2,2
1000000US060971529033000,060971529033000,"Block 3000, Block Group 3, Census Tract 1529.03, Sonoma County, California",97,92,5
1000000US060971529033001,060971529033001,"Block 3001, Block Group 3, Census Tract 1529.03, Sonoma County, California",122,118,4
1000000US060971529033002,060971529033002,"Block 3002, Block Group 3, Census Tract 1529.03, Sonoma County, California",27,24,3
1000000US060971529034000,060971529034000,"Block 4000, Block Group 4, Census Tract 1529.03, Sonoma County, California",2,2,0
1000000US060971529034001,060971529034001,"Block 4001, Block Group 4, Census Tract 1529.03, Sonoma County, California",51,50,1
1000000US060971529034002,060971529034002,"Block 4002, Block Group 4, Census Tract 1529.03, Sonoma County, California",25,25,0
1000000US060971529034003,060971529034003,"Block 4003, Block Group 4, Census Tract 1529.03, Sonoma County, California",22,22,0
1000000US060971529034004,060971529034004,"Block 4004, Block Group 4, Census Tract 1529.03, Sonoma County, California",97,94,3
1000000US060971529034005,060971529034005,"Block 4005, Block Group 4, Census Tract 1529.03, Sonoma County, California",70,67,3
1000000US060971529034006,060971529034006,"Block 4006, Block Group 4, Census Tract 1529.03, Sonoma County, California",16,16,0
1000000US060971529041000,060971529041000,"Block 1000, Block Group 1, Census Tract 1529.04, Sonoma County, California",23,23,0
1000000US060971529041001,060971529041001,"Block 1001, Block Group 1, Census Tract 1529.04, Sonoma County, California",290,270,20
1000000US060971529041002,060971529041002,"Block 1002, Block Group 1, Census Tract 1529.04, Sonoma County, California",0,0,0
1000000US060971529041003,060971529041003,"Block 1003, Block Group 1, Census Tract 1529.04, Sonoma County, California",53,50,3
1000000US060971529041004,060971529041004,"Block 1004, Block Group 1, Census Tract 1529.04, Sonoma County, California",64,61,3
1000000US060971529041005,060971529041005,"Block 1005, Block Group 1, Census Tract 1529.04, Sonoma County, California",0,0,0
1000000US060971529041006,060971529041006,"Block 1006, Block Group 1, Census Tract 1529.04, Sonoma County, California",1,1,0
1000000US060971529041007,060971529041007,"Block 1007, Block Group 1, Census Tract 1529.04, Sonoma County, California",62,57,5
1000000US060971529041008,060971529041008,"Block 1008, Block Group 1, Census Tract 1529.04, Sonoma County, California",8,8,0
1000000US060971529041009,060971529041009,"Block 1009, Block Group 1, Census Tract 1529.04, Sonoma County, California",43,42,1
1000000US060971529041010,060971529041010,"Block 1010, Block Group 1, Census Tract 1529.04, Sonoma County, California",39,38,1
1000000US060971529041011,060971529041011,"Block 1011, Block Group 1, Census Tract 1529.04, Sonoma County, California",8,7,1
1000000US060971529041012,060971529041012,"Block 1012, Block Group 1, Census Tract 1529.04, Sonoma County, California",40,39,1
1000000US060971529041013,060971529041013,"Block 1013, Block Group 1, Census Tract 1529.04, Sonoma County, California",19,18,1
1000000US060971529041014,060971529041014,"Block 1014, Block Group 1, Census Tract 1529.04, Sonoma County, California",30,30,0
1000000US060971529041015,060971529041015,"Block 1015, Block Group 1, Census Tract 1529.04, Sonoma County, California",12,11,1
1000000US060971529041016,060971529041016,"Block 1016, Block Group 1, Census Tract 1529.04, Sonoma County, California",1,1,0
1000000US060971529041017,060971529041017,"Block 1017, Block Group 1, Census Tract 1529.04, Sonoma County, California",48,42,6
1000000US060971529041018,060971529041018,"Block 1018, Block Group 1, Census Tract 1529.04, Sonoma County, California",38,35,3
1000000US060971529041019,060971529041019,"Block 1019, Block Group 1, Census Tract 1529.04, Sonoma County, California",3,3,0
1000000US060971529041020,060971529041020,"Block 1020, Block Group 1, Census Tract 1529.04, Sonoma County, California",2,2,0
1000000US060971529042000,060971529042000,"Block 2000, Block Group 2, Census Tract 1529.04, Sonoma County, California",6,6,0
1000000US060971529042001,060971529042001,"Block 2001, Block Group 2, Census Tract 1529.04, Sonoma County, California",53,51,2
1000000US060971529042002,060971529042002,"Block 2002, Block Group 2, Census Tract 1529.04, Sonoma County, California",118,112,6
1000000US060971529042003,060971529042003,"Block 2003, Block Group 2, Census Tract 1529.04, Sonoma County, California",25,24,1
1000000US060971529042004,060971529042004,"Block 2004, Block Group 2, Census Tract 1529.04, Sonoma County, California",48,46,2
1000000US060971529042005,060971529042005,"Block 2005, Block Group 2, Census Tract 1529.04, Sonoma County, California",30,28,2
1000000US060971529043000,060971529043000,"Block 3000, Block Group 3, Census Tract 1529.04, Sonoma County, California",120,118,2
1000000US060971529043001,060971529043001,"Block 3001, Block Group 3, Census Tract 1529.04, Sonoma County, California",0,0,0
1000000US060971529043002,060971529043002,"Block 3002, Block Group 3, Census Tract 1529.04, Sonoma County, California",5,5,0
1000000US060971529043003,060971529043003,"Block 3003, Block Group 3, Census Tract 1529.04, Sonoma County, California",2,2,0
1000000US060971529043004,060971529043004,"Block 3004, Block Group 3, Census Tract 1529.04, Sonoma County, California",31,30,1
1000000US060971529043005,060971529043005,"Block 3005, Block Group 3, Census Tract 1529.04, Sonoma County, California",4,3,1
1000000US060971529043006,060971529043006,"Block 3006, Block Group 3, Census Tract 1529.04, Sonoma County, California",2,2,0
1000000US060971529043007,060971529043007,"Block 3007, Block Group 3, Census Tract 1529.04, Sonoma County, California",5,5,0
1000000US060971529043008,060971529043008,"Block 3008, Block Group 3, Census Tract 1529.04, Sonoma County, California",5,5,0
1000000US060971529043009,060971529043009,"Block 3009, Block Group 3, Census Tract 1529.04, Sonoma County, California",32,32,0
1000000US060971529043010,060971529043010,"Block 3010, Block Group 3, Census Tract 1529.04, Sonoma County, California",0,0,0
1000000US060971529043011,060971529043011,"Block 3011, Block Group 3, Census Tract 1529.04, Sonoma County, California",12,12,0
1000000US060971529043012,060971529043012,"Block 3012, Block Group 3, Census Tract 1529.04, Sonoma County, California",61,61,0
1000000US060971529043013,060971529043013,"Block 3013, Block Group 3, Census Tract 1529.04, Sonoma County, California",18,17,1
1000000US060971529043014,060971529043014,"Block 3014, Block Group 3, Census Tract 1529.04, Sonoma County, California",7,7,0
1000000US060971529043015,060971529043015,"Block 3015, Block Group 3, Census Tract 1529.04, Sonoma County, California",18,17,1
1000000US060971529043016,060971529043016,"Block 3016, Block Group 3, Census Tract 1529.04, Sonoma County, California",6,6,0
1000000US060971529043017,060971529043017,"Block 3017, Block Group 3, Census Tract 1529.04, Sonoma County, California",23,23,0
1000000US060971529043018,060971529043018,"Block 3018, Block Group 3, Census Tract 1529.04, Sonoma County, California",10,10,0
1000000US060971529043019,060971529043019,"Block 3019, Block Group 3, Census Tract 1529.04, Sonoma County, California",12,12,0
1000000US060971529043020,060971529043020,"Block 3020, Block Group 3, Census Tract 1529.04, Sonoma County, California",21,20,1
1000000US060971529043021,060971529043021,"Block 3021, Block Group 3, Census Tract 1529.04, Sonoma County, California",5,5,0
1000000US060971529043022,060971529043022,"Block 3022, Block Group 3, Census Tract 1529.04, Sonoma County, California",88,85,3
1000000US060971529043023,060971529043023,"Block 3023, Block Group 3, Census Tract 1529.04, Sonoma County, California",5,5,0
1000000US060971529044000,060971529044000,"Block 4000, Block Group 4, Census Tract 1529.04, Sonoma County, California",250,244,6
1000000US060971529044001,060971529044001,"Block 4001, Block Group 4, Census Tract 1529.04, Sonoma County, California",39,35,4
1000000US060971529044002,060971529044002,"Block 4002, Block Group 4, Census Tract 1529.04, Sonoma County, California",14,14,0
1000000US060971529044003,060971529044003,"Block 4003, Block Group 4, Census Tract 1529.04, Sonoma County, California",83,80,3
1000000US060971529044004,060971529044004,"Block 4004, Block Group 4, Census Tract 1529.04, Sonoma County, California",11,11,0
1000000US060971529044005,060971529044005,"Block 4005, Block Group 4, Census Tract 1529.04, Sonoma County, California",1,1,0
1000000US060971529044006,060971529044006,"Block 4006, Block Group 4, Census Tract 1529.04, Sonoma County, California",18,18,0
1000000US060971529051000,060971529051000,"Block 1000, Block Group 1, Census Tract 1529.05, Sonoma County, California",33,31,2
1000000US060971529051001,060971529051001,"Block 1001, Block Group 1, Census Tract 1529.05, Sonoma County, California",22,20,2
1000000US060971529051002,060971529051002,"Block 1002, Block Group 1, Census Tract 1529.05, Sonoma County, California",16,16,0
1000000US060971529051003,060971529051003,"Block 1003, Block Group 1, Census Tract 1529.05, Sonoma County, California",12,11,1
1000000US060971529051004,060971529051004,"Block 1004, Block Group 1, Census Tract 1529.05, Sonoma County, California",13,13,0
1000000US060971529051005,060971529051005,"Block 1005, Block Group 1, Census Tract 1529.05, Sonoma County, California",0,0,0
1000000US060971529051006,060971529051006,"Block 1006, Block Group 1, Census Tract 1529.05, Sonoma County, California",142,134,8
1000000US060971529051007,060971529051007,"Block 1007, Block Group 1, Census Tract 1529.05, Sonoma County, California",16,16,0
1000000US060971529051008,060971529051008,"Block 1008, Block Group 1, Census Tract 1529.05, Sonoma County, California",20,14,6
1000000US060971529051009,060971529051009,"Block 1009, Block Group 1, Census Tract 1529.05, Sonoma County, California",21,21,0
1000000US060971529051010,060971529051010,"Block 1010, Block Group 1, Census Tract 1529.05, Sonoma County, California",44,42,2
1000000US060971529051011,060971529051011,"Block 1011, Block Group 1, Census Tract 1529.05, Sonoma County, California",18,18,0
1000000US060971529051012,060971529051012,"Block 1012, Block Group 1, Census Tract 1529.05, Sonoma County, California",227,216,11
1000000US060971529052000,060971529052000,"Block 2000, Block Group 2, Census Tract 1529.05, Sonoma County, California",28,28,0
1000000US060971529052001,060971529052001,"Block 2001, Block Group 2, Census Tract 1529.05, Sonoma County, California",81,76,5
1000000US060971529052002,060971529052002,"Block 2002, Block Group 2, Census Tract 1529.05, Sonoma County, California",13,13,0
1000000US060971529052003,060971529052003,"Block 2003, Block Group 2, Census Tract 1529.05, Sonoma County, California",10,10,0
1000000US060971529052004,060971529052004,"Block 2004, Block Group 2, Census Tract 1529.05, Sonoma County, California",81,80,1
1000000US060971529052005,060971529052005,"Block 2005, Block Group 2, Census Tract 1529.05, Sonoma County, California",0,0,0
1000000US060971529052006,060971529052006,"Block 2006, Block Group 2, Census Tract 1529.05, Sonoma County, California",31,25,6
1000000US060971529052007,060971529052007,"Block 2007, Block Group 2, Census Tract 1529.05, Sonoma County, California",2,2,0
1000000US060971529052008,060971529052008,"Block 2008, Block Group 2, Census Tract 1529.05, Sonoma County, California",54,54,0
1000000US060971529052009,060971529052009,"Block 2009, Block Group 2, Census Tract 1529.05, Sonoma County, California",12,12,0
1000000US060971529052010,060971529052010,"Block 2010, Block Group 2, Census Tract 1529.05, Sonoma County, California",21,20,1
1000000US060971529052011,060971529052011,"Block 2011, Block Group 2, Census Tract 1529.05, Sonoma County, California",32,31,1
1000000US060971529052012,060971529052012,"Block 2012, Block Group 2, Census Tract 1529.05, Sonoma County, California",39,36,3
1000000US060971529052013,060971529052013,"Block 2013, Block Group 2, Census Tract 1529.05, Sonoma County, California",69,64,5
1000000US060971529052014,060971529052014,"Block 2014, Block Group 2, Census Tract 1529.05, Sonoma County, California",44,41,3
1000000US060971529052015,060971529052015,"Block 2015, Block Group 2, Census Tract 1529.05, Sonoma County, California",4,4,0
1000000US060971529052016,060971529052016,"Block 2016, Block Group 2, Census Tract 1529.05, Sonoma County, California",28,28,0
1000000US060971529053000,060971529053000,"Block 3000, Block Group 3, Census Tract 1529.05, Sonoma County, California",24,23,1
1000000US060971529053001,060971529053001,"Block 3001, Block Group 3, Census Tract 1529.05, Sonoma County, California",47,47,0
1000000US060971529053002,060971529053002,"Block 3002, Block Group 3, Census Tract 1529.05, Sonoma County, California",50,50,0
1000000US060971529053003,060971529053003,"Block 3003, Block Group 3, Census Tract 1529.05, Sonoma County, California",23,22,1
1000000US060971529053004,060971529053004,"Block 3004, Block Group 3, Census Tract 1529.05, Sonoma County, California",35,33,2
1000000US060971529053005,060971529053005,"Block 3005, Block Group 3, Census Tract 1529.05, Sonoma County, California",27,26,1
1000000US060971529053006,060971529053006,"Block 3006, Block Group 3, Census Tract 1529.05, Sonoma County, California",22,22,0
1000000US060971529053007,060971529053007,"Block 3007, Block Group 3, Census Tract 1529.05, Sonoma County, California",155,140,15
1000000US060971529053008,060971529053008,"Block 3008, Block Group 3, Census Tract 1529.05, Sonoma County, California",20,20,0
1000000US060971529053009,060971529053009,"Block 3009, Block Group 3, Census Tract 1529.05, Sonoma County, California",66,64,2
1000000US060971529053010,060971529053010,"Block 3010, Block Group 3, Census Tract 1529.05, Sonoma County, California",16,16,0
1000000US060971529053011,060971529053011,"Block 3011, Block Group 3, Census Tract 1529.05, Sonoma County, California",0,0,0
1000000US060971529061000,060971529061000,"Block 1000, Block Group 1, Census Tract 1529.06, Sonoma County, California",11,11,0
1000000US060971529061001,060971529061001,"Block 1001, Block Group 1, Census Tract 1529.06, Sonoma County, California",90,84,6
1000000US060971529061002,060971529061002,"Block 1002, Block Group 1, Census Tract 1529.06, Sonoma County, California",0,0,0
1000000US060971529061003,060971529061003,"Block 1003, Block Group 1, Census Tract 1529.06, Sonoma County, California",6,6,0
1000000US060971529061004,060971529061004,"Block 1004, Block Group 1, Census Tract 1529.06, Sonoma County, California",1,1,0
1000000US060971529061005,060971529061005,"Block 1005, Block Group 1, Census Tract 1529.06, Sonoma County, California",0,0,0
1000000US060971529061006,060971529061006,"Block 1006, Block Group 1, Census Tract 1529.06, Sonoma County, California",8,8,0
1000000US060971529061007,060971529061007,"Block 1007, Block Group 1, Census Tract 1529.06, Sonoma County, California",0,0,0
1000000US060971529061008,060971529061008,"Block 1008, Block Group 1, Census Tract 1529.06, Sonoma County, California",8,8,0
1000000US060971529061009,060971529061009,"Block 1009, Block Group 1, Census Tract 1529.06, Sonoma County, California",8,5,3
1000000US060971529061010,060971529061010,"Block 1010, Block Group 1, Census Tract 1529.06, Sonoma County, California",45,41,4
1000000US060971529061011,060971529061011,"Block 1011, Block Group 1, Census Tract 1529.06, Sonoma County, California",1,1,0
1000000US060971529061012,060971529061012,"Block 1012, Block Group 1, Census Tract 1529.06, Sonoma County, California",94,77,17
1000000US060971529061013,060971529061013,"Block 1013, Block Group 1, Census Tract 1529.06, Sonoma County, California",22,17,5
1000000US060971529061014,060971529061014,"Block 1014, Block Group 1, Census Tract 1529.06, Sonoma County, California",0,0,0
1000000US060971529061015,060971529061015,"Block 1015, Block Group 1, Census Tract 1529.06, Sonoma County, California",38,34,4
1000000US060971529061016,060971529061016,"Block 1016, Block Group 1, Census Tract 1529.06, Sonoma County, California",2,2,0
1000000US060971529061017,060971529061017,"Block 1017, Block Group 1, Census Tract 1529.06, Sonoma County, California",5,5,0
1000000US060971529061018,060971529061018,"Block 1018, Block Group 1, Census Tract 1529.06, Sonoma County, California",22,20,2
1000000US060971529061019,060971529061019,"Block 1019, Block Group 1, Census Tract 1529.06, Sonoma County, California",2,2,0
1000000US060971529061020,060971529061020,"Block 1020, Block Group 1, Census Tract 1529.06, Sonoma County, California",45,39,6
1000000US060971529061021,060971529061021,"Block 1021, Block Group 1, Census Tract 1529.06, Sonoma County, California",0,0,0
1000000US060971529061022,060971529061022,"Block 1022, Block Group 1, Census Tract 1529.06, Sonoma County, California",0,0,0
1000000US060971529061023,060971529061023,"Block 1023, Block Group 1, Census Tract 1529.06, Sonoma County, California",0,0,0
1000000US060971529061024,060971529061024,"Block 1024, Block Group 1, Census Tract 1529.06, Sonoma County, California",136,126,10
1000000US060971529061025,060971529061025,"Block 1025, Block Group 1, Census Tract 1529.06, Sonoma County, California",25,22,3
1000000US060971529061026,060971529061026,"Block 1026, Block Group 1, Census Tract 1529.06, Sonoma County, California",24,23,1
1000000US060971529061027,060971529061027,"Block 1027, Block Group 1, Census Tract 1529.06, Sonoma County, California",24,18,6
1000000US060971529061028,060971529061028,"Block 1028, Block Group 1, Census Tract 1529.06, Sonoma County, California",27,26,1
1000000US060971529061029,060971529061029,"Block 1029, Block Group 1, Census Tract 1529.06, Sonoma County, California",36,35,1
1000000US060971529061030,060971529061030,"Block 1030, Block Group 1, Census Tract 1529.06, Sonoma County, California",10,8,2
1000000US060971529061031,060971529061031,"Block 1031, Block Group 1, Census Tract 1529.06, Sonoma County, California",22,21,1
1000000US060971529061032,060971529061032,"Block 1032, Block Group 1, Census Tract 1529.06, Sonoma County, California",12,11,1
1000000US060971529061033,060971529061033,"Block 1033, Block Group 1, Census Tract 1529.06, Sonoma County, California",40,37,3
1000000US060971529061034,060971529061034,"Block 1034, Block Group 1, Census Tract 1529.06, Sonoma County, California",43,42,1
1000000US060971529061035,060971529061035,"Block 1035, Block Group 1, Census Tract 1529.06, Sonoma County, California",0,0,0
1000000US060971529061036,060971529061036,"Block 1036, Block Group 1, Census Tract 1529.06, Sonoma County, California",0,0,0
1000000US060971529061037,060971529061037,"Block 1037, Block Group 1, Census Tract 1529.06, Sonoma County, California",10,10,0
1000000US060971529061038,060971529061038,"Block 1038, Block Group 1, Census Tract 1529.06, Sonoma County, California",18,18,0
1000000US060971529061039,060971529061039,"Block 1039, Block Group 1, Census Tract 1529.06, Sonoma County, California",23,22,1
1000000US060971529061040,060971529061040,"Block 1040, Block Group 1, Census Tract 1529.06, Sonoma County, California",44,43,1
1000000US060971529061041,060971529061041,"Block 1041, Block Group 1, Census Tract 1529.06, Sonoma County, California",66,65,1
1000000US060971529061042,060971529061042,"Block 1042, Block Group 1, Census Tract 1529.06, Sonoma County, California",14,12,2
1000000US060971529061043,060971529061043,"Block 1043, Block Group 1, Census Tract 1529.06, Sonoma County, California",20,20,0
1000000US060971529061044,060971529061044,"Block 1044, Block Group 1, Census Tract 1529.06, Sonoma County, California",37,37,0
1000000US060971529061045,060971529061045,"Block 1045, Block Group 1, Census Tract 1529.06, Sonoma County, California",48,44,4
1000000US060971529061046,060971529061046,"Block 1046, Block Group 1, Census Tract 1529.06, Sonoma County, California",1,1,0
1000000US060971529061047,060971529061047,"Block 1047, Block Group 1, Census Tract 1529.06, Sonoma County, California",0,0,0
1000000US060971529061048,060971529061048,"Block 1048, Block Group 1, Census Tract 1529.06, Sonoma County, California",55,53,2
1000000US060971529061049,060971529061049,"Block 1049, Block Group 1, Census Tract 1529.06, Sonoma County, California",0,0,0
1000000US060971529061050,060971529061050,"Block 1050, Block Group 1, Census Tract 1529.06, Sonoma County, California",20,20,0
1000000US060971529061051,060971529061051,"Block 1051, Block Group 1, Census Tract 1529.06, Sonoma County, California",16,15,1
1000000US060971529061052,060971529061052,"Block 1052, Block Group 1, Census Tract 1529.06, Sonoma County, California",103,101,2
1000000US060971529061053,060971529061053,"Block 1053, Block Group 1, Census Tract 1529.06, Sonoma County, California",20,18,2
1000000US060971529061054,060971529061054,"Block 1054, Block Group 1, Census Tract 1529.06, Sonoma County, California",10,10,0
1000000US060971529061055,060971529061055,"Block 1055, Block Group 1, Census Tract 1529.06, Sonoma County, California",1,1,0
1000000US060971529061056,060971529061056,"Block 1056, Block Group 1, Census Tract 1529.06, Sonoma County, California",1,0,1
1000000US060971529062000,060971529062000,"Block 2000, Block Group 2, Census Tract 1529.06, Sonoma County, California",315,293,22
1000000US060971529062001,060971529062001,"Block 2001, Block Group 2, Census Tract 1529.06, Sonoma County, California",21,20,1
1000000US060971529062002,060971529062002,"Block 2002, Block Group 2, Census Tract 1529.06, Sonoma County, California",0,0,0
1000000US060971529062003,060971529062003,"Block 2003, Block Group 2, Census Tract 1529.06, Sonoma County, California",201,181,20
1000000US060971529062004,060971529062004,"Block 2004, Block Group 2, Census Tract 1529.06, Sonoma County, California",100,91,9
1000000US060971529062005,060971529062005,"Block 2005, Block Group 2, Census Tract 1529.06, Sonoma County, California",11,10,1
1000000US060971529062006,060971529062006,"Block 2006, Block Group 2, Census Tract 1529.06, Sonoma County, California",0,0,0
1000000US060971529062007,060971529062007,"Block 2007, Block Group 2, Census Tract 1529.06, Sonoma County, California",33,32,1
1000000US060971529062008,060971529062008,"Block 2008, Block Group 2, Census Tract 1529.06, Sonoma County, California",16,15,1
1000000US060971529062009,060971529062009,"Block 2009, Block Group 2, Census Tract 1529.06, Sonoma County, California",65,56,9
1000000US060971529062010,060971529062010,"Block 2010, Block Group 2, Census Tract 1529.06, Sonoma County, California",0,0,0
1000000US060971530011000,060971530011000,"Block 1000, Block Group 1, Census Tract 1530.01, Sonoma County, California",0,0,0
1000000US060971530011001,060971530011001,"Block 1001, Block Group 1, Census Tract 1530.01, Sonoma County, California",0,0,0
1000000US060971530011002,060971530011002,"Block 1002, Block Group 1, Census Tract 1530.01, Sonoma County, California",44,43,1
1000000US060971530011003,060971530011003,"Block 1003, Block Group 1, Census Tract 1530.01, Sonoma County, California",451,408,43
1000000US060971530011004,060971530011004,"Block 1004, Block Group 1, Census Tract 1530.01, Sonoma County, California",116,112,4
1000000US060971530011005,060971530011005,"Block 1005, Block Group 1, Census Tract 1530.01, Sonoma County, California",117,110,7
1000000US060971530011006,060971530011006,"Block 1006, Block Group 1, Census Tract 1530.01, Sonoma County, California",52,51,1
1000000US060971530012000,060971530012000,"Block 2000, Block Group 2, Census Tract 1530.01, Sonoma County, California",96,95,1
1000000US060971530012001,060971530012001,"Block 2001, Block Group 2, Census Tract 1530.01, Sonoma County, California",15,15,0
1000000US060971530012002,060971530012002,"Block 2002, Block Group 2, Census Tract 1530.01, Sonoma County, California",107,104,3
1000000US060971530012003,060971530012003,"Block 2003, Block Group 2, Census Tract 1530.01, Sonoma County, California",68,67,1
1000000US060971530012004,060971530012004,"Block 2004, Block Group 2, Census Tract 1530.01, Sonoma County, California",3,3,0
1000000US060971530012005,060971530012005,"Block 2005, Block Group 2, Census Tract 1530.01, Sonoma County, California",27,27,0
1000000US060971530012006,060971530012006,"Block 2006, Block Group 2, Census Tract 1530.01, Sonoma County, California",86,79,7
1000000US060971530012007,060971530012007,"Block 2007, Block Group 2, Census Tract 1530.01, Sonoma County, California",70,68,2
1000000US060971530012008,060971530012008,"Block 2008, Block Group 2, Census Tract 1530.01, Sonoma County, California",26,25,1
1000000US060971530012009,060971530012009,"Block 2009, Block Group 2, Census Tract 1530.01, Sonoma County, California",29,27,2
1000000US060971530012010,060971530012010,"Block 2010, Block Group 2, Census Tract 1530.01, Sonoma County, California",57,54,3
1000000US060971530012011,060971530012011,"Block 2011, Block Group 2, Census Tract 1530.01, Sonoma County, California",27,25,2
1000000US060971530012012,060971530012012,"Block 2012, Block Group 2, Census Tract 1530.01, Sonoma County, California",13,13,0
1000000US060971530012013,060971530012013,"Block 2013, Block Group 2, Census Tract 1530.01, Sonoma County, California",26,25,1
1000000US060971530013000,060971530013000,"Block 3000, Block Group 3, Census Tract 1530.01, Sonoma County, California",19,15,4
1000000US060971530013001,060971530013001,"Block 3001, Block Group 3, Census Tract 1530.01, Sonoma County, California",51,51,0
1000000US060971530013002,060971530013002,"Block 3002, Block Group 3, Census Tract 1530.01, Sonoma County, California",235,229,6
1000000US060971530013003,060971530013003,"Block 3003, Block Group 3, Census Tract 1530.01, Sonoma County, California",0,0,0
1000000US060971530013004,060971530013004,"Block 3004, Block Group 3, Census Tract 1530.01, Sonoma County, California",0,0,0
1000000US060971530013005,060971530013005,"Block 3005, Block Group 3, Census Tract 1530.01, Sonoma County, California",99,99,0
1000000US060971530013006,060971530013006,"Block 3006, Block Group 3, Census Tract 1530.01, Sonoma County, California",0,0,0
1000000US060971530013007,060971530013007,"Block 3007, Block Group 3, Census Tract 1530.01, Sonoma County, California",190,171,19
1000000US060971530013008,060971530013008,"Block 3008, Block Group 3, Census Tract 1530.01, Sonoma County, California",21,21,0
1000000US060971530013009,060971530013009,"Block 3009, Block Group 3, Census Tract 1530.01, Sonoma County, California",15,15,0
1000000US060971530013010,060971530013010,"Block 3010, Block Group 3, Census Tract 1530.01, Sonoma County, California",1,1,0
1000000US060971530013011,060971530013011,"Block 3011, Block Group 3, Census Tract 1530.01, Sonoma County, California",61,58,3
1000000US060971530013012,060971530013012,"Block 3012, Block Group 3, Census Tract 1530.01, Sonoma County, California",107,102,5
1000000US060971530013013,060971530013013,"Block 3013, Block Group 3, Census Tract 1530.01, Sonoma County, California",45,40,5
1000000US060971530013014,060971530013014,"Block 3014, Block Group 3, Census Tract 1530.01, Sonoma County, California",54,54,0
1000000US060971530013015,060971530013015,"Block 3015, Block Group 3, Census Tract 1530.01, Sonoma County, California",174,170,4
1000000US060971530013016,060971530013016,"Block 3016, Block Group 3, Census Tract 1530.01, Sonoma County, California",23,23,0
1000000US060971530013017,060971530013017,"Block 3017, Block Group 3, Census Tract 1530.01, Sonoma County, California",4,4,0
1000000US060971530013018,060971530013018,"Block 3018, Block Group 3, Census Tract 1530.01, Sonoma County, California",5,4,1
1000000US060971530013019,060971530013019,"Block 3019, Block Group 3, Census Tract 1530.01, Sonoma County, California",0,0,0
1000000US060971530013020,060971530013020,"Block 3020, Block Group 3, Census Tract 1530.01, Sonoma County, California",0,0,0
1000000US060971530013021,060971530013021,"Block 3021, Block Group 3, Census Tract 1530.01, Sonoma County, California",20,18,2
1000000US060971530021000,060971530021000,"Block 1000, Block Group 1, Census Tract 1530.02, Sonoma County, California",45,43,2
1000000US060971530021001,060971530021001,"Block 1001, Block Group 1, Census Tract 1530.02, Sonoma County, California",16,15,1
1000000US060971530021002,060971530021002,"Block 1002, Block Group 1, Census Tract 1530.02, Sonoma County, California",0,0,0
1000000US060971530021003,060971530021003,"Block 1003, Block Group 1, Census Tract 1530.02, Sonoma County, California",1,1,0
1000000US060971530021004,060971530021004,"Block 1004, Block Group 1, Census Tract 1530.02, Sonoma County, California",25,25,0
1000000US060971530021005,060971530021005,"Block 1005, Block Group 1, Census Tract 1530.02, Sonoma County, California",72,70,2
1000000US060971530021006,060971530021006,"Block 1006, Block Group 1, Census Tract 1530.02, Sonoma County, California",453,423,30
1000000US060971530021007,060971530021007,"Block 1007, Block Group 1, Census Tract 1530.02, Sonoma County, California",0,0,0
1000000US060971530022000,060971530022000,"Block 2000, Block Group 2, Census Tract 1530.02, Sonoma County, California",32,31,1
1000000US060971530022001,060971530022001,"Block 2001, Block Group 2, Census Tract 1530.02, Sonoma County, California",45,44,1
1000000US060971530022002,060971530022002,"Block 2002, Block Group 2, Census Tract 1530.02, Sonoma County, California",78,75,3
1000000US060971530022003,060971530022003,"Block 2003, Block Group 2, Census Tract 1530.02, Sonoma County, California",46,45,1
1000000US060971530022004,060971530022004,"Block 2004, Block Group 2, Census Tract 1530.02, Sonoma County, California",0,0,0
1000000US060971530022005,060971530022005,"Block 2005, Block Group 2, Census Tract 1530.02, Sonoma County, California",63,63,0
1000000US060971530022006,060971530022006,"Block 2006, Block Group 2, Census Tract 1530.02, Sonoma County, California",14,13,1
1000000US060971530022007,060971530022007,"Block 2007, Block Group 2, Census Tract 1530.02, Sonoma County, California",26,25,1
1000000US060971530022008,060971530022008,"Block 2008, Block Group 2, Census Tract 1530.02, Sonoma County, California",32,31,1
1000000US060971530022009,060971530022009,"Block 2009, Block Group 2, Census Tract 1530.02, Sonoma County, California",38,37,1
1000000US060971530022010,060971530022010,"Block 2010, Block Group 2, Census Tract 1530.02, Sonoma County, California",29,27,2
1000000US060971530022011,060971530022011,"Block 2011, Block Group 2, Census Tract 1530.02, Sonoma County, California",27,27,0
1000000US060971530022012,060971530022012,"Block 2012, Block Group 2, Census Tract 1530.02, Sonoma County, California",14,14,0
1000000US060971530022013,060971530022013,"Block 2013, Block Group 2, Census Tract 1530.02, Sonoma County, California",14,14,0
1000000US060971530022014,060971530022014,"Block 2014, Block Group 2, Census Tract 1530.02, Sonoma County, California",24,22,2
1000000US060971530022015,060971530022015,"Block 2015, Block Group 2, Census Tract 1530.02, Sonoma County, California",21,20,1
1000000US060971530022016,060971530022016,"Block 2016, Block Group 2, Census Tract 1530.02, Sonoma County, California",8,8,0
1000000US060971530023000,060971530023000,"Block 3000, Block Group 3, Census Tract 1530.02, Sonoma County, California",8,7,1
1000000US060971530023001,060971530023001,"Block 3001, Block Group 3, Census Tract 1530.02, Sonoma County, California",19,18,1
1000000US060971530023002,060971530023002,"Block 3002, Block Group 3, Census Tract 1530.02, Sonoma County, California",0,0,0
1000000US060971530023003,060971530023003,"Block 3003, Block Group 3, Census Tract 1530.02, Sonoma County, California",58,55,3
1000000US060971530023004,060971530023004,"Block 3004, Block Group 3, Census Tract 1530.02, Sonoma County, California",16,16,0
1000000US060971530023005,060971530023005,"Block 3005, Block Group 3, Census Tract 1530.02, Sonoma County, California",7,7,0
1000000US060971530023006,060971530023006,"Block 3006, Block Group 3, Census Tract 1530.02, Sonoma County, California",4,4,0
1000000US060971530023007,060971530023007,"Block 3007, Block Group 3, Census Tract 1530.02, Sonoma County, California",22,20,2
1000000US060971530023008,060971530023008,"Block 3008, Block Group 3, Census Tract 1530.02, Sonoma County, California",0,0,0
1000000US060971530023009,060971530023009,"Block 3009, Block Group 3, Census Tract 1530.02, Sonoma County, California",9,9,0
1000000US060971530023010,060971530023010,"Block 3010, Block Group 3, Census Tract 1530.02, Sonoma County, California",1,1,0
1000000US060971530023011,060971530023011,"Block 3011, Block Group 3, Census Tract 1530.02, Sonoma County, California",0,0,0
1000000US060971530023012,060971530023012,"Block 3012, Block Group 3, Census Tract 1530.02, Sonoma County, California",29,23,6
1000000US060971530023013,060971530023013,"Block 3013, Block Group 3, Census Tract 1530.02, Sonoma County, California",0,0,0
1000000US060971530023014,060971530023014,"Block 3014, Block Group 3, Census Tract 1530.02, Sonoma County, California",0,0,0
1000000US060971530023015,060971530023015,"Block 3015, Block Group 3, Census Tract 1530.02, Sonoma County, California",0,0,0
1000000US060971530023016,060971530023016,"Block 3016, Block Group 3, Census Tract 1530.02, Sonoma County, California",0,0,0
1000000US060971530023017,060971530023017,"Block 3017, Block Group 3, Census Tract 1530.02, Sonoma County, California",0,0,0
1000000US060971530023018,060971530023018,"Block 3018, Block Group 3, Census Tract 1530.02, Sonoma County, California",0,0,0
1000000US060971530023019,060971530023019,"Block 3019, Block Group 3, Census Tract 1530.02, Sonoma County, California",0,0,0
1000000US060971530023020,060971530023020,"Block 3020, Block Group 3, Census Tract 1530.02, Sonoma County, California",0,0,0
1000000US060971530023021,060971530023021,"Block 3021, Block Group 3, Census Tract 1530.02, Sonoma County, California",0,0,0
1000000US060971530023022,060971530023022,"Block 3022, Block Group 3, Census Tract 1530.02, Sonoma County, California",27,26,1
1000000US060971530023023,060971530023023,"Block 3023, Block Group 3, Census Tract 1530.02, Sonoma County, California",38,36,2
1000000US060971530023024,060971530023024,"Block 3024, Block Group 3, Census Tract 1530.02, Sonoma County, California",10,9,1
1000000US060971530023025,060971530023025,"Block 3025, Block Group 3, Census Tract 1530.02, Sonoma County, California",32,29,3
1000000US060971530023026,060971530023026,"Block 3026, Block Group 3, Census Tract 1530.02, Sonoma County, California",11,11,0
1000000US060971530023027,060971530023027,"Block 3027, Block Group 3, Census Tract 1530.02, Sonoma County, California",0,0,0
1000000US060971530024000,060971530024000,"Block 4000, Block Group 4, Census Tract 1530.02, Sonoma County, California",0,0,0
1000000US060971530024001,060971530024001,"Block 4001, Block Group 4, Census Tract 1530.02, Sonoma County, California",54,53,1
1000000US060971530024002,060971530024002,"Block 4002, Block Group 4, Census Tract 1530.02, Sonoma County, California",0,0,0
1000000US060971530024003,060971530024003,"Block 4003, Block Group 4, Census Tract 1530.02, Sonoma County, California",16,15,1
1000000US060971530024004,060971530024004,"Block 4004, Block Group 4, Census Tract 1530.02, Sonoma County, California",37,34,3
1000000US060971530024005,060971530024005,"Block 4005, Block Group 4, Census Tract 1530.02, Sonoma County, California",17,17,0
1000000US060971530024006,060971530024006,"Block 4006, Block Group 4, Census Tract 1530.02, Sonoma County, California",2,1,1
1000000US060971530024007,060971530024007,"Block 4007, Block Group 4, Census Tract 1530.02, Sonoma County, California",4,4,0
1000000US060971530024008,060971530024008,"Block 4008, Block Group 4, Census Tract 1530.02, Sonoma County, California",30,25,5
1000000US060971530024009,060971530024009,"Block 4009, Block Group 4, Census Tract 1530.02, Sonoma County, California",0,0,0
1000000US060971530024010,060971530024010,"Block 4010, Block Group 4, Census Tract 1530.02, Sonoma County, California",0,0,0
1000000US060971530024011,060971530024011,"Block 4011, Block Group 4, Census Tract 1530.02, Sonoma County, California",158,152,6
1000000US060971530024012,060971530024012,"Block 4012, Block Group 4, Census Tract 1530.02, Sonoma County, California",49,47,2
1000000US060971530024013,060971530024013,"Block 4013, Block Group 4, Census Tract 1530.02, Sonoma County, California",0,0,0
1000000US060971530024014,060971530024014,"Block 4014, Block Group 4, Census Tract 1530.02, Sonoma County, California",1,1,0
1000000US060971530024015,060971530024015,"Block 4015, Block Group 4, Census Tract 1530.02, Sonoma County, California",38,33,5
1000000US060971530024016,060971530024016,"Block 4016, Block Group 4, Census Tract 1530.02, Sonoma County, California",0,0,0
1000000US060971530025000,060971530025000,"Block 5000, Block Group 5, Census Tract 1530.02, Sonoma County, California",0,0,0
1000000US060971530025001,060971530025001,"Block 5001, Block Group 5, Census Tract 1530.02, Sonoma County, California",9,7,2
1000000US060971530025002,060971530025002,"Block 5002, Block Group 5, Census Tract 1530.02, Sonoma County, California",15,12,3
1000000US060971530025003,060971530025003,"Block 5003, Block Group 5, Census Tract 1530.02, Sonoma County, California",26,24,2
1000000US060971530025004,060971530025004,"Block 5004, Block Group 5, Census Tract 1530.02, Sonoma County, California",16,15,1
1000000US060971530025005,060971530025005,"Block 5005, Block Group 5, Census Tract 1530.02, Sonoma County, California",0,0,0
1000000US060971530025006,060971530025006,"Block 5006, Block Group 5, Census Tract 1530.02, Sonoma County, California",32,31,1
1000000US060971530025007,060971530025007,"Block 5007, Block Group 5, Census Tract 1530.02, Sonoma County, California",24,21,3
1000000US060971530025008,060971530025008,"Block 5008, Block Group 5, Census Tract 1530.02, Sonoma County, California",27,26,1
1000000US060971530025009,060971530025009,"Block 5009, Block Group 5, Census Tract 1530.02, Sonoma County, California",26,24,2
1000000US060971530025010,060971530025010,"Block 5010, Block Group 5, Census Tract 1530.02, Sonoma County, California",14,14,0
1000000US060971530025011,060971530025011,"Block 5011, Block Group 5, Census Tract 1530.02, Sonoma County, California",19,19,0
1000000US060971530025012,060971530025012,"Block 5012, Block Group 5, Census Tract 1530.02, Sonoma County, California",48,46,2
1000000US060971530025013,060971530025013,"Block 5013, Block Group 5, Census Tract 1530.02, Sonoma County, California",33,32,1
1000000US060971530031000,060971530031000,"Block 1000, Block Group 1, Census Tract 1530.03, Sonoma County, California",131,116,15
1000000US060971530031001,060971530031001,"Block 1001, Block Group 1, Census Tract 1530.03, Sonoma County, California",10,10,0
1000000US060971530031002,060971530031002,"Block 1002, Block Group 1, Census Tract 1530.03, Sonoma County, California",10,10,0
1000000US060971530031003,060971530031003,"Block 1003, Block Group 1, Census Tract 1530.03, Sonoma County, California",103,89,14
1000000US060971530031004,060971530031004,"Block 1004, Block Group 1, Census Tract 1530.03, Sonoma County, California",18,17,1
1000000US060971530031005,060971530031005,"Block 1005, Block Group 1, Census Tract 1530.03, Sonoma County, California",56,56,0
1000000US060971530031006,060971530031006,"Block 1006, Block Group 1, Census Tract 1530.03, Sonoma County, California",46,45,1
1000000US060971530031007,060971530031007,"Block 1007, Block Group 1, Census Tract 1530.03, Sonoma County, California",12,12,0
1000000US060971530032000,060971530032000,"Block 2000, Block Group 2, Census Tract 1530.03, Sonoma County, California",0,0,0
1000000US060971530032001,060971530032001,"Block 2001, Block Group 2, Census Tract 1530.03, Sonoma County, California",28,28,0
1000000US060971530032002,060971530032002,"Block 2002, Block Group 2, Census Tract 1530.03, Sonoma County, California",19,18,1
1000000US060971530032003,060971530032003,"Block 2003, Block Group 2, Census Tract 1530.03, Sonoma County, California",23,22,1
1000000US060971530032004,060971530032004,"Block 2004, Block Group 2, Census Tract 1530.03, Sonoma County, California",0,0,0
1000000US060971530032005,060971530032005,"Block 2005, Block Group 2, Census Tract 1530.03, Sonoma County, California",10,9,1
1000000US060971530032006,060971530032006,"Block 2006, Block Group 2, Census Tract 1530.03, Sonoma County, California",0,0,0
1000000US060971530032007,060971530032007,"Block 2007, Block Group 2, Census Tract 1530.03, Sonoma County, California",0,0,0
1000000US060971530032008,060971530032008,"Block 2008, Block Group 2, Census Tract 1530.03, Sonoma County, California",0,0,0
1000000US060971530032009,060971530032009,"Block 2009, Block Group 2, Census Tract 1530.03, Sonoma County, California",0,0,0
1000000US060971530032010,060971530032010,"Block 2010, Block Group 2, Census Tract 1530.03, Sonoma County, California",0,0,0
1000000US060971530032011,060971530032011,"Block 2011, Block Group 2, Census Tract 1530.03, Sonoma County, California",29,25,4
1000000US060971530032012,060971530032012,"Block 2012, Block Group 2, Census Tract 1530.03, Sonoma County, California",1,1,0
1000000US060971530032013,060971530032013,"Block 2013, Block Group 2, Census Tract 1530.03, Sonoma County, California",0,0,0
1000000US060971530032014,060971530032014,"Block 2014, Block Group 2, Census Tract 1530.03, Sonoma County, California",67,63,4
1000000US060971530032015,060971530032015,"Block 2015, Block Group 2, Census Tract 1530.03, Sonoma County, California",9,9,0
1000000US060971530032016,060971530032016,"Block 2016, Block Group 2, Census Tract 1530.03, Sonoma County, California",41,37,4
1000000US060971530032017,060971530032017,"Block 2017, Block Group 2, Census Tract 1530.03, Sonoma County, California",114,113,1
1000000US060971530032018,060971530032018,"Block 2018, Block Group 2, Census Tract 1530.03, Sonoma County, California",0,0,0
1000000US060971530032019,060971530032019,"Block 2019, Block Group 2, Census Tract 1530.03, Sonoma County, California",0,0,0
1000000US060971530032020,060971530032020,"Block 2020, Block Group 2, Census Tract 1530.03, Sonoma County, California",0,0,0
1000000US060971530033000,060971530033000,"Block 3000, Block Group 3, Census Tract 1530.03, Sonoma County, California",0,0,0
1000000US060971530033001,060971530033001,"Block 3001, Block Group 3, Census Tract 1530.03, Sonoma County, California",41,39,2
1000000US060971530033002,060971530033002,"Block 3002, Block Group 3, Census Tract 1530.03, Sonoma County, California",10,9,1
1000000US060971530033003,060971530033003,"Block 3003, Block Group 3, Census Tract 1530.03, Sonoma County, California",12,11,1
1000000US060971530033004,060971530033004,"Block 3004, Block Group 3, Census Tract 1530.03, Sonoma County, California",15,15,0
1000000US060971530033005,060971530033005,"Block 3005, Block Group 3, Census Tract 1530.03, Sonoma County, California",7,6,1
1000000US060971530033006,060971530033006,"Block 3006, Block Group 3, Census Tract 1530.03, Sonoma County, California",2,2,0
1000000US060971530033007,060971530033007,"Block 3007, Block Group 3, Census Tract 1530.03, Sonoma County, California",249,238,11
1000000US060971530033008,060971530033008,"Block 3008, Block Group 3, Census Tract 1530.03, Sonoma County, California",0,0,0
1000000US060971530033009,060971530033009,"Block 3009, Block Group 3, Census Tract 1530.03, Sonoma County, California",11,9,2
1000000US060971530033010,060971530033010,"Block 3010, Block Group 3, Census Tract 1530.03, Sonoma County, California",205,203,2
1000000US060971530033011,060971530033011,"Block 3011, Block Group 3, Census Tract 1530.03, Sonoma County, California",24,21,3
1000000US060971530033012,060971530033012,"Block 3012, Block Group 3, Census Tract 1530.03, Sonoma County, California",53,50,3
1000000US060971530033013,060971530033013,"Block 3013, Block Group 3, Census Tract 1530.03, Sonoma County, California",18,18,0
1000000US060971530033014,060971530033014,"Block 3014, Block Group 3, Census Tract 1530.03, Sonoma County, California",30,29,1
1000000US060971530034000,060971530034000,"Block 4000, Block Group 4, Census Tract 1530.03, Sonoma County, California",76,71,5
1000000US060971530034001,060971530034001,"Block 4001, Block Group 4, Census Tract 1530.03, Sonoma County, California",0,0,0
1000000US060971530034002,060971530034002,"Block 4002, Block Group 4, Census Tract 1530.03, Sonoma County, California",0,0,0
1000000US060971530034003,060971530034003,"Block 4003, Block Group 4, Census Tract 1530.03, Sonoma County, California",489,434,55
1000000US060971530034004,060971530034004,"Block 4004, Block Group 4, Census Tract 1530.03, Sonoma County, California",47,44,3
1000000US060971530034005,060971530034005,"Block 4005, Block Group 4, Census Tract 1530.03, Sonoma County, California",0,0,0
1000000US060971530034006,060971530034006,"Block 4006, Block Group 4, Census Tract 1530.03, Sonoma County, California",0,0,0
1000000US060971530034007,060971530034007,"Block 4007, Block Group 4, Census Tract 1530.03, Sonoma County, California",3,3,0
1000000US060971530034008,060971530034008,"Block 4008, Block Group 4, Census Tract 1530.03, Sonoma County, California",29,29,0
1000000US060971530034009,060971530034009,"Block 4009, Block Group 4, Census Tract 1530.03, Sonoma County, California",0,0,0
1000000US060971530034010,060971530034010,"Block 4010, Block Group 4, Census Tract 1530.03, Sonoma County, California",36,35,1
1000000US060971530034011,060971530034011,"Block 4011, Block Group 4, Census Tract 1530.03, Sonoma County, California",0,0,0
1000000US060971530034012,060971530034012,"Block 4012, Block Group 4, Census Tract 1530.03, Sonoma County, California",0,0,0
1000000US060971530034013,060971530034013,"Block 4013, Block Group 4, Census Tract 1530.03, Sonoma County, California",0,0,0
1000000US060971530034014,060971530034014,"Block 4014, Block Group 4, Census Tract 1530.03, Sonoma County, California",0,0,0
1000000US060971530051000,060971530051000,"Block 1000, Block Group 1, Census Tract 1530.05, Sonoma County, California",0,0,0
1000000US060971530051001,060971530051001,"Block 1001, Block Group 1, Census Tract 1530.05, Sonoma County, California",62,60,2
1000000US060971530051002,060971530051002,"Block 1002, Block Group 1, Census Tract 1530.05, Sonoma County, California",0,0,0
1000000US060971530051003,060971530051003,"Block 1003, Block Group 1, Census Tract 1530.05, Sonoma County, California",2,2,0
1000000US060971530051004,060971530051004,"Block 1004, Block Group 1, Census Tract 1530.05, Sonoma County, California",39,34,5
1000000US060971530051005,060971530051005,"Block 1005, Block Group 1, Census Tract 1530.05, Sonoma County, California",22,19,3
1000000US060971530051006,060971530051006,"Block 1006, Block Group 1, Census Tract 1530.05, Sonoma County, California",160,132,28
1000000US060971530051007,060971530051007,"Block 1007, Block Group 1, Census Tract 1530.05, Sonoma County, California",0,0,0
1000000US060971530051008,060971530051008,"Block 1008, Block Group 1, Census Tract 1530.05, Sonoma County, California",49,46,3
1000000US060971530051009,060971530051009,"Block 1009, Block Group 1, Census Tract 1530.05, Sonoma County, California",31,29,2
1000000US060971530051010,060971530051010,"Block 1010, Block Group 1, Census Tract 1530.05, Sonoma County, California",0,0,0
1000000US060971530051011,060971530051011,"Block 1011, Block Group 1, Census Tract 1530.05, Sonoma County, California",0,0,0
1000000US060971530051012,060971530051012,"Block 1012, Block Group 1, Census Tract 1530.05, Sonoma County, California",0,0,0
1000000US060971530051013,060971530051013,"Block 1013, Block Group 1, Census Tract 1530.05, Sonoma County, California",8,6,2
1000000US060971530051014,060971530051014,"Block 1014, Block Group 1, Census Tract 1530.05, Sonoma County, California",24,21,3
1000000US060971530051015,060971530051015,"Block 1015, Block Group 1, Census Tract 1530.05, Sonoma County, California",13,11,2
1000000US060971530052000,060971530052000,"Block 2000, Block Group 2, Census Tract 1530.05, Sonoma County, California",28,26,2
1000000US060971530052001,060971530052001,"Block 2001, Block Group 2, Census Tract 1530.05, Sonoma County, California",5,4,1
1000000US060971530052002,060971530052002,"Block 2002, Block Group 2, Census Tract 1530.05, Sonoma County, California",101,89,12
1000000US060971530052003,060971530052003,"Block 2003, Block Group 2, Census Tract 1530.05, Sonoma County, California",0,0,0
1000000US060971530052004,060971530052004,"Block 2004, Block Group 2, Census Tract 1530.05, Sonoma County, California",0,0,0
1000000US060971530052005,060971530052005,"Block 2005, Block Group 2, Census Tract 1530.05, Sonoma County, California",0,0,0
1000000US060971530052006,060971530052006,"Block 2006, Block Group 2, Census Tract 1530.05, Sonoma County, California",20,18,2
1000000US060971530052007,060971530052007,"Block 2007, Block Group 2, Census Tract 1530.05, Sonoma County, California",0,0,0
1000000US060971530052008,060971530052008,"Block 2008, Block Group 2, Census Tract 1530.05, Sonoma County, California",0,0,0
1000000US060971530052009,060971530052009,"Block 2009, Block Group 2, Census Tract 1530.05, Sonoma County, California",5,4,1
1000000US060971530052010,060971530052010,"Block 2010, Block Group 2, Census Tract 1530.05, Sonoma County, California",0,0,0
1000000US060971530052011,060971530052011,"Block 2011, Block Group 2, Census Tract 1530.05, Sonoma County, California",0,0,0
1000000US060971530052012,060971530052012,"Block 2012, Block Group 2, Census Tract 1530.05, Sonoma County, California",1,1,0
1000000US060971530052013,060971530052013,"Block 2013, Block Group 2, Census Tract 1530.05, Sonoma County, California",0,0,0
1000000US060971530052014,060971530052014,"Block 2014, Block Group 2, Census Tract 1530.05, Sonoma County, California",3,3,0
1000000US060971530052015,060971530052015,"Block 2015, Block Group 2, Census Tract 1530.05, Sonoma County, California",0,0,0
1000000US060971530052016,060971530052016,"Block 2016, Block Group 2, Census Tract 1530.05, Sonoma County, California",29,26,3
1000000US060971530052017,060971530052017,"Block 2017, Block Group 2, Census Tract 1530.05, Sonoma County, California",15,12,3
1000000US060971530052018,060971530052018,"Block 2018, Block Group 2, Census Tract 1530.05, Sonoma County, California",12,11,1
1000000US060971530052019,060971530052019,"Block 2019, Block Group 2, Census Tract 1530.05, Sonoma County, California",0,0,0
1000000US060971530052020,060971530052020,"Block 2020, Block Group 2, Census Tract 1530.05, Sonoma County, California",2,1,1
1000000US060971530052021,060971530052021,"Block 2021, Block Group 2, Census Tract 1530.05, Sonoma County, California",0,0,0
1000000US060971530052022,060971530052022,"Block 2022, Block Group 2, Census Tract 1530.05, Sonoma County, California",0,0,0
1000000US060971530052023,060971530052023,"Block 2023, Block Group 2, Census Tract 1530.05, Sonoma County, California",0,0,0
1000000US060971530052024,060971530052024,"Block 2024, Block Group 2, Census Tract 1530.05, Sonoma County, California",0,0,0
1000000US060971530052025,060971530052025,"Block 2025, Block Group 2, Census Tract 1530.05, Sonoma County, California",1,1,0
1000000US060971530052026,060971530052026,"Block 2026, Block Group 2, Census Tract 1530.05, Sonoma County, California",49,42,7
1000000US060971530052027,060971530052027,"Block 2027, Block Group 2, Census Tract 1530.05, Sonoma County, California",34,30,4
1000000US060971530052028,060971530052028,"Block 2028, Block Group 2, Census Tract 1530.05, Sonoma County, California",0,0,0
1000000US060971530052029,060971530052029,"Block 2029, Block Group 2, Census Tract 1530.05, Sonoma County, California",0,0,0
1000000US060971530052030,060971530052030,"Block 2030, Block Group 2, Census Tract 1530.05, Sonoma County, California",0,0,0
1000000US060971530052031,060971530052031,"Block 2031, Block Group 2, Census Tract 1530.05, Sonoma County, California",0,0,0
1000000US060971530052032,060971530052032,"Block 2032, Block Group 2, Census Tract 1530.05, Sonoma County, California",0,0,0
1000000US060971530052033,060971530052033,"Block 2033, Block Group 2, Census Tract 1530.05, Sonoma County, California",0,0,0
1000000US060971530053000,060971530053000,"Block 3000, Block Group 3, Census Tract 1530.05, Sonoma County, California",0,0,0
1000000US060971530053001,060971530053001,"Block 3001, Block Group 3, Census Tract 1530.05, Sonoma County, California",50,49,1
1000000US060971530053002,060971530053002,"Block 3002, Block Group 3, Census Tract 1530.05, Sonoma County, California",4,3,1
1000000US060971530053003,060971530053003,"Block 3003, Block Group 3, Census Tract 1530.05, Sonoma County, California",0,0,0
1000000US060971530053004,060971530053004,"Block 3004, Block Group 3, Census Tract 1530.05, Sonoma County, California",0,0,0
1000000US060971530053005,060971530053005,"Block 3005, Block Group 3, Census Tract 1530.05, Sonoma County, California",0,0,0
1000000US060971530053006,060971530053006,"Block 3006, Block Group 3, Census Tract 1530.05, Sonoma County, California",29,29,0
1000000US060971530053007,060971530053007,"Block 3007, Block Group 3, Census Tract 1530.05, Sonoma County, California",0,0,0
1000000US060971530053008,060971530053008,"Block 3008, Block Group 3, Census Tract 1530.05, Sonoma County, California",0,0,0
1000000US060971530053009,060971530053009,"Block 3009, Block Group 3, Census Tract 1530.05, Sonoma County, California",22,21,1
1000000US060971530053010,060971530053010,"Block 3010, Block Group 3, Census Tract 1530.05, Sonoma County, California",0,0,0
1000000US060971530053011,060971530053011,"Block 3011, Block Group 3, Census Tract 1530.05, Sonoma County, California",2,1,1
1000000US060971530053012,060971530053012,"Block 3012, Block Group 3, Census Tract 1530.05, Sonoma County, California",6,6,0
1000000US060971530053013,060971530053013,"Block 3013, Block Group 3, Census Tract 1530.05, Sonoma County, California",6,5,1
1000000US060971530053014,060971530053014,"Block 3014, Block Group 3, Census Tract 1530.05, Sonoma County, California",5,5,0
1000000US060971530053015,060971530053015,"Block 3015, Block Group 3, Census Tract 1530.05, Sonoma County, California",15,13,2
1000000US060971530053016,060971530053016,"Block 3016, Block Group 3, Census Tract 1530.05, Sonoma County, California",0,0,0
1000000US060971530053017,060971530053017,"Block 3017, Block Group 3, Census Tract 1530.05, Sonoma County, California",2,1,1
1000000US060971530053018,060971530053018,"Block 3018, Block Group 3, Census Tract 1530.05, Sonoma County, California",42,37,5
1000000US060971530053019,060971530053019,"Block 3019, Block Group 3, Census Tract 1530.05, Sonoma County, California",0,0,0
1000000US060971530053020,060971530053020,"Block 3020, Block Group 3, Census Tract 1530.05, Sonoma County, California",1,1,0
1000000US060971530053021,060971530053021,"Block 3021, Block Group 3, Census Tract 1530.05, Sonoma County, California",5,4,1
1000000US060971530053022,060971530053022,"Block 3022, Block Group 3, Census Tract 1530.05, Sonoma County, California",0,0,0
1000000US060971530053023,060971530053023,"Block 3023, Block Group 3, Census Tract 1530.05, Sonoma County, California",0,0,0
1000000US060971530053024,060971530053024,"Block 3024, Block Group 3, Census Tract 1530.05, Sonoma County, California",0,0,0
1000000US060971530053025,060971530053025,"Block 3025, Block Group 3, Census Tract 1530.05, Sonoma County, California",0,0,0
1000000US060971530053026,060971530053026,"Block 3026, Block Group 3, Census Tract 1530.05, Sonoma County, California",0,0,0
1000000US060971530053027,060971530053027,"Block 3027, Block Group 3, Census Tract 1530.05, Sonoma County, California",0,0,0
1000000US060971530053028,060971530053028,"Block 3028, Block Group 3, Census Tract 1530.05, Sonoma County, California",3,3,0
1000000US060971530053029,060971530053029,"Block 3029, Block Group 3, Census Tract 1530.05, Sonoma County, California",80,78,2
1000000US060971530053030,060971530053030,"Block 3030, Block Group 3, Census Tract 1530.05, Sonoma County, California",0,0,0
1000000US060971530053031,060971530053031,"Block 3031, Block Group 3, Census Tract 1530.05, Sonoma County, California",7,7,0
1000000US060971530053032,060971530053032,"Block 3032, Block Group 3, Census Tract 1530.05, Sonoma County, California",7,7,0
1000000US060971530053033,060971530053033,"Block 3033, Block Group 3, Census Tract 1530.05, Sonoma County, California",6,6,0
1000000US060971530053034,060971530053034,"Block 3034, Block Group 3, Census Tract 1530.05, Sonoma County, California",3,3,0
1000000US060971530053035,060971530053035,"Block 3035, Block Group 3, Census Tract 1530.05, Sonoma County, California",23,23,0
1000000US060971530053036,060971530053036,"Block 3036, Block Group 3, Census Tract 1530.05, Sonoma County, California",0,0,0
1000000US060971530053037,060971530053037,"Block 3037, Block Group 3, Census Tract 1530.05, Sonoma County, California",0,0,0
1000000US060971530053038,060971530053038,"Block 3038, Block Group 3, Census Tract 1530.05, Sonoma County, California",0,0,0
1000000US060971530053039,060971530053039,"Block 3039, Block Group 3, Census Tract 1530.05, Sonoma County, California",9,9,0
1000000US060971530053040,060971530053040,"Block 3040, Block Group 3, Census Tract 1530.05, Sonoma County, California",5,4,1
1000000US060971530053041,060971530053041,"Block 3041, Block Group 3, Census Tract 1530.05, Sonoma County, California",118,110,8
1000000US060971530053042,060971530053042,"Block 3042, Block Group 3, Census Tract 1530.05, Sonoma County, California",50,46,4
1000000US060971530053043,060971530053043,"Block 3043, Block Group 3, Census Tract 1530.05, Sonoma County, California",2,2,0
1000000US060971530053044,060971530053044,"Block 3044, Block Group 3, Census Tract 1530.05, Sonoma County, California",38,36,2
1000000US060971530053045,060971530053045,"Block 3045, Block Group 3, Census Tract 1530.05, Sonoma County, California",27,27,0
1000000US060971530053046,060971530053046,"Block 3046, Block Group 3, Census Tract 1530.05, Sonoma County, California",18,17,1
1000000US060971530053047,060971530053047,"Block 3047, Block Group 3, Census Tract 1530.05, Sonoma County, California",0,0,0
1000000US060971530053048,060971530053048,"Block 3048, Block Group 3, Census Tract 1530.05, Sonoma County, California",0,0,0
1000000US060971530053049,060971530053049,"Block 3049, Block Group 3, Census Tract 1530.05, Sonoma County, California",0,0,0
1000000US060971530053050,060971530053050,"Block 3050, Block Group 3, Census Tract 1530.05, Sonoma County, California",0,0,0
1000000US060971530053051,060971530053051,"Block 3051, Block Group 3, Census Tract 1530.05, Sonoma County, California",0,0,0
1000000US060971530053052,060971530053052,"Block 3052, Block Group 3, Census Tract 1530.05, Sonoma County, California",2,2,0
1000000US060971530054000,060971530054000,"Block 4000, Block Group 4, Census Tract 1530.05, Sonoma County, California",0,0,0
1000000US060971530054001,060971530054001,"Block 4001, Block Group 4, Census Tract 1530.05, Sonoma County, California",0,0,0
1000000US060971530054002,060971530054002,"Block 4002, Block Group 4, Census Tract 1530.05, Sonoma County, California",56,56,0
1000000US060971530054003,060971530054003,"Block 4003, Block Group 4, Census Tract 1530.05, Sonoma County, California",11,11,0
1000000US060971530054004,060971530054004,"Block 4004, Block Group 4, Census Tract 1530.05, Sonoma County, California",0,0,0
1000000US060971530054005,060971530054005,"Block 4005, Block Group 4, Census Tract 1530.05, Sonoma County, California",30,29,1
1000000US060971530054006,060971530054006,"Block 4006, Block Group 4, Census Tract 1530.05, Sonoma County, California",0,0,0
1000000US060971530054007,060971530054007,"Block 4007, Block Group 4, Census Tract 1530.05, Sonoma County, California",0,0,0
1000000US060971530054008,060971530054008,"Block 4008, Block Group 4, Census Tract 1530.05, Sonoma County, California",37,35,2
1000000US060971530054009,060971530054009,"Block 4009, Block Group 4, Census Tract 1530.05, Sonoma County, California",59,58,1
1000000US060971530054010,060971530054010,"Block 4010, Block Group 4, Census Tract 1530.05, Sonoma County, California",31,31,0
1000000US060971530054011,060971530054011,"Block 4011, Block Group 4, Census Tract 1530.05, Sonoma County, California",31,29,2
1000000US060971530054012,060971530054012,"Block 4012, Block Group 4, Census Tract 1530.05, Sonoma County, California",24,22,2
1000000US060971530054013,060971530054013,"Block 4013, Block Group 4, Census Tract 1530.05, Sonoma County, California",42,42,0
1000000US060971530054014,060971530054014,"Block 4014, Block Group 4, Census Tract 1530.05, Sonoma County, California",13,13,0
1000000US060971530055000,060971530055000,"Block 5000, Block Group 5, Census Tract 1530.05, Sonoma County, California",68,65,3
1000000US060971530055001,060971530055001,"Block 5001, Block Group 5, Census Tract 1530.05, Sonoma County, California",10,10,0
1000000US060971530055002,060971530055002,"Block 5002, Block Group 5, Census Tract 1530.05, Sonoma County, California",10,10,0
1000000US060971530055003,060971530055003,"Block 5003, Block Group 5, Census Tract 1530.05, Sonoma County, California",115,109,6
1000000US060971530055004,060971530055004,"Block 5004, Block Group 5, Census Tract 1530.05, Sonoma County, California",50,47,3
1000000US060971530055005,060971530055005,"Block 5005, Block Group 5, Census Tract 1530.05, Sonoma County, California",1,1,0
1000000US060971530055006,060971530055006,"Block 5006, Block Group 5, Census Tract 1530.05, Sonoma County, California",22,18,4
1000000US060971530055007,060971530055007,"Block 5007, Block Group 5, Census Tract 1530.05, Sonoma County, California",0,0,0
1000000US060971530055008,060971530055008,"Block 5008, Block Group 5, Census Tract 1530.05, Sonoma County, California",198,193,5
1000000US060971530055009,060971530055009,"Block 5009, Block Group 5, Census Tract 1530.05, Sonoma County, California",64,60,4
1000000US060971530055010,060971530055010,"Block 5010, Block Group 5, Census Tract 1530.05, Sonoma County, California",58,58,0
1000000US060971530055011,060971530055011,"Block 5011, Block Group 5, Census Tract 1530.05, Sonoma County, California",0,0,0
1000000US060971530055012,060971530055012,"Block 5012, Block Group 5, Census Tract 1530.05, Sonoma County, California",16,15,1
1000000US060971530056000,060971530056000,"Block 6000, Block Group 6, Census Tract 1530.05, Sonoma County, California",0,0,0
1000000US060971530056001,060971530056001,"Block 6001, Block Group 6, Census Tract 1530.05, Sonoma County, California",0,0,0
1000000US060971530056002,060971530056002,"Block 6002, Block Group 6, Census Tract 1530.05, Sonoma County, California",58,54,4
1000000US060971530056003,060971530056003,"Block 6003, Block Group 6, Census Tract 1530.05, Sonoma County, California",83,80,3
1000000US060971530056004,060971530056004,"Block 6004, Block Group 6, Census Tract 1530.05, Sonoma County, California",0,0,0
1000000US060971530056005,060971530056005,"Block 6005, Block Group 6, Census Tract 1530.05, Sonoma County, California",0,0,0
1000000US060971530056006,060971530056006,"Block 6006, Block Group 6, Census Tract 1530.05, Sonoma County, California",48,46,2
1000000US060971530056007,060971530056007,"Block 6007, Block Group 6, Census Tract 1530.05, Sonoma County, California",97,97,0
1000000US060971530056008,060971530056008,"Block 6008, Block Group 6, Census Tract 1530.05, Sonoma County, California",37,37,0
1000000US060971530061000,060971530061000,"Block 1000, Block Group 1, Census Tract 1530.06, Sonoma County, California",0,0,0
1000000US060971530061001,060971530061001,"Block 1001, Block Group 1, Census Tract 1530.06, Sonoma County, California",153,146,7
1000000US060971530061002,060971530061002,"Block 1002, Block Group 1, Census Tract 1530.06, Sonoma County, California",168,155,13
1000000US060971530061003,060971530061003,"Block 1003, Block Group 1, Census Tract 1530.06, Sonoma County, California",0,0,0
1000000US060971530061004,060971530061004,"Block 1004, Block Group 1, Census Tract 1530.06, Sonoma County, California",0,0,0
1000000US060971530061005,060971530061005,"Block 1005, Block Group 1, Census Tract 1530.06, Sonoma County, California",33,31,2
1000000US060971530062000,060971530062000,"Block 2000, Block Group 2, Census Tract 1530.06, Sonoma County, California",102,99,3
1000000US060971530062001,060971530062001,"Block 2001, Block Group 2, Census Tract 1530.06, Sonoma County, California",29,29,0
1000000US060971530062002,060971530062002,"Block 2002, Block Group 2, Census Tract 1530.06, Sonoma County, California",5,5,0
1000000US060971530062003,060971530062003,"Block 2003, Block Group 2, Census Tract 1530.06, Sonoma County, California",0,0,0
1000000US060971530062004,060971530062004,"Block 2004, Block Group 2, Census Tract 1530.06, Sonoma County, California",125,123,2
1000000US060971530062005,060971530062005,"Block 2005, Block Group 2, Census Tract 1530.06, Sonoma County, California",33,31,2
1000000US060971530062006,060971530062006,"Block 2006, Block Group 2, Census Tract 1530.06, Sonoma County, California",30,30,0
1000000US060971530063000,060971530063000,"Block 3000, Block Group 3, Census Tract 1530.06, Sonoma County, California",145,139,6
1000000US060971530063001,060971530063001,"Block 3001, Block Group 3, Census Tract 1530.06, Sonoma County, California",54,53,1
1000000US060971530063002,060971530063002,"Block 3002, Block Group 3, Census Tract 1530.06, Sonoma County, California",59,59,0
1000000US060971530063003,060971530063003,"Block 3003, Block Group 3, Census Tract 1530.06, Sonoma County, California",61,59,2
1000000US060971530063004,060971530063004,"Block 3004, Block Group 3, Census Tract 1530.06, Sonoma County, California",80,74,6
1000000US060971530063005,060971530063005,"Block 3005, Block Group 3, Census Tract 1530.06, Sonoma County, California",50,49,1
1000000US060971530063006,060971530063006,"Block 3006, Block Group 3, Census Tract 1530.06, Sonoma County, California",0,0,0
1000000US060971530063007,060971530063007,"Block 3007, Block Group 3, Census Tract 1530.06, Sonoma County, California",19,19,0
1000000US060971530063008,060971530063008,"Block 3008, Block Group 3, Census Tract 1530.06, Sonoma County, California",17,16,1
1000000US060971530063009,060971530063009,"Block 3009, Block Group 3, Census Tract 1530.06, Sonoma County, California",59,53,6
1000000US060971530063010,060971530063010,"Block 3010, Block Group 3, Census Tract 1530.06, Sonoma County, California",18,18,0
1000000US060971530064000,060971530064000,"Block 4000, Block Group 4, Census Tract 1530.06, Sonoma County, California",97,97,0
1000000US060971530064001,060971530064001,"Block 4001, Block Group 4, Census Tract 1530.06, Sonoma County, California",131,120,11
1000000US060971530064002,060971530064002,"Block 4002, Block Group 4, Census Tract 1530.06, Sonoma County, California",13,13,0
1000000US060971530064003,060971530064003,"Block 4003, Block Group 4, Census Tract 1530.06, Sonoma County, California",48,46,2
1000000US060971530064004,060971530064004,"Block 4004, Block Group 4, Census Tract 1530.06, Sonoma County, California",18,18,0
1000000US060971530064005,060971530064005,"Block 4005, Block Group 4, Census Tract 1530.06, Sonoma County, California",0,0,0
1000000US060971530064006,060971530064006,"Block 4006, Block Group 4, Census Tract 1530.06, Sonoma County, California",11,11,0
1000000US060971530064007,060971530064007,"Block 4007, Block Group 4, Census Tract 1530.06, Sonoma County, California",14,12,2
1000000US060971530064008,060971530064008,"Block 4008, Block Group 4, Census Tract 1530.06, Sonoma County, California",1,1,0
1000000US060971530064009,060971530064009,"Block 4009, Block Group 4, Census Tract 1530.06, Sonoma County, California",0,0,0
1000000US060971530064010,060971530064010,"Block 4010, Block Group 4, Census Tract 1530.06, Sonoma County, California",131,125,6
1000000US060971530064011,060971530064011,"Block 4011, Block Group 4, Census Tract 1530.06, Sonoma County, California",11,10,1
1000000US060971530064012,060971530064012,"Block 4012, Block Group 4, Census Tract 1530.06, Sonoma County, California",63,61,2
1000000US060971530064013,060971530064013,"Block 4013, Block Group 4, Census Tract 1530.06, Sonoma County, California",43,42,1
1000000US060971530064014,060971530064014,"Block 4014, Block Group 4, Census Tract 1530.06, Sonoma County, California",183,181,2
1000000US060971530064015,060971530064015,"Block 4015, Block Group 4, Census Tract 1530.06, Sonoma County, California",51,47,4
1000000US060971530064016,060971530064016,"Block 4016, Block Group 4, Census Tract 1530.06, Sonoma County, California",35,33,2
1000000US060971530064017,060971530064017,"Block 4017, Block Group 4, Census Tract 1530.06, Sonoma County, California",11,11,0
1000000US060971530065000,060971530065000,"Block 5000, Block Group 5, Census Tract 1530.06, Sonoma County, California",55,51,4
1000000US060971530065001,060971530065001,"Block 5001, Block Group 5, Census Tract 1530.06, Sonoma County, California",26,24,2
1000000US060971530065002,060971530065002,"Block 5002, Block Group 5, Census Tract 1530.06, Sonoma County, California",15,15,0
1000000US060971530065003,060971530065003,"Block 5003, Block Group 5, Census Tract 1530.06, Sonoma County, California",25,25,0
1000000US060971530065004,060971530065004,"Block 5004, Block Group 5, Census Tract 1530.06, Sonoma County, California",78,76,2
1000000US060971530065005,060971530065005,"Block 5005, Block Group 5, Census Tract 1530.06, Sonoma County, California",25,24,1
1000000US060971530065006,060971530065006,"Block 5006, Block Group 5, Census Tract 1530.06, Sonoma County, California",18,18,0
1000000US060971530065007,060971530065007,"Block 5007, Block Group 5, Census Tract 1530.06, Sonoma County, California",30,29,1
1000000US060971530065008,060971530065008,"Block 5008, Block Group 5, Census Tract 1530.06, Sonoma County, California",19,19,0
1000000US060971530065009,060971530065009,"Block 5009, Block Group 5, Census Tract 1530.06, Sonoma County, California",18,18,0
1000000US060971530065010,060971530065010,"Block 5010, Block Group 5, Census Tract 1530.06, Sonoma County, California",17,17,0
1000000US060971530065011,060971530065011,"Block 5011, Block Group 5, Census Tract 1530.06, Sonoma County, California",13,12,1
1000000US060971530066000,060971530066000,"Block 6000, Block Group 6, Census Tract 1530.06, Sonoma County, California",193,186,7
1000000US060971530066001,060971530066001,"Block 6001, Block Group 6, Census Tract 1530.06, Sonoma County, California",1,1,0
1000000US060971530066002,060971530066002,"Block 6002, Block Group 6, Census Tract 1530.06, Sonoma County, California",9,8,1
1000000US060971530066003,060971530066003,"Block 6003, Block Group 6, Census Tract 1530.06, Sonoma County, California",0,0,0
1000000US060971530066004,060971530066004,"Block 6004, Block Group 6, Census Tract 1530.06, Sonoma County, California",18,17,1
1000000US060971530066005,060971530066005,"Block 6005, Block Group 6, Census Tract 1530.06, Sonoma County, California",18,17,1
1000000US060971530066006,060971530066006,"Block 6006, Block Group 6, Census Tract 1530.06, Sonoma County, California",8,7,1
1000000US060971530066007,060971530066007,"Block 6007, Block Group 6, Census Tract 1530.06, Sonoma County, California",12,10,2
1000000US060971530066008,060971530066008,"Block 6008, Block Group 6, Census Tract 1530.06, Sonoma County, California",15,12,3
1000000US060971530066009,060971530066009,"Block 6009, Block Group 6, Census Tract 1530.06, Sonoma County, California",14,12,2
1000000US060971530066010,060971530066010,"Block 6010, Block Group 6, Census Tract 1530.06, Sonoma County, California",46,44,2
1000000US060971530066011,060971530066011,"Block 6011, Block Group 6, Census Tract 1530.06, Sonoma County, California",25,23,2
1000000US060971530066012,060971530066012,"Block 6012, Block Group 6, Census Tract 1530.06, Sonoma County, California",4,4,0
1000000US060971530066013,060971530066013,"Block 6013, Block Group 6, Census Tract 1530.06, Sonoma County, California",40,40,0
1000000US060971530066014,060971530066014,"Block 6014, Block Group 6, Census Tract 1530.06, Sonoma County, California",73,71,2
1000000US060971530066015,060971530066015,"Block 6015, Block Group 6, Census Tract 1530.06, Sonoma County, California",3,3,0
1000000US060971531021000,060971531021000,"Block 1000, Block Group 1, Census Tract 1531.02, Sonoma County, California",31,30,1
1000000US060971531021001,060971531021001,"Block 1001, Block Group 1, Census Tract 1531.02, Sonoma County, California",58,54,4
1000000US060971531021002,060971531021002,"Block 1002, Block Group 1, Census Tract 1531.02, Sonoma County, California",82,77,5
1000000US060971531021003,060971531021003,"Block 1003, Block Group 1, Census Tract 1531.02, Sonoma County, California",30,29,1
1000000US060971531021004,060971531021004,"Block 1004, Block Group 1, Census Tract 1531.02, Sonoma County, California",39,36,3
1000000US060971531021005,060971531021005,"Block 1005, Block Group 1, Census Tract 1531.02, Sonoma County, California",49,49,0
1000000US060971531021006,060971531021006,"Block 1006, Block Group 1, Census Tract 1531.02, Sonoma County, California",16,16,0
1000000US060971531021007,060971531021007,"Block 1007, Block Group 1, Census Tract 1531.02, Sonoma County, California",16,15,1
1000000US060971531021008,060971531021008,"Block 1008, Block Group 1, Census Tract 1531.02, Sonoma County, California",21,20,1
1000000US060971531022000,060971531022000,"Block 2000, Block Group 2, Census Tract 1531.02, Sonoma County, California",77,73,4
1000000US060971531022001,060971531022001,"Block 2001, Block Group 2, Census Tract 1531.02, Sonoma County, California",11,11,0
1000000US060971531022002,060971531022002,"Block 2002, Block Group 2, Census Tract 1531.02, Sonoma County, California",8,8,0
1000000US060971531022003,060971531022003,"Block 2003, Block Group 2, Census Tract 1531.02, Sonoma County, California",1,1,0
1000000US060971531022004,060971531022004,"Block 2004, Block Group 2, Census Tract 1531.02, Sonoma County, California",0,0,0
1000000US060971531022005,060971531022005,"Block 2005, Block Group 2, Census Tract 1531.02, Sonoma County, California",31,29,2
1000000US060971531022006,060971531022006,"Block 2006, Block Group 2, Census Tract 1531.02, Sonoma County, California",32,32,0
1000000US060971531022007,060971531022007,"Block 2007, Block Group 2, Census Tract 1531.02, Sonoma County, California",7,6,1
1000000US060971531022008,060971531022008,"Block 2008, Block Group 2, Census Tract 1531.02, Sonoma County, California",47,47,0
1000000US060971531022009,060971531022009,"Block 2009, Block Group 2, Census Tract 1531.02, Sonoma County, California",16,16,0
1000000US060971531022010,060971531022010,"Block 2010, Block Group 2, Census Tract 1531.02, Sonoma County, California",26,26,0
1000000US060971531022011,060971531022011,"Block 2011, Block Group 2, Census Tract 1531.02, Sonoma County, California",0,0,0
1000000US060971531022012,060971531022012,"Block 2012, Block Group 2, Census Tract 1531.02, Sonoma County, California",187,176,11
1000000US060971531023000,060971531023000,"Block 3000, Block Group 3, Census Tract 1531.02, Sonoma County, California",0,0,0
1000000US060971531023001,060971531023001,"Block 3001, Block Group 3, Census Tract 1531.02, Sonoma County, California",0,0,0
1000000US060971531023002,060971531023002,"Block 3002, Block Group 3, Census Tract 1531.02, Sonoma County, California",39,37,2
1000000US060971531023003,060971531023003,"Block 3003, Block Group 3, Census Tract 1531.02, Sonoma County, California",82,76,6
1000000US060971531023004,060971531023004,"Block 3004, Block Group 3, Census Tract 1531.02, Sonoma County, California",5,5,0
1000000US060971531023005,060971531023005,"Block 3005, Block Group 3, Census Tract 1531.02, Sonoma County, California",14,14,0
1000000US060971531023006,060971531023006,"Block 3006, Block Group 3, Census Tract 1531.02, Sonoma County, California",20,16,4
1000000US060971531023007,060971531023007,"Block 3007, Block Group 3, Census Tract 1531.02, Sonoma County, California",10,10,0
1000000US060971531023008,060971531023008,"Block 3008, Block Group 3, Census Tract 1531.02, Sonoma County, California",0,0,0
1000000US060971531023009,060971531023009,"Block 3009, Block Group 3, Census Tract 1531.02, Sonoma County, California",0,0,0
1000000US060971531023010,060971531023010,"Block 3010, Block Group 3, Census Tract 1531.02, Sonoma County, California",0,0,0
1000000US060971531023011,060971531023011,"Block 3011, Block Group 3, Census Tract 1531.02, Sonoma County, California",36,28,8
1000000US060971531023012,060971531023012,"Block 3012, Block Group 3, Census Tract 1531.02, Sonoma County, California",44,44,0
1000000US060971531023013,060971531023013,"Block 3013, Block Group 3, Census Tract 1531.02, Sonoma County, California",41,37,4
1000000US060971531023014,060971531023014,"Block 3014, Block Group 3, Census Tract 1531.02, Sonoma County, California",52,47,5
1000000US060971531023015,060971531023015,"Block 3015, Block Group 3, Census Tract 1531.02, Sonoma County, California",21,20,1
1000000US060971531023016,060971531023016,"Block 3016, Block Group 3, Census Tract 1531.02, Sonoma County, California",31,28,3
1000000US060971531024000,060971531024000,"Block 4000, Block Group 4, Census Tract 1531.02, Sonoma County, California",0,0,0
1000000US060971531024001,060971531024001,"Block 4001, Block Group 4, Census Tract 1531.02, Sonoma County, California",0,0,0
1000000US060971531024002,060971531024002,"Block 4002, Block Group 4, Census Tract 1531.02, Sonoma County, California",199,195,4
1000000US060971531024003,060971531024003,"Block 4003, Block Group 4, Census Tract 1531.02, Sonoma County, California",28,28,0
1000000US060971531024004,060971531024004,"Block 4004, Block Group 4, Census Tract 1531.02, Sonoma County, California",0,0,0
1000000US060971531024005,060971531024005,"Block 4005, Block Group 4, Census Tract 1531.02, Sonoma County, California",10,10,0
1000000US060971531024006,060971531024006,"Block 4006, Block Group 4, Census Tract 1531.02, Sonoma County, California",30,30,0
1000000US060971531031000,060971531031000,"Block 1000, Block Group 1, Census Tract 1531.03, Sonoma County, California",62,61,1
1000000US060971531031001,060971531031001,"Block 1001, Block Group 1, Census Tract 1531.03, Sonoma County, California",33,31,2
1000000US060971531031002,060971531031002,"Block 1002, Block Group 1, Census Tract 1531.03, Sonoma County, California",30,28,2
1000000US060971531031003,060971531031003,"Block 1003, Block Group 1, Census Tract 1531.03, Sonoma County, California",67,59,8
1000000US060971531031004,060971531031004,"Block 1004, Block Group 1, Census Tract 1531.03, Sonoma County, California",21,20,1
1000000US060971531031005,060971531031005,"Block 1005, Block Group 1, Census Tract 1531.03, Sonoma County, California",285,264,21
1000000US060971531031006,060971531031006,"Block 1006, Block Group 1, Census Tract 1531.03, Sonoma County, California",21,18,3
1000000US060971531031007,060971531031007,"Block 1007, Block Group 1, Census Tract 1531.03, Sonoma County, California",14,14,0
1000000US060971531031008,060971531031008,"Block 1008, Block Group 1, Census Tract 1531.03, Sonoma County, California",34,33,1
1000000US060971531031009,060971531031009,"Block 1009, Block Group 1, Census Tract 1531.03, Sonoma County, California",16,12,4
1000000US060971531031010,060971531031010,"Block 1010, Block Group 1, Census Tract 1531.03, Sonoma County, California",18,18,0
1000000US060971531031011,060971531031011,"Block 1011, Block Group 1, Census Tract 1531.03, Sonoma County, California",39,37,2
1000000US060971531031012,060971531031012,"Block 1012, Block Group 1, Census Tract 1531.03, Sonoma County, California",1,1,0
1000000US060971531031013,060971531031013,"Block 1013, Block Group 1, Census Tract 1531.03, Sonoma County, California",17,17,0
1000000US060971531031014,060971531031014,"Block 1014, Block Group 1, Census Tract 1531.03, Sonoma County, California",0,0,0
1000000US060971531031015,060971531031015,"Block 1015, Block Group 1, Census Tract 1531.03, Sonoma County, California",24,23,1
1000000US060971531032000,060971531032000,"Block 2000, Block Group 2, Census Tract 1531.03, Sonoma County, California",0,0,0
1000000US060971531032001,060971531032001,"Block 2001, Block Group 2, Census Tract 1531.03, Sonoma County, California",33,33,0
1000000US060971531032002,060971531032002,"Block 2002, Block Group 2, Census Tract 1531.03, Sonoma County, California",146,136,10
1000000US060971531032003,060971531032003,"Block 2003, Block Group 2, Census Tract 1531.03, Sonoma County, California",0,0,0
1000000US060971531032004,060971531032004,"Block 2004, Block Group 2, Census Tract 1531.03, Sonoma County, California",13,12,1
1000000US060971531032005,060971531032005,"Block 2005, Block Group 2, Census Tract 1531.03, Sonoma County, California",1,0,1
1000000US060971531032006,060971531032006,"Block 2006, Block Group 2, Census Tract 1531.03, Sonoma County, California",0,0,0
1000000US060971531032007,060971531032007,"Block 2007, Block Group 2, Census Tract 1531.03, Sonoma County, California",23,22,1
1000000US060971531032008,060971531032008,"Block 2008, Block Group 2, Census Tract 1531.03, Sonoma County, California",67,66,1
1000000US060971531032009,060971531032009,"Block 2009, Block Group 2, Census Tract 1531.03, Sonoma County, California",26,25,1
1000000US060971531032010,060971531032010,"Block 2010, Block Group 2, Census Tract 1531.03, Sonoma County, California",63,61,2
1000000US060971531032011,060971531032011,"Block 2011, Block Group 2, Census Tract 1531.03, Sonoma County, California",37,37,0
1000000US060971531033000,060971531033000,"Block 3000, Block Group 3, Census Tract 1531.03, Sonoma County, California",99,94,5
1000000US060971531033001,060971531033001,"Block 3001, Block Group 3, Census Tract 1531.03, Sonoma County, California",13,12,1
1000000US060971531033002,060971531033002,"Block 3002, Block Group 3, Census Tract 1531.03, Sonoma County, California",156,151,5
1000000US060971531033003,060971531033003,"Block 3003, Block Group 3, Census Tract 1531.03, Sonoma County, California",43,41,2
1000000US060971531041000,060971531041000,"Block 1000, Block Group 1, Census Tract 1531.04, Sonoma County, California",0,0,0
1000000US060971531041001,060971531041001,"Block 1001, Block Group 1, Census Tract 1531.04, Sonoma County, California",0,0,0
1000000US060971531041002,060971531041002,"Block 1002, Block Group 1, Census Tract 1531.04, Sonoma County, California",0,0,0
1000000US060971531041003,060971531041003,"Block 1003, Block Group 1, Census Tract 1531.04, Sonoma County, California",0,0,0
1000000US060971531041004,060971531041004,"Block 1004, Block Group 1, Census Tract 1531.04, Sonoma County, California",0,0,0
1000000US060971531041005,060971531041005,"Block 1005, Block Group 1, Census Tract 1531.04, Sonoma County, California",0,0,0
1000000US060971531041006,060971531041006,"Block 1006, Block Group 1, Census Tract 1531.04, Sonoma County, California",0,0,0
1000000US060971531041007,060971531041007,"Block 1007, Block Group 1, Census Tract 1531.04, Sonoma County, California",4,4,0
1000000US060971531041008,060971531041008,"Block 1008, Block Group 1, Census Tract 1531.04, Sonoma County, California",186,177,9
1000000US060971531041009,060971531041009,"Block 1009, Block Group 1, Census Tract 1531.04, Sonoma County, California",1,0,1
1000000US060971531041010,060971531041010,"Block 1010, Block Group 1, Census Tract 1531.04, Sonoma County, California",7,7,0
1000000US060971531041011,060971531041011,"Block 1011, Block Group 1, Census Tract 1531.04, Sonoma County, California",0,0,0
1000000US060971531041012,060971531041012,"Block 1012, Block Group 1, Census Tract 1531.04, Sonoma County, California",1,1,0
1000000US060971531041013,060971531041013,"Block 1013, Block Group 1, Census Tract 1531.04, Sonoma County, California",127,115,12
1000000US060971531041014,060971531041014,"Block 1014, Block Group 1, Census Tract 1531.04, Sonoma County, California",7,7,0
1000000US060971531041015,060971531041015,"Block 1015, Block Group 1, Census Tract 1531.04, Sonoma County, California",41,40,1
1000000US060971531041016,060971531041016,"Block 1016, Block Group 1, Census Tract 1531.04, Sonoma County, California",36,35,1
1000000US060971531041017,060971531041017,"Block 1017, Block Group 1, Census Tract 1531.04, Sonoma County, California",33,33,0
1000000US060971531041018,060971531041018,"Block 1018, Block Group 1, Census Tract 1531.04, Sonoma County, California",23,20,3
1000000US060971531041019,060971531041019,"Block 1019, Block Group 1, Census Tract 1531.04, Sonoma County, California",68,65,3
1000000US060971531041020,060971531041020,"Block 1020, Block Group 1, Census Tract 1531.04, Sonoma County, California",29,24,5
1000000US060971531041021,060971531041021,"Block 1021, Block Group 1, Census Tract 1531.04, Sonoma County, California",24,23,1
1000000US060971531041022,060971531041022,"Block 1022, Block Group 1, Census Tract 1531.04, Sonoma County, California",0,0,0
1000000US060971531041023,060971531041023,"Block 1023, Block Group 1, Census Tract 1531.04, Sonoma County, California",24,23,1
1000000US060971531042000,060971531042000,"Block 2000, Block Group 2, Census Tract 1531.04, Sonoma County, California",0,0,0
1000000US060971531042001,060971531042001,"Block 2001, Block Group 2, Census Tract 1531.04, Sonoma County, California",0,0,0
1000000US060971531042002,060971531042002,"Block 2002, Block Group 2, Census Tract 1531.04, Sonoma County, California",0,0,0
1000000US060971531042003,060971531042003,"Block 2003, Block Group 2, Census Tract 1531.04, Sonoma County, California",0,0,0
1000000US060971531042004,060971531042004,"Block 2004, Block Group 2, Census Tract 1531.04, Sonoma County, California",5,2,3
1000000US060971531042005,060971531042005,"Block 2005, Block Group 2, Census Tract 1531.04, Sonoma County, California",0,0,0
1000000US060971531042006,060971531042006,"Block 2006, Block Group 2, Census Tract 1531.04, Sonoma County, California",0,0,0
1000000US060971531042007,060971531042007,"Block 2007, Block Group 2, Census Tract 1531.04, Sonoma County, California",0,0,0
1000000US060971531042008,060971531042008,"Block 2008, Block Group 2, Census Tract 1531.04, Sonoma County, California",0,0,0
1000000US060971531042009,060971531042009,"Block 2009, Block Group 2, Census Tract 1531.04, Sonoma County, California",25,21,4
1000000US060971531042010,060971531042010,"Block 2010, Block Group 2, Census Tract 1531.04, Sonoma County, California",49,46,3
1000000US060971531042011,060971531042011,"Block 2011, Block Group 2, Census Tract 1531.04, Sonoma County, California",0,0,0
1000000US060971531042012,060971531042012,"Block 2012, Block Group 2, Census Tract 1531.04, Sonoma County, California",0,0,0
1000000US060971531042013,060971531042013,"Block 2013, Block Group 2, Census Tract 1531.04, Sonoma County, California",2,2,0
1000000US060971531042014,060971531042014,"Block 2014, Block Group 2, Census Tract 1531.04, Sonoma County, California",78,69,9
1000000US060971531042015,060971531042015,"Block 2015, Block Group 2, Census Tract 1531.04, Sonoma County, California",47,47,0
1000000US060971531042016,060971531042016,"Block 2016, Block Group 2, Census Tract 1531.04, Sonoma County, California",5,5,0
1000000US060971531042017,060971531042017,"Block 2017, Block Group 2, Census Tract 1531.04, Sonoma County, California",8,7,1
1000000US060971531042018,060971531042018,"Block 2018, Block Group 2, Census Tract 1531.04, Sonoma County, California",0,0,0
1000000US060971531042019,060971531042019,"Block 2019, Block Group 2, Census Tract 1531.04, Sonoma County, California",27,25,2
1000000US060971531042020,060971531042020,"Block 2020, Block Group 2, Census Tract 1531.04, Sonoma County, California",23,19,4
1000000US060971531042021,060971531042021,"Block 2021, Block Group 2, Census Tract 1531.04, Sonoma County, California",1,1,0
1000000US060971531042022,060971531042022,"Block 2022, Block Group 2, Census Tract 1531.04, Sonoma County, California",0,0,0
1000000US060971531043000,060971531043000,"Block 3000, Block Group 3, Census Tract 1531.04, Sonoma County, California",0,0,0
1000000US060971531043001,060971531043001,"Block 3001, Block Group 3, Census Tract 1531.04, Sonoma County, California",1,0,1
1000000US060971531043002,060971531043002,"Block 3002, Block Group 3, Census Tract 1531.04, Sonoma County, California",3,3,0
1000000US060971531043003,060971531043003,"Block 3003, Block Group 3, Census Tract 1531.04, Sonoma County, California",347,335,12
1000000US060971532001000,060971532001000,"Block 1000, Block Group 1, Census Tract 1532, Sonoma County, California",7,6,1
1000000US060971532001001,060971532001001,"Block 1001, Block Group 1, Census Tract 1532, Sonoma County, California",55,53,2
1000000US060971532001002,060971532001002,"Block 1002, Block Group 1, Census Tract 1532, Sonoma County, California",17,17,0
1000000US060971532001003,060971532001003,"Block 1003, Block Group 1, Census Tract 1532, Sonoma County, California",39,38,1
1000000US060971532001004,060971532001004,"Block 1004, Block Group 1, Census Tract 1532, Sonoma County, California",32,29,3
1000000US060971532001005,060971532001005,"Block 1005, Block Group 1, Census Tract 1532, Sonoma County, California",58,52,6
1000000US060971532001006,060971532001006,"Block 1006, Block Group 1, Census Tract 1532, Sonoma County, California",0,0,0
1000000US060971532001007,060971532001007,"Block 1007, Block Group 1, Census Tract 1532, Sonoma County, California",2,2,0
1000000US060971532001008,060971532001008,"Block 1008, Block Group 1, Census Tract 1532, Sonoma County, California",0,0,0
1000000US060971532001009,060971532001009,"Block 1009, Block Group 1, Census Tract 1532, Sonoma County, California",0,0,0
1000000US060971532001010,060971532001010,"Block 1010, Block Group 1, Census Tract 1532, Sonoma County, California",0,0,0
1000000US060971532001011,060971532001011,"Block 1011, Block Group 1, Census Tract 1532, Sonoma County, California",45,41,4
1000000US060971532001012,060971532001012,"Block 1012, Block Group 1, Census Tract 1532, Sonoma County, California",53,51,2
1000000US060971532001013,060971532001013,"Block 1013, Block Group 1, Census Tract 1532, Sonoma County, California",1,1,0
1000000US060971532002000,060971532002000,"Block 2000, Block Group 2, Census Tract 1532, Sonoma County, California",0,0,0
1000000US060971532002001,060971532002001,"Block 2001, Block Group 2, Census Tract 1532, Sonoma County, California",0,0,0
1000000US060971532002002,060971532002002,"Block 2002, Block Group 2, Census Tract 1532, Sonoma County, California",0,0,0
1000000US060971532002003,060971532002003,"Block 2003, Block Group 2, Census Tract 1532, Sonoma County, California",2,2,0
1000000US060971532002004,060971532002004,"Block 2004, Block Group 2, Census Tract 1532, Sonoma County, California",0,0,0
1000000US060971532002005,060971532002005,"Block 2005, Block Group 2, Census Tract 1532, Sonoma County, California",100,95,5
1000000US060971532002006,060971532002006,"Block 2006, Block Group 2, Census Tract 1532, Sonoma County, California",0,0,0
1000000US060971532002007,060971532002007,"Block 2007, Block Group 2, Census Tract 1532, Sonoma County, California",6,3,3
1000000US060971532002008,060971532002008,"Block 2008, Block Group 2, Census Tract 1532, Sonoma County, California",0,0,0
1000000US060971532002009,060971532002009,"Block 2009, Block Group 2, Census Tract 1532, Sonoma County, California",0,0,0
1000000US060971532002010,060971532002010,"Block 2010, Block Group 2, Census Tract 1532, Sonoma County, California",0,0,0
1000000US060971532002011,060971532002011,"Block 2011, Block Group 2, Census Tract 1532, Sonoma County, California",0,0,0
1000000US060971532002012,060971532002012,"Block 2012, Block Group 2, Census Tract 1532, Sonoma County, California",0,0,0
1000000US060971532002013,060971532002013,"Block 2013, Block Group 2, Census Tract 1532, Sonoma County, California",0,0,0
1000000US060971532002014,060971532002014,"Block 2014, Block Group 2, Census Tract 1532, Sonoma County, California",0,0,0
1000000US060971532002015,060971532002015,"Block 2015, Block Group 2, Census Tract 1532, Sonoma County, California",0,0,0
1000000US060971532002016,060971532002016,"Block 2016, Block Group 2, Census Tract 1532, Sonoma County, California",0,0,0
1000000US060971532002017,060971532002017,"Block 2017, Block Group 2, Census Tract 1532, Sonoma County, California",0,0,0
1000000US060971532002018,060971532002018,"Block 2018, Block Group 2, Census Tract 1532, Sonoma County, California",0,0,0
1000000US060971532002019,060971532002019,"Block 2019, Block Group 2, Census Tract 1532, Sonoma County, California",23,19,4
1000000US060971532002020,060971532002020,"Block 2020, Block Group 2, Census Tract 1532, Sonoma County, California",2,2,0
1000000US060971532002021,060971532002021,"Block 2021, Block Group 2, Census Tract 1532, Sonoma County, California",1,1,0
1000000US060971532002022,060971532002022,"Block 2022, Block Group 2, Census Tract 1532, Sonoma County, California",15,15,0
1000000US060971532002023,060971532002023,"Block 2023, Block Group 2, Census Tract 1532, Sonoma County, California",25,22,3
1000000US060971532002024,060971532002024,"Block 2024, Block Group 2, Census Tract 1532, Sonoma County, California",26,20,6
1000000US060971532002025,060971532002025,"Block 2025, Block Group 2, Census Tract 1532, Sonoma County, California",32,27,5
1000000US060971532002026,060971532002026,"Block 2026, Block Group 2, Census Tract 1532, Sonoma County, California",18,15,3
1000000US060971532002027,060971532002027,"Block 2027, Block Group 2, Census Tract 1532, Sonoma County, California",15,13,2
1000000US060971532002028,060971532002028,"Block 2028, Block Group 2, Census Tract 1532, Sonoma County, California",29,21,8
1000000US060971532002029,060971532002029,"Block 2029, Block Group 2, Census Tract 1532, Sonoma County, California",6,5,1
1000000US060971532002030,060971532002030,"Block 2030, Block Group 2, Census Tract 1532, Sonoma County, California",1,1,0
1000000US060971532002031,060971532002031,"Block 2031, Block Group 2, Census Tract 1532, Sonoma County, California",9,9,0
1000000US060971532002032,060971532002032,"Block 2032, Block Group 2, Census Tract 1532, Sonoma County, California",0,0,0
1000000US060971532002033,060971532002033,"Block 2033, Block Group 2, Census Tract 1532, Sonoma County, California",0,0,0
1000000US060971532002034,060971532002034,"Block 2034, Block Group 2, Census Tract 1532, Sonoma County, California",0,0,0
1000000US060971532002035,060971532002035,"Block 2035, Block Group 2, Census Tract 1532, Sonoma County, California",9,9,0
1000000US060971532002036,060971532002036,"Block 2036, Block Group 2, Census Tract 1532, Sonoma County, California",14,11,3
1000000US060971532003000,060971532003000,"Block 3000, Block Group 3, Census Tract 1532, Sonoma County, California",104,100,4
1000000US060971532003001,060971532003001,"Block 3001, Block Group 3, Census Tract 1532, Sonoma County, California",19,17,2
1000000US060971532003002,060971532003002,"Block 3002, Block Group 3, Census Tract 1532, Sonoma County, California",12,10,2
1000000US060971532003003,060971532003003,"Block 3003, Block Group 3, Census Tract 1532, Sonoma County, California",20,20,0
1000000US060971532003004,060971532003004,"Block 3004, Block Group 3, Census Tract 1532, Sonoma County, California",15,15,0
1000000US060971532003005,060971532003005,"Block 3005, Block Group 3, Census Tract 1532, Sonoma County, California",18,16,2
1000000US060971532003006,060971532003006,"Block 3006, Block Group 3, Census Tract 1532, Sonoma County, California",167,157,10
1000000US060971532003007,060971532003007,"Block 3007, Block Group 3, Census Tract 1532, Sonoma County, California",32,30,2
1000000US060971532003008,060971532003008,"Block 3008, Block Group 3, Census Tract 1532, Sonoma County, California",1,1,0
1000000US060971532003009,060971532003009,"Block 3009, Block Group 3, Census Tract 1532, Sonoma County, California",0,0,0
1000000US060971532003010,060971532003010,"Block 3010, Block Group 3, Census Tract 1532, Sonoma County, California",80,76,4
1000000US060971532003011,060971532003011,"Block 3011, Block Group 3, Census Tract 1532, Sonoma County, California",16,16,0
1000000US060971532003012,060971532003012,"Block 3012, Block Group 3, Census Tract 1532, Sonoma County, California",25,21,4
1000000US060971532003013,060971532003013,"Block 3013, Block Group 3, Census Tract 1532, Sonoma County, California",0,0,0
1000000US060971532004000,060971532004000,"Block 4000, Block Group 4, Census Tract 1532, Sonoma County, California",0,0,0
1000000US060971532004001,060971532004001,"Block 4001, Block Group 4, Census Tract 1532, Sonoma County, California",0,0,0
1000000US060971532004002,060971532004002,"Block 4002, Block Group 4, Census Tract 1532, Sonoma County, California",24,24,0
1000000US060971532004003,060971532004003,"Block 4003, Block Group 4, Census Tract 1532, Sonoma County, California",0,0,0
1000000US060971532004004,060971532004004,"Block 4004, Block Group 4, Census Tract 1532, Sonoma County, California",1,1,0
1000000US060971532004005,060971532004005,"Block 4005, Block Group 4, Census Tract 1532, Sonoma County, California",1,1,0
1000000US060971532004006,060971532004006,"Block 4006, Block Group 4, Census Tract 1532, Sonoma County, California",0,0,0
1000000US060971532004007,060971532004007,"Block 4007, Block Group 4, Census Tract 1532, Sonoma County, California",13,12,1
1000000US060971532004008,060971532004008,"Block 4008, Block Group 4, Census Tract 1532, Sonoma County, California",0,0,0
1000000US060971532004009,060971532004009,"Block 4009, Block Group 4, Census Tract 1532, Sonoma County, California",0,0,0
1000000US060971532004010,060971532004010,"Block 4010, Block Group 4, Census Tract 1532, Sonoma County, California",40,36,4
1000000US060971532004011,060971532004011,"Block 4011, Block Group 4, Census Tract 1532, Sonoma County, California",5,4,1
1000000US060971532004012,060971532004012,"Block 4012, Block Group 4, Census Tract 1532, Sonoma County, California",6,6,0
1000000US060971532004013,060971532004013,"Block 4013, Block Group 4, Census Tract 1532, Sonoma County, California",41,38,3
1000000US060971532004014,060971532004014,"Block 4014, Block Group 4, Census Tract 1532, Sonoma County, California",3,3,0
1000000US060971532004015,060971532004015,"Block 4015, Block Group 4, Census Tract 1532, Sonoma County, California",19,19,0
1000000US060971532004016,060971532004016,"Block 4016, Block Group 4, Census Tract 1532, Sonoma County, California",10,10,0
1000000US060971532004017,060971532004017,"Block 4017, Block Group 4, Census Tract 1532, Sonoma County, California",40,40,0
1000000US060971532004018,060971532004018,"Block 4018, Block Group 4, Census Tract 1532, Sonoma County, California",31,29,2
1000000US060971532004019,060971532004019,"Block 4019, Block Group 4, Census Tract 1532, Sonoma County, California",40,39,1
1000000US060971532004020,060971532004020,"Block 4020, Block Group 4, Census Tract 1532, Sonoma County, California",7,7,0
1000000US060971532004021,060971532004021,"Block 4021, Block Group 4, Census Tract 1532, Sonoma County, California",16,14,2
1000000US060971532004022,060971532004022,"Block 4022, Block Group 4, Census Tract 1532, Sonoma County, California",80,74,6
1000000US060971532004023,060971532004023,"Block 4023, Block Group 4, Census Tract 1532, Sonoma County, California",12,12,0
1000000US060971532004024,060971532004024,"Block 4024, Block Group 4, Census Tract 1532, Sonoma County, California",18,18,0
1000000US060971532004025,060971532004025,"Block 4025, Block Group 4, Census Tract 1532, Sonoma County, California",12,10,2
1000000US060971532004026,060971532004026,"Block 4026, Block Group 4, Census Tract 1532, Sonoma County, California",130,126,4
1000000US060971532004027,060971532004027,"Block 4027, Block Group 4, Census Tract 1532, Sonoma County, California",14,14,0
1000000US060971532004028,060971532004028,"Block 4028, Block Group 4, Census Tract 1532, Sonoma County, California",12,12,0
1000000US060971532004029,060971532004029,"Block 4029, Block Group 4, Census Tract 1532, Sonoma County, California",11,11,0
1000000US060971532004030,060971532004030,"Block 4030, Block Group 4, Census Tract 1532, Sonoma County, California",40,40,0
1000000US060971532004031,060971532004031,"Block 4031, Block Group 4, Census Tract 1532, Sonoma County, California",14,13,1
1000000US060971532004032,060971532004032,"Block 4032, Block Group 4, Census Tract 1532, Sonoma County, California",22,22,0
1000000US060971532004033,060971532004033,"Block 4033, Block Group 4, Census Tract 1532, Sonoma County, California",10,9,1
1000000US060971532004034,060971532004034,"Block 4034, Block Group 4, Census Tract 1532, Sonoma County, California",15,15,0
1000000US060971532004035,060971532004035,"Block 4035, Block Group 4, Census Tract 1532, Sonoma County, California",44,44,0
1000000US060971532004036,060971532004036,"Block 4036, Block Group 4, Census Tract 1532, Sonoma County, California",16,15,1
1000000US060971532004037,060971532004037,"Block 4037, Block Group 4, Census Tract 1532, Sonoma County, California",3,3,0
1000000US060971532004038,060971532004038,"Block 4038, Block Group 4, Census Tract 1532, Sonoma County, California",12,11,1
1000000US060971532004039,060971532004039,"Block 4039, Block Group 4, Census Tract 1532, Sonoma County, California",32,31,1
1000000US060971532004040,060971532004040,"Block 4040, Block Group 4, Census Tract 1532, Sonoma County, California",128,122,6
1000000US060971532004041,060971532004041,"Block 4041, Block Group 4, Census Tract 1532, Sonoma County, California",45,44,1
1000000US060971532004042,060971532004042,"Block 4042, Block Group 4, Census Tract 1532, Sonoma County, California",16,16,0
1000000US060971532004043,060971532004043,"Block 4043, Block Group 4, Census Tract 1532, Sonoma County, California",12,11,1
1000000US060971532004044,060971532004044,"Block 4044, Block Group 4, Census Tract 1532, Sonoma County, California",14,14,0
1000000US060971532004045,060971532004045,"Block 4045, Block Group 4, Census Tract 1532, Sonoma County, California",14,14,0
1000000US060971532004046,060971532004046,"Block 4046, Block Group 4, Census Tract 1532, Sonoma County, California",0,0,0
1000000US060971532004047,060971532004047,"Block 4047, Block Group 4, Census Tract 1532, Sonoma County, California",0,0,0
1000000US060971532004048,060971532004048,"Block 4048, Block Group 4, Census Tract 1532, Sonoma County, California",0,0,0
1000000US060971532004049,060971532004049,"Block 4049, Block Group 4, Census Tract 1532, Sonoma County, California",0,0,0
1000000US060971532004050,060971532004050,"Block 4050, Block Group 4, Census Tract 1532, Sonoma County, California",24,24,0
1000000US060971532004051,060971532004051,"Block 4051, Block Group 4, Census Tract 1532, Sonoma County, California",28,27,1
1000000US060971532004052,060971532004052,"Block 4052, Block Group 4, Census Tract 1532, Sonoma County, California",10,10,0
1000000US060971532004053,060971532004053,"Block 4053, Block Group 4, Census Tract 1532, Sonoma County, California",16,16,0
1000000US060971532004054,060971532004054,"Block 4054, Block Group 4, Census Tract 1532, Sonoma County, California",12,11,1
1000000US060971533001000,060971533001000,"Block 1000, Block Group 1, Census Tract 1533, Sonoma County, California",0,0,0
1000000US060971533001001,060971533001001,"Block 1001, Block Group 1, Census Tract 1533, Sonoma County, California",0,0,0
1000000US060971533001002,060971533001002,"Block 1002, Block Group 1, Census Tract 1533, Sonoma County, California",0,0,0
1000000US060971533001003,060971533001003,"Block 1003, Block Group 1, Census Tract 1533, Sonoma County, California",108,103,5
1000000US060971533001004,060971533001004,"Block 1004, Block Group 1, Census Tract 1533, Sonoma County, California",0,0,0
1000000US060971533001005,060971533001005,"Block 1005, Block Group 1, Census Tract 1533, Sonoma County, California",0,0,0
1000000US060971533001006,060971533001006,"Block 1006, Block Group 1, Census Tract 1533, Sonoma County, California",0,0,0
1000000US060971533001007,060971533001007,"Block 1007, Block Group 1, Census Tract 1533, Sonoma County, California",60,56,4
1000000US060971533001008,060971533001008,"Block 1008, Block Group 1, Census Tract 1533, Sonoma County, California",1,1,0
1000000US060971533001009,060971533001009,"Block 1009, Block Group 1, Census Tract 1533, Sonoma County, California",53,49,4
1000000US060971533001010,060971533001010,"Block 1010, Block Group 1, Census Tract 1533, Sonoma County, California",5,5,0
1000000US060971533001011,060971533001011,"Block 1011, Block Group 1, Census Tract 1533, Sonoma County, California",19,18,1
1000000US060971533001012,060971533001012,"Block 1012, Block Group 1, Census Tract 1533, Sonoma County, California",0,0,0
1000000US060971533001013,060971533001013,"Block 1013, Block Group 1, Census Tract 1533, Sonoma County, California",2,2,0
1000000US060971533001014,060971533001014,"Block 1014, Block Group 1, Census Tract 1533, Sonoma County, California",54,53,1
1000000US060971533001015,060971533001015,"Block 1015, Block Group 1, Census Tract 1533, Sonoma County, California",47,43,4
1000000US060971533001016,060971533001016,"Block 1016, Block Group 1, Census Tract 1533, Sonoma County, California",212,166,46
1000000US060971533001017,060971533001017,"Block 1017, Block Group 1, Census Tract 1533, Sonoma County, California",32,24,8
1000000US060971533001018,060971533001018,"Block 1018, Block Group 1, Census Tract 1533, Sonoma County, California",29,23,6
1000000US060971533001019,060971533001019,"Block 1019, Block Group 1, Census Tract 1533, Sonoma County, California",59,53,6
1000000US060971533001020,060971533001020,"Block 1020, Block Group 1, Census Tract 1533, Sonoma County, California",18,17,1
1000000US060971533001021,060971533001021,"Block 1021, Block Group 1, Census Tract 1533, Sonoma County, California",16,16,0
1000000US060971533001022,060971533001022,"Block 1022, Block Group 1, Census Tract 1533, Sonoma County, California",7,7,0
1000000US060971533001023,060971533001023,"Block 1023, Block Group 1, Census Tract 1533, Sonoma County, California",15,13,2
1000000US060971533001024,060971533001024,"Block 1024, Block Group 1, Census Tract 1533, Sonoma County, California",6,6,0
1000000US060971533001025,060971533001025,"Block 1025, Block Group 1, Census Tract 1533, Sonoma County, California",14,14,0
1000000US060971533001026,060971533001026,"Block 1026, Block Group 1, Census Tract 1533, Sonoma County, California",1,1,0
1000000US060971533001027,060971533001027,"Block 1027, Block Group 1, Census Tract 1533, Sonoma County, California",33,31,2
1000000US060971533001028,060971533001028,"Block 1028, Block Group 1, Census Tract 1533, Sonoma County, California",12,12,0
1000000US060971533001029,060971533001029,"Block 1029, Block Group 1, Census Tract 1533, Sonoma County, California",22,20,2
1000000US060971533001030,060971533001030,"Block 1030, Block Group 1, Census Tract 1533, Sonoma County, California",67,54,13
1000000US060971533001031,060971533001031,"Block 1031, Block Group 1, Census Tract 1533, Sonoma County, California",8,8,0
1000000US060971533001032,060971533001032,"Block 1032, Block Group 1, Census Tract 1533, Sonoma County, California",40,37,3
1000000US060971533001033,060971533001033,"Block 1033, Block Group 1, Census Tract 1533, Sonoma County, California",7,6,1
1000000US060971533001034,060971533001034,"Block 1034, Block Group 1, Census Tract 1533, Sonoma County, California",18,14,4
1000000US060971533001035,060971533001035,"Block 1035, Block Group 1, Census Tract 1533, Sonoma County, California",43,37,6
1000000US060971533001036,060971533001036,"Block 1036, Block Group 1, Census Tract 1533, Sonoma County, California",5,5,0
1000000US060971533001037,060971533001037,"Block 1037, Block Group 1, Census Tract 1533, Sonoma County, California",19,17,2
1000000US060971533001038,060971533001038,"Block 1038, Block Group 1, Census Tract 1533, Sonoma County, California",48,34,14
1000000US060971533001039,060971533001039,"Block 1039, Block Group 1, Census Tract 1533, Sonoma County, California",19,19,0
1000000US060971533001040,060971533001040,"Block 1040, Block Group 1, Census Tract 1533, Sonoma County, California",23,23,0
1000000US060971533001041,060971533001041,"Block 1041, Block Group 1, Census Tract 1533, Sonoma County, California",18,17,1
1000000US060971533001042,060971533001042,"Block 1042, Block Group 1, Census Tract 1533, Sonoma County, California",14,13,1
1000000US060971533001043,060971533001043,"Block 1043, Block Group 1, Census Tract 1533, Sonoma County, California",52,51,1
1000000US060971533001044,060971533001044,"Block 1044, Block Group 1, Census Tract 1533, Sonoma County, California",0,0,0
1000000US060971533001045,060971533001045,"Block 1045, Block Group 1, Census Tract 1533, Sonoma County, California",5,5,0
1000000US060971533001046,060971533001046,"Block 1046, Block Group 1, Census Tract 1533, Sonoma County, California",40,40,0
1000000US060971533001047,060971533001047,"Block 1047, Block Group 1, Census Tract 1533, Sonoma County, California",14,14,0
1000000US060971533001048,060971533001048,"Block 1048, Block Group 1, Census Tract 1533, Sonoma County, California",12,12,0
1000000US060971533002000,060971533002000,"Block 2000, Block Group 2, Census Tract 1533, Sonoma County, California",0,0,0
1000000US060971533002001,060971533002001,"Block 2001, Block Group 2, Census Tract 1533, Sonoma County, California",2,2,0
1000000US060971533002002,060971533002002,"Block 2002, Block Group 2, Census Tract 1533, Sonoma County, California",1,1,0
1000000US060971533002003,060971533002003,"Block 2003, Block Group 2, Census Tract 1533, Sonoma County, California",0,0,0
1000000US060971533002004,060971533002004,"Block 2004, Block Group 2, Census Tract 1533, Sonoma County, California",0,0,0
1000000US060971533002005,060971533002005,"Block 2005, Block Group 2, Census Tract 1533, Sonoma County, California",31,29,2
1000000US060971533002006,060971533002006,"Block 2006, Block Group 2, Census Tract 1533, Sonoma County, California",8,7,1
1000000US060971533002007,060971533002007,"Block 2007, Block Group 2, Census Tract 1533, Sonoma County, California",0,0,0
1000000US060971533002008,060971533002008,"Block 2008, Block Group 2, Census Tract 1533, Sonoma County, California",91,87,4
1000000US060971533002009,060971533002009,"Block 2009, Block Group 2, Census Tract 1533, Sonoma County, California",2,2,0
1000000US060971533002010,060971533002010,"Block 2010, Block Group 2, Census Tract 1533, Sonoma County, California",1,1,0
1000000US060971533002011,060971533002011,"Block 2011, Block Group 2, Census Tract 1533, Sonoma County, California",6,5,1
1000000US060971533002012,060971533002012,"Block 2012, Block Group 2, Census Tract 1533, Sonoma County, California",3,3,0
1000000US060971533002013,060971533002013,"Block 2013, Block Group 2, Census Tract 1533, Sonoma County, California",0,0,0
1000000US060971533002014,060971533002014,"Block 2014, Block Group 2, Census Tract 1533, Sonoma County, California",0,0,0
1000000US060971533002015,060971533002015,"Block 2015, Block Group 2, Census Tract 1533, Sonoma County, California",0,0,0
1000000US060971533002016,060971533002016,"Block 2016, Block Group 2, Census Tract 1533, Sonoma County, California",64,59,5
1000000US060971533002017,060971533002017,"Block 2017, Block Group 2, Census Tract 1533, Sonoma County, California",1,1,0
1000000US060971533002018,060971533002018,"Block 2018, Block Group 2, Census Tract 1533, Sonoma County, California",2,2,0
1000000US060971533002019,060971533002019,"Block 2019, Block Group 2, Census Tract 1533, Sonoma County, California",73,68,5
1000000US060971533002020,060971533002020,"Block 2020, Block Group 2, Census Tract 1533, Sonoma County, California",44,39,5
1000000US060971533002021,060971533002021,"Block 2021, Block Group 2, Census Tract 1533, Sonoma County, California",0,0,0
1000000US060971533002022,060971533002022,"Block 2022, Block Group 2, Census Tract 1533, Sonoma County, California",1,1,0
1000000US060971533002023,060971533002023,"Block 2023, Block Group 2, Census Tract 1533, Sonoma County, California",22,21,1
1000000US060971533002024,060971533002024,"Block 2024, Block Group 2, Census Tract 1533, Sonoma County, California",0,0,0
1000000US060971533003000,060971533003000,"Block 3000, Block Group 3, Census Tract 1533, Sonoma County, California",83,76,7
1000000US060971533003001,060971533003001,"Block 3001, Block Group 3, Census Tract 1533, Sonoma County, California",0,0,0
1000000US060971533003002,060971533003002,"Block 3002, Block Group 3, Census Tract 1533, Sonoma County, California",0,0,0
1000000US060971533003003,060971533003003,"Block 3003, Block Group 3, Census Tract 1533, Sonoma County, California",0,0,0
1000000US060971533003004,060971533003004,"Block 3004, Block Group 3, Census Tract 1533, Sonoma County, California",41,40,1
1000000US060971533003005,060971533003005,"Block 3005, Block Group 3, Census Tract 1533, Sonoma County, California",34,33,1
1000000US060971533003006,060971533003006,"Block 3006, Block Group 3, Census Tract 1533, Sonoma County, California",0,0,0
1000000US060971533003007,060971533003007,"Block 3007, Block Group 3, Census Tract 1533, Sonoma County, California",0,0,0
1000000US060971533003008,060971533003008,"Block 3008, Block Group 3, Census Tract 1533, Sonoma County, California",0,0,0
1000000US060971533003009,060971533003009,"Block 3009, Block Group 3, Census Tract 1533, Sonoma County, California",0,0,0
1000000US060971533003010,060971533003010,"Block 3010, Block Group 3, Census Tract 1533, Sonoma County, California",3,3,0
1000000US060971533003011,060971533003011,"Block 3011, Block Group 3, Census Tract 1533, Sonoma County, California",2,2,0
1000000US060971533003012,060971533003012,"Block 3012, Block Group 3, Census Tract 1533, Sonoma County, California",0,0,0
1000000US060971533003013,060971533003013,"Block 3013, Block Group 3, Census Tract 1533, Sonoma County, California",0,0,0
1000000US060971533003014,060971533003014,"Block 3014, Block Group 3, Census Tract 1533, Sonoma County, California",0,0,0
1000000US060971533003015,060971533003015,"Block 3015, Block Group 3, Census Tract 1533, Sonoma County, California",0,0,0
1000000US060971533003016,060971533003016,"Block 3016, Block Group 3, Census Tract 1533, Sonoma County, California",0,0,0
1000000US060971533003017,060971533003017,"Block 3017, Block Group 3, Census Tract 1533, Sonoma County, California",0,0,0
1000000US060971533003018,060971533003018,"Block 3018, Block Group 3, Census Tract 1533, Sonoma County, California",0,0,0
1000000US060971533003019,060971533003019,"Block 3019, Block Group 3, Census Tract 1533, Sonoma County, California",0,0,0
1000000US060971533003020,060971533003020,"Block 3020, Block Group 3, Census Tract 1533, Sonoma County, California",0,0,0
1000000US060971533003021,060971533003021,"Block 3021, Block Group 3, Census Tract 1533, Sonoma County, California",0,0,0
1000000US060971533003022,060971533003022,"Block 3022, Block Group 3, Census Tract 1533, Sonoma County, California",0,0,0
1000000US060971533003023,060971533003023,"Block 3023, Block Group 3, Census Tract 1533, Sonoma County, California",5,5,0
1000000US060971533003024,060971533003024,"Block 3024, Block Group 3, Census Tract 1533, Sonoma County, California",0,0,0
1000000US060971533003025,060971533003025,"Block 3025, Block Group 3, Census Tract 1533, Sonoma County, California",0,0,0
1000000US060971533003026,060971533003026,"Block 3026, Block Group 3, Census Tract 1533, Sonoma County, California",0,0,0
1000000US060971533003027,060971533003027,"Block 3027, Block Group 3, Census Tract 1533, Sonoma County, California",0,0,0
1000000US060971533003028,060971533003028,"Block 3028, Block Group 3, Census Tract 1533, Sonoma County, California",0,0,0
1000000US060971533003029,060971533003029,"Block 3029, Block Group 3, Census Tract 1533, Sonoma County, California",0,0,0
1000000US060971533003030,060971533003030,"Block 3030, Block Group 3, Census Tract 1533, Sonoma County, California",0,0,0
1000000US060971533003031,060971533003031,"Block 3031, Block Group 3, Census Tract 1533, Sonoma County, California",0,0,0
1000000US060971533003032,060971533003032,"Block 3032, Block Group 3, Census Tract 1533, Sonoma County, California",0,0,0
1000000US060971533003033,060971533003033,"Block 3033, Block Group 3, Census Tract 1533, Sonoma County, California",0,0,0
1000000US060971533003034,060971533003034,"Block 3034, Block Group 3, Census Tract 1533, Sonoma County, California",0,0,0
1000000US060971533003035,060971533003035,"Block 3035, Block Group 3, Census Tract 1533, Sonoma County, California",3,3,0
1000000US060971533003036,060971533003036,"Block 3036, Block Group 3, Census Tract 1533, Sonoma County, California",0,0,0
1000000US060971533003037,060971533003037,"Block 3037, Block Group 3, Census Tract 1533, Sonoma County, California",21,18,3
1000000US060971533003038,060971533003038,"Block 3038, Block Group 3, Census Tract 1533, Sonoma County, California",2,2,0
1000000US060971533003039,060971533003039,"Block 3039, Block Group 3, Census Tract 1533, Sonoma County, California",42,40,2
1000000US060971533003040,060971533003040,"Block 3040, Block Group 3, Census Tract 1533, Sonoma County, California",113,108,5
1000000US060971533003041,060971533003041,"Block 3041, Block Group 3, Census Tract 1533, Sonoma County, California",0,0,0
1000000US060971533003042,060971533003042,"Block 3042, Block Group 3, Census Tract 1533, Sonoma County, California",45,43,2
1000000US060971533003043,060971533003043,"Block 3043, Block Group 3, Census Tract 1533, Sonoma County, California",0,0,0
1000000US060971533003044,060971533003044,"Block 3044, Block Group 3, Census Tract 1533, Sonoma County, California",0,0,0
1000000US060971533003045,060971533003045,"Block 3045, Block Group 3, Census Tract 1533, Sonoma County, California",59,51,8
1000000US060971533003046,060971533003046,"Block 3046, Block Group 3, Census Tract 1533, Sonoma County, California",1,1,0
1000000US060971533003047,060971533003047,"Block 3047, Block Group 3, Census Tract 1533, Sonoma County, California",5,5,0
1000000US060971533003048,060971533003048,"Block 3048, Block Group 3, Census Tract 1533, Sonoma County, California",8,8,0
1000000US060971533003049,060971533003049,"Block 3049, Block Group 3, Census Tract 1533, Sonoma County, California",32,31,1
1000000US060971533003050,060971533003050,"Block 3050, Block Group 3, Census Tract 1533, Sonoma County, California",25,23,2
1000000US060971533003051,060971533003051,"Block 3051, Block Group 3, Census Tract 1533, Sonoma County, California",0,0,0
1000000US060971533003052,060971533003052,"Block 3052, Block Group 3, Census Tract 1533, Sonoma County, California",0,0,0
1000000US060971533003053,060971533003053,"Block 3053, Block Group 3, Census Tract 1533, Sonoma County, California",14,14,0
1000000US060971533003054,060971533003054,"Block 3054, Block Group 3, Census Tract 1533, Sonoma County, California",0,0,0
1000000US060971533003055,060971533003055,"Block 3055, Block Group 3, Census Tract 1533, Sonoma County, California",0,0,0
1000000US060971533003056,060971533003056,"Block 3056, Block Group 3, Census Tract 1533, Sonoma County, California",0,0,0
1000000US060971533003057,060971533003057,"Block 3057, Block Group 3, Census Tract 1533, Sonoma County, California",0,0,0
1000000US060971533003058,060971533003058,"Block 3058, Block Group 3, Census Tract 1533, Sonoma County, California",0,0,0
1000000US060971533004000,060971533004000,"Block 4000, Block Group 4, Census Tract 1533, Sonoma County, California",36,32,4
1000000US060971533004001,060971533004001,"Block 4001, Block Group 4, Census Tract 1533, Sonoma County, California",151,145,6
1000000US060971533004002,060971533004002,"Block 4002, Block Group 4, Census Tract 1533, Sonoma County, California",253,251,2
1000000US060971533004003,060971533004003,"Block 4003, Block Group 4, Census Tract 1533, Sonoma County, California",0,0,0
1000000US060971533004004,060971533004004,"Block 4004, Block Group 4, Census Tract 1533, Sonoma County, California",0,0,0
1000000US060971533004005,060971533004005,"Block 4005, Block Group 4, Census Tract 1533, Sonoma County, California",0,0,0
1000000US060971533004006,060971533004006,"Block 4006, Block Group 4, Census Tract 1533, Sonoma County, California",14,14,0
1000000US060971533004007,060971533004007,"Block 4007, Block Group 4, Census Tract 1533, Sonoma County, California",18,17,1
1000000US060971533004008,060971533004008,"Block 4008, Block Group 4, Census Tract 1533, Sonoma County, California",0,0,0
1000000US060971533004009,060971533004009,"Block 4009, Block Group 4, Census Tract 1533, Sonoma County, California",0,0,0
1000000US060971533004010,060971533004010,"Block 4010, Block Group 4, Census Tract 1533, Sonoma County, California",47,46,1
1000000US060971533004011,060971533004011,"Block 4011, Block Group 4, Census Tract 1533, Sonoma County, California",21,18,3
1000000US060971533004012,060971533004012,"Block 4012, Block Group 4, Census Tract 1533, Sonoma County, California",0,0,0
1000000US060971533004013,060971533004013,"Block 4013, Block Group 4, Census Tract 1533, Sonoma County, California",261,243,18
1000000US060971533004014,060971533004014,"Block 4014, Block Group 4, Census Tract 1533, Sonoma County, California",1,1,0
1000000US060971533004015,060971533004015,"Block 4015, Block Group 4, Census Tract 1533, Sonoma County, California",0,0,0
1000000US060971533004016,060971533004016,"Block 4016, Block Group 4, Census Tract 1533, Sonoma County, California",25,24,1
1000000US060971533004017,060971533004017,"Block 4017, Block Group 4, Census Tract 1533, Sonoma County, California",0,0,0
1000000US060971533004018,060971533004018,"Block 4018, Block Group 4, Census Tract 1533, Sonoma County, California",0,0,0
1000000US060971533004019,060971533004019,"Block 4019, Block Group 4, Census Tract 1533, Sonoma County, California",18,18,0
1000000US060971533004020,060971533004020,"Block 4020, Block Group 4, Census Tract 1533, Sonoma County, California",26,24,2
1000000US060971533004021,060971533004021,"Block 4021, Block Group 4, Census Tract 1533, Sonoma County, California",35,34,1
1000000US060971533004022,060971533004022,"Block 4022, Block Group 4, Census Tract 1533, Sonoma County, California",0,0,0
1000000US060971533004023,060971533004023,"Block 4023, Block Group 4, Census Tract 1533, Sonoma County, California",0,0,0
1000000US060971533004024,060971533004024,"Block 4024, Block Group 4, Census Tract 1533, Sonoma County, California",0,0,0
1000000US060971533004025,060971533004025,"Block 4025, Block Group 4, Census Tract 1533, Sonoma County, California",8,7,1
1000000US060971533004026,060971533004026,"Block 4026, Block Group 4, Census Tract 1533, Sonoma County, California",8,8,0
1000000US060971533004027,060971533004027,"Block 4027, Block Group 4, Census Tract 1533, Sonoma County, California",0,0,0
1000000US060971533004028,060971533004028,"Block 4028, Block Group 4, Census Tract 1533, Sonoma County, California",19,17,2
1000000US060971533004029,060971533004029,"Block 4029, Block Group 4, Census Tract 1533, Sonoma County, California",15,15,0
1000000US060971533004030,060971533004030,"Block 4030, Block Group 4, Census Tract 1533, Sonoma County, California",14,14,0
1000000US060971533004031,060971533004031,"Block 4031, Block Group 4, Census Tract 1533, Sonoma County, California",32,29,3
1000000US060971533004032,060971533004032,"Block 4032, Block Group 4, Census Tract 1533, Sonoma County, California",0,0,0
1000000US060971533004033,060971533004033,"Block 4033, Block Group 4, Census Tract 1533, Sonoma County, California",14,13,1
1000000US060971533004034,060971533004034,"Block 4034, Block Group 4, Census Tract 1533, Sonoma County, California",0,0,0
1000000US060971533004035,060971533004035,"Block 4035, Block Group 4, Census Tract 1533, Sonoma County, California",9,7,2
1000000US060971533004036,060971533004036,"Block 4036, Block Group 4, Census Tract 1533, Sonoma County, California",20,19,1
1000000US060971533004037,060971533004037,"Block 4037, Block Group 4, Census Tract 1533, Sonoma County, California",13,13,0
1000000US060971533004038,060971533004038,"Block 4038, Block Group 4, Census Tract 1533, Sonoma County, California",0,0,0
1000000US060971533004039,060971533004039,"Block 4039, Block Group 4, Census Tract 1533, Sonoma County, California",26,26,0
1000000US060971533004040,060971533004040,"Block 4040, Block Group 4, Census Tract 1533, Sonoma County, California",26,24,2
1000000US060971533004041,060971533004041,"Block 4041, Block Group 4, Census Tract 1533, Sonoma County, California",16,16,0
1000000US060971533004042,060971533004042,"Block 4042, Block Group 4, Census Tract 1533, Sonoma County, California",19,18,1
1000000US060971533004043,060971533004043,"Block 4043, Block Group 4, Census Tract 1533, Sonoma County, California",0,0,0
1000000US060971533004044,060971533004044,"Block 4044, Block Group 4, Census Tract 1533, Sonoma County, California",0,0,0
1000000US060971533004045,060971533004045,"Block 4045, Block Group 4, Census Tract 1533, Sonoma County, California",0,0,0
1000000US060971533004046,060971533004046,"Block 4046, Block Group 4, Census Tract 1533, Sonoma County, California",16,15,1
1000000US060971533004047,060971533004047,"Block 4047, Block Group 4, Census Tract 1533, Sonoma County, California",16,14,2
1000000US060971533004048,060971533004048,"Block 4048, Block Group 4, Census Tract 1533, Sonoma County, California",14,14,0
1000000US060971533004049,060971533004049,"Block 4049, Block Group 4, Census Tract 1533, Sonoma County, California",13,13,0
1000000US060971533004050,060971533004050,"Block 4050, Block Group 4, Census Tract 1533, Sonoma County, California",14,13,1
1000000US060971533004051,060971533004051,"Block 4051, Block Group 4, Census Tract 1533, Sonoma County, California",14,13,1
1000000US060971533004052,060971533004052,"Block 4052, Block Group 4, Census Tract 1533, Sonoma County, California",37,37,0
1000000US060971533004053,060971533004053,"Block 4053, Block Group 4, Census Tract 1533, Sonoma County, California",0,0,0
1000000US060971533004054,060971533004054,"Block 4054, Block Group 4, Census Tract 1533, Sonoma County, California",0,0,0
1000000US060971533004055,060971533004055,"Block 4055, Block Group 4, Census Tract 1533, Sonoma County, California",27,26,1
1000000US060971533004056,060971533004056,"Block 4056, Block Group 4, Census Tract 1533, Sonoma County, California",15,13,2
1000000US060971533004057,060971533004057,"Block 4057, Block Group 4, Census Tract 1533, Sonoma County, California",24,22,2
1000000US060971533004058,060971533004058,"Block 4058, Block Group 4, Census Tract 1533, Sonoma County, California",1,1,0
1000000US060971533004059,060971533004059,"Block 4059, Block Group 4, Census Tract 1533, Sonoma County, California",16,16,0
1000000US060971533004060,060971533004060,"Block 4060, Block Group 4, Census Tract 1533, Sonoma County, California",28,28,0
1000000US060971533004061,060971533004061,"Block 4061, Block Group 4, Census Tract 1533, Sonoma County, California",15,15,0
1000000US060971533004062,060971533004062,"Block 4062, Block Group 4, Census Tract 1533, Sonoma County, California",26,25,1
1000000US060971533004063,060971533004063,"Block 4063, Block Group 4, Census Tract 1533, Sonoma County, California",44,42,2
1000000US060971533004064,060971533004064,"Block 4064, Block Group 4, Census Tract 1533, Sonoma County, California",23,23,0
1000000US060971533004065,060971533004065,"Block 4065, Block Group 4, Census Tract 1533, Sonoma County, California",25,23,2
1000000US060971533004066,060971533004066,"Block 4066, Block Group 4, Census Tract 1533, Sonoma County, California",6,6,0
1000000US060971533004067,060971533004067,"Block 4067, Block Group 4, Census Tract 1533, Sonoma County, California",17,15,2
1000000US060971533004068,060971533004068,"Block 4068, Block Group 4, Census Tract 1533, Sonoma County, California",16,16,0
1000000US060971533004069,060971533004069,"Block 4069, Block Group 4, Census Tract 1533, Sonoma County, California",42,40,2
1000000US060971533004070,060971533004070,"Block 4070, Block Group 4, Census Tract 1533, Sonoma County, California",14,14,0
1000000US060971533004071,060971533004071,"Block 4071, Block Group 4, Census Tract 1533, Sonoma County, California",0,0,0
1000000US060971534011000,060971534011000,"Block 1000, Block Group 1, Census Tract 1534.01, Sonoma County, California",0,0,0
1000000US060971534011001,060971534011001,"Block 1001, Block Group 1, Census Tract 1534.01, Sonoma County, California",44,42,2
1000000US060971534011002,060971534011002,"Block 1002, Block Group 1, Census Tract 1534.01, Sonoma County, California",0,0,0
1000000US060971534011003,060971534011003,"Block 1003, Block Group 1, Census Tract 1534.01, Sonoma County, California",0,0,0
1000000US060971534011004,060971534011004,"Block 1004, Block Group 1, Census Tract 1534.01, Sonoma County, California",0,0,0
1000000US060971534011005,060971534011005,"Block 1005, Block Group 1, Census Tract 1534.01, Sonoma County, California",1,1,0
1000000US060971534011006,060971534011006,"Block 1006, Block Group 1, Census Tract 1534.01, Sonoma County, California",30,30,0
1000000US060971534011007,060971534011007,"Block 1007, Block Group 1, Census Tract 1534.01, Sonoma County, California",59,57,2
1000000US060971534011008,060971534011008,"Block 1008, Block Group 1, Census Tract 1534.01, Sonoma County, California",22,22,0
1000000US060971534011009,060971534011009,"Block 1009, Block Group 1, Census Tract 1534.01, Sonoma County, California",20,20,0
1000000US060971534011010,060971534011010,"Block 1010, Block Group 1, Census Tract 1534.01, Sonoma County, California",17,16,1
1000000US060971534011011,060971534011011,"Block 1011, Block Group 1, Census Tract 1534.01, Sonoma County, California",16,16,0
1000000US060971534011012,060971534011012,"Block 1012, Block Group 1, Census Tract 1534.01, Sonoma County, California",0,0,0
1000000US060971534011013,060971534011013,"Block 1013, Block Group 1, Census Tract 1534.01, Sonoma County, California",0,0,0
1000000US060971534011014,060971534011014,"Block 1014, Block Group 1, Census Tract 1534.01, Sonoma County, California",5,5,0
1000000US060971534011015,060971534011015,"Block 1015, Block Group 1, Census Tract 1534.01, Sonoma County, California",20,18,2
1000000US060971534011016,060971534011016,"Block 1016, Block Group 1, Census Tract 1534.01, Sonoma County, California",21,21,0
1000000US060971534011017,060971534011017,"Block 1017, Block Group 1, Census Tract 1534.01, Sonoma County, California",0,0,0
1000000US060971534011018,060971534011018,"Block 1018, Block Group 1, Census Tract 1534.01, Sonoma County, California",23,23,0
1000000US060971534011019,060971534011019,"Block 1019, Block Group 1, Census Tract 1534.01, Sonoma County, California",4,4,0
1000000US060971534011020,060971534011020,"Block 1020, Block Group 1, Census Tract 1534.01, Sonoma County, California",0,0,0
1000000US060971534011021,060971534011021,"Block 1021, Block Group 1, Census Tract 1534.01, Sonoma County, California",0,0,0
1000000US060971534011022,060971534011022,"Block 1022, Block Group 1, Census Tract 1534.01, Sonoma County, California",0,0,0
1000000US060971534011023,060971534011023,"Block 1023, Block Group 1, Census Tract 1534.01, Sonoma County, California",0,0,0
1000000US060971534011024,060971534011024,"Block 1024, Block Group 1, Census Tract 1534.01, Sonoma County, California",0,0,0
1000000US060971534011025,060971534011025,"Block 1025, Block Group 1, Census Tract 1534.01, Sonoma County, California",0,0,0
1000000US060971534011026,060971534011026,"Block 1026, Block Group 1, Census Tract 1534.01, Sonoma County, California",0,0,0
1000000US060971534011027,060971534011027,"Block 1027, Block Group 1, Census Tract 1534.01, Sonoma County, California",0,0,0
1000000US060971534011028,060971534011028,"Block 1028, Block Group 1, Census Tract 1534.01, Sonoma County, California",0,0,0
1000000US060971534011029,060971534011029,"Block 1029, Block Group 1, Census Tract 1534.01, Sonoma County, California",13,13,0
1000000US060971534011030,060971534011030,"Block 1030, Block Group 1, Census Tract 1534.01, Sonoma County, California",0,0,0
1000000US060971534011031,060971534011031,"Block 1031, Block Group 1, Census Tract 1534.01, Sonoma County, California",6,5,1
1000000US060971534011032,060971534011032,"Block 1032, Block Group 1, Census Tract 1534.01, Sonoma County, California",0,0,0
1000000US060971534011033,060971534011033,"Block 1033, Block Group 1, Census Tract 1534.01, Sonoma County, California",0,0,0
1000000US060971534011034,060971534011034,"Block 1034, Block Group 1, Census Tract 1534.01, Sonoma County, California",15,15,0
1000000US060971534011035,060971534011035,"Block 1035, Block Group 1, Census Tract 1534.01, Sonoma County, California",7,5,2
1000000US060971534011036,060971534011036,"Block 1036, Block Group 1, Census Tract 1534.01, Sonoma County, California",0,0,0
1000000US060971534012000,060971534012000,"Block 2000, Block Group 2, Census Tract 1534.01, Sonoma County, California",73,65,8
1000000US060971534012001,060971534012001,"Block 2001, Block Group 2, Census Tract 1534.01, Sonoma County, California",34,27,7
1000000US060971534012002,060971534012002,"Block 2002, Block Group 2, Census Tract 1534.01, Sonoma County, California",17,17,0
1000000US060971534012003,060971534012003,"Block 2003, Block Group 2, Census Tract 1534.01, Sonoma County, California",64,60,4
1000000US060971534012004,060971534012004,"Block 2004, Block Group 2, Census Tract 1534.01, Sonoma County, California",0,0,0
1000000US060971534012005,060971534012005,"Block 2005, Block Group 2, Census Tract 1534.01, Sonoma County, California",131,118,13
1000000US060971534012006,060971534012006,"Block 2006, Block Group 2, Census Tract 1534.01, Sonoma County, California",7,7,0
1000000US060971534012007,060971534012007,"Block 2007, Block Group 2, Census Tract 1534.01, Sonoma County, California",14,14,0
1000000US060971534012008,060971534012008,"Block 2008, Block Group 2, Census Tract 1534.01, Sonoma County, California",84,79,5
1000000US060971534012009,060971534012009,"Block 2009, Block Group 2, Census Tract 1534.01, Sonoma County, California",7,7,0
1000000US060971534012010,060971534012010,"Block 2010, Block Group 2, Census Tract 1534.01, Sonoma County, California",4,4,0
1000000US060971534012011,060971534012011,"Block 2011, Block Group 2, Census Tract 1534.01, Sonoma County, California",21,20,1
1000000US060971534012012,060971534012012,"Block 2012, Block Group 2, Census Tract 1534.01, Sonoma County, California",77,76,1
1000000US060971534012013,060971534012013,"Block 2013, Block Group 2, Census Tract 1534.01, Sonoma County, California",9,9,0
1000000US060971534012014,060971534012014,"Block 2014, Block Group 2, Census Tract 1534.01, Sonoma County, California",6,6,0
1000000US060971534012015,060971534012015,"Block 2015, Block Group 2, Census Tract 1534.01, Sonoma County, California",4,4,0
1000000US060971534012016,060971534012016,"Block 2016, Block Group 2, Census Tract 1534.01, Sonoma County, California",4,4,0
1000000US060971534012017,060971534012017,"Block 2017, Block Group 2, Census Tract 1534.01, Sonoma County, California",26,24,2
1000000US060971534012018,060971534012018,"Block 2018, Block Group 2, Census Tract 1534.01, Sonoma County, California",30,26,4
1000000US060971534012019,060971534012019,"Block 2019, Block Group 2, Census Tract 1534.01, Sonoma County, California",2,2,0
1000000US060971534013000,060971534013000,"Block 3000, Block Group 3, Census Tract 1534.01, Sonoma County, California",0,0,0
1000000US060971534013001,060971534013001,"Block 3001, Block Group 3, Census Tract 1534.01, Sonoma County, California",78,73,5
1000000US060971534013002,060971534013002,"Block 3002, Block Group 3, Census Tract 1534.01, Sonoma County, California",65,58,7
1000000US060971534013003,060971534013003,"Block 3003, Block Group 3, Census Tract 1534.01, Sonoma County, California",2,2,0
1000000US060971534013004,060971534013004,"Block 3004, Block Group 3, Census Tract 1534.01, Sonoma County, California",13,12,1
1000000US060971534013005,060971534013005,"Block 3005, Block Group 3, Census Tract 1534.01, Sonoma County, California",12,11,1
1000000US060971534013006,060971534013006,"Block 3006, Block Group 3, Census Tract 1534.01, Sonoma County, California",0,0,0
1000000US060971534013007,060971534013007,"Block 3007, Block Group 3, Census Tract 1534.01, Sonoma County, California",61,55,6
1000000US060971534013008,060971534013008,"Block 3008, Block Group 3, Census Tract 1534.01, Sonoma County, California",46,42,4
1000000US060971534013009,060971534013009,"Block 3009, Block Group 3, Census Tract 1534.01, Sonoma County, California",1,1,0
1000000US060971534013010,060971534013010,"Block 3010, Block Group 3, Census Tract 1534.01, Sonoma County, California",5,5,0
1000000US060971534013011,060971534013011,"Block 3011, Block Group 3, Census Tract 1534.01, Sonoma County, California",117,114,3
1000000US060971534013012,060971534013012,"Block 3012, Block Group 3, Census Tract 1534.01, Sonoma County, California",0,0,0
1000000US060971534013013,060971534013013,"Block 3013, Block Group 3, Census Tract 1534.01, Sonoma County, California",0,0,0
1000000US060971534013014,060971534013014,"Block 3014, Block Group 3, Census Tract 1534.01, Sonoma County, California",41,41,0
1000000US060971534013015,060971534013015,"Block 3015, Block Group 3, Census Tract 1534.01, Sonoma County, California",7,7,0
1000000US060971534014000,060971534014000,"Block 4000, Block Group 4, Census Tract 1534.01, Sonoma County, California",82,76,6
1000000US060971534014001,060971534014001,"Block 4001, Block Group 4, Census Tract 1534.01, Sonoma County, California",15,15,0
1000000US060971534014002,060971534014002,"Block 4002, Block Group 4, Census Tract 1534.01, Sonoma County, California",0,0,0
1000000US060971534014003,060971534014003,"Block 4003, Block Group 4, Census Tract 1534.01, Sonoma County, California",16,16,0
1000000US060971534014004,060971534014004,"Block 4004, Block Group 4, Census Tract 1534.01, Sonoma County, California",56,55,1
1000000US060971534014005,060971534014005,"Block 4005, Block Group 4, Census Tract 1534.01, Sonoma County, California",30,30,0
1000000US060971534014006,060971534014006,"Block 4006, Block Group 4, Census Tract 1534.01, Sonoma County, California",39,36,3
1000000US060971534014007,060971534014007,"Block 4007, Block Group 4, Census Tract 1534.01, Sonoma County, California",1,1,0
1000000US060971534014008,060971534014008,"Block 4008, Block Group 4, Census Tract 1534.01, Sonoma County, California",11,11,0
1000000US060971534014009,060971534014009,"Block 4009, Block Group 4, Census Tract 1534.01, Sonoma County, California",2,2,0
1000000US060971534014010,060971534014010,"Block 4010, Block Group 4, Census Tract 1534.01, Sonoma County, California",95,91,4
1000000US060971534014011,060971534014011,"Block 4011, Block Group 4, Census Tract 1534.01, Sonoma County, California",22,22,0
1000000US060971534014012,060971534014012,"Block 4012, Block Group 4, Census Tract 1534.01, Sonoma County, California",57,57,0
1000000US060971534014013,060971534014013,"Block 4013, Block Group 4, Census Tract 1534.01, Sonoma County, California",20,20,0
1000000US060971534015000,060971534015000,"Block 5000, Block Group 5, Census Tract 1534.01, Sonoma County, California",32,30,2
1000000US060971534015001,060971534015001,"Block 5001, Block Group 5, Census Tract 1534.01, Sonoma County, California",164,155,9
1000000US060971534015002,060971534015002,"Block 5002, Block Group 5, Census Tract 1534.01, Sonoma County, California",38,38,0
1000000US060971534015003,060971534015003,"Block 5003, Block Group 5, Census Tract 1534.01, Sonoma County, California",14,14,0
1000000US060971534015004,060971534015004,"Block 5004, Block Group 5, Census Tract 1534.01, Sonoma County, California",34,33,1
1000000US060971534015005,060971534015005,"Block 5005, Block Group 5, Census Tract 1534.01, Sonoma County, California",57,50,7
1000000US060971534015006,060971534015006,"Block 5006, Block Group 5, Census Tract 1534.01, Sonoma County, California",41,35,6
1000000US060971534015007,060971534015007,"Block 5007, Block Group 5, Census Tract 1534.01, Sonoma County, California",14,14,0
1000000US060971534015008,060971534015008,"Block 5008, Block Group 5, Census Tract 1534.01, Sonoma County, California",21,19,2
1000000US060971534015009,060971534015009,"Block 5009, Block Group 5, Census Tract 1534.01, Sonoma County, California",6,6,0
1000000US060971534016000,060971534016000,"Block 6000, Block Group 6, Census Tract 1534.01, Sonoma County, California",115,112,3
1000000US060971534016001,060971534016001,"Block 6001, Block Group 6, Census Tract 1534.01, Sonoma County, California",4,4,0
1000000US060971534016002,060971534016002,"Block 6002, Block Group 6, Census Tract 1534.01, Sonoma County, California",175,165,10
1000000US060971534016003,060971534016003,"Block 6003, Block Group 6, Census Tract 1534.01, Sonoma County, California",64,60,4
1000000US060971534016004,060971534016004,"Block 6004, Block Group 6, Census Tract 1534.01, Sonoma County, California",26,24,2
1000000US060971534016005,060971534016005,"Block 6005, Block Group 6, Census Tract 1534.01, Sonoma County, California",11,11,0
1000000US060971534016006,060971534016006,"Block 6006, Block Group 6, Census Tract 1534.01, Sonoma County, California",73,68,5
1000000US060971534016007,060971534016007,"Block 6007, Block Group 6, Census Tract 1534.01, Sonoma County, California",9,7,2
1000000US060971534016008,060971534016008,"Block 6008, Block Group 6, Census Tract 1534.01, Sonoma County, California",54,50,4
1000000US060971534016009,060971534016009,"Block 6009, Block Group 6, Census Tract 1534.01, Sonoma County, California",0,0,0
1000000US060971534031000,060971534031000,"Block 1000, Block Group 1, Census Tract 1534.03, Sonoma County, California",2,2,0
1000000US060971534031001,060971534031001,"Block 1001, Block Group 1, Census Tract 1534.03, Sonoma County, California",30,27,3
1000000US060971534031002,060971534031002,"Block 1002, Block Group 1, Census Tract 1534.03, Sonoma County, California",0,0,0
1000000US060971534031003,060971534031003,"Block 1003, Block Group 1, Census Tract 1534.03, Sonoma County, California",20,19,1
1000000US060971534031004,060971534031004,"Block 1004, Block Group 1, Census Tract 1534.03, Sonoma County, California",35,32,3
1000000US060971534031005,060971534031005,"Block 1005, Block Group 1, Census Tract 1534.03, Sonoma County, California",9,8,1
1000000US060971534031006,060971534031006,"Block 1006, Block Group 1, Census Tract 1534.03, Sonoma County, California",130,119,11
1000000US060971534031007,060971534031007,"Block 1007, Block Group 1, Census Tract 1534.03, Sonoma County, California",15,15,0
1000000US060971534031008,060971534031008,"Block 1008, Block Group 1, Census Tract 1534.03, Sonoma County, California",110,103,7
1000000US060971534031009,060971534031009,"Block 1009, Block Group 1, Census Tract 1534.03, Sonoma County, California",0,0,0
1000000US060971534031010,060971534031010,"Block 1010, Block Group 1, Census Tract 1534.03, Sonoma County, California",6,6,0
1000000US060971534031011,060971534031011,"Block 1011, Block Group 1, Census Tract 1534.03, Sonoma County, California",9,9,0
1000000US060971534031012,060971534031012,"Block 1012, Block Group 1, Census Tract 1534.03, Sonoma County, California",1,1,0
1000000US060971534031013,060971534031013,"Block 1013, Block Group 1, Census Tract 1534.03, Sonoma County, California",4,4,0
1000000US060971534031014,060971534031014,"Block 1014, Block Group 1, Census Tract 1534.03, Sonoma County, California",0,0,0
1000000US060971534031015,060971534031015,"Block 1015, Block Group 1, Census Tract 1534.03, Sonoma County, California",9,7,2
1000000US060971534031016,060971534031016,"Block 1016, Block Group 1, Census Tract 1534.03, Sonoma County, California",44,36,8
1000000US060971534031017,060971534031017,"Block 1017, Block Group 1, Census Tract 1534.03, Sonoma County, California",5,5,0
1000000US060971534031018,060971534031018,"Block 1018, Block Group 1, Census Tract 1534.03, Sonoma County, California",0,0,0
1000000US060971534031019,060971534031019,"Block 1019, Block Group 1, Census Tract 1534.03, Sonoma County, California",59,54,5
1000000US060971534031020,060971534031020,"Block 1020, Block Group 1, Census Tract 1534.03, Sonoma County, California",13,12,1
1000000US060971534031021,060971534031021,"Block 1021, Block Group 1, Census Tract 1534.03, Sonoma County, California",18,18,0
1000000US060971534031022,060971534031022,"Block 1022, Block Group 1, Census Tract 1534.03, Sonoma County, California",1,1,0
1000000US060971534031023,060971534031023,"Block 1023, Block Group 1, Census Tract 1534.03, Sonoma County, California",1,1,0
1000000US060971534032000,060971534032000,"Block 2000, Block Group 2, Census Tract 1534.03, Sonoma County, California",23,23,0
1000000US060971534032001,060971534032001,"Block 2001, Block Group 2, Census Tract 1534.03, Sonoma County, California",0,0,0
1000000US060971534032002,060971534032002,"Block 2002, Block Group 2, Census Tract 1534.03, Sonoma County, California",7,6,1
1000000US060971534032003,060971534032003,"Block 2003, Block Group 2, Census Tract 1534.03, Sonoma County, California",6,4,2
1000000US060971534032004,060971534032004,"Block 2004, Block Group 2, Census Tract 1534.03, Sonoma County, California",0,0,0
1000000US060971534032005,060971534032005,"Block 2005, Block Group 2, Census Tract 1534.03, Sonoma County, California",0,0,0
1000000US060971534032006,060971534032006,"Block 2006, Block Group 2, Census Tract 1534.03, Sonoma County, California",0,0,0
1000000US060971534032007,060971534032007,"Block 2007, Block Group 2, Census Tract 1534.03, Sonoma County, California",0,0,0
1000000US060971534032008,060971534032008,"Block 2008, Block Group 2, Census Tract 1534.03, Sonoma County, California",18,17,1
1000000US060971534032009,060971534032009,"Block 2009, Block Group 2, Census Tract 1534.03, Sonoma County, California",21,15,6
1000000US060971534032010,060971534032010,"Block 2010, Block Group 2, Census Tract 1534.03, Sonoma County, California",47,45,2
1000000US060971534032011,060971534032011,"Block 2011, Block Group 2, Census Tract 1534.03, Sonoma County, California",62,60,2
1000000US060971534032012,060971534032012,"Block 2012, Block Group 2, Census Tract 1534.03, Sonoma County, California",75,64,11
1000000US060971534032013,060971534032013,"Block 2013, Block Group 2, Census Tract 1534.03, Sonoma County, California",0,0,0
1000000US060971534032014,060971534032014,"Block 2014, Block Group 2, Census Tract 1534.03, Sonoma County, California",6,5,1
1000000US060971534032015,060971534032015,"Block 2015, Block Group 2, Census Tract 1534.03, Sonoma County, California",1,1,0
1000000US060971534032016,060971534032016,"Block 2016, Block Group 2, Census Tract 1534.03, Sonoma County, California",11,9,2
1000000US060971534032017,060971534032017,"Block 2017, Block Group 2, Census Tract 1534.03, Sonoma County, California",24,20,4
1000000US060971534032018,060971534032018,"Block 2018, Block Group 2, Census Tract 1534.03, Sonoma County, California",15,13,2
1000000US060971534032019,060971534032019,"Block 2019, Block Group 2, Census Tract 1534.03, Sonoma County, California",0,0,0
1000000US060971534032020,060971534032020,"Block 2020, Block Group 2, Census Tract 1534.03, Sonoma County, California",62,56,6
1000000US060971534032021,060971534032021,"Block 2021, Block Group 2, Census Tract 1534.03, Sonoma County, California",0,0,0
1000000US060971534032022,060971534032022,"Block 2022, Block Group 2, Census Tract 1534.03, Sonoma County, California",81,76,5
1000000US060971534032023,060971534032023,"Block 2023, Block Group 2, Census Tract 1534.03, Sonoma County, California",9,7,2
1000000US060971534032024,060971534032024,"Block 2024, Block Group 2, Census Tract 1534.03, Sonoma County, California",0,0,0
1000000US060971534032025,060971534032025,"Block 2025, Block Group 2, Census Tract 1534.03, Sonoma County, California",11,10,1
1000000US060971534032026,060971534032026,"Block 2026, Block Group 2, Census Tract 1534.03, Sonoma County, California",9,8,1
1000000US060971534032027,060971534032027,"Block 2027, Block Group 2, Census Tract 1534.03, Sonoma County, California",0,0,0
1000000US060971534032028,060971534032028,"Block 2028, Block Group 2, Census Tract 1534.03, Sonoma County, California",2,1,1
1000000US060971534032029,060971534032029,"Block 2029, Block Group 2, Census Tract 1534.03, Sonoma County, California",12,11,1
1000000US060971534032030,060971534032030,"Block 2030, Block Group 2, Census Tract 1534.03, Sonoma County, California",0,0,0
1000000US060971534032031,060971534032031,"Block 2031, Block Group 2, Census Tract 1534.03, Sonoma County, California",6,6,0
1000000US060971534032032,060971534032032,"Block 2032, Block Group 2, Census Tract 1534.03, Sonoma County, California",0,0,0
1000000US060971534032033,060971534032033,"Block 2033, Block Group 2, Census Tract 1534.03, Sonoma County, California",1,1,0
1000000US060971534032034,060971534032034,"Block 2034, Block Group 2, Census Tract 1534.03, Sonoma County, California",19,18,1
1000000US060971534032035,060971534032035,"Block 2035, Block Group 2, Census Tract 1534.03, Sonoma County, California",24,22,2
1000000US060971534033000,060971534033000,"Block 3000, Block Group 3, Census Tract 1534.03, Sonoma County, California",12,12,0
1000000US060971534033001,060971534033001,"Block 3001, Block Group 3, Census Tract 1534.03, Sonoma County, California",47,46,1
1000000US060971534033002,060971534033002,"Block 3002, Block Group 3, Census Tract 1534.03, Sonoma County, California",0,0,0
1000000US060971534033003,060971534033003,"Block 3003, Block Group 3, Census Tract 1534.03, Sonoma County, California",44,43,1
1000000US060971534033004,060971534033004,"Block 3004, Block Group 3, Census Tract 1534.03, Sonoma County, California",12,12,0
1000000US060971534033005,060971534033005,"Block 3005, Block Group 3, Census Tract 1534.03, Sonoma County, California",64,64,0
1000000US060971534033006,060971534033006,"Block 3006, Block Group 3, Census Tract 1534.03, Sonoma County, California",23,22,1
1000000US060971534033007,060971534033007,"Block 3007, Block Group 3, Census Tract 1534.03, Sonoma County, California",38,36,2
1000000US060971534033008,060971534033008,"Block 3008, Block Group 3, Census Tract 1534.03, Sonoma County, California",25,23,2
1000000US060971534033009,060971534033009,"Block 3009, Block Group 3, Census Tract 1534.03, Sonoma County, California",17,16,1
1000000US060971534033010,060971534033010,"Block 3010, Block Group 3, Census Tract 1534.03, Sonoma County, California",33,33,0
1000000US060971534033011,060971534033011,"Block 3011, Block Group 3, Census Tract 1534.03, Sonoma County, California",15,15,0
1000000US060971534034000,060971534034000,"Block 4000, Block Group 4, Census Tract 1534.03, Sonoma County, California",0,0,0
1000000US060971534034001,060971534034001,"Block 4001, Block Group 4, Census Tract 1534.03, Sonoma County, California",39,36,3
1000000US060971534034002,060971534034002,"Block 4002, Block Group 4, Census Tract 1534.03, Sonoma County, California",0,0,0
1000000US060971534034003,060971534034003,"Block 4003, Block Group 4, Census Tract 1534.03, Sonoma County, California",49,43,6
1000000US060971534034004,060971534034004,"Block 4004, Block Group 4, Census Tract 1534.03, Sonoma County, California",19,18,1
1000000US060971534034005,060971534034005,"Block 4005, Block Group 4, Census Tract 1534.03, Sonoma County, California",6,6,0
1000000US060971534034006,060971534034006,"Block 4006, Block Group 4, Census Tract 1534.03, Sonoma County, California",82,78,4
1000000US060971534034007,060971534034007,"Block 4007, Block Group 4, Census Tract 1534.03, Sonoma County, California",2,2,0
1000000US060971534034008,060971534034008,"Block 4008, Block Group 4, Census Tract 1534.03, Sonoma County, California",50,49,1
1000000US060971534034009,060971534034009,"Block 4009, Block Group 4, Census Tract 1534.03, Sonoma County, California",18,18,0
1000000US060971534034010,060971534034010,"Block 4010, Block Group 4, Census Tract 1534.03, Sonoma County, California",0,0,0
1000000US060971534034011,060971534034011,"Block 4011, Block Group 4, Census Tract 1534.03, Sonoma County, California",3,3,0
1000000US060971534034012,060971534034012,"Block 4012, Block Group 4, Census Tract 1534.03, Sonoma County, California",0,0,0
1000000US060971534034013,060971534034013,"Block 4013, Block Group 4, Census Tract 1534.03, Sonoma County, California",51,51,0
1000000US060971534034014,060971534034014,"Block 4014, Block Group 4, Census Tract 1534.03, Sonoma County, California",16,15,1
1000000US060971534034015,060971534034015,"Block 4015, Block Group 4, Census Tract 1534.03, Sonoma County, California",0,0,0
1000000US060971534034016,060971534034016,"Block 4016, Block Group 4, Census Tract 1534.03, Sonoma County, California",1,1,0
1000000US060971534041000,060971534041000,"Block 1000, Block Group 1, Census Tract 1534.04, Sonoma County, California",69,67,2
1000000US060971534041001,060971534041001,"Block 1001, Block Group 1, Census Tract 1534.04, Sonoma County, California",9,7,2
1000000US060971534041002,060971534041002,"Block 1002, Block Group 1, Census Tract 1534.04, Sonoma County, California",22,21,1
1000000US060971534041003,060971534041003,"Block 1003, Block Group 1, Census Tract 1534.04, Sonoma County, California",54,54,0
1000000US060971534041004,060971534041004,"Block 1004, Block Group 1, Census Tract 1534.04, Sonoma County, California",17,17,0
1000000US060971534041005,060971534041005,"Block 1005, Block Group 1, Census Tract 1534.04, Sonoma County, California",47,43,4
1000000US060971534041006,060971534041006,"Block 1006, Block Group 1, Census Tract 1534.04, Sonoma County, California",60,59,1
1000000US060971534041007,060971534041007,"Block 1007, Block Group 1, Census Tract 1534.04, Sonoma County, California",80,69,11
1000000US060971534041008,060971534041008,"Block 1008, Block Group 1, Census Tract 1534.04, Sonoma County, California",31,29,2
1000000US060971534041009,060971534041009,"Block 1009, Block Group 1, Census Tract 1534.04, Sonoma County, California",0,0,0
1000000US060971534041010,060971534041010,"Block 1010, Block Group 1, Census Tract 1534.04, Sonoma County, California",1,0,1
1000000US060971534042000,060971534042000,"Block 2000, Block Group 2, Census Tract 1534.04, Sonoma County, California",33,32,1
1000000US060971534042001,060971534042001,"Block 2001, Block Group 2, Census Tract 1534.04, Sonoma County, California",58,50,8
1000000US060971534042002,060971534042002,"Block 2002, Block Group 2, Census Tract 1534.04, Sonoma County, California",6,6,0
1000000US060971534042003,060971534042003,"Block 2003, Block Group 2, Census Tract 1534.04, Sonoma County, California",137,124,13
1000000US060971534042004,060971534042004,"Block 2004, Block Group 2, Census Tract 1534.04, Sonoma County, California",138,129,9
1000000US060971534042005,060971534042005,"Block 2005, Block Group 2, Census Tract 1534.04, Sonoma County, California",5,4,1
1000000US060971534042006,060971534042006,"Block 2006, Block Group 2, Census Tract 1534.04, Sonoma County, California",0,0,0
1000000US060971534042007,060971534042007,"Block 2007, Block Group 2, Census Tract 1534.04, Sonoma County, California",0,0,0
1000000US060971534042008,060971534042008,"Block 2008, Block Group 2, Census Tract 1534.04, Sonoma County, California",0,0,0
1000000US060971534042009,060971534042009,"Block 2009, Block Group 2, Census Tract 1534.04, Sonoma County, California",36,34,2
1000000US060971534042010,060971534042010,"Block 2010, Block Group 2, Census Tract 1534.04, Sonoma County, California",14,13,1
1000000US060971534042011,060971534042011,"Block 2011, Block Group 2, Census Tract 1534.04, Sonoma County, California",1,1,0
1000000US060971534042012,060971534042012,"Block 2012, Block Group 2, Census Tract 1534.04, Sonoma County, California",19,18,1
1000000US060971534042013,060971534042013,"Block 2013, Block Group 2, Census Tract 1534.04, Sonoma County, California",3,3,0
1000000US060971534042014,060971534042014,"Block 2014, Block Group 2, Census Tract 1534.04, Sonoma County, California",52,43,9
1000000US060971534042015,060971534042015,"Block 2015, Block Group 2, Census Tract 1534.04, Sonoma County, California",16,16,0
1000000US060971534042016,060971534042016,"Block 2016, Block Group 2, Census Tract 1534.04, Sonoma County, California",20,19,1
1000000US060971534042017,060971534042017,"Block 2017, Block Group 2, Census Tract 1534.04, Sonoma County, California",18,16,2
1000000US060971534042018,060971534042018,"Block 2018, Block Group 2, Census Tract 1534.04, Sonoma County, California",21,21,0
1000000US060971534042019,060971534042019,"Block 2019, Block Group 2, Census Tract 1534.04, Sonoma County, California",17,15,2
1000000US060971534042020,060971534042020,"Block 2020, Block Group 2, Census Tract 1534.04, Sonoma County, California",4,4,0
1000000US060971534043000,060971534043000,"Block 3000, Block Group 3, Census Tract 1534.04, Sonoma County, California",0,0,0
1000000US060971534043001,060971534043001,"Block 3001, Block Group 3, Census Tract 1534.04, Sonoma County, California",86,81,5
1000000US060971534043002,060971534043002,"Block 3002, Block Group 3, Census Tract 1534.04, Sonoma County, California",2,1,1
1000000US060971534043003,060971534043003,"Block 3003, Block Group 3, Census Tract 1534.04, Sonoma County, California",17,15,2
1000000US060971534043004,060971534043004,"Block 3004, Block Group 3, Census Tract 1534.04, Sonoma County, California",21,19,2
1000000US060971534043005,060971534043005,"Block 3005, Block Group 3, Census Tract 1534.04, Sonoma County, California",4,3,1
1000000US060971534043006,060971534043006,"Block 3006, Block Group 3, Census Tract 1534.04, Sonoma County, California",4,4,0
1000000US060971534043007,060971534043007,"Block 3007, Block Group 3, Census Tract 1534.04, Sonoma County, California",53,48,5
1000000US060971534043008,060971534043008,"Block 3008, Block Group 3, Census Tract 1534.04, Sonoma County, California",0,0,0
1000000US060971534043009,060971534043009,"Block 3009, Block Group 3, Census Tract 1534.04, Sonoma County, California",7,6,1
1000000US060971534043010,060971534043010,"Block 3010, Block Group 3, Census Tract 1534.04, Sonoma County, California",0,0,0
1000000US060971534043011,060971534043011,"Block 3011, Block Group 3, Census Tract 1534.04, Sonoma County, California",3,3,0
1000000US060971534043012,060971534043012,"Block 3012, Block Group 3, Census Tract 1534.04, Sonoma County, California",15,14,1
1000000US060971534043013,060971534043013,"Block 3013, Block Group 3, Census Tract 1534.04, Sonoma County, California",2,2,0
1000000US060971534043014,060971534043014,"Block 3014, Block Group 3, Census Tract 1534.04, Sonoma County, California",3,3,0
1000000US060971534043015,060971534043015,"Block 3015, Block Group 3, Census Tract 1534.04, Sonoma County, California",16,14,2
1000000US060971534043016,060971534043016,"Block 3016, Block Group 3, Census Tract 1534.04, Sonoma County, California",86,79,7
1000000US060971534043017,060971534043017,"Block 3017, Block Group 3, Census Tract 1534.04, Sonoma County, California",16,14,2
1000000US060971534043018,060971534043018,"Block 3018, Block Group 3, Census Tract 1534.04, Sonoma County, California",1,1,0
1000000US060971534044000,060971534044000,"Block 4000, Block Group 4, Census Tract 1534.04, Sonoma County, California",10,10,0
1000000US060971534044001,060971534044001,"Block 4001, Block Group 4, Census Tract 1534.04, Sonoma County, California",2,2,0
1000000US060971534044002,060971534044002,"Block 4002, Block Group 4, Census Tract 1534.04, Sonoma County, California",87,78,9
1000000US060971534044003,060971534044003,"Block 4003, Block Group 4, Census Tract 1534.04, Sonoma County, California",0,0,0
1000000US060971534044004,060971534044004,"Block 4004, Block Group 4, Census Tract 1534.04, Sonoma County, California",82,74,8
1000000US060971534044005,060971534044005,"Block 4005, Block Group 4, Census Tract 1534.04, Sonoma County, California",40,36,4
1000000US060971534044006,060971534044006,"Block 4006, Block Group 4, Census Tract 1534.04, Sonoma County, California",91,81,10
1000000US060971534044007,060971534044007,"Block 4007, Block Group 4, Census Tract 1534.04, Sonoma County, California",21,17,4
1000000US060971534044008,060971534044008,"Block 4008, Block Group 4, Census Tract 1534.04, Sonoma County, California",7,6,1
1000000US060971534044009,060971534044009,"Block 4009, Block Group 4, Census Tract 1534.04, Sonoma County, California",14,13,1
1000000US060971534044010,060971534044010,"Block 4010, Block Group 4, Census Tract 1534.04, Sonoma County, California",34,31,3
1000000US060971534044011,060971534044011,"Block 4011, Block Group 4, Census Tract 1534.04, Sonoma County, California",141,131,10
1000000US060971534044012,060971534044012,"Block 4012, Block Group 4, Census Tract 1534.04, Sonoma County, California",20,20,0
1000000US060971535011000,060971535011000,"Block 1000, Block Group 1, Census Tract 1535.01, Sonoma County, California",79,70,9
1000000US060971535011001,060971535011001,"Block 1001, Block Group 1, Census Tract 1535.01, Sonoma County, California",3,3,0
1000000US060971535011002,060971535011002,"Block 1002, Block Group 1, Census Tract 1535.01, Sonoma County, California",0,0,0
1000000US060971535011003,060971535011003,"Block 1003, Block Group 1, Census Tract 1535.01, Sonoma County, California",24,21,3
1000000US060971535011004,060971535011004,"Block 1004, Block Group 1, Census Tract 1535.01, Sonoma County, California",47,43,4
1000000US060971535011005,060971535011005,"Block 1005, Block Group 1, Census Tract 1535.01, Sonoma County, California",183,162,21
1000000US060971535011006,060971535011006,"Block 1006, Block Group 1, Census Tract 1535.01, Sonoma County, California",3,3,0
1000000US060971535011007,060971535011007,"Block 1007, Block Group 1, Census Tract 1535.01, Sonoma County, California",5,5,0
1000000US060971535011008,060971535011008,"Block 1008, Block Group 1, Census Tract 1535.01, Sonoma County, California",2,2,0
1000000US060971535011009,060971535011009,"Block 1009, Block Group 1, Census Tract 1535.01, Sonoma County, California",9,9,0
1000000US060971535011010,060971535011010,"Block 1010, Block Group 1, Census Tract 1535.01, Sonoma County, California",5,5,0
1000000US060971535011011,060971535011011,"Block 1011, Block Group 1, Census Tract 1535.01, Sonoma County, California",17,15,2
1000000US060971535011012,060971535011012,"Block 1012, Block Group 1, Census Tract 1535.01, Sonoma County, California",43,40,3
1000000US060971535011013,060971535011013,"Block 1013, Block Group 1, Census Tract 1535.01, Sonoma County, California",0,0,0
1000000US060971535012000,060971535012000,"Block 2000, Block Group 2, Census Tract 1535.01, Sonoma County, California",129,121,8
1000000US060971535012001,060971535012001,"Block 2001, Block Group 2, Census Tract 1535.01, Sonoma County, California",6,6,0
1000000US060971535012002,060971535012002,"Block 2002, Block Group 2, Census Tract 1535.01, Sonoma County, California",16,15,1
1000000US060971535012003,060971535012003,"Block 2003, Block Group 2, Census Tract 1535.01, Sonoma County, California",31,28,3
1000000US060971535012004,060971535012004,"Block 2004, Block Group 2, Census Tract 1535.01, Sonoma County, California",4,4,0
1000000US060971535012005,060971535012005,"Block 2005, Block Group 2, Census Tract 1535.01, Sonoma County, California",36,35,1
1000000US060971535012006,060971535012006,"Block 2006, Block Group 2, Census Tract 1535.01, Sonoma County, California",52,50,2
1000000US060971535012007,060971535012007,"Block 2007, Block Group 2, Census Tract 1535.01, Sonoma County, California",109,101,8
1000000US060971535012008,060971535012008,"Block 2008, Block Group 2, Census Tract 1535.01, Sonoma County, California",2,2,0
1000000US060971535012009,060971535012009,"Block 2009, Block Group 2, Census Tract 1535.01, Sonoma County, California",2,2,0
1000000US060971535012010,060971535012010,"Block 2010, Block Group 2, Census Tract 1535.01, Sonoma County, California",2,2,0
1000000US060971535012011,060971535012011,"Block 2011, Block Group 2, Census Tract 1535.01, Sonoma County, California",72,72,0
1000000US060971535012012,060971535012012,"Block 2012, Block Group 2, Census Tract 1535.01, Sonoma County, California",11,10,1
1000000US060971535012013,060971535012013,"Block 2013, Block Group 2, Census Tract 1535.01, Sonoma County, California",4,3,1
1000000US060971535013000,060971535013000,"Block 3000, Block Group 3, Census Tract 1535.01, Sonoma County, California",2,2,0
1000000US060971535013001,060971535013001,"Block 3001, Block Group 3, Census Tract 1535.01, Sonoma County, California",16,15,1
1000000US060971535013002,060971535013002,"Block 3002, Block Group 3, Census Tract 1535.01, Sonoma County, California",34,33,1
1000000US060971535013003,060971535013003,"Block 3003, Block Group 3, Census Tract 1535.01, Sonoma County, California",63,57,6
1000000US060971535013004,060971535013004,"Block 3004, Block Group 3, Census Tract 1535.01, Sonoma County, California",3,2,1
1000000US060971535013005,060971535013005,"Block 3005, Block Group 3, Census Tract 1535.01, Sonoma County, California",0,0,0
1000000US060971535013006,060971535013006,"Block 3006, Block Group 3, Census Tract 1535.01, Sonoma County, California",1,1,0
1000000US060971535013007,060971535013007,"Block 3007, Block Group 3, Census Tract 1535.01, Sonoma County, California",13,9,4
1000000US060971535013008,060971535013008,"Block 3008, Block Group 3, Census Tract 1535.01, Sonoma County, California",4,4,0
1000000US060971535013009,060971535013009,"Block 3009, Block Group 3, Census Tract 1535.01, Sonoma County, California",6,6,0
1000000US060971535013010,060971535013010,"Block 3010, Block Group 3, Census Tract 1535.01, Sonoma County, California",4,4,0
1000000US060971535013011,060971535013011,"Block 3011, Block Group 3, Census Tract 1535.01, Sonoma County, California",4,4,0
1000000US060971535013012,060971535013012,"Block 3012, Block Group 3, Census Tract 1535.01, Sonoma County, California",3,3,0
1000000US060971535013013,060971535013013,"Block 3013, Block Group 3, Census Tract 1535.01, Sonoma County, California",21,19,2
1000000US060971535013014,060971535013014,"Block 3014, Block Group 3, Census Tract 1535.01, Sonoma County, California",7,7,0
1000000US060971535013015,060971535013015,"Block 3015, Block Group 3, Census Tract 1535.01, Sonoma County, California",11,11,0
1000000US060971535013016,060971535013016,"Block 3016, Block Group 3, Census Tract 1535.01, Sonoma County, California",42,37,5
1000000US060971535013017,060971535013017,"Block 3017, Block Group 3, Census Tract 1535.01, Sonoma County, California",63,56,7
1000000US060971535013018,060971535013018,"Block 3018, Block Group 3, Census Tract 1535.01, Sonoma County, California",1,1,0
1000000US060971535013019,060971535013019,"Block 3019, Block Group 3, Census Tract 1535.01, Sonoma County, California",16,15,1
1000000US060971535013020,060971535013020,"Block 3020, Block Group 3, Census Tract 1535.01, Sonoma County, California",23,14,9
1000000US060971535013021,060971535013021,"Block 3021, Block Group 3, Census Tract 1535.01, Sonoma County, California",12,9,3
1000000US060971535013022,060971535013022,"Block 3022, Block Group 3, Census Tract 1535.01, Sonoma County, California",0,0,0
1000000US060971535013023,060971535013023,"Block 3023, Block Group 3, Census Tract 1535.01, Sonoma County, California",0,0,0
1000000US060971535013024,060971535013024,"Block 3024, Block Group 3, Census Tract 1535.01, Sonoma County, California",25,21,4
1000000US060971535013025,060971535013025,"Block 3025, Block Group 3, Census Tract 1535.01, Sonoma County, California",0,0,0
1000000US060971535013026,060971535013026,"Block 3026, Block Group 3, Census Tract 1535.01, Sonoma County, California",1,1,0
1000000US060971535013027,060971535013027,"Block 3027, Block Group 3, Census Tract 1535.01, Sonoma County, California",3,3,0
1000000US060971535013028,060971535013028,"Block 3028, Block Group 3, Census Tract 1535.01, Sonoma County, California",2,2,0
1000000US060971535013029,060971535013029,"Block 3029, Block Group 3, Census Tract 1535.01, Sonoma County, California",1,1,0
1000000US060971535013030,060971535013030,"Block 3030, Block Group 3, Census Tract 1535.01, Sonoma County, California",0,0,0
1000000US060971535013031,060971535013031,"Block 3031, Block Group 3, Census Tract 1535.01, Sonoma County, California",1,1,0
1000000US060971535013032,060971535013032,"Block 3032, Block Group 3, Census Tract 1535.01, Sonoma County, California",1,1,0
1000000US060971535013033,060971535013033,"Block 3033, Block Group 3, Census Tract 1535.01, Sonoma County, California",0,0,0
1000000US060971535013034,060971535013034,"Block 3034, Block Group 3, Census Tract 1535.01, Sonoma County, California",3,2,1
1000000US060971535013035,060971535013035,"Block 3035, Block Group 3, Census Tract 1535.01, Sonoma County, California",2,1,1
1000000US060971535013036,060971535013036,"Block 3036, Block Group 3, Census Tract 1535.01, Sonoma County, California",0,0,0
1000000US060971535013037,060971535013037,"Block 3037, Block Group 3, Census Tract 1535.01, Sonoma County, California",0,0,0
1000000US060971535013038,060971535013038,"Block 3038, Block Group 3, Census Tract 1535.01, Sonoma County, California",5,5,0
1000000US060971535013039,060971535013039,"Block 3039, Block Group 3, Census Tract 1535.01, Sonoma County, California",0,0,0
1000000US060971535013040,060971535013040,"Block 3040, Block Group 3, Census Tract 1535.01, Sonoma County, California",3,3,0
1000000US060971535013041,060971535013041,"Block 3041, Block Group 3, Census Tract 1535.01, Sonoma County, California",19,17,2
1000000US060971535013042,060971535013042,"Block 3042, Block Group 3, Census Tract 1535.01, Sonoma County, California",28,25,3
1000000US060971535013043,060971535013043,"Block 3043, Block Group 3, Census Tract 1535.01, Sonoma County, California",0,0,0
1000000US060971535013044,060971535013044,"Block 3044, Block Group 3, Census Tract 1535.01, Sonoma County, California",0,0,0
1000000US060971535013045,060971535013045,"Block 3045, Block Group 3, Census Tract 1535.01, Sonoma County, California",3,3,0
1000000US060971535014000,060971535014000,"Block 4000, Block Group 4, Census Tract 1535.01, Sonoma County, California",11,11,0
1000000US060971535014001,060971535014001,"Block 4001, Block Group 4, Census Tract 1535.01, Sonoma County, California",22,19,3
1000000US060971535014002,060971535014002,"Block 4002, Block Group 4, Census Tract 1535.01, Sonoma County, California",78,73,5
1000000US060971535014003,060971535014003,"Block 4003, Block Group 4, Census Tract 1535.01, Sonoma County, California",205,194,11
1000000US060971535014004,060971535014004,"Block 4004, Block Group 4, Census Tract 1535.01, Sonoma County, California",15,15,0
1000000US060971535014005,060971535014005,"Block 4005, Block Group 4, Census Tract 1535.01, Sonoma County, California",153,143,10
1000000US060971535014006,060971535014006,"Block 4006, Block Group 4, Census Tract 1535.01, Sonoma County, California",2,2,0
1000000US060971535014007,060971535014007,"Block 4007, Block Group 4, Census Tract 1535.01, Sonoma County, California",2,2,0
1000000US060971535014008,060971535014008,"Block 4008, Block Group 4, Census Tract 1535.01, Sonoma County, California",2,2,0
1000000US060971535014009,060971535014009,"Block 4009, Block Group 4, Census Tract 1535.01, Sonoma County, California",32,25,7
1000000US060971535014010,060971535014010,"Block 4010, Block Group 4, Census Tract 1535.01, Sonoma County, California",25,21,4
1000000US060971535014011,060971535014011,"Block 4011, Block Group 4, Census Tract 1535.01, Sonoma County, California",0,0,0
1000000US060971535014012,060971535014012,"Block 4012, Block Group 4, Census Tract 1535.01, Sonoma County, California",36,34,2
1000000US060971535014013,060971535014013,"Block 4013, Block Group 4, Census Tract 1535.01, Sonoma County, California",0,0,0
1000000US060971535014014,060971535014014,"Block 4014, Block Group 4, Census Tract 1535.01, Sonoma County, California",0,0,0
1000000US060971535014015,060971535014015,"Block 4015, Block Group 4, Census Tract 1535.01, Sonoma County, California",0,0,0
1000000US060971535014016,060971535014016,"Block 4016, Block Group 4, Census Tract 1535.01, Sonoma County, California",1,1,0
1000000US060971535014017,060971535014017,"Block 4017, Block Group 4, Census Tract 1535.01, Sonoma County, California",0,0,0
1000000US060971535014018,060971535014018,"Block 4018, Block Group 4, Census Tract 1535.01, Sonoma County, California",4,3,1
1000000US060971535014019,060971535014019,"Block 4019, Block Group 4, Census Tract 1535.01, Sonoma County, California",9,9,0
1000000US060971535014020,060971535014020,"Block 4020, Block Group 4, Census Tract 1535.01, Sonoma County, California",4,4,0
1000000US060971535014021,060971535014021,"Block 4021, Block Group 4, Census Tract 1535.01, Sonoma County, California",3,3,0
1000000US060971535014022,060971535014022,"Block 4022, Block Group 4, Census Tract 1535.01, Sonoma County, California",3,3,0
1000000US060971535014023,060971535014023,"Block 4023, Block Group 4, Census Tract 1535.01, Sonoma County, California",0,0,0
1000000US060971535014024,060971535014024,"Block 4024, Block Group 4, Census Tract 1535.01, Sonoma County, California",0,0,0
1000000US060971535014025,060971535014025,"Block 4025, Block Group 4, Census Tract 1535.01, Sonoma County, California",1,1,0
1000000US060971535021000,060971535021000,"Block 1000, Block Group 1, Census Tract 1535.02, Sonoma County, California",100,88,12
1000000US060971535021001,060971535021001,"Block 1001, Block Group 1, Census Tract 1535.02, Sonoma County, California",27,26,1
1000000US060971535021002,060971535021002,"Block 1002, Block Group 1, Census Tract 1535.02, Sonoma County, California",26,21,5
1000000US060971535021003,060971535021003,"Block 1003, Block Group 1, Census Tract 1535.02, Sonoma County, California",1,1,0
1000000US060971535021004,060971535021004,"Block 1004, Block Group 1, Census Tract 1535.02, Sonoma County, California",34,28,6
1000000US060971535021005,060971535021005,"Block 1005, Block Group 1, Census Tract 1535.02, Sonoma County, California",25,25,0
1000000US060971535021006,060971535021006,"Block 1006, Block Group 1, Census Tract 1535.02, Sonoma County, California",158,142,16
1000000US060971535022000,060971535022000,"Block 2000, Block Group 2, Census Tract 1535.02, Sonoma County, California",1,0,1
1000000US060971535022001,060971535022001,"Block 2001, Block Group 2, Census Tract 1535.02, Sonoma County, California",95,91,4
1000000US060971535022002,060971535022002,"Block 2002, Block Group 2, Census Tract 1535.02, Sonoma County, California",0,0,0
1000000US060971535022003,060971535022003,"Block 2003, Block Group 2, Census Tract 1535.02, Sonoma County, California",0,0,0
1000000US060971535022004,060971535022004,"Block 2004, Block Group 2, Census Tract 1535.02, Sonoma County, California",4,3,1
1000000US060971535022005,060971535022005,"Block 2005, Block Group 2, Census Tract 1535.02, Sonoma County, California",111,104,7
1000000US060971535022006,060971535022006,"Block 2006, Block Group 2, Census Tract 1535.02, Sonoma County, California",0,0,0
1000000US060971535022007,060971535022007,"Block 2007, Block Group 2, Census Tract 1535.02, Sonoma County, California",1,1,0
1000000US060971535022008,060971535022008,"Block 2008, Block Group 2, Census Tract 1535.02, Sonoma County, California",1,1,0
1000000US060971535022009,060971535022009,"Block 2009, Block Group 2, Census Tract 1535.02, Sonoma County, California",86,76,10
1000000US060971535022010,060971535022010,"Block 2010, Block Group 2, Census Tract 1535.02, Sonoma County, California",6,6,0
1000000US060971535022011,060971535022011,"Block 2011, Block Group 2, Census Tract 1535.02, Sonoma County, California",0,0,0
1000000US060971535022012,060971535022012,"Block 2012, Block Group 2, Census Tract 1535.02, Sonoma County, California",4,4,0
1000000US060971535023000,060971535023000,"Block 3000, Block Group 3, Census Tract 1535.02, Sonoma County, California",69,61,8
1000000US060971535023001,060971535023001,"Block 3001, Block Group 3, Census Tract 1535.02, Sonoma County, California",10,8,2
1000000US060971535023002,060971535023002,"Block 3002, Block Group 3, Census Tract 1535.02, Sonoma County, California",118,105,13
1000000US060971535023003,060971535023003,"Block 3003, Block Group 3, Census Tract 1535.02, Sonoma County, California",2,2,0
1000000US060971535023004,060971535023004,"Block 3004, Block Group 3, Census Tract 1535.02, Sonoma County, California",77,68,9
1000000US060971535023005,060971535023005,"Block 3005, Block Group 3, Census Tract 1535.02, Sonoma County, California",1,1,0
1000000US060971535023006,060971535023006,"Block 3006, Block Group 3, Census Tract 1535.02, Sonoma County, California",0,0,0
1000000US060971535023007,060971535023007,"Block 3007, Block Group 3, Census Tract 1535.02, Sonoma County, California",0,0,0
1000000US060971535023008,060971535023008,"Block 3008, Block Group 3, Census Tract 1535.02, Sonoma County, California",81,64,17
1000000US060971535023009,060971535023009,"Block 3009, Block Group 3, Census Tract 1535.02, Sonoma County, California",0,0,0
1000000US060971535023010,060971535023010,"Block 3010, Block Group 3, Census Tract 1535.02, Sonoma County, California",19,19,0
1000000US060971535023011,060971535023011,"Block 3011, Block Group 3, Census Tract 1535.02, Sonoma County, California",2,2,0
1000000US060971535023012,060971535023012,"Block 3012, Block Group 3, Census Tract 1535.02, Sonoma County, California",51,44,7
1000000US060971535023013,060971535023013,"Block 3013, Block Group 3, Census Tract 1535.02, Sonoma County, California",7,7,0
1000000US060971535023014,060971535023014,"Block 3014, Block Group 3, Census Tract 1535.02, Sonoma County, California",0,0,0
1000000US060971535023015,060971535023015,"Block 3015, Block Group 3, Census Tract 1535.02, Sonoma County, California",1,0,1
1000000US060971535023016,060971535023016,"Block 3016, Block Group 3, Census Tract 1535.02, Sonoma County, California",22,20,2
1000000US060971535023017,060971535023017,"Block 3017, Block Group 3, Census Tract 1535.02, Sonoma County, California",0,0,0
1000000US060971535023018,060971535023018,"Block 3018, Block Group 3, Census Tract 1535.02, Sonoma County, California",1,1,0
1000000US060971535023019,060971535023019,"Block 3019, Block Group 3, Census Tract 1535.02, Sonoma County, California",30,27,3
1000000US060971535023020,060971535023020,"Block 3020, Block Group 3, Census Tract 1535.02, Sonoma County, California",0,0,0
1000000US060971535024000,060971535024000,"Block 4000, Block Group 4, Census Tract 1535.02, Sonoma County, California",311,288,23
1000000US060971535024001,060971535024001,"Block 4001, Block Group 4, Census Tract 1535.02, Sonoma County, California",21,19,2
1000000US060971535024002,060971535024002,"Block 4002, Block Group 4, Census Tract 1535.02, Sonoma County, California",24,20,4
1000000US060971535024003,060971535024003,"Block 4003, Block Group 4, Census Tract 1535.02, Sonoma County, California",21,16,5
1000000US060971535024004,060971535024004,"Block 4004, Block Group 4, Census Tract 1535.02, Sonoma County, California",0,0,0
1000000US060971535024005,060971535024005,"Block 4005, Block Group 4, Census Tract 1535.02, Sonoma County, California",58,56,2
1000000US060971535024006,060971535024006,"Block 4006, Block Group 4, Census Tract 1535.02, Sonoma County, California",6,5,1
1000000US060971535024007,060971535024007,"Block 4007, Block Group 4, Census Tract 1535.02, Sonoma County, California",4,4,0
1000000US060971535024008,060971535024008,"Block 4008, Block Group 4, Census Tract 1535.02, Sonoma County, California",7,6,1
1000000US060971535024009,060971535024009,"Block 4009, Block Group 4, Census Tract 1535.02, Sonoma County, California",5,5,0
1000000US060971535024010,060971535024010,"Block 4010, Block Group 4, Census Tract 1535.02, Sonoma County, California",6,5,1
1000000US060971535024011,060971535024011,"Block 4011, Block Group 4, Census Tract 1535.02, Sonoma County, California",11,11,0
1000000US060971535024012,060971535024012,"Block 4012, Block Group 4, Census Tract 1535.02, Sonoma County, California",3,3,0
1000000US060971535024013,060971535024013,"Block 4013, Block Group 4, Census Tract 1535.02, Sonoma County, California",2,2,0
1000000US060971535024014,060971535024014,"Block 4014, Block Group 4, Census Tract 1535.02, Sonoma County, California",4,4,0
1000000US060971535024015,060971535024015,"Block 4015, Block Group 4, Census Tract 1535.02, Sonoma County, California",0,0,0
1000000US060971535024016,060971535024016,"Block 4016, Block Group 4, Census Tract 1535.02, Sonoma County, California",1,1,0
1000000US060971535024017,060971535024017,"Block 4017, Block Group 4, Census Tract 1535.02, Sonoma County, California",3,3,0
1000000US060971535024018,060971535024018,"Block 4018, Block Group 4, Census Tract 1535.02, Sonoma County, California",6,6,0
1000000US060971535024019,060971535024019,"Block 4019, Block Group 4, Census Tract 1535.02, Sonoma County, California",0,0,0
1000000US060971535024020,060971535024020,"Block 4020, Block Group 4, Census Tract 1535.02, Sonoma County, California",0,0,0
1000000US060971535024021,060971535024021,"Block 4021, Block Group 4, Census Tract 1535.02, Sonoma County, California",0,0,0
1000000US060971535024022,060971535024022,"Block 4022, Block Group 4, Census Tract 1535.02, Sonoma County, California",2,0,2
1000000US060971535024023,060971535024023,"Block 4023, Block Group 4, Census Tract 1535.02, Sonoma County, California",0,0,0
1000000US060971535024024,060971535024024,"Block 4024, Block Group 4, Census Tract 1535.02, Sonoma County, California",5,5,0
1000000US060971535024025,060971535024025,"Block 4025, Block Group 4, Census Tract 1535.02, Sonoma County, California",4,4,0
1000000US060971535024026,060971535024026,"Block 4026, Block Group 4, Census Tract 1535.02, Sonoma County, California",29,21,8
1000000US060971535024027,060971535024027,"Block 4027, Block Group 4, Census Tract 1535.02, Sonoma County, California",0,0,0
1000000US060971535024028,060971535024028,"Block 4028, Block Group 4, Census Tract 1535.02, Sonoma County, California",28,26,2
1000000US060971535024029,060971535024029,"Block 4029, Block Group 4, Census Tract 1535.02, Sonoma County, California",10,10,0
1000000US060971535024030,060971535024030,"Block 4030, Block Group 4, Census Tract 1535.02, Sonoma County, California",4,4,0
1000000US060971535024031,060971535024031,"Block 4031, Block Group 4, Census Tract 1535.02, Sonoma County, California",1,1,0
1000000US060971535024032,060971535024032,"Block 4032, Block Group 4, Census Tract 1535.02, Sonoma County, California",2,2,0
1000000US060971535024033,060971535024033,"Block 4033, Block Group 4, Census Tract 1535.02, Sonoma County, California",3,2,1
1000000US060971536001000,060971536001000,"Block 1000, Block Group 1, Census Tract 1536, Sonoma County, California",100,88,12
1000000US060971536001001,060971536001001,"Block 1001, Block Group 1, Census Tract 1536, Sonoma County, California",6,5,1
1000000US060971536001002,060971536001002,"Block 1002, Block Group 1, Census Tract 1536, Sonoma County, California",0,0,0
1000000US060971536001003,060971536001003,"Block 1003, Block Group 1, Census Tract 1536, Sonoma County, California",0,0,0
1000000US060971536001004,060971536001004,"Block 1004, Block Group 1, Census Tract 1536, Sonoma County, California",6,5,1
1000000US060971536001005,060971536001005,"Block 1005, Block Group 1, Census Tract 1536, Sonoma County, California",0,0,0
1000000US060971536001006,060971536001006,"Block 1006, Block Group 1, Census Tract 1536, Sonoma County, California",0,0,0
1000000US060971536001007,060971536001007,"Block 1007, Block Group 1, Census Tract 1536, Sonoma County, California",51,46,5
1000000US060971536001008,060971536001008,"Block 1008, Block Group 1, Census Tract 1536, Sonoma County, California",9,7,2
1000000US060971536001009,060971536001009,"Block 1009, Block Group 1, Census Tract 1536, Sonoma County, California",0,0,0
1000000US060971536001010,060971536001010,"Block 1010, Block Group 1, Census Tract 1536, Sonoma County, California",35,35,0
1000000US060971536001011,060971536001011,"Block 1011, Block Group 1, Census Tract 1536, Sonoma County, California",2,2,0
1000000US060971536001012,060971536001012,"Block 1012, Block Group 1, Census Tract 1536, Sonoma County, California",8,7,1
1000000US060971536001013,060971536001013,"Block 1013, Block Group 1, Census Tract 1536, Sonoma County, California",3,3,0
1000000US060971536001014,060971536001014,"Block 1014, Block Group 1, Census Tract 1536, Sonoma County, California",119,111,8
1000000US060971536001015,060971536001015,"Block 1015, Block Group 1, Census Tract 1536, Sonoma County, California",1,1,0
1000000US060971536001016,060971536001016,"Block 1016, Block Group 1, Census Tract 1536, Sonoma County, California",3,2,1
1000000US060971536001017,060971536001017,"Block 1017, Block Group 1, Census Tract 1536, Sonoma County, California",1,1,0
1000000US060971536001018,060971536001018,"Block 1018, Block Group 1, Census Tract 1536, Sonoma County, California",29,25,4
1000000US060971536001019,060971536001019,"Block 1019, Block Group 1, Census Tract 1536, Sonoma County, California",0,0,0
1000000US060971536001020,060971536001020,"Block 1020, Block Group 1, Census Tract 1536, Sonoma County, California",19,18,1
1000000US060971536001021,060971536001021,"Block 1021, Block Group 1, Census Tract 1536, Sonoma County, California",4,4,0
1000000US060971536001022,060971536001022,"Block 1022, Block Group 1, Census Tract 1536, Sonoma County, California",3,2,1
1000000US060971536001023,060971536001023,"Block 1023, Block Group 1, Census Tract 1536, Sonoma County, California",14,12,2
1000000US060971536001024,060971536001024,"Block 1024, Block Group 1, Census Tract 1536, Sonoma County, California",0,0,0
1000000US060971536001025,060971536001025,"Block 1025, Block Group 1, Census Tract 1536, Sonoma County, California",6,5,1
1000000US060971536001026,060971536001026,"Block 1026, Block Group 1, Census Tract 1536, Sonoma County, California",16,16,0
1000000US060971536001027,060971536001027,"Block 1027, Block Group 1, Census Tract 1536, Sonoma County, California",2,2,0
1000000US060971536002000,060971536002000,"Block 2000, Block Group 2, Census Tract 1536, Sonoma County, California",31,27,4
1000000US060971536002001,060971536002001,"Block 2001, Block Group 2, Census Tract 1536, Sonoma County, California",37,34,3
1000000US060971536002002,060971536002002,"Block 2002, Block Group 2, Census Tract 1536, Sonoma County, California",0,0,0
1000000US060971536002003,060971536002003,"Block 2003, Block Group 2, Census Tract 1536, Sonoma County, California",138,123,15
1000000US060971536002004,060971536002004,"Block 2004, Block Group 2, Census Tract 1536, Sonoma County, California",0,0,0
1000000US060971536002005,060971536002005,"Block 2005, Block Group 2, Census Tract 1536, Sonoma County, California",64,52,12
1000000US060971536002006,060971536002006,"Block 2006, Block Group 2, Census Tract 1536, Sonoma County, California",4,4,0
1000000US060971536002007,060971536002007,"Block 2007, Block Group 2, Census Tract 1536, Sonoma County, California",62,53,9
1000000US060971536002008,060971536002008,"Block 2008, Block Group 2, Census Tract 1536, Sonoma County, California",101,85,16
1000000US060971536002009,060971536002009,"Block 2009, Block Group 2, Census Tract 1536, Sonoma County, California",2,2,0
1000000US060971536003000,060971536003000,"Block 3000, Block Group 3, Census Tract 1536, Sonoma County, California",18,17,1
1000000US060971536003001,060971536003001,"Block 3001, Block Group 3, Census Tract 1536, Sonoma County, California",45,40,5
1000000US060971536003002,060971536003002,"Block 3002, Block Group 3, Census Tract 1536, Sonoma County, California",12,11,1
1000000US060971536003003,060971536003003,"Block 3003, Block Group 3, Census Tract 1536, Sonoma County, California",36,35,1
1000000US060971536003004,060971536003004,"Block 3004, Block Group 3, Census Tract 1536, Sonoma County, California",9,7,2
1000000US060971536003005,060971536003005,"Block 3005, Block Group 3, Census Tract 1536, Sonoma County, California",12,12,0
1000000US060971536003006,060971536003006,"Block 3006, Block Group 3, Census Tract 1536, Sonoma County, California",1,0,1
1000000US060971536003007,060971536003007,"Block 3007, Block Group 3, Census Tract 1536, Sonoma County, California",0,0,0
1000000US060971536003008,060971536003008,"Block 3008, Block Group 3, Census Tract 1536, Sonoma County, California",13,12,1
1000000US060971536003009,060971536003009,"Block 3009, Block Group 3, Census Tract 1536, Sonoma County, California",0,0,0
1000000US060971536003010,060971536003010,"Block 3010, Block Group 3, Census Tract 1536, Sonoma County, California",24,21,3
1000000US060971536003011,060971536003011,"Block 3011, Block Group 3, Census Tract 1536, Sonoma County, California",25,24,1
1000000US060971536003012,060971536003012,"Block 3012, Block Group 3, Census Tract 1536, Sonoma County, California",4,3,1
1000000US060971536003013,060971536003013,"Block 3013, Block Group 3, Census Tract 1536, Sonoma County, California",14,14,0
1000000US060971536003014,060971536003014,"Block 3014, Block Group 3, Census Tract 1536, Sonoma County, California",22,22,0
1000000US060971536003015,060971536003015,"Block 3015, Block Group 3, Census Tract 1536, Sonoma County, California",7,7,0
1000000US060971536003016,060971536003016,"Block 3016, Block Group 3, Census Tract 1536, Sonoma County, California",15,15,0
1000000US060971536003017,060971536003017,"Block 3017, Block Group 3, Census Tract 1536, Sonoma County, California",15,15,0
1000000US060971536003018,060971536003018,"Block 3018, Block Group 3, Census Tract 1536, Sonoma County, California",3,3,0
1000000US060971536003019,060971536003019,"Block 3019, Block Group 3, Census Tract 1536, Sonoma County, California",0,0,0
1000000US060971536003020,060971536003020,"Block 3020, Block Group 3, Census Tract 1536, Sonoma County, California",71,67,4
1000000US060971536003021,060971536003021,"Block 3021, Block Group 3, Census Tract 1536, Sonoma County, California",15,15,0
1000000US060971536003022,060971536003022,"Block 3022, Block Group 3, Census Tract 1536, Sonoma County, California",20,19,1
1000000US060971536003023,060971536003023,"Block 3023, Block Group 3, Census Tract 1536, Sonoma County, California",0,0,0
1000000US060971536003024,060971536003024,"Block 3024, Block Group 3, Census Tract 1536, Sonoma County, California",47,44,3
1000000US060971536003025,060971536003025,"Block 3025, Block Group 3, Census Tract 1536, Sonoma County, California",0,0,0
1000000US060971536003026,060971536003026,"Block 3026, Block Group 3, Census Tract 1536, Sonoma County, California",0,0,0
1000000US060971536003027,060971536003027,"Block 3027, Block Group 3, Census Tract 1536, Sonoma County, California",11,10,1
1000000US060971536004000,060971536004000,"Block 4000, Block Group 4, Census Tract 1536, Sonoma County, California",67,64,3
1000000US060971536004001,060971536004001,"Block 4001, Block Group 4, Census Tract 1536, Sonoma County, California",9,8,1
1000000US060971536004002,060971536004002,"Block 4002, Block Group 4, Census Tract 1536, Sonoma County, California",9,9,0
1000000US060971536004003,060971536004003,"Block 4003, Block Group 4, Census Tract 1536, Sonoma County, California",24,23,1
1000000US060971536004004,060971536004004,"Block 4004, Block Group 4, Census Tract 1536, Sonoma County, California",0,0,0
1000000US060971536004005,060971536004005,"Block 4005, Block Group 4, Census Tract 1536, Sonoma County, California",60,55,5
1000000US060971536004006,060971536004006,"Block 4006, Block Group 4, Census Tract 1536, Sonoma County, California",2,2,0
1000000US060971536004007,060971536004007,"Block 4007, Block Group 4, Census Tract 1536, Sonoma County, California",2,2,0
1000000US060971536004008,060971536004008,"Block 4008, Block Group 4, Census Tract 1536, Sonoma County, California",3,3,0
1000000US060971536004009,060971536004009,"Block 4009, Block Group 4, Census Tract 1536, Sonoma County, California",5,4,1
1000000US060971536004010,060971536004010,"Block 4010, Block Group 4, Census Tract 1536, Sonoma County, California",19,17,2
1000000US060971536004011,060971536004011,"Block 4011, Block Group 4, Census Tract 1536, Sonoma County, California",1,1,0
1000000US060971536004012,060971536004012,"Block 4012, Block Group 4, Census Tract 1536, Sonoma County, California",5,5,0
1000000US060971536004013,060971536004013,"Block 4013, Block Group 4, Census Tract 1536, Sonoma County, California",4,4,0
1000000US060971536004014,060971536004014,"Block 4014, Block Group 4, Census Tract 1536, Sonoma County, California",2,1,1
1000000US060971536004015,060971536004015,"Block 4015, Block Group 4, Census Tract 1536, Sonoma County, California",122,107,15
1000000US060971536004016,060971536004016,"Block 4016, Block Group 4, Census Tract 1536, Sonoma County, California",0,0,0
1000000US060971536004017,060971536004017,"Block 4017, Block Group 4, Census Tract 1536, Sonoma County, California",59,51,8
1000000US060971536004018,060971536004018,"Block 4018, Block Group 4, Census Tract 1536, Sonoma County, California",0,0,0
1000000US060971536004019,060971536004019,"Block 4019, Block Group 4, Census Tract 1536, Sonoma County, California",0,0,0
1000000US060971536004020,060971536004020,"Block 4020, Block Group 4, Census Tract 1536, Sonoma County, California",5,5,0
1000000US060971536004021,060971536004021,"Block 4021, Block Group 4, Census Tract 1536, Sonoma County, California",2,2,0
1000000US060971536004022,060971536004022,"Block 4022, Block Group 4, Census Tract 1536, Sonoma County, California",0,0,0
1000000US060971536004023,060971536004023,"Block 4023, Block Group 4, Census Tract 1536, Sonoma County, California",1,0,1
1000000US060971536005000,060971536005000,"Block 5000, Block Group 5, Census Tract 1536, Sonoma County, California",32,31,1
1000000US060971536005001,060971536005001,"Block 5001, Block Group 5, Census Tract 1536, Sonoma County, California",15,15,0
1000000US060971536005002,060971536005002,"Block 5002, Block Group 5, Census Tract 1536, Sonoma County, California",30,25,5
1000000US060971536005003,060971536005003,"Block 5003, Block Group 5, Census Tract 1536, Sonoma County, California",94,82,12
1000000US060971536005004,060971536005004,"Block 5004, Block Group 5, Census Tract 1536, Sonoma County, California",1,1,0
1000000US060971536005005,060971536005005,"Block 5005, Block Group 5, Census Tract 1536, Sonoma County, California",113,91,22
1000000US060971536005006,060971536005006,"Block 5006, Block Group 5, Census Tract 1536, Sonoma County, California",12,9,3
1000000US060971536005007,060971536005007,"Block 5007, Block Group 5, Census Tract 1536, Sonoma County, California",0,0,0
1000000US060971536005008,060971536005008,"Block 5008, Block Group 5, Census Tract 1536, Sonoma County, California",0,0,0
1000000US060971536005009,060971536005009,"Block 5009, Block Group 5, Census Tract 1536, Sonoma County, California",0,0,0
1000000US060971536005010,060971536005010,"Block 5010, Block Group 5, Census Tract 1536, Sonoma County, California",1,1,0
1000000US060971536005011,060971536005011,"Block 5011, Block Group 5, Census Tract 1536, Sonoma County, California",11,11,0
1000000US060971536005012,060971536005012,"Block 5012, Block Group 5, Census Tract 1536, Sonoma County, California",50,45,5
1000000US060971536005013,060971536005013,"Block 5013, Block Group 5, Census Tract 1536, Sonoma County, California",50,46,4
1000000US060971536005014,060971536005014,"Block 5014, Block Group 5, Census Tract 1536, Sonoma County, California",48,42,6
1000000US060971536005015,060971536005015,"Block 5015, Block Group 5, Census Tract 1536, Sonoma County, California",23,19,4
1000000US060971536005016,060971536005016,"Block 5016, Block Group 5, Census Tract 1536, Sonoma County, California",48,44,4
1000000US060971536005017,060971536005017,"Block 5017, Block Group 5, Census Tract 1536, Sonoma County, California",10,10,0
1000000US060971536005018,060971536005018,"Block 5018, Block Group 5, Census Tract 1536, Sonoma County, California",50,40,10
1000000US060971536005019,060971536005019,"Block 5019, Block Group 5, Census Tract 1536, Sonoma County, California",0,0,0
1000000US060971536005020,060971536005020,"Block 5020, Block Group 5, Census Tract 1536, Sonoma County, California",82,68,14
1000000US060971536005021,060971536005021,"Block 5021, Block Group 5, Census Tract 1536, Sonoma County, California",22,20,2
1000000US060971536005022,060971536005022,"Block 5022, Block Group 5, Census Tract 1536, Sonoma County, California",31,26,5
1000000US060971536005023,060971536005023,"Block 5023, Block Group 5, Census Tract 1536, Sonoma County, California",38,32,6
1000000US060971536005024,060971536005024,"Block 5024, Block Group 5, Census Tract 1536, Sonoma County, California",0,0,0
1000000US060971536005025,060971536005025,"Block 5025, Block Group 5, Census Tract 1536, Sonoma County, California",1,1,0
1000000US060971536005026,060971536005026,"Block 5026, Block Group 5, Census Tract 1536, Sonoma County, California",9,5,4
1000000US060971536005027,060971536005027,"Block 5027, Block Group 5, Census Tract 1536, Sonoma County, California",5,2,3
1000000US060971537031000,060971537031000,"Block 1000, Block Group 1, Census Tract 1537.03, Sonoma County, California",5,2,3
1000000US060971537031001,060971537031001,"Block 1001, Block Group 1, Census Tract 1537.03, Sonoma County, California",9,2,7
1000000US060971537031002,060971537031002,"Block 1002, Block Group 1, Census Tract 1537.03, Sonoma County, California",59,23,36
1000000US060971537031003,060971537031003,"Block 1003, Block Group 1, Census Tract 1537.03, Sonoma County, California",5,3,2
1000000US060971537031004,060971537031004,"Block 1004, Block Group 1, Census Tract 1537.03, Sonoma County, California",0,0,0
1000000US060971537031005,060971537031005,"Block 1005, Block Group 1, Census Tract 1537.03, Sonoma County, California",5,0,5
1000000US060971537031006,060971537031006,"Block 1006, Block Group 1, Census Tract 1537.03, Sonoma County, California",0,0,0
1000000US060971537031007,060971537031007,"Block 1007, Block Group 1, Census Tract 1537.03, Sonoma County, California",0,0,0
1000000US060971537031008,060971537031008,"Block 1008, Block Group 1, Census Tract 1537.03, Sonoma County, California",0,0,0
1000000US060971537031009,060971537031009,"Block 1009, Block Group 1, Census Tract 1537.03, Sonoma County, California",79,50,29
1000000US060971537031010,060971537031010,"Block 1010, Block Group 1, Census Tract 1537.03, Sonoma County, California",1,1,0
1000000US060971537031011,060971537031011,"Block 1011, Block Group 1, Census Tract 1537.03, Sonoma County, California",12,3,9
1000000US060971537031012,060971537031012,"Block 1012, Block Group 1, Census Tract 1537.03, Sonoma County, California",6,5,1
1000000US060971537031013,060971537031013,"Block 1013, Block Group 1, Census Tract 1537.03, Sonoma County, California",0,0,0
1000000US060971537031014,060971537031014,"Block 1014, Block Group 1, Census Tract 1537.03, Sonoma County, California",60,38,22
1000000US060971537031015,060971537031015,"Block 1015, Block Group 1, Census Tract 1537.03, Sonoma County, California",103,64,39
1000000US060971537031016,060971537031016,"Block 1016, Block Group 1, Census Tract 1537.03, Sonoma County, California",15,12,3
1000000US060971537031017,060971537031017,"Block 1017, Block Group 1, Census Tract 1537.03, Sonoma County, California",25,15,10
1000000US060971537031018,060971537031018,"Block 1018, Block Group 1, Census Tract 1537.03, Sonoma County, California",13,10,3
1000000US060971537031019,060971537031019,"Block 1019, Block Group 1, Census Tract 1537.03, Sonoma County, California",18,14,4
1000000US060971537031020,060971537031020,"Block 1020, Block Group 1, Census Tract 1537.03, Sonoma County, California",3,1,2
1000000US060971537031021,060971537031021,"Block 1021, Block Group 1, Census Tract 1537.03, Sonoma County, California",2,2,0
1000000US060971537031022,060971537031022,"Block 1022, Block Group 1, Census Tract 1537.03, Sonoma County, California",0,0,0
1000000US060971537031023,060971537031023,"Block 1023, Block Group 1, Census Tract 1537.03, Sonoma County, California",0,0,0
1000000US060971537031024,060971537031024,"Block 1024, Block Group 1, Census Tract 1537.03, Sonoma County, California",0,0,0
1000000US060971537031025,060971537031025,"Block 1025, Block Group 1, Census Tract 1537.03, Sonoma County, California",24,10,14
1000000US060971537031026,060971537031026,"Block 1026, Block Group 1, Census Tract 1537.03, Sonoma County, California",0,0,0
1000000US060971537031027,060971537031027,"Block 1027, Block Group 1, Census Tract 1537.03, Sonoma County, California",0,0,0
1000000US060971537031028,060971537031028,"Block 1028, Block Group 1, Census Tract 1537.03, Sonoma County, California",0,0,0
1000000US060971537031029,060971537031029,"Block 1029, Block Group 1, Census Tract 1537.03, Sonoma County, California",0,0,0
1000000US060971537031030,060971537031030,"Block 1030, Block Group 1, Census Tract 1537.03, Sonoma County, California",12,5,7
1000000US060971537031031,060971537031031,"Block 1031, Block Group 1, Census Tract 1537.03, Sonoma County, California",9,5,4
1000000US060971537031032,060971537031032,"Block 1032, Block Group 1, Census Tract 1537.03, Sonoma County, California",4,0,4
1000000US060971537031033,060971537031033,"Block 1033, Block Group 1, Census Tract 1537.03, Sonoma County, California",16,11,5
1000000US060971537031034,060971537031034,"Block 1034, Block Group 1, Census Tract 1537.03, Sonoma County, California",23,10,13
1000000US060971537031035,060971537031035,"Block 1035, Block Group 1, Census Tract 1537.03, Sonoma County, California",44,12,32
1000000US060971537031036,060971537031036,"Block 1036, Block Group 1, Census Tract 1537.03, Sonoma County, California",5,1,4
1000000US060971537031037,060971537031037,"Block 1037, Block Group 1, Census Tract 1537.03, Sonoma County, California",0,0,0
1000000US060971537031038,060971537031038,"Block 1038, Block Group 1, Census Tract 1537.03, Sonoma County, California",1,0,1
1000000US060971537031039,060971537031039,"Block 1039, Block Group 1, Census Tract 1537.03, Sonoma County, California",0,0,0
1000000US060971537031040,060971537031040,"Block 1040, Block Group 1, Census Tract 1537.03, Sonoma County, California",0,0,0
1000000US060971537031041,060971537031041,"Block 1041, Block Group 1, Census Tract 1537.03, Sonoma County, California",1,0,1
1000000US060971537031042,060971537031042,"Block 1042, Block Group 1, Census Tract 1537.03, Sonoma County, California",10,2,8
1000000US060971537031043,060971537031043,"Block 1043, Block Group 1, Census Tract 1537.03, Sonoma County, California",0,0,0
1000000US060971537031044,060971537031044,"Block 1044, Block Group 1, Census Tract 1537.03, Sonoma County, California",0,0,0
1000000US060971537031045,060971537031045,"Block 1045, Block Group 1, Census Tract 1537.03, Sonoma County, California",0,0,0
1000000US060971537031046,060971537031046,"Block 1046, Block Group 1, Census Tract 1537.03, Sonoma County, California",48,37,11
1000000US060971537031047,060971537031047,"Block 1047, Block Group 1, Census Tract 1537.03, Sonoma County, California",13,10,3
1000000US060971537031048,060971537031048,"Block 1048, Block Group 1, Census Tract 1537.03, Sonoma County, California",15,11,4
1000000US060971537031049,060971537031049,"Block 1049, Block Group 1, Census Tract 1537.03, Sonoma County, California",6,6,0
1000000US060971537031050,060971537031050,"Block 1050, Block Group 1, Census Tract 1537.03, Sonoma County, California",4,2,2
1000000US060971537031051,060971537031051,"Block 1051, Block Group 1, Census Tract 1537.03, Sonoma County, California",6,5,1
1000000US060971537031052,060971537031052,"Block 1052, Block Group 1, Census Tract 1537.03, Sonoma County, California",0,0,0
1000000US060971537031053,060971537031053,"Block 1053, Block Group 1, Census Tract 1537.03, Sonoma County, California",11,7,4
1000000US060971537031054,060971537031054,"Block 1054, Block Group 1, Census Tract 1537.03, Sonoma County, California",16,15,1
1000000US060971537031055,060971537031055,"Block 1055, Block Group 1, Census Tract 1537.03, Sonoma County, California",8,7,1
1000000US060971537031056,060971537031056,"Block 1056, Block Group 1, Census Tract 1537.03, Sonoma County, California",0,0,0
1000000US060971537031057,060971537031057,"Block 1057, Block Group 1, Census Tract 1537.03, Sonoma County, California",7,6,1
1000000US060971537031058,060971537031058,"Block 1058, Block Group 1, Census Tract 1537.03, Sonoma County, California",35,17,18
1000000US060971537031059,060971537031059,"Block 1059, Block Group 1, Census Tract 1537.03, Sonoma County, California",0,0,0
1000000US060971537031060,060971537031060,"Block 1060, Block Group 1, Census Tract 1537.03, Sonoma County, California",110,87,23
1000000US060971537031061,060971537031061,"Block 1061, Block Group 1, Census Tract 1537.03, Sonoma County, California",19,18,1
1000000US060971537031062,060971537031062,"Block 1062, Block Group 1, Census Tract 1537.03, Sonoma County, California",2,1,1
1000000US060971537031063,060971537031063,"Block 1063, Block Group 1, Census Tract 1537.03, Sonoma County, California",0,0,0
1000000US060971537031064,060971537031064,"Block 1064, Block Group 1, Census Tract 1537.03, Sonoma County, California",10,4,6
1000000US060971537031065,060971537031065,"Block 1065, Block Group 1, Census Tract 1537.03, Sonoma County, California",3,3,0
1000000US060971537031066,060971537031066,"Block 1066, Block Group 1, Census Tract 1537.03, Sonoma County, California",0,0,0
1000000US060971537031067,060971537031067,"Block 1067, Block Group 1, Census Tract 1537.03, Sonoma County, California",0,0,0
1000000US060971537031068,060971537031068,"Block 1068, Block Group 1, Census Tract 1537.03, Sonoma County, California",1,1,0
1000000US060971537031069,060971537031069,"Block 1069, Block Group 1, Census Tract 1537.03, Sonoma County, California",14,14,0
1000000US060971537031070,060971537031070,"Block 1070, Block Group 1, Census Tract 1537.03, Sonoma County, California",13,8,5
1000000US060971537031071,060971537031071,"Block 1071, Block Group 1, Census Tract 1537.03, Sonoma County, California",4,4,0
1000000US060971537032000,060971537032000,"Block 2000, Block Group 2, Census Tract 1537.03, Sonoma County, California",89,50,39
1000000US060971537032001,060971537032001,"Block 2001, Block Group 2, Census Tract 1537.03, Sonoma County, California",18,9,9
1000000US060971537032002,060971537032002,"Block 2002, Block Group 2, Census Tract 1537.03, Sonoma County, California",8,6,2
1000000US060971537032003,060971537032003,"Block 2003, Block Group 2, Census Tract 1537.03, Sonoma County, California",31,18,13
1000000US060971537032004,060971537032004,"Block 2004, Block Group 2, Census Tract 1537.03, Sonoma County, California",11,9,2
1000000US060971537032005,060971537032005,"Block 2005, Block Group 2, Census Tract 1537.03, Sonoma County, California",0,0,0
1000000US060971537032006,060971537032006,"Block 2006, Block Group 2, Census Tract 1537.03, Sonoma County, California",15,9,6
1000000US060971537032007,060971537032007,"Block 2007, Block Group 2, Census Tract 1537.03, Sonoma County, California",65,21,44
1000000US060971537032008,060971537032008,"Block 2008, Block Group 2, Census Tract 1537.03, Sonoma County, California",8,3,5
1000000US060971537032009,060971537032009,"Block 2009, Block Group 2, Census Tract 1537.03, Sonoma County, California",5,1,4
1000000US060971537032010,060971537032010,"Block 2010, Block Group 2, Census Tract 1537.03, Sonoma County, California",17,10,7
1000000US060971537032011,060971537032011,"Block 2011, Block Group 2, Census Tract 1537.03, Sonoma County, California",14,12,2
1000000US060971537032012,060971537032012,"Block 2012, Block Group 2, Census Tract 1537.03, Sonoma County, California",9,4,5
1000000US060971537032013,060971537032013,"Block 2013, Block Group 2, Census Tract 1537.03, Sonoma County, California",0,0,0
1000000US060971537032014,060971537032014,"Block 2014, Block Group 2, Census Tract 1537.03, Sonoma County, California",6,3,3
1000000US060971537032015,060971537032015,"Block 2015, Block Group 2, Census Tract 1537.03, Sonoma County, California",7,6,1
1000000US060971537032016,060971537032016,"Block 2016, Block Group 2, Census Tract 1537.03, Sonoma County, California",6,5,1
1000000US060971537032017,060971537032017,"Block 2017, Block Group 2, Census Tract 1537.03, Sonoma County, California",7,3,4
1000000US060971537032018,060971537032018,"Block 2018, Block Group 2, Census Tract 1537.03, Sonoma County, California",9,4,5
1000000US060971537032019,060971537032019,"Block 2019, Block Group 2, Census Tract 1537.03, Sonoma County, California",50,31,19
1000000US060971537032020,060971537032020,"Block 2020, Block Group 2, Census Tract 1537.03, Sonoma County, California",53,36,17
1000000US060971537032021,060971537032021,"Block 2021, Block Group 2, Census Tract 1537.03, Sonoma County, California",17,10,7
1000000US060971537032022,060971537032022,"Block 2022, Block Group 2, Census Tract 1537.03, Sonoma County, California",8,4,4
1000000US060971537032023,060971537032023,"Block 2023, Block Group 2, Census Tract 1537.03, Sonoma County, California",39,22,17
1000000US060971537032024,060971537032024,"Block 2024, Block Group 2, Census Tract 1537.03, Sonoma County, California",86,59,27
1000000US060971537032025,060971537032025,"Block 2025, Block Group 2, Census Tract 1537.03, Sonoma County, California",6,4,2
1000000US060971537032026,060971537032026,"Block 2026, Block Group 2, Census Tract 1537.03, Sonoma County, California",9,5,4
1000000US060971537032027,060971537032027,"Block 2027, Block Group 2, Census Tract 1537.03, Sonoma County, California",1,1,0
1000000US060971537032028,060971537032028,"Block 2028, Block Group 2, Census Tract 1537.03, Sonoma County, California",8,6,2
1000000US060971537032029,060971537032029,"Block 2029, Block Group 2, Census Tract 1537.03, Sonoma County, California",18,7,11
1000000US060971537032030,060971537032030,"Block 2030, Block Group 2, Census Tract 1537.03, Sonoma County, California",3,2,1
1000000US060971537032031,060971537032031,"Block 2031, Block Group 2, Census Tract 1537.03, Sonoma County, California",14,9,5
1000000US060971537032032,060971537032032,"Block 2032, Block Group 2, Census Tract 1537.03, Sonoma County, California",4,4,0
1000000US060971537032033,060971537032033,"Block 2033, Block Group 2, Census Tract 1537.03, Sonoma County, California",0,0,0
1000000US060971537032034,060971537032034,"Block 2034, Block Group 2, Census Tract 1537.03, Sonoma County, California",5,4,1
1000000US060971537032035,060971537032035,"Block 2035, Block Group 2, Census Tract 1537.03, Sonoma County, California",32,20,12
1000000US060971537033000,060971537033000,"Block 3000, Block Group 3, Census Tract 1537.03, Sonoma County, California",21,11,10
1000000US060971537033001,060971537033001,"Block 3001, Block Group 3, Census Tract 1537.03, Sonoma County, California",0,0,0
1000000US060971537033002,060971537033002,"Block 3002, Block Group 3, Census Tract 1537.03, Sonoma County, California",1,1,0
1000000US060971537033003,060971537033003,"Block 3003, Block Group 3, Census Tract 1537.03, Sonoma County, California",61,41,20
1000000US060971537033004,060971537033004,"Block 3004, Block Group 3, Census Tract 1537.03, Sonoma County, California",0,0,0
1000000US060971537033005,060971537033005,"Block 3005, Block Group 3, Census Tract 1537.03, Sonoma County, California",31,20,11
1000000US060971537033006,060971537033006,"Block 3006, Block Group 3, Census Tract 1537.03, Sonoma County, California",29,14,15
1000000US060971537033007,060971537033007,"Block 3007, Block Group 3, Census Tract 1537.03, Sonoma County, California",102,61,41
1000000US060971537033008,060971537033008,"Block 3008, Block Group 3, Census Tract 1537.03, Sonoma County, California",6,6,0
1000000US060971537033009,060971537033009,"Block 3009, Block Group 3, Census Tract 1537.03, Sonoma County, California",21,18,3
1000000US060971537033010,060971537033010,"Block 3010, Block Group 3, Census Tract 1537.03, Sonoma County, California",6,6,0
1000000US060971537033011,060971537033011,"Block 3011, Block Group 3, Census Tract 1537.03, Sonoma County, California",28,19,9
1000000US060971537033012,060971537033012,"Block 3012, Block Group 3, Census Tract 1537.03, Sonoma County, California",53,42,11
1000000US060971537033013,060971537033013,"Block 3013, Block Group 3, Census Tract 1537.03, Sonoma County, California",0,0,0
1000000US060971537033014,060971537033014,"Block 3014, Block Group 3, Census Tract 1537.03, Sonoma County, California",30,9,21
1000000US060971537033015,060971537033015,"Block 3015, Block Group 3, Census Tract 1537.03, Sonoma County, California",1,1,0
1000000US060971537033016,060971537033016,"Block 3016, Block Group 3, Census Tract 1537.03, Sonoma County, California",22,19,3
1000000US060971537033017,060971537033017,"Block 3017, Block Group 3, Census Tract 1537.03, Sonoma County, California",19,9,10
1000000US060971537033018,060971537033018,"Block 3018, Block Group 3, Census Tract 1537.03, Sonoma County, California",24,19,5
1000000US060971537033019,060971537033019,"Block 3019, Block Group 3, Census Tract 1537.03, Sonoma County, California",0,0,0
1000000US060971537034000,060971537034000,"Block 4000, Block Group 4, Census Tract 1537.03, Sonoma County, California",35,27,8
1000000US060971537034001,060971537034001,"Block 4001, Block Group 4, Census Tract 1537.03, Sonoma County, California",23,18,5
1000000US060971537034002,060971537034002,"Block 4002, Block Group 4, Census Tract 1537.03, Sonoma County, California",0,0,0
1000000US060971537034003,060971537034003,"Block 4003, Block Group 4, Census Tract 1537.03, Sonoma County, California",39,33,6
1000000US060971537034004,060971537034004,"Block 4004, Block Group 4, Census Tract 1537.03, Sonoma County, California",0,0,0
1000000US060971537034005,060971537034005,"Block 4005, Block Group 4, Census Tract 1537.03, Sonoma County, California",0,0,0
1000000US060971537034006,060971537034006,"Block 4006, Block Group 4, Census Tract 1537.03, Sonoma County, California",0,0,0
1000000US060971537034007,060971537034007,"Block 4007, Block Group 4, Census Tract 1537.03, Sonoma County, California",0,0,0
1000000US060971537034008,060971537034008,"Block 4008, Block Group 4, Census Tract 1537.03, Sonoma County, California",0,0,0
1000000US060971537034009,060971537034009,"Block 4009, Block Group 4, Census Tract 1537.03, Sonoma County, California",0,0,0
1000000US060971537034010,060971537034010,"Block 4010, Block Group 4, Census Tract 1537.03, Sonoma County, California",0,0,0
1000000US060971537034011,060971537034011,"Block 4011, Block Group 4, Census Tract 1537.03, Sonoma County, California",0,0,0
1000000US060971537034012,060971537034012,"Block 4012, Block Group 4, Census Tract 1537.03, Sonoma County, California",0,0,0
1000000US060971537034013,060971537034013,"Block 4013, Block Group 4, Census Tract 1537.03, Sonoma County, California",29,20,9
1000000US060971537034014,060971537034014,"Block 4014, Block Group 4, Census Tract 1537.03, Sonoma County, California",0,0,0
1000000US060971537034015,060971537034015,"Block 4015, Block Group 4, Census Tract 1537.03, Sonoma County, California",0,0,0
1000000US060971537034016,060971537034016,"Block 4016, Block Group 4, Census Tract 1537.03, Sonoma County, California",0,0,0
1000000US060971537034017,060971537034017,"Block 4017, Block Group 4, Census Tract 1537.03, Sonoma County, California",17,14,3
1000000US060971537034018,060971537034018,"Block 4018, Block Group 4, Census Tract 1537.03, Sonoma County, California",0,0,0
1000000US060971537034019,060971537034019,"Block 4019, Block Group 4, Census Tract 1537.03, Sonoma County, California",0,0,0
1000000US060971537034020,060971537034020,"Block 4020, Block Group 4, Census Tract 1537.03, Sonoma County, California",0,0,0
1000000US060971537034021,060971537034021,"Block 4021, Block Group 4, Census Tract 1537.03, Sonoma County, California",0,0,0
1000000US060971537034022,060971537034022,"Block 4022, Block Group 4, Census Tract 1537.03, Sonoma County, California",0,0,0
1000000US060971537034023,060971537034023,"Block 4023, Block Group 4, Census Tract 1537.03, Sonoma County, California",0,0,0
1000000US060971537034024,060971537034024,"Block 4024, Block Group 4, Census Tract 1537.03, Sonoma County, California",0,0,0
1000000US060971537034025,060971537034025,"Block 4025, Block Group 4, Census Tract 1537.03, Sonoma County, California",6,6,0
1000000US060971537034026,060971537034026,"Block 4026, Block Group 4, Census Tract 1537.03, Sonoma County, California",1,1,0
1000000US060971537034027,060971537034027,"Block 4027, Block Group 4, Census Tract 1537.03, Sonoma County, California",22,12,10
1000000US060971537034028,060971537034028,"Block 4028, Block Group 4, Census Tract 1537.03, Sonoma County, California",56,44,12
1000000US060971537034029,060971537034029,"Block 4029, Block Group 4, Census Tract 1537.03, Sonoma County, California",8,7,1
1000000US060971537034030,060971537034030,"Block 4030, Block Group 4, Census Tract 1537.03, Sonoma County, California",0,0,0
1000000US060971537034031,060971537034031,"Block 4031, Block Group 4, Census Tract 1537.03, Sonoma County, California",0,0,0
1000000US060971537034032,060971537034032,"Block 4032, Block Group 4, Census Tract 1537.03, Sonoma County, California",0,0,0
1000000US060971537034033,060971537034033,"Block 4033, Block Group 4, Census Tract 1537.03, Sonoma County, California",1,0,1
1000000US060971537034034,060971537034034,"Block 4034, Block Group 4, Census Tract 1537.03, Sonoma County, California",0,0,0
1000000US060971537034035,060971537034035,"Block 4035, Block Group 4, Census Tract 1537.03, Sonoma County, California",0,0,0
1000000US060971537034036,060971537034036,"Block 4036, Block Group 4, Census Tract 1537.03, Sonoma County, California",0,0,0
1000000US060971537034037,060971537034037,"Block 4037, Block Group 4, Census Tract 1537.03, Sonoma County, California",0,0,0
1000000US060971537034038,060971537034038,"Block 4038, Block Group 4, Census Tract 1537.03, Sonoma County, California",5,3,2
1000000US060971537034039,060971537034039,"Block 4039, Block Group 4, Census Tract 1537.03, Sonoma County, California",0,0,0
1000000US060971537034040,060971537034040,"Block 4040, Block Group 4, Census Tract 1537.03, Sonoma County, California",5,5,0
1000000US060971537034041,060971537034041,"Block 4041, Block Group 4, Census Tract 1537.03, Sonoma County, California",0,0,0
1000000US060971537034042,060971537034042,"Block 4042, Block Group 4, Census Tract 1537.03, Sonoma County, California",0,0,0
1000000US060971537034043,060971537034043,"Block 4043, Block Group 4, Census Tract 1537.03, Sonoma County, California",0,0,0
1000000US060971537034044,060971537034044,"Block 4044, Block Group 4, Census Tract 1537.03, Sonoma County, California",12,9,3
1000000US060971537034045,060971537034045,"Block 4045, Block Group 4, Census Tract 1537.03, Sonoma County, California",9,7,2
1000000US060971537034046,060971537034046,"Block 4046, Block Group 4, Census Tract 1537.03, Sonoma County, California",2,2,0
1000000US060971537034047,060971537034047,"Block 4047, Block Group 4, Census Tract 1537.03, Sonoma County, California",11,7,4
1000000US060971537034048,060971537034048,"Block 4048, Block Group 4, Census Tract 1537.03, Sonoma County, California",13,9,4
1000000US060971537034049,060971537034049,"Block 4049, Block Group 4, Census Tract 1537.03, Sonoma County, California",0,0,0
1000000US060971537034050,060971537034050,"Block 4050, Block Group 4, Census Tract 1537.03, Sonoma County, California",0,0,0
1000000US060971537034051,060971537034051,"Block 4051, Block Group 4, Census Tract 1537.03, Sonoma County, California",0,0,0
1000000US060971537034052,060971537034052,"Block 4052, Block Group 4, Census Tract 1537.03, Sonoma County, California",0,0,0
1000000US060971537034053,060971537034053,"Block 4053, Block Group 4, Census Tract 1537.03, Sonoma County, California",18,10,8
1000000US060971537034054,060971537034054,"Block 4054, Block Group 4, Census Tract 1537.03, Sonoma County, California",1,1,0
1000000US060971537034055,060971537034055,"Block 4055, Block Group 4, Census Tract 1537.03, Sonoma County, California",0,0,0
1000000US060971537034056,060971537034056,"Block 4056, Block Group 4, Census Tract 1537.03, Sonoma County, California",0,0,0
1000000US060971537034057,060971537034057,"Block 4057, Block Group 4, Census Tract 1537.03, Sonoma County, California",0,0,0
1000000US060971537034058,060971537034058,"Block 4058, Block Group 4, Census Tract 1537.03, Sonoma County, California",4,2,2
1000000US060971537034059,060971537034059,"Block 4059, Block Group 4, Census Tract 1537.03, Sonoma County, California",0,0,0
1000000US060971537034060,060971537034060,"Block 4060, Block Group 4, Census Tract 1537.03, Sonoma County, California",0,0,0
1000000US060971537035000,060971537035000,"Block 5000, Block Group 5, Census Tract 1537.03, Sonoma County, California",82,61,21
1000000US060971537035001,060971537035001,"Block 5001, Block Group 5, Census Tract 1537.03, Sonoma County, California",27,13,14
1000000US060971537035002,060971537035002,"Block 5002, Block Group 5, Census Tract 1537.03, Sonoma County, California",11,8,3
1000000US060971537035003,060971537035003,"Block 5003, Block Group 5, Census Tract 1537.03, Sonoma County, California",9,4,5
1000000US060971537035004,060971537035004,"Block 5004, Block Group 5, Census Tract 1537.03, Sonoma County, California",25,19,6
1000000US060971537035005,060971537035005,"Block 5005, Block Group 5, Census Tract 1537.03, Sonoma County, California",5,5,0
1000000US060971537035006,060971537035006,"Block 5006, Block Group 5, Census Tract 1537.03, Sonoma County, California",25,16,9
1000000US060971537035007,060971537035007,"Block 5007, Block Group 5, Census Tract 1537.03, Sonoma County, California",8,5,3
1000000US060971537035008,060971537035008,"Block 5008, Block Group 5, Census Tract 1537.03, Sonoma County, California",21,7,14
1000000US060971537035009,060971537035009,"Block 5009, Block Group 5, Census Tract 1537.03, Sonoma County, California",19,7,12
1000000US060971537035010,060971537035010,"Block 5010, Block Group 5, Census Tract 1537.03, Sonoma County, California",4,3,1
1000000US060971537035011,060971537035011,"Block 5011, Block Group 5, Census Tract 1537.03, Sonoma County, California",0,0,0
1000000US060971537035012,060971537035012,"Block 5012, Block Group 5, Census Tract 1537.03, Sonoma County, California",0,0,0
1000000US060971537035013,060971537035013,"Block 5013, Block Group 5, Census Tract 1537.03, Sonoma County, California",11,5,6
1000000US060971537035014,060971537035014,"Block 5014, Block Group 5, Census Tract 1537.03, Sonoma County, California",0,0,0
1000000US060971537035015,060971537035015,"Block 5015, Block Group 5, Census Tract 1537.03, Sonoma County, California",30,11,19
1000000US060971537035016,060971537035016,"Block 5016, Block Group 5, Census Tract 1537.03, Sonoma County, California",6,3,3
1000000US060971537035017,060971537035017,"Block 5017, Block Group 5, Census Tract 1537.03, Sonoma County, California",50,29,21
1000000US060971537035018,060971537035018,"Block 5018, Block Group 5, Census Tract 1537.03, Sonoma County, California",2,2,0
1000000US060971537035019,060971537035019,"Block 5019, Block Group 5, Census Tract 1537.03, Sonoma County, California",10,7,3
1000000US060971537035020,060971537035020,"Block 5020, Block Group 5, Census Tract 1537.03, Sonoma County, California",6,4,2
1000000US060971537035021,060971537035021,"Block 5021, Block Group 5, Census Tract 1537.03, Sonoma County, California",0,0,0
1000000US060971537035022,060971537035022,"Block 5022, Block Group 5, Census Tract 1537.03, Sonoma County, California",28,19,9
1000000US060971537035023,060971537035023,"Block 5023, Block Group 5, Census Tract 1537.03, Sonoma County, California",31,22,9
1000000US060971537035024,060971537035024,"Block 5024, Block Group 5, Census Tract 1537.03, Sonoma County, California",8,3,5
1000000US060971537035025,060971537035025,"Block 5025, Block Group 5, Census Tract 1537.03, Sonoma County, California",0,0,0
1000000US060971537035026,060971537035026,"Block 5026, Block Group 5, Census Tract 1537.03, Sonoma County, California",25,21,4
1000000US060971537035027,060971537035027,"Block 5027, Block Group 5, Census Tract 1537.03, Sonoma County, California",0,0,0
1000000US060971537035028,060971537035028,"Block 5028, Block Group 5, Census Tract 1537.03, Sonoma County, California",0,0,0
1000000US060971537035029,060971537035029,"Block 5029, Block Group 5, Census Tract 1537.03, Sonoma County, California",0,0,0
1000000US060971537035030,060971537035030,"Block 5030, Block Group 5, Census Tract 1537.03, Sonoma County, California",0,0,0
1000000US060971537035031,060971537035031,"Block 5031, Block Group 5, Census Tract 1537.03, Sonoma County, California",0,0,0
1000000US060971537035032,060971537035032,"Block 5032, Block Group 5, Census Tract 1537.03, Sonoma County, California",14,7,7
1000000US060971537035033,060971537035033,"Block 5033, Block Group 5, Census Tract 1537.03, Sonoma County, California",6,5,1
1000000US060971537035034,060971537035034,"Block 5034, Block Group 5, Census Tract 1537.03, Sonoma County, California",0,0,0
1000000US060971537035035,060971537035035,"Block 5035, Block Group 5, Census Tract 1537.03, Sonoma County, California",0,0,0
1000000US060971537041000,060971537041000,"Block 1000, Block Group 1, Census Tract 1537.04, Sonoma County, California",31,24,7
1000000US060971537041001,060971537041001,"Block 1001, Block Group 1, Census Tract 1537.04, Sonoma County, California",0,0,0
1000000US060971537041002,060971537041002,"Block 1002, Block Group 1, Census Tract 1537.04, Sonoma County, California",0,0,0
1000000US060971537041003,060971537041003,"Block 1003, Block Group 1, Census Tract 1537.04, Sonoma County, California",0,0,0
1000000US060971537041004,060971537041004,"Block 1004, Block Group 1, Census Tract 1537.04, Sonoma County, California",2,1,1
1000000US060971537041005,060971537041005,"Block 1005, Block Group 1, Census Tract 1537.04, Sonoma County, California",0,0,0
1000000US060971537041006,060971537041006,"Block 1006, Block Group 1, Census Tract 1537.04, Sonoma County, California",2,2,0
1000000US060971537041007,060971537041007,"Block 1007, Block Group 1, Census Tract 1537.04, Sonoma County, California",0,0,0
1000000US060971537041008,060971537041008,"Block 1008, Block Group 1, Census Tract 1537.04, Sonoma County, California",0,0,0
1000000US060971537041009,060971537041009,"Block 1009, Block Group 1, Census Tract 1537.04, Sonoma County, California",0,0,0
1000000US060971537041010,060971537041010,"Block 1010, Block Group 1, Census Tract 1537.04, Sonoma County, California",1,1,0
1000000US060971537041011,060971537041011,"Block 1011, Block Group 1, Census Tract 1537.04, Sonoma County, California",1,1,0
1000000US060971537041012,060971537041012,"Block 1012, Block Group 1, Census Tract 1537.04, Sonoma County, California",0,0,0
1000000US060971537041013,060971537041013,"Block 1013, Block Group 1, Census Tract 1537.04, Sonoma County, California",14,8,6
1000000US060971537041014,060971537041014,"Block 1014, Block Group 1, Census Tract 1537.04, Sonoma County, California",0,0,0
1000000US060971537041015,060971537041015,"Block 1015, Block Group 1, Census Tract 1537.04, Sonoma County, California",1,0,1
1000000US060971537041016,060971537041016,"Block 1016, Block Group 1, Census Tract 1537.04, Sonoma County, California",0,0,0
1000000US060971537041017,060971537041017,"Block 1017, Block Group 1, Census Tract 1537.04, Sonoma County, California",2,0,2
1000000US060971537041018,060971537041018,"Block 1018, Block Group 1, Census Tract 1537.04, Sonoma County, California",0,0,0
1000000US060971537041019,060971537041019,"Block 1019, Block Group 1, Census Tract 1537.04, Sonoma County, California",0,0,0
1000000US060971537041020,060971537041020,"Block 1020, Block Group 1, Census Tract 1537.04, Sonoma County, California",4,2,2
1000000US060971537041021,060971537041021,"Block 1021, Block Group 1, Census Tract 1537.04, Sonoma County, California",9,3,6
1000000US060971537041022,060971537041022,"Block 1022, Block Group 1, Census Tract 1537.04, Sonoma County, California",8,8,0
1000000US060971537041023,060971537041023,"Block 1023, Block Group 1, Census Tract 1537.04, Sonoma County, California",171,115,56
1000000US060971537041024,060971537041024,"Block 1024, Block Group 1, Census Tract 1537.04, Sonoma County, California",55,44,11
1000000US060971537041025,060971537041025,"Block 1025, Block Group 1, Census Tract 1537.04, Sonoma County, California",0,0,0
1000000US060971537041026,060971537041026,"Block 1026, Block Group 1, Census Tract 1537.04, Sonoma County, California",14,14,0
1000000US060971537041027,060971537041027,"Block 1027, Block Group 1, Census Tract 1537.04, Sonoma County, California",0,0,0
1000000US060971537041028,060971537041028,"Block 1028, Block Group 1, Census Tract 1537.04, Sonoma County, California",2,1,1
1000000US060971537041029,060971537041029,"Block 1029, Block Group 1, Census Tract 1537.04, Sonoma County, California",0,0,0
1000000US060971537041030,060971537041030,"Block 1030, Block Group 1, Census Tract 1537.04, Sonoma County, California",0,0,0
1000000US060971537041031,060971537041031,"Block 1031, Block Group 1, Census Tract 1537.04, Sonoma County, California",0,0,0
1000000US060971537041032,060971537041032,"Block 1032, Block Group 1, Census Tract 1537.04, Sonoma County, California",0,0,0
1000000US060971537041033,060971537041033,"Block 1033, Block Group 1, Census Tract 1537.04, Sonoma County, California",0,0,0
1000000US060971537041034,060971537041034,"Block 1034, Block Group 1, Census Tract 1537.04, Sonoma County, California",0,0,0
1000000US060971537041035,060971537041035,"Block 1035, Block Group 1, Census Tract 1537.04, Sonoma County, California",0,0,0
1000000US060971537041036,060971537041036,"Block 1036, Block Group 1, Census Tract 1537.04, Sonoma County, California",0,0,0
1000000US060971537041037,060971537041037,"Block 1037, Block Group 1, Census Tract 1537.04, Sonoma County, California",2,2,0
1000000US060971537041038,060971537041038,"Block 1038, Block Group 1, Census Tract 1537.04, Sonoma County, California",69,39,30
1000000US060971537041039,060971537041039,"Block 1039, Block Group 1, Census Tract 1537.04, Sonoma County, California",43,26,17
1000000US060971537041040,060971537041040,"Block 1040, Block Group 1, Census Tract 1537.04, Sonoma County, California",25,14,11
1000000US060971537041041,060971537041041,"Block 1041, Block Group 1, Census Tract 1537.04, Sonoma County, California",14,7,7
1000000US060971537041042,060971537041042,"Block 1042, Block Group 1, Census Tract 1537.04, Sonoma County, California",0,0,0
1000000US060971537041043,060971537041043,"Block 1043, Block Group 1, Census Tract 1537.04, Sonoma County, California",3,3,0
1000000US060971537041044,060971537041044,"Block 1044, Block Group 1, Census Tract 1537.04, Sonoma County, California",1,1,0
1000000US060971537041045,060971537041045,"Block 1045, Block Group 1, Census Tract 1537.04, Sonoma County, California",33,25,8
1000000US060971537041046,060971537041046,"Block 1046, Block Group 1, Census Tract 1537.04, Sonoma County, California",21,15,6
1000000US060971537041047,060971537041047,"Block 1047, Block Group 1, Census Tract 1537.04, Sonoma County, California",0,0,0
1000000US060971537041048,060971537041048,"Block 1048, Block Group 1, Census Tract 1537.04, Sonoma County, California",0,0,0
1000000US060971537042000,060971537042000,"Block 2000, Block Group 2, Census Tract 1537.04, Sonoma County, California",1,1,0
1000000US060971537042001,060971537042001,"Block 2001, Block Group 2, Census Tract 1537.04, Sonoma County, California",7,5,2
1000000US060971537042002,060971537042002,"Block 2002, Block Group 2, Census Tract 1537.04, Sonoma County, California",32,26,6
1000000US060971537042003,060971537042003,"Block 2003, Block Group 2, Census Tract 1537.04, Sonoma County, California",9,7,2
1000000US060971537042004,060971537042004,"Block 2004, Block Group 2, Census Tract 1537.04, Sonoma County, California",13,12,1
1000000US060971537042005,060971537042005,"Block 2005, Block Group 2, Census Tract 1537.04, Sonoma County, California",26,17,9
1000000US060971537042006,060971537042006,"Block 2006, Block Group 2, Census Tract 1537.04, Sonoma County, California",10,9,1
1000000US060971537042007,060971537042007,"Block 2007, Block Group 2, Census Tract 1537.04, Sonoma County, California",146,122,24
1000000US060971537042008,060971537042008,"Block 2008, Block Group 2, Census Tract 1537.04, Sonoma County, California",7,7,0
1000000US060971537042009,060971537042009,"Block 2009, Block Group 2, Census Tract 1537.04, Sonoma County, California",0,0,0
1000000US060971537042010,060971537042010,"Block 2010, Block Group 2, Census Tract 1537.04, Sonoma County, California",22,20,2
1000000US060971537042011,060971537042011,"Block 2011, Block Group 2, Census Tract 1537.04, Sonoma County, California",11,8,3
1000000US060971537042012,060971537042012,"Block 2012, Block Group 2, Census Tract 1537.04, Sonoma County, California",2,2,0
1000000US060971537042013,060971537042013,"Block 2013, Block Group 2, Census Tract 1537.04, Sonoma County, California",51,44,7
1000000US060971537042014,060971537042014,"Block 2014, Block Group 2, Census Tract 1537.04, Sonoma County, California",4,4,0
1000000US060971537042015,060971537042015,"Block 2015, Block Group 2, Census Tract 1537.04, Sonoma County, California",1,1,0
1000000US060971537042016,060971537042016,"Block 2016, Block Group 2, Census Tract 1537.04, Sonoma County, California",6,6,0
1000000US060971537042017,060971537042017,"Block 2017, Block Group 2, Census Tract 1537.04, Sonoma County, California",15,13,2
1000000US060971537042018,060971537042018,"Block 2018, Block Group 2, Census Tract 1537.04, Sonoma County, California",0,0,0
1000000US060971537042019,060971537042019,"Block 2019, Block Group 2, Census Tract 1537.04, Sonoma County, California",3,3,0
1000000US060971537042020,060971537042020,"Block 2020, Block Group 2, Census Tract 1537.04, Sonoma County, California",1,1,0
1000000US060971537042021,060971537042021,"Block 2021, Block Group 2, Census Tract 1537.04, Sonoma County, California",8,5,3
1000000US060971537042022,060971537042022,"Block 2022, Block Group 2, Census Tract 1537.04, Sonoma County, California",27,24,3
1000000US060971537042023,060971537042023,"Block 2023, Block Group 2, Census Tract 1537.04, Sonoma County, California",0,0,0
1000000US060971537042024,060971537042024,"Block 2024, Block Group 2, Census Tract 1537.04, Sonoma County, California",2,2,0
1000000US060971537042025,060971537042025,"Block 2025, Block Group 2, Census Tract 1537.04, Sonoma County, California",0,0,0
1000000US060971537042026,060971537042026,"Block 2026, Block Group 2, Census Tract 1537.04, Sonoma County, California",0,0,0
1000000US060971537042027,060971537042027,"Block 2027, Block Group 2, Census Tract 1537.04, Sonoma County, California",4,2,2
1000000US060971537042028,060971537042028,"Block 2028, Block Group 2, Census Tract 1537.04, Sonoma County, California",0,0,0
1000000US060971537043000,060971537043000,"Block 3000, Block Group 3, Census Tract 1537.04, Sonoma County, California",306,179,127
1000000US060971537043001,060971537043001,"Block 3001, Block Group 3, Census Tract 1537.04, Sonoma County, California",6,4,2
1000000US060971537043002,060971537043002,"Block 3002, Block Group 3, Census Tract 1537.04, Sonoma County, California",16,13,3
1000000US060971537043003,060971537043003,"Block 3003, Block Group 3, Census Tract 1537.04, Sonoma County, California",13,7,6
1000000US060971537043004,060971537043004,"Block 3004, Block Group 3, Census Tract 1537.04, Sonoma County, California",11,5,6
1000000US060971537043005,060971537043005,"Block 3005, Block Group 3, Census Tract 1537.04, Sonoma County, California",7,6,1
1000000US060971537043006,060971537043006,"Block 3006, Block Group 3, Census Tract 1537.04, Sonoma County, California",19,15,4
1000000US060971537043007,060971537043007,"Block 3007, Block Group 3, Census Tract 1537.04, Sonoma County, California",0,0,0
1000000US060971537043008,060971537043008,"Block 3008, Block Group 3, Census Tract 1537.04, Sonoma County, California",20,15,5
1000000US060971537043009,060971537043009,"Block 3009, Block Group 3, Census Tract 1537.04, Sonoma County, California",27,24,3
1000000US060971537043010,060971537043010,"Block 3010, Block Group 3, Census Tract 1537.04, Sonoma County, California",4,1,3
1000000US060971537043011,060971537043011,"Block 3011, Block Group 3, Census Tract 1537.04, Sonoma County, California",21,17,4
1000000US060971537043012,060971537043012,"Block 3012, Block Group 3, Census Tract 1537.04, Sonoma County, California",26,18,8
1000000US060971537043013,060971537043013,"Block 3013, Block Group 3, Census Tract 1537.04, Sonoma County, California",3,2,1
1000000US060971537043014,060971537043014,"Block 3014, Block Group 3, Census Tract 1537.04, Sonoma County, California",0,0,0
1000000US060971537043015,060971537043015,"Block 3015, Block Group 3, Census Tract 1537.04, Sonoma County, California",27,23,4
1000000US060971537043016,060971537043016,"Block 3016, Block Group 3, Census Tract 1537.04, Sonoma County, California",0,0,0
1000000US060971537043017,060971537043017,"Block 3017, Block Group 3, Census Tract 1537.04, Sonoma County, California",3,1,2
1000000US060971537043018,060971537043018,"Block 3018, Block Group 3, Census Tract 1537.04, Sonoma County, California",24,20,4
1000000US060971537043019,060971537043019,"Block 3019, Block Group 3, Census Tract 1537.04, Sonoma County, California",3,2,1
1000000US060971537044000,060971537044000,"Block 4000, Block Group 4, Census Tract 1537.04, Sonoma County, California",85,71,14
1000000US060971537044001,060971537044001,"Block 4001, Block Group 4, Census Tract 1537.04, Sonoma County, California",0,0,0
1000000US060971537044002,060971537044002,"Block 4002, Block Group 4, Census Tract 1537.04, Sonoma County, California",2,1,1
1000000US060971537044003,060971537044003,"Block 4003, Block Group 4, Census Tract 1537.04, Sonoma County, California",0,0,0
1000000US060971537044004,060971537044004,"Block 4004, Block Group 4, Census Tract 1537.04, Sonoma County, California",0,0,0
1000000US060971537044005,060971537044005,"Block 4005, Block Group 4, Census Tract 1537.04, Sonoma County, California",168,101,67
1000000US060971537044006,060971537044006,"Block 4006, Block Group 4, Census Tract 1537.04, Sonoma County, California",11,7,4
1000000US060971537044007,060971537044007,"Block 4007, Block Group 4, Census Tract 1537.04, Sonoma County, California",16,14,2
1000000US060971537044008,060971537044008,"Block 4008, Block Group 4, Census Tract 1537.04, Sonoma County, California",6,5,1
1000000US060971537044009,060971537044009,"Block 4009, Block Group 4, Census Tract 1537.04, Sonoma County, California",7,5,2
1000000US060971537044010,060971537044010,"Block 4010, Block Group 4, Census Tract 1537.04, Sonoma County, California",31,22,9
1000000US060971537044011,060971537044011,"Block 4011, Block Group 4, Census Tract 1537.04, Sonoma County, California",0,0,0
1000000US060971537044012,060971537044012,"Block 4012, Block Group 4, Census Tract 1537.04, Sonoma County, California",194,129,65
1000000US060971537044013,060971537044013,"Block 4013, Block Group 4, Census Tract 1537.04, Sonoma County, California",1,1,0
1000000US060971537044014,060971537044014,"Block 4014, Block Group 4, Census Tract 1537.04, Sonoma County, California",6,4,2
1000000US060971537044015,060971537044015,"Block 4015, Block Group 4, Census Tract 1537.04, Sonoma County, California",42,29,13
1000000US060971537044016,060971537044016,"Block 4016, Block Group 4, Census Tract 1537.04, Sonoma County, California",1,0,1
1000000US060971537044017,060971537044017,"Block 4017, Block Group 4, Census Tract 1537.04, Sonoma County, California",278,212,66
1000000US060971537044018,060971537044018,"Block 4018, Block Group 4, Census Tract 1537.04, Sonoma County, California",2,2,0
1000000US060971537044019,060971537044019,"Block 4019, Block Group 4, Census Tract 1537.04, Sonoma County, California",18,14,4
1000000US060971537044020,060971537044020,"Block 4020, Block Group 4, Census Tract 1537.04, Sonoma County, California",2,2,0
1000000US060971537044021,060971537044021,"Block 4021, Block Group 4, Census Tract 1537.04, Sonoma County, California",0,0,0
1000000US060971537044022,060971537044022,"Block 4022, Block Group 4, Census Tract 1537.04, Sonoma County, California",5,2,3
1000000US060971537044023,060971537044023,"Block 4023, Block Group 4, Census Tract 1537.04, Sonoma County, California",9,5,4
1000000US060971537044024,060971537044024,"Block 4024, Block Group 4, Census Tract 1537.04, Sonoma County, California",17,12,5
1000000US060971537044025,060971537044025,"Block 4025, Block Group 4, Census Tract 1537.04, Sonoma County, California",0,0,0
1000000US060971537044026,060971537044026,"Block 4026, Block Group 4, Census Tract 1537.04, Sonoma County, California",92,53,39
1000000US060971537044027,060971537044027,"Block 4027, Block Group 4, Census Tract 1537.04, Sonoma County, California",0,0,0
1000000US060971537044028,060971537044028,"Block 4028, Block Group 4, Census Tract 1537.04, Sonoma County, California",0,0,0
1000000US060971537044029,060971537044029,"Block 4029, Block Group 4, Census Tract 1537.04, Sonoma County, California",0,0,0
1000000US060971537044030,060971537044030,"Block 4030, Block Group 4, Census Tract 1537.04, Sonoma County, California",1,1,0
1000000US060971537044031,060971537044031,"Block 4031, Block Group 4, Census Tract 1537.04, Sonoma County, California",44,31,13
1000000US060971537044032,060971537044032,"Block 4032, Block Group 4, Census Tract 1537.04, Sonoma County, California",13,11,2
1000000US060971537044033,060971537044033,"Block 4033, Block Group 4, Census Tract 1537.04, Sonoma County, California",24,12,12
1000000US060971537044034,060971537044034,"Block 4034, Block Group 4, Census Tract 1537.04, Sonoma County, California",16,12,4
1000000US060971537044035,060971537044035,"Block 4035, Block Group 4, Census Tract 1537.04, Sonoma County, California",33,18,15
1000000US060971537044036,060971537044036,"Block 4036, Block Group 4, Census Tract 1537.04, Sonoma County, California",15,12,3
1000000US060971537044037,060971537044037,"Block 4037, Block Group 4, Census Tract 1537.04, Sonoma County, California",17,12,5
1000000US060971537044038,060971537044038,"Block 4038, Block Group 4, Census Tract 1537.04, Sonoma County, California",7,6,1
1000000US060971537044039,060971537044039,"Block 4039, Block Group 4, Census Tract 1537.04, Sonoma County, California",1,0,1
1000000US060971537051000,060971537051000,"Block 1000, Block Group 1, Census Tract 1537.05, Sonoma County, California",27,16,11
1000000US060971537051001,060971537051001,"Block 1001, Block Group 1, Census Tract 1537.05, Sonoma County, California",0,0,0
1000000US060971537051002,060971537051002,"Block 1002, Block Group 1, Census Tract 1537.05, Sonoma County, California",0,0,0
1000000US060971537051003,060971537051003,"Block 1003, Block Group 1, Census Tract 1537.05, Sonoma County, California",0,0,0
1000000US060971537051004,060971537051004,"Block 1004, Block Group 1, Census Tract 1537.05, Sonoma County, California",0,0,0
1000000US060971537051005,060971537051005,"Block 1005, Block Group 1, Census Tract 1537.05, Sonoma County, California",0,0,0
1000000US060971537051006,060971537051006,"Block 1006, Block Group 1, Census Tract 1537.05, Sonoma County, California",29,23,6
1000000US060971537051007,060971537051007,"Block 1007, Block Group 1, Census Tract 1537.05, Sonoma County, California",1,1,0
1000000US060971537051008,060971537051008,"Block 1008, Block Group 1, Census Tract 1537.05, Sonoma County, California",0,0,0
1000000US060971537051009,060971537051009,"Block 1009, Block Group 1, Census Tract 1537.05, Sonoma County, California",0,0,0
1000000US060971537051010,060971537051010,"Block 1010, Block Group 1, Census Tract 1537.05, Sonoma County, California",2,2,0
1000000US060971537051011,060971537051011,"Block 1011, Block Group 1, Census Tract 1537.05, Sonoma County, California",0,0,0
1000000US060971537051012,060971537051012,"Block 1012, Block Group 1, Census Tract 1537.05, Sonoma County, California",0,0,0
1000000US060971537051013,060971537051013,"Block 1013, Block Group 1, Census Tract 1537.05, Sonoma County, California",1,1,0
1000000US060971537051014,060971537051014,"Block 1014, Block Group 1, Census Tract 1537.05, Sonoma County, California",0,0,0
1000000US060971537051015,060971537051015,"Block 1015, Block Group 1, Census Tract 1537.05, Sonoma County, California",7,6,1
1000000US060971537051016,060971537051016,"Block 1016, Block Group 1, Census Tract 1537.05, Sonoma County, California",3,0,3
1000000US060971537051017,060971537051017,"Block 1017, Block Group 1, Census Tract 1537.05, Sonoma County, California",0,0,0
1000000US060971537051018,060971537051018,"Block 1018, Block Group 1, Census Tract 1537.05, Sonoma County, California",0,0,0
1000000US060971537051019,060971537051019,"Block 1019, Block Group 1, Census Tract 1537.05, Sonoma County, California",0,0,0
1000000US060971537051020,060971537051020,"Block 1020, Block Group 1, Census Tract 1537.05, Sonoma County, California",0,0,0
1000000US060971537051021,060971537051021,"Block 1021, Block Group 1, Census Tract 1537.05, Sonoma County, California",2,2,0
1000000US060971537051022,060971537051022,"Block 1022, Block Group 1, Census Tract 1537.05, Sonoma County, California",0,0,0
1000000US060971537051023,060971537051023,"Block 1023, Block Group 1, Census Tract 1537.05, Sonoma County, California",0,0,0
1000000US060971537051024,060971537051024,"Block 1024, Block Group 1, Census Tract 1537.05, Sonoma County, California",1,1,0
1000000US060971537051025,060971537051025,"Block 1025, Block Group 1, Census Tract 1537.05, Sonoma County, California",89,67,22
1000000US060971537051026,060971537051026,"Block 1026, Block Group 1, Census Tract 1537.05, Sonoma County, California",15,11,4
1000000US060971537051027,060971537051027,"Block 1027, Block Group 1, Census Tract 1537.05, Sonoma County, California",11,6,5
1000000US060971537051028,060971537051028,"Block 1028, Block Group 1, Census Tract 1537.05, Sonoma County, California",22,17,5
1000000US060971537051029,060971537051029,"Block 1029, Block Group 1, Census Tract 1537.05, Sonoma County, California",1,0,1
1000000US060971537051030,060971537051030,"Block 1030, Block Group 1, Census Tract 1537.05, Sonoma County, California",0,0,0
1000000US060971537051031,060971537051031,"Block 1031, Block Group 1, Census Tract 1537.05, Sonoma County, California",2,1,1
1000000US060971537051032,060971537051032,"Block 1032, Block Group 1, Census Tract 1537.05, Sonoma County, California",0,0,0
1000000US060971537051033,060971537051033,"Block 1033, Block Group 1, Census Tract 1537.05, Sonoma County, California",22,22,0
1000000US060971537051034,060971537051034,"Block 1034, Block Group 1, Census Tract 1537.05, Sonoma County, California",13,13,0
1000000US060971537051035,060971537051035,"Block 1035, Block Group 1, Census Tract 1537.05, Sonoma County, California",14,10,4
1000000US060971537051036,060971537051036,"Block 1036, Block Group 1, Census Tract 1537.05, Sonoma County, California",17,17,0
1000000US060971537051037,060971537051037,"Block 1037, Block Group 1, Census Tract 1537.05, Sonoma County, California",5,1,4
1000000US060971537051038,060971537051038,"Block 1038, Block Group 1, Census Tract 1537.05, Sonoma County, California",0,0,0
1000000US060971537051039,060971537051039,"Block 1039, Block Group 1, Census Tract 1537.05, Sonoma County, California",37,20,17
1000000US060971537051040,060971537051040,"Block 1040, Block Group 1, Census Tract 1537.05, Sonoma County, California",1,1,0
1000000US060971537051041,060971537051041,"Block 1041, Block Group 1, Census Tract 1537.05, Sonoma County, California",36,29,7
1000000US060971537051042,060971537051042,"Block 1042, Block Group 1, Census Tract 1537.05, Sonoma County, California",2,1,1
1000000US060971537051043,060971537051043,"Block 1043, Block Group 1, Census Tract 1537.05, Sonoma County, California",0,0,0
1000000US060971537051044,060971537051044,"Block 1044, Block Group 1, Census Tract 1537.05, Sonoma County, California",0,0,0
1000000US060971537051045,060971537051045,"Block 1045, Block Group 1, Census Tract 1537.05, Sonoma County, California",0,0,0
1000000US060971537051046,060971537051046,"Block 1046, Block Group 1, Census Tract 1537.05, Sonoma County, California",0,0,0
1000000US060971537051047,060971537051047,"Block 1047, Block Group 1, Census Tract 1537.05, Sonoma County, California",0,0,0
1000000US060971537051048,060971537051048,"Block 1048, Block Group 1, Census Tract 1537.05, Sonoma County, California",0,0,0
1000000US060971537051049,060971537051049,"Block 1049, Block Group 1, Census Tract 1537.05, Sonoma County, California",6,6,0
1000000US060971537051050,060971537051050,"Block 1050, Block Group 1, Census Tract 1537.05, Sonoma County, California",0,0,0
1000000US060971537052000,060971537052000,"Block 2000, Block Group 2, Census Tract 1537.05, Sonoma County, California",108,96,12
1000000US060971537052001,060971537052001,"Block 2001, Block Group 2, Census Tract 1537.05, Sonoma County, California",83,74,9
1000000US060971537052002,060971537052002,"Block 2002, Block Group 2, Census Tract 1537.05, Sonoma County, California",149,140,9
1000000US060971537052003,060971537052003,"Block 2003, Block Group 2, Census Tract 1537.05, Sonoma County, California",4,3,1
1000000US060971537052004,060971537052004,"Block 2004, Block Group 2, Census Tract 1537.05, Sonoma County, California",7,6,1
1000000US060971537052005,060971537052005,"Block 2005, Block Group 2, Census Tract 1537.05, Sonoma County, California",26,24,2
1000000US060971537052006,060971537052006,"Block 2006, Block Group 2, Census Tract 1537.05, Sonoma County, California",0,0,0
1000000US060971537052007,060971537052007,"Block 2007, Block Group 2, Census Tract 1537.05, Sonoma County, California",4,3,1
1000000US060971537052008,060971537052008,"Block 2008, Block Group 2, Census Tract 1537.05, Sonoma County, California",6,5,1
1000000US060971537053000,060971537053000,"Block 3000, Block Group 3, Census Tract 1537.05, Sonoma County, California",0,0,0
1000000US060971537053001,060971537053001,"Block 3001, Block Group 3, Census Tract 1537.05, Sonoma County, California",33,27,6
1000000US060971537053002,060971537053002,"Block 3002, Block Group 3, Census Tract 1537.05, Sonoma County, California",351,302,49
1000000US060971537053003,060971537053003,"Block 3003, Block Group 3, Census Tract 1537.05, Sonoma County, California",4,4,0
1000000US060971537053004,060971537053004,"Block 3004, Block Group 3, Census Tract 1537.05, Sonoma County, California",6,6,0
1000000US060971537053005,060971537053005,"Block 3005, Block Group 3, Census Tract 1537.05, Sonoma County, California",0,0,0
1000000US060971537053006,060971537053006,"Block 3006, Block Group 3, Census Tract 1537.05, Sonoma County, California",0,0,0
1000000US060971537053007,060971537053007,"Block 3007, Block Group 3, Census Tract 1537.05, Sonoma County, California",1,1,0
1000000US060971537053008,060971537053008,"Block 3008, Block Group 3, Census Tract 1537.05, Sonoma County, California",64,61,3
1000000US060971537053009,060971537053009,"Block 3009, Block Group 3, Census Tract 1537.05, Sonoma County, California",0,0,0
1000000US060971537053010,060971537053010,"Block 3010, Block Group 3, Census Tract 1537.05, Sonoma County, California",0,0,0
1000000US060971537053011,060971537053011,"Block 3011, Block Group 3, Census Tract 1537.05, Sonoma County, California",17,16,1
1000000US060971537053012,060971537053012,"Block 3012, Block Group 3, Census Tract 1537.05, Sonoma County, California",0,0,0
1000000US060971537053013,060971537053013,"Block 3013, Block Group 3, Census Tract 1537.05, Sonoma County, California",29,26,3
1000000US060971537053014,060971537053014,"Block 3014, Block Group 3, Census Tract 1537.05, Sonoma County, California",28,26,2
1000000US060971537053015,060971537053015,"Block 3015, Block Group 3, Census Tract 1537.05, Sonoma County, California",14,12,2
1000000US060971537053016,060971537053016,"Block 3016, Block Group 3, Census Tract 1537.05, Sonoma County, California",7,5,2
1000000US060971537053017,060971537053017,"Block 3017, Block Group 3, Census Tract 1537.05, Sonoma County, California",3,3,0
1000000US060971537053018,060971537053018,"Block 3018, Block Group 3, Census Tract 1537.05, Sonoma County, California",1,0,1
1000000US060971537054000,060971537054000,"Block 4000, Block Group 4, Census Tract 1537.05, Sonoma County, California",4,4,0
1000000US060971537054001,060971537054001,"Block 4001, Block Group 4, Census Tract 1537.05, Sonoma County, California",1,0,1
1000000US060971537054002,060971537054002,"Block 4002, Block Group 4, Census Tract 1537.05, Sonoma County, California",1,1,0
1000000US060971537054003,060971537054003,"Block 4003, Block Group 4, Census Tract 1537.05, Sonoma County, California",0,0,0
1000000US060971537054004,060971537054004,"Block 4004, Block Group 4, Census Tract 1537.05, Sonoma County, California",19,15,4
1000000US060971537054005,060971537054005,"Block 4005, Block Group 4, Census Tract 1537.05, Sonoma County, California",0,0,0
1000000US060971537054006,060971537054006,"Block 4006, Block Group 4, Census Tract 1537.05, Sonoma County, California",14,10,4
1000000US060971537054007,060971537054007,"Block 4007, Block Group 4, Census Tract 1537.05, Sonoma County, California",0,0,0
1000000US060971537054008,060971537054008,"Block 4008, Block Group 4, Census Tract 1537.05, Sonoma County, California",6,6,0
1000000US060971537054009,060971537054009,"Block 4009, Block Group 4, Census Tract 1537.05, Sonoma County, California",12,9,3
1000000US060971537054010,060971537054010,"Block 4010, Block Group 4, Census Tract 1537.05, Sonoma County, California",164,152,12
1000000US060971537054011,060971537054011,"Block 4011, Block Group 4, Census Tract 1537.05, Sonoma County, California",29,27,2
1000000US060971537054012,060971537054012,"Block 4012, Block Group 4, Census Tract 1537.05, Sonoma County, California",42,35,7
1000000US060971537054013,060971537054013,"Block 4013, Block Group 4, Census Tract 1537.05, Sonoma County, California",17,12,5
1000000US060971537054014,060971537054014,"Block 4014, Block Group 4, Census Tract 1537.05, Sonoma County, California",34,27,7
1000000US060971537054015,060971537054015,"Block 4015, Block Group 4, Census Tract 1537.05, Sonoma County, California",52,48,4
1000000US060971537054016,060971537054016,"Block 4016, Block Group 4, Census Tract 1537.05, Sonoma County, California",14,14,0
1000000US060971537054017,060971537054017,"Block 4017, Block Group 4, Census Tract 1537.05, Sonoma County, California",10,8,2
1000000US060971537054018,060971537054018,"Block 4018, Block Group 4, Census Tract 1537.05, Sonoma County, California",33,26,7
1000000US060971537054019,060971537054019,"Block 4019, Block Group 4, Census Tract 1537.05, Sonoma County, California",0,0,0
1000000US060971537054020,060971537054020,"Block 4020, Block Group 4, Census Tract 1537.05, Sonoma County, California",0,0,0
1000000US060971537054021,060971537054021,"Block 4021, Block Group 4, Census Tract 1537.05, Sonoma County, California",51,46,5
1000000US060971537054022,060971537054022,"Block 4022, Block Group 4, Census Tract 1537.05, Sonoma County, California",9,7,2
1000000US060971537054023,060971537054023,"Block 4023, Block Group 4, Census Tract 1537.05, Sonoma County, California",7,7,0
1000000US060971537054024,060971537054024,"Block 4024, Block Group 4, Census Tract 1537.05, Sonoma County, California",0,0,0
1000000US060971537061000,060971537061000,"Block 1000, Block Group 1, Census Tract 1537.06, Sonoma County, California",9,8,1
1000000US060971537061001,060971537061001,"Block 1001, Block Group 1, Census Tract 1537.06, Sonoma County, California",0,0,0
1000000US060971537061002,060971537061002,"Block 1002, Block Group 1, Census Tract 1537.06, Sonoma County, California",18,17,1
1000000US060971537061003,060971537061003,"Block 1003, Block Group 1, Census Tract 1537.06, Sonoma County, California",15,12,3
1000000US060971537061004,060971537061004,"Block 1004, Block Group 1, Census Tract 1537.06, Sonoma County, California",0,0,0
1000000US060971537061005,060971537061005,"Block 1005, Block Group 1, Census Tract 1537.06, Sonoma County, California",38,36,2
1000000US060971537061006,060971537061006,"Block 1006, Block Group 1, Census Tract 1537.06, Sonoma County, California",22,21,1
1000000US060971537061007,060971537061007,"Block 1007, Block Group 1, Census Tract 1537.06, Sonoma County, California",4,3,1
1000000US060971537061008,060971537061008,"Block 1008, Block Group 1, Census Tract 1537.06, Sonoma County, California",30,28,2
1000000US060971537061009,060971537061009,"Block 1009, Block Group 1, Census Tract 1537.06, Sonoma County, California",4,4,0
1000000US060971537061010,060971537061010,"Block 1010, Block Group 1, Census Tract 1537.06, Sonoma County, California",0,0,0
1000000US060971537061011,060971537061011,"Block 1011, Block Group 1, Census Tract 1537.06, Sonoma County, California",35,31,4
1000000US060971537061012,060971537061012,"Block 1012, Block Group 1, Census Tract 1537.06, Sonoma County, California",5,5,0
1000000US060971537061013,060971537061013,"Block 1013, Block Group 1, Census Tract 1537.06, Sonoma County, California",0,0,0
1000000US060971537061014,060971537061014,"Block 1014, Block Group 1, Census Tract 1537.06, Sonoma County, California",4,3,1
1000000US060971537061015,060971537061015,"Block 1015, Block Group 1, Census Tract 1537.06, Sonoma County, California",0,0,0
1000000US060971537061016,060971537061016,"Block 1016, Block Group 1, Census Tract 1537.06, Sonoma County, California",3,2,1
1000000US060971537061017,060971537061017,"Block 1017, Block Group 1, Census Tract 1537.06, Sonoma County, California",0,0,0
1000000US060971537061018,060971537061018,"Block 1018, Block Group 1, Census Tract 1537.06, Sonoma County, California",6,6,0
1000000US060971537061019,060971537061019,"Block 1019, Block Group 1, Census Tract 1537.06, Sonoma County, California",57,52,5
1000000US060971537061020,060971537061020,"Block 1020, Block Group 1, Census Tract 1537.06, Sonoma County, California",83,81,2
1000000US060971537061021,060971537061021,"Block 1021, Block Group 1, Census Tract 1537.06, Sonoma County, California",0,0,0
1000000US060971537061022,060971537061022,"Block 1022, Block Group 1, Census Tract 1537.06, Sonoma County, California",4,4,0
1000000US060971537061023,060971537061023,"Block 1023, Block Group 1, Census Tract 1537.06, Sonoma County, California",4,3,1
1000000US060971537061024,060971537061024,"Block 1024, Block Group 1, Census Tract 1537.06, Sonoma County, California",3,3,0
1000000US060971537061025,060971537061025,"Block 1025, Block Group 1, Census Tract 1537.06, Sonoma County, California",3,1,2
1000000US060971537062000,060971537062000,"Block 2000, Block Group 2, Census Tract 1537.06, Sonoma County, California",78,70,8
1000000US060971537062001,060971537062001,"Block 2001, Block Group 2, Census Tract 1537.06, Sonoma County, California",0,0,0
1000000US060971537062002,060971537062002,"Block 2002, Block Group 2, Census Tract 1537.06, Sonoma County, California",2,2,0
1000000US060971537062003,060971537062003,"Block 2003, Block Group 2, Census Tract 1537.06, Sonoma County, California",123,108,15
1000000US060971537062004,060971537062004,"Block 2004, Block Group 2, Census Tract 1537.06, Sonoma County, California",54,50,4
1000000US060971537062005,060971537062005,"Block 2005, Block Group 2, Census Tract 1537.06, Sonoma County, California",0,0,0
1000000US060971537062006,060971537062006,"Block 2006, Block Group 2, Census Tract 1537.06, Sonoma County, California",26,26,0
1000000US060971537062007,060971537062007,"Block 2007, Block Group 2, Census Tract 1537.06, Sonoma County, California",1,1,0
1000000US060971537062008,060971537062008,"Block 2008, Block Group 2, Census Tract 1537.06, Sonoma County, California",79,69,10
1000000US060971537062009,060971537062009,"Block 2009, Block Group 2, Census Tract 1537.06, Sonoma County, California",95,86,9
1000000US060971537062010,060971537062010,"Block 2010, Block Group 2, Census Tract 1537.06, Sonoma County, California",2,2,0
1000000US060971537062011,060971537062011,"Block 2011, Block Group 2, Census Tract 1537.06, Sonoma County, California",4,4,0
1000000US060971537062012,060971537062012,"Block 2012, Block Group 2, Census Tract 1537.06, Sonoma County, California",7,5,2
1000000US060971537062013,060971537062013,"Block 2013, Block Group 2, Census Tract 1537.06, Sonoma County, California",0,0,0
1000000US060971537062014,060971537062014,"Block 2014, Block Group 2, Census Tract 1537.06, Sonoma County, California",102,93,9
1000000US060971537063000,060971537063000,"Block 3000, Block Group 3, Census Tract 1537.06, Sonoma County, California",37,17,20
1000000US060971537063001,060971537063001,"Block 3001, Block Group 3, Census Tract 1537.06, Sonoma County, California",18,13,5
1000000US060971537063002,060971537063002,"Block 3002, Block Group 3, Census Tract 1537.06, Sonoma County, California",19,16,3
1000000US060971537063003,060971537063003,"Block 3003, Block Group 3, Census Tract 1537.06, Sonoma County, California",20,13,7
1000000US060971537063004,060971537063004,"Block 3004, Block Group 3, Census Tract 1537.06, Sonoma County, California",23,15,8
1000000US060971537063005,060971537063005,"Block 3005, Block Group 3, Census Tract 1537.06, Sonoma County, California",0,0,0
1000000US060971537063006,060971537063006,"Block 3006, Block Group 3, Census Tract 1537.06, Sonoma County, California",12,10,2
1000000US060971537063007,060971537063007,"Block 3007, Block Group 3, Census Tract 1537.06, Sonoma County, California",33,22,11
1000000US060971537063008,060971537063008,"Block 3008, Block Group 3, Census Tract 1537.06, Sonoma County, California",3,2,1
1000000US060971537063009,060971537063009,"Block 3009, Block Group 3, Census Tract 1537.06, Sonoma County, California",21,18,3
1000000US060971537063010,060971537063010,"Block 3010, Block Group 3, Census Tract 1537.06, Sonoma County, California",11,7,4
1000000US060971537063011,060971537063011,"Block 3011, Block Group 3, Census Tract 1537.06, Sonoma County, California",18,14,4
1000000US060971537063012,060971537063012,"Block 3012, Block Group 3, Census Tract 1537.06, Sonoma County, California",65,54,11
1000000US060971537063013,060971537063013,"Block 3013, Block Group 3, Census Tract 1537.06, Sonoma County, California",6,5,1
1000000US060971537063014,060971537063014,"Block 3014, Block Group 3, Census Tract 1537.06, Sonoma County, California",36,26,10
1000000US060971537063015,060971537063015,"Block 3015, Block Group 3, Census Tract 1537.06, Sonoma County, California",4,3,1
1000000US060971537063016,060971537063016,"Block 3016, Block Group 3, Census Tract 1537.06, Sonoma County, California",339,203,136
1000000US060971537063017,060971537063017,"Block 3017, Block Group 3, Census Tract 1537.06, Sonoma County, California",0,0,0
1000000US060971537063018,060971537063018,"Block 3018, Block Group 3, Census Tract 1537.06, Sonoma County, California",0,0,0
1000000US060971537063019,060971537063019,"Block 3019, Block Group 3, Census Tract 1537.06, Sonoma County, California",0,0,0
1000000US060971537063020,060971537063020,"Block 3020, Block Group 3, Census Tract 1537.06, Sonoma County, California",13,8,5
1000000US060971537063021,060971537063021,"Block 3021, Block Group 3, Census Tract 1537.06, Sonoma County, California",4,3,1
1000000US060971537063022,060971537063022,"Block 3022, Block Group 3, Census Tract 1537.06, Sonoma County, California",5,4,1
1000000US060971537063023,060971537063023,"Block 3023, Block Group 3, Census Tract 1537.06, Sonoma County, California",0,0,0
1000000US060971537063024,060971537063024,"Block 3024, Block Group 3, Census Tract 1537.06, Sonoma County, California",0,0,0
1000000US060971537063025,060971537063025,"Block 3025, Block Group 3, Census Tract 1537.06, Sonoma County, California",17,2,15
1000000US060971537063026,060971537063026,"Block 3026, Block Group 3, Census Tract 1537.06, Sonoma County, California",0,0,0
1000000US060971537063027,060971537063027,"Block 3027, Block Group 3, Census Tract 1537.06, Sonoma County, California",4,3,1
1000000US060971537063028,060971537063028,"Block 3028, Block Group 3, Census Tract 1537.06, Sonoma County, California",5,3,2
1000000US060971537063029,060971537063029,"Block 3029, Block Group 3, Census Tract 1537.06, Sonoma County, California",16,3,13
1000000US060971537063030,060971537063030,"Block 3030, Block Group 3, Census Tract 1537.06, Sonoma County, California",14,13,1
1000000US060971537063031,060971537063031,"Block 3031, Block Group 3, Census Tract 1537.06, Sonoma County, California",17,3,14
1000000US060971537063032,060971537063032,"Block 3032, Block Group 3, Census Tract 1537.06, Sonoma County, California",122,45,77
1000000US060971537063033,060971537063033,"Block 3033, Block Group 3, Census Tract 1537.06, Sonoma County, California",33,10,23
1000000US060971537063034,060971537063034,"Block 3034, Block Group 3, Census Tract 1537.06, Sonoma County, California",7,2,5
1000000US060971537063035,060971537063035,"Block 3035, Block Group 3, Census Tract 1537.06, Sonoma County, California",1,1,0
1000000US060971537063036,060971537063036,"Block 3036, Block Group 3, Census Tract 1537.06, Sonoma County, California",19,12,7
1000000US060971537063037,060971537063037,"Block 3037, Block Group 3, Census Tract 1537.06, Sonoma County, California",0,0,0
1000000US060971537063038,060971537063038,"Block 3038, Block Group 3, Census Tract 1537.06, Sonoma County, California",12,8,4
1000000US060971537063039,060971537063039,"Block 3039, Block Group 3, Census Tract 1537.06, Sonoma County, California",15,4,11
1000000US060971537063040,060971537063040,"Block 3040, Block Group 3, Census Tract 1537.06, Sonoma County, California",29,9,20
1000000US060971537063041,060971537063041,"Block 3041, Block Group 3, Census Tract 1537.06, Sonoma County, California",1,1,0
1000000US060971537063042,060971537063042,"Block 3042, Block Group 3, Census Tract 1537.06, Sonoma County, California",58,33,25
1000000US060971537063043,060971537063043,"Block 3043, Block Group 3, Census Tract 1537.06, Sonoma County, California",4,2,2
1000000US060971537063044,060971537063044,"Block 3044, Block Group 3, Census Tract 1537.06, Sonoma County, California",0,0,0
1000000US060971537063045,060971537063045,"Block 3045, Block Group 3, Census Tract 1537.06, Sonoma County, California",0,0,0
1000000US060971537063046,060971537063046,"Block 3046, Block Group 3, Census Tract 1537.06, Sonoma County, California",0,0,0
1000000US060971537064000,060971537064000,"Block 4000, Block Group 4, Census Tract 1537.06, Sonoma County, California",16,15,1
1000000US060971537064001,060971537064001,"Block 4001, Block Group 4, Census Tract 1537.06, Sonoma County, California",8,6,2
1000000US060971537064002,060971537064002,"Block 4002, Block Group 4, Census Tract 1537.06, Sonoma County, California",88,81,7
1000000US060971537064003,060971537064003,"Block 4003, Block Group 4, Census Tract 1537.06, Sonoma County, California",10,10,0
1000000US060971537064004,060971537064004,"Block 4004, Block Group 4, Census Tract 1537.06, Sonoma County, California",12,12,0
1000000US060971537064005,060971537064005,"Block 4005, Block Group 4, Census Tract 1537.06, Sonoma County, California",2,1,1
1000000US060971537064006,060971537064006,"Block 4006, Block Group 4, Census Tract 1537.06, Sonoma County, California",95,77,18
1000000US060971537064007,060971537064007,"Block 4007, Block Group 4, Census Tract 1537.06, Sonoma County, California",0,0,0
1000000US060971537064008,060971537064008,"Block 4008, Block Group 4, Census Tract 1537.06, Sonoma County, California",7,7,0
1000000US060971537064009,060971537064009,"Block 4009, Block Group 4, Census Tract 1537.06, Sonoma County, California",4,4,0
1000000US060971537064010,060971537064010,"Block 4010, Block Group 4, Census Tract 1537.06, Sonoma County, California",1,1,0
1000000US060971537064011,060971537064011,"Block 4011, Block Group 4, Census Tract 1537.06, Sonoma County, California",19,19,0
1000000US060971537064012,060971537064012,"Block 4012, Block Group 4, Census Tract 1537.06, Sonoma County, California",0,0,0
1000000US060971537064013,060971537064013,"Block 4013, Block Group 4, Census Tract 1537.06, Sonoma County, California",25,23,2
1000000US060971537064014,060971537064014,"Block 4014, Block Group 4, Census Tract 1537.06, Sonoma County, California",0,0,0
1000000US060971537064015,060971537064015,"Block 4015, Block Group 4, Census Tract 1537.06, Sonoma County, California",11,11,0
1000000US060971537064016,060971537064016,"Block 4016, Block Group 4, Census Tract 1537.06, Sonoma County, California",31,29,2
1000000US060971537064017,060971537064017,"Block 4017, Block Group 4, Census Tract 1537.06, Sonoma County, California",3,3,0
1000000US060971537064018,060971537064018,"Block 4018, Block Group 4, Census Tract 1537.06, Sonoma County, California",1,1,0
1000000US060971537064019,060971537064019,"Block 4019, Block Group 4, Census Tract 1537.06, Sonoma County, California",58,55,3
1000000US060971537064020,060971537064020,"Block 4020, Block Group 4, Census Tract 1537.06, Sonoma County, California",0,0,0
1000000US060971538011000,060971538011000,"Block 1000, Block Group 1, Census Tract 1538.01, Sonoma County, California",22,19,3
1000000US060971538011001,060971538011001,"Block 1001, Block Group 1, Census Tract 1538.01, Sonoma County, California",0,0,0
1000000US060971538011002,060971538011002,"Block 1002, Block Group 1, Census Tract 1538.01, Sonoma County, California",6,6,0
1000000US060971538011003,060971538011003,"Block 1003, Block Group 1, Census Tract 1538.01, Sonoma County, California",0,0,0
1000000US060971538011004,060971538011004,"Block 1004, Block Group 1, Census Tract 1538.01, Sonoma County, California",0,0,0
1000000US060971538011005,060971538011005,"Block 1005, Block Group 1, Census Tract 1538.01, Sonoma County, California",0,0,0
1000000US060971538011006,060971538011006,"Block 1006, Block Group 1, Census Tract 1538.01, Sonoma County, California",0,0,0
1000000US060971538011007,060971538011007,"Block 1007, Block Group 1, Census Tract 1538.01, Sonoma County, California",0,0,0
1000000US060971538011008,060971538011008,"Block 1008, Block Group 1, Census Tract 1538.01, Sonoma County, California",2,2,0
1000000US060971538011009,060971538011009,"Block 1009, Block Group 1, Census Tract 1538.01, Sonoma County, California",103,95,8
1000000US060971538011010,060971538011010,"Block 1010, Block Group 1, Census Tract 1538.01, Sonoma County, California",4,4,0
1000000US060971538011011,060971538011011,"Block 1011, Block Group 1, Census Tract 1538.01, Sonoma County, California",2,2,0
1000000US060971538011012,060971538011012,"Block 1012, Block Group 1, Census Tract 1538.01, Sonoma County, California",83,66,17
1000000US060971538011013,060971538011013,"Block 1013, Block Group 1, Census Tract 1538.01, Sonoma County, California",0,0,0
1000000US060971538011014,060971538011014,"Block 1014, Block Group 1, Census Tract 1538.01, Sonoma County, California",0,0,0
1000000US060971538011015,060971538011015,"Block 1015, Block Group 1, Census Tract 1538.01, Sonoma County, California",1,1,0
1000000US060971538011016,060971538011016,"Block 1016, Block Group 1, Census Tract 1538.01, Sonoma County, California",39,35,4
1000000US060971538011017,060971538011017,"Block 1017, Block Group 1, Census Tract 1538.01, Sonoma County, California",1,1,0
1000000US060971538011018,060971538011018,"Block 1018, Block Group 1, Census Tract 1538.01, Sonoma County, California",3,1,2
1000000US060971538011019,060971538011019,"Block 1019, Block Group 1, Census Tract 1538.01, Sonoma County, California",4,4,0
1000000US060971538011020,060971538011020,"Block 1020, Block Group 1, Census Tract 1538.01, Sonoma County, California",24,22,2
1000000US060971538011021,060971538011021,"Block 1021, Block Group 1, Census Tract 1538.01, Sonoma County, California",3,1,2
1000000US060971538011022,060971538011022,"Block 1022, Block Group 1, Census Tract 1538.01, Sonoma County, California",0,0,0
1000000US060971538011023,060971538011023,"Block 1023, Block Group 1, Census Tract 1538.01, Sonoma County, California",0,0,0
1000000US060971538011024,060971538011024,"Block 1024, Block Group 1, Census Tract 1538.01, Sonoma County, California",0,0,0
1000000US060971538011025,060971538011025,"Block 1025, Block Group 1, Census Tract 1538.01, Sonoma County, California",13,12,1
1000000US060971538011026,060971538011026,"Block 1026, Block Group 1, Census Tract 1538.01, Sonoma County, California",15,11,4
1000000US060971538011027,060971538011027,"Block 1027, Block Group 1, Census Tract 1538.01, Sonoma County, California",0,0,0
1000000US060971538011028,060971538011028,"Block 1028, Block Group 1, Census Tract 1538.01, Sonoma County, California",0,0,0
1000000US060971538011029,060971538011029,"Block 1029, Block Group 1, Census Tract 1538.01, Sonoma County, California",0,0,0
1000000US060971538011030,060971538011030,"Block 1030, Block Group 1, Census Tract 1538.01, Sonoma County, California",0,0,0
1000000US060971538011031,060971538011031,"Block 1031, Block Group 1, Census Tract 1538.01, Sonoma County, California",1,1,0
1000000US060971538011032,060971538011032,"Block 1032, Block Group 1, Census Tract 1538.01, Sonoma County, California",2,2,0
1000000US060971538011033,060971538011033,"Block 1033, Block Group 1, Census Tract 1538.01, Sonoma County, California",2,2,0
1000000US060971538011034,060971538011034,"Block 1034, Block Group 1, Census Tract 1538.01, Sonoma County, California",0,0,0
1000000US060971538011035,060971538011035,"Block 1035, Block Group 1, Census Tract 1538.01, Sonoma County, California",0,0,0
1000000US060971538011036,060971538011036,"Block 1036, Block Group 1, Census Tract 1538.01, Sonoma County, California",0,0,0
1000000US060971538011037,060971538011037,"Block 1037, Block Group 1, Census Tract 1538.01, Sonoma County, California",1,1,0
1000000US060971538011038,060971538011038,"Block 1038, Block Group 1, Census Tract 1538.01, Sonoma County, California",0,0,0
1000000US060971538011039,060971538011039,"Block 1039, Block Group 1, Census Tract 1538.01, Sonoma County, California",0,0,0
1000000US060971538011040,060971538011040,"Block 1040, Block Group 1, Census Tract 1538.01, Sonoma County, California",10,6,4
1000000US060971538011041,060971538011041,"Block 1041, Block Group 1, Census Tract 1538.01, Sonoma County, California",1,1,0
1000000US060971538011042,060971538011042,"Block 1042, Block Group 1, Census Tract 1538.01, Sonoma County, California",0,0,0
1000000US060971538011043,060971538011043,"Block 1043, Block Group 1, Census Tract 1538.01, Sonoma County, California",14,13,1
1000000US060971538011044,060971538011044,"Block 1044, Block Group 1, Census Tract 1538.01, Sonoma County, California",46,45,1
1000000US060971538011045,060971538011045,"Block 1045, Block Group 1, Census Tract 1538.01, Sonoma County, California",0,0,0
1000000US060971538011046,060971538011046,"Block 1046, Block Group 1, Census Tract 1538.01, Sonoma County, California",0,0,0
1000000US060971538011047,060971538011047,"Block 1047, Block Group 1, Census Tract 1538.01, Sonoma County, California",0,0,0
1000000US060971538012000,060971538012000,"Block 2000, Block Group 2, Census Tract 1538.01, Sonoma County, California",15,14,1
1000000US060971538012001,060971538012001,"Block 2001, Block Group 2, Census Tract 1538.01, Sonoma County, California",24,24,0
1000000US060971538012002,060971538012002,"Block 2002, Block Group 2, Census Tract 1538.01, Sonoma County, California",28,27,1
1000000US060971538012003,060971538012003,"Block 2003, Block Group 2, Census Tract 1538.01, Sonoma County, California",6,6,0
1000000US060971538012004,060971538012004,"Block 2004, Block Group 2, Census Tract 1538.01, Sonoma County, California",34,34,0
1000000US060971538012005,060971538012005,"Block 2005, Block Group 2, Census Tract 1538.01, Sonoma County, California",224,211,13
1000000US060971538012006,060971538012006,"Block 2006, Block Group 2, Census Tract 1538.01, Sonoma County, California",35,34,1
1000000US060971538012007,060971538012007,"Block 2007, Block Group 2, Census Tract 1538.01, Sonoma County, California",15,15,0
1000000US060971538012008,060971538012008,"Block 2008, Block Group 2, Census Tract 1538.01, Sonoma County, California",15,15,0
1000000US060971538012009,060971538012009,"Block 2009, Block Group 2, Census Tract 1538.01, Sonoma County, California",7,7,0
1000000US060971538012010,060971538012010,"Block 2010, Block Group 2, Census Tract 1538.01, Sonoma County, California",17,17,0
1000000US060971538012011,060971538012011,"Block 2011, Block Group 2, Census Tract 1538.01, Sonoma County, California",16,16,0
1000000US060971538012012,060971538012012,"Block 2012, Block Group 2, Census Tract 1538.01, Sonoma County, California",12,12,0
1000000US060971538012013,060971538012013,"Block 2013, Block Group 2, Census Tract 1538.01, Sonoma County, California",2,2,0
1000000US060971538012014,060971538012014,"Block 2014, Block Group 2, Census Tract 1538.01, Sonoma County, California",16,16,0
1000000US060971538012015,060971538012015,"Block 2015, Block Group 2, Census Tract 1538.01, Sonoma County, California",39,38,1
1000000US060971538012016,060971538012016,"Block 2016, Block Group 2, Census Tract 1538.01, Sonoma County, California",41,41,0
1000000US060971538012017,060971538012017,"Block 2017, Block Group 2, Census Tract 1538.01, Sonoma County, California",29,27,2
1000000US060971538012018,060971538012018,"Block 2018, Block Group 2, Census Tract 1538.01, Sonoma County, California",11,11,0
1000000US060971538012019,060971538012019,"Block 2019, Block Group 2, Census Tract 1538.01, Sonoma County, California",12,12,0
1000000US060971538012020,060971538012020,"Block 2020, Block Group 2, Census Tract 1538.01, Sonoma County, California",26,26,0
1000000US060971538012021,060971538012021,"Block 2021, Block Group 2, Census Tract 1538.01, Sonoma County, California",34,34,0
1000000US060971538012022,060971538012022,"Block 2022, Block Group 2, Census Tract 1538.01, Sonoma County, California",30,28,2
1000000US060971538012023,060971538012023,"Block 2023, Block Group 2, Census Tract 1538.01, Sonoma County, California",30,29,1
1000000US060971538012024,060971538012024,"Block 2024, Block Group 2, Census Tract 1538.01, Sonoma County, California",27,22,5
1000000US060971538012025,060971538012025,"Block 2025, Block Group 2, Census Tract 1538.01, Sonoma County, California",20,20,0
1000000US060971538012026,060971538012026,"Block 2026, Block Group 2, Census Tract 1538.01, Sonoma County, California",0,0,0
1000000US060971538012027,060971538012027,"Block 2027, Block Group 2, Census Tract 1538.01, Sonoma County, California",15,14,1
1000000US060971538012028,060971538012028,"Block 2028, Block Group 2, Census Tract 1538.01, Sonoma County, California",15,15,0
1000000US060971538012029,060971538012029,"Block 2029, Block Group 2, Census Tract 1538.01, Sonoma County, California",8,8,0
1000000US060971538012030,060971538012030,"Block 2030, Block Group 2, Census Tract 1538.01, Sonoma County, California",7,7,0
1000000US060971538012031,060971538012031,"Block 2031, Block Group 2, Census Tract 1538.01, Sonoma County, California",26,26,0
1000000US060971538012032,060971538012032,"Block 2032, Block Group 2, Census Tract 1538.01, Sonoma County, California",53,52,1
1000000US060971538012033,060971538012033,"Block 2033, Block Group 2, Census Tract 1538.01, Sonoma County, California",27,26,1
1000000US060971538012034,060971538012034,"Block 2034, Block Group 2, Census Tract 1538.01, Sonoma County, California",15,14,1
1000000US060971538012035,060971538012035,"Block 2035, Block Group 2, Census Tract 1538.01, Sonoma County, California",16,16,0
1000000US060971538012036,060971538012036,"Block 2036, Block Group 2, Census Tract 1538.01, Sonoma County, California",0,0,0
1000000US060971538012037,060971538012037,"Block 2037, Block Group 2, Census Tract 1538.01, Sonoma County, California",19,19,0
1000000US060971538012038,060971538012038,"Block 2038, Block Group 2, Census Tract 1538.01, Sonoma County, California",34,33,1
1000000US060971538012039,060971538012039,"Block 2039, Block Group 2, Census Tract 1538.01, Sonoma County, California",17,16,1
1000000US060971538012040,060971538012040,"Block 2040, Block Group 2, Census Tract 1538.01, Sonoma County, California",15,14,1
1000000US060971538012041,060971538012041,"Block 2041, Block Group 2, Census Tract 1538.01, Sonoma County, California",19,19,0
1000000US060971538012042,060971538012042,"Block 2042, Block Group 2, Census Tract 1538.01, Sonoma County, California",16,15,1
1000000US060971538012043,060971538012043,"Block 2043, Block Group 2, Census Tract 1538.01, Sonoma County, California",9,9,0
1000000US060971538012044,060971538012044,"Block 2044, Block Group 2, Census Tract 1538.01, Sonoma County, California",33,33,0
1000000US060971538012045,060971538012045,"Block 2045, Block Group 2, Census Tract 1538.01, Sonoma County, California",17,16,1
1000000US060971538012046,060971538012046,"Block 2046, Block Group 2, Census Tract 1538.01, Sonoma County, California",12,11,1
1000000US060971538012047,060971538012047,"Block 2047, Block Group 2, Census Tract 1538.01, Sonoma County, California",26,22,4
1000000US060971538012048,060971538012048,"Block 2048, Block Group 2, Census Tract 1538.01, Sonoma County, California",14,14,0
1000000US060971538012049,060971538012049,"Block 2049, Block Group 2, Census Tract 1538.01, Sonoma County, California",17,14,3
1000000US060971538012050,060971538012050,"Block 2050, Block Group 2, Census Tract 1538.01, Sonoma County, California",22,22,0
1000000US060971538012051,060971538012051,"Block 2051, Block Group 2, Census Tract 1538.01, Sonoma County, California",22,21,1
1000000US060971538012052,060971538012052,"Block 2052, Block Group 2, Census Tract 1538.01, Sonoma County, California",21,19,2
1000000US060971538012053,060971538012053,"Block 2053, Block Group 2, Census Tract 1538.01, Sonoma County, California",25,23,2
1000000US060971538012054,060971538012054,"Block 2054, Block Group 2, Census Tract 1538.01, Sonoma County, California",22,21,1
1000000US060971538012055,060971538012055,"Block 2055, Block Group 2, Census Tract 1538.01, Sonoma County, California",11,11,0
1000000US060971538012056,060971538012056,"Block 2056, Block Group 2, Census Tract 1538.01, Sonoma County, California",22,21,1
1000000US060971538012057,060971538012057,"Block 2057, Block Group 2, Census Tract 1538.01, Sonoma County, California",21,21,0
1000000US060971538012058,060971538012058,"Block 2058, Block Group 2, Census Tract 1538.01, Sonoma County, California",22,21,1
1000000US060971538012059,060971538012059,"Block 2059, Block Group 2, Census Tract 1538.01, Sonoma County, California",18,16,2
1000000US060971538012060,060971538012060,"Block 2060, Block Group 2, Census Tract 1538.01, Sonoma County, California",20,20,0
1000000US060971538012061,060971538012061,"Block 2061, Block Group 2, Census Tract 1538.01, Sonoma County, California",20,19,1
1000000US060971538012062,060971538012062,"Block 2062, Block Group 2, Census Tract 1538.01, Sonoma County, California",20,20,0
1000000US060971538012063,060971538012063,"Block 2063, Block Group 2, Census Tract 1538.01, Sonoma County, California",19,18,1
1000000US060971538012064,060971538012064,"Block 2064, Block Group 2, Census Tract 1538.01, Sonoma County, California",17,17,0
1000000US060971538012065,060971538012065,"Block 2065, Block Group 2, Census Tract 1538.01, Sonoma County, California",25,24,1
1000000US060971538012066,060971538012066,"Block 2066, Block Group 2, Census Tract 1538.01, Sonoma County, California",1,1,0
1000000US060971538012067,060971538012067,"Block 2067, Block Group 2, Census Tract 1538.01, Sonoma County, California",3,3,0
1000000US060971538012068,060971538012068,"Block 2068, Block Group 2, Census Tract 1538.01, Sonoma County, California",5,2,3
1000000US060971538012069,060971538012069,"Block 2069, Block Group 2, Census Tract 1538.01, Sonoma County, California",24,22,2
1000000US060971538012070,060971538012070,"Block 2070, Block Group 2, Census Tract 1538.01, Sonoma County, California",2,2,0
1000000US060971538012071,060971538012071,"Block 2071, Block Group 2, Census Tract 1538.01, Sonoma County, California",124,108,16
1000000US060971538012072,060971538012072,"Block 2072, Block Group 2, Census Tract 1538.01, Sonoma County, California",1,1,0
1000000US060971538012073,060971538012073,"Block 2073, Block Group 2, Census Tract 1538.01, Sonoma County, California",233,0,233
1000000US060971538012074,060971538012074,"Block 2074, Block Group 2, Census Tract 1538.01, Sonoma County, California",0,0,0
1000000US060971538012075,060971538012075,"Block 2075, Block Group 2, Census Tract 1538.01, Sonoma County, California",13,13,0
1000000US060971538012076,060971538012076,"Block 2076, Block Group 2, Census Tract 1538.01, Sonoma County, California",10,10,0
1000000US060971538012077,060971538012077,"Block 2077, Block Group 2, Census Tract 1538.01, Sonoma County, California",8,8,0
1000000US060971538012078,060971538012078,"Block 2078, Block Group 2, Census Tract 1538.01, Sonoma County, California",20,17,3
1000000US060971538012079,060971538012079,"Block 2079, Block Group 2, Census Tract 1538.01, Sonoma County, California",0,0,0
1000000US060971538012080,060971538012080,"Block 2080, Block Group 2, Census Tract 1538.01, Sonoma County, California",18,18,0
1000000US060971538012081,060971538012081,"Block 2081, Block Group 2, Census Tract 1538.01, Sonoma County, California",0,0,0
1000000US060971538013000,060971538013000,"Block 3000, Block Group 3, Census Tract 1538.01, Sonoma County, California",169,164,5
1000000US060971538013001,060971538013001,"Block 3001, Block Group 3, Census Tract 1538.01, Sonoma County, California",33,29,4
1000000US060971538013002,060971538013002,"Block 3002, Block Group 3, Census Tract 1538.01, Sonoma County, California",54,51,3
1000000US060971538013003,060971538013003,"Block 3003, Block Group 3, Census Tract 1538.01, Sonoma County, California",11,11,0
1000000US060971538013004,060971538013004,"Block 3004, Block Group 3, Census Tract 1538.01, Sonoma County, California",18,18,0
1000000US060971538013005,060971538013005,"Block 3005, Block Group 3, Census Tract 1538.01, Sonoma County, California",28,28,0
1000000US060971538014000,060971538014000,"Block 4000, Block Group 4, Census Tract 1538.01, Sonoma County, California",81,71,10
1000000US060971538014001,060971538014001,"Block 4001, Block Group 4, Census Tract 1538.01, Sonoma County, California",8,8,0
1000000US060971538014002,060971538014002,"Block 4002, Block Group 4, Census Tract 1538.01, Sonoma County, California",13,13,0
1000000US060971538014003,060971538014003,"Block 4003, Block Group 4, Census Tract 1538.01, Sonoma County, California",23,22,1
1000000US060971538014004,060971538014004,"Block 4004, Block Group 4, Census Tract 1538.01, Sonoma County, California",133,125,8
1000000US060971538014005,060971538014005,"Block 4005, Block Group 4, Census Tract 1538.01, Sonoma County, California",28,26,2
1000000US060971538014006,060971538014006,"Block 4006, Block Group 4, Census Tract 1538.01, Sonoma County, California",21,21,0
1000000US060971538014007,060971538014007,"Block 4007, Block Group 4, Census Tract 1538.01, Sonoma County, California",8,8,0
1000000US060971538014008,060971538014008,"Block 4008, Block Group 4, Census Tract 1538.01, Sonoma County, California",74,71,3
1000000US060971538014009,060971538014009,"Block 4009, Block Group 4, Census Tract 1538.01, Sonoma County, California",37,36,1
1000000US060971538014010,060971538014010,"Block 4010, Block Group 4, Census Tract 1538.01, Sonoma County, California",3,1,2
1000000US060971538014011,060971538014011,"Block 4011, Block Group 4, Census Tract 1538.01, Sonoma County, California",42,42,0
1000000US060971538014012,060971538014012,"Block 4012, Block Group 4, Census Tract 1538.01, Sonoma County, California",90,88,2
1000000US060971538014013,060971538014013,"Block 4013, Block Group 4, Census Tract 1538.01, Sonoma County, California",28,26,2
1000000US060971538014014,060971538014014,"Block 4014, Block Group 4, Census Tract 1538.01, Sonoma County, California",36,34,2
1000000US060971538014015,060971538014015,"Block 4015, Block Group 4, Census Tract 1538.01, Sonoma County, California",10,10,0
1000000US060971538014016,060971538014016,"Block 4016, Block Group 4, Census Tract 1538.01, Sonoma County, California",26,25,1
1000000US060971538041000,060971538041000,"Block 1000, Block Group 1, Census Tract 1538.04, Sonoma County, California",60,57,3
1000000US060971538041001,060971538041001,"Block 1001, Block Group 1, Census Tract 1538.04, Sonoma County, California",19,17,2
1000000US060971538041002,060971538041002,"Block 1002, Block Group 1, Census Tract 1538.04, Sonoma County, California",53,47,6
1000000US060971538041003,060971538041003,"Block 1003, Block Group 1, Census Tract 1538.04, Sonoma County, California",53,52,1
1000000US060971538041004,060971538041004,"Block 1004, Block Group 1, Census Tract 1538.04, Sonoma County, California",30,30,0
1000000US060971538041005,060971538041005,"Block 1005, Block Group 1, Census Tract 1538.04, Sonoma County, California",57,55,2
1000000US060971538041006,060971538041006,"Block 1006, Block Group 1, Census Tract 1538.04, Sonoma County, California",74,73,1
1000000US060971538041007,060971538041007,"Block 1007, Block Group 1, Census Tract 1538.04, Sonoma County, California",26,26,0
1000000US060971538041008,060971538041008,"Block 1008, Block Group 1, Census Tract 1538.04, Sonoma County, California",11,11,0
1000000US060971538041009,060971538041009,"Block 1009, Block Group 1, Census Tract 1538.04, Sonoma County, California",17,17,0
1000000US060971538041010,060971538041010,"Block 1010, Block Group 1, Census Tract 1538.04, Sonoma County, California",207,194,13
1000000US060971538041011,060971538041011,"Block 1011, Block Group 1, Census Tract 1538.04, Sonoma County, California",6,5,1
1000000US060971538041012,060971538041012,"Block 1012, Block Group 1, Census Tract 1538.04, Sonoma County, California",6,4,2
1000000US060971538041013,060971538041013,"Block 1013, Block Group 1, Census Tract 1538.04, Sonoma County, California",0,0,0
1000000US060971538041014,060971538041014,"Block 1014, Block Group 1, Census Tract 1538.04, Sonoma County, California",0,0,0
1000000US060971538042000,060971538042000,"Block 2000, Block Group 2, Census Tract 1538.04, Sonoma County, California",76,75,1
1000000US060971538042001,060971538042001,"Block 2001, Block Group 2, Census Tract 1538.04, Sonoma County, California",21,20,1
1000000US060971538042002,060971538042002,"Block 2002, Block Group 2, Census Tract 1538.04, Sonoma County, California",23,22,1
1000000US060971538042003,060971538042003,"Block 2003, Block Group 2, Census Tract 1538.04, Sonoma County, California",128,122,6
1000000US060971538042004,060971538042004,"Block 2004, Block Group 2, Census Tract 1538.04, Sonoma County, California",0,0,0
1000000US060971538042005,060971538042005,"Block 2005, Block Group 2, Census Tract 1538.04, Sonoma County, California",16,16,0
1000000US060971538042006,060971538042006,"Block 2006, Block Group 2, Census Tract 1538.04, Sonoma County, California",138,136,2
1000000US060971538042007,060971538042007,"Block 2007, Block Group 2, Census Tract 1538.04, Sonoma County, California",0,0,0
1000000US060971538042008,060971538042008,"Block 2008, Block Group 2, Census Tract 1538.04, Sonoma County, California",0,0,0
1000000US060971538042009,060971538042009,"Block 2009, Block Group 2, Census Tract 1538.04, Sonoma County, California",16,15,1
1000000US060971538042010,060971538042010,"Block 2010, Block Group 2, Census Tract 1538.04, Sonoma County, California",38,36,2
1000000US060971538042011,060971538042011,"Block 2011, Block Group 2, Census Tract 1538.04, Sonoma County, California",27,26,1
1000000US060971538042012,060971538042012,"Block 2012, Block Group 2, Census Tract 1538.04, Sonoma County, California",9,9,0
1000000US060971538042013,060971538042013,"Block 2013, Block Group 2, Census Tract 1538.04, Sonoma County, California",10,9,1
1000000US060971538042014,060971538042014,"Block 2014, Block Group 2, Census Tract 1538.04, Sonoma County, California",25,24,1
1000000US060971538042015,060971538042015,"Block 2015, Block Group 2, Census Tract 1538.04, Sonoma County, California",0,0,0
1000000US060971538061000,060971538061000,"Block 1000, Block Group 1, Census Tract 1538.06, Sonoma County, California",142,140,2
1000000US060971538061001,060971538061001,"Block 1001, Block Group 1, Census Tract 1538.06, Sonoma County, California",15,15,0
1000000US060971538061002,060971538061002,"Block 1002, Block Group 1, Census Tract 1538.06, Sonoma County, California",34,34,0
1000000US060971538061003,060971538061003,"Block 1003, Block Group 1, Census Tract 1538.06, Sonoma County, California",26,24,2
1000000US060971538061004,060971538061004,"Block 1004, Block Group 1, Census Tract 1538.06, Sonoma County, California",28,27,1
1000000US060971538061005,060971538061005,"Block 1005, Block Group 1, Census Tract 1538.06, Sonoma County, California",32,32,0
1000000US060971538061006,060971538061006,"Block 1006, Block Group 1, Census Tract 1538.06, Sonoma County, California",5,5,0
1000000US060971538061007,060971538061007,"Block 1007, Block Group 1, Census Tract 1538.06, Sonoma County, California",7,7,0
1000000US060971538062000,060971538062000,"Block 2000, Block Group 2, Census Tract 1538.06, Sonoma County, California",109,107,2
1000000US060971538062001,060971538062001,"Block 2001, Block Group 2, Census Tract 1538.06, Sonoma County, California",138,131,7
1000000US060971538062002,060971538062002,"Block 2002, Block Group 2, Census Tract 1538.06, Sonoma County, California",10,10,0
1000000US060971538062003,060971538062003,"Block 2003, Block Group 2, Census Tract 1538.06, Sonoma County, California",43,40,3
1000000US060971538062004,060971538062004,"Block 2004, Block Group 2, Census Tract 1538.06, Sonoma County, California",14,14,0
1000000US060971538062005,060971538062005,"Block 2005, Block Group 2, Census Tract 1538.06, Sonoma County, California",13,13,0
1000000US060971538062006,060971538062006,"Block 2006, Block Group 2, Census Tract 1538.06, Sonoma County, California",21,20,1
1000000US060971538062007,060971538062007,"Block 2007, Block Group 2, Census Tract 1538.06, Sonoma County, California",29,29,0
1000000US060971538062008,060971538062008,"Block 2008, Block Group 2, Census Tract 1538.06, Sonoma County, California",11,10,1
1000000US060971538062009,060971538062009,"Block 2009, Block Group 2, Census Tract 1538.06, Sonoma County, California",36,36,0
1000000US060971538063000,060971538063000,"Block 3000, Block Group 3, Census Tract 1538.06, Sonoma County, California",424,409,15
1000000US060971538063001,060971538063001,"Block 3001, Block Group 3, Census Tract 1538.06, Sonoma County, California",0,0,0
1000000US060971538063002,060971538063002,"Block 3002, Block Group 3, Census Tract 1538.06, Sonoma County, California",2,2,0
1000000US060971538063003,060971538063003,"Block 3003, Block Group 3, Census Tract 1538.06, Sonoma County, California",7,7,0
1000000US060971538063004,060971538063004,"Block 3004, Block Group 3, Census Tract 1538.06, Sonoma County, California",0,0,0
1000000US060971538063005,060971538063005,"Block 3005, Block Group 3, Census Tract 1538.06, Sonoma County, California",0,0,0
1000000US060971538063006,060971538063006,"Block 3006, Block Group 3, Census Tract 1538.06, Sonoma County, California",76,74,2
1000000US060971538063007,060971538063007,"Block 3007, Block Group 3, Census Tract 1538.06, Sonoma County, California",0,0,0
1000000US060971538063008,060971538063008,"Block 3008, Block Group 3, Census Tract 1538.06, Sonoma County, California",34,33,1
1000000US060971538063009,060971538063009,"Block 3009, Block Group 3, Census Tract 1538.06, Sonoma County, California",4,4,0
1000000US060971538063010,060971538063010,"Block 3010, Block Group 3, Census Tract 1538.06, Sonoma County, California",0,0,0
1000000US060971538071000,060971538071000,"Block 1000, Block Group 1, Census Tract 1538.07, Sonoma County, California",21,21,0
1000000US060971538071001,060971538071001,"Block 1001, Block Group 1, Census Tract 1538.07, Sonoma County, California",17,16,1
1000000US060971538071002,060971538071002,"Block 1002, Block Group 1, Census Tract 1538.07, Sonoma County, California",92,90,2
1000000US060971538071003,060971538071003,"Block 1003, Block Group 1, Census Tract 1538.07, Sonoma County, California",5,4,1
1000000US060971538071004,060971538071004,"Block 1004, Block Group 1, Census Tract 1538.07, Sonoma County, California",18,17,1
1000000US060971538071005,060971538071005,"Block 1005, Block Group 1, Census Tract 1538.07, Sonoma County, California",18,17,1
1000000US060971538071006,060971538071006,"Block 1006, Block Group 1, Census Tract 1538.07, Sonoma County, California",19,19,0
1000000US060971538071007,060971538071007,"Block 1007, Block Group 1, Census Tract 1538.07, Sonoma County, California",64,62,2
1000000US060971538071008,060971538071008,"Block 1008, Block Group 1, Census Tract 1538.07, Sonoma County, California",14,14,0
1000000US060971538071009,060971538071009,"Block 1009, Block Group 1, Census Tract 1538.07, Sonoma County, California",7,7,0
1000000US060971538071010,060971538071010,"Block 1010, Block Group 1, Census Tract 1538.07, Sonoma County, California",14,14,0
1000000US060971538071011,060971538071011,"Block 1011, Block Group 1, Census Tract 1538.07, Sonoma County, California",45,44,1
1000000US060971538071012,060971538071012,"Block 1012, Block Group 1, Census Tract 1538.07, Sonoma County, California",31,29,2
1000000US060971538072000,060971538072000,"Block 2000, Block Group 2, Census Tract 1538.07, Sonoma County, California",8,6,2
1000000US060971538072001,060971538072001,"Block 2001, Block Group 2, Census Tract 1538.07, Sonoma County, California",0,0,0
1000000US060971538072002,060971538072002,"Block 2002, Block Group 2, Census Tract 1538.07, Sonoma County, California",27,17,10
1000000US060971538072003,060971538072003,"Block 2003, Block Group 2, Census Tract 1538.07, Sonoma County, California",14,6,8
1000000US060971538072004,060971538072004,"Block 2004, Block Group 2, Census Tract 1538.07, Sonoma County, California",7,4,3
1000000US060971538072005,060971538072005,"Block 2005, Block Group 2, Census Tract 1538.07, Sonoma County, California",2,2,0
1000000US060971538072006,060971538072006,"Block 2006, Block Group 2, Census Tract 1538.07, Sonoma County, California",0,0,0
1000000US060971538072007,060971538072007,"Block 2007, Block Group 2, Census Tract 1538.07, Sonoma County, California",4,4,0
1000000US060971538072008,060971538072008,"Block 2008, Block Group 2, Census Tract 1538.07, Sonoma County, California",30,27,3
1000000US060971538072009,060971538072009,"Block 2009, Block Group 2, Census Tract 1538.07, Sonoma County, California",0,0,0
1000000US060971538072010,060971538072010,"Block 2010, Block Group 2, Census Tract 1538.07, Sonoma County, California",1,1,0
1000000US060971538072011,060971538072011,"Block 2011, Block Group 2, Census Tract 1538.07, Sonoma County, California",0,0,0
1000000US060971538072012,060971538072012,"Block 2012, Block Group 2, Census Tract 1538.07, Sonoma County, California",0,0,0
1000000US060971538072013,060971538072013,"Block 2013, Block Group 2, Census Tract 1538.07, Sonoma County, California",0,0,0
1000000US060971538072014,060971538072014,"Block 2014, Block Group 2, Census Tract 1538.07, Sonoma County, California",71,55,16
1000000US060971538072015,060971538072015,"Block 2015, Block Group 2, Census Tract 1538.07, Sonoma County, California",0,0,0
1000000US060971538072016,060971538072016,"Block 2016, Block Group 2, Census Tract 1538.07, Sonoma County, California",0,0,0
1000000US060971538072017,060971538072017,"Block 2017, Block Group 2, Census Tract 1538.07, Sonoma County, California",0,0,0
1000000US060971538072018,060971538072018,"Block 2018, Block Group 2, Census Tract 1538.07, Sonoma County, California",1,1,0
1000000US060971538072019,060971538072019,"Block 2019, Block Group 2, Census Tract 1538.07, Sonoma County, California",0,0,0
1000000US060971538072020,060971538072020,"Block 2020, Block Group 2, Census Tract 1538.07, Sonoma County, California",1,1,0
1000000US060971538072021,060971538072021,"Block 2021, Block Group 2, Census Tract 1538.07, Sonoma County, California",1,1,0
1000000US060971538072022,060971538072022,"Block 2022, Block Group 2, Census Tract 1538.07, Sonoma County, California",0,0,0
1000000US060971538072023,060971538072023,"Block 2023, Block Group 2, Census Tract 1538.07, Sonoma County, California",0,0,0
1000000US060971538072024,060971538072024,"Block 2024, Block Group 2, Census Tract 1538.07, Sonoma County, California",2,1,1
1000000US060971538072025,060971538072025,"Block 2025, Block Group 2, Census Tract 1538.07, Sonoma County, California",0,0,0
1000000US060971538072026,060971538072026,"Block 2026, Block Group 2, Census Tract 1538.07, Sonoma County, California",2,2,0
1000000US060971538072027,060971538072027,"Block 2027, Block Group 2, Census Tract 1538.07, Sonoma County, California",0,0,0
1000000US060971538072028,060971538072028,"Block 2028, Block Group 2, Census Tract 1538.07, Sonoma County, California",35,32,3
1000000US060971538072029,060971538072029,"Block 2029, Block Group 2, Census Tract 1538.07, Sonoma County, California",4,4,0
1000000US060971538072030,060971538072030,"Block 2030, Block Group 2, Census Tract 1538.07, Sonoma County, California",2,2,0
1000000US060971538072031,060971538072031,"Block 2031, Block Group 2, Census Tract 1538.07, Sonoma County, California",3,2,1
1000000US060971538072032,060971538072032,"Block 2032, Block Group 2, Census Tract 1538.07, Sonoma County, California",170,166,4
1000000US060971538072033,060971538072033,"Block 2033, Block Group 2, Census Tract 1538.07, Sonoma County, California",10,10,0
1000000US060971538072034,060971538072034,"Block 2034, Block Group 2, Census Tract 1538.07, Sonoma County, California",22,22,0
1000000US060971538072035,060971538072035,"Block 2035, Block Group 2, Census Tract 1538.07, Sonoma County, California",28,28,0
1000000US060971538072036,060971538072036,"Block 2036, Block Group 2, Census Tract 1538.07, Sonoma County, California",25,25,0
1000000US060971538072037,060971538072037,"Block 2037, Block Group 2, Census Tract 1538.07, Sonoma County, California",25,25,0
1000000US060971538072038,060971538072038,"Block 2038, Block Group 2, Census Tract 1538.07, Sonoma County, California",63,61,2
1000000US060971538072039,060971538072039,"Block 2039, Block Group 2, Census Tract 1538.07, Sonoma County, California",140,138,2
1000000US060971538072040,060971538072040,"Block 2040, Block Group 2, Census Tract 1538.07, Sonoma County, California",27,27,0
1000000US060971538072041,060971538072041,"Block 2041, Block Group 2, Census Tract 1538.07, Sonoma County, California",0,0,0
1000000US060971538072042,060971538072042,"Block 2042, Block Group 2, Census Tract 1538.07, Sonoma County, California",19,19,0
1000000US060971538072043,060971538072043,"Block 2043, Block Group 2, Census Tract 1538.07, Sonoma County, California",20,20,0
1000000US060971538072044,060971538072044,"Block 2044, Block Group 2, Census Tract 1538.07, Sonoma County, California",199,196,3
1000000US060971538072045,060971538072045,"Block 2045, Block Group 2, Census Tract 1538.07, Sonoma County, California",18,17,1
1000000US060971538072046,060971538072046,"Block 2046, Block Group 2, Census Tract 1538.07, Sonoma County, California",8,8,0
1000000US060971538072047,060971538072047,"Block 2047, Block Group 2, Census Tract 1538.07, Sonoma County, California",30,29,1
1000000US060971538072048,060971538072048,"Block 2048, Block Group 2, Census Tract 1538.07, Sonoma County, California",0,0,0
1000000US060971538072049,060971538072049,"Block 2049, Block Group 2, Census Tract 1538.07, Sonoma County, California",6,1,5
1000000US060971538072050,060971538072050,"Block 2050, Block Group 2, Census Tract 1538.07, Sonoma County, California",21,20,1
1000000US060971538072051,060971538072051,"Block 2051, Block Group 2, Census Tract 1538.07, Sonoma County, California",0,0,0
1000000US060971538072052,060971538072052,"Block 2052, Block Group 2, Census Tract 1538.07, Sonoma County, California",0,0,0
1000000US060971538072053,060971538072053,"Block 2053, Block Group 2, Census Tract 1538.07, Sonoma County, California",3,3,0
1000000US060971538072054,060971538072054,"Block 2054, Block Group 2, Census Tract 1538.07, Sonoma County, California",0,0,0
1000000US060971538081000,060971538081000,"Block 1000, Block Group 1, Census Tract 1538.08, Sonoma County, California",0,0,0
1000000US060971538081001,060971538081001,"Block 1001, Block Group 1, Census Tract 1538.08, Sonoma County, California",6,5,1
1000000US060971538081002,060971538081002,"Block 1002, Block Group 1, Census Tract 1538.08, Sonoma County, California",33,29,4
1000000US060971538081003,060971538081003,"Block 1003, Block Group 1, Census Tract 1538.08, Sonoma County, California",1,1,0
1000000US060971538081004,060971538081004,"Block 1004, Block Group 1, Census Tract 1538.08, Sonoma County, California",0,0,0
1000000US060971538081005,060971538081005,"Block 1005, Block Group 1, Census Tract 1538.08, Sonoma County, California",8,6,2
1000000US060971538081006,060971538081006,"Block 1006, Block Group 1, Census Tract 1538.08, Sonoma County, California",42,36,6
1000000US060971538081007,060971538081007,"Block 1007, Block Group 1, Census Tract 1538.08, Sonoma County, California",13,12,1
1000000US060971538081008,060971538081008,"Block 1008, Block Group 1, Census Tract 1538.08, Sonoma County, California",212,208,4
1000000US060971538081009,060971538081009,"Block 1009, Block Group 1, Census Tract 1538.08, Sonoma County, California",0,0,0
1000000US060971538081010,060971538081010,"Block 1010, Block Group 1, Census Tract 1538.08, Sonoma County, California",13,12,1
1000000US060971538081011,060971538081011,"Block 1011, Block Group 1, Census Tract 1538.08, Sonoma County, California",17,17,0
1000000US060971538081012,060971538081012,"Block 1012, Block Group 1, Census Tract 1538.08, Sonoma County, California",137,132,5
1000000US060971538081013,060971538081013,"Block 1013, Block Group 1, Census Tract 1538.08, Sonoma County, California",0,0,0
1000000US060971538081014,060971538081014,"Block 1014, Block Group 1, Census Tract 1538.08, Sonoma County, California",7,7,0
1000000US060971538081015,060971538081015,"Block 1015, Block Group 1, Census Tract 1538.08, Sonoma County, California",8,7,1
1000000US060971538081016,060971538081016,"Block 1016, Block Group 1, Census Tract 1538.08, Sonoma County, California",14,11,3
1000000US060971538081017,060971538081017,"Block 1017, Block Group 1, Census Tract 1538.08, Sonoma County, California",0,0,0
1000000US060971538081018,060971538081018,"Block 1018, Block Group 1, Census Tract 1538.08, Sonoma County, California",18,14,4
1000000US060971538081019,060971538081019,"Block 1019, Block Group 1, Census Tract 1538.08, Sonoma County, California",24,23,1
1000000US060971538081020,060971538081020,"Block 1020, Block Group 1, Census Tract 1538.08, Sonoma County, California",15,13,2
1000000US060971538081021,060971538081021,"Block 1021, Block Group 1, Census Tract 1538.08, Sonoma County, California",0,0,0
1000000US060971538081022,060971538081022,"Block 1022, Block Group 1, Census Tract 1538.08, Sonoma County, California",0,0,0
1000000US060971538081023,060971538081023,"Block 1023, Block Group 1, Census Tract 1538.08, Sonoma County, California",2,2,0
1000000US060971538081024,060971538081024,"Block 1024, Block Group 1, Census Tract 1538.08, Sonoma County, California",1,1,0
1000000US060971538081025,060971538081025,"Block 1025, Block Group 1, Census Tract 1538.08, Sonoma County, California",0,0,0
1000000US060971538081026,060971538081026,"Block 1026, Block Group 1, Census Tract 1538.08, Sonoma County, California",0,0,0
1000000US060971538081027,060971538081027,"Block 1027, Block Group 1, Census Tract 1538.08, Sonoma County, California",17,15,2
1000000US060971538081028,060971538081028,"Block 1028, Block Group 1, Census Tract 1538.08, Sonoma County, California",17,16,1
1000000US060971538081029,060971538081029,"Block 1029, Block Group 1, Census Tract 1538.08, Sonoma County, California",26,23,3
1000000US060971538081030,060971538081030,"Block 1030, Block Group 1, Census Tract 1538.08, Sonoma County, California",18,17,1
1000000US060971538081031,060971538081031,"Block 1031, Block Group 1, Census Tract 1538.08, Sonoma County, California",10,9,1
1000000US060971538081032,060971538081032,"Block 1032, Block Group 1, Census Tract 1538.08, Sonoma County, California",8,8,0
1000000US060971538081033,060971538081033,"Block 1033, Block Group 1, Census Tract 1538.08, Sonoma County, California",15,15,0
1000000US060971538081034,060971538081034,"Block 1034, Block Group 1, Census Tract 1538.08, Sonoma County, California",15,14,1
1000000US060971538081035,060971538081035,"Block 1035, Block Group 1, Census Tract 1538.08, Sonoma County, California",12,11,1
1000000US060971538082000,060971538082000,"Block 2000, Block Group 2, Census Tract 1538.08, Sonoma County, California",0,0,0
1000000US060971538082001,060971538082001,"Block 2001, Block Group 2, Census Tract 1538.08, Sonoma County, California",242,231,11
1000000US060971538082002,060971538082002,"Block 2002, Block Group 2, Census Tract 1538.08, Sonoma County, California",0,0,0
1000000US060971538082003,060971538082003,"Block 2003, Block Group 2, Census Tract 1538.08, Sonoma County, California",5,5,0
1000000US060971538082004,060971538082004,"Block 2004, Block Group 2, Census Tract 1538.08, Sonoma County, California",26,26,0
1000000US060971538082005,060971538082005,"Block 2005, Block Group 2, Census Tract 1538.08, Sonoma County, California",36,36,0
1000000US060971538082006,060971538082006,"Block 2006, Block Group 2, Census Tract 1538.08, Sonoma County, California",0,0,0
1000000US060971538083000,060971538083000,"Block 3000, Block Group 3, Census Tract 1538.08, Sonoma County, California",21,17,4
1000000US060971538083001,060971538083001,"Block 3001, Block Group 3, Census Tract 1538.08, Sonoma County, California",0,0,0
1000000US060971538083002,060971538083002,"Block 3002, Block Group 3, Census Tract 1538.08, Sonoma County, California",43,43,0
1000000US060971538083003,060971538083003,"Block 3003, Block Group 3, Census Tract 1538.08, Sonoma County, California",0,0,0
1000000US060971538083004,060971538083004,"Block 3004, Block Group 3, Census Tract 1538.08, Sonoma County, California",0,0,0
1000000US060971538083005,060971538083005,"Block 3005, Block Group 3, Census Tract 1538.08, Sonoma County, California",0,0,0
1000000US060971538083006,060971538083006,"Block 3006, Block Group 3, Census Tract 1538.08, Sonoma County, California",0,0,0
1000000US060971538083007,060971538083007,"Block 3007, Block Group 3, Census Tract 1538.08, Sonoma County, California",0,0,0
1000000US060971538083008,060971538083008,"Block 3008, Block Group 3, Census Tract 1538.08, Sonoma County, California",140,132,8
1000000US060971538083009,060971538083009,"Block 3009, Block Group 3, Census Tract 1538.08, Sonoma County, California",6,6,0
1000000US060971538083010,060971538083010,"Block 3010, Block Group 3, Census Tract 1538.08, Sonoma County, California",36,36,0
1000000US060971538083011,060971538083011,"Block 3011, Block Group 3, Census Tract 1538.08, Sonoma County, California",145,139,6
1000000US060971538083012,060971538083012,"Block 3012, Block Group 3, Census Tract 1538.08, Sonoma County, California",30,27,3
1000000US060971538083013,060971538083013,"Block 3013, Block Group 3, Census Tract 1538.08, Sonoma County, California",15,15,0
1000000US060971538083014,060971538083014,"Block 3014, Block Group 3, Census Tract 1538.08, Sonoma County, California",11,11,0
1000000US060971538083015,060971538083015,"Block 3015, Block Group 3, Census Tract 1538.08, Sonoma County, California",35,34,1
1000000US060971538083016,060971538083016,"Block 3016, Block Group 3, Census Tract 1538.08, Sonoma County, California",14,14,0
1000000US060971538083017,060971538083017,"Block 3017, Block Group 3, Census Tract 1538.08, Sonoma County, California",44,41,3
1000000US060971538083018,060971538083018,"Block 3018, Block Group 3, Census Tract 1538.08, Sonoma County, California",12,12,0
1000000US060971538083019,060971538083019,"Block 3019, Block Group 3, Census Tract 1538.08, Sonoma County, California",26,25,1
1000000US060971538083020,060971538083020,"Block 3020, Block Group 3, Census Tract 1538.08, Sonoma County, California",43,36,7
1000000US060971538083021,060971538083021,"Block 3021, Block Group 3, Census Tract 1538.08, Sonoma County, California",7,7,0
1000000US060971538083022,060971538083022,"Block 3022, Block Group 3, Census Tract 1538.08, Sonoma County, California",0,0,0
1000000US060971538091000,060971538091000,"Block 1000, Block Group 1, Census Tract 1538.09, Sonoma County, California",15,15,0
1000000US060971538091001,060971538091001,"Block 1001, Block Group 1, Census Tract 1538.09, Sonoma County, California",0,0,0
1000000US060971538091002,060971538091002,"Block 1002, Block Group 1, Census Tract 1538.09, Sonoma County, California",28,26,2
1000000US060971538091003,060971538091003,"Block 1003, Block Group 1, Census Tract 1538.09, Sonoma County, California",72,70,2
1000000US060971538091004,060971538091004,"Block 1004, Block Group 1, Census Tract 1538.09, Sonoma County, California",19,19,0
1000000US060971538091005,060971538091005,"Block 1005, Block Group 1, Census Tract 1538.09, Sonoma County, California",35,33,2
1000000US060971538091006,060971538091006,"Block 1006, Block Group 1, Census Tract 1538.09, Sonoma County, California",36,36,0
1000000US060971538091007,060971538091007,"Block 1007, Block Group 1, Census Tract 1538.09, Sonoma County, California",0,0,0
1000000US060971538091008,060971538091008,"Block 1008, Block Group 1, Census Tract 1538.09, Sonoma County, California",0,0,0
1000000US060971538091009,060971538091009,"Block 1009, Block Group 1, Census Tract 1538.09, Sonoma County, California",19,18,1
1000000US060971538091010,060971538091010,"Block 1010, Block Group 1, Census Tract 1538.09, Sonoma County, California",0,0,0
1000000US060971538091011,060971538091011,"Block 1011, Block Group 1, Census Tract 1538.09, Sonoma County, California",9,9,0
1000000US060971538091012,060971538091012,"Block 1012, Block Group 1, Census Tract 1538.09, Sonoma County, California",130,124,6
1000000US060971538091013,060971538091013,"Block 1013, Block Group 1, Census Tract 1538.09, Sonoma County, California",17,16,1
1000000US060971538091014,060971538091014,"Block 1014, Block Group 1, Census Tract 1538.09, Sonoma County, California",49,45,4
1000000US060971538091015,060971538091015,"Block 1015, Block Group 1, Census Tract 1538.09, Sonoma County, California",0,0,0
1000000US060971538091016,060971538091016,"Block 1016, Block Group 1, Census Tract 1538.09, Sonoma County, California",0,0,0
1000000US060971538091017,060971538091017,"Block 1017, Block Group 1, Census Tract 1538.09, Sonoma County, California",10,10,0
1000000US060971538091018,060971538091018,"Block 1018, Block Group 1, Census Tract 1538.09, Sonoma County, California",8,8,0
1000000US060971538091019,060971538091019,"Block 1019, Block Group 1, Census Tract 1538.09, Sonoma County, California",0,0,0
1000000US060971538091020,060971538091020,"Block 1020, Block Group 1, Census Tract 1538.09, Sonoma County, California",0,0,0
1000000US060971538091021,060971538091021,"Block 1021, Block Group 1, Census Tract 1538.09, Sonoma County, California",0,0,0
1000000US060971538091022,060971538091022,"Block 1022, Block Group 1, Census Tract 1538.09, Sonoma County, California",1,1,0
1000000US060971538091023,060971538091023,"Block 1023, Block Group 1, Census Tract 1538.09, Sonoma County, California",7,7,0
1000000US060971538091024,060971538091024,"Block 1024, Block Group 1, Census Tract 1538.09, Sonoma County, California",1,1,0
1000000US060971538091025,060971538091025,"Block 1025, Block Group 1, Census Tract 1538.09, Sonoma County, California",6,6,0
1000000US060971538091026,060971538091026,"Block 1026, Block Group 1, Census Tract 1538.09, Sonoma County, California",9,9,0
1000000US060971538091027,060971538091027,"Block 1027, Block Group 1, Census Tract 1538.09, Sonoma County, California",6,6,0
1000000US060971538091028,060971538091028,"Block 1028, Block Group 1, Census Tract 1538.09, Sonoma County, California",0,0,0
1000000US060971538091029,060971538091029,"Block 1029, Block Group 1, Census Tract 1538.09, Sonoma County, California",0,0,0
1000000US060971538091030,060971538091030,"Block 1030, Block Group 1, Census Tract 1538.09, Sonoma County, California",0,0,0
1000000US060971538091031,060971538091031,"Block 1031, Block Group 1, Census Tract 1538.09, Sonoma County, California",0,0,0
1000000US060971538091032,060971538091032,"Block 1032, Block Group 1, Census Tract 1538.09, Sonoma County, California",9,9,0
1000000US060971538091033,060971538091033,"Block 1033, Block Group 1, Census Tract 1538.09, Sonoma County, California",16,15,1
1000000US060971538091034,060971538091034,"Block 1034, Block Group 1, Census Tract 1538.09, Sonoma County, California",4,4,0
1000000US060971538092000,060971538092000,"Block 2000, Block Group 2, Census Tract 1538.09, Sonoma County, California",188,184,4
1000000US060971538092001,060971538092001,"Block 2001, Block Group 2, Census Tract 1538.09, Sonoma County, California",12,12,0
1000000US060971538092002,060971538092002,"Block 2002, Block Group 2, Census Tract 1538.09, Sonoma County, California",14,14,0
1000000US060971538092003,060971538092003,"Block 2003, Block Group 2, Census Tract 1538.09, Sonoma County, California",91,90,1
1000000US060971538092004,060971538092004,"Block 2004, Block Group 2, Census Tract 1538.09, Sonoma County, California",13,13,0
1000000US060971538092005,060971538092005,"Block 2005, Block Group 2, Census Tract 1538.09, Sonoma County, California",94,92,2
1000000US060971538092006,060971538092006,"Block 2006, Block Group 2, Census Tract 1538.09, Sonoma County, California",24,24,0
1000000US060971538092007,060971538092007,"Block 2007, Block Group 2, Census Tract 1538.09, Sonoma County, California",16,16,0
1000000US060971538092008,060971538092008,"Block 2008, Block Group 2, Census Tract 1538.09, Sonoma County, California",48,46,2
1000000US060971538092009,060971538092009,"Block 2009, Block Group 2, Census Tract 1538.09, Sonoma County, California",68,66,2
1000000US060971538092010,060971538092010,"Block 2010, Block Group 2, Census Tract 1538.09, Sonoma County, California",21,20,1
1000000US060971538092011,060971538092011,"Block 2011, Block Group 2, Census Tract 1538.09, Sonoma County, California",12,12,0
1000000US060971538092012,060971538092012,"Block 2012, Block Group 2, Census Tract 1538.09, Sonoma County, California",16,15,1
1000000US060971538093000,060971538093000,"Block 3000, Block Group 3, Census Tract 1538.09, Sonoma County, California",28,27,1
1000000US060971538093001,060971538093001,"Block 3001, Block Group 3, Census Tract 1538.09, Sonoma County, California",18,18,0
1000000US060971538093002,060971538093002,"Block 3002, Block Group 3, Census Tract 1538.09, Sonoma County, California",36,35,1
1000000US060971538093003,060971538093003,"Block 3003, Block Group 3, Census Tract 1538.09, Sonoma County, California",8,8,0
1000000US060971538093004,060971538093004,"Block 3004, Block Group 3, Census Tract 1538.09, Sonoma County, California",0,0,0
1000000US060971538093005,060971538093005,"Block 3005, Block Group 3, Census Tract 1538.09, Sonoma County, California",42,38,4
1000000US060971538093006,060971538093006,"Block 3006, Block Group 3, Census Tract 1538.09, Sonoma County, California",6,6,0
1000000US060971538093007,060971538093007,"Block 3007, Block Group 3, Census Tract 1538.09, Sonoma County, California",26,26,0
1000000US060971538093008,060971538093008,"Block 3008, Block Group 3, Census Tract 1538.09, Sonoma County, California",27,27,0
1000000US060971538093009,060971538093009,"Block 3009, Block Group 3, Census Tract 1538.09, Sonoma County, California",12,12,0
1000000US060971538093010,060971538093010,"Block 3010, Block Group 3, Census Tract 1538.09, Sonoma County, California",24,23,1
1000000US060971538093011,060971538093011,"Block 3011, Block Group 3, Census Tract 1538.09, Sonoma County, California",10,10,0
1000000US060971538093012,060971538093012,"Block 3012, Block Group 3, Census Tract 1538.09, Sonoma County, California",77,74,3
1000000US060971538093013,060971538093013,"Block 3013, Block Group 3, Census Tract 1538.09, Sonoma County, California",19,19,0
1000000US060971538093014,060971538093014,"Block 3014, Block Group 3, Census Tract 1538.09, Sonoma County, California",10,10,0
1000000US060971538093015,060971538093015,"Block 3015, Block Group 3, Census Tract 1538.09, Sonoma County, California",14,13,1
1000000US060971538093016,060971538093016,"Block 3016, Block Group 3, Census Tract 1538.09, Sonoma County, California",15,15,0
1000000US060971538093017,060971538093017,"Block 3017, Block Group 3, Census Tract 1538.09, Sonoma County, California",28,28,0
1000000US060971539011000,060971539011000,"Block 1000, Block Group 1, Census Tract 1539.01, Sonoma County, California",3,3,0
1000000US060971539011001,060971539011001,"Block 1001, Block Group 1, Census Tract 1539.01, Sonoma County, California",119,72,47
1000000US060971539011002,060971539011002,"Block 1002, Block Group 1, Census Tract 1539.01, Sonoma County, California",40,27,13
1000000US060971539011003,060971539011003,"Block 1003, Block Group 1, Census Tract 1539.01, Sonoma County, California",4,3,1
1000000US060971539011004,060971539011004,"Block 1004, Block Group 1, Census Tract 1539.01, Sonoma County, California",103,78,25
1000000US060971539011005,060971539011005,"Block 1005, Block Group 1, Census Tract 1539.01, Sonoma County, California",17,10,7
1000000US060971539011006,060971539011006,"Block 1006, Block Group 1, Census Tract 1539.01, Sonoma County, California",0,0,0
1000000US060971539011007,060971539011007,"Block 1007, Block Group 1, Census Tract 1539.01, Sonoma County, California",0,0,0
1000000US060971539011008,060971539011008,"Block 1008, Block Group 1, Census Tract 1539.01, Sonoma County, California",1,1,0
1000000US060971539011009,060971539011009,"Block 1009, Block Group 1, Census Tract 1539.01, Sonoma County, California",0,0,0
1000000US060971539011010,060971539011010,"Block 1010, Block Group 1, Census Tract 1539.01, Sonoma County, California",0,0,0
1000000US060971539011011,060971539011011,"Block 1011, Block Group 1, Census Tract 1539.01, Sonoma County, California",0,0,0
1000000US060971539011012,060971539011012,"Block 1012, Block Group 1, Census Tract 1539.01, Sonoma County, California",3,2,1
1000000US060971539011013,060971539011013,"Block 1013, Block Group 1, Census Tract 1539.01, Sonoma County, California",0,0,0
1000000US060971539011014,060971539011014,"Block 1014, Block Group 1, Census Tract 1539.01, Sonoma County, California",1,1,0
1000000US060971539011015,060971539011015,"Block 1015, Block Group 1, Census Tract 1539.01, Sonoma County, California",10,5,5
1000000US060971539011016,060971539011016,"Block 1016, Block Group 1, Census Tract 1539.01, Sonoma County, California",40,37,3
1000000US060971539011017,060971539011017,"Block 1017, Block Group 1, Census Tract 1539.01, Sonoma County, California",1,1,0
1000000US060971539011018,060971539011018,"Block 1018, Block Group 1, Census Tract 1539.01, Sonoma County, California",16,16,0
1000000US060971539011019,060971539011019,"Block 1019, Block Group 1, Census Tract 1539.01, Sonoma County, California",32,25,7
1000000US060971539011020,060971539011020,"Block 1020, Block Group 1, Census Tract 1539.01, Sonoma County, California",2,1,1
1000000US060971539011021,060971539011021,"Block 1021, Block Group 1, Census Tract 1539.01, Sonoma County, California",0,0,0
1000000US060971539011022,060971539011022,"Block 1022, Block Group 1, Census Tract 1539.01, Sonoma County, California",0,0,0
1000000US060971539011023,060971539011023,"Block 1023, Block Group 1, Census Tract 1539.01, Sonoma County, California",3,2,1
1000000US060971539011024,060971539011024,"Block 1024, Block Group 1, Census Tract 1539.01, Sonoma County, California",0,0,0
1000000US060971539011025,060971539011025,"Block 1025, Block Group 1, Census Tract 1539.01, Sonoma County, California",0,0,0
1000000US060971539011026,060971539011026,"Block 1026, Block Group 1, Census Tract 1539.01, Sonoma County, California",0,0,0
1000000US060971539011027,060971539011027,"Block 1027, Block Group 1, Census Tract 1539.01, Sonoma County, California",0,0,0
1000000US060971539011028,060971539011028,"Block 1028, Block Group 1, Census Tract 1539.01, Sonoma County, California",0,0,0
1000000US060971539011029,060971539011029,"Block 1029, Block Group 1, Census Tract 1539.01, Sonoma County, California",10,9,1
1000000US060971539011030,060971539011030,"Block 1030, Block Group 1, Census Tract 1539.01, Sonoma County, California",106,88,18
1000000US060971539011031,060971539011031,"Block 1031, Block Group 1, Census Tract 1539.01, Sonoma County, California",0,0,0
1000000US060971539011032,060971539011032,"Block 1032, Block Group 1, Census Tract 1539.01, Sonoma County, California",40,27,13
1000000US060971539011033,060971539011033,"Block 1033, Block Group 1, Census Tract 1539.01, Sonoma County, California",0,0,0
1000000US060971539011034,060971539011034,"Block 1034, Block Group 1, Census Tract 1539.01, Sonoma County, California",0,0,0
1000000US060971539011035,060971539011035,"Block 1035, Block Group 1, Census Tract 1539.01, Sonoma County, California",2,2,0
1000000US060971539011036,060971539011036,"Block 1036, Block Group 1, Census Tract 1539.01, Sonoma County, California",0,0,0
1000000US060971539011037,060971539011037,"Block 1037, Block Group 1, Census Tract 1539.01, Sonoma County, California",0,0,0
1000000US060971539011038,060971539011038,"Block 1038, Block Group 1, Census Tract 1539.01, Sonoma County, California",0,0,0
1000000US060971539011039,060971539011039,"Block 1039, Block Group 1, Census Tract 1539.01, Sonoma County, California",29,22,7
1000000US060971539011040,060971539011040,"Block 1040, Block Group 1, Census Tract 1539.01, Sonoma County, California",1,1,0
1000000US060971539011041,060971539011041,"Block 1041, Block Group 1, Census Tract 1539.01, Sonoma County, California",0,0,0
1000000US060971539011042,060971539011042,"Block 1042, Block Group 1, Census Tract 1539.01, Sonoma County, California",3,2,1
1000000US060971539011043,060971539011043,"Block 1043, Block Group 1, Census Tract 1539.01, Sonoma County, California",10,8,2
1000000US060971539011044,060971539011044,"Block 1044, Block Group 1, Census Tract 1539.01, Sonoma County, California",0,0,0
1000000US060971539011045,060971539011045,"Block 1045, Block Group 1, Census Tract 1539.01, Sonoma County, California",1,1,0
1000000US060971539011046,060971539011046,"Block 1046, Block Group 1, Census Tract 1539.01, Sonoma County, California",1,1,0
1000000US060971539011047,060971539011047,"Block 1047, Block Group 1, Census Tract 1539.01, Sonoma County, California",3,2,1
1000000US060971539011048,060971539011048,"Block 1048, Block Group 1, Census Tract 1539.01, Sonoma County, California",0,0,0
1000000US060971539011049,060971539011049,"Block 1049, Block Group 1, Census Tract 1539.01, Sonoma County, California",1,1,0
1000000US060971539011050,060971539011050,"Block 1050, Block Group 1, Census Tract 1539.01, Sonoma County, California",32,26,6
1000000US060971539011051,060971539011051,"Block 1051, Block Group 1, Census Tract 1539.01, Sonoma County, California",0,0,0
1000000US060971539011052,060971539011052,"Block 1052, Block Group 1, Census Tract 1539.01, Sonoma County, California",3,2,1
1000000US060971539011053,060971539011053,"Block 1053, Block Group 1, Census Tract 1539.01, Sonoma County, California",1,1,0
1000000US060971539011054,060971539011054,"Block 1054, Block Group 1, Census Tract 1539.01, Sonoma County, California",2,2,0
1000000US060971539011055,060971539011055,"Block 1055, Block Group 1, Census Tract 1539.01, Sonoma County, California",1,1,0
1000000US060971539011056,060971539011056,"Block 1056, Block Group 1, Census Tract 1539.01, Sonoma County, California",0,0,0
1000000US060971539011057,060971539011057,"Block 1057, Block Group 1, Census Tract 1539.01, Sonoma County, California",24,15,9
1000000US060971539011058,060971539011058,"Block 1058, Block Group 1, Census Tract 1539.01, Sonoma County, California",1,1,0
1000000US060971539011059,060971539011059,"Block 1059, Block Group 1, Census Tract 1539.01, Sonoma County, California",1,1,0
1000000US060971539011060,060971539011060,"Block 1060, Block Group 1, Census Tract 1539.01, Sonoma County, California",0,0,0
1000000US060971539011061,060971539011061,"Block 1061, Block Group 1, Census Tract 1539.01, Sonoma County, California",1,1,0
1000000US060971539011062,060971539011062,"Block 1062, Block Group 1, Census Tract 1539.01, Sonoma County, California",0,0,0
1000000US060971539011063,060971539011063,"Block 1063, Block Group 1, Census Tract 1539.01, Sonoma County, California",0,0,0
1000000US060971539012000,060971539012000,"Block 2000, Block Group 2, Census Tract 1539.01, Sonoma County, California",290,263,27
1000000US060971539012001,060971539012001,"Block 2001, Block Group 2, Census Tract 1539.01, Sonoma County, California",9,8,1
1000000US060971539012002,060971539012002,"Block 2002, Block Group 2, Census Tract 1539.01, Sonoma County, California",42,38,4
1000000US060971539012003,060971539012003,"Block 2003, Block Group 2, Census Tract 1539.01, Sonoma County, California",73,65,8
1000000US060971539012004,060971539012004,"Block 2004, Block Group 2, Census Tract 1539.01, Sonoma County, California",26,19,7
1000000US060971539012005,060971539012005,"Block 2005, Block Group 2, Census Tract 1539.01, Sonoma County, California",47,43,4
1000000US060971539012006,060971539012006,"Block 2006, Block Group 2, Census Tract 1539.01, Sonoma County, California",21,21,0
1000000US060971539012007,060971539012007,"Block 2007, Block Group 2, Census Tract 1539.01, Sonoma County, California",0,0,0
1000000US060971539012008,060971539012008,"Block 2008, Block Group 2, Census Tract 1539.01, Sonoma County, California",18,17,1
1000000US060971539012009,060971539012009,"Block 2009, Block Group 2, Census Tract 1539.01, Sonoma County, California",20,20,0
1000000US060971539012010,060971539012010,"Block 2010, Block Group 2, Census Tract 1539.01, Sonoma County, California",64,62,2
1000000US060971539012011,060971539012011,"Block 2011, Block Group 2, Census Tract 1539.01, Sonoma County, California",0,0,0
1000000US060971539012012,060971539012012,"Block 2012, Block Group 2, Census Tract 1539.01, Sonoma County, California",12,10,2
1000000US060971539012013,060971539012013,"Block 2013, Block Group 2, Census Tract 1539.01, Sonoma County, California",0,0,0
1000000US060971539012014,060971539012014,"Block 2014, Block Group 2, Census Tract 1539.01, Sonoma County, California",0,0,0
1000000US060971539012015,060971539012015,"Block 2015, Block Group 2, Census Tract 1539.01, Sonoma County, California",0,0,0
1000000US060971539012016,060971539012016,"Block 2016, Block Group 2, Census Tract 1539.01, Sonoma County, California",0,0,0
1000000US060971539013000,060971539013000,"Block 3000, Block Group 3, Census Tract 1539.01, Sonoma County, California",0,0,0
1000000US060971539013001,060971539013001,"Block 3001, Block Group 3, Census Tract 1539.01, Sonoma County, California",0,0,0
1000000US060971539013002,060971539013002,"Block 3002, Block Group 3, Census Tract 1539.01, Sonoma County, California",0,0,0
1000000US060971539013003,060971539013003,"Block 3003, Block Group 3, Census Tract 1539.01, Sonoma County, California",1,1,0
1000000US060971539013004,060971539013004,"Block 3004, Block Group 3, Census Tract 1539.01, Sonoma County, California",0,0,0
1000000US060971539013005,060971539013005,"Block 3005, Block Group 3, Census Tract 1539.01, Sonoma County, California",1,1,0
1000000US060971539013006,060971539013006,"Block 3006, Block Group 3, Census Tract 1539.01, Sonoma County, California",0,0,0
1000000US060971539013007,060971539013007,"Block 3007, Block Group 3, Census Tract 1539.01, Sonoma County, California",0,0,0
1000000US060971539013008,060971539013008,"Block 3008, Block Group 3, Census Tract 1539.01, Sonoma County, California",6,5,1
1000000US060971539013009,060971539013009,"Block 3009, Block Group 3, Census Tract 1539.01, Sonoma County, California",81,81,0
1000000US060971539013010,060971539013010,"Block 3010, Block Group 3, Census Tract 1539.01, Sonoma County, California",1,1,0
1000000US060971539013011,060971539013011,"Block 3011, Block Group 3, Census Tract 1539.01, Sonoma County, California",0,0,0
1000000US060971539013012,060971539013012,"Block 3012, Block Group 3, Census Tract 1539.01, Sonoma County, California",51,48,3
1000000US060971539013013,060971539013013,"Block 3013, Block Group 3, Census Tract 1539.01, Sonoma County, California",5,4,1
1000000US060971539013014,060971539013014,"Block 3014, Block Group 3, Census Tract 1539.01, Sonoma County, California",58,51,7
1000000US060971539013015,060971539013015,"Block 3015, Block Group 3, Census Tract 1539.01, Sonoma County, California",73,69,4
1000000US060971539013016,060971539013016,"Block 3016, Block Group 3, Census Tract 1539.01, Sonoma County, California",17,17,0
1000000US060971539013017,060971539013017,"Block 3017, Block Group 3, Census Tract 1539.01, Sonoma County, California",32,30,2
1000000US060971539013018,060971539013018,"Block 3018, Block Group 3, Census Tract 1539.01, Sonoma County, California",15,15,0
1000000US060971539013019,060971539013019,"Block 3019, Block Group 3, Census Tract 1539.01, Sonoma County, California",36,33,3
1000000US060971539013020,060971539013020,"Block 3020, Block Group 3, Census Tract 1539.01, Sonoma County, California",8,8,0
1000000US060971539013021,060971539013021,"Block 3021, Block Group 3, Census Tract 1539.01, Sonoma County, California",26,26,0
1000000US060971539013022,060971539013022,"Block 3022, Block Group 3, Census Tract 1539.01, Sonoma County, California",10,10,0
1000000US060971539013023,060971539013023,"Block 3023, Block Group 3, Census Tract 1539.01, Sonoma County, California",109,102,7
1000000US060971539013024,060971539013024,"Block 3024, Block Group 3, Census Tract 1539.01, Sonoma County, California",0,0,0
1000000US060971539013025,060971539013025,"Block 3025, Block Group 3, Census Tract 1539.01, Sonoma County, California",13,13,0
1000000US060971539013026,060971539013026,"Block 3026, Block Group 3, Census Tract 1539.01, Sonoma County, California",0,0,0
1000000US060971539013027,060971539013027,"Block 3027, Block Group 3, Census Tract 1539.01, Sonoma County, California",0,0,0
1000000US060971539013028,060971539013028,"Block 3028, Block Group 3, Census Tract 1539.01, Sonoma County, California",0,0,0
1000000US060971539013029,060971539013029,"Block 3029, Block Group 3, Census Tract 1539.01, Sonoma County, California",0,0,0
1000000US060971539013030,060971539013030,"Block 3030, Block Group 3, Census Tract 1539.01, Sonoma County, California",0,0,0
1000000US060971539013031,060971539013031,"Block 3031, Block Group 3, Census Tract 1539.01, Sonoma County, California",2,2,0
1000000US060971539013032,060971539013032,"Block 3032, Block Group 3, Census Tract 1539.01, Sonoma County, California",0,0,0
1000000US060971539013033,060971539013033,"Block 3033, Block Group 3, Census Tract 1539.01, Sonoma County, California",0,0,0
1000000US060971539013034,060971539013034,"Block 3034, Block Group 3, Census Tract 1539.01, Sonoma County, California",36,34,2
1000000US060971539013035,060971539013035,"Block 3035, Block Group 3, Census Tract 1539.01, Sonoma County, California",5,5,0
1000000US060971539013036,060971539013036,"Block 3036, Block Group 3, Census Tract 1539.01, Sonoma County, California",21,20,1
1000000US060971539013037,060971539013037,"Block 3037, Block Group 3, Census Tract 1539.01, Sonoma County, California",114,104,10
1000000US060971539013038,060971539013038,"Block 3038, Block Group 3, Census Tract 1539.01, Sonoma County, California",17,17,0
1000000US060971539013039,060971539013039,"Block 3039, Block Group 3, Census Tract 1539.01, Sonoma County, California",22,21,1
1000000US060971539013040,060971539013040,"Block 3040, Block Group 3, Census Tract 1539.01, Sonoma County, California",43,42,1
1000000US060971539013041,060971539013041,"Block 3041, Block Group 3, Census Tract 1539.01, Sonoma County, California",14,14,0
1000000US060971539013042,060971539013042,"Block 3042, Block Group 3, Census Tract 1539.01, Sonoma County, California",0,0,0
1000000US060971539013043,060971539013043,"Block 3043, Block Group 3, Census Tract 1539.01, Sonoma County, California",18,18,0
1000000US060971539013044,060971539013044,"Block 3044, Block Group 3, Census Tract 1539.01, Sonoma County, California",9,8,1
1000000US060971539013045,060971539013045,"Block 3045, Block Group 3, Census Tract 1539.01, Sonoma County, California",0,0,0
1000000US060971539014000,060971539014000,"Block 4000, Block Group 4, Census Tract 1539.01, Sonoma County, California",24,19,5
1000000US060971539014001,060971539014001,"Block 4001, Block Group 4, Census Tract 1539.01, Sonoma County, California",0,0,0
1000000US060971539014002,060971539014002,"Block 4002, Block Group 4, Census Tract 1539.01, Sonoma County, California",97,82,15
1000000US060971539014003,060971539014003,"Block 4003, Block Group 4, Census Tract 1539.01, Sonoma County, California",0,0,0
1000000US060971539014004,060971539014004,"Block 4004, Block Group 4, Census Tract 1539.01, Sonoma County, California",8,7,1
1000000US060971539014005,060971539014005,"Block 4005, Block Group 4, Census Tract 1539.01, Sonoma County, California",5,5,0
1000000US060971539014006,060971539014006,"Block 4006, Block Group 4, Census Tract 1539.01, Sonoma County, California",9,7,2
1000000US060971539014007,060971539014007,"Block 4007, Block Group 4, Census Tract 1539.01, Sonoma County, California",1,0,1
1000000US060971539014008,060971539014008,"Block 4008, Block Group 4, Census Tract 1539.01, Sonoma County, California",0,0,0
1000000US060971539014009,060971539014009,"Block 4009, Block Group 4, Census Tract 1539.01, Sonoma County, California",0,0,0
1000000US060971539014010,060971539014010,"Block 4010, Block Group 4, Census Tract 1539.01, Sonoma County, California",0,0,0
1000000US060971539014011,060971539014011,"Block 4011, Block Group 4, Census Tract 1539.01, Sonoma County, California",4,4,0
1000000US060971539014012,060971539014012,"Block 4012, Block Group 4, Census Tract 1539.01, Sonoma County, California",0,0,0
1000000US060971539014013,060971539014013,"Block 4013, Block Group 4, Census Tract 1539.01, Sonoma County, California",5,2,3
1000000US060971539014014,060971539014014,"Block 4014, Block Group 4, Census Tract 1539.01, Sonoma County, California",1,1,0
1000000US060971539014015,060971539014015,"Block 4015, Block Group 4, Census Tract 1539.01, Sonoma County, California",0,0,0
1000000US060971539014016,060971539014016,"Block 4016, Block Group 4, Census Tract 1539.01, Sonoma County, California",17,12,5
1000000US060971539014017,060971539014017,"Block 4017, Block Group 4, Census Tract 1539.01, Sonoma County, California",1,1,0
1000000US060971539014018,060971539014018,"Block 4018, Block Group 4, Census Tract 1539.01, Sonoma County, California",3,3,0
1000000US060971539014019,060971539014019,"Block 4019, Block Group 4, Census Tract 1539.01, Sonoma County, California",4,4,0
1000000US060971539014020,060971539014020,"Block 4020, Block Group 4, Census Tract 1539.01, Sonoma County, California",9,7,2
1000000US060971539014021,060971539014021,"Block 4021, Block Group 4, Census Tract 1539.01, Sonoma County, California",0,0,0
1000000US060971539014022,060971539014022,"Block 4022, Block Group 4, Census Tract 1539.01, Sonoma County, California",0,0,0
1000000US060971539014023,060971539014023,"Block 4023, Block Group 4, Census Tract 1539.01, Sonoma County, California",2,1,1
1000000US060971539014024,060971539014024,"Block 4024, Block Group 4, Census Tract 1539.01, Sonoma County, California",10,10,0
1000000US060971539014025,060971539014025,"Block 4025, Block Group 4, Census Tract 1539.01, Sonoma County, California",3,3,0
1000000US060971539014026,060971539014026,"Block 4026, Block Group 4, Census Tract 1539.01, Sonoma County, California",0,0,0
1000000US060971539014027,060971539014027,"Block 4027, Block Group 4, Census Tract 1539.01, Sonoma County, California",1,0,1
1000000US060971539014028,060971539014028,"Block 4028, Block Group 4, Census Tract 1539.01, Sonoma County, California",0,0,0
1000000US060971539014029,060971539014029,"Block 4029, Block Group 4, Census Tract 1539.01, Sonoma County, California",0,0,0
1000000US060971539014030,060971539014030,"Block 4030, Block Group 4, Census Tract 1539.01, Sonoma County, California",0,0,0
1000000US060971539014031,060971539014031,"Block 4031, Block Group 4, Census Tract 1539.01, Sonoma County, California",0,0,0
1000000US060971539014032,060971539014032,"Block 4032, Block Group 4, Census Tract 1539.01, Sonoma County, California",44,39,5
1000000US060971539014033,060971539014033,"Block 4033, Block Group 4, Census Tract 1539.01, Sonoma County, California",17,16,1
1000000US060971539014034,060971539014034,"Block 4034, Block Group 4, Census Tract 1539.01, Sonoma County, California",0,0,0
1000000US060971539014035,060971539014035,"Block 4035, Block Group 4, Census Tract 1539.01, Sonoma County, California",0,0,0
1000000US060971539014036,060971539014036,"Block 4036, Block Group 4, Census Tract 1539.01, Sonoma County, California",0,0,0
1000000US060971539014037,060971539014037,"Block 4037, Block Group 4, Census Tract 1539.01, Sonoma County, California",33,32,1
1000000US060971539014038,060971539014038,"Block 4038, Block Group 4, Census Tract 1539.01, Sonoma County, California",12,11,1
1000000US060971539014039,060971539014039,"Block 4039, Block Group 4, Census Tract 1539.01, Sonoma County, California",20,18,2
1000000US060971539014040,060971539014040,"Block 4040, Block Group 4, Census Tract 1539.01, Sonoma County, California",0,0,0
1000000US060971539014041,060971539014041,"Block 4041, Block Group 4, Census Tract 1539.01, Sonoma County, California",0,0,0
1000000US060971539021000,060971539021000,"Block 1000, Block Group 1, Census Tract 1539.02, Sonoma County, California",26,26,0
1000000US060971539021001,060971539021001,"Block 1001, Block Group 1, Census Tract 1539.02, Sonoma County, California",152,120,32
1000000US060971539021002,060971539021002,"Block 1002, Block Group 1, Census Tract 1539.02, Sonoma County, California",0,0,0
1000000US060971539021003,060971539021003,"Block 1003, Block Group 1, Census Tract 1539.02, Sonoma County, California",0,0,0
1000000US060971539021004,060971539021004,"Block 1004, Block Group 1, Census Tract 1539.02, Sonoma County, California",29,15,14
1000000US060971539021005,060971539021005,"Block 1005, Block Group 1, Census Tract 1539.02, Sonoma County, California",0,0,0
1000000US060971539021006,060971539021006,"Block 1006, Block Group 1, Census Tract 1539.02, Sonoma County, California",0,0,0
1000000US060971539021007,060971539021007,"Block 1007, Block Group 1, Census Tract 1539.02, Sonoma County, California",0,0,0
1000000US060971539021008,060971539021008,"Block 1008, Block Group 1, Census Tract 1539.02, Sonoma County, California",0,0,0
1000000US060971539021009,060971539021009,"Block 1009, Block Group 1, Census Tract 1539.02, Sonoma County, California",0,0,0
1000000US060971539021010,060971539021010,"Block 1010, Block Group 1, Census Tract 1539.02, Sonoma County, California",0,0,0
1000000US060971539021011,060971539021011,"Block 1011, Block Group 1, Census Tract 1539.02, Sonoma County, California",3,1,2
1000000US060971539021012,060971539021012,"Block 1012, Block Group 1, Census Tract 1539.02, Sonoma County, California",14,11,3
1000000US060971539021013,060971539021013,"Block 1013, Block Group 1, Census Tract 1539.02, Sonoma County, California",1,1,0
1000000US060971539021014,060971539021014,"Block 1014, Block Group 1, Census Tract 1539.02, Sonoma County, California",9,8,1
1000000US060971539021015,060971539021015,"Block 1015, Block Group 1, Census Tract 1539.02, Sonoma County, California",0,0,0
1000000US060971539021016,060971539021016,"Block 1016, Block Group 1, Census Tract 1539.02, Sonoma County, California",6,6,0
1000000US060971539021017,060971539021017,"Block 1017, Block Group 1, Census Tract 1539.02, Sonoma County, California",0,0,0
1000000US060971539021018,060971539021018,"Block 1018, Block Group 1, Census Tract 1539.02, Sonoma County, California",2,0,2
1000000US060971539021019,060971539021019,"Block 1019, Block Group 1, Census Tract 1539.02, Sonoma County, California",0,0,0
1000000US060971539021020,060971539021020,"Block 1020, Block Group 1, Census Tract 1539.02, Sonoma County, California",6,5,1
1000000US060971539021021,060971539021021,"Block 1021, Block Group 1, Census Tract 1539.02, Sonoma County, California",22,18,4
1000000US060971539021022,060971539021022,"Block 1022, Block Group 1, Census Tract 1539.02, Sonoma County, California",4,4,0
1000000US060971539021023,060971539021023,"Block 1023, Block Group 1, Census Tract 1539.02, Sonoma County, California",31,30,1
1000000US060971539021024,060971539021024,"Block 1024, Block Group 1, Census Tract 1539.02, Sonoma County, California",38,38,0
1000000US060971539021025,060971539021025,"Block 1025, Block Group 1, Census Tract 1539.02, Sonoma County, California",3,2,1
1000000US060971539021026,060971539021026,"Block 1026, Block Group 1, Census Tract 1539.02, Sonoma County, California",0,0,0
1000000US060971539021027,060971539021027,"Block 1027, Block Group 1, Census Tract 1539.02, Sonoma County, California",91,83,8
1000000US060971539021028,060971539021028,"Block 1028, Block Group 1, Census Tract 1539.02, Sonoma County, California",17,16,1
1000000US060971539021029,060971539021029,"Block 1029, Block Group 1, Census Tract 1539.02, Sonoma County, California",7,7,0
1000000US060971539021030,060971539021030,"Block 1030, Block Group 1, Census Tract 1539.02, Sonoma County, California",20,19,1
1000000US060971539021031,060971539021031,"Block 1031, Block Group 1, Census Tract 1539.02, Sonoma County, California",12,10,2
1000000US060971539021032,060971539021032,"Block 1032, Block Group 1, Census Tract 1539.02, Sonoma County, California",0,0,0
1000000US060971539021033,060971539021033,"Block 1033, Block Group 1, Census Tract 1539.02, Sonoma County, California",77,58,19
1000000US060971539021034,060971539021034,"Block 1034, Block Group 1, Census Tract 1539.02, Sonoma County, California",1,1,0
1000000US060971539021035,060971539021035,"Block 1035, Block Group 1, Census Tract 1539.02, Sonoma County, California",11,11,0
1000000US060971539021036,060971539021036,"Block 1036, Block Group 1, Census Tract 1539.02, Sonoma County, California",0,0,0
1000000US060971539021037,060971539021037,"Block 1037, Block Group 1, Census Tract 1539.02, Sonoma County, California",0,0,0
1000000US060971539021038,060971539021038,"Block 1038, Block Group 1, Census Tract 1539.02, Sonoma County, California",0,0,0
1000000US060971539021039,060971539021039,"Block 1039, Block Group 1, Census Tract 1539.02, Sonoma County, California",2,2,0
1000000US060971539021040,060971539021040,"Block 1040, Block Group 1, Census Tract 1539.02, Sonoma County, California",0,0,0
1000000US060971539021041,060971539021041,"Block 1041, Block Group 1, Census Tract 1539.02, Sonoma County, California",2,2,0
1000000US060971539021042,060971539021042,"Block 1042, Block Group 1, Census Tract 1539.02, Sonoma County, California",1,1,0
1000000US060971539021043,060971539021043,"Block 1043, Block Group 1, Census Tract 1539.02, Sonoma County, California",0,0,0
1000000US060971539021044,060971539021044,"Block 1044, Block Group 1, Census Tract 1539.02, Sonoma County, California",0,0,0
1000000US060971539021045,060971539021045,"Block 1045, Block Group 1, Census Tract 1539.02, Sonoma County, California",0,0,0
1000000US060971539021046,060971539021046,"Block 1046, Block Group 1, Census Tract 1539.02, Sonoma County, California",0,0,0
1000000US060971539021047,060971539021047,"Block 1047, Block Group 1, Census Tract 1539.02, Sonoma County, California",0,0,0
1000000US060971539021048,060971539021048,"Block 1048, Block Group 1, Census Tract 1539.02, Sonoma County, California",0,0,0
1000000US060971539021049,060971539021049,"Block 1049, Block Group 1, Census Tract 1539.02, Sonoma County, California",18,18,0
1000000US060971539021050,060971539021050,"Block 1050, Block Group 1, Census Tract 1539.02, Sonoma County, California",0,0,0
1000000US060971539021051,060971539021051,"Block 1051, Block Group 1, Census Tract 1539.02, Sonoma County, California",0,0,0
1000000US060971539021052,060971539021052,"Block 1052, Block Group 1, Census Tract 1539.02, Sonoma County, California",0,0,0
1000000US060971539021053,060971539021053,"Block 1053, Block Group 1, Census Tract 1539.02, Sonoma County, California",0,0,0
1000000US060971539021054,060971539021054,"Block 1054, Block Group 1, Census Tract 1539.02, Sonoma County, California",0,0,0
1000000US060971539021055,060971539021055,"Block 1055, Block Group 1, Census Tract 1539.02, Sonoma County, California",0,0,0
1000000US060971539021056,060971539021056,"Block 1056, Block Group 1, Census Tract 1539.02, Sonoma County, California",0,0,0
1000000US060971539021057,060971539021057,"Block 1057, Block Group 1, Census Tract 1539.02, Sonoma County, California",20,20,0
1000000US060971539021058,060971539021058,"Block 1058, Block Group 1, Census Tract 1539.02, Sonoma County, California",0,0,0
1000000US060971539022000,060971539022000,"Block 2000, Block Group 2, Census Tract 1539.02, Sonoma County, California",121,117,4
1000000US060971539022001,060971539022001,"Block 2001, Block Group 2, Census Tract 1539.02, Sonoma County, California",22,21,1
1000000US060971539022002,060971539022002,"Block 2002, Block Group 2, Census Tract 1539.02, Sonoma County, California",24,23,1
1000000US060971539022003,060971539022003,"Block 2003, Block Group 2, Census Tract 1539.02, Sonoma County, California",32,31,1
1000000US060971539022004,060971539022004,"Block 2004, Block Group 2, Census Tract 1539.02, Sonoma County, California",23,20,3
1000000US060971539022005,060971539022005,"Block 2005, Block Group 2, Census Tract 1539.02, Sonoma County, California",29,27,2
1000000US060971539022006,060971539022006,"Block 2006, Block Group 2, Census Tract 1539.02, Sonoma County, California",25,15,10
1000000US060971539023000,060971539023000,"Block 3000, Block Group 3, Census Tract 1539.02, Sonoma County, California",17,16,1
1000000US060971539023001,060971539023001,"Block 3001, Block Group 3, Census Tract 1539.02, Sonoma County, California",28,27,1
1000000US060971539023002,060971539023002,"Block 3002, Block Group 3, Census Tract 1539.02, Sonoma County, California",103,90,13
1000000US060971539023003,060971539023003,"Block 3003, Block Group 3, Census Tract 1539.02, Sonoma County, California",15,8,7
1000000US060971539023004,060971539023004,"Block 3004, Block Group 3, Census Tract 1539.02, Sonoma County, California",19,18,1
1000000US060971539023005,060971539023005,"Block 3005, Block Group 3, Census Tract 1539.02, Sonoma County, California",5,5,0
1000000US060971539023006,060971539023006,"Block 3006, Block Group 3, Census Tract 1539.02, Sonoma County, California",27,20,7
1000000US060971539023007,060971539023007,"Block 3007, Block Group 3, Census Tract 1539.02, Sonoma County, California",59,51,8
1000000US060971539023008,060971539023008,"Block 3008, Block Group 3, Census Tract 1539.02, Sonoma County, California",12,11,1
1000000US060971539023009,060971539023009,"Block 3009, Block Group 3, Census Tract 1539.02, Sonoma County, California",6,4,2
1000000US060971539023010,060971539023010,"Block 3010, Block Group 3, Census Tract 1539.02, Sonoma County, California",19,13,6
1000000US060971539023011,060971539023011,"Block 3011, Block Group 3, Census Tract 1539.02, Sonoma County, California",27,25,2
1000000US060971539023012,060971539023012,"Block 3012, Block Group 3, Census Tract 1539.02, Sonoma County, California",39,28,11
1000000US060971539023013,060971539023013,"Block 3013, Block Group 3, Census Tract 1539.02, Sonoma County, California",28,26,2
1000000US060971539023014,060971539023014,"Block 3014, Block Group 3, Census Tract 1539.02, Sonoma County, California",24,20,4
1000000US060971539023015,060971539023015,"Block 3015, Block Group 3, Census Tract 1539.02, Sonoma County, California",9,9,0
1000000US060971539024000,060971539024000,"Block 4000, Block Group 4, Census Tract 1539.02, Sonoma County, California",35,34,1
1000000US060971539024001,060971539024001,"Block 4001, Block Group 4, Census Tract 1539.02, Sonoma County, California",65,64,1
1000000US060971539024002,060971539024002,"Block 4002, Block Group 4, Census Tract 1539.02, Sonoma County, California",36,35,1
1000000US060971539024003,060971539024003,"Block 4003, Block Group 4, Census Tract 1539.02, Sonoma County, California",108,100,8
1000000US060971539024004,060971539024004,"Block 4004, Block Group 4, Census Tract 1539.02, Sonoma County, California",12,12,0
1000000US060971539024005,060971539024005,"Block 4005, Block Group 4, Census Tract 1539.02, Sonoma County, California",15,14,1
1000000US060971539024006,060971539024006,"Block 4006, Block Group 4, Census Tract 1539.02, Sonoma County, California",14,14,0
1000000US060971539024007,060971539024007,"Block 4007, Block Group 4, Census Tract 1539.02, Sonoma County, California",24,24,0
1000000US060971539024008,060971539024008,"Block 4008, Block Group 4, Census Tract 1539.02, Sonoma County, California",11,11,0
1000000US060971539024009,060971539024009,"Block 4009, Block Group 4, Census Tract 1539.02, Sonoma County, California",6,6,0
1000000US060971539031000,060971539031000,"Block 1000, Block Group 1, Census Tract 1539.03, Sonoma County, California",0,0,0
1000000US060971539031001,060971539031001,"Block 1001, Block Group 1, Census Tract 1539.03, Sonoma County, California",0,0,0
1000000US060971539031002,060971539031002,"Block 1002, Block Group 1, Census Tract 1539.03, Sonoma County, California",0,0,0
1000000US060971539031003,060971539031003,"Block 1003, Block Group 1, Census Tract 1539.03, Sonoma County, California",75,73,2
1000000US060971539031004,060971539031004,"Block 1004, Block Group 1, Census Tract 1539.03, Sonoma County, California",0,0,0
1000000US060971539031005,060971539031005,"Block 1005, Block Group 1, Census Tract 1539.03, Sonoma County, California",7,7,0
1000000US060971539031006,060971539031006,"Block 1006, Block Group 1, Census Tract 1539.03, Sonoma County, California",61,57,4
1000000US060971539031007,060971539031007,"Block 1007, Block Group 1, Census Tract 1539.03, Sonoma County, California",0,0,0
1000000US060971539031008,060971539031008,"Block 1008, Block Group 1, Census Tract 1539.03, Sonoma County, California",145,139,6
1000000US060971539031009,060971539031009,"Block 1009, Block Group 1, Census Tract 1539.03, Sonoma County, California",8,8,0
1000000US060971539031010,060971539031010,"Block 1010, Block Group 1, Census Tract 1539.03, Sonoma County, California",9,9,0
1000000US060971539031011,060971539031011,"Block 1011, Block Group 1, Census Tract 1539.03, Sonoma County, California",10,8,2
1000000US060971539031012,060971539031012,"Block 1012, Block Group 1, Census Tract 1539.03, Sonoma County, California",17,17,0
1000000US060971539031013,060971539031013,"Block 1013, Block Group 1, Census Tract 1539.03, Sonoma County, California",6,5,1
1000000US060971539031014,060971539031014,"Block 1014, Block Group 1, Census Tract 1539.03, Sonoma County, California",3,3,0
1000000US060971539031015,060971539031015,"Block 1015, Block Group 1, Census Tract 1539.03, Sonoma County, California",1,1,0
1000000US060971539031016,060971539031016,"Block 1016, Block Group 1, Census Tract 1539.03, Sonoma County, California",1,1,0
1000000US060971539031017,060971539031017,"Block 1017, Block Group 1, Census Tract 1539.03, Sonoma County, California",5,5,0
1000000US060971539031018,060971539031018,"Block 1018, Block Group 1, Census Tract 1539.03, Sonoma County, California",0,0,0
1000000US060971539031019,060971539031019,"Block 1019, Block Group 1, Census Tract 1539.03, Sonoma County, California",20,17,3
1000000US060971539031020,060971539031020,"Block 1020, Block Group 1, Census Tract 1539.03, Sonoma County, California",20,20,0
1000000US060971539031021,060971539031021,"Block 1021, Block Group 1, Census Tract 1539.03, Sonoma County, California",16,15,1
1000000US060971539031022,060971539031022,"Block 1022, Block Group 1, Census Tract 1539.03, Sonoma County, California",16,15,1
1000000US060971539032000,060971539032000,"Block 2000, Block Group 2, Census Tract 1539.03, Sonoma County, California",41,38,3
1000000US060971539032001,060971539032001,"Block 2001, Block Group 2, Census Tract 1539.03, Sonoma County, California",32,29,3
1000000US060971539032002,060971539032002,"Block 2002, Block Group 2, Census Tract 1539.03, Sonoma County, California",42,35,7
1000000US060971539032003,060971539032003,"Block 2003, Block Group 2, Census Tract 1539.03, Sonoma County, California",42,40,2
1000000US060971539032004,060971539032004,"Block 2004, Block Group 2, Census Tract 1539.03, Sonoma County, California",31,25,6
1000000US060971539032005,060971539032005,"Block 2005, Block Group 2, Census Tract 1539.03, Sonoma County, California",14,13,1
1000000US060971539032006,060971539032006,"Block 2006, Block Group 2, Census Tract 1539.03, Sonoma County, California",137,124,13
1000000US060971539032007,060971539032007,"Block 2007, Block Group 2, Census Tract 1539.03, Sonoma County, California",50,48,2
1000000US060971539032008,060971539032008,"Block 2008, Block Group 2, Census Tract 1539.03, Sonoma County, California",23,22,1
1000000US060971539032009,060971539032009,"Block 2009, Block Group 2, Census Tract 1539.03, Sonoma County, California",13,12,1
1000000US060971539033000,060971539033000,"Block 3000, Block Group 3, Census Tract 1539.03, Sonoma County, California",0,0,0
1000000US060971539033001,060971539033001,"Block 3001, Block Group 3, Census Tract 1539.03, Sonoma County, California",19,18,1
1000000US060971539033002,060971539033002,"Block 3002, Block Group 3, Census Tract 1539.03, Sonoma County, California",0,0,0
1000000US060971539033003,060971539033003,"Block 3003, Block Group 3, Census Tract 1539.03, Sonoma County, California",4,4,0
1000000US060971539033004,060971539033004,"Block 3004, Block Group 3, Census Tract 1539.03, Sonoma County, California",154,141,13
1000000US060971539033005,060971539033005,"Block 3005, Block Group 3, Census Tract 1539.03, Sonoma County, California",0,0,0
1000000US060971539033006,060971539033006,"Block 3006, Block Group 3, Census Tract 1539.03, Sonoma County, California",1,1,0
1000000US060971539033007,060971539033007,"Block 3007, Block Group 3, Census Tract 1539.03, Sonoma County, California",9,6,3
1000000US060971539033008,060971539033008,"Block 3008, Block Group 3, Census Tract 1539.03, Sonoma County, California",1,1,0
1000000US060971539033009,060971539033009,"Block 3009, Block Group 3, Census Tract 1539.03, Sonoma County, California",60,58,2
1000000US060971539033010,060971539033010,"Block 3010, Block Group 3, Census Tract 1539.03, Sonoma County, California",0,0,0
1000000US060971539033011,060971539033011,"Block 3011, Block Group 3, Census Tract 1539.03, Sonoma County, California",19,19,0
1000000US060971539033012,060971539033012,"Block 3012, Block Group 3, Census Tract 1539.03, Sonoma County, California",11,10,1
1000000US060971539033013,060971539033013,"Block 3013, Block Group 3, Census Tract 1539.03, Sonoma County, California",18,16,2
1000000US060971539033014,060971539033014,"Block 3014, Block Group 3, Census Tract 1539.03, Sonoma County, California",11,10,1
1000000US060971539033015,060971539033015,"Block 3015, Block Group 3, Census Tract 1539.03, Sonoma County, California",5,3,2
1000000US060971539033016,060971539033016,"Block 3016, Block Group 3, Census Tract 1539.03, Sonoma County, California",13,10,3
1000000US060971539033017,060971539033017,"Block 3017, Block Group 3, Census Tract 1539.03, Sonoma County, California",0,0,0
1000000US060971539034000,060971539034000,"Block 4000, Block Group 4, Census Tract 1539.03, Sonoma County, California",21,20,1
1000000US060971539034001,060971539034001,"Block 4001, Block Group 4, Census Tract 1539.03, Sonoma County, California",22,19,3
1000000US060971539034002,060971539034002,"Block 4002, Block Group 4, Census Tract 1539.03, Sonoma County, California",28,28,0
1000000US060971539034003,060971539034003,"Block 4003, Block Group 4, Census Tract 1539.03, Sonoma County, California",72,69,3
1000000US060971539034004,060971539034004,"Block 4004, Block Group 4, Census Tract 1539.03, Sonoma County, California",21,19,2
1000000US060971539034005,060971539034005,"Block 4005, Block Group 4, Census Tract 1539.03, Sonoma County, California",39,36,3
1000000US060971539034006,060971539034006,"Block 4006, Block Group 4, Census Tract 1539.03, Sonoma County, California",23,19,4
1000000US060971539034007,060971539034007,"Block 4007, Block Group 4, Census Tract 1539.03, Sonoma County, California",16,14,2
1000000US060971539034008,060971539034008,"Block 4008, Block Group 4, Census Tract 1539.03, Sonoma County, California",20,17,3
1000000US060971539034009,060971539034009,"Block 4009, Block Group 4, Census Tract 1539.03, Sonoma County, California",25,24,1
1000000US060971539034010,060971539034010,"Block 4010, Block Group 4, Census Tract 1539.03, Sonoma County, California",26,23,3
1000000US060971539034011,060971539034011,"Block 4011, Block Group 4, Census Tract 1539.03, Sonoma County, California",19,17,2
1000000US060971539034012,060971539034012,"Block 4012, Block Group 4, Census Tract 1539.03, Sonoma County, California",12,11,1
1000000US060971539034013,060971539034013,"Block 4013, Block Group 4, Census Tract 1539.03, Sonoma County, California",22,22,0
1000000US060971539034014,060971539034014,"Block 4014, Block Group 4, Census Tract 1539.03, Sonoma County, California",21,20,1
1000000US060971539034015,060971539034015,"Block 4015, Block Group 4, Census Tract 1539.03, Sonoma County, California",20,15,5
1000000US060971539034016,060971539034016,"Block 4016, Block Group 4, Census Tract 1539.03, Sonoma County, California",28,25,3
1000000US060971539034017,060971539034017,"Block 4017, Block Group 4, Census Tract 1539.03, Sonoma County, California",8,8,0
1000000US060971539034018,060971539034018,"Block 4018, Block Group 4, Census Tract 1539.03, Sonoma County, California",18,16,2
1000000US060971539034019,060971539034019,"Block 4019, Block Group 4, Census Tract 1539.03, Sonoma County, California",27,27,0
1000000US060971539034020,060971539034020,"Block 4020, Block Group 4, Census Tract 1539.03, Sonoma County, California",15,13,2
1000000US060971539034021,060971539034021,"Block 4021, Block Group 4, Census Tract 1539.03, Sonoma County, California",12,11,1
1000000US060971539034022,060971539034022,"Block 4022, Block Group 4, Census Tract 1539.03, Sonoma County, California",20,19,1
1000000US060971540001000,060971540001000,"Block 1000, Block Group 1, Census Tract 1540, Sonoma County, California",14,12,2
1000000US060971540001001,060971540001001,"Block 1001, Block Group 1, Census Tract 1540, Sonoma County, California",14,10,4
1000000US060971540001002,060971540001002,"Block 1002, Block Group 1, Census Tract 1540, Sonoma County, California",0,0,0
1000000US060971540001003,060971540001003,"Block 1003, Block Group 1, Census Tract 1540, Sonoma County, California",7,7,0
1000000US060971540001004,060971540001004,"Block 1004, Block Group 1, Census Tract 1540, Sonoma County, California",60,40,20
1000000US060971540001005,060971540001005,"Block 1005, Block Group 1, Census Tract 1540, Sonoma County, California",1,0,1
1000000US060971540001006,060971540001006,"Block 1006, Block Group 1, Census Tract 1540, Sonoma County, California",0,0,0
1000000US060971540001007,060971540001007,"Block 1007, Block Group 1, Census Tract 1540, Sonoma County, California",1,0,1
1000000US060971540001008,060971540001008,"Block 1008, Block Group 1, Census Tract 1540, Sonoma County, California",1,1,0
1000000US060971540001009,060971540001009,"Block 1009, Block Group 1, Census Tract 1540, Sonoma County, California",3,0,3
1000000US060971540001010,060971540001010,"Block 1010, Block Group 1, Census Tract 1540, Sonoma County, California",0,0,0
1000000US060971540001011,060971540001011,"Block 1011, Block Group 1, Census Tract 1540, Sonoma County, California",0,0,0
1000000US060971540001012,060971540001012,"Block 1012, Block Group 1, Census Tract 1540, Sonoma County, California",0,0,0
1000000US060971540001013,060971540001013,"Block 1013, Block Group 1, Census Tract 1540, Sonoma County, California",88,58,30
1000000US060971540001014,060971540001014,"Block 1014, Block Group 1, Census Tract 1540, Sonoma County, California",1,1,0
1000000US060971540001015,060971540001015,"Block 1015, Block Group 1, Census Tract 1540, Sonoma County, California",0,0,0
1000000US060971540001016,060971540001016,"Block 1016, Block Group 1, Census Tract 1540, Sonoma County, California",1,1,0
1000000US060971540001017,060971540001017,"Block 1017, Block Group 1, Census Tract 1540, Sonoma County, California",2,1,1
1000000US060971540001018,060971540001018,"Block 1018, Block Group 1, Census Tract 1540, Sonoma County, California",1,1,0
1000000US060971540001019,060971540001019,"Block 1019, Block Group 1, Census Tract 1540, Sonoma County, California",2,2,0
1000000US060971540001020,060971540001020,"Block 1020, Block Group 1, Census Tract 1540, Sonoma County, California",3,1,2
1000000US060971540001021,060971540001021,"Block 1021, Block Group 1, Census Tract 1540, Sonoma County, California",1,0,1
1000000US060971540001022,060971540001022,"Block 1022, Block Group 1, Census Tract 1540, Sonoma County, California",4,3,1
1000000US060971540001023,060971540001023,"Block 1023, Block Group 1, Census Tract 1540, Sonoma County, California",19,9,10
1000000US060971540001024,060971540001024,"Block 1024, Block Group 1, Census Tract 1540, Sonoma County, California",3,3,0
1000000US060971540001025,060971540001025,"Block 1025, Block Group 1, Census Tract 1540, Sonoma County, California",1,0,1
1000000US060971540001026,060971540001026,"Block 1026, Block Group 1, Census Tract 1540, Sonoma County, California",0,0,0
1000000US060971540001027,060971540001027,"Block 1027, Block Group 1, Census Tract 1540, Sonoma County, California",0,0,0
1000000US060971540001028,060971540001028,"Block 1028, Block Group 1, Census Tract 1540, Sonoma County, California",0,0,0
1000000US060971540001029,060971540001029,"Block 1029, Block Group 1, Census Tract 1540, Sonoma County, California",4,0,4
1000000US060971540001030,060971540001030,"Block 1030, Block Group 1, Census Tract 1540, Sonoma County, California",0,0,0
1000000US060971540001031,060971540001031,"Block 1031, Block Group 1, Census Tract 1540, Sonoma County, California",2,2,0
1000000US060971540001032,060971540001032,"Block 1032, Block Group 1, Census Tract 1540, Sonoma County, California",0,0,0
1000000US060971540001033,060971540001033,"Block 1033, Block Group 1, Census Tract 1540, Sonoma County, California",0,0,0
1000000US060971540001034,060971540001034,"Block 1034, Block Group 1, Census Tract 1540, Sonoma County, California",0,0,0
1000000US060971540001035,060971540001035,"Block 1035, Block Group 1, Census Tract 1540, Sonoma County, California",11,7,4
1000000US060971540001036,060971540001036,"Block 1036, Block Group 1, Census Tract 1540, Sonoma County, California",1,1,0
1000000US060971540001037,060971540001037,"Block 1037, Block Group 1, Census Tract 1540, Sonoma County, California",3,3,0
1000000US060971540001038,060971540001038,"Block 1038, Block Group 1, Census Tract 1540, Sonoma County, California",1,0,1
1000000US060971540001039,060971540001039,"Block 1039, Block Group 1, Census Tract 1540, Sonoma County, California",3,1,2
1000000US060971540001040,060971540001040,"Block 1040, Block Group 1, Census Tract 1540, Sonoma County, California",0,0,0
1000000US060971540001041,060971540001041,"Block 1041, Block Group 1, Census Tract 1540, Sonoma County, California",0,0,0
1000000US060971540001042,060971540001042,"Block 1042, Block Group 1, Census Tract 1540, Sonoma County, California",0,0,0
1000000US060971540001043,060971540001043,"Block 1043, Block Group 1, Census Tract 1540, Sonoma County, California",52,42,10
1000000US060971540001044,060971540001044,"Block 1044, Block Group 1, Census Tract 1540, Sonoma County, California",2,1,1
1000000US060971540001045,060971540001045,"Block 1045, Block Group 1, Census Tract 1540, Sonoma County, California",0,0,0
1000000US060971540001046,060971540001046,"Block 1046, Block Group 1, Census Tract 1540, Sonoma County, California",0,0,0
1000000US060971540001047,060971540001047,"Block 1047, Block Group 1, Census Tract 1540, Sonoma County, California",3,2,1
1000000US060971540001048,060971540001048,"Block 1048, Block Group 1, Census Tract 1540, Sonoma County, California",0,0,0
1000000US060971540001049,060971540001049,"Block 1049, Block Group 1, Census Tract 1540, Sonoma County, California",0,0,0
1000000US060971540001050,060971540001050,"Block 1050, Block Group 1, Census Tract 1540, Sonoma County, California",0,0,0
1000000US060971540001051,060971540001051,"Block 1051, Block Group 1, Census Tract 1540, Sonoma County, California",0,0,0
1000000US060971540001052,060971540001052,"Block 1052, Block Group 1, Census Tract 1540, Sonoma County, California",0,0,0
1000000US060971540001053,060971540001053,"Block 1053, Block Group 1, Census Tract 1540, Sonoma County, California",0,0,0
1000000US060971540001054,060971540001054,"Block 1054, Block Group 1, Census Tract 1540, Sonoma County, California",1,1,0
1000000US060971540001055,060971540001055,"Block 1055, Block Group 1, Census Tract 1540, Sonoma County, California",0,0,0
1000000US060971540001056,060971540001056,"Block 1056, Block Group 1, Census Tract 1540, Sonoma County, California",0,0,0
1000000US060971540001057,060971540001057,"Block 1057, Block Group 1, Census Tract 1540, Sonoma County, California",1,1,0
1000000US060971540001058,060971540001058,"Block 1058, Block Group 1, Census Tract 1540, Sonoma County, California",0,0,0
1000000US060971540001059,060971540001059,"Block 1059, Block Group 1, Census Tract 1540, Sonoma County, California",0,0,0
1000000US060971540001060,060971540001060,"Block 1060, Block Group 1, Census Tract 1540, Sonoma County, California",0,0,0
1000000US060971540001061,060971540001061,"Block 1061, Block Group 1, Census Tract 1540, Sonoma County, California",0,0,0
1000000US060971540001062,060971540001062,"Block 1062, Block Group 1, Census Tract 1540, Sonoma County, California",9,4,5
1000000US060971540001063,060971540001063,"Block 1063, Block Group 1, Census Tract 1540, Sonoma County, California",0,0,0
1000000US060971540001064,060971540001064,"Block 1064, Block Group 1, Census Tract 1540, Sonoma County, California",0,0,0
1000000US060971540001065,060971540001065,"Block 1065, Block Group 1, Census Tract 1540, Sonoma County, California",2,2,0
1000000US060971540001066,060971540001066,"Block 1066, Block Group 1, Census Tract 1540, Sonoma County, California",24,16,8
1000000US060971540001067,060971540001067,"Block 1067, Block Group 1, Census Tract 1540, Sonoma County, California",0,0,0
1000000US060971540001068,060971540001068,"Block 1068, Block Group 1, Census Tract 1540, Sonoma County, California",1,1,0
1000000US060971540001069,060971540001069,"Block 1069, Block Group 1, Census Tract 1540, Sonoma County, California",1,1,0
1000000US060971540001070,060971540001070,"Block 1070, Block Group 1, Census Tract 1540, Sonoma County, California",0,0,0
1000000US060971540001071,060971540001071,"Block 1071, Block Group 1, Census Tract 1540, Sonoma County, California",0,0,0
1000000US060971540001072,060971540001072,"Block 1072, Block Group 1, Census Tract 1540, Sonoma County, California",7,6,1
1000000US060971540001073,060971540001073,"Block 1073, Block Group 1, Census Tract 1540, Sonoma County, California",0,0,0
1000000US060971540001074,060971540001074,"Block 1074, Block Group 1, Census Tract 1540, Sonoma County, California",1,0,1
1000000US060971540001075,060971540001075,"Block 1075, Block Group 1, Census Tract 1540, Sonoma County, California",0,0,0
1000000US060971540001076,060971540001076,"Block 1076, Block Group 1, Census Tract 1540, Sonoma County, California",1,1,0
1000000US060971540001077,060971540001077,"Block 1077, Block Group 1, Census Tract 1540, Sonoma County, California",0,0,0
1000000US060971540001078,060971540001078,"Block 1078, Block Group 1, Census Tract 1540, Sonoma County, California",0,0,0
1000000US060971540002000,060971540002000,"Block 2000, Block Group 2, Census Tract 1540, Sonoma County, California",0,0,0
1000000US060971540002001,060971540002001,"Block 2001, Block Group 2, Census Tract 1540, Sonoma County, California",1,0,1
1000000US060971540002002,060971540002002,"Block 2002, Block Group 2, Census Tract 1540, Sonoma County, California",12,12,0
1000000US060971540002003,060971540002003,"Block 2003, Block Group 2, Census Tract 1540, Sonoma County, California",0,0,0
1000000US060971540002004,060971540002004,"Block 2004, Block Group 2, Census Tract 1540, Sonoma County, California",0,0,0
1000000US060971540002005,060971540002005,"Block 2005, Block Group 2, Census Tract 1540, Sonoma County, California",0,0,0
1000000US060971540002006,060971540002006,"Block 2006, Block Group 2, Census Tract 1540, Sonoma County, California",0,0,0
1000000US060971540002007,060971540002007,"Block 2007, Block Group 2, Census Tract 1540, Sonoma County, California",0,0,0
1000000US060971540002008,060971540002008,"Block 2008, Block Group 2, Census Tract 1540, Sonoma County, California",10,7,3
1000000US060971540002009,060971540002009,"Block 2009, Block Group 2, Census Tract 1540, Sonoma County, California",0,0,0
1000000US060971540002010,060971540002010,"Block 2010, Block Group 2, Census Tract 1540, Sonoma County, California",0,0,0
1000000US060971540002011,060971540002011,"Block 2011, Block Group 2, Census Tract 1540, Sonoma County, California",0,0,0
1000000US060971540002012,060971540002012,"Block 2012, Block Group 2, Census Tract 1540, Sonoma County, California",1,1,0
1000000US060971540002013,060971540002013,"Block 2013, Block Group 2, Census Tract 1540, Sonoma County, California",21,15,6
1000000US060971540002014,060971540002014,"Block 2014, Block Group 2, Census Tract 1540, Sonoma County, California",2,1,1
1000000US060971540002015,060971540002015,"Block 2015, Block Group 2, Census Tract 1540, Sonoma County, California",0,0,0
1000000US060971540002016,060971540002016,"Block 2016, Block Group 2, Census Tract 1540, Sonoma County, California",5,4,1
1000000US060971540002017,060971540002017,"Block 2017, Block Group 2, Census Tract 1540, Sonoma County, California",1,1,0
1000000US060971540002018,060971540002018,"Block 2018, Block Group 2, Census Tract 1540, Sonoma County, California",1,1,0
1000000US060971540002019,060971540002019,"Block 2019, Block Group 2, Census Tract 1540, Sonoma County, California",87,73,14
1000000US060971540002020,060971540002020,"Block 2020, Block Group 2, Census Tract 1540, Sonoma County, California",1,0,1
1000000US060971540002021,060971540002021,"Block 2021, Block Group 2, Census Tract 1540, Sonoma County, California",0,0,0
1000000US060971540002022,060971540002022,"Block 2022, Block Group 2, Census Tract 1540, Sonoma County, California",1,0,1
1000000US060971540002023,060971540002023,"Block 2023, Block Group 2, Census Tract 1540, Sonoma County, California",0,0,0
1000000US060971540002024,060971540002024,"Block 2024, Block Group 2, Census Tract 1540, Sonoma County, California",1,1,0
1000000US060971540002025,060971540002025,"Block 2025, Block Group 2, Census Tract 1540, Sonoma County, California",0,0,0
1000000US060971540002026,060971540002026,"Block 2026, Block Group 2, Census Tract 1540, Sonoma County, California",0,0,0
1000000US060971540002027,060971540002027,"Block 2027, Block Group 2, Census Tract 1540, Sonoma County, California",0,0,0
1000000US060971540002028,060971540002028,"Block 2028, Block Group 2, Census Tract 1540, Sonoma County, California",0,0,0
1000000US060971540002029,060971540002029,"Block 2029, Block Group 2, Census Tract 1540, Sonoma County, California",9,8,1
1000000US060971540002030,060971540002030,"Block 2030, Block Group 2, Census Tract 1540, Sonoma County, California",0,0,0
1000000US060971540002031,060971540002031,"Block 2031, Block Group 2, Census Tract 1540, Sonoma County, California",8,5,3
1000000US060971540002032,060971540002032,"Block 2032, Block Group 2, Census Tract 1540, Sonoma County, California",5,3,2
1000000US060971540002033,060971540002033,"Block 2033, Block Group 2, Census Tract 1540, Sonoma County, California",0,0,0
1000000US060971540002034,060971540002034,"Block 2034, Block Group 2, Census Tract 1540, Sonoma County, California",1,1,0
1000000US060971540002035,060971540002035,"Block 2035, Block Group 2, Census Tract 1540, Sonoma County, California",1,0,1
1000000US060971540002036,060971540002036,"Block 2036, Block Group 2, Census Tract 1540, Sonoma County, California",5,5,0
1000000US060971540002037,060971540002037,"Block 2037, Block Group 2, Census Tract 1540, Sonoma County, California",2,1,1
1000000US060971540002038,060971540002038,"Block 2038, Block Group 2, Census Tract 1540, Sonoma County, California",3,2,1
1000000US060971540002039,060971540002039,"Block 2039, Block Group 2, Census Tract 1540, Sonoma County, California",35,26,9
1000000US060971540002040,060971540002040,"Block 2040, Block Group 2, Census Tract 1540, Sonoma County, California",0,0,0
1000000US060971540002041,060971540002041,"Block 2041, Block Group 2, Census Tract 1540, Sonoma County, California",0,0,0
1000000US060971540002042,060971540002042,"Block 2042, Block Group 2, Census Tract 1540, Sonoma County, California",22,19,3
1000000US060971540002043,060971540002043,"Block 2043, Block Group 2, Census Tract 1540, Sonoma County, California",0,0,0
1000000US060971540002044,060971540002044,"Block 2044, Block Group 2, Census Tract 1540, Sonoma County, California",1,1,0
1000000US060971540002045,060971540002045,"Block 2045, Block Group 2, Census Tract 1540, Sonoma County, California",1,1,0
1000000US060971540002046,060971540002046,"Block 2046, Block Group 2, Census Tract 1540, Sonoma County, California",0,0,0
1000000US060971540002047,060971540002047,"Block 2047, Block Group 2, Census Tract 1540, Sonoma County, California",0,0,0
1000000US060971540002048,060971540002048,"Block 2048, Block Group 2, Census Tract 1540, Sonoma County, California",0,0,0
1000000US060971540002049,060971540002049,"Block 2049, Block Group 2, Census Tract 1540, Sonoma County, California",2,2,0
1000000US060971540002050,060971540002050,"Block 2050, Block Group 2, Census Tract 1540, Sonoma County, California",0,0,0
1000000US060971540002051,060971540002051,"Block 2051, Block Group 2, Census Tract 1540, Sonoma County, California",17,14,3
1000000US060971540002052,060971540002052,"Block 2052, Block Group 2, Census Tract 1540, Sonoma County, California",1,1,0
1000000US060971540002053,060971540002053,"Block 2053, Block Group 2, Census Tract 1540, Sonoma County, California",0,0,0
1000000US060971540002054,060971540002054,"Block 2054, Block Group 2, Census Tract 1540, Sonoma County, California",0,0,0
1000000US060971540002055,060971540002055,"Block 2055, Block Group 2, Census Tract 1540, Sonoma County, California",6,6,0
1000000US060971540002056,060971540002056,"Block 2056, Block Group 2, Census Tract 1540, Sonoma County, California",1,1,0
1000000US060971540002057,060971540002057,"Block 2057, Block Group 2, Census Tract 1540, Sonoma County, California",34,21,13
1000000US060971540002058,060971540002058,"Block 2058, Block Group 2, Census Tract 1540, Sonoma County, California",0,0,0
1000000US060971540002059,060971540002059,"Block 2059, Block Group 2, Census Tract 1540, Sonoma County, California",11,7,4
1000000US060971540002060,060971540002060,"Block 2060, Block Group 2, Census Tract 1540, Sonoma County, California",0,0,0
1000000US060971540002061,060971540002061,"Block 2061, Block Group 2, Census Tract 1540, Sonoma County, California",0,0,0
1000000US060971540002062,060971540002062,"Block 2062, Block Group 2, Census Tract 1540, Sonoma County, California",2,2,0
1000000US060971540002063,060971540002063,"Block 2063, Block Group 2, Census Tract 1540, Sonoma County, California",0,0,0
1000000US060971540002064,060971540002064,"Block 2064, Block Group 2, Census Tract 1540, Sonoma County, California",0,0,0
1000000US060971540002065,060971540002065,"Block 2065, Block Group 2, Census Tract 1540, Sonoma County, California",1,1,0
1000000US060971540002066,060971540002066,"Block 2066, Block Group 2, Census Tract 1540, Sonoma County, California",36,23,13
1000000US060971540002067,060971540002067,"Block 2067, Block Group 2, Census Tract 1540, Sonoma County, California",0,0,0
1000000US060971540002068,060971540002068,"Block 2068, Block Group 2, Census Tract 1540, Sonoma County, California",0,0,0
1000000US060971540002069,060971540002069,"Block 2069, Block Group 2, Census Tract 1540, Sonoma County, California",0,0,0
1000000US060971540002070,060971540002070,"Block 2070, Block Group 2, Census Tract 1540, Sonoma County, California",0,0,0
1000000US060971540002071,060971540002071,"Block 2071, Block Group 2, Census Tract 1540, Sonoma County, California",5,1,4
1000000US060971540002072,060971540002072,"Block 2072, Block Group 2, Census Tract 1540, Sonoma County, California",0,0,0
1000000US060971540002073,060971540002073,"Block 2073, Block Group 2, Census Tract 1540, Sonoma County, California",0,0,0
1000000US060971540002074,060971540002074,"Block 2074, Block Group 2, Census Tract 1540, Sonoma County, California",4,1,3
1000000US060971540002075,060971540002075,"Block 2075, Block Group 2, Census Tract 1540, Sonoma County, California",1,0,1
1000000US060971540002076,060971540002076,"Block 2076, Block Group 2, Census Tract 1540, Sonoma County, California",0,0,0
1000000US060971540002077,060971540002077,"Block 2077, Block Group 2, Census Tract 1540, Sonoma County, California",3,3,0
1000000US060971540002078,060971540002078,"Block 2078, Block Group 2, Census Tract 1540, Sonoma County, California",3,3,0
1000000US060971540002079,060971540002079,"Block 2079, Block Group 2, Census Tract 1540, Sonoma County, California",0,0,0
1000000US060971540002080,060971540002080,"Block 2080, Block Group 2, Census Tract 1540, Sonoma County, California",0,0,0
1000000US060971540002081,060971540002081,"Block 2081, Block Group 2, Census Tract 1540, Sonoma County, California",0,0,0
1000000US060971540002082,060971540002082,"Block 2082, Block Group 2, Census Tract 1540, Sonoma County, California",0,0,0
1000000US060971540002083,060971540002083,"Block 2083, Block Group 2, Census Tract 1540, Sonoma County, California",0,0,0
1000000US060971540002084,060971540002084,"Block 2084, Block Group 2, Census Tract 1540, Sonoma County, California",0,0,0
1000000US060971540002085,060971540002085,"Block 2085, Block Group 2, Census Tract 1540, Sonoma County, California",2,1,1
1000000US060971540002086,060971540002086,"Block 2086, Block Group 2, Census Tract 1540, Sonoma County, California",0,0,0
1000000US060971540002087,060971540002087,"Block 2087, Block Group 2, Census Tract 1540, Sonoma County, California",0,0,0
1000000US060971540002088,060971540002088,"Block 2088, Block Group 2, Census Tract 1540, Sonoma County, California",0,0,0
1000000US060971540002089,060971540002089,"Block 2089, Block Group 2, Census Tract 1540, Sonoma County, California",0,0,0
1000000US060971540002090,060971540002090,"Block 2090, Block Group 2, Census Tract 1540, Sonoma County, California",12,11,1
1000000US060971540002091,060971540002091,"Block 2091, Block Group 2, Census Tract 1540, Sonoma County, California",2,2,0
1000000US060971540002092,060971540002092,"Block 2092, Block Group 2, Census Tract 1540, Sonoma County, California",0,0,0
1000000US060971540002093,060971540002093,"Block 2093, Block Group 2, Census Tract 1540, Sonoma County, California",7,5,2
1000000US060971540002094,060971540002094,"Block 2094, Block Group 2, Census Tract 1540, Sonoma County, California",0,0,0
1000000US060971540002095,060971540002095,"Block 2095, Block Group 2, Census Tract 1540, Sonoma County, California",0,0,0
1000000US060971540002096,060971540002096,"Block 2096, Block Group 2, Census Tract 1540, Sonoma County, California",0,0,0
1000000US060971540002097,060971540002097,"Block 2097, Block Group 2, Census Tract 1540, Sonoma County, California",0,0,0
1000000US060971540003000,060971540003000,"Block 3000, Block Group 3, Census Tract 1540, Sonoma County, California",0,0,0
1000000US060971540003001,060971540003001,"Block 3001, Block Group 3, Census Tract 1540, Sonoma County, California",17,14,3
1000000US060971540003002,060971540003002,"Block 3002, Block Group 3, Census Tract 1540, Sonoma County, California",0,0,0
1000000US060971540003003,060971540003003,"Block 3003, Block Group 3, Census Tract 1540, Sonoma County, California",0,0,0
1000000US060971540003004,060971540003004,"Block 3004, Block Group 3, Census Tract 1540, Sonoma County, California",2,2,0
1000000US060971540003005,060971540003005,"Block 3005, Block Group 3, Census Tract 1540, Sonoma County, California",80,73,7
1000000US060971540003006,060971540003006,"Block 3006, Block Group 3, Census Tract 1540, Sonoma County, California",0,0,0
1000000US060971540003007,060971540003007,"Block 3007, Block Group 3, Census Tract 1540, Sonoma County, California",1,1,0
1000000US060971540003008,060971540003008,"Block 3008, Block Group 3, Census Tract 1540, Sonoma County, California",6,6,0
1000000US060971540003009,060971540003009,"Block 3009, Block Group 3, Census Tract 1540, Sonoma County, California",4,4,0
1000000US060971540003010,060971540003010,"Block 3010, Block Group 3, Census Tract 1540, Sonoma County, California",6,5,1
1000000US060971540003011,060971540003011,"Block 3011, Block Group 3, Census Tract 1540, Sonoma County, California",50,41,9
1000000US060971540003012,060971540003012,"Block 3012, Block Group 3, Census Tract 1540, Sonoma County, California",2,2,0
1000000US060971540003013,060971540003013,"Block 3013, Block Group 3, Census Tract 1540, Sonoma County, California",0,0,0
1000000US060971540003014,060971540003014,"Block 3014, Block Group 3, Census Tract 1540, Sonoma County, California",0,0,0
1000000US060971540003015,060971540003015,"Block 3015, Block Group 3, Census Tract 1540, Sonoma County, California",0,0,0
1000000US060971540003016,060971540003016,"Block 3016, Block Group 3, Census Tract 1540, Sonoma County, California",1,1,0
1000000US060971540003017,060971540003017,"Block 3017, Block Group 3, Census Tract 1540, Sonoma County, California",0,0,0
1000000US060971540003018,060971540003018,"Block 3018, Block Group 3, Census Tract 1540, Sonoma County, California",0,0,0
1000000US060971540003019,060971540003019,"Block 3019, Block Group 3, Census Tract 1540, Sonoma County, California",111,85,26
1000000US060971540003020,060971540003020,"Block 3020, Block Group 3, Census Tract 1540, Sonoma County, California",0,0,0
1000000US060971540003021,060971540003021,"Block 3021, Block Group 3, Census Tract 1540, Sonoma County, California",0,0,0
1000000US060971540003022,060971540003022,"Block 3022, Block Group 3, Census Tract 1540, Sonoma County, California",0,0,0
1000000US060971540003023,060971540003023,"Block 3023, Block Group 3, Census Tract 1540, Sonoma County, California",22,17,5
1000000US060971540003024,060971540003024,"Block 3024, Block Group 3, Census Tract 1540, Sonoma County, California",64,43,21
1000000US060971540003025,060971540003025,"Block 3025, Block Group 3, Census Tract 1540, Sonoma County, California",2,1,1
1000000US060971540003026,060971540003026,"Block 3026, Block Group 3, Census Tract 1540, Sonoma County, California",3,3,0
1000000US060971540003027,060971540003027,"Block 3027, Block Group 3, Census Tract 1540, Sonoma County, California",0,0,0
1000000US060971540003028,060971540003028,"Block 3028, Block Group 3, Census Tract 1540, Sonoma County, California",9,4,5
1000000US060971540003029,060971540003029,"Block 3029, Block Group 3, Census Tract 1540, Sonoma County, California",1,0,1
1000000US060971540003030,060971540003030,"Block 3030, Block Group 3, Census Tract 1540, Sonoma County, California",0,0,0
1000000US060971540003031,060971540003031,"Block 3031, Block Group 3, Census Tract 1540, Sonoma County, California",2,2,0
1000000US060971540003032,060971540003032,"Block 3032, Block Group 3, Census Tract 1540, Sonoma County, California",11,8,3
1000000US060971540003033,060971540003033,"Block 3033, Block Group 3, Census Tract 1540, Sonoma County, California",0,0,0
1000000US060971540003034,060971540003034,"Block 3034, Block Group 3, Census Tract 1540, Sonoma County, California",1,1,0
1000000US060971540003035,060971540003035,"Block 3035, Block Group 3, Census Tract 1540, Sonoma County, California",0,0,0
1000000US060971540003036,060971540003036,"Block 3036, Block Group 3, Census Tract 1540, Sonoma County, California",0,0,0
1000000US060971540003037,060971540003037,"Block 3037, Block Group 3, Census Tract 1540, Sonoma County, California",0,0,0
1000000US060971540003038,060971540003038,"Block 3038, Block Group 3, Census Tract 1540, Sonoma County, California",15,14,1
1000000US060971540003039,060971540003039,"Block 3039, Block Group 3, Census Tract 1540, Sonoma County, California",26,25,1
1000000US060971540003040,060971540003040,"Block 3040, Block Group 3, Census Tract 1540, Sonoma County, California",0,0,0
1000000US060971540003041,060971540003041,"Block 3041, Block Group 3, Census Tract 1540, Sonoma County, California",53,42,11
1000000US060971540003042,060971540003042,"Block 3042, Block Group 3, Census Tract 1540, Sonoma County, California",2,1,1
1000000US060971540003043,060971540003043,"Block 3043, Block Group 3, Census Tract 1540, Sonoma County, California",0,0,0
1000000US060971540003044,060971540003044,"Block 3044, Block Group 3, Census Tract 1540, Sonoma County, California",1,0,1
1000000US060971540003045,060971540003045,"Block 3045, Block Group 3, Census Tract 1540, Sonoma County, California",0,0,0
1000000US060971540003046,060971540003046,"Block 3046, Block Group 3, Census Tract 1540, Sonoma County, California",2,2,0
1000000US060971540003047,060971540003047,"Block 3047, Block Group 3, Census Tract 1540, Sonoma County, California",0,0,0
1000000US060971540003048,060971540003048,"Block 3048, Block Group 3, Census Tract 1540, Sonoma County, California",0,0,0
1000000US060971540003049,060971540003049,"Block 3049, Block Group 3, Census Tract 1540, Sonoma County, California",11,7,4
1000000US060971540003050,060971540003050,"Block 3050, Block Group 3, Census Tract 1540, Sonoma County, California",88,70,18
1000000US060971540003051,060971540003051,"Block 3051, Block Group 3, Census Tract 1540, Sonoma County, California",1,1,0
1000000US060971540003052,060971540003052,"Block 3052, Block Group 3, Census Tract 1540, Sonoma County, California",25,25,0
1000000US060971540003053,060971540003053,"Block 3053, Block Group 3, Census Tract 1540, Sonoma County, California",4,2,2
1000000US060971540003054,060971540003054,"Block 3054, Block Group 3, Census Tract 1540, Sonoma County, California",21,21,0
1000000US060971540003055,060971540003055,"Block 3055, Block Group 3, Census Tract 1540, Sonoma County, California",0,0,0
1000000US060971540003056,060971540003056,"Block 3056, Block Group 3, Census Tract 1540, Sonoma County, California",0,0,0
1000000US060971540003057,060971540003057,"Block 3057, Block Group 3, Census Tract 1540, Sonoma County, California",0,0,0
1000000US060971540003058,060971540003058,"Block 3058, Block Group 3, Census Tract 1540, Sonoma County, California",22,21,1
1000000US060971540003059,060971540003059,"Block 3059, Block Group 3, Census Tract 1540, Sonoma County, California",1,1,0
1000000US060971540003060,060971540003060,"Block 3060, Block Group 3, Census Tract 1540, Sonoma County, California",0,0,0
1000000US060971540003061,060971540003061,"Block 3061, Block Group 3, Census Tract 1540, Sonoma County, California",0,0,0
1000000US060971540003062,060971540003062,"Block 3062, Block Group 3, Census Tract 1540, Sonoma County, California",1,1,0
1000000US060971540003063,060971540003063,"Block 3063, Block Group 3, Census Tract 1540, Sonoma County, California",0,0,0
1000000US060971541001000,060971541001000,"Block 1000, Block Group 1, Census Tract 1541, Sonoma County, California",6,3,3
1000000US060971541001001,060971541001001,"Block 1001, Block Group 1, Census Tract 1541, Sonoma County, California",16,13,3
1000000US060971541001002,060971541001002,"Block 1002, Block Group 1, Census Tract 1541, Sonoma County, California",12,11,1
1000000US060971541001003,060971541001003,"Block 1003, Block Group 1, Census Tract 1541, Sonoma County, California",11,10,1
1000000US060971541001004,060971541001004,"Block 1004, Block Group 1, Census Tract 1541, Sonoma County, California",32,31,1
1000000US060971541001005,060971541001005,"Block 1005, Block Group 1, Census Tract 1541, Sonoma County, California",3,3,0
1000000US060971541001006,060971541001006,"Block 1006, Block Group 1, Census Tract 1541, Sonoma County, California",5,4,1
1000000US060971541001007,060971541001007,"Block 1007, Block Group 1, Census Tract 1541, Sonoma County, California",0,0,0
1000000US060971541001008,060971541001008,"Block 1008, Block Group 1, Census Tract 1541, Sonoma County, California",5,4,1
1000000US060971541001009,060971541001009,"Block 1009, Block Group 1, Census Tract 1541, Sonoma County, California",1,1,0
1000000US060971541001010,060971541001010,"Block 1010, Block Group 1, Census Tract 1541, Sonoma County, California",0,0,0
1000000US060971541001011,060971541001011,"Block 1011, Block Group 1, Census Tract 1541, Sonoma County, California",0,0,0
1000000US060971541001012,060971541001012,"Block 1012, Block Group 1, Census Tract 1541, Sonoma County, California",1,1,0
1000000US060971541001013,060971541001013,"Block 1013, Block Group 1, Census Tract 1541, Sonoma County, California",1,1,0
1000000US060971541001014,060971541001014,"Block 1014, Block Group 1, Census Tract 1541, Sonoma County, California",0,0,0
1000000US060971541001015,060971541001015,"Block 1015, Block Group 1, Census Tract 1541, Sonoma County, California",2,1,1
1000000US060971541001016,060971541001016,"Block 1016, Block Group 1, Census Tract 1541, Sonoma County, California",6,5,1
1000000US060971541001017,060971541001017,"Block 1017, Block Group 1, Census Tract 1541, Sonoma County, California",3,3,0
1000000US060971541001018,060971541001018,"Block 1018, Block Group 1, Census Tract 1541, Sonoma County, California",0,0,0
1000000US060971541001019,060971541001019,"Block 1019, Block Group 1, Census Tract 1541, Sonoma County, California",0,0,0
1000000US060971541001020,060971541001020,"Block 1020, Block Group 1, Census Tract 1541, Sonoma County, California",0,0,0
1000000US060971541001021,060971541001021,"Block 1021, Block Group 1, Census Tract 1541, Sonoma County, California",0,0,0
1000000US060971541001022,060971541001022,"Block 1022, Block Group 1, Census Tract 1541, Sonoma County, California",5,4,1
1000000US060971541001023,060971541001023,"Block 1023, Block Group 1, Census Tract 1541, Sonoma County, California",0,0,0
1000000US060971541001024,060971541001024,"Block 1024, Block Group 1, Census Tract 1541, Sonoma County, California",0,0,0
1000000US060971541001025,060971541001025,"Block 1025, Block Group 1, Census Tract 1541, Sonoma County, California",0,0,0
1000000US060971541001026,060971541001026,"Block 1026, Block Group 1, Census Tract 1541, Sonoma County, California",0,0,0
1000000US060971541001027,060971541001027,"Block 1027, Block Group 1, Census Tract 1541, Sonoma County, California",0,0,0
1000000US060971541001028,060971541001028,"Block 1028, Block Group 1, Census Tract 1541, Sonoma County, California",0,0,0
1000000US060971541001029,060971541001029,"Block 1029, Block Group 1, Census Tract 1541, Sonoma County, California",0,0,0
1000000US060971541001030,060971541001030,"Block 1030, Block Group 1, Census Tract 1541, Sonoma County, California",0,0,0
1000000US060971541001031,060971541001031,"Block 1031, Block Group 1, Census Tract 1541, Sonoma County, California",0,0,0
1000000US060971541001032,060971541001032,"Block 1032, Block Group 1, Census Tract 1541, Sonoma County, California",15,14,1
1000000US060971541001033,060971541001033,"Block 1033, Block Group 1, Census Tract 1541, Sonoma County, California",0,0,0
1000000US060971541001034,060971541001034,"Block 1034, Block Group 1, Census Tract 1541, Sonoma County, California",0,0,0
1000000US060971541001035,060971541001035,"Block 1035, Block Group 1, Census Tract 1541, Sonoma County, California",1,0,1
1000000US060971541001036,060971541001036,"Block 1036, Block Group 1, Census Tract 1541, Sonoma County, California",0,0,0
1000000US060971541001037,060971541001037,"Block 1037, Block Group 1, Census Tract 1541, Sonoma County, California",0,0,0
1000000US060971541001038,060971541001038,"Block 1038, Block Group 1, Census Tract 1541, Sonoma County, California",0,0,0
1000000US060971541001039,060971541001039,"Block 1039, Block Group 1, Census Tract 1541, Sonoma County, California",0,0,0
1000000US060971541001040,060971541001040,"Block 1040, Block Group 1, Census Tract 1541, Sonoma County, California",0,0,0
1000000US060971541001041,060971541001041,"Block 1041, Block Group 1, Census Tract 1541, Sonoma County, California",0,0,0
1000000US060971541001042,060971541001042,"Block 1042, Block Group 1, Census Tract 1541, Sonoma County, California",0,0,0
1000000US060971541001043,060971541001043,"Block 1043, Block Group 1, Census Tract 1541, Sonoma County, California",1,1,0
1000000US060971541001044,060971541001044,"Block 1044, Block Group 1, Census Tract 1541, Sonoma County, California",0,0,0
1000000US060971541001045,060971541001045,"Block 1045, Block Group 1, Census Tract 1541, Sonoma County, California",2,2,0
1000000US060971541001046,060971541001046,"Block 1046, Block Group 1, Census Tract 1541, Sonoma County, California",1,1,0
1000000US060971541001047,060971541001047,"Block 1047, Block Group 1, Census Tract 1541, Sonoma County, California",15,13,2
1000000US060971541001048,060971541001048,"Block 1048, Block Group 1, Census Tract 1541, Sonoma County, California",2,1,1
1000000US060971541001049,060971541001049,"Block 1049, Block Group 1, Census Tract 1541, Sonoma County, California",65,54,11
1000000US060971541001050,060971541001050,"Block 1050, Block Group 1, Census Tract 1541, Sonoma County, California",0,0,0
1000000US060971541001051,060971541001051,"Block 1051, Block Group 1, Census Tract 1541, Sonoma County, California",3,3,0
1000000US060971541001052,060971541001052,"Block 1052, Block Group 1, Census Tract 1541, Sonoma County, California",1,1,0
1000000US060971541001053,060971541001053,"Block 1053, Block Group 1, Census Tract 1541, Sonoma County, California",0,0,0
1000000US060971541001054,060971541001054,"Block 1054, Block Group 1, Census Tract 1541, Sonoma County, California",2,0,2
1000000US060971541001055,060971541001055,"Block 1055, Block Group 1, Census Tract 1541, Sonoma County, California",1,1,0
1000000US060971541001056,060971541001056,"Block 1056, Block Group 1, Census Tract 1541, Sonoma County, California",0,0,0
1000000US060971541001057,060971541001057,"Block 1057, Block Group 1, Census Tract 1541, Sonoma County, California",0,0,0
1000000US060971541001058,060971541001058,"Block 1058, Block Group 1, Census Tract 1541, Sonoma County, California",1,1,0
1000000US060971541001059,060971541001059,"Block 1059, Block Group 1, Census Tract 1541, Sonoma County, California",2,1,1
1000000US060971541001060,060971541001060,"Block 1060, Block Group 1, Census Tract 1541, Sonoma County, California",0,0,0
1000000US060971541001061,060971541001061,"Block 1061, Block Group 1, Census Tract 1541, Sonoma County, California",1,1,0
1000000US060971541001062,060971541001062,"Block 1062, Block Group 1, Census Tract 1541, Sonoma County, California",0,0,0
1000000US060971541001063,060971541001063,"Block 1063, Block Group 1, Census Tract 1541, Sonoma County, California",0,0,0
1000000US060971541001064,060971541001064,"Block 1064, Block Group 1, Census Tract 1541, Sonoma County, California",0,0,0
1000000US060971541001065,060971541001065,"Block 1065, Block Group 1, Census Tract 1541, Sonoma County, California",21,21,0
1000000US060971541001066,060971541001066,"Block 1066, Block Group 1, Census Tract 1541, Sonoma County, California",2,2,0
1000000US060971541001067,060971541001067,"Block 1067, Block Group 1, Census Tract 1541, Sonoma County, California",10,9,1
1000000US060971541002000,060971541002000,"Block 2000, Block Group 2, Census Tract 1541, Sonoma County, California",2,0,2
1000000US060971541002001,060971541002001,"Block 2001, Block Group 2, Census Tract 1541, Sonoma County, California",0,0,0
1000000US060971541002002,060971541002002,"Block 2002, Block Group 2, Census Tract 1541, Sonoma County, California",4,4,0
1000000US060971541002003,060971541002003,"Block 2003, Block Group 2, Census Tract 1541, Sonoma County, California",0,0,0
1000000US060971541002004,060971541002004,"Block 2004, Block Group 2, Census Tract 1541, Sonoma County, California",0,0,0
1000000US060971541002005,060971541002005,"Block 2005, Block Group 2, Census Tract 1541, Sonoma County, California",0,0,0
1000000US060971541002006,060971541002006,"Block 2006, Block Group 2, Census Tract 1541, Sonoma County, California",0,0,0
1000000US060971541002007,060971541002007,"Block 2007, Block Group 2, Census Tract 1541, Sonoma County, California",1,1,0
1000000US060971541002008,060971541002008,"Block 2008, Block Group 2, Census Tract 1541, Sonoma County, California",0,0,0
1000000US060971541002009,060971541002009,"Block 2009, Block Group 2, Census Tract 1541, Sonoma County, California",20,13,7
1000000US060971541002010,060971541002010,"Block 2010, Block Group 2, Census Tract 1541, Sonoma County, California",0,0,0
1000000US060971541002011,060971541002011,"Block 2011, Block Group 2, Census Tract 1541, Sonoma County, California",1,1,0
1000000US060971541002012,060971541002012,"Block 2012, Block Group 2, Census Tract 1541, Sonoma County, California",3,3,0
1000000US060971541002013,060971541002013,"Block 2013, Block Group 2, Census Tract 1541, Sonoma County, California",5,2,3
1000000US060971541002014,060971541002014,"Block 2014, Block Group 2, Census Tract 1541, Sonoma County, California",0,0,0
1000000US060971541002015,060971541002015,"Block 2015, Block Group 2, Census Tract 1541, Sonoma County, California",0,0,0
1000000US060971541002016,060971541002016,"Block 2016, Block Group 2, Census Tract 1541, Sonoma County, California",1,1,0
1000000US060971541002017,060971541002017,"Block 2017, Block Group 2, Census Tract 1541, Sonoma County, California",3,2,1
1000000US060971541002018,060971541002018,"Block 2018, Block Group 2, Census Tract 1541, Sonoma County, California",6,5,1
1000000US060971541002019,060971541002019,"Block 2019, Block Group 2, Census Tract 1541, Sonoma County, California",1,0,1
1000000US060971541002020,060971541002020,"Block 2020, Block Group 2, Census Tract 1541, Sonoma County, California",0,0,0
1000000US060971541002021,060971541002021,"Block 2021, Block Group 2, Census Tract 1541, Sonoma County, California",4,4,0
1000000US060971541002022,060971541002022,"Block 2022, Block Group 2, Census Tract 1541, Sonoma County, California",8,7,1
1000000US060971541002023,060971541002023,"Block 2023, Block Group 2, Census Tract 1541, Sonoma County, California",2,1,1
1000000US060971541002024,060971541002024,"Block 2024, Block Group 2, Census Tract 1541, Sonoma County, California",151,140,11
1000000US060971541002025,060971541002025,"Block 2025, Block Group 2, Census Tract 1541, Sonoma County, California",1,1,0
1000000US060971541002026,060971541002026,"Block 2026, Block Group 2, Census Tract 1541, Sonoma County, California",11,10,1
1000000US060971541002027,060971541002027,"Block 2027, Block Group 2, Census Tract 1541, Sonoma County, California",10,8,2
1000000US060971541002028,060971541002028,"Block 2028, Block Group 2, Census Tract 1541, Sonoma County, California",0,0,0
1000000US060971541002029,060971541002029,"Block 2029, Block Group 2, Census Tract 1541, Sonoma County, California",0,0,0
1000000US060971541002030,060971541002030,"Block 2030, Block Group 2, Census Tract 1541, Sonoma County, California",0,0,0
1000000US060971541002031,060971541002031,"Block 2031, Block Group 2, Census Tract 1541, Sonoma County, California",51,38,13
1000000US060971541002032,060971541002032,"Block 2032, Block Group 2, Census Tract 1541, Sonoma County, California",0,0,0
1000000US060971541002033,060971541002033,"Block 2033, Block Group 2, Census Tract 1541, Sonoma County, California",1,1,0
1000000US060971541002034,060971541002034,"Block 2034, Block Group 2, Census Tract 1541, Sonoma County, California",7,7,0
1000000US060971541002035,060971541002035,"Block 2035, Block Group 2, Census Tract 1541, Sonoma County, California",6,4,2
1000000US060971541002036,060971541002036,"Block 2036, Block Group 2, Census Tract 1541, Sonoma County, California",15,13,2
1000000US060971541002037,060971541002037,"Block 2037, Block Group 2, Census Tract 1541, Sonoma County, California",0,0,0
1000000US060971541002038,060971541002038,"Block 2038, Block Group 2, Census Tract 1541, Sonoma County, California",10,10,0
1000000US060971541002039,060971541002039,"Block 2039, Block Group 2, Census Tract 1541, Sonoma County, California",4,4,0
1000000US060971541002040,060971541002040,"Block 2040, Block Group 2, Census Tract 1541, Sonoma County, California",0,0,0
1000000US060971541002041,060971541002041,"Block 2041, Block Group 2, Census Tract 1541, Sonoma County, California",7,5,2
1000000US060971541002042,060971541002042,"Block 2042, Block Group 2, Census Tract 1541, Sonoma County, California",2,2,0
1000000US060971541002043,060971541002043,"Block 2043, Block Group 2, Census Tract 1541, Sonoma County, California",0,0,0
1000000US060971541002044,060971541002044,"Block 2044, Block Group 2, Census Tract 1541, Sonoma County, California",0,0,0
1000000US060971541002045,060971541002045,"Block 2045, Block Group 2, Census Tract 1541, Sonoma County, California",6,5,1
1000000US060971541002046,060971541002046,"Block 2046, Block Group 2, Census Tract 1541, Sonoma County, California",0,0,0
1000000US060971541002047,060971541002047,"Block 2047, Block Group 2, Census Tract 1541, Sonoma County, California",0,0,0
1000000US060971541002048,060971541002048,"Block 2048, Block Group 2, Census Tract 1541, Sonoma County, California",0,0,0
1000000US060971541002049,060971541002049,"Block 2049, Block Group 2, Census Tract 1541, Sonoma County, California",0,0,0
1000000US060971541002050,060971541002050,"Block 2050, Block Group 2, Census Tract 1541, Sonoma County, California",11,11,0
1000000US060971541002051,060971541002051,"Block 2051, Block Group 2, Census Tract 1541, Sonoma County, California",3,3,0
1000000US060971541002052,060971541002052,"Block 2052, Block Group 2, Census Tract 1541, Sonoma County, California",0,0,0
1000000US060971541002053,060971541002053,"Block 2053, Block Group 2, Census Tract 1541, Sonoma County, California",6,4,2
1000000US060971541002054,060971541002054,"Block 2054, Block Group 2, Census Tract 1541, Sonoma County, California",1,1,0
1000000US060971541002055,060971541002055,"Block 2055, Block Group 2, Census Tract 1541, Sonoma County, California",0,0,0
1000000US060971541002056,060971541002056,"Block 2056, Block Group 2, Census Tract 1541, Sonoma County, California",0,0,0
1000000US060971541002057,060971541002057,"Block 2057, Block Group 2, Census Tract 1541, Sonoma County, California",0,0,0
1000000US060971541002058,060971541002058,"Block 2058, Block Group 2, Census Tract 1541, Sonoma County, California",0,0,0
1000000US060971541002059,060971541002059,"Block 2059, Block Group 2, Census Tract 1541, Sonoma County, California",0,0,0
1000000US060971541002060,060971541002060,"Block 2060, Block Group 2, Census Tract 1541, Sonoma County, California",1,1,0
1000000US060971541002061,060971541002061,"Block 2061, Block Group 2, Census Tract 1541, Sonoma County, California",0,0,0
1000000US060971541002062,060971541002062,"Block 2062, Block Group 2, Census Tract 1541, Sonoma County, California",0,0,0
1000000US060971541002063,060971541002063,"Block 2063, Block Group 2, Census Tract 1541, Sonoma County, California",0,0,0
1000000US060971541002064,060971541002064,"Block 2064, Block Group 2, Census Tract 1541, Sonoma County, California",0,0,0
1000000US060971541002065,060971541002065,"Block 2065, Block Group 2, Census Tract 1541, Sonoma County, California",3,3,0
1000000US060971541002066,060971541002066,"Block 2066, Block Group 2, Census Tract 1541, Sonoma County, California",0,0,0
1000000US060971541002067,060971541002067,"Block 2067, Block Group 2, Census Tract 1541, Sonoma County, California",1,1,0
1000000US060971541002068,060971541002068,"Block 2068, Block Group 2, Census Tract 1541, Sonoma County, California",0,0,0
1000000US060971541002069,060971541002069,"Block 2069, Block Group 2, Census Tract 1541, Sonoma County, California",7,7,0
1000000US060971541002070,060971541002070,"Block 2070, Block Group 2, Census Tract 1541, Sonoma County, California",0,0,0
1000000US060971541002071,060971541002071,"Block 2071, Block Group 2, Census Tract 1541, Sonoma County, California",0,0,0
1000000US060971541002072,060971541002072,"Block 2072, Block Group 2, Census Tract 1541, Sonoma County, California",0,0,0
1000000US060971541002073,060971541002073,"Block 2073, Block Group 2, Census Tract 1541, Sonoma County, California",0,0,0
1000000US060971541002074,060971541002074,"Block 2074, Block Group 2, Census Tract 1541, Sonoma County, California",0,0,0
1000000US060971541002075,060971541002075,"Block 2075, Block Group 2, Census Tract 1541, Sonoma County, California",3,3,0
1000000US060971541002076,060971541002076,"Block 2076, Block Group 2, Census Tract 1541, Sonoma County, California",2,2,0
1000000US060971541002077,060971541002077,"Block 2077, Block Group 2, Census Tract 1541, Sonoma County, California",61,53,8
1000000US060971541002078,060971541002078,"Block 2078, Block Group 2, Census Tract 1541, Sonoma County, California",0,0,0
1000000US060971541002079,060971541002079,"Block 2079, Block Group 2, Census Tract 1541, Sonoma County, California",0,0,0
1000000US060971541002080,060971541002080,"Block 2080, Block Group 2, Census Tract 1541, Sonoma County, California",0,0,0
1000000US060971541002081,060971541002081,"Block 2081, Block Group 2, Census Tract 1541, Sonoma County, California",1,1,0
1000000US060971541002082,060971541002082,"Block 2082, Block Group 2, Census Tract 1541, Sonoma County, California",6,6,0
1000000US060971541002083,060971541002083,"Block 2083, Block Group 2, Census Tract 1541, Sonoma County, California",56,48,8
1000000US060971541002084,060971541002084,"Block 2084, Block Group 2, Census Tract 1541, Sonoma County, California",5,5,0
1000000US060971541002085,060971541002085,"Block 2085, Block Group 2, Census Tract 1541, Sonoma County, California",0,0,0
1000000US060971541002086,060971541002086,"Block 2086, Block Group 2, Census Tract 1541, Sonoma County, California",0,0,0
1000000US060971541002087,060971541002087,"Block 2087, Block Group 2, Census Tract 1541, Sonoma County, California",1,1,0
1000000US060971541002088,060971541002088,"Block 2088, Block Group 2, Census Tract 1541, Sonoma County, California",0,0,0
1000000US060971541002089,060971541002089,"Block 2089, Block Group 2, Census Tract 1541, Sonoma County, California",0,0,0
1000000US060971541002090,060971541002090,"Block 2090, Block Group 2, Census Tract 1541, Sonoma County, California",1,1,0
1000000US060971541002091,060971541002091,"Block 2091, Block Group 2, Census Tract 1541, Sonoma County, California",0,0,0
1000000US060971541002092,060971541002092,"Block 2092, Block Group 2, Census Tract 1541, Sonoma County, California",0,0,0
1000000US060971541002093,060971541002093,"Block 2093, Block Group 2, Census Tract 1541, Sonoma County, California",0,0,0
1000000US060971541002094,060971541002094,"Block 2094, Block Group 2, Census Tract 1541, Sonoma County, California",0,0,0
1000000US060971541002095,060971541002095,"Block 2095, Block Group 2, Census Tract 1541, Sonoma County, California",0,0,0
1000000US060971541002096,060971541002096,"Block 2096, Block Group 2, Census Tract 1541, Sonoma County, California",0,0,0
1000000US060971541002097,060971541002097,"Block 2097, Block Group 2, Census Tract 1541, Sonoma County, California",2,1,1
1000000US060971541002098,060971541002098,"Block 2098, Block Group 2, Census Tract 1541, Sonoma County, California",35,29,6
1000000US060971541002099,060971541002099,"Block 2099, Block Group 2, Census Tract 1541, Sonoma County, California",7,7,0
1000000US060971541002100,060971541002100,"Block 2100, Block Group 2, Census Tract 1541, Sonoma County, California",0,0,0
1000000US060971541002101,060971541002101,"Block 2101, Block Group 2, Census Tract 1541, Sonoma County, California",0,0,0
1000000US060971541002102,060971541002102,"Block 2102, Block Group 2, Census Tract 1541, Sonoma County, California",9,9,0
1000000US060971541002103,060971541002103,"Block 2103, Block Group 2, Census Tract 1541, Sonoma County, California",0,0,0
1000000US060971541002104,060971541002104,"Block 2104, Block Group 2, Census Tract 1541, Sonoma County, California",0,0,0
1000000US060971541002105,060971541002105,"Block 2105, Block Group 2, Census Tract 1541, Sonoma County, California",0,0,0
1000000US060971541002106,060971541002106,"Block 2106, Block Group 2, Census Tract 1541, Sonoma County, California",11,9,2
1000000US060971541002107,060971541002107,"Block 2107, Block Group 2, Census Tract 1541, Sonoma County, California",0,0,0
1000000US060971541002108,060971541002108,"Block 2108, Block Group 2, Census Tract 1541, Sonoma County, California",15,10,5
1000000US060971541002109,060971541002109,"Block 2109, Block Group 2, Census Tract 1541, Sonoma County, California",0,0,0
1000000US060971541002110,060971541002110,"Block 2110, Block Group 2, Census Tract 1541, Sonoma County, California",0,0,0
1000000US060971541002111,060971541002111,"Block 2111, Block Group 2, Census Tract 1541, Sonoma County, California",0,0,0
1000000US060971541002112,060971541002112,"Block 2112, Block Group 2, Census Tract 1541, Sonoma County, California",0,0,0
1000000US060971541002113,060971541002113,"Block 2113, Block Group 2, Census Tract 1541, Sonoma County, California",0,0,0
1000000US060971541002114,060971541002114,"Block 2114, Block Group 2, Census Tract 1541, Sonoma County, California",0,0,0
1000000US060971541002115,060971541002115,"Block 2115, Block Group 2, Census Tract 1541, Sonoma County, California",1,1,0
1000000US060971541002116,060971541002116,"Block 2116, Block Group 2, Census Tract 1541, Sonoma County, California",1,1,0
1000000US060971541003000,060971541003000,"Block 3000, Block Group 3, Census Tract 1541, Sonoma County, California",0,0,0
1000000US060971541003001,060971541003001,"Block 3001, Block Group 3, Census Tract 1541, Sonoma County, California",0,0,0
1000000US060971541003002,060971541003002,"Block 3002, Block Group 3, Census Tract 1541, Sonoma County, California",0,0,0
1000000US060971541003003,060971541003003,"Block 3003, Block Group 3, Census Tract 1541, Sonoma County, California",0,0,0
1000000US060971541003004,060971541003004,"Block 3004, Block Group 3, Census Tract 1541, Sonoma County, California",0,0,0
1000000US060971541003005,060971541003005,"Block 3005, Block Group 3, Census Tract 1541, Sonoma County, California",0,0,0
1000000US060971541003006,060971541003006,"Block 3006, Block Group 3, Census Tract 1541, Sonoma County, California",0,0,0
1000000US060971541003007,060971541003007,"Block 3007, Block Group 3, Census Tract 1541, Sonoma County, California",2,1,1
1000000US060971541003008,060971541003008,"Block 3008, Block Group 3, Census Tract 1541, Sonoma County, California",0,0,0
1000000US060971541003009,060971541003009,"Block 3009, Block Group 3, Census Tract 1541, Sonoma County, California",0,0,0
1000000US060971541003010,060971541003010,"Block 3010, Block Group 3, Census Tract 1541, Sonoma County, California",1,1,0
1000000US060971541003011,060971541003011,"Block 3011, Block Group 3, Census Tract 1541, Sonoma County, California",0,0,0
1000000US060971541003012,060971541003012,"Block 3012, Block Group 3, Census Tract 1541, Sonoma County, California",0,0,0
1000000US060971541003013,060971541003013,"Block 3013, Block Group 3, Census Tract 1541, Sonoma County, California",0,0,0
1000000US060971541003014,060971541003014,"Block 3014, Block Group 3, Census Tract 1541, Sonoma County, California",0,0,0
1000000US060971541003015,060971541003015,"Block 3015, Block Group 3, Census Tract 1541, Sonoma County, California",0,0,0
1000000US060971541003016,060971541003016,"Block 3016, Block Group 3, Census Tract 1541, Sonoma County, California",0,0,0
1000000US060971541003017,060971541003017,"Block 3017, Block Group 3, Census Tract 1541, Sonoma County, California",0,0,0
1000000US060971541003018,060971541003018,"Block 3018, Block Group 3, Census Tract 1541, Sonoma County, California",2,2,0
1000000US060971541003019,060971541003019,"Block 3019, Block Group 3, Census Tract 1541, Sonoma County, California",0,0,0
1000000US060971541003020,060971541003020,"Block 3020, Block Group 3, Census Tract 1541, Sonoma County, California",6,2,4
1000000US060971541003021,060971541003021,"Block 3021, Block Group 3, Census Tract 1541, Sonoma County, California",0,0,0
1000000US060971541003022,060971541003022,"Block 3022, Block Group 3, Census Tract 1541, Sonoma County, California",0,0,0
1000000US060971541003023,060971541003023,"Block 3023, Block Group 3, Census Tract 1541, Sonoma County, California",1,1,0
1000000US060971541003024,060971541003024,"Block 3024, Block Group 3, Census Tract 1541, Sonoma County, California",0,0,0
1000000US060971541003025,060971541003025,"Block 3025, Block Group 3, Census Tract 1541, Sonoma County, California",0,0,0
1000000US060971541003026,060971541003026,"Block 3026, Block Group 3, Census Tract 1541, Sonoma County, California",35,33,2
1000000US060971541003027,060971541003027,"Block 3027, Block Group 3, Census Tract 1541, Sonoma County, California",5,5,0
1000000US060971541003028,060971541003028,"Block 3028, Block Group 3, Census Tract 1541, Sonoma County, California",0,0,0
1000000US060971541003029,060971541003029,"Block 3029, Block Group 3, Census Tract 1541, Sonoma County, California",1,1,0
1000000US060971541003030,060971541003030,"Block 3030, Block Group 3, Census Tract 1541, Sonoma County, California",0,0,0
1000000US060971541003031,060971541003031,"Block 3031, Block Group 3, Census Tract 1541, Sonoma County, California",0,0,0
1000000US060971541003032,060971541003032,"Block 3032, Block Group 3, Census Tract 1541, Sonoma County, California",3,3,0
1000000US060971541003033,060971541003033,"Block 3033, Block Group 3, Census Tract 1541, Sonoma County, California",0,0,0
1000000US060971541003034,060971541003034,"Block 3034, Block Group 3, Census Tract 1541, Sonoma County, California",0,0,0
1000000US060971541003035,060971541003035,"Block 3035, Block Group 3, Census Tract 1541, Sonoma County, California",0,0,0
1000000US060971541003036,060971541003036,"Block 3036, Block Group 3, Census Tract 1541, Sonoma County, California",0,0,0
1000000US060971541003037,060971541003037,"Block 3037, Block Group 3, Census Tract 1541, Sonoma County, California",0,0,0
1000000US060971541003038,060971541003038,"Block 3038, Block Group 3, Census Tract 1541, Sonoma County, California",0,0,0
1000000US060971541003039,060971541003039,"Block 3039, Block Group 3, Census Tract 1541, Sonoma County, California",0,0,0
1000000US060971541003040,060971541003040,"Block 3040, Block Group 3, Census Tract 1541, Sonoma County, California",0,0,0
1000000US060971541003041,060971541003041,"Block 3041, Block Group 3, Census Tract 1541, Sonoma County, California",0,0,0
1000000US060971541003042,060971541003042,"Block 3042, Block Group 3, Census Tract 1541, Sonoma County, California",2,2,0
1000000US060971541003043,060971541003043,"Block 3043, Block Group 3, Census Tract 1541, Sonoma County, California",0,0,0
1000000US060971541003044,060971541003044,"Block 3044, Block Group 3, Census Tract 1541, Sonoma County, California",0,0,0
1000000US060971541003045,060971541003045,"Block 3045, Block Group 3, Census Tract 1541, Sonoma County, California",0,0,0
1000000US060971541003046,060971541003046,"Block 3046, Block Group 3, Census Tract 1541, Sonoma County, California",0,0,0
1000000US060971541003047,060971541003047,"Block 3047, Block Group 3, Census Tract 1541, Sonoma County, California",0,0,0
1000000US060971541003048,060971541003048,"Block 3048, Block Group 3, Census Tract 1541, Sonoma County, California",0,0,0
1000000US060971541003049,060971541003049,"Block 3049, Block Group 3, Census Tract 1541, Sonoma County, California",0,0,0
1000000US060971541003050,060971541003050,"Block 3050, Block Group 3, Census Tract 1541, Sonoma County, California",0,0,0
1000000US060971541003051,060971541003051,"Block 3051, Block Group 3, Census Tract 1541, Sonoma County, California",0,0,0
1000000US060971541003052,060971541003052,"Block 3052, Block Group 3, Census Tract 1541, Sonoma County, California",0,0,0
1000000US060971541003053,060971541003053,"Block 3053, Block Group 3, Census Tract 1541, Sonoma County, California",0,0,0
1000000US060971541003054,060971541003054,"Block 3054, Block Group 3, Census Tract 1541, Sonoma County, California",0,0,0
1000000US060971541003055,060971541003055,"Block 3055, Block Group 3, Census Tract 1541, Sonoma County, California",0,0,0
1000000US060971541003056,060971541003056,"Block 3056, Block Group 3, Census Tract 1541, Sonoma County, California",0,0,0
1000000US060971541003057,060971541003057,"Block 3057, Block Group 3, Census Tract 1541, Sonoma County, California",0,0,0
1000000US060971541003058,060971541003058,"Block 3058, Block Group 3, Census Tract 1541, Sonoma County, California",0,0,0
1000000US060971541003059,060971541003059,"Block 3059, Block Group 3, Census Tract 1541, Sonoma County, California",0,0,0
1000000US060971541003060,060971541003060,"Block 3060, Block Group 3, Census Tract 1541, Sonoma County, California",0,0,0
1000000US060971541003061,060971541003061,"Block 3061, Block Group 3, Census Tract 1541, Sonoma County, California",0,0,0
1000000US060971541003062,060971541003062,"Block 3062, Block Group 3, Census Tract 1541, Sonoma County, California",0,0,0
1000000US060971541003063,060971541003063,"Block 3063, Block Group 3, Census Tract 1541, Sonoma County, California",0,0,0
1000000US060971541003064,060971541003064,"Block 3064, Block Group 3, Census Tract 1541, Sonoma County, California",0,0,0
1000000US060971541003065,060971541003065,"Block 3065, Block Group 3, Census Tract 1541, Sonoma County, California",0,0,0
1000000US060971541003066,060971541003066,"Block 3066, Block Group 3, Census Tract 1541, Sonoma County, California",0,0,0
1000000US060971541003067,060971541003067,"Block 3067, Block Group 3, Census Tract 1541, Sonoma County, California",0,0,0
1000000US060971541003068,060971541003068,"Block 3068, Block Group 3, Census Tract 1541, Sonoma County, California",0,0,0
1000000US060971541003069,060971541003069,"Block 3069, Block Group 3, Census Tract 1541, Sonoma County, California",0,0,0
1000000US060971541003070,060971541003070,"Block 3070, Block Group 3, Census Tract 1541, Sonoma County, California",0,0,0
1000000US060971541003071,060971541003071,"Block 3071, Block Group 3, Census Tract 1541, Sonoma County, California",0,0,0
1000000US060971541003072,060971541003072,"Block 3072, Block Group 3, Census Tract 1541, Sonoma County, California",0,0,0
1000000US060971541003073,060971541003073,"Block 3073, Block Group 3, Census Tract 1541, Sonoma County, California",0,0,0
1000000US060971541003074,060971541003074,"Block 3074, Block Group 3, Census Tract 1541, Sonoma County, California",0,0,0
1000000US060971541003075,060971541003075,"Block 3075, Block Group 3, Census Tract 1541, Sonoma County, California",0,0,0
1000000US060971541003076,060971541003076,"Block 3076, Block Group 3, Census Tract 1541, Sonoma County, California",0,0,0
1000000US060971541003077,060971541003077,"Block 3077, Block Group 3, Census Tract 1541, Sonoma County, California",0,0,0
1000000US060971541003078,060971541003078,"Block 3078, Block Group 3, Census Tract 1541, Sonoma County, California",3,3,0
1000000US060971541003079,060971541003079,"Block 3079, Block Group 3, Census Tract 1541, Sonoma County, California",0,0,0
1000000US060971541003080,060971541003080,"Block 3080, Block Group 3, Census Tract 1541, Sonoma County, California",0,0,0
1000000US060971541003081,060971541003081,"Block 3081, Block Group 3, Census Tract 1541, Sonoma County, California",0,0,0
1000000US060971541003082,060971541003082,"Block 3082, Block Group 3, Census Tract 1541, Sonoma County, California",0,0,0
1000000US060971541003083,060971541003083,"Block 3083, Block Group 3, Census Tract 1541, Sonoma County, California",2,0,2
1000000US060971541003084,060971541003084,"Block 3084, Block Group 3, Census Tract 1541, Sonoma County, California",0,0,0
1000000US060971541003085,060971541003085,"Block 3085, Block Group 3, Census Tract 1541, Sonoma County, California",31,26,5
1000000US060971541003086,060971541003086,"Block 3086, Block Group 3, Census Tract 1541, Sonoma County, California",0,0,0
1000000US060971541003087,060971541003087,"Block 3087, Block Group 3, Census Tract 1541, Sonoma County, California",6,5,1
1000000US060971541003088,060971541003088,"Block 3088, Block Group 3, Census Tract 1541, Sonoma County, California",11,8,3
1000000US060971541003089,060971541003089,"Block 3089, Block Group 3, Census Tract 1541, Sonoma County, California",0,0,0
1000000US060971541003090,060971541003090,"Block 3090, Block Group 3, Census Tract 1541, Sonoma County, California",5,4,1
1000000US060971541003091,060971541003091,"Block 3091, Block Group 3, Census Tract 1541, Sonoma County, California",0,0,0
1000000US060971541003092,060971541003092,"Block 3092, Block Group 3, Census Tract 1541, Sonoma County, California",9,8,1
1000000US060971541003093,060971541003093,"Block 3093, Block Group 3, Census Tract 1541, Sonoma County, California",5,4,1
1000000US060971541003094,060971541003094,"Block 3094, Block Group 3, Census Tract 1541, Sonoma County, California",4,4,0
1000000US060971541003095,060971541003095,"Block 3095, Block Group 3, Census Tract 1541, Sonoma County, California",4,0,4
1000000US060971541003096,060971541003096,"Block 3096, Block Group 3, Census Tract 1541, Sonoma County, California",2,1,1
1000000US060971541003097,060971541003097,"Block 3097, Block Group 3, Census Tract 1541, Sonoma County, California",0,0,0
1000000US060971541003098,060971541003098,"Block 3098, Block Group 3, Census Tract 1541, Sonoma County, California",1,0,1
1000000US060971541003099,060971541003099,"Block 3099, Block Group 3, Census Tract 1541, Sonoma County, California",0,0,0
1000000US060971541003100,060971541003100,"Block 3100, Block Group 3, Census Tract 1541, Sonoma County, California",0,0,0
1000000US060971541003101,060971541003101,"Block 3101, Block Group 3, Census Tract 1541, Sonoma County, California",0,0,0
1000000US060971541003102,060971541003102,"Block 3102, Block Group 3, Census Tract 1541, Sonoma County, California",20,15,5
1000000US060971541003103,060971541003103,"Block 3103, Block Group 3, Census Tract 1541, Sonoma County, California",0,0,0
1000000US060971541003104,060971541003104,"Block 3104, Block Group 3, Census Tract 1541, Sonoma County, California",0,0,0
1000000US060971541003105,060971541003105,"Block 3105, Block Group 3, Census Tract 1541, Sonoma County, California",0,0,0
1000000US060971541003106,060971541003106,"Block 3106, Block Group 3, Census Tract 1541, Sonoma County, California",0,0,0
1000000US060971541003107,060971541003107,"Block 3107, Block Group 3, Census Tract 1541, Sonoma County, California",2,1,1
1000000US060971541003108,060971541003108,"Block 3108, Block Group 3, Census Tract 1541, Sonoma County, California",0,0,0
1000000US060971541003109,060971541003109,"Block 3109, Block Group 3, Census Tract 1541, Sonoma County, California",0,0,0
1000000US060971541003110,060971541003110,"Block 3110, Block Group 3, Census Tract 1541, Sonoma County, California",0,0,0
1000000US060971541003111,060971541003111,"Block 3111, Block Group 3, Census Tract 1541, Sonoma County, California",2,0,2
1000000US060971541003112,060971541003112,"Block 3112, Block Group 3, Census Tract 1541, Sonoma County, California",0,0,0
1000000US060971541003113,060971541003113,"Block 3113, Block Group 3, Census Tract 1541, Sonoma County, California",0,0,0
1000000US060971541003114,060971541003114,"Block 3114, Block Group 3, Census Tract 1541, Sonoma County, California",0,0,0
1000000US060971541003115,060971541003115,"Block 3115, Block Group 3, Census Tract 1541, Sonoma County, California",117,89,28
1000000US060971541003116,060971541003116,"Block 3116, Block Group 3, Census Tract 1541, Sonoma County, California",0,0,0
1000000US060971541003117,060971541003117,"Block 3117, Block Group 3, Census Tract 1541, Sonoma County, California",0,0,0
1000000US060971541003118,060971541003118,"Block 3118, Block Group 3, Census Tract 1541, Sonoma County, California",43,38,5
1000000US060971541003119,060971541003119,"Block 3119, Block Group 3, Census Tract 1541, Sonoma County, California",0,0,0
1000000US060971541003120,060971541003120,"Block 3120, Block Group 3, Census Tract 1541, Sonoma County, California",11,10,1
1000000US060971541003121,060971541003121,"Block 3121, Block Group 3, Census Tract 1541, Sonoma County, California",1,1,0
1000000US060971541003122,060971541003122,"Block 3122, Block Group 3, Census Tract 1541, Sonoma County, California",0,0,0
1000000US060971541003123,060971541003123,"Block 3123, Block Group 3, Census Tract 1541, Sonoma County, California",0,0,0
1000000US060971541003124,060971541003124,"Block 3124, Block Group 3, Census Tract 1541, Sonoma County, California",0,0,0
1000000US060971541003125,060971541003125,"Block 3125, Block Group 3, Census Tract 1541, Sonoma County, California",0,0,0
1000000US060971541003126,060971541003126,"Block 3126, Block Group 3, Census Tract 1541, Sonoma County, California",2,0,2
1000000US060971541003127,060971541003127,"Block 3127, Block Group 3, Census Tract 1541, Sonoma County, California",7,4,3
1000000US060971541003128,060971541003128,"Block 3128, Block Group 3, Census Tract 1541, Sonoma County, California",0,0,0
1000000US060971541003129,060971541003129,"Block 3129, Block Group 3, Census Tract 1541, Sonoma County, California",0,0,0
1000000US060971541003130,060971541003130,"Block 3130, Block Group 3, Census Tract 1541, Sonoma County, California",0,0,0
1000000US060971541003131,060971541003131,"Block 3131, Block Group 3, Census Tract 1541, Sonoma County, California",0,0,0
1000000US060971541003132,060971541003132,"Block 3132, Block Group 3, Census Tract 1541, Sonoma County, California",1,0,1
1000000US060971541003133,060971541003133,"Block 3133, Block Group 3, Census Tract 1541, Sonoma County, California",11,6,5
1000000US060971541003134,060971541003134,"Block 3134, Block Group 3, Census Tract 1541, Sonoma County, California",0,0,0
1000000US060971541003135,060971541003135,"Block 3135, Block Group 3, Census Tract 1541, Sonoma County, California",2,2,0
1000000US060971541003136,060971541003136,"Block 3136, Block Group 3, Census Tract 1541, Sonoma County, California",0,0,0
1000000US060971541003137,060971541003137,"Block 3137, Block Group 3, Census Tract 1541, Sonoma County, California",0,0,0
1000000US060971541003138,060971541003138,"Block 3138, Block Group 3, Census Tract 1541, Sonoma County, California",0,0,0
1000000US060971541003139,060971541003139,"Block 3139, Block Group 3, Census Tract 1541, Sonoma County, California",0,0,0
1000000US060971541003140,060971541003140,"Block 3140, Block Group 3, Census Tract 1541, Sonoma County, California",1,1,0
1000000US060971541003141,060971541003141,"Block 3141, Block Group 3, Census Tract 1541, Sonoma County, California",0,0,0
1000000US060971541003142,060971541003142,"Block 3142, Block Group 3, Census Tract 1541, Sonoma County, California",24,15,9
1000000US060971541003143,060971541003143,"Block 3143, Block Group 3, Census Tract 1541, Sonoma County, California",16,8,8
1000000US060971541003144,060971541003144,"Block 3144, Block Group 3, Census Tract 1541, Sonoma County, California",0,0,0
1000000US060971541003145,060971541003145,"Block 3145, Block Group 3, Census Tract 1541, Sonoma County, California",2,2,0
1000000US060971541003146,060971541003146,"Block 3146, Block Group 3, Census Tract 1541, Sonoma County, California",0,0,0
1000000US060971541003147,060971541003147,"Block 3147, Block Group 3, Census Tract 1541, Sonoma County, California",0,0,0
1000000US060971541003148,060971541003148,"Block 3148, Block Group 3, Census Tract 1541, Sonoma County, California",0,0,0
1000000US060971541003149,060971541003149,"Block 3149, Block Group 3, Census Tract 1541, Sonoma County, California",14,10,4
1000000US060971541003150,060971541003150,"Block 3150, Block Group 3, Census Tract 1541, Sonoma County, California",14,8,6
1000000US060971541003151,060971541003151,"Block 3151, Block Group 3, Census Tract 1541, Sonoma County, California",9,7,2
1000000US060971541003152,060971541003152,"Block 3152, Block Group 3, Census Tract 1541, Sonoma County, California",18,16,2
1000000US060971541003153,060971541003153,"Block 3153, Block Group 3, Census Tract 1541, Sonoma County, California",0,0,0
1000000US060971541003154,060971541003154,"Block 3154, Block Group 3, Census Tract 1541, Sonoma County, California",0,0,0
1000000US060971541003155,060971541003155,"Block 3155, Block Group 3, Census Tract 1541, Sonoma County, California",9,8,1
1000000US060971541003156,060971541003156,"Block 3156, Block Group 3, Census Tract 1541, Sonoma County, California",0,0,0
1000000US060971541003157,060971541003157,"Block 3157, Block Group 3, Census Tract 1541, Sonoma County, California",0,0,0
1000000US060971541003158,060971541003158,"Block 3158, Block Group 3, Census Tract 1541, Sonoma County, California",0,0,0
1000000US060971541003159,060971541003159,"Block 3159, Block Group 3, Census Tract 1541, Sonoma County, California",1,1,0
1000000US060971541003160,060971541003160,"Block 3160, Block Group 3, Census Tract 1541, Sonoma County, California",0,0,0
1000000US060971541003161,060971541003161,"Block 3161, Block Group 3, Census Tract 1541, Sonoma County, California",0,0,0
1000000US060971541003162,060971541003162,"Block 3162, Block Group 3, Census Tract 1541, Sonoma County, California",0,0,0
1000000US060971541003163,060971541003163,"Block 3163, Block Group 3, Census Tract 1541, Sonoma County, California",0,0,0
1000000US060971541003164,060971541003164,"Block 3164, Block Group 3, Census Tract 1541, Sonoma County, California",2,2,0
1000000US060971541003165,060971541003165,"Block 3165, Block Group 3, Census Tract 1541, Sonoma County, California",0,0,0
1000000US060971541003166,060971541003166,"Block 3166, Block Group 3, Census Tract 1541, Sonoma County, California",1,0,1
1000000US060971541003167,060971541003167,"Block 3167, Block Group 3, Census Tract 1541, Sonoma County, California",0,0,0
1000000US060971541003168,060971541003168,"Block 3168, Block Group 3, Census Tract 1541, Sonoma County, California",1,0,1
1000000US060971541003169,060971541003169,"Block 3169, Block Group 3, Census Tract 1541, Sonoma County, California",0,0,0
1000000US060971541003170,060971541003170,"Block 3170, Block Group 3, Census Tract 1541, Sonoma County, California",0,0,0
1000000US060971541003171,060971541003171,"Block 3171, Block Group 3, Census Tract 1541, Sonoma County, California",0,0,0
1000000US060971541003172,060971541003172,"Block 3172, Block Group 3, Census Tract 1541, Sonoma County, California",2,1,1
1000000US060971541003173,060971541003173,"Block 3173, Block Group 3, Census Tract 1541, Sonoma County, California",0,0,0
1000000US060971541003174,060971541003174,"Block 3174, Block Group 3, Census Tract 1541, Sonoma County, California",0,0,0
1000000US060971541003175,060971541003175,"Block 3175, Block Group 3, Census Tract 1541, Sonoma County, California",12,10,2
1000000US060971541003176,060971541003176,"Block 3176, Block Group 3, Census Tract 1541, Sonoma County, California",0,0,0
1000000US060971541003177,060971541003177,"Block 3177, Block Group 3, Census Tract 1541, Sonoma County, California",0,0,0
1000000US060971541003178,060971541003178,"Block 3178, Block Group 3, Census Tract 1541, Sonoma County, California",0,0,0
1000000US060971541003179,060971541003179,"Block 3179, Block Group 3, Census Tract 1541, Sonoma County, California",0,0,0
1000000US060971541003180,060971541003180,"Block 3180, Block Group 3, Census Tract 1541, Sonoma County, California",2,1,1
1000000US060971541003181,060971541003181,"Block 3181, Block Group 3, Census Tract 1541, Sonoma County, California",0,0,0
1000000US060971541003182,060971541003182,"Block 3182, Block Group 3, Census Tract 1541, Sonoma County, California",0,0,0
1000000US060971541003183,060971541003183,"Block 3183, Block Group 3, Census Tract 1541, Sonoma County, California",1,1,0
1000000US060971541003184,060971541003184,"Block 3184, Block Group 3, Census Tract 1541, Sonoma County, California",0,0,0
1000000US060971541003185,060971541003185,"Block 3185, Block Group 3, Census Tract 1541, Sonoma County, California",0,0,0
1000000US060971541003186,060971541003186,"Block 3186, Block Group 3, Census Tract 1541, Sonoma County, California",0,0,0
1000000US060971541003187,060971541003187,"Block 3187, Block Group 3, Census Tract 1541, Sonoma County, California",0,0,0
1000000US060971541003188,060971541003188,"Block 3188, Block Group 3, Census Tract 1541, Sonoma County, California",1,1,0
1000000US060971541003189,060971541003189,"Block 3189, Block Group 3, Census Tract 1541, Sonoma County, California",0,0,0
1000000US060971541003190,060971541003190,"Block 3190, Block Group 3, Census Tract 1541, Sonoma County, California",0,0,0
1000000US060971541003191,060971541003191,"Block 3191, Block Group 3, Census Tract 1541, Sonoma County, California",0,0,0
1000000US060971541003192,060971541003192,"Block 3192, Block Group 3, Census Tract 1541, Sonoma County, California",0,0,0
1000000US060971541003193,060971541003193,"Block 3193, Block Group 3, Census Tract 1541, Sonoma County, California",0,0,0
1000000US060971541003194,060971541003194,"Block 3194, Block Group 3, Census Tract 1541, Sonoma County, California",0,0,0
1000000US060971541003195,060971541003195,"Block 3195, Block Group 3, Census Tract 1541, Sonoma County, California",5,3,2
1000000US060971541003196,060971541003196,"Block 3196, Block Group 3, Census Tract 1541, Sonoma County, California",0,0,0
1000000US060971541003197,060971541003197,"Block 3197, Block Group 3, Census Tract 1541, Sonoma County, California",0,0,0
1000000US060971541003198,060971541003198,"Block 3198, Block Group 3, Census Tract 1541, Sonoma County, California",0,0,0
1000000US060971541003199,060971541003199,"Block 3199, Block Group 3, Census Tract 1541, Sonoma County, California",0,0,0
1000000US060971541003200,060971541003200,"Block 3200, Block Group 3, Census Tract 1541, Sonoma County, California",0,0,0
1000000US060971541003201,060971541003201,"Block 3201, Block Group 3, Census Tract 1541, Sonoma County, California",0,0,0
1000000US060971541003202,060971541003202,"Block 3202, Block Group 3, Census Tract 1541, Sonoma County, California",0,0,0
1000000US060971541003203,060971541003203,"Block 3203, Block Group 3, Census Tract 1541, Sonoma County, California",0,0,0
1000000US060971541003204,060971541003204,"Block 3204, Block Group 3, Census Tract 1541, Sonoma County, California",0,0,0
1000000US060971541003205,060971541003205,"Block 3205, Block Group 3, Census Tract 1541, Sonoma County, California",0,0,0
1000000US060971541003206,060971541003206,"Block 3206, Block Group 3, Census Tract 1541, Sonoma County, California",0,0,0
1000000US060971541003207,060971541003207,"Block 3207, Block Group 3, Census Tract 1541, Sonoma County, California",0,0,0
1000000US060971541003208,060971541003208,"Block 3208, Block Group 3, Census Tract 1541, Sonoma County, California",0,0,0
1000000US060971541003209,060971541003209,"Block 3209, Block Group 3, Census Tract 1541, Sonoma County, California",0,0,0
1000000US060971541003210,060971541003210,"Block 3210, Block Group 3, Census Tract 1541, Sonoma County, California",0,0,0
1000000US060971541004000,060971541004000,"Block 4000, Block Group 4, Census Tract 1541, Sonoma County, California",4,2,2
1000000US060971541004001,060971541004001,"Block 4001, Block Group 4, Census Tract 1541, Sonoma County, California",0,0,0
1000000US060971541004002,060971541004002,"Block 4002, Block Group 4, Census Tract 1541, Sonoma County, California",1,1,0
1000000US060971541004003,060971541004003,"Block 4003, Block Group 4, Census Tract 1541, Sonoma County, California",0,0,0
1000000US060971541004004,060971541004004,"Block 4004, Block Group 4, Census Tract 1541, Sonoma County, California",1,1,0
1000000US060971541004005,060971541004005,"Block 4005, Block Group 4, Census Tract 1541, Sonoma County, California",0,0,0
1000000US060971541004006,060971541004006,"Block 4006, Block Group 4, Census Tract 1541, Sonoma County, California",0,0,0
1000000US060971541004007,060971541004007,"Block 4007, Block Group 4, Census Tract 1541, Sonoma County, California",0,0,0
1000000US060971541004008,060971541004008,"Block 4008, Block Group 4, Census Tract 1541, Sonoma County, California",0,0,0
1000000US060971541004009,060971541004009,"Block 4009, Block Group 4, Census Tract 1541, Sonoma County, California",0,0,0
1000000US060971541004010,060971541004010,"Block 4010, Block Group 4, Census Tract 1541, Sonoma County, California",0,0,0
1000000US060971541004011,060971541004011,"Block 4011, Block Group 4, Census Tract 1541, Sonoma County, California",0,0,0
1000000US060971541004012,060971541004012,"Block 4012, Block Group 4, Census Tract 1541, Sonoma County, California",0,0,0
1000000US060971541004013,060971541004013,"Block 4013, Block Group 4, Census Tract 1541, Sonoma County, California",0,0,0
1000000US060971541004014,060971541004014,"Block 4014, Block Group 4, Census Tract 1541, Sonoma County, California",0,0,0
1000000US060971541004015,060971541004015,"Block 4015, Block Group 4, Census Tract 1541, Sonoma County, California",0,0,0
1000000US060971541004016,060971541004016,"Block 4016, Block Group 4, Census Tract 1541, Sonoma County, California",3,2,1
1000000US060971541004017,060971541004017,"Block 4017, Block Group 4, Census Tract 1541, Sonoma County, California",0,0,0
1000000US060971541004018,060971541004018,"Block 4018, Block Group 4, Census Tract 1541, Sonoma County, California",0,0,0
1000000US060971541004019,060971541004019,"Block 4019, Block Group 4, Census Tract 1541, Sonoma County, California",0,0,0
1000000US060971541004020,060971541004020,"Block 4020, Block Group 4, Census Tract 1541, Sonoma County, California",0,0,0
1000000US060971541004021,060971541004021,"Block 4021, Block Group 4, Census Tract 1541, Sonoma County, California",0,0,0
1000000US060971541004022,060971541004022,"Block 4022, Block Group 4, Census Tract 1541, Sonoma County, California",0,0,0
1000000US060971541004023,060971541004023,"Block 4023, Block Group 4, Census Tract 1541, Sonoma County, California",0,0,0
1000000US060971541004024,060971541004024,"Block 4024, Block Group 4, Census Tract 1541, Sonoma County, California",41,36,5
1000000US060971541004025,060971541004025,"Block 4025, Block Group 4, Census Tract 1541, Sonoma County, California",1,0,1
1000000US060971541004026,060971541004026,"Block 4026, Block Group 4, Census Tract 1541, Sonoma County, California",0,0,0
1000000US060971541004027,060971541004027,"Block 4027, Block Group 4, Census Tract 1541, Sonoma County, California",0,0,0
1000000US060971541004028,060971541004028,"Block 4028, Block Group 4, Census Tract 1541, Sonoma County, California",1,1,0
1000000US060971541004029,060971541004029,"Block 4029, Block Group 4, Census Tract 1541, Sonoma County, California",1,1,0
1000000US060971541004030,060971541004030,"Block 4030, Block Group 4, Census Tract 1541, Sonoma County, California",0,0,0
1000000US060971541004031,060971541004031,"Block 4031, Block Group 4, Census Tract 1541, Sonoma County, California",0,0,0
1000000US060971541004032,060971541004032,"Block 4032, Block Group 4, Census Tract 1541, Sonoma County, California",0,0,0
1000000US060971541004033,060971541004033,"Block 4033, Block Group 4, Census Tract 1541, Sonoma County, California",2,1,1
1000000US060971541004034,060971541004034,"Block 4034, Block Group 4, Census Tract 1541, Sonoma County, California",1,1,0
1000000US060971541004035,060971541004035,"Block 4035, Block Group 4, Census Tract 1541, Sonoma County, California",0,0,0
1000000US060971541004036,060971541004036,"Block 4036, Block Group 4, Census Tract 1541, Sonoma County, California",5,4,1
1000000US060971541004037,060971541004037,"Block 4037, Block Group 4, Census Tract 1541, Sonoma County, California",0,0,0
1000000US060971541004038,060971541004038,"Block 4038, Block Group 4, Census Tract 1541, Sonoma County, California",10,8,2
1000000US060971541004039,060971541004039,"Block 4039, Block Group 4, Census Tract 1541, Sonoma County, California",0,0,0
1000000US060971541004040,060971541004040,"Block 4040, Block Group 4, Census Tract 1541, Sonoma County, California",0,0,0
1000000US060971541004041,060971541004041,"Block 4041, Block Group 4, Census Tract 1541, Sonoma County, California",0,0,0
1000000US060971541004042,060971541004042,"Block 4042, Block Group 4, Census Tract 1541, Sonoma County, California",0,0,0
1000000US060971541004043,060971541004043,"Block 4043, Block Group 4, Census Tract 1541, Sonoma County, California",0,0,0
1000000US060971541004044,060971541004044,"Block 4044, Block Group 4, Census Tract 1541, Sonoma County, California",0,0,0
1000000US060971541004045,060971541004045,"Block 4045, Block Group 4, Census Tract 1541, Sonoma County, California",0,0,0
1000000US060971541004046,060971541004046,"Block 4046, Block Group 4, Census Tract 1541, Sonoma County, California",6,6,0
1000000US060971541004047,060971541004047,"Block 4047, Block Group 4, Census Tract 1541, Sonoma County, California",0,0,0
1000000US060971541004048,060971541004048,"Block 4048, Block Group 4, Census Tract 1541, Sonoma County, California",1,0,1
1000000US060971541004049,060971541004049,"Block 4049, Block Group 4, Census Tract 1541, Sonoma County, California",0,0,0
1000000US060971541004050,060971541004050,"Block 4050, Block Group 4, Census Tract 1541, Sonoma County, California",11,9,2
1000000US060971541004051,060971541004051,"Block 4051, Block Group 4, Census Tract 1541, Sonoma County, California",0,0,0
1000000US060971541004052,060971541004052,"Block 4052, Block Group 4, Census Tract 1541, Sonoma County, California",2,2,0
1000000US060971541004053,060971541004053,"Block 4053, Block Group 4, Census Tract 1541, Sonoma County, California",5,3,2
1000000US060971541004054,060971541004054,"Block 4054, Block Group 4, Census Tract 1541, Sonoma County, California",0,0,0
1000000US060971541004055,060971541004055,"Block 4055, Block Group 4, Census Tract 1541, Sonoma County, California",0,0,0
1000000US060971541004056,060971541004056,"Block 4056, Block Group 4, Census Tract 1541, Sonoma County, California",4,2,2
1000000US060971541004057,060971541004057,"Block 4057, Block Group 4, Census Tract 1541, Sonoma County, California",0,0,0
1000000US060971541004058,060971541004058,"Block 4058, Block Group 4, Census Tract 1541, Sonoma County, California",2,2,0
1000000US060971541004059,060971541004059,"Block 4059, Block Group 4, Census Tract 1541, Sonoma County, California",2,2,0
1000000US060971541004060,060971541004060,"Block 4060, Block Group 4, Census Tract 1541, Sonoma County, California",0,0,0
1000000US060971541004061,060971541004061,"Block 4061, Block Group 4, Census Tract 1541, Sonoma County, California",2,2,0
1000000US060971541004062,060971541004062,"Block 4062, Block Group 4, Census Tract 1541, Sonoma County, California",0,0,0
1000000US060971541004063,060971541004063,"Block 4063, Block Group 4, Census Tract 1541, Sonoma County, California",50,39,11
1000000US060971541004064,060971541004064,"Block 4064, Block Group 4, Census Tract 1541, Sonoma County, California",7,5,2
1000000US060971541004065,060971541004065,"Block 4065, Block Group 4, Census Tract 1541, Sonoma County, California",0,0,0
1000000US060971541004066,060971541004066,"Block 4066, Block Group 4, Census Tract 1541, Sonoma County, California",6,6,0
1000000US060971541004067,060971541004067,"Block 4067, Block Group 4, Census Tract 1541, Sonoma County, California",0,0,0
1000000US060971541004068,060971541004068,"Block 4068, Block Group 4, Census Tract 1541, Sonoma County, California",20,11,9
1000000US060971541004069,060971541004069,"Block 4069, Block Group 4, Census Tract 1541, Sonoma County, California",19,15,4
1000000US060971541004070,060971541004070,"Block 4070, Block Group 4, Census Tract 1541, Sonoma County, California",3,2,1
1000000US060971541004071,060971541004071,"Block 4071, Block Group 4, Census Tract 1541, Sonoma County, California",0,0,0
1000000US060971541004072,060971541004072,"Block 4072, Block Group 4, Census Tract 1541, Sonoma County, California",51,41,10
1000000US060971541004073,060971541004073,"Block 4073, Block Group 4, Census Tract 1541, Sonoma County, California",0,0,0
1000000US060971541004074,060971541004074,"Block 4074, Block Group 4, Census Tract 1541, Sonoma County, California",0,0,0
1000000US060971541004075,060971541004075,"Block 4075, Block Group 4, Census Tract 1541, Sonoma County, California",0,0,0
1000000US060971541004076,060971541004076,"Block 4076, Block Group 4, Census Tract 1541, Sonoma County, California",0,0,0
1000000US060971541004077,060971541004077,"Block 4077, Block Group 4, Census Tract 1541, Sonoma County, California",0,0,0
1000000US060971541004078,060971541004078,"Block 4078, Block Group 4, Census Tract 1541, Sonoma County, California",2,1,1
1000000US060971541004079,060971541004079,"Block 4079, Block Group 4, Census Tract 1541, Sonoma County, California",40,33,7
1000000US060971541004080,060971541004080,"Block 4080, Block Group 4, Census Tract 1541, Sonoma County, California",0,0,0
1000000US060971541004081,060971541004081,"Block 4081, Block Group 4, Census Tract 1541, Sonoma County, California",1,1,0
1000000US060971541004082,060971541004082,"Block 4082, Block Group 4, Census Tract 1541, Sonoma County, California",2,2,0
1000000US060971541004083,060971541004083,"Block 4083, Block Group 4, Census Tract 1541, Sonoma County, California",15,14,1
1000000US060971541004084,060971541004084,"Block 4084, Block Group 4, Census Tract 1541, Sonoma County, California",3,2,1
1000000US060971541004085,060971541004085,"Block 4085, Block Group 4, Census Tract 1541, Sonoma County, California",9,4,5
1000000US060971541004086,060971541004086,"Block 4086, Block Group 4, Census Tract 1541, Sonoma County, California",1,0,1
1000000US060971541004087,060971541004087,"Block 4087, Block Group 4, Census Tract 1541, Sonoma County, California",2,0,2
1000000US060971541004088,060971541004088,"Block 4088, Block Group 4, Census Tract 1541, Sonoma County, California",6,3,3
1000000US060971541004089,060971541004089,"Block 4089, Block Group 4, Census Tract 1541, Sonoma County, California",5,5,0
1000000US060971541004090,060971541004090,"Block 4090, Block Group 4, Census Tract 1541, Sonoma County, California",0,0,0
1000000US060971541004091,060971541004091,"Block 4091, Block Group 4, Census Tract 1541, Sonoma County, California",5,5,0
1000000US060971541004092,060971541004092,"Block 4092, Block Group 4, Census Tract 1541, Sonoma County, California",6,4,2
1000000US060971541004093,060971541004093,"Block 4093, Block Group 4, Census Tract 1541, Sonoma County, California",0,0,0
1000000US060971541004094,060971541004094,"Block 4094, Block Group 4, Census Tract 1541, Sonoma County, California",8,3,5
1000000US060971541004095,060971541004095,"Block 4095, Block Group 4, Census Tract 1541, Sonoma County, California",0,0,0
1000000US060971541004096,060971541004096,"Block 4096, Block Group 4, Census Tract 1541, Sonoma County, California",0,0,0
1000000US060971541004097,060971541004097,"Block 4097, Block Group 4, Census Tract 1541, Sonoma County, California",0,0,0
1000000US060971541004098,060971541004098,"Block 4098, Block Group 4, Census Tract 1541, Sonoma County, California",0,0,0
1000000US060971541004099,060971541004099,"Block 4099, Block Group 4, Census Tract 1541, Sonoma County, California",12,9,3
1000000US060971541004100,060971541004100,"Block 4100, Block Group 4, Census Tract 1541, Sonoma County, California",6,5,1
1000000US060971542011000,060971542011000,"Block 1000, Block Group 1, Census Tract 1542.01, Sonoma County, California",73,72,1
1000000US060971542011001,060971542011001,"Block 1001, Block Group 1, Census Tract 1542.01, Sonoma County, California",4,4,0
1000000US060971542011002,060971542011002,"Block 1002, Block Group 1, Census Tract 1542.01, Sonoma County, California",8,8,0
1000000US060971542011003,060971542011003,"Block 1003, Block Group 1, Census Tract 1542.01, Sonoma County, California",4,4,0
1000000US060971542011004,060971542011004,"Block 1004, Block Group 1, Census Tract 1542.01, Sonoma County, California",75,72,3
1000000US060971542011005,060971542011005,"Block 1005, Block Group 1, Census Tract 1542.01, Sonoma County, California",0,0,0
1000000US060971542011006,060971542011006,"Block 1006, Block Group 1, Census Tract 1542.01, Sonoma County, California",36,35,1
1000000US060971542011007,060971542011007,"Block 1007, Block Group 1, Census Tract 1542.01, Sonoma County, California",22,21,1
1000000US060971542011008,060971542011008,"Block 1008, Block Group 1, Census Tract 1542.01, Sonoma County, California",11,11,0
1000000US060971542011009,060971542011009,"Block 1009, Block Group 1, Census Tract 1542.01, Sonoma County, California",12,12,0
1000000US060971542011010,060971542011010,"Block 1010, Block Group 1, Census Tract 1542.01, Sonoma County, California",22,20,2
1000000US060971542011011,060971542011011,"Block 1011, Block Group 1, Census Tract 1542.01, Sonoma County, California",22,18,4
1000000US060971542011012,060971542011012,"Block 1012, Block Group 1, Census Tract 1542.01, Sonoma County, California",39,38,1
1000000US060971542011013,060971542011013,"Block 1013, Block Group 1, Census Tract 1542.01, Sonoma County, California",12,10,2
1000000US060971542011014,060971542011014,"Block 1014, Block Group 1, Census Tract 1542.01, Sonoma County, California",9,9,0
1000000US060971542011015,060971542011015,"Block 1015, Block Group 1, Census Tract 1542.01, Sonoma County, California",22,22,0
1000000US060971542011016,060971542011016,"Block 1016, Block Group 1, Census Tract 1542.01, Sonoma County, California",0,0,0
1000000US060971542011017,060971542011017,"Block 1017, Block Group 1, Census Tract 1542.01, Sonoma County, California",24,24,0
1000000US060971542011018,060971542011018,"Block 1018, Block Group 1, Census Tract 1542.01, Sonoma County, California",10,10,0
1000000US060971542011019,060971542011019,"Block 1019, Block Group 1, Census Tract 1542.01, Sonoma County, California",14,13,1
1000000US060971542011020,060971542011020,"Block 1020, Block Group 1, Census Tract 1542.01, Sonoma County, California",7,7,0
1000000US060971542011021,060971542011021,"Block 1021, Block Group 1, Census Tract 1542.01, Sonoma County, California",87,79,8
1000000US060971542011022,060971542011022,"Block 1022, Block Group 1, Census Tract 1542.01, Sonoma County, California",7,7,0
1000000US060971542011023,060971542011023,"Block 1023, Block Group 1, Census Tract 1542.01, Sonoma County, California",11,11,0
1000000US060971542011024,060971542011024,"Block 1024, Block Group 1, Census Tract 1542.01, Sonoma County, California",0,0,0
1000000US060971542012000,060971542012000,"Block 2000, Block Group 2, Census Tract 1542.01, Sonoma County, California",25,23,2
1000000US060971542012001,060971542012001,"Block 2001, Block Group 2, Census Tract 1542.01, Sonoma County, California",2,2,0
1000000US060971542012002,060971542012002,"Block 2002, Block Group 2, Census Tract 1542.01, Sonoma County, California",3,3,0
1000000US060971542012003,060971542012003,"Block 2003, Block Group 2, Census Tract 1542.01, Sonoma County, California",14,12,2
1000000US060971542012004,060971542012004,"Block 2004, Block Group 2, Census Tract 1542.01, Sonoma County, California",24,22,2
1000000US060971542012005,060971542012005,"Block 2005, Block Group 2, Census Tract 1542.01, Sonoma County, California",0,0,0
1000000US060971542012006,060971542012006,"Block 2006, Block Group 2, Census Tract 1542.01, Sonoma County, California",23,20,3
1000000US060971542012007,060971542012007,"Block 2007, Block Group 2, Census Tract 1542.01, Sonoma County, California",10,8,2
1000000US060971542012008,060971542012008,"Block 2008, Block Group 2, Census Tract 1542.01, Sonoma County, California",0,0,0
1000000US060971542012009,060971542012009,"Block 2009, Block Group 2, Census Tract 1542.01, Sonoma County, California",0,0,0
1000000US060971542012010,060971542012010,"Block 2010, Block Group 2, Census Tract 1542.01, Sonoma County, California",0,0,0
1000000US060971542012011,060971542012011,"Block 2011, Block Group 2, Census Tract 1542.01, Sonoma County, California",0,0,0
1000000US060971542012012,060971542012012,"Block 2012, Block Group 2, Census Tract 1542.01, Sonoma County, California",32,28,4
1000000US060971542012013,060971542012013,"Block 2013, Block Group 2, Census Tract 1542.01, Sonoma County, California",1,1,0
1000000US060971542012014,060971542012014,"Block 2014, Block Group 2, Census Tract 1542.01, Sonoma County, California",1,1,0
1000000US060971542012015,060971542012015,"Block 2015, Block Group 2, Census Tract 1542.01, Sonoma County, California",0,0,0
1000000US060971542012016,060971542012016,"Block 2016, Block Group 2, Census Tract 1542.01, Sonoma County, California",3,3,0
1000000US060971542012017,060971542012017,"Block 2017, Block Group 2, Census Tract 1542.01, Sonoma County, California",0,0,0
1000000US060971542012018,060971542012018,"Block 2018, Block Group 2, Census Tract 1542.01, Sonoma County, California",1,1,0
1000000US060971542012019,060971542012019,"Block 2019, Block Group 2, Census Tract 1542.01, Sonoma County, California",0,0,0
1000000US060971542012020,060971542012020,"Block 2020, Block Group 2, Census Tract 1542.01, Sonoma County, California",0,0,0
1000000US060971542012021,060971542012021,"Block 2021, Block Group 2, Census Tract 1542.01, Sonoma County, California",0,0,0
1000000US060971542012022,060971542012022,"Block 2022, Block Group 2, Census Tract 1542.01, Sonoma County, California",95,92,3
1000000US060971542012023,060971542012023,"Block 2023, Block Group 2, Census Tract 1542.01, Sonoma County, California",6,5,1
1000000US060971542012024,060971542012024,"Block 2024, Block Group 2, Census Tract 1542.01, Sonoma County, California",0,0,0
1000000US060971542012025,060971542012025,"Block 2025, Block Group 2, Census Tract 1542.01, Sonoma County, California",0,0,0
1000000US060971542012026,060971542012026,"Block 2026, Block Group 2, Census Tract 1542.01, Sonoma County, California",10,8,2
1000000US060971542012027,060971542012027,"Block 2027, Block Group 2, Census Tract 1542.01, Sonoma County, California",0,0,0
1000000US060971542012028,060971542012028,"Block 2028, Block Group 2, Census Tract 1542.01, Sonoma County, California",18,17,1
1000000US060971542012029,060971542012029,"Block 2029, Block Group 2, Census Tract 1542.01, Sonoma County, California",34,33,1
1000000US060971542012030,060971542012030,"Block 2030, Block Group 2, Census Tract 1542.01, Sonoma County, California",0,0,0
1000000US060971542012031,060971542012031,"Block 2031, Block Group 2, Census Tract 1542.01, Sonoma County, California",5,5,0
1000000US060971542012032,060971542012032,"Block 2032, Block Group 2, Census Tract 1542.01, Sonoma County, California",8,8,0
1000000US060971542012033,060971542012033,"Block 2033, Block Group 2, Census Tract 1542.01, Sonoma County, California",3,3,0
1000000US060971542012034,060971542012034,"Block 2034, Block Group 2, Census Tract 1542.01, Sonoma County, California",1,1,0
1000000US060971542012035,060971542012035,"Block 2035, Block Group 2, Census Tract 1542.01, Sonoma County, California",11,11,0
1000000US060971542012036,060971542012036,"Block 2036, Block Group 2, Census Tract 1542.01, Sonoma County, California",0,0,0
1000000US060971542012037,060971542012037,"Block 2037, Block Group 2, Census Tract 1542.01, Sonoma County, California",3,3,0
1000000US060971542012038,060971542012038,"Block 2038, Block Group 2, Census Tract 1542.01, Sonoma County, California",0,0,0
1000000US060971542012039,060971542012039,"Block 2039, Block Group 2, Census Tract 1542.01, Sonoma County, California",0,0,0
1000000US060971542012040,060971542012040,"Block 2040, Block Group 2, Census Tract 1542.01, Sonoma County, California",0,0,0
1000000US060971542012041,060971542012041,"Block 2041, Block Group 2, Census Tract 1542.01, Sonoma County, California",1,1,0
1000000US060971542012042,060971542012042,"Block 2042, Block Group 2, Census Tract 1542.01, Sonoma County, California",0,0,0
1000000US060971542013000,060971542013000,"Block 3000, Block Group 3, Census Tract 1542.01, Sonoma County, California",2,2,0
1000000US060971542013001,060971542013001,"Block 3001, Block Group 3, Census Tract 1542.01, Sonoma County, California",2,1,1
1000000US060971542013002,060971542013002,"Block 3002, Block Group 3, Census Tract 1542.01, Sonoma County, California",19,18,1
1000000US060971542013003,060971542013003,"Block 3003, Block Group 3, Census Tract 1542.01, Sonoma County, California",0,0,0
1000000US060971542013004,060971542013004,"Block 3004, Block Group 3, Census Tract 1542.01, Sonoma County, California",1,1,0
1000000US060971542013005,060971542013005,"Block 3005, Block Group 3, Census Tract 1542.01, Sonoma County, California",0,0,0
1000000US060971542013006,060971542013006,"Block 3006, Block Group 3, Census Tract 1542.01, Sonoma County, California",0,0,0
1000000US060971542013007,060971542013007,"Block 3007, Block Group 3, Census Tract 1542.01, Sonoma County, California",1,1,0
1000000US060971542013008,060971542013008,"Block 3008, Block Group 3, Census Tract 1542.01, Sonoma County, California",5,4,1
1000000US060971542013009,060971542013009,"Block 3009, Block Group 3, Census Tract 1542.01, Sonoma County, California",0,0,0
1000000US060971542013010,060971542013010,"Block 3010, Block Group 3, Census Tract 1542.01, Sonoma County, California",0,0,0
1000000US060971542013011,060971542013011,"Block 3011, Block Group 3, Census Tract 1542.01, Sonoma County, California",26,24,2
1000000US060971542013012,060971542013012,"Block 3012, Block Group 3, Census Tract 1542.01, Sonoma County, California",0,0,0
1000000US060971542013013,060971542013013,"Block 3013, Block Group 3, Census Tract 1542.01, Sonoma County, California",20,17,3
1000000US060971542013014,060971542013014,"Block 3014, Block Group 3, Census Tract 1542.01, Sonoma County, California",0,0,0
1000000US060971542013015,060971542013015,"Block 3015, Block Group 3, Census Tract 1542.01, Sonoma County, California",0,0,0
1000000US060971542013016,060971542013016,"Block 3016, Block Group 3, Census Tract 1542.01, Sonoma County, California",0,0,0
1000000US060971542013017,060971542013017,"Block 3017, Block Group 3, Census Tract 1542.01, Sonoma County, California",0,0,0
1000000US060971542013018,060971542013018,"Block 3018, Block Group 3, Census Tract 1542.01, Sonoma County, California",0,0,0
1000000US060971542013019,060971542013019,"Block 3019, Block Group 3, Census Tract 1542.01, Sonoma County, California",0,0,0
1000000US060971542013020,060971542013020,"Block 3020, Block Group 3, Census Tract 1542.01, Sonoma County, California",0,0,0
1000000US060971542013021,060971542013021,"Block 3021, Block Group 3, Census Tract 1542.01, Sonoma County, California",0,0,0
1000000US060971542013022,060971542013022,"Block 3022, Block Group 3, Census Tract 1542.01, Sonoma County, California",1,1,0
1000000US060971542013023,060971542013023,"Block 3023, Block Group 3, Census Tract 1542.01, Sonoma County, California",0,0,0
1000000US060971542013024,060971542013024,"Block 3024, Block Group 3, Census Tract 1542.01, Sonoma County, California",0,0,0
1000000US060971542013025,060971542013025,"Block 3025, Block Group 3, Census Tract 1542.01, Sonoma County, California",0,0,0
1000000US060971542013026,060971542013026,"Block 3026, Block Group 3, Census Tract 1542.01, Sonoma County, California",0,0,0
1000000US060971542013027,060971542013027,"Block 3027, Block Group 3, Census Tract 1542.01, Sonoma County, California",0,0,0
1000000US060971542013028,060971542013028,"Block 3028, Block Group 3, Census Tract 1542.01, Sonoma County, California",0,0,0
1000000US060971542013029,060971542013029,"Block 3029, Block Group 3, Census Tract 1542.01, Sonoma County, California",3,2,1
1000000US060971542013030,060971542013030,"Block 3030, Block Group 3, Census Tract 1542.01, Sonoma County, California",0,0,0
1000000US060971542013031,060971542013031,"Block 3031, Block Group 3, Census Tract 1542.01, Sonoma County, California",0,0,0
1000000US060971542013032,060971542013032,"Block 3032, Block Group 3, Census Tract 1542.01, Sonoma County, California",1,1,0
1000000US060971542013033,060971542013033,"Block 3033, Block Group 3, Census Tract 1542.01, Sonoma County, California",1,1,0
1000000US060971542013034,060971542013034,"Block 3034, Block Group 3, Census Tract 1542.01, Sonoma County, California",0,0,0
1000000US060971542013035,060971542013035,"Block 3035, Block Group 3, Census Tract 1542.01, Sonoma County, California",0,0,0
1000000US060971542013036,060971542013036,"Block 3036, Block Group 3, Census Tract 1542.01, Sonoma County, California",0,0,0
1000000US060971542013037,060971542013037,"Block 3037, Block Group 3, Census Tract 1542.01, Sonoma County, California",0,0,0
1000000US060971542013038,060971542013038,"Block 3038, Block Group 3, Census Tract 1542.01, Sonoma County, California",0,0,0
1000000US060971542013039,060971542013039,"Block 3039, Block Group 3, Census Tract 1542.01, Sonoma County, California",0,0,0
1000000US060971542013040,060971542013040,"Block 3040, Block Group 3, Census Tract 1542.01, Sonoma County, California",62,62,0
1000000US060971542013041,060971542013041,"Block 3041, Block Group 3, Census Tract 1542.01, Sonoma County, California",0,0,0
1000000US060971542013042,060971542013042,"Block 3042, Block Group 3, Census Tract 1542.01, Sonoma County, California",0,0,0
1000000US060971542013043,060971542013043,"Block 3043, Block Group 3, Census Tract 1542.01, Sonoma County, California",1,1,0
1000000US060971542013044,060971542013044,"Block 3044, Block Group 3, Census Tract 1542.01, Sonoma County, California",11,10,1
1000000US060971542013045,060971542013045,"Block 3045, Block Group 3, Census Tract 1542.01, Sonoma County, California",0,0,0
1000000US060971542013046,060971542013046,"Block 3046, Block Group 3, Census Tract 1542.01, Sonoma County, California",0,0,0
1000000US060971542013047,060971542013047,"Block 3047, Block Group 3, Census Tract 1542.01, Sonoma County, California",0,0,0
1000000US060971542013048,060971542013048,"Block 3048, Block Group 3, Census Tract 1542.01, Sonoma County, California",0,0,0
1000000US060971542013049,060971542013049,"Block 3049, Block Group 3, Census Tract 1542.01, Sonoma County, California",0,0,0
1000000US060971542013050,060971542013050,"Block 3050, Block Group 3, Census Tract 1542.01, Sonoma County, California",0,0,0
1000000US060971542013051,060971542013051,"Block 3051, Block Group 3, Census Tract 1542.01, Sonoma County, California",0,0,0
1000000US060971542013052,060971542013052,"Block 3052, Block Group 3, Census Tract 1542.01, Sonoma County, California",5,4,1
1000000US060971542013053,060971542013053,"Block 3053, Block Group 3, Census Tract 1542.01, Sonoma County, California",0,0,0
1000000US060971542013054,060971542013054,"Block 3054, Block Group 3, Census Tract 1542.01, Sonoma County, California",0,0,0
1000000US060971542013055,060971542013055,"Block 3055, Block Group 3, Census Tract 1542.01, Sonoma County, California",0,0,0
1000000US060971542013056,060971542013056,"Block 3056, Block Group 3, Census Tract 1542.01, Sonoma County, California",0,0,0
1000000US060971542013057,060971542013057,"Block 3057, Block Group 3, Census Tract 1542.01, Sonoma County, California",0,0,0
1000000US060971542013058,060971542013058,"Block 3058, Block Group 3, Census Tract 1542.01, Sonoma County, California",0,0,0
1000000US060971542013059,060971542013059,"Block 3059, Block Group 3, Census Tract 1542.01, Sonoma County, California",0,0,0
1000000US060971542013060,060971542013060,"Block 3060, Block Group 3, Census Tract 1542.01, Sonoma County, California",0,0,0
1000000US060971542013061,060971542013061,"Block 3061, Block Group 3, Census Tract 1542.01, Sonoma County, California",0,0,0
1000000US060971542013062,060971542013062,"Block 3062, Block Group 3, Census Tract 1542.01, Sonoma County, California",3,3,0
1000000US060971542013063,060971542013063,"Block 3063, Block Group 3, Census Tract 1542.01, Sonoma County, California",46,39,7
1000000US060971542013064,060971542013064,"Block 3064, Block Group 3, Census Tract 1542.01, Sonoma County, California",7,7,0
1000000US060971542013065,060971542013065,"Block 3065, Block Group 3, Census Tract 1542.01, Sonoma County, California",0,0,0
1000000US060971542013066,060971542013066,"Block 3066, Block Group 3, Census Tract 1542.01, Sonoma County, California",0,0,0
1000000US060971542013067,060971542013067,"Block 3067, Block Group 3, Census Tract 1542.01, Sonoma County, California",0,0,0
1000000US060971542013068,060971542013068,"Block 3068, Block Group 3, Census Tract 1542.01, Sonoma County, California",0,0,0
1000000US060971542013069,060971542013069,"Block 3069, Block Group 3, Census Tract 1542.01, Sonoma County, California",0,0,0
1000000US060971542013070,060971542013070,"Block 3070, Block Group 3, Census Tract 1542.01, Sonoma County, California",7,7,0
1000000US060971542013071,060971542013071,"Block 3071, Block Group 3, Census Tract 1542.01, Sonoma County, California",0,0,0
1000000US060971542013072,060971542013072,"Block 3072, Block Group 3, Census Tract 1542.01, Sonoma County, California",0,0,0
1000000US060971542013073,060971542013073,"Block 3073, Block Group 3, Census Tract 1542.01, Sonoma County, California",0,0,0
1000000US060971542013074,060971542013074,"Block 3074, Block Group 3, Census Tract 1542.01, Sonoma County, California",0,0,0
1000000US060971542013075,060971542013075,"Block 3075, Block Group 3, Census Tract 1542.01, Sonoma County, California",1,1,0
1000000US060971542013076,060971542013076,"Block 3076, Block Group 3, Census Tract 1542.01, Sonoma County, California",0,0,0
1000000US060971542013077,060971542013077,"Block 3077, Block Group 3, Census Tract 1542.01, Sonoma County, California",0,0,0
1000000US060971542013078,060971542013078,"Block 3078, Block Group 3, Census Tract 1542.01, Sonoma County, California",0,0,0
1000000US060971542013079,060971542013079,"Block 3079, Block Group 3, Census Tract 1542.01, Sonoma County, California",1,1,0
1000000US060971542013080,060971542013080,"Block 3080, Block Group 3, Census Tract 1542.01, Sonoma County, California",5,5,0
1000000US060971542013081,060971542013081,"Block 3081, Block Group 3, Census Tract 1542.01, Sonoma County, California",0,0,0
1000000US060971542013082,060971542013082,"Block 3082, Block Group 3, Census Tract 1542.01, Sonoma County, California",0,0,0
1000000US060971542013083,060971542013083,"Block 3083, Block Group 3, Census Tract 1542.01, Sonoma County, California",0,0,0
1000000US060971542013084,060971542013084,"Block 3084, Block Group 3, Census Tract 1542.01, Sonoma County, California",0,0,0
1000000US060971542013085,060971542013085,"Block 3085, Block Group 3, Census Tract 1542.01, Sonoma County, California",0,0,0
1000000US060971542013086,060971542013086,"Block 3086, Block Group 3, Census Tract 1542.01, Sonoma County, California",0,0,0
1000000US060971542013087,060971542013087,"Block 3087, Block Group 3, Census Tract 1542.01, Sonoma County, California",1,1,0
1000000US060971542013088,060971542013088,"Block 3088, Block Group 3, Census Tract 1542.01, Sonoma County, California",0,0,0
1000000US060971542014000,060971542014000,"Block 4000, Block Group 4, Census Tract 1542.01, Sonoma County, California",165,142,23
1000000US060971542014001,060971542014001,"Block 4001, Block Group 4, Census Tract 1542.01, Sonoma County, California",0,0,0
1000000US060971542014002,060971542014002,"Block 4002, Block Group 4, Census Tract 1542.01, Sonoma County, California",5,5,0
1000000US060971542014003,060971542014003,"Block 4003, Block Group 4, Census Tract 1542.01, Sonoma County, California",9,9,0
1000000US060971542014004,060971542014004,"Block 4004, Block Group 4, Census Tract 1542.01, Sonoma County, California",16,16,0
1000000US060971542014005,060971542014005,"Block 4005, Block Group 4, Census Tract 1542.01, Sonoma County, California",8,8,0
1000000US060971542014006,060971542014006,"Block 4006, Block Group 4, Census Tract 1542.01, Sonoma County, California",24,23,1
1000000US060971542014007,060971542014007,"Block 4007, Block Group 4, Census Tract 1542.01, Sonoma County, California",14,12,2
1000000US060971542014008,060971542014008,"Block 4008, Block Group 4, Census Tract 1542.01, Sonoma County, California",35,32,3
1000000US060971542014009,060971542014009,"Block 4009, Block Group 4, Census Tract 1542.01, Sonoma County, California",0,0,0
1000000US060971542014010,060971542014010,"Block 4010, Block Group 4, Census Tract 1542.01, Sonoma County, California",5,4,1
1000000US060971542014011,060971542014011,"Block 4011, Block Group 4, Census Tract 1542.01, Sonoma County, California",0,0,0
1000000US060971542014012,060971542014012,"Block 4012, Block Group 4, Census Tract 1542.01, Sonoma County, California",2,1,1
1000000US060971542014013,060971542014013,"Block 4013, Block Group 4, Census Tract 1542.01, Sonoma County, California",1,1,0
1000000US060971542014014,060971542014014,"Block 4014, Block Group 4, Census Tract 1542.01, Sonoma County, California",7,6,1
1000000US060971542014015,060971542014015,"Block 4015, Block Group 4, Census Tract 1542.01, Sonoma County, California",26,25,1
1000000US060971542014016,060971542014016,"Block 4016, Block Group 4, Census Tract 1542.01, Sonoma County, California",24,23,1
1000000US060971542014017,060971542014017,"Block 4017, Block Group 4, Census Tract 1542.01, Sonoma County, California",0,0,0
1000000US060971542014018,060971542014018,"Block 4018, Block Group 4, Census Tract 1542.01, Sonoma County, California",5,5,0
1000000US060971542014019,060971542014019,"Block 4019, Block Group 4, Census Tract 1542.01, Sonoma County, California",12,12,0
1000000US060971542014020,060971542014020,"Block 4020, Block Group 4, Census Tract 1542.01, Sonoma County, California",22,19,3
1000000US060971542014021,060971542014021,"Block 4021, Block Group 4, Census Tract 1542.01, Sonoma County, California",10,9,1
1000000US060971542014022,060971542014022,"Block 4022, Block Group 4, Census Tract 1542.01, Sonoma County, California",31,27,4
1000000US060971542014023,060971542014023,"Block 4023, Block Group 4, Census Tract 1542.01, Sonoma County, California",5,3,2
1000000US060971542014024,060971542014024,"Block 4024, Block Group 4, Census Tract 1542.01, Sonoma County, California",3,3,0
1000000US060971542021000,060971542021000,"Block 1000, Block Group 1, Census Tract 1542.02, Sonoma County, California",30,29,1
1000000US060971542021001,060971542021001,"Block 1001, Block Group 1, Census Tract 1542.02, Sonoma County, California",63,23,40
1000000US060971542021002,060971542021002,"Block 1002, Block Group 1, Census Tract 1542.02, Sonoma County, California",10,10,0
1000000US060971542021003,060971542021003,"Block 1003, Block Group 1, Census Tract 1542.02, Sonoma County, California",132,130,2
1000000US060971542021004,060971542021004,"Block 1004, Block Group 1, Census Tract 1542.02, Sonoma County, California",0,0,0
1000000US060971542021005,060971542021005,"Block 1005, Block Group 1, Census Tract 1542.02, Sonoma County, California",0,0,0
1000000US060971542021006,060971542021006,"Block 1006, Block Group 1, Census Tract 1542.02, Sonoma County, California",0,0,0
1000000US060971542021007,060971542021007,"Block 1007, Block Group 1, Census Tract 1542.02, Sonoma County, California",38,36,2
1000000US060971542021008,060971542021008,"Block 1008, Block Group 1, Census Tract 1542.02, Sonoma County, California",0,0,0
1000000US060971542021009,060971542021009,"Block 1009, Block Group 1, Census Tract 1542.02, Sonoma County, California",15,14,1
1000000US060971542021010,060971542021010,"Block 1010, Block Group 1, Census Tract 1542.02, Sonoma County, California",91,82,9
1000000US060971542021011,060971542021011,"Block 1011, Block Group 1, Census Tract 1542.02, Sonoma County, California",13,13,0
1000000US060971542021012,060971542021012,"Block 1012, Block Group 1, Census Tract 1542.02, Sonoma County, California",21,20,1
1000000US060971542021013,060971542021013,"Block 1013, Block Group 1, Census Tract 1542.02, Sonoma County, California",10,9,1
1000000US060971542021014,060971542021014,"Block 1014, Block Group 1, Census Tract 1542.02, Sonoma County, California",2,2,0
1000000US060971542021015,060971542021015,"Block 1015, Block Group 1, Census Tract 1542.02, Sonoma County, California",3,2,1
1000000US060971542021016,060971542021016,"Block 1016, Block Group 1, Census Tract 1542.02, Sonoma County, California",72,69,3
1000000US060971542021017,060971542021017,"Block 1017, Block Group 1, Census Tract 1542.02, Sonoma County, California",7,7,0
1000000US060971542021018,060971542021018,"Block 1018, Block Group 1, Census Tract 1542.02, Sonoma County, California",62,60,2
1000000US060971542021019,060971542021019,"Block 1019, Block Group 1, Census Tract 1542.02, Sonoma County, California",20,19,1
1000000US060971542021020,060971542021020,"Block 1020, Block Group 1, Census Tract 1542.02, Sonoma County, California",32,31,1
1000000US060971542021021,060971542021021,"Block 1021, Block Group 1, Census Tract 1542.02, Sonoma County, California",8,8,0
1000000US060971542021022,060971542021022,"Block 1022, Block Group 1, Census Tract 1542.02, Sonoma County, California",11,11,0
1000000US060971542021023,060971542021023,"Block 1023, Block Group 1, Census Tract 1542.02, Sonoma County, California",87,84,3
1000000US060971542021024,060971542021024,"Block 1024, Block Group 1, Census Tract 1542.02, Sonoma County, California",151,146,5
1000000US060971542021025,060971542021025,"Block 1025, Block Group 1, Census Tract 1542.02, Sonoma County, California",8,7,1
1000000US060971542021026,060971542021026,"Block 1026, Block Group 1, Census Tract 1542.02, Sonoma County, California",10,10,0
1000000US060971542021027,060971542021027,"Block 1027, Block Group 1, Census Tract 1542.02, Sonoma County, California",33,31,2
1000000US060971542021028,060971542021028,"Block 1028, Block Group 1, Census Tract 1542.02, Sonoma County, California",25,19,6
1000000US060971542021029,060971542021029,"Block 1029, Block Group 1, Census Tract 1542.02, Sonoma County, California",1,0,1
1000000US060971542021030,060971542021030,"Block 1030, Block Group 1, Census Tract 1542.02, Sonoma County, California",0,0,0
1000000US060971542021031,060971542021031,"Block 1031, Block Group 1, Census Tract 1542.02, Sonoma County, California",0,0,0
1000000US060971542021032,060971542021032,"Block 1032, Block Group 1, Census Tract 1542.02, Sonoma County, California",0,0,0
1000000US060971542021033,060971542021033,"Block 1033, Block Group 1, Census Tract 1542.02, Sonoma County, California",0,0,0
1000000US060971542021034,060971542021034,"Block 1034, Block Group 1, Census Tract 1542.02, Sonoma County, California",88,87,1
1000000US060971542021035,060971542021035,"Block 1035, Block Group 1, Census Tract 1542.02, Sonoma County, California",15,14,1
1000000US060971542021036,060971542021036,"Block 1036, Block Group 1, Census Tract 1542.02, Sonoma County, California",21,18,3
1000000US060971542021037,060971542021037,"Block 1037, Block Group 1, Census Tract 1542.02, Sonoma County, California",21,20,1
1000000US060971542021038,060971542021038,"Block 1038, Block Group 1, Census Tract 1542.02, Sonoma County, California",18,17,1
1000000US060971542021039,060971542021039,"Block 1039, Block Group 1, Census Tract 1542.02, Sonoma County, California",107,97,10
1000000US060971542021040,060971542021040,"Block 1040, Block Group 1, Census Tract 1542.02, Sonoma County, California",30,30,0
1000000US060971542021041,060971542021041,"Block 1041, Block Group 1, Census Tract 1542.02, Sonoma County, California",10,9,1
1000000US060971542021042,060971542021042,"Block 1042, Block Group 1, Census Tract 1542.02, Sonoma County, California",9,7,2
1000000US060971542021043,060971542021043,"Block 1043, Block Group 1, Census Tract 1542.02, Sonoma County, California",0,0,0
1000000US060971542021044,060971542021044,"Block 1044, Block Group 1, Census Tract 1542.02, Sonoma County, California",2,2,0
1000000US060971542021045,060971542021045,"Block 1045, Block Group 1, Census Tract 1542.02, Sonoma County, California",38,37,1
1000000US060971542021046,060971542021046,"Block 1046, Block Group 1, Census Tract 1542.02, Sonoma County, California",14,14,0
1000000US060971542021047,060971542021047,"Block 1047, Block Group 1, Census Tract 1542.02, Sonoma County, California",0,0,0
1000000US060971542021048,060971542021048,"Block 1048, Block Group 1, Census Tract 1542.02, Sonoma County, California",0,0,0
1000000US060971542021049,060971542021049,"Block 1049, Block Group 1, Census Tract 1542.02, Sonoma County, California",0,0,0
1000000US060971542021050,060971542021050,"Block 1050, Block Group 1, Census Tract 1542.02, Sonoma County, California",0,0,0
1000000US060971542021051,060971542021051,"Block 1051, Block Group 1, Census Tract 1542.02, Sonoma County, California",9,7,2
1000000US060971542021052,060971542021052,"Block 1052, Block Group 1, Census Tract 1542.02, Sonoma County, California",0,0,0
1000000US060971542021053,060971542021053,"Block 1053, Block Group 1, Census Tract 1542.02, Sonoma County, California",98,93,5
1000000US060971542021054,060971542021054,"Block 1054, Block Group 1, Census Tract 1542.02, Sonoma County, California",17,17,0
1000000US060971542021055,060971542021055,"Block 1055, Block Group 1, Census Tract 1542.02, Sonoma County, California",15,15,0
1000000US060971542021056,060971542021056,"Block 1056, Block Group 1, Census Tract 1542.02, Sonoma County, California",41,38,3
1000000US060971542021057,060971542021057,"Block 1057, Block Group 1, Census Tract 1542.02, Sonoma County, California",1,1,0
1000000US060971542021058,060971542021058,"Block 1058, Block Group 1, Census Tract 1542.02, Sonoma County, California",11,11,0
1000000US060971542021059,060971542021059,"Block 1059, Block Group 1, Census Tract 1542.02, Sonoma County, California",149,127,22
1000000US060971542021060,060971542021060,"Block 1060, Block Group 1, Census Tract 1542.02, Sonoma County, California",18,18,0
1000000US060971542021061,060971542021061,"Block 1061, Block Group 1, Census Tract 1542.02, Sonoma County, California",8,7,1
1000000US060971542021062,060971542021062,"Block 1062, Block Group 1, Census Tract 1542.02, Sonoma County, California",12,12,0
1000000US060971542021063,060971542021063,"Block 1063, Block Group 1, Census Tract 1542.02, Sonoma County, California",0,0,0
1000000US060971542021064,060971542021064,"Block 1064, Block Group 1, Census Tract 1542.02, Sonoma County, California",0,0,0
1000000US060971542021065,060971542021065,"Block 1065, Block Group 1, Census Tract 1542.02, Sonoma County, California",0,0,0
1000000US060971542021066,060971542021066,"Block 1066, Block Group 1, Census Tract 1542.02, Sonoma County, California",0,0,0
1000000US060971542021067,060971542021067,"Block 1067, Block Group 1, Census Tract 1542.02, Sonoma County, California",23,19,4
1000000US060971542021068,060971542021068,"Block 1068, Block Group 1, Census Tract 1542.02, Sonoma County, California",0,0,0
1000000US060971542021069,060971542021069,"Block 1069, Block Group 1, Census Tract 1542.02, Sonoma County, California",17,12,5
1000000US060971542021070,060971542021070,"Block 1070, Block Group 1, Census Tract 1542.02, Sonoma County, California",0,0,0
1000000US060971542021071,060971542021071,"Block 1071, Block Group 1, Census Tract 1542.02, Sonoma County, California",0,0,0
1000000US060971542021072,060971542021072,"Block 1072, Block Group 1, Census Tract 1542.02, Sonoma County, California",2,1,1
1000000US060971542021073,060971542021073,"Block 1073, Block Group 1, Census Tract 1542.02, Sonoma County, California",0,0,0
1000000US060971542021074,060971542021074,"Block 1074, Block Group 1, Census Tract 1542.02, Sonoma County, California",0,0,0
1000000US060971542021075,060971542021075,"Block 1075, Block Group 1, Census Tract 1542.02, Sonoma County, California",0,0,0
1000000US060971542021076,060971542021076,"Block 1076, Block Group 1, Census Tract 1542.02, Sonoma County, California",0,0,0
1000000US060971542021077,060971542021077,"Block 1077, Block Group 1, Census Tract 1542.02, Sonoma County, California",0,0,0
1000000US060971542021078,060971542021078,"Block 1078, Block Group 1, Census Tract 1542.02, Sonoma County, California",0,0,0
1000000US060971542021079,060971542021079,"Block 1079, Block Group 1, Census Tract 1542.02, Sonoma County, California",0,0,0
1000000US060971542021080,060971542021080,"Block 1080, Block Group 1, Census Tract 1542.02, Sonoma County, California",0,0,0
1000000US060971542021081,060971542021081,"Block 1081, Block Group 1, Census Tract 1542.02, Sonoma County, California",0,0,0
1000000US060971542021082,060971542021082,"Block 1082, Block Group 1, Census Tract 1542.02, Sonoma County, California",0,0,0
1000000US060971542021083,060971542021083,"Block 1083, Block Group 1, Census Tract 1542.02, Sonoma County, California",0,0,0
1000000US060971542021084,060971542021084,"Block 1084, Block Group 1, Census Tract 1542.02, Sonoma County, California",0,0,0
1000000US060971542022000,060971542022000,"Block 2000, Block Group 2, Census Tract 1542.02, Sonoma County, California",57,41,16
1000000US060971542022001,060971542022001,"Block 2001, Block Group 2, Census Tract 1542.02, Sonoma County, California",0,0,0
1000000US060971542022002,060971542022002,"Block 2002, Block Group 2, Census Tract 1542.02, Sonoma County, California",2,2,0
1000000US060971542022003,060971542022003,"Block 2003, Block Group 2, Census Tract 1542.02, Sonoma County, California",0,0,0
1000000US060971542022004,060971542022004,"Block 2004, Block Group 2, Census Tract 1542.02, Sonoma County, California",2,0,2
1000000US060971542022005,060971542022005,"Block 2005, Block Group 2, Census Tract 1542.02, Sonoma County, California",0,0,0
1000000US060971542022006,060971542022006,"Block 2006, Block Group 2, Census Tract 1542.02, Sonoma County, California",0,0,0
1000000US060971542022007,060971542022007,"Block 2007, Block Group 2, Census Tract 1542.02, Sonoma County, California",0,0,0
1000000US060971542022008,060971542022008,"Block 2008, Block Group 2, Census Tract 1542.02, Sonoma County, California",1,1,0
1000000US060971542022009,060971542022009,"Block 2009, Block Group 2, Census Tract 1542.02, Sonoma County, California",1,1,0
1000000US060971542022010,060971542022010,"Block 2010, Block Group 2, Census Tract 1542.02, Sonoma County, California",0,0,0
1000000US060971542022011,060971542022011,"Block 2011, Block Group 2, Census Tract 1542.02, Sonoma County, California",0,0,0
1000000US060971542022012,060971542022012,"Block 2012, Block Group 2, Census Tract 1542.02, Sonoma County, California",0,0,0
1000000US060971542022013,060971542022013,"Block 2013, Block Group 2, Census Tract 1542.02, Sonoma County, California",0,0,0
1000000US060971542022014,060971542022014,"Block 2014, Block Group 2, Census Tract 1542.02, Sonoma County, California",2,0,2
1000000US060971542022015,060971542022015,"Block 2015, Block Group 2, Census Tract 1542.02, Sonoma County, California",2,2,0
1000000US060971542022016,060971542022016,"Block 2016, Block Group 2, Census Tract 1542.02, Sonoma County, California",1,0,1
1000000US060971542022017,060971542022017,"Block 2017, Block Group 2, Census Tract 1542.02, Sonoma County, California",3,0,3
1000000US060971542022018,060971542022018,"Block 2018, Block Group 2, Census Tract 1542.02, Sonoma County, California",0,0,0
1000000US060971542022019,060971542022019,"Block 2019, Block Group 2, Census Tract 1542.02, Sonoma County, California",1,0,1
1000000US060971542022020,060971542022020,"Block 2020, Block Group 2, Census Tract 1542.02, Sonoma County, California",0,0,0
1000000US060971542022021,060971542022021,"Block 2021, Block Group 2, Census Tract 1542.02, Sonoma County, California",0,0,0
1000000US060971542022022,060971542022022,"Block 2022, Block Group 2, Census Tract 1542.02, Sonoma County, California",0,0,0
1000000US060971542022023,060971542022023,"Block 2023, Block Group 2, Census Tract 1542.02, Sonoma County, California",0,0,0
1000000US060971542022024,060971542022024,"Block 2024, Block Group 2, Census Tract 1542.02, Sonoma County, California",0,0,0
1000000US060971542022025,060971542022025,"Block 2025, Block Group 2, Census Tract 1542.02, Sonoma County, California",0,0,0
1000000US060971542022026,060971542022026,"Block 2026, Block Group 2, Census Tract 1542.02, Sonoma County, California",0,0,0
1000000US060971542022027,060971542022027,"Block 2027, Block Group 2, Census Tract 1542.02, Sonoma County, California",0,0,0
1000000US060971542022028,060971542022028,"Block 2028, Block Group 2, Census Tract 1542.02, Sonoma County, California",12,8,4
1000000US060971542022029,060971542022029,"Block 2029, Block Group 2, Census Tract 1542.02, Sonoma County, California",2,2,0
1000000US060971542022030,060971542022030,"Block 2030, Block Group 2, Census Tract 1542.02, Sonoma County, California",0,0,0
1000000US060971542022031,060971542022031,"Block 2031, Block Group 2, Census Tract 1542.02, Sonoma County, California",0,0,0
1000000US060971542022032,060971542022032,"Block 2032, Block Group 2, Census Tract 1542.02, Sonoma County, California",1,1,0
1000000US060971542022033,060971542022033,"Block 2033, Block Group 2, Census Tract 1542.02, Sonoma County, California",5,3,2
1000000US060971542022034,060971542022034,"Block 2034, Block Group 2, Census Tract 1542.02, Sonoma County, California",0,0,0
1000000US060971542022035,060971542022035,"Block 2035, Block Group 2, Census Tract 1542.02, Sonoma County, California",0,0,0
1000000US060971542022036,060971542022036,"Block 2036, Block Group 2, Census Tract 1542.02, Sonoma County, California",95,77,18
1000000US060971542022037,060971542022037,"Block 2037, Block Group 2, Census Tract 1542.02, Sonoma County, California",0,0,0
1000000US060971542022038,060971542022038,"Block 2038, Block Group 2, Census Tract 1542.02, Sonoma County, California",0,0,0
1000000US060971542022039,060971542022039,"Block 2039, Block Group 2, Census Tract 1542.02, Sonoma County, California",0,0,0
1000000US060971542022040,060971542022040,"Block 2040, Block Group 2, Census Tract 1542.02, Sonoma County, California",0,0,0
1000000US060971542022041,060971542022041,"Block 2041, Block Group 2, Census Tract 1542.02, Sonoma County, California",0,0,0
1000000US060971542022042,060971542022042,"Block 2042, Block Group 2, Census Tract 1542.02, Sonoma County, California",10,8,2
1000000US060971542022043,060971542022043,"Block 2043, Block Group 2, Census Tract 1542.02, Sonoma County, California",0,0,0
1000000US060971542022044,060971542022044,"Block 2044, Block Group 2, Census Tract 1542.02, Sonoma County, California",1,1,0
1000000US060971542022045,060971542022045,"Block 2045, Block Group 2, Census Tract 1542.02, Sonoma County, California",0,0,0
1000000US060971542022046,060971542022046,"Block 2046, Block Group 2, Census Tract 1542.02, Sonoma County, California",0,0,0
1000000US060971542022047,060971542022047,"Block 2047, Block Group 2, Census Tract 1542.02, Sonoma County, California",4,4,0
1000000US060971542022048,060971542022048,"Block 2048, Block Group 2, Census Tract 1542.02, Sonoma County, California",75,74,1
1000000US060971542022049,060971542022049,"Block 2049, Block Group 2, Census Tract 1542.02, Sonoma County, California",1,1,0
1000000US060971542022050,060971542022050,"Block 2050, Block Group 2, Census Tract 1542.02, Sonoma County, California",24,22,2
1000000US060971542022051,060971542022051,"Block 2051, Block Group 2, Census Tract 1542.02, Sonoma County, California",10,10,0
1000000US060971542022052,060971542022052,"Block 2052, Block Group 2, Census Tract 1542.02, Sonoma County, California",0,0,0
1000000US060971542022053,060971542022053,"Block 2053, Block Group 2, Census Tract 1542.02, Sonoma County, California",0,0,0
1000000US060971542022054,060971542022054,"Block 2054, Block Group 2, Census Tract 1542.02, Sonoma County, California",0,0,0
1000000US060971542022055,060971542022055,"Block 2055, Block Group 2, Census Tract 1542.02, Sonoma County, California",1,1,0
1000000US060971542022056,060971542022056,"Block 2056, Block Group 2, Census Tract 1542.02, Sonoma County, California",0,0,0
1000000US060971542022057,060971542022057,"Block 2057, Block Group 2, Census Tract 1542.02, Sonoma County, California",16,15,1
1000000US060971542022058,060971542022058,"Block 2058, Block Group 2, Census Tract 1542.02, Sonoma County, California",41,36,5
1000000US060971542022059,060971542022059,"Block 2059, Block Group 2, Census Tract 1542.02, Sonoma County, California",93,88,5
1000000US060971542022060,060971542022060,"Block 2060, Block Group 2, Census Tract 1542.02, Sonoma County, California",0,0,0
1000000US060971542022061,060971542022061,"Block 2061, Block Group 2, Census Tract 1542.02, Sonoma County, California",3,3,0
1000000US060971542022062,060971542022062,"Block 2062, Block Group 2, Census Tract 1542.02, Sonoma County, California",0,0,0
1000000US060971542022063,060971542022063,"Block 2063, Block Group 2, Census Tract 1542.02, Sonoma County, California",0,0,0
1000000US060971542022064,060971542022064,"Block 2064, Block Group 2, Census Tract 1542.02, Sonoma County, California",0,0,0
1000000US060971542022065,060971542022065,"Block 2065, Block Group 2, Census Tract 1542.02, Sonoma County, California",0,0,0
1000000US060971542022066,060971542022066,"Block 2066, Block Group 2, Census Tract 1542.02, Sonoma County, California",0,0,0
1000000US060971542022067,060971542022067,"Block 2067, Block Group 2, Census Tract 1542.02, Sonoma County, California",0,0,0
1000000US060971542022068,060971542022068,"Block 2068, Block Group 2, Census Tract 1542.02, Sonoma County, California",0,0,0
1000000US060971542022069,060971542022069,"Block 2069, Block Group 2, Census Tract 1542.02, Sonoma County, California",0,0,0
1000000US060971542022070,060971542022070,"Block 2070, Block Group 2, Census Tract 1542.02, Sonoma County, California",6,6,0
1000000US060971542022071,060971542022071,"Block 2071, Block Group 2, Census Tract 1542.02, Sonoma County, California",0,0,0
1000000US060971542022072,060971542022072,"Block 2072, Block Group 2, Census Tract 1542.02, Sonoma County, California",0,0,0
1000000US060971542022073,060971542022073,"Block 2073, Block Group 2, Census Tract 1542.02, Sonoma County, California",0,0,0
1000000US060971542022074,060971542022074,"Block 2074, Block Group 2, Census Tract 1542.02, Sonoma County, California",0,0,0
1000000US060971542023000,060971542023000,"Block 3000, Block Group 3, Census Tract 1542.02, Sonoma County, California",14,13,1
1000000US060971542023001,060971542023001,"Block 3001, Block Group 3, Census Tract 1542.02, Sonoma County, California",24,20,4
1000000US060971542023002,060971542023002,"Block 3002, Block Group 3, Census Tract 1542.02, Sonoma County, California",29,26,3
1000000US060971542023003,060971542023003,"Block 3003, Block Group 3, Census Tract 1542.02, Sonoma County, California",10,10,0
1000000US060971542023004,060971542023004,"Block 3004, Block Group 3, Census Tract 1542.02, Sonoma County, California",8,8,0
1000000US060971542023005,060971542023005,"Block 3005, Block Group 3, Census Tract 1542.02, Sonoma County, California",54,53,1
1000000US060971542023006,060971542023006,"Block 3006, Block Group 3, Census Tract 1542.02, Sonoma County, California",11,10,1
1000000US060971542023007,060971542023007,"Block 3007, Block Group 3, Census Tract 1542.02, Sonoma County, California",12,11,1
1000000US060971542023008,060971542023008,"Block 3008, Block Group 3, Census Tract 1542.02, Sonoma County, California",25,24,1
1000000US060971542023009,060971542023009,"Block 3009, Block Group 3, Census Tract 1542.02, Sonoma County, California",20,20,0
1000000US060971542023010,060971542023010,"Block 3010, Block Group 3, Census Tract 1542.02, Sonoma County, California",19,16,3
1000000US060971542023011,060971542023011,"Block 3011, Block Group 3, Census Tract 1542.02, Sonoma County, California",14,12,2
1000000US060971542023012,060971542023012,"Block 3012, Block Group 3, Census Tract 1542.02, Sonoma County, California",7,7,0
1000000US060971542023013,060971542023013,"Block 3013, Block Group 3, Census Tract 1542.02, Sonoma County, California",15,12,3
1000000US060971542023014,060971542023014,"Block 3014, Block Group 3, Census Tract 1542.02, Sonoma County, California",23,21,2
1000000US060971542023015,060971542023015,"Block 3015, Block Group 3, Census Tract 1542.02, Sonoma County, California",13,12,1
1000000US060971543021000,060971543021000,"Block 1000, Block Group 1, Census Tract 1543.02, Sonoma County, California",54,51,3
1000000US060971543021001,060971543021001,"Block 1001, Block Group 1, Census Tract 1543.02, Sonoma County, California",15,13,2
1000000US060971543021002,060971543021002,"Block 1002, Block Group 1, Census Tract 1543.02, Sonoma County, California",1,1,0
1000000US060971543021003,060971543021003,"Block 1003, Block Group 1, Census Tract 1543.02, Sonoma County, California",24,20,4
1000000US060971543021004,060971543021004,"Block 1004, Block Group 1, Census Tract 1543.02, Sonoma County, California",4,4,0
1000000US060971543021005,060971543021005,"Block 1005, Block Group 1, Census Tract 1543.02, Sonoma County, California",0,0,0
1000000US060971543021006,060971543021006,"Block 1006, Block Group 1, Census Tract 1543.02, Sonoma County, California",0,0,0
1000000US060971543021007,060971543021007,"Block 1007, Block Group 1, Census Tract 1543.02, Sonoma County, California",0,0,0
1000000US060971543021008,060971543021008,"Block 1008, Block Group 1, Census Tract 1543.02, Sonoma County, California",52,40,12
1000000US060971543021009,060971543021009,"Block 1009, Block Group 1, Census Tract 1543.02, Sonoma County, California",26,14,12
1000000US060971543021010,060971543021010,"Block 1010, Block Group 1, Census Tract 1543.02, Sonoma County, California",7,7,0
1000000US060971543021011,060971543021011,"Block 1011, Block Group 1, Census Tract 1543.02, Sonoma County, California",6,5,1
1000000US060971543021012,060971543021012,"Block 1012, Block Group 1, Census Tract 1543.02, Sonoma County, California",0,0,0
1000000US060971543021013,060971543021013,"Block 1013, Block Group 1, Census Tract 1543.02, Sonoma County, California",0,0,0
1000000US060971543021014,060971543021014,"Block 1014, Block Group 1, Census Tract 1543.02, Sonoma County, California",2,1,1
1000000US060971543021015,060971543021015,"Block 1015, Block Group 1, Census Tract 1543.02, Sonoma County, California",12,9,3
1000000US060971543021016,060971543021016,"Block 1016, Block Group 1, Census Tract 1543.02, Sonoma County, California",1,1,0
1000000US060971543021017,060971543021017,"Block 1017, Block Group 1, Census Tract 1543.02, Sonoma County, California",11,9,2
1000000US060971543021018,060971543021018,"Block 1018, Block Group 1, Census Tract 1543.02, Sonoma County, California",0,0,0
1000000US060971543021019,060971543021019,"Block 1019, Block Group 1, Census Tract 1543.02, Sonoma County, California",0,0,0
1000000US060971543021020,060971543021020,"Block 1020, Block Group 1, Census Tract 1543.02, Sonoma County, California",1,1,0
1000000US060971543021021,060971543021021,"Block 1021, Block Group 1, Census Tract 1543.02, Sonoma County, California",0,0,0
1000000US060971543021022,060971543021022,"Block 1022, Block Group 1, Census Tract 1543.02, Sonoma County, California",9,4,5
1000000US060971543021023,060971543021023,"Block 1023, Block Group 1, Census Tract 1543.02, Sonoma County, California",0,0,0
1000000US060971543021024,060971543021024,"Block 1024, Block Group 1, Census Tract 1543.02, Sonoma County, California",108,85,23
1000000US060971543021025,060971543021025,"Block 1025, Block Group 1, Census Tract 1543.02, Sonoma County, California",0,0,0
1000000US060971543021026,060971543021026,"Block 1026, Block Group 1, Census Tract 1543.02, Sonoma County, California",5,3,2
1000000US060971543021027,060971543021027,"Block 1027, Block Group 1, Census Tract 1543.02, Sonoma County, California",0,0,0
1000000US060971543021028,060971543021028,"Block 1028, Block Group 1, Census Tract 1543.02, Sonoma County, California",7,4,3
1000000US060971543021029,060971543021029,"Block 1029, Block Group 1, Census Tract 1543.02, Sonoma County, California",1,1,0
1000000US060971543021030,060971543021030,"Block 1030, Block Group 1, Census Tract 1543.02, Sonoma County, California",18,14,4
1000000US060971543021031,060971543021031,"Block 1031, Block Group 1, Census Tract 1543.02, Sonoma County, California",1,1,0
1000000US060971543021032,060971543021032,"Block 1032, Block Group 1, Census Tract 1543.02, Sonoma County, California",4,4,0
1000000US060971543021033,060971543021033,"Block 1033, Block Group 1, Census Tract 1543.02, Sonoma County, California",13,10,3
1000000US060971543021034,060971543021034,"Block 1034, Block Group 1, Census Tract 1543.02, Sonoma County, California",17,14,3
1000000US060971543021035,060971543021035,"Block 1035, Block Group 1, Census Tract 1543.02, Sonoma County, California",8,6,2
1000000US060971543021036,060971543021036,"Block 1036, Block Group 1, Census Tract 1543.02, Sonoma County, California",11,9,2
1000000US060971543021037,060971543021037,"Block 1037, Block Group 1, Census Tract 1543.02, Sonoma County, California",19,11,8
1000000US060971543021038,060971543021038,"Block 1038, Block Group 1, Census Tract 1543.02, Sonoma County, California",8,5,3
1000000US060971543021039,060971543021039,"Block 1039, Block Group 1, Census Tract 1543.02, Sonoma County, California",7,4,3
1000000US060971543021040,060971543021040,"Block 1040, Block Group 1, Census Tract 1543.02, Sonoma County, California",0,0,0
1000000US060971543021041,060971543021041,"Block 1041, Block Group 1, Census Tract 1543.02, Sonoma County, California",0,0,0
1000000US060971543021042,060971543021042,"Block 1042, Block Group 1, Census Tract 1543.02, Sonoma County, California",2,2,0
1000000US060971543021043,060971543021043,"Block 1043, Block Group 1, Census Tract 1543.02, Sonoma County, California",15,11,4
1000000US060971543021044,060971543021044,"Block 1044, Block Group 1, Census Tract 1543.02, Sonoma County, California",12,7,5
1000000US060971543021045,060971543021045,"Block 1045, Block Group 1, Census Tract 1543.02, Sonoma County, California",22,18,4
1000000US060971543021046,060971543021046,"Block 1046, Block Group 1, Census Tract 1543.02, Sonoma County, California",8,6,2
1000000US060971543021047,060971543021047,"Block 1047, Block Group 1, Census Tract 1543.02, Sonoma County, California",13,11,2
1000000US060971543021048,060971543021048,"Block 1048, Block Group 1, Census Tract 1543.02, Sonoma County, California",4,3,1
1000000US060971543022000,060971543022000,"Block 2000, Block Group 2, Census Tract 1543.02, Sonoma County, California",12,12,0
1000000US060971543022001,060971543022001,"Block 2001, Block Group 2, Census Tract 1543.02, Sonoma County, California",235,194,41
1000000US060971543022002,060971543022002,"Block 2002, Block Group 2, Census Tract 1543.02, Sonoma County, California",0,0,0
1000000US060971543022003,060971543022003,"Block 2003, Block Group 2, Census Tract 1543.02, Sonoma County, California",2,2,0
1000000US060971543022004,060971543022004,"Block 2004, Block Group 2, Census Tract 1543.02, Sonoma County, California",1,1,0
1000000US060971543022005,060971543022005,"Block 2005, Block Group 2, Census Tract 1543.02, Sonoma County, California",3,2,1
1000000US060971543022006,060971543022006,"Block 2006, Block Group 2, Census Tract 1543.02, Sonoma County, California",2,2,0
1000000US060971543022007,060971543022007,"Block 2007, Block Group 2, Census Tract 1543.02, Sonoma County, California",0,0,0
1000000US060971543022008,060971543022008,"Block 2008, Block Group 2, Census Tract 1543.02, Sonoma County, California",0,0,0
1000000US060971543022009,060971543022009,"Block 2009, Block Group 2, Census Tract 1543.02, Sonoma County, California",127,118,9
1000000US060971543022010,060971543022010,"Block 2010, Block Group 2, Census Tract 1543.02, Sonoma County, California",2,1,1
1000000US060971543022011,060971543022011,"Block 2011, Block Group 2, Census Tract 1543.02, Sonoma County, California",0,0,0
1000000US060971543022012,060971543022012,"Block 2012, Block Group 2, Census Tract 1543.02, Sonoma County, California",0,0,0
1000000US060971543022013,060971543022013,"Block 2013, Block Group 2, Census Tract 1543.02, Sonoma County, California",3,3,0
1000000US060971543022014,060971543022014,"Block 2014, Block Group 2, Census Tract 1543.02, Sonoma County, California",11,9,2
1000000US060971543022015,060971543022015,"Block 2015, Block Group 2, Census Tract 1543.02, Sonoma County, California",2,0,2
1000000US060971543022016,060971543022016,"Block 2016, Block Group 2, Census Tract 1543.02, Sonoma County, California",5,1,4
1000000US060971543022017,060971543022017,"Block 2017, Block Group 2, Census Tract 1543.02, Sonoma County, California",164,135,29
1000000US060971543022018,060971543022018,"Block 2018, Block Group 2, Census Tract 1543.02, Sonoma County, California",11,10,1
1000000US060971543022019,060971543022019,"Block 2019, Block Group 2, Census Tract 1543.02, Sonoma County, California",1,0,1
1000000US060971543022020,060971543022020,"Block 2020, Block Group 2, Census Tract 1543.02, Sonoma County, California",0,0,0
1000000US060971543022021,060971543022021,"Block 2021, Block Group 2, Census Tract 1543.02, Sonoma County, California",17,15,2
1000000US060971543022022,060971543022022,"Block 2022, Block Group 2, Census Tract 1543.02, Sonoma County, California",0,0,0
1000000US060971543022023,060971543022023,"Block 2023, Block Group 2, Census Tract 1543.02, Sonoma County, California",6,5,1
1000000US060971543022024,060971543022024,"Block 2024, Block Group 2, Census Tract 1543.02, Sonoma County, California",0,0,0
1000000US060971543022025,060971543022025,"Block 2025, Block Group 2, Census Tract 1543.02, Sonoma County, California",0,0,0
1000000US060971543022026,060971543022026,"Block 2026, Block Group 2, Census Tract 1543.02, Sonoma County, California",1,1,0
1000000US060971543022027,060971543022027,"Block 2027, Block Group 2, Census Tract 1543.02, Sonoma County, California",0,0,0
1000000US060971543022028,060971543022028,"Block 2028, Block Group 2, Census Tract 1543.02, Sonoma County, California",0,0,0
1000000US060971543022029,060971543022029,"Block 2029, Block Group 2, Census Tract 1543.02, Sonoma County, California",0,0,0
1000000US060971543023000,060971543023000,"Block 3000, Block Group 3, Census Tract 1543.02, Sonoma County, California",240,195,45
1000000US060971543023001,060971543023001,"Block 3001, Block Group 3, Census Tract 1543.02, Sonoma County, California",0,0,0
1000000US060971543023002,060971543023002,"Block 3002, Block Group 3, Census Tract 1543.02, Sonoma County, California",0,0,0
1000000US060971543023003,060971543023003,"Block 3003, Block Group 3, Census Tract 1543.02, Sonoma County, California",0,0,0
1000000US060971543023004,060971543023004,"Block 3004, Block Group 3, Census Tract 1543.02, Sonoma County, California",1,1,0
1000000US060971543023005,060971543023005,"Block 3005, Block Group 3, Census Tract 1543.02, Sonoma County, California",2,1,1
1000000US060971543023006,060971543023006,"Block 3006, Block Group 3, Census Tract 1543.02, Sonoma County, California",0,0,0
1000000US060971543023007,060971543023007,"Block 3007, Block Group 3, Census Tract 1543.02, Sonoma County, California",5,5,0
1000000US060971543023008,060971543023008,"Block 3008, Block Group 3, Census Tract 1543.02, Sonoma County, California",0,0,0
1000000US060971543023009,060971543023009,"Block 3009, Block Group 3, Census Tract 1543.02, Sonoma County, California",0,0,0
1000000US060971543023010,060971543023010,"Block 3010, Block Group 3, Census Tract 1543.02, Sonoma County, California",7,6,1
1000000US060971543023011,060971543023011,"Block 3011, Block Group 3, Census Tract 1543.02, Sonoma County, California",0,0,0
1000000US060971543023012,060971543023012,"Block 3012, Block Group 3, Census Tract 1543.02, Sonoma County, California",0,0,0
1000000US060971543023013,060971543023013,"Block 3013, Block Group 3, Census Tract 1543.02, Sonoma County, California",0,0,0
1000000US060971543023014,060971543023014,"Block 3014, Block Group 3, Census Tract 1543.02, Sonoma County, California",0,0,0
1000000US060971543023015,060971543023015,"Block 3015, Block Group 3, Census Tract 1543.02, Sonoma County, California",0,0,0
1000000US060971543023016,060971543023016,"Block 3016, Block Group 3, Census Tract 1543.02, Sonoma County, California",17,10,7
1000000US060971543023017,060971543023017,"Block 3017, Block Group 3, Census Tract 1543.02, Sonoma County, California",2,1,1
1000000US060971543023018,060971543023018,"Block 3018, Block Group 3, Census Tract 1543.02, Sonoma County, California",0,0,0
1000000US060971543023019,060971543023019,"Block 3019, Block Group 3, Census Tract 1543.02, Sonoma County, California",10,5,5
1000000US060971543023020,060971543023020,"Block 3020, Block Group 3, Census Tract 1543.02, Sonoma County, California",10,7,3
1000000US060971543023021,060971543023021,"Block 3021, Block Group 3, Census Tract 1543.02, Sonoma County, California",0,0,0
1000000US060971543023022,060971543023022,"Block 3022, Block Group 3, Census Tract 1543.02, Sonoma County, California",0,0,0
1000000US060971543023023,060971543023023,"Block 3023, Block Group 3, Census Tract 1543.02, Sonoma County, California",1,0,1
1000000US060971543023024,060971543023024,"Block 3024, Block Group 3, Census Tract 1543.02, Sonoma County, California",1,1,0
1000000US060971543023025,060971543023025,"Block 3025, Block Group 3, Census Tract 1543.02, Sonoma County, California",2,2,0
1000000US060971543023026,060971543023026,"Block 3026, Block Group 3, Census Tract 1543.02, Sonoma County, California",0,0,0
1000000US060971543023027,060971543023027,"Block 3027, Block Group 3, Census Tract 1543.02, Sonoma County, California",66,48,18
1000000US060971543023028,060971543023028,"Block 3028, Block Group 3, Census Tract 1543.02, Sonoma County, California",12,11,1
1000000US060971543023029,060971543023029,"Block 3029, Block Group 3, Census Tract 1543.02, Sonoma County, California",5,3,2
1000000US060971543023030,060971543023030,"Block 3030, Block Group 3, Census Tract 1543.02, Sonoma County, California",51,48,3
1000000US060971543023031,060971543023031,"Block 3031, Block Group 3, Census Tract 1543.02, Sonoma County, California",16,10,6
1000000US060971543023032,060971543023032,"Block 3032, Block Group 3, Census Tract 1543.02, Sonoma County, California",11,11,0
1000000US060971543023033,060971543023033,"Block 3033, Block Group 3, Census Tract 1543.02, Sonoma County, California",4,4,0
1000000US060971543023034,060971543023034,"Block 3034, Block Group 3, Census Tract 1543.02, Sonoma County, California",0,0,0
1000000US060971543023035,060971543023035,"Block 3035, Block Group 3, Census Tract 1543.02, Sonoma County, California",14,13,1
1000000US060971543023036,060971543023036,"Block 3036, Block Group 3, Census Tract 1543.02, Sonoma County, California",0,0,0
1000000US060971543024000,060971543024000,"Block 4000, Block Group 4, Census Tract 1543.02, Sonoma County, California",20,15,5
1000000US060971543024001,060971543024001,"Block 4001, Block Group 4, Census Tract 1543.02, Sonoma County, California",1,1,0
1000000US060971543024002,060971543024002,"Block 4002, Block Group 4, Census Tract 1543.02, Sonoma County, California",1,0,1
1000000US060971543024003,060971543024003,"Block 4003, Block Group 4, Census Tract 1543.02, Sonoma County, California",1,1,0
1000000US060971543024004,060971543024004,"Block 4004, Block Group 4, Census Tract 1543.02, Sonoma County, California",0,0,0
1000000US060971543024005,060971543024005,"Block 4005, Block Group 4, Census Tract 1543.02, Sonoma County, California",4,3,1
1000000US060971543024006,060971543024006,"Block 4006, Block Group 4, Census Tract 1543.02, Sonoma County, California",4,4,0
1000000US060971543024007,060971543024007,"Block 4007, Block Group 4, Census Tract 1543.02, Sonoma County, California",9,9,0
1000000US060971543024008,060971543024008,"Block 4008, Block Group 4, Census Tract 1543.02, Sonoma County, California",3,3,0
1000000US060971543024009,060971543024009,"Block 4009, Block Group 4, Census Tract 1543.02, Sonoma County, California",0,0,0
1000000US060971543024010,060971543024010,"Block 4010, Block Group 4, Census Tract 1543.02, Sonoma County, California",4,4,0
1000000US060971543024011,060971543024011,"Block 4011, Block Group 4, Census Tract 1543.02, Sonoma County, California",2,2,0
1000000US060971543024012,060971543024012,"Block 4012, Block Group 4, Census Tract 1543.02, Sonoma County, California",2,2,0
1000000US060971543024013,060971543024013,"Block 4013, Block Group 4, Census Tract 1543.02, Sonoma County, California",3,0,3
1000000US060971543024014,060971543024014,"Block 4014, Block Group 4, Census Tract 1543.02, Sonoma County, California",3,2,1
1000000US060971543024015,060971543024015,"Block 4015, Block Group 4, Census Tract 1543.02, Sonoma County, California",0,0,0
1000000US060971543024016,060971543024016,"Block 4016, Block Group 4, Census Tract 1543.02, Sonoma County, California",1,1,0
1000000US060971543024017,060971543024017,"Block 4017, Block Group 4, Census Tract 1543.02, Sonoma County, California",229,139,90
1000000US060971543024018,060971543024018,"Block 4018, Block Group 4, Census Tract 1543.02, Sonoma County, California",12,9,3
1000000US060971543024019,060971543024019,"Block 4019, Block Group 4, Census Tract 1543.02, Sonoma County, California",7,3,4
1000000US060971543024020,060971543024020,"Block 4020, Block Group 4, Census Tract 1543.02, Sonoma County, California",8,6,2
1000000US060971543024021,060971543024021,"Block 4021, Block Group 4, Census Tract 1543.02, Sonoma County, California",3,3,0
1000000US060971543024022,060971543024022,"Block 4022, Block Group 4, Census Tract 1543.02, Sonoma County, California",19,12,7
1000000US060971543024023,060971543024023,"Block 4023, Block Group 4, Census Tract 1543.02, Sonoma County, California",37,16,21
1000000US060971543024024,060971543024024,"Block 4024, Block Group 4, Census Tract 1543.02, Sonoma County, California",2,2,0
1000000US060971543024025,060971543024025,"Block 4025, Block Group 4, Census Tract 1543.02, Sonoma County, California",8,5,3
1000000US060971543024026,060971543024026,"Block 4026, Block Group 4, Census Tract 1543.02, Sonoma County, California",9,4,5
1000000US060971543024027,060971543024027,"Block 4027, Block Group 4, Census Tract 1543.02, Sonoma County, California",0,0,0
1000000US060971543024028,060971543024028,"Block 4028, Block Group 4, Census Tract 1543.02, Sonoma County, California",0,0,0
1000000US060971543024029,060971543024029,"Block 4029, Block Group 4, Census Tract 1543.02, Sonoma County, California",0,0,0
1000000US060971543024030,060971543024030,"Block 4030, Block Group 4, Census Tract 1543.02, Sonoma County, California",0,0,0
1000000US060971543024031,060971543024031,"Block 4031, Block Group 4, Census Tract 1543.02, Sonoma County, California",0,0,0
1000000US060971543024032,060971543024032,"Block 4032, Block Group 4, Census Tract 1543.02, Sonoma County, California",8,4,4
1000000US060971543024033,060971543024033,"Block 4033, Block Group 4, Census Tract 1543.02, Sonoma County, California",1,1,0
1000000US060971543024034,060971543024034,"Block 4034, Block Group 4, Census Tract 1543.02, Sonoma County, California",0,0,0
1000000US060971543024035,060971543024035,"Block 4035, Block Group 4, Census Tract 1543.02, Sonoma County, California",0,0,0
1000000US060971543024036,060971543024036,"Block 4036, Block Group 4, Census Tract 1543.02, Sonoma County, California",0,0,0
1000000US060971543024037,060971543024037,"Block 4037, Block Group 4, Census Tract 1543.02, Sonoma County, California",0,0,0
1000000US060971543024038,060971543024038,"Block 4038, Block Group 4, Census Tract 1543.02, Sonoma County, California",0,0,0
1000000US060971543024039,060971543024039,"Block 4039, Block Group 4, Census Tract 1543.02, Sonoma County, California",0,0,0
1000000US060971543024040,060971543024040,"Block 4040, Block Group 4, Census Tract 1543.02, Sonoma County, California",0,0,0
1000000US060971543024041,060971543024041,"Block 4041, Block Group 4, Census Tract 1543.02, Sonoma County, California",0,0,0
1000000US060971543024042,060971543024042,"Block 4042, Block Group 4, Census Tract 1543.02, Sonoma County, California",237,90,147
1000000US060971543024043,060971543024043,"Block 4043, Block Group 4, Census Tract 1543.02, Sonoma County, California",210,95,115
1000000US060971543024044,060971543024044,"Block 4044, Block Group 4, Census Tract 1543.02, Sonoma County, California",17,5,12
1000000US060971543024045,060971543024045,"Block 4045, Block Group 4, Census Tract 1543.02, Sonoma County, California",27,8,19
1000000US060971543024046,060971543024046,"Block 4046, Block Group 4, Census Tract 1543.02, Sonoma County, California",6,2,4
1000000US060971543024047,060971543024047,"Block 4047, Block Group 4, Census Tract 1543.02, Sonoma County, California",21,8,13
1000000US060971543024048,060971543024048,"Block 4048, Block Group 4, Census Tract 1543.02, Sonoma County, California",1,0,1
1000000US060971543024049,060971543024049,"Block 4049, Block Group 4, Census Tract 1543.02, Sonoma County, California",17,9,8
1000000US060971543024050,060971543024050,"Block 4050, Block Group 4, Census Tract 1543.02, Sonoma County, California",5,2,3
1000000US060971543024051,060971543024051,"Block 4051, Block Group 4, Census Tract 1543.02, Sonoma County, California",5,1,4
1000000US060971543024052,060971543024052,"Block 4052, Block Group 4, Census Tract 1543.02, Sonoma County, California",0,0,0
1000000US060971543024053,060971543024053,"Block 4053, Block Group 4, Census Tract 1543.02, Sonoma County, California",3,1,2
1000000US060971543024054,060971543024054,"Block 4054, Block Group 4, Census Tract 1543.02, Sonoma County, California",0,0,0
1000000US060971543024055,060971543024055,"Block 4055, Block Group 4, Census Tract 1543.02, Sonoma County, California",4,2,2
1000000US060971543024056,060971543024056,"Block 4056, Block Group 4, Census Tract 1543.02, Sonoma County, California",0,0,0
1000000US060971543024057,060971543024057,"Block 4057, Block Group 4, Census Tract 1543.02, Sonoma County, California",6,6,0
1000000US060971543024058,060971543024058,"Block 4058, Block Group 4, Census Tract 1543.02, Sonoma County, California",2,1,1
1000000US060971543024059,060971543024059,"Block 4059, Block Group 4, Census Tract 1543.02, Sonoma County, California",0,0,0
1000000US060971543024060,060971543024060,"Block 4060, Block Group 4, Census Tract 1543.02, Sonoma County, California",0,0,0
1000000US060971543024061,060971543024061,"Block 4061, Block Group 4, Census Tract 1543.02, Sonoma County, California",0,0,0
1000000US060971543024062,060971543024062,"Block 4062, Block Group 4, Census Tract 1543.02, Sonoma County, California",0,0,0
1000000US060971543024063,060971543024063,"Block 4063, Block Group 4, Census Tract 1543.02, Sonoma County, California",2,2,0
1000000US060971543024064,060971543024064,"Block 4064, Block Group 4, Census Tract 1543.02, Sonoma County, California",0,0,0
1000000US060971543031000,060971543031000,"Block 1000, Block Group 1, Census Tract 1543.03, Sonoma County, California",109,57,52
1000000US060971543031001,060971543031001,"Block 1001, Block Group 1, Census Tract 1543.03, Sonoma County, California",293,87,206
1000000US060971543031002,060971543031002,"Block 1002, Block Group 1, Census Tract 1543.03, Sonoma County, California",0,0,0
1000000US060971543031003,060971543031003,"Block 1003, Block Group 1, Census Tract 1543.03, Sonoma County, California",0,0,0
1000000US060971543031004,060971543031004,"Block 1004, Block Group 1, Census Tract 1543.03, Sonoma County, California",3,2,1
1000000US060971543031005,060971543031005,"Block 1005, Block Group 1, Census Tract 1543.03, Sonoma County, California",69,36,33
1000000US060971543031006,060971543031006,"Block 1006, Block Group 1, Census Tract 1543.03, Sonoma County, California",5,2,3
1000000US060971543031007,060971543031007,"Block 1007, Block Group 1, Census Tract 1543.03, Sonoma County, California",5,4,1
1000000US060971543031008,060971543031008,"Block 1008, Block Group 1, Census Tract 1543.03, Sonoma County, California",6,4,2
1000000US060971543031009,060971543031009,"Block 1009, Block Group 1, Census Tract 1543.03, Sonoma County, California",4,1,3
1000000US060971543031010,060971543031010,"Block 1010, Block Group 1, Census Tract 1543.03, Sonoma County, California",4,1,3
1000000US060971543031011,060971543031011,"Block 1011, Block Group 1, Census Tract 1543.03, Sonoma County, California",84,32,52
1000000US060971543031012,060971543031012,"Block 1012, Block Group 1, Census Tract 1543.03, Sonoma County, California",23,12,11
1000000US060971543031013,060971543031013,"Block 1013, Block Group 1, Census Tract 1543.03, Sonoma County, California",23,10,13
1000000US060971543031014,060971543031014,"Block 1014, Block Group 1, Census Tract 1543.03, Sonoma County, California",10,3,7
1000000US060971543031015,060971543031015,"Block 1015, Block Group 1, Census Tract 1543.03, Sonoma County, California",0,0,0
1000000US060971543031016,060971543031016,"Block 1016, Block Group 1, Census Tract 1543.03, Sonoma County, California",2,1,1
1000000US060971543031017,060971543031017,"Block 1017, Block Group 1, Census Tract 1543.03, Sonoma County, California",0,0,0
1000000US060971543031018,060971543031018,"Block 1018, Block Group 1, Census Tract 1543.03, Sonoma County, California",0,0,0
1000000US060971543031019,060971543031019,"Block 1019, Block Group 1, Census Tract 1543.03, Sonoma County, California",0,0,0
1000000US060971543031020,060971543031020,"Block 1020, Block Group 1, Census Tract 1543.03, Sonoma County, California",0,0,0
1000000US060971543031021,060971543031021,"Block 1021, Block Group 1, Census Tract 1543.03, Sonoma County, California",0,0,0
1000000US060971543031022,060971543031022,"Block 1022, Block Group 1, Census Tract 1543.03, Sonoma County, California",0,0,0
1000000US060971543031023,060971543031023,"Block 1023, Block Group 1, Census Tract 1543.03, Sonoma County, California",0,0,0
1000000US060971543031024,060971543031024,"Block 1024, Block Group 1, Census Tract 1543.03, Sonoma County, California",0,0,0
1000000US060971543031025,060971543031025,"Block 1025, Block Group 1, Census Tract 1543.03, Sonoma County, California",2,2,0
1000000US060971543031026,060971543031026,"Block 1026, Block Group 1, Census Tract 1543.03, Sonoma County, California",26,14,12
1000000US060971543031027,060971543031027,"Block 1027, Block Group 1, Census Tract 1543.03, Sonoma County, California",0,0,0
1000000US060971543031028,060971543031028,"Block 1028, Block Group 1, Census Tract 1543.03, Sonoma County, California",0,0,0
1000000US060971543031029,060971543031029,"Block 1029, Block Group 1, Census Tract 1543.03, Sonoma County, California",0,0,0
1000000US060971543031030,060971543031030,"Block 1030, Block Group 1, Census Tract 1543.03, Sonoma County, California",0,0,0
1000000US060971543031031,060971543031031,"Block 1031, Block Group 1, Census Tract 1543.03, Sonoma County, California",28,17,11
1000000US060971543031032,060971543031032,"Block 1032, Block Group 1, Census Tract 1543.03, Sonoma County, California",0,0,0
1000000US060971543031033,060971543031033,"Block 1033, Block Group 1, Census Tract 1543.03, Sonoma County, California",6,6,0
1000000US060971543031034,060971543031034,"Block 1034, Block Group 1, Census Tract 1543.03, Sonoma County, California",0,0,0
1000000US060971543031035,060971543031035,"Block 1035, Block Group 1, Census Tract 1543.03, Sonoma County, California",0,0,0
1000000US060971543031036,060971543031036,"Block 1036, Block Group 1, Census Tract 1543.03, Sonoma County, California",4,4,0
1000000US060971543031037,060971543031037,"Block 1037, Block Group 1, Census Tract 1543.03, Sonoma County, California",0,0,0
1000000US060971543031038,060971543031038,"Block 1038, Block Group 1, Census Tract 1543.03, Sonoma County, California",0,0,0
1000000US060971543031039,060971543031039,"Block 1039, Block Group 1, Census Tract 1543.03, Sonoma County, California",28,10,18
1000000US060971543031040,060971543031040,"Block 1040, Block Group 1, Census Tract 1543.03, Sonoma County, California",0,0,0
1000000US060971543031041,060971543031041,"Block 1041, Block Group 1, Census Tract 1543.03, Sonoma County, California",0,0,0
1000000US060971543031042,060971543031042,"Block 1042, Block Group 1, Census Tract 1543.03, Sonoma County, California",0,0,0
1000000US060971543031043,060971543031043,"Block 1043, Block Group 1, Census Tract 1543.03, Sonoma County, California",0,0,0
1000000US060971543031044,060971543031044,"Block 1044, Block Group 1, Census Tract 1543.03, Sonoma County, California",0,0,0
1000000US060971543031045,060971543031045,"Block 1045, Block Group 1, Census Tract 1543.03, Sonoma County, California",0,0,0
1000000US060971543031046,060971543031046,"Block 1046, Block Group 1, Census Tract 1543.03, Sonoma County, California",0,0,0
1000000US060971543031047,060971543031047,"Block 1047, Block Group 1, Census Tract 1543.03, Sonoma County, California",11,7,4
1000000US060971543031048,060971543031048,"Block 1048, Block Group 1, Census Tract 1543.03, Sonoma County, California",0,0,0
1000000US060971543031049,060971543031049,"Block 1049, Block Group 1, Census Tract 1543.03, Sonoma County, California",0,0,0
1000000US060971543031050,060971543031050,"Block 1050, Block Group 1, Census Tract 1543.03, Sonoma County, California",14,4,10
1000000US060971543031051,060971543031051,"Block 1051, Block Group 1, Census Tract 1543.03, Sonoma County, California",0,0,0
1000000US060971543031052,060971543031052,"Block 1052, Block Group 1, Census Tract 1543.03, Sonoma County, California",0,0,0
1000000US060971543031053,060971543031053,"Block 1053, Block Group 1, Census Tract 1543.03, Sonoma County, California",0,0,0
1000000US060971543031054,060971543031054,"Block 1054, Block Group 1, Census Tract 1543.03, Sonoma County, California",0,0,0
1000000US060971543031055,060971543031055,"Block 1055, Block Group 1, Census Tract 1543.03, Sonoma County, California",0,0,0
1000000US060971543031056,060971543031056,"Block 1056, Block Group 1, Census Tract 1543.03, Sonoma County, California",8,7,1
1000000US060971543031057,060971543031057,"Block 1057, Block Group 1, Census Tract 1543.03, Sonoma County, California",0,0,0
1000000US060971543031058,060971543031058,"Block 1058, Block Group 1, Census Tract 1543.03, Sonoma County, California",0,0,0
1000000US060971543031059,060971543031059,"Block 1059, Block Group 1, Census Tract 1543.03, Sonoma County, California",1,1,0
1000000US060971543031060,060971543031060,"Block 1060, Block Group 1, Census Tract 1543.03, Sonoma County, California",21,10,11
1000000US060971543031061,060971543031061,"Block 1061, Block Group 1, Census Tract 1543.03, Sonoma County, California",0,0,0
1000000US060971543031062,060971543031062,"Block 1062, Block Group 1, Census Tract 1543.03, Sonoma County, California",0,0,0
1000000US060971543031063,060971543031063,"Block 1063, Block Group 1, Census Tract 1543.03, Sonoma County, California",30,22,8
1000000US060971543031064,060971543031064,"Block 1064, Block Group 1, Census Tract 1543.03, Sonoma County, California",22,10,12
1000000US060971543031065,060971543031065,"Block 1065, Block Group 1, Census Tract 1543.03, Sonoma County, California",0,0,0
1000000US060971543031066,060971543031066,"Block 1066, Block Group 1, Census Tract 1543.03, Sonoma County, California",1,1,0
1000000US060971543031067,060971543031067,"Block 1067, Block Group 1, Census Tract 1543.03, Sonoma County, California",0,0,0
1000000US060971543031068,060971543031068,"Block 1068, Block Group 1, Census Tract 1543.03, Sonoma County, California",1,1,0
1000000US060971543031069,060971543031069,"Block 1069, Block Group 1, Census Tract 1543.03, Sonoma County, California",13,6,7
1000000US060971543031070,060971543031070,"Block 1070, Block Group 1, Census Tract 1543.03, Sonoma County, California",0,0,0
1000000US060971543031071,060971543031071,"Block 1071, Block Group 1, Census Tract 1543.03, Sonoma County, California",20,9,11
1000000US060971543031072,060971543031072,"Block 1072, Block Group 1, Census Tract 1543.03, Sonoma County, California",31,18,13
1000000US060971543031073,060971543031073,"Block 1073, Block Group 1, Census Tract 1543.03, Sonoma County, California",0,0,0
1000000US060971543031074,060971543031074,"Block 1074, Block Group 1, Census Tract 1543.03, Sonoma County, California",4,2,2
1000000US060971543031075,060971543031075,"Block 1075, Block Group 1, Census Tract 1543.03, Sonoma County, California",5,5,0
1000000US060971543031076,060971543031076,"Block 1076, Block Group 1, Census Tract 1543.03, Sonoma County, California",3,3,0
1000000US060971543031077,060971543031077,"Block 1077, Block Group 1, Census Tract 1543.03, Sonoma County, California",0,0,0
1000000US060971543031078,060971543031078,"Block 1078, Block Group 1, Census Tract 1543.03, Sonoma County, California",0,0,0
1000000US060971543031079,060971543031079,"Block 1079, Block Group 1, Census Tract 1543.03, Sonoma County, California",0,0,0
1000000US060971543031080,060971543031080,"Block 1080, Block Group 1, Census Tract 1543.03, Sonoma County, California",0,0,0
1000000US060971543031081,060971543031081,"Block 1081, Block Group 1, Census Tract 1543.03, Sonoma County, California",0,0,0
1000000US060971543031082,060971543031082,"Block 1082, Block Group 1, Census Tract 1543.03, Sonoma County, California",0,0,0
1000000US060971543031083,060971543031083,"Block 1083, Block Group 1, Census Tract 1543.03, Sonoma County, California",22,9,13
1000000US060971543031084,060971543031084,"Block 1084, Block Group 1, Census Tract 1543.03, Sonoma County, California",2,2,0
1000000US060971543031085,060971543031085,"Block 1085, Block Group 1, Census Tract 1543.03, Sonoma County, California",1,0,1
1000000US060971543031086,060971543031086,"Block 1086, Block Group 1, Census Tract 1543.03, Sonoma County, California",0,0,0
1000000US060971543031087,060971543031087,"Block 1087, Block Group 1, Census Tract 1543.03, Sonoma County, California",38,21,17
1000000US060971543031088,060971543031088,"Block 1088, Block Group 1, Census Tract 1543.03, Sonoma County, California",3,0,3
1000000US060971543031089,060971543031089,"Block 1089, Block Group 1, Census Tract 1543.03, Sonoma County, California",3,1,2
1000000US060971543031090,060971543031090,"Block 1090, Block Group 1, Census Tract 1543.03, Sonoma County, California",0,0,0
1000000US060971543031091,060971543031091,"Block 1091, Block Group 1, Census Tract 1543.03, Sonoma County, California",0,0,0
1000000US060971543031092,060971543031092,"Block 1092, Block Group 1, Census Tract 1543.03, Sonoma County, California",0,0,0
1000000US060971543032000,060971543032000,"Block 2000, Block Group 2, Census Tract 1543.03, Sonoma County, California",324,163,161
1000000US060971543032001,060971543032001,"Block 2001, Block Group 2, Census Tract 1543.03, Sonoma County, California",51,14,37
1000000US060971543032002,060971543032002,"Block 2002, Block Group 2, Census Tract 1543.03, Sonoma County, California",12,7,5
1000000US060971543032003,060971543032003,"Block 2003, Block Group 2, Census Tract 1543.03, Sonoma County, California",21,11,10
1000000US060971543032004,060971543032004,"Block 2004, Block Group 2, Census Tract 1543.03, Sonoma County, California",310,91,219
1000000US060971543032005,060971543032005,"Block 2005, Block Group 2, Census Tract 1543.03, Sonoma County, California",28,10,18
1000000US060971543032006,060971543032006,"Block 2006, Block Group 2, Census Tract 1543.03, Sonoma County, California",24,5,19
1000000US060971543032007,060971543032007,"Block 2007, Block Group 2, Census Tract 1543.03, Sonoma County, California",11,2,9
1000000US060971543032008,060971543032008,"Block 2008, Block Group 2, Census Tract 1543.03, Sonoma County, California",50,18,32
1000000US060971543032009,060971543032009,"Block 2009, Block Group 2, Census Tract 1543.03, Sonoma County, California",0,0,0
1000000US060971543032010,060971543032010,"Block 2010, Block Group 2, Census Tract 1543.03, Sonoma County, California",0,0,0
1000000US060971543032011,060971543032011,"Block 2011, Block Group 2, Census Tract 1543.03, Sonoma County, California",73,29,44
1000000US060971543032012,060971543032012,"Block 2012, Block Group 2, Census Tract 1543.03, Sonoma County, California",0,0,0
1000000US060971543032013,060971543032013,"Block 2013, Block Group 2, Census Tract 1543.03, Sonoma County, California",0,0,0
1000000US060971543032014,060971543032014,"Block 2014, Block Group 2, Census Tract 1543.03, Sonoma County, California",170,55,115
1000000US060971543032015,060971543032015,"Block 2015, Block Group 2, Census Tract 1543.03, Sonoma County, California",18,4,14
1000000US060971543032016,060971543032016,"Block 2016, Block Group 2, Census Tract 1543.03, Sonoma County, California",21,10,11
1000000US060971543032017,060971543032017,"Block 2017, Block Group 2, Census Tract 1543.03, Sonoma County, California",5,1,4
1000000US060971543032018,060971543032018,"Block 2018, Block Group 2, Census Tract 1543.03, Sonoma County, California",0,0,0
1000000US060971543032019,060971543032019,"Block 2019, Block Group 2, Census Tract 1543.03, Sonoma County, California",0,0,0
1000000US060971543032020,060971543032020,"Block 2020, Block Group 2, Census Tract 1543.03, Sonoma County, California",0,0,0
1000000US060971543032021,060971543032021,"Block 2021, Block Group 2, Census Tract 1543.03, Sonoma County, California",0,0,0
1000000US060971543032022,060971543032022,"Block 2022, Block Group 2, Census Tract 1543.03, Sonoma County, California",38,7,31
1000000US060971543032023,060971543032023,"Block 2023, Block Group 2, Census Tract 1543.03, Sonoma County, California",0,0,0
1000000US060971543032024,060971543032024,"Block 2024, Block Group 2, Census Tract 1543.03, Sonoma County, California",0,0,0
1000000US060971543032025,060971543032025,"Block 2025, Block Group 2, Census Tract 1543.03, Sonoma County, California",0,0,0
1000000US060971543032026,060971543032026,"Block 2026, Block Group 2, Census Tract 1543.03, Sonoma County, California",0,0,0
1000000US060971543032027,060971543032027,"Block 2027, Block Group 2, Census Tract 1543.03, Sonoma County, California",0,0,0
1000000US060971543032028,060971543032028,"Block 2028, Block Group 2, Census Tract 1543.03, Sonoma County, California",0,0,0
1000000US060971543032029,060971543032029,"Block 2029, Block Group 2, Census Tract 1543.03, Sonoma County, California",0,0,0
1000000US060971543032030,060971543032030,"Block 2030, Block Group 2, Census Tract 1543.03, Sonoma County, California",0,0,0
1000000US060971543032031,060971543032031,"Block 2031, Block Group 2, Census Tract 1543.03, Sonoma County, California",0,0,0
1000000US060971543032032,060971543032032,"Block 2032, Block Group 2, Census Tract 1543.03, Sonoma County, California",0,0,0
1000000US060971543032033,060971543032033,"Block 2033, Block Group 2, Census Tract 1543.03, Sonoma County, California",0,0,0
1000000US060971543041000,060971543041000,"Block 1000, Block Group 1, Census Tract 1543.04, Sonoma County, California",1,1,0
1000000US060971543041001,060971543041001,"Block 1001, Block Group 1, Census Tract 1543.04, Sonoma County, California",0,0,0
1000000US060971543041002,060971543041002,"Block 1002, Block Group 1, Census Tract 1543.04, Sonoma County, California",0,0,0
1000000US060971543041003,060971543041003,"Block 1003, Block Group 1, Census Tract 1543.04, Sonoma County, California",0,0,0
1000000US060971543041004,060971543041004,"Block 1004, Block Group 1, Census Tract 1543.04, Sonoma County, California",0,0,0
1000000US060971543041005,060971543041005,"Block 1005, Block Group 1, Census Tract 1543.04, Sonoma County, California",0,0,0
1000000US060971543041006,060971543041006,"Block 1006, Block Group 1, Census Tract 1543.04, Sonoma County, California",0,0,0
1000000US060971543041007,060971543041007,"Block 1007, Block Group 1, Census Tract 1543.04, Sonoma County, California",4,2,2
1000000US060971543041008,060971543041008,"Block 1008, Block Group 1, Census Tract 1543.04, Sonoma County, California",0,0,0
1000000US060971543041009,060971543041009,"Block 1009, Block Group 1, Census Tract 1543.04, Sonoma County, California",0,0,0
1000000US060971543041010,060971543041010,"Block 1010, Block Group 1, Census Tract 1543.04, Sonoma County, California",0,0,0
1000000US060971543041011,060971543041011,"Block 1011, Block Group 1, Census Tract 1543.04, Sonoma County, California",0,0,0
1000000US060971543041012,060971543041012,"Block 1012, Block Group 1, Census Tract 1543.04, Sonoma County, California",1,1,0
1000000US060971543041013,060971543041013,"Block 1013, Block Group 1, Census Tract 1543.04, Sonoma County, California",0,0,0
1000000US060971543041014,060971543041014,"Block 1014, Block Group 1, Census Tract 1543.04, Sonoma County, California",0,0,0
1000000US060971543041015,060971543041015,"Block 1015, Block Group 1, Census Tract 1543.04, Sonoma County, California",0,0,0
1000000US060971543041016,060971543041016,"Block 1016, Block Group 1, Census Tract 1543.04, Sonoma County, California",0,0,0
1000000US060971543041017,060971543041017,"Block 1017, Block Group 1, Census Tract 1543.04, Sonoma County, California",0,0,0
1000000US060971543041018,060971543041018,"Block 1018, Block Group 1, Census Tract 1543.04, Sonoma County, California",0,0,0
1000000US060971543041019,060971543041019,"Block 1019, Block Group 1, Census Tract 1543.04, Sonoma County, California",0,0,0
1000000US060971543041020,060971543041020,"Block 1020, Block Group 1, Census Tract 1543.04, Sonoma County, California",0,0,0
1000000US060971543041021,060971543041021,"Block 1021, Block Group 1, Census Tract 1543.04, Sonoma County, California",0,0,0
1000000US060971543041022,060971543041022,"Block 1022, Block Group 1, Census Tract 1543.04, Sonoma County, California",0,0,0
1000000US060971543041023,060971543041023,"Block 1023, Block Group 1, Census Tract 1543.04, Sonoma County, California",0,0,0
1000000US060971543041024,060971543041024,"Block 1024, Block Group 1, Census Tract 1543.04, Sonoma County, California",0,0,0
1000000US060971543041025,060971543041025,"Block 1025, Block Group 1, Census Tract 1543.04, Sonoma County, California",0,0,0
1000000US060971543041026,060971543041026,"Block 1026, Block Group 1, Census Tract 1543.04, Sonoma County, California",0,0,0
1000000US060971543041027,060971543041027,"Block 1027, Block Group 1, Census Tract 1543.04, Sonoma County, California",0,0,0
1000000US060971543041028,060971543041028,"Block 1028, Block Group 1, Census Tract 1543.04, Sonoma County, California",0,0,0
1000000US060971543041029,060971543041029,"Block 1029, Block Group 1, Census Tract 1543.04, Sonoma County, California",0,0,0
1000000US060971543041030,060971543041030,"Block 1030, Block Group 1, Census Tract 1543.04, Sonoma County, California",2,1,1
1000000US060971543041031,060971543041031,"Block 1031, Block Group 1, Census Tract 1543.04, Sonoma County, California",0,0,0
1000000US060971543041032,060971543041032,"Block 1032, Block Group 1, Census Tract 1543.04, Sonoma County, California",0,0,0
1000000US060971543041033,060971543041033,"Block 1033, Block Group 1, Census Tract 1543.04, Sonoma County, California",0,0,0
1000000US060971543041034,060971543041034,"Block 1034, Block Group 1, Census Tract 1543.04, Sonoma County, California",0,0,0
1000000US060971543041035,060971543041035,"Block 1035, Block Group 1, Census Tract 1543.04, Sonoma County, California",0,0,0
1000000US060971543041036,060971543041036,"Block 1036, Block Group 1, Census Tract 1543.04, Sonoma County, California",0,0,0
1000000US060971543041037,060971543041037,"Block 1037, Block Group 1, Census Tract 1543.04, Sonoma County, California",0,0,0
1000000US060971543041038,060971543041038,"Block 1038, Block Group 1, Census Tract 1543.04, Sonoma County, California",0,0,0
1000000US060971543041039,060971543041039,"Block 1039, Block Group 1, Census Tract 1543.04, Sonoma County, California",0,0,0
1000000US060971543041040,060971543041040,"Block 1040, Block Group 1, Census Tract 1543.04, Sonoma County, California",2,1,1
1000000US060971543041041,060971543041041,"Block 1041, Block Group 1, Census Tract 1543.04, Sonoma County, California",0,0,0
1000000US060971543041042,060971543041042,"Block 1042, Block Group 1, Census Tract 1543.04, Sonoma County, California",0,0,0
1000000US060971543041043,060971543041043,"Block 1043, Block Group 1, Census Tract 1543.04, Sonoma County, California",5,5,0
1000000US060971543041044,060971543041044,"Block 1044, Block Group 1, Census Tract 1543.04, Sonoma County, California",0,0,0
1000000US060971543041045,060971543041045,"Block 1045, Block Group 1, Census Tract 1543.04, Sonoma County, California",0,0,0
1000000US060971543041046,060971543041046,"Block 1046, Block Group 1, Census Tract 1543.04, Sonoma County, California",0,0,0
1000000US060971543041047,060971543041047,"Block 1047, Block Group 1, Census Tract 1543.04, Sonoma County, California",1,1,0
1000000US060971543041048,060971543041048,"Block 1048, Block Group 1, Census Tract 1543.04, Sonoma County, California",0,0,0
1000000US060971543041049,060971543041049,"Block 1049, Block Group 1, Census Tract 1543.04, Sonoma County, California",1,0,1
1000000US060971543041050,060971543041050,"Block 1050, Block Group 1, Census Tract 1543.04, Sonoma County, California",0,0,0
1000000US060971543041051,060971543041051,"Block 1051, Block Group 1, Census Tract 1543.04, Sonoma County, California",0,0,0
1000000US060971543041052,060971543041052,"Block 1052, Block Group 1, Census Tract 1543.04, Sonoma County, California",0,0,0
1000000US060971543041053,060971543041053,"Block 1053, Block Group 1, Census Tract 1543.04, Sonoma County, California",0,0,0
1000000US060971543041054,060971543041054,"Block 1054, Block Group 1, Census Tract 1543.04, Sonoma County, California",0,0,0
1000000US060971543041055,060971543041055,"Block 1055, Block Group 1, Census Tract 1543.04, Sonoma County, California",0,0,0
1000000US060971543041056,060971543041056,"Block 1056, Block Group 1, Census Tract 1543.04, Sonoma County, California",0,0,0
1000000US060971543041057,060971543041057,"Block 1057, Block Group 1, Census Tract 1543.04, Sonoma County, California",0,0,0
1000000US060971543041058,060971543041058,"Block 1058, Block Group 1, Census Tract 1543.04, Sonoma County, California",0,0,0
1000000US060971543041059,060971543041059,"Block 1059, Block Group 1, Census Tract 1543.04, Sonoma County, California",1,1,0
1000000US060971543041060,060971543041060,"Block 1060, Block Group 1, Census Tract 1543.04, Sonoma County, California",0,0,0
1000000US060971543041061,060971543041061,"Block 1061, Block Group 1, Census Tract 1543.04, Sonoma County, California",0,0,0
1000000US060971543041062,060971543041062,"Block 1062, Block Group 1, Census Tract 1543.04, Sonoma County, California",0,0,0
1000000US060971543041063,060971543041063,"Block 1063, Block Group 1, Census Tract 1543.04, Sonoma County, California",0,0,0
1000000US060971543041064,060971543041064,"Block 1064, Block Group 1, Census Tract 1543.04, Sonoma County, California",0,0,0
1000000US060971543041065,060971543041065,"Block 1065, Block Group 1, Census Tract 1543.04, Sonoma County, California",0,0,0
1000000US060971543041066,060971543041066,"Block 1066, Block Group 1, Census Tract 1543.04, Sonoma County, California",0,0,0
1000000US060971543041067,060971543041067,"Block 1067, Block Group 1, Census Tract 1543.04, Sonoma County, California",19,14,5
1000000US060971543041068,060971543041068,"Block 1068, Block Group 1, Census Tract 1543.04, Sonoma County, California",2,2,0
1000000US060971543041069,060971543041069,"Block 1069, Block Group 1, Census Tract 1543.04, Sonoma County, California",6,3,3
1000000US060971543041070,060971543041070,"Block 1070, Block Group 1, Census Tract 1543.04, Sonoma County, California",1,0,1
1000000US060971543041071,060971543041071,"Block 1071, Block Group 1, Census Tract 1543.04, Sonoma County, California",0,0,0
1000000US060971543041072,060971543041072,"Block 1072, Block Group 1, Census Tract 1543.04, Sonoma County, California",0,0,0
1000000US060971543041073,060971543041073,"Block 1073, Block Group 1, Census Tract 1543.04, Sonoma County, California",1,0,1
1000000US060971543041074,060971543041074,"Block 1074, Block Group 1, Census Tract 1543.04, Sonoma County, California",0,0,0
1000000US060971543041075,060971543041075,"Block 1075, Block Group 1, Census Tract 1543.04, Sonoma County, California",1,0,1
1000000US060971543041076,060971543041076,"Block 1076, Block Group 1, Census Tract 1543.04, Sonoma County, California",0,0,0
1000000US060971543041077,060971543041077,"Block 1077, Block Group 1, Census Tract 1543.04, Sonoma County, California",4,2,2
1000000US060971543041078,060971543041078,"Block 1078, Block Group 1, Census Tract 1543.04, Sonoma County, California",4,4,0
1000000US060971543041079,060971543041079,"Block 1079, Block Group 1, Census Tract 1543.04, Sonoma County, California",28,21,7
1000000US060971543041080,060971543041080,"Block 1080, Block Group 1, Census Tract 1543.04, Sonoma County, California",0,0,0
1000000US060971543041081,060971543041081,"Block 1081, Block Group 1, Census Tract 1543.04, Sonoma County, California",0,0,0
1000000US060971543041082,060971543041082,"Block 1082, Block Group 1, Census Tract 1543.04, Sonoma County, California",0,0,0
1000000US060971543041083,060971543041083,"Block 1083, Block Group 1, Census Tract 1543.04, Sonoma County, California",0,0,0
1000000US060971543041084,060971543041084,"Block 1084, Block Group 1, Census Tract 1543.04, Sonoma County, California",0,0,0
1000000US060971543041085,060971543041085,"Block 1085, Block Group 1, Census Tract 1543.04, Sonoma County, California",2,1,1
1000000US060971543041086,060971543041086,"Block 1086, Block Group 1, Census Tract 1543.04, Sonoma County, California",2,2,0
1000000US060971543041087,060971543041087,"Block 1087, Block Group 1, Census Tract 1543.04, Sonoma County, California",5,3,2
1000000US060971543041088,060971543041088,"Block 1088, Block Group 1, Census Tract 1543.04, Sonoma County, California",15,10,5
1000000US060971543041089,060971543041089,"Block 1089, Block Group 1, Census Tract 1543.04, Sonoma County, California",1,1,0
1000000US060971543041090,060971543041090,"Block 1090, Block Group 1, Census Tract 1543.04, Sonoma County, California",0,0,0
1000000US060971543041091,060971543041091,"Block 1091, Block Group 1, Census Tract 1543.04, Sonoma County, California",0,0,0
1000000US060971543041092,060971543041092,"Block 1092, Block Group 1, Census Tract 1543.04, Sonoma County, California",0,0,0
1000000US060971543041093,060971543041093,"Block 1093, Block Group 1, Census Tract 1543.04, Sonoma County, California",3,1,2
1000000US060971543041094,060971543041094,"Block 1094, Block Group 1, Census Tract 1543.04, Sonoma County, California",0,0,0
1000000US060971543041095,060971543041095,"Block 1095, Block Group 1, Census Tract 1543.04, Sonoma County, California",0,0,0
1000000US060971543041096,060971543041096,"Block 1096, Block Group 1, Census Tract 1543.04, Sonoma County, California",0,0,0
1000000US060971543041097,060971543041097,"Block 1097, Block Group 1, Census Tract 1543.04, Sonoma County, California",0,0,0
1000000US060971543041098,060971543041098,"Block 1098, Block Group 1, Census Tract 1543.04, Sonoma County, California",0,0,0
1000000US060971543041099,060971543041099,"Block 1099, Block Group 1, Census Tract 1543.04, Sonoma County, California",0,0,0
1000000US060971543041100,060971543041100,"Block 1100, Block Group 1, Census Tract 1543.04, Sonoma County, California",0,0,0
1000000US060971543041101,060971543041101,"Block 1101, Block Group 1, Census Tract 1543.04, Sonoma County, California",0,0,0
1000000US060971543041102,060971543041102,"Block 1102, Block Group 1, Census Tract 1543.04, Sonoma County, California",1,1,0
1000000US060971543041103,060971543041103,"Block 1103, Block Group 1, Census Tract 1543.04, Sonoma County, California",1,1,0
1000000US060971543041104,060971543041104,"Block 1104, Block Group 1, Census Tract 1543.04, Sonoma County, California",27,24,3
1000000US060971543041105,060971543041105,"Block 1105, Block Group 1, Census Tract 1543.04, Sonoma County, California",0,0,0
1000000US060971543041106,060971543041106,"Block 1106, Block Group 1, Census Tract 1543.04, Sonoma County, California",0,0,0
1000000US060971543041107,060971543041107,"Block 1107, Block Group 1, Census Tract 1543.04, Sonoma County, California",0,0,0
1000000US060971543041108,060971543041108,"Block 1108, Block Group 1, Census Tract 1543.04, Sonoma County, California",9,5,4
1000000US060971543041109,060971543041109,"Block 1109, Block Group 1, Census Tract 1543.04, Sonoma County, California",12,9,3
1000000US060971543041110,060971543041110,"Block 1110, Block Group 1, Census Tract 1543.04, Sonoma County, California",1,1,0
1000000US060971543041111,060971543041111,"Block 1111, Block Group 1, Census Tract 1543.04, Sonoma County, California",0,0,0
1000000US060971543041112,060971543041112,"Block 1112, Block Group 1, Census Tract 1543.04, Sonoma County, California",1,1,0
1000000US060971543041113,060971543041113,"Block 1113, Block Group 1, Census Tract 1543.04, Sonoma County, California",0,0,0
1000000US060971543041114,060971543041114,"Block 1114, Block Group 1, Census Tract 1543.04, Sonoma County, California",6,4,2
1000000US060971543041115,060971543041115,"Block 1115, Block Group 1, Census Tract 1543.04, Sonoma County, California",2,2,0
1000000US060971543041116,060971543041116,"Block 1116, Block Group 1, Census Tract 1543.04, Sonoma County, California",2,2,0
1000000US060971543041117,060971543041117,"Block 1117, Block Group 1, Census Tract 1543.04, Sonoma County, California",0,0,0
1000000US060971543041118,060971543041118,"Block 1118, Block Group 1, Census Tract 1543.04, Sonoma County, California",0,0,0
1000000US060971543041119,060971543041119,"Block 1119, Block Group 1, Census Tract 1543.04, Sonoma County, California",0,0,0
1000000US060971543041120,060971543041120,"Block 1120, Block Group 1, Census Tract 1543.04, Sonoma County, California",0,0,0
1000000US060971543041121,060971543041121,"Block 1121, Block Group 1, Census Tract 1543.04, Sonoma County, California",0,0,0
1000000US060971543041122,060971543041122,"Block 1122, Block Group 1, Census Tract 1543.04, Sonoma County, California",0,0,0
1000000US060971543041123,060971543041123,"Block 1123, Block Group 1, Census Tract 1543.04, Sonoma County, California",0,0,0
1000000US060971543041124,060971543041124,"Block 1124, Block Group 1, Census Tract 1543.04, Sonoma County, California",0,0,0
1000000US060971543041125,060971543041125,"Block 1125, Block Group 1, Census Tract 1543.04, Sonoma County, California",0,0,0
1000000US060971543041126,060971543041126,"Block 1126, Block Group 1, Census Tract 1543.04, Sonoma County, California",0,0,0
1000000US060971543041127,060971543041127,"Block 1127, Block Group 1, Census Tract 1543.04, Sonoma County, California",0,0,0
1000000US060971543041128,060971543041128,"Block 1128, Block Group 1, Census Tract 1543.04, Sonoma County, California",0,0,0
1000000US060971543041129,060971543041129,"Block 1129, Block Group 1, Census Tract 1543.04, Sonoma County, California",0,0,0
1000000US060971543041130,060971543041130,"Block 1130, Block Group 1, Census Tract 1543.04, Sonoma County, California",0,0,0
1000000US060971543041131,060971543041131,"Block 1131, Block Group 1, Census Tract 1543.04, Sonoma County, California",0,0,0
1000000US060971543041132,060971543041132,"Block 1132, Block Group 1, Census Tract 1543.04, Sonoma County, California",0,0,0
1000000US060971543041133,060971543041133,"Block 1133, Block Group 1, Census Tract 1543.04, Sonoma County, California",0,0,0
1000000US060971543041134,060971543041134,"Block 1134, Block Group 1, Census Tract 1543.04, Sonoma County, California",0,0,0
1000000US060971543041135,060971543041135,"Block 1135, Block Group 1, Census Tract 1543.04, Sonoma County, California",0,0,0
1000000US060971543041136,060971543041136,"Block 1136, Block Group 1, Census Tract 1543.04, Sonoma County, California",0,0,0
1000000US060971543041137,060971543041137,"Block 1137, Block Group 1, Census Tract 1543.04, Sonoma County, California",0,0,0
1000000US060971543041138,060971543041138,"Block 1138, Block Group 1, Census Tract 1543.04, Sonoma County, California",0,0,0
1000000US060971543041139,060971543041139,"Block 1139, Block Group 1, Census Tract 1543.04, Sonoma County, California",0,0,0
1000000US060971543041140,060971543041140,"Block 1140, Block Group 1, Census Tract 1543.04, Sonoma County, California",0,0,0
1000000US060971543041141,060971543041141,"Block 1141, Block Group 1, Census Tract 1543.04, Sonoma County, California",0,0,0
1000000US060971543041142,060971543041142,"Block 1142, Block Group 1, Census Tract 1543.04, Sonoma County, California",0,0,0
1000000US060971543041143,060971543041143,"Block 1143, Block Group 1, Census Tract 1543.04, Sonoma County, California",0,0,0
1000000US060971543041144,060971543041144,"Block 1144, Block Group 1, Census Tract 1543.04, Sonoma County, California",0,0,0
1000000US060971543041145,060971543041145,"Block 1145, Block Group 1, Census Tract 1543.04, Sonoma County, California",0,0,0
1000000US060971543041146,060971543041146,"Block 1146, Block Group 1, Census Tract 1543.04, Sonoma County, California",0,0,0
1000000US060971543041147,060971543041147,"Block 1147, Block Group 1, Census Tract 1543.04, Sonoma County, California",0,0,0
1000000US060971543041148,060971543041148,"Block 1148, Block Group 1, Census Tract 1543.04, Sonoma County, California",0,0,0
1000000US060971543041149,060971543041149,"Block 1149, Block Group 1, Census Tract 1543.04, Sonoma County, California",0,0,0
1000000US060971543041150,060971543041150,"Block 1150, Block Group 1, Census Tract 1543.04, Sonoma County, California",0,0,0
1000000US060971543041151,060971543041151,"Block 1151, Block Group 1, Census Tract 1543.04, Sonoma County, California",0,0,0
1000000US060971543041152,060971543041152,"Block 1152, Block Group 1, Census Tract 1543.04, Sonoma County, California",0,0,0
1000000US060971543041153,060971543041153,"Block 1153, Block Group 1, Census Tract 1543.04, Sonoma County, California",1,1,0
1000000US060971543041154,060971543041154,"Block 1154, Block Group 1, Census Tract 1543.04, Sonoma County, California",0,0,0
1000000US060971543041155,060971543041155,"Block 1155, Block Group 1, Census Tract 1543.04, Sonoma County, California",0,0,0
1000000US060971543041156,060971543041156,"Block 1156, Block Group 1, Census Tract 1543.04, Sonoma County, California",0,0,0
1000000US060971543041157,060971543041157,"Block 1157, Block Group 1, Census Tract 1543.04, Sonoma County, California",3,3,0
1000000US060971543041158,060971543041158,"Block 1158, Block Group 1, Census Tract 1543.04, Sonoma County, California",0,0,0
1000000US060971543041159,060971543041159,"Block 1159, Block Group 1, Census Tract 1543.04, Sonoma County, California",0,0,0
1000000US060971543041160,060971543041160,"Block 1160, Block Group 1, Census Tract 1543.04, Sonoma County, California",0,0,0
1000000US060971543041161,060971543041161,"Block 1161, Block Group 1, Census Tract 1543.04, Sonoma County, California",1,1,0
1000000US060971543041162,060971543041162,"Block 1162, Block Group 1, Census Tract 1543.04, Sonoma County, California",0,0,0
1000000US060971543041163,060971543041163,"Block 1163, Block Group 1, Census Tract 1543.04, Sonoma County, California",0,0,0
1000000US060971543041164,060971543041164,"Block 1164, Block Group 1, Census Tract 1543.04, Sonoma County, California",0,0,0
1000000US060971543041165,060971543041165,"Block 1165, Block Group 1, Census Tract 1543.04, Sonoma County, California",0,0,0
1000000US060971543041166,060971543041166,"Block 1166, Block Group 1, Census Tract 1543.04, Sonoma County, California",0,0,0
1000000US060971543041167,060971543041167,"Block 1167, Block Group 1, Census Tract 1543.04, Sonoma County, California",0,0,0
1000000US060971543041168,060971543041168,"Block 1168, Block Group 1, Census Tract 1543.04, Sonoma County, California",0,0,0
1000000US060971543041169,060971543041169,"Block 1169, Block Group 1, Census Tract 1543.04, Sonoma County, California",0,0,0
1000000US060971543041170,060971543041170,"Block 1170, Block Group 1, Census Tract 1543.04, Sonoma County, California",0,0,0
1000000US060971543041171,060971543041171,"Block 1171, Block Group 1, Census Tract 1543.04, Sonoma County, California",0,0,0
1000000US060971543041172,060971543041172,"Block 1172, Block Group 1, Census Tract 1543.04, Sonoma County, California",1,1,0
1000000US060971543041173,060971543041173,"Block 1173, Block Group 1, Census Tract 1543.04, Sonoma County, California",0,0,0
1000000US060971543041174,060971543041174,"Block 1174, Block Group 1, Census Tract 1543.04, Sonoma County, California",5,2,3
1000000US060971543041175,060971543041175,"Block 1175, Block Group 1, Census Tract 1543.04, Sonoma County, California",1,0,1
1000000US060971543041176,060971543041176,"Block 1176, Block Group 1, Census Tract 1543.04, Sonoma County, California",6,4,2
1000000US060971543041177,060971543041177,"Block 1177, Block Group 1, Census Tract 1543.04, Sonoma County, California",0,0,0
1000000US060971543041178,060971543041178,"Block 1178, Block Group 1, Census Tract 1543.04, Sonoma County, California",0,0,0
1000000US060971543041179,060971543041179,"Block 1179, Block Group 1, Census Tract 1543.04, Sonoma County, California",0,0,0
1000000US060971543041180,060971543041180,"Block 1180, Block Group 1, Census Tract 1543.04, Sonoma County, California",3,1,2
1000000US060971543041181,060971543041181,"Block 1181, Block Group 1, Census Tract 1543.04, Sonoma County, California",0,0,0
1000000US060971543041182,060971543041182,"Block 1182, Block Group 1, Census Tract 1543.04, Sonoma County, California",0,0,0
1000000US060971543041183,060971543041183,"Block 1183, Block Group 1, Census Tract 1543.04, Sonoma County, California",0,0,0
1000000US060971543041184,060971543041184,"Block 1184, Block Group 1, Census Tract 1543.04, Sonoma County, California",1,1,0
1000000US060971543041185,060971543041185,"Block 1185, Block Group 1, Census Tract 1543.04, Sonoma County, California",0,0,0
1000000US060971543041186,060971543041186,"Block 1186, Block Group 1, Census Tract 1543.04, Sonoma County, California",0,0,0
1000000US060971543041187,060971543041187,"Block 1187, Block Group 1, Census Tract 1543.04, Sonoma County, California",0,0,0
1000000US060971543041188,060971543041188,"Block 1188, Block Group 1, Census Tract 1543.04, Sonoma County, California",0,0,0
1000000US060971543041189,060971543041189,"Block 1189, Block Group 1, Census Tract 1543.04, Sonoma County, California",0,0,0
1000000US060971543041190,060971543041190,"Block 1190, Block Group 1, Census Tract 1543.04, Sonoma County, California",26,10,16
1000000US060971543041191,060971543041191,"Block 1191, Block Group 1, Census Tract 1543.04, Sonoma County, California",1,0,1
1000000US060971543041192,060971543041192,"Block 1192, Block Group 1, Census Tract 1543.04, Sonoma County, California",0,0,0
1000000US060971543041193,060971543041193,"Block 1193, Block Group 1, Census Tract 1543.04, Sonoma County, California",0,0,0
1000000US060971543041194,060971543041194,"Block 1194, Block Group 1, Census Tract 1543.04, Sonoma County, California",0,0,0
1000000US060971543041195,060971543041195,"Block 1195, Block Group 1, Census Tract 1543.04, Sonoma County, California",0,0,0
1000000US060971543041196,060971543041196,"Block 1196, Block Group 1, Census Tract 1543.04, Sonoma County, California",0,0,0
1000000US060971543041197,060971543041197,"Block 1197, Block Group 1, Census Tract 1543.04, Sonoma County, California",0,0,0
1000000US060971543041198,060971543041198,"Block 1198, Block Group 1, Census Tract 1543.04, Sonoma County, California",0,0,0
1000000US060971543041199,060971543041199,"Block 1199, Block Group 1, Census Tract 1543.04, Sonoma County, California",0,0,0
1000000US060971543041200,060971543041200,"Block 1200, Block Group 1, Census Tract 1543.04, Sonoma County, California",0,0,0
1000000US060971543041201,060971543041201,"Block 1201, Block Group 1, Census Tract 1543.04, Sonoma County, California",0,0,0
1000000US060971543041202,060971543041202,"Block 1202, Block Group 1, Census Tract 1543.04, Sonoma County, California",0,0,0
1000000US060971543041203,060971543041203,"Block 1203, Block Group 1, Census Tract 1543.04, Sonoma County, California",0,0,0
1000000US060971543041204,060971543041204,"Block 1204, Block Group 1, Census Tract 1543.04, Sonoma County, California",0,0,0
1000000US060971543041205,060971543041205,"Block 1205, Block Group 1, Census Tract 1543.04, Sonoma County, California",0,0,0
1000000US060971543041206,060971543041206,"Block 1206, Block Group 1, Census Tract 1543.04, Sonoma County, California",0,0,0
1000000US060971543041207,060971543041207,"Block 1207, Block Group 1, Census Tract 1543.04, Sonoma County, California",0,0,0
1000000US060971543041208,060971543041208,"Block 1208, Block Group 1, Census Tract 1543.04, Sonoma County, California",0,0,0
1000000US060971543041209,060971543041209,"Block 1209, Block Group 1, Census Tract 1543.04, Sonoma County, California",0,0,0
1000000US060971543041210,060971543041210,"Block 1210, Block Group 1, Census Tract 1543.04, Sonoma County, California",0,0,0
1000000US060971543041211,060971543041211,"Block 1211, Block Group 1, Census Tract 1543.04, Sonoma County, California",0,0,0
1000000US060971543041212,060971543041212,"Block 1212, Block Group 1, Census Tract 1543.04, Sonoma County, California",0,0,0
1000000US060971543041213,060971543041213,"Block 1213, Block Group 1, Census Tract 1543.04, Sonoma County, California",0,0,0
1000000US060971543041214,060971543041214,"Block 1214, Block Group 1, Census Tract 1543.04, Sonoma County, California",0,0,0
1000000US060971543041215,060971543041215,"Block 1215, Block Group 1, Census Tract 1543.04, Sonoma County, California",0,0,0
1000000US060971543041216,060971543041216,"Block 1216, Block Group 1, Census Tract 1543.04, Sonoma County, California",1,1,0
1000000US060971543041217,060971543041217,"Block 1217, Block Group 1, Census Tract 1543.04, Sonoma County, California",0,0,0
1000000US060971543041218,060971543041218,"Block 1218, Block Group 1, Census Tract 1543.04, Sonoma County, California",0,0,0
1000000US060971543041219,060971543041219,"Block 1219, Block Group 1, Census Tract 1543.04, Sonoma County, California",0,0,0
1000000US060971543041220,060971543041220,"Block 1220, Block Group 1, Census Tract 1543.04, Sonoma County, California",0,0,0
1000000US060971543041221,060971543041221,"Block 1221, Block Group 1, Census Tract 1543.04, Sonoma County, California",1,1,0
1000000US060971543041222,060971543041222,"Block 1222, Block Group 1, Census Tract 1543.04, Sonoma County, California",1,1,0
1000000US060971543041223,060971543041223,"Block 1223, Block Group 1, Census Tract 1543.04, Sonoma County, California",0,0,0
1000000US060971543041224,060971543041224,"Block 1224, Block Group 1, Census Tract 1543.04, Sonoma County, California",2,1,1
1000000US060971543041225,060971543041225,"Block 1225, Block Group 1, Census Tract 1543.04, Sonoma County, California",0,0,0
1000000US060971543041226,060971543041226,"Block 1226, Block Group 1, Census Tract 1543.04, Sonoma County, California",0,0,0
1000000US060971543041227,060971543041227,"Block 1227, Block Group 1, Census Tract 1543.04, Sonoma County, California",5,5,0
1000000US060971543041228,060971543041228,"Block 1228, Block Group 1, Census Tract 1543.04, Sonoma County, California",0,0,0
1000000US060971543041229,060971543041229,"Block 1229, Block Group 1, Census Tract 1543.04, Sonoma County, California",0,0,0
1000000US060971543041230,060971543041230,"Block 1230, Block Group 1, Census Tract 1543.04, Sonoma County, California",0,0,0
1000000US060971543041231,060971543041231,"Block 1231, Block Group 1, Census Tract 1543.04, Sonoma County, California",1,0,1
1000000US060971543041232,060971543041232,"Block 1232, Block Group 1, Census Tract 1543.04, Sonoma County, California",0,0,0
1000000US060971543041233,060971543041233,"Block 1233, Block Group 1, Census Tract 1543.04, Sonoma County, California",0,0,0
1000000US060971543041234,060971543041234,"Block 1234, Block Group 1, Census Tract 1543.04, Sonoma County, California",0,0,0
1000000US060971543041235,060971543041235,"Block 1235, Block Group 1, Census Tract 1543.04, Sonoma County, California",2,2,0
1000000US060971543041236,060971543041236,"Block 1236, Block Group 1, Census Tract 1543.04, Sonoma County, California",0,0,0
1000000US060971543041237,060971543041237,"Block 1237, Block Group 1, Census Tract 1543.04, Sonoma County, California",2,1,1
1000000US060971543041238,060971543041238,"Block 1238, Block Group 1, Census Tract 1543.04, Sonoma County, California",0,0,0
1000000US060971543041239,060971543041239,"Block 1239, Block Group 1, Census Tract 1543.04, Sonoma County, California",0,0,0
1000000US060971543041240,060971543041240,"Block 1240, Block Group 1, Census Tract 1543.04, Sonoma County, California",0,0,0
1000000US060971543041241,060971543041241,"Block 1241, Block Group 1, Census Tract 1543.04, Sonoma County, California",1,0,1
1000000US060971543041242,060971543041242,"Block 1242, Block Group 1, Census Tract 1543.04, Sonoma County, California",1,1,0
1000000US060971543041243,060971543041243,"Block 1243, Block Group 1, Census Tract 1543.04, Sonoma County, California",1,1,0
1000000US060971543041244,060971543041244,"Block 1244, Block Group 1, Census Tract 1543.04, Sonoma County, California",0,0,0
1000000US060971543041245,060971543041245,"Block 1245, Block Group 1, Census Tract 1543.04, Sonoma County, California",1,0,1
1000000US060971543041246,060971543041246,"Block 1246, Block Group 1, Census Tract 1543.04, Sonoma County, California",0,0,0
1000000US060971543041247,060971543041247,"Block 1247, Block Group 1, Census Tract 1543.04, Sonoma County, California",3,3,0
1000000US060971543041248,060971543041248,"Block 1248, Block Group 1, Census Tract 1543.04, Sonoma County, California",0,0,0
1000000US060971543041249,060971543041249,"Block 1249, Block Group 1, Census Tract 1543.04, Sonoma County, California",0,0,0
1000000US060971543041250,060971543041250,"Block 1250, Block Group 1, Census Tract 1543.04, Sonoma County, California",0,0,0
1000000US060971543041251,060971543041251,"Block 1251, Block Group 1, Census Tract 1543.04, Sonoma County, California",0,0,0
1000000US060971543041252,060971543041252,"Block 1252, Block Group 1, Census Tract 1543.04, Sonoma County, California",0,0,0
1000000US060971543041253,060971543041253,"Block 1253, Block Group 1, Census Tract 1543.04, Sonoma County, California",3,2,1
1000000US060971543041254,060971543041254,"Block 1254, Block Group 1, Census Tract 1543.04, Sonoma County, California",0,0,0
1000000US060971543041255,060971543041255,"Block 1255, Block Group 1, Census Tract 1543.04, Sonoma County, California",2,2,0
1000000US060971543041256,060971543041256,"Block 1256, Block Group 1, Census Tract 1543.04, Sonoma County, California",0,0,0
1000000US060971543041257,060971543041257,"Block 1257, Block Group 1, Census Tract 1543.04, Sonoma County, California",2,0,2
1000000US060971543041258,060971543041258,"Block 1258, Block Group 1, Census Tract 1543.04, Sonoma County, California",0,0,0
1000000US060971543041259,060971543041259,"Block 1259, Block Group 1, Census Tract 1543.04, Sonoma County, California",0,0,0
1000000US060971543041260,060971543041260,"Block 1260, Block Group 1, Census Tract 1543.04, Sonoma County, California",0,0,0
1000000US060971543041261,060971543041261,"Block 1261, Block Group 1, Census Tract 1543.04, Sonoma County, California",4,3,1
1000000US060971543041262,060971543041262,"Block 1262, Block Group 1, Census Tract 1543.04, Sonoma County, California",4,1,3
1000000US060971543041263,060971543041263,"Block 1263, Block Group 1, Census Tract 1543.04, Sonoma County, California",6,5,1
1000000US060971543041264,060971543041264,"Block 1264, Block Group 1, Census Tract 1543.04, Sonoma County, California",1,0,1
1000000US060971543041265,060971543041265,"Block 1265, Block Group 1, Census Tract 1543.04, Sonoma County, California",1,0,1
1000000US060971543041266,060971543041266,"Block 1266, Block Group 1, Census Tract 1543.04, Sonoma County, California",1,1,0
1000000US060971543041267,060971543041267,"Block 1267, Block Group 1, Census Tract 1543.04, Sonoma County, California",0,0,0
1000000US060971543041268,060971543041268,"Block 1268, Block Group 1, Census Tract 1543.04, Sonoma County, California",0,0,0
1000000US060971543041269,060971543041269,"Block 1269, Block Group 1, Census Tract 1543.04, Sonoma County, California",0,0,0
1000000US060971543041270,060971543041270,"Block 1270, Block Group 1, Census Tract 1543.04, Sonoma County, California",2,2,0
1000000US060971543041271,060971543041271,"Block 1271, Block Group 1, Census Tract 1543.04, Sonoma County, California",5,3,2
1000000US060971543041272,060971543041272,"Block 1272, Block Group 1, Census Tract 1543.04, Sonoma County, California",0,0,0
1000000US060971543041273,060971543041273,"Block 1273, Block Group 1, Census Tract 1543.04, Sonoma County, California",0,0,0
1000000US060971543041274,060971543041274,"Block 1274, Block Group 1, Census Tract 1543.04, Sonoma County, California",21,14,7
1000000US060971543041275,060971543041275,"Block 1275, Block Group 1, Census Tract 1543.04, Sonoma County, California",0,0,0
1000000US060971543041276,060971543041276,"Block 1276, Block Group 1, Census Tract 1543.04, Sonoma County, California",0,0,0
1000000US060971543041277,060971543041277,"Block 1277, Block Group 1, Census Tract 1543.04, Sonoma County, California",4,3,1
1000000US060971543041278,060971543041278,"Block 1278, Block Group 1, Census Tract 1543.04, Sonoma County, California",0,0,0
1000000US060971543041279,060971543041279,"Block 1279, Block Group 1, Census Tract 1543.04, Sonoma County, California",0,0,0
1000000US060971543041280,060971543041280,"Block 1280, Block Group 1, Census Tract 1543.04, Sonoma County, California",10,6,4
1000000US060971543041281,060971543041281,"Block 1281, Block Group 1, Census Tract 1543.04, Sonoma County, California",0,0,0
1000000US060971543041282,060971543041282,"Block 1282, Block Group 1, Census Tract 1543.04, Sonoma County, California",0,0,0
1000000US060971543041283,060971543041283,"Block 1283, Block Group 1, Census Tract 1543.04, Sonoma County, California",1,0,1
1000000US060971543041284,060971543041284,"Block 1284, Block Group 1, Census Tract 1543.04, Sonoma County, California",7,2,5
1000000US060971543041285,060971543041285,"Block 1285, Block Group 1, Census Tract 1543.04, Sonoma County, California",0,0,0
1000000US060971543041286,060971543041286,"Block 1286, Block Group 1, Census Tract 1543.04, Sonoma County, California",0,0,0
1000000US060971543041287,060971543041287,"Block 1287, Block Group 1, Census Tract 1543.04, Sonoma County, California",1,1,0
1000000US060971543041288,060971543041288,"Block 1288, Block Group 1, Census Tract 1543.04, Sonoma County, California",3,0,3
1000000US060971543041289,060971543041289,"Block 1289, Block Group 1, Census Tract 1543.04, Sonoma County, California",4,1,3
1000000US060971543041290,060971543041290,"Block 1290, Block Group 1, Census Tract 1543.04, Sonoma County, California",0,0,0
1000000US060971543041291,060971543041291,"Block 1291, Block Group 1, Census Tract 1543.04, Sonoma County, California",0,0,0
1000000US060971543041292,060971543041292,"Block 1292, Block Group 1, Census Tract 1543.04, Sonoma County, California",6,5,1
1000000US060971543041293,060971543041293,"Block 1293, Block Group 1, Census Tract 1543.04, Sonoma County, California",2,1,1
1000000US060971543041294,060971543041294,"Block 1294, Block Group 1, Census Tract 1543.04, Sonoma County, California",0,0,0
1000000US060971543041295,060971543041295,"Block 1295, Block Group 1, Census Tract 1543.04, Sonoma County, California",0,0,0
1000000US060971543041296,060971543041296,"Block 1296, Block Group 1, Census Tract 1543.04, Sonoma County, California",0,0,0
1000000US060971543041297,060971543041297,"Block 1297, Block Group 1, Census Tract 1543.04, Sonoma County, California",0,0,0
1000000US060971543041298,060971543041298,"Block 1298, Block Group 1, Census Tract 1543.04, Sonoma County, California",0,0,0
1000000US060971543041299,060971543041299,"Block 1299, Block Group 1, Census Tract 1543.04, Sonoma County, California",0,0,0
1000000US060971543041300,060971543041300,"Block 1300, Block Group 1, Census Tract 1543.04, Sonoma County, California",0,0,0
1000000US060971543041301,060971543041301,"Block 1301, Block Group 1, Census Tract 1543.04, Sonoma County, California",0,0,0
1000000US060971543041302,060971543041302,"Block 1302, Block Group 1, Census Tract 1543.04, Sonoma County, California",7,3,4
1000000US060971543041303,060971543041303,"Block 1303, Block Group 1, Census Tract 1543.04, Sonoma County, California",16,11,5
1000000US060971543041304,060971543041304,"Block 1304, Block Group 1, Census Tract 1543.04, Sonoma County, California",0,0,0
1000000US060971543041305,060971543041305,"Block 1305, Block Group 1, Census Tract 1543.04, Sonoma County, California",0,0,0
1000000US060971543041306,060971543041306,"Block 1306, Block Group 1, Census Tract 1543.04, Sonoma County, California",0,0,0
1000000US060971543041307,060971543041307,"Block 1307, Block Group 1, Census Tract 1543.04, Sonoma County, California",0,0,0
1000000US060971543041308,060971543041308,"Block 1308, Block Group 1, Census Tract 1543.04, Sonoma County, California",0,0,0
1000000US060971543041309,060971543041309,"Block 1309, Block Group 1, Census Tract 1543.04, Sonoma County, California",5,4,1
1000000US060971543041310,060971543041310,"Block 1310, Block Group 1, Census Tract 1543.04, Sonoma County, California",0,0,0
1000000US060971543041311,060971543041311,"Block 1311, Block Group 1, Census Tract 1543.04, Sonoma County, California",0,0,0
1000000US060971543041312,060971543041312,"Block 1312, Block Group 1, Census Tract 1543.04, Sonoma County, California",0,0,0
1000000US060971543041313,060971543041313,"Block 1313, Block Group 1, Census Tract 1543.04, Sonoma County, California",0,0,0
1000000US060971543041314,060971543041314,"Block 1314, Block Group 1, Census Tract 1543.04, Sonoma County, California",3,1,2
1000000US060971543041315,060971543041315,"Block 1315, Block Group 1, Census Tract 1543.04, Sonoma County, California",0,0,0
1000000US060971543041316,060971543041316,"Block 1316, Block Group 1, Census Tract 1543.04, Sonoma County, California",0,0,0
1000000US060971543041317,060971543041317,"Block 1317, Block Group 1, Census Tract 1543.04, Sonoma County, California",0,0,0
1000000US060971543041318,060971543041318,"Block 1318, Block Group 1, Census Tract 1543.04, Sonoma County, California",1,0,1
1000000US060971543041319,060971543041319,"Block 1319, Block Group 1, Census Tract 1543.04, Sonoma County, California",32,17,15
1000000US060971543041320,060971543041320,"Block 1320, Block Group 1, Census Tract 1543.04, Sonoma County, California",6,4,2
1000000US060971543041321,060971543041321,"Block 1321, Block Group 1, Census Tract 1543.04, Sonoma County, California",0,0,0
1000000US060971543041322,060971543041322,"Block 1322, Block Group 1, Census Tract 1543.04, Sonoma County, California",0,0,0
1000000US060971543041323,060971543041323,"Block 1323, Block Group 1, Census Tract 1543.04, Sonoma County, California",2,1,1
1000000US060971543041324,060971543041324,"Block 1324, Block Group 1, Census Tract 1543.04, Sonoma County, California",2,0,2
1000000US060971543041325,060971543041325,"Block 1325, Block Group 1, Census Tract 1543.04, Sonoma County, California",1,1,0
1000000US060971543041326,060971543041326,"Block 1326, Block Group 1, Census Tract 1543.04, Sonoma County, California",1,0,1
1000000US060971543041327,060971543041327,"Block 1327, Block Group 1, Census Tract 1543.04, Sonoma County, California",4,1,3
1000000US060971543041328,060971543041328,"Block 1328, Block Group 1, Census Tract 1543.04, Sonoma County, California",4,2,2
1000000US060971543041329,060971543041329,"Block 1329, Block Group 1, Census Tract 1543.04, Sonoma County, California",0,0,0
1000000US060971543041330,060971543041330,"Block 1330, Block Group 1, Census Tract 1543.04, Sonoma County, California",3,2,1
1000000US060971543041331,060971543041331,"Block 1331, Block Group 1, Census Tract 1543.04, Sonoma County, California",12,9,3
1000000US060971543041332,060971543041332,"Block 1332, Block Group 1, Census Tract 1543.04, Sonoma County, California",0,0,0
1000000US060971543041333,060971543041333,"Block 1333, Block Group 1, Census Tract 1543.04, Sonoma County, California",5,2,3
1000000US060971543041334,060971543041334,"Block 1334, Block Group 1, Census Tract 1543.04, Sonoma County, California",1,0,1
1000000US060971543041335,060971543041335,"Block 1335, Block Group 1, Census Tract 1543.04, Sonoma County, California",0,0,0
1000000US060971543041336,060971543041336,"Block 1336, Block Group 1, Census Tract 1543.04, Sonoma County, California",0,0,0
1000000US060971543041337,060971543041337,"Block 1337, Block Group 1, Census Tract 1543.04, Sonoma County, California",0,0,0
1000000US060971543041338,060971543041338,"Block 1338, Block Group 1, Census Tract 1543.04, Sonoma County, California",0,0,0
1000000US060971543041339,060971543041339,"Block 1339, Block Group 1, Census Tract 1543.04, Sonoma County, California",0,0,0
1000000US060971543041340,060971543041340,"Block 1340, Block Group 1, Census Tract 1543.04, Sonoma County, California",5,2,3
1000000US060971543041341,060971543041341,"Block 1341, Block Group 1, Census Tract 1543.04, Sonoma County, California",1,1,0
1000000US060971543041342,060971543041342,"Block 1342, Block Group 1, Census Tract 1543.04, Sonoma County, California",5,2,3
1000000US060971543041343,060971543041343,"Block 1343, Block Group 1, Census Tract 1543.04, Sonoma County, California",0,0,0
1000000US060971543041344,060971543041344,"Block 1344, Block Group 1, Census Tract 1543.04, Sonoma County, California",0,0,0
1000000US060971543041345,060971543041345,"Block 1345, Block Group 1, Census Tract 1543.04, Sonoma County, California",3,0,3
1000000US060971543041346,060971543041346,"Block 1346, Block Group 1, Census Tract 1543.04, Sonoma County, California",0,0,0
1000000US060971543041347,060971543041347,"Block 1347, Block Group 1, Census Tract 1543.04, Sonoma County, California",1,1,0
1000000US060971543041348,060971543041348,"Block 1348, Block Group 1, Census Tract 1543.04, Sonoma County, California",1,1,0
1000000US060971543041349,060971543041349,"Block 1349, Block Group 1, Census Tract 1543.04, Sonoma County, California",1,0,1
1000000US060971543041350,060971543041350,"Block 1350, Block Group 1, Census Tract 1543.04, Sonoma County, California",0,0,0
1000000US060971543041351,060971543041351,"Block 1351, Block Group 1, Census Tract 1543.04, Sonoma County, California",0,0,0
1000000US060971543041352,060971543041352,"Block 1352, Block Group 1, Census Tract 1543.04, Sonoma County, California",0,0,0
1000000US060971543041353,060971543041353,"Block 1353, Block Group 1, Census Tract 1543.04, Sonoma County, California",0,0,0
1000000US060971543041354,060971543041354,"Block 1354, Block Group 1, Census Tract 1543.04, Sonoma County, California",0,0,0
1000000US060971543041355,060971543041355,"Block 1355, Block Group 1, Census Tract 1543.04, Sonoma County, California",5,2,3
1000000US060971543041356,060971543041356,"Block 1356, Block Group 1, Census Tract 1543.04, Sonoma County, California",7,5,2
1000000US060971543041357,060971543041357,"Block 1357, Block Group 1, Census Tract 1543.04, Sonoma County, California",1,0,1
1000000US060971543041358,060971543041358,"Block 1358, Block Group 1, Census Tract 1543.04, Sonoma County, California",0,0,0
1000000US060971543041359,060971543041359,"Block 1359, Block Group 1, Census Tract 1543.04, Sonoma County, California",0,0,0
1000000US060971543041360,060971543041360,"Block 1360, Block Group 1, Census Tract 1543.04, Sonoma County, California",0,0,0
1000000US060971543041361,060971543041361,"Block 1361, Block Group 1, Census Tract 1543.04, Sonoma County, California",0,0,0
1000000US060971543041362,060971543041362,"Block 1362, Block Group 1, Census Tract 1543.04, Sonoma County, California",4,4,0
1000000US060971543041363,060971543041363,"Block 1363, Block Group 1, Census Tract 1543.04, Sonoma County, California",3,3,0
1000000US060971543041364,060971543041364,"Block 1364, Block Group 1, Census Tract 1543.04, Sonoma County, California",1,1,0
1000000US060971543041365,060971543041365,"Block 1365, Block Group 1, Census Tract 1543.04, Sonoma County, California",5,5,0
1000000US060971543041366,060971543041366,"Block 1366, Block Group 1, Census Tract 1543.04, Sonoma County, California",0,0,0
1000000US060971543041367,060971543041367,"Block 1367, Block Group 1, Census Tract 1543.04, Sonoma County, California",7,7,0
1000000US060971543041368,060971543041368,"Block 1368, Block Group 1, Census Tract 1543.04, Sonoma County, California",0,0,0
1000000US060971543041369,060971543041369,"Block 1369, Block Group 1, Census Tract 1543.04, Sonoma County, California",0,0,0
1000000US060971543041370,060971543041370,"Block 1370, Block Group 1, Census Tract 1543.04, Sonoma County, California",0,0,0
1000000US060971543041371,060971543041371,"Block 1371, Block Group 1, Census Tract 1543.04, Sonoma County, California",1,1,0
1000000US060971543041372,060971543041372,"Block 1372, Block Group 1, Census Tract 1543.04, Sonoma County, California",5,4,1
1000000US060971543041373,060971543041373,"Block 1373, Block Group 1, Census Tract 1543.04, Sonoma County, California",2,2,0
1000000US060971543041374,060971543041374,"Block 1374, Block Group 1, Census Tract 1543.04, Sonoma County, California",0,0,0
1000000US060971543041375,060971543041375,"Block 1375, Block Group 1, Census Tract 1543.04, Sonoma County, California",0,0,0
1000000US060971543041376,060971543041376,"Block 1376, Block Group 1, Census Tract 1543.04, Sonoma County, California",4,2,2
1000000US060971543041377,060971543041377,"Block 1377, Block Group 1, Census Tract 1543.04, Sonoma County, California",2,0,2
1000000US060971543041378,060971543041378,"Block 1378, Block Group 1, Census Tract 1543.04, Sonoma County, California",0,0,0
1000000US060971543041379,060971543041379,"Block 1379, Block Group 1, Census Tract 1543.04, Sonoma County, California",0,0,0
1000000US060971543041380,060971543041380,"Block 1380, Block Group 1, Census Tract 1543.04, Sonoma County, California",0,0,0
1000000US060971543041381,060971543041381,"Block 1381, Block Group 1, Census Tract 1543.04, Sonoma County, California",0,0,0
1000000US060971543041382,060971543041382,"Block 1382, Block Group 1, Census Tract 1543.04, Sonoma County, California",0,0,0
1000000US060971543041383,060971543041383,"Block 1383, Block Group 1, Census Tract 1543.04, Sonoma County, California",0,0,0
1000000US060971543041384,060971543041384,"Block 1384, Block Group 1, Census Tract 1543.04, Sonoma County, California",0,0,0
1000000US060971543041385,060971543041385,"Block 1385, Block Group 1, Census Tract 1543.04, Sonoma County, California",0,0,0
1000000US060971543042000,060971543042000,"Block 2000, Block Group 2, Census Tract 1543.04, Sonoma County, California",69,40,29
1000000US060971543042001,060971543042001,"Block 2001, Block Group 2, Census Tract 1543.04, Sonoma County, California",1,0,1
1000000US060971543042002,060971543042002,"Block 2002, Block Group 2, Census Tract 1543.04, Sonoma County, California",7,3,4
1000000US060971543042003,060971543042003,"Block 2003, Block Group 2, Census Tract 1543.04, Sonoma County, California",12,4,8
1000000US060971543042004,060971543042004,"Block 2004, Block Group 2, Census Tract 1543.04, Sonoma County, California",3,3,0
1000000US060971543042005,060971543042005,"Block 2005, Block Group 2, Census Tract 1543.04, Sonoma County, California",0,0,0
1000000US060971543042006,060971543042006,"Block 2006, Block Group 2, Census Tract 1543.04, Sonoma County, California",3,2,1
1000000US060971543042007,060971543042007,"Block 2007, Block Group 2, Census Tract 1543.04, Sonoma County, California",2,1,1
1000000US060971543042008,060971543042008,"Block 2008, Block Group 2, Census Tract 1543.04, Sonoma County, California",0,0,0
1000000US060971543042009,060971543042009,"Block 2009, Block Group 2, Census Tract 1543.04, Sonoma County, California",0,0,0
1000000US060971543042010,060971543042010,"Block 2010, Block Group 2, Census Tract 1543.04, Sonoma County, California",2,1,1
1000000US060971543042011,060971543042011,"Block 2011, Block Group 2, Census Tract 1543.04, Sonoma County, California",16,7,9
1000000US060971543042012,060971543042012,"Block 2012, Block Group 2, Census Tract 1543.04, Sonoma County, California",1,1,0
1000000US060971543042013,060971543042013,"Block 2013, Block Group 2, Census Tract 1543.04, Sonoma County, California",21,14,7
1000000US060971543042014,060971543042014,"Block 2014, Block Group 2, Census Tract 1543.04, Sonoma County, California",0,0,0
1000000US060971543042015,060971543042015,"Block 2015, Block Group 2, Census Tract 1543.04, Sonoma County, California",5,4,1
1000000US060971543042016,060971543042016,"Block 2016, Block Group 2, Census Tract 1543.04, Sonoma County, California",0,0,0
1000000US060971543042017,060971543042017,"Block 2017, Block Group 2, Census Tract 1543.04, Sonoma County, California",1,1,0
1000000US060971543042018,060971543042018,"Block 2018, Block Group 2, Census Tract 1543.04, Sonoma County, California",7,6,1
1000000US060971543042019,060971543042019,"Block 2019, Block Group 2, Census Tract 1543.04, Sonoma County, California",0,0,0
1000000US060971543042020,060971543042020,"Block 2020, Block Group 2, Census Tract 1543.04, Sonoma County, California",0,0,0
1000000US060971543042021,060971543042021,"Block 2021, Block Group 2, Census Tract 1543.04, Sonoma County, California",0,0,0
1000000US060971543042022,060971543042022,"Block 2022, Block Group 2, Census Tract 1543.04, Sonoma County, California",2,2,0
1000000US060971543042023,060971543042023,"Block 2023, Block Group 2, Census Tract 1543.04, Sonoma County, California",0,0,0
1000000US060971543042024,060971543042024,"Block 2024, Block Group 2, Census Tract 1543.04, Sonoma County, California",0,0,0
1000000US060971543042025,060971543042025,"Block 2025, Block Group 2, Census Tract 1543.04, Sonoma County, California",0,0,0
1000000US060971543042026,060971543042026,"Block 2026, Block Group 2, Census Tract 1543.04, Sonoma County, California",0,0,0
1000000US060971543042027,060971543042027,"Block 2027, Block Group 2, Census Tract 1543.04, Sonoma County, California",2,1,1
1000000US060971543042028,060971543042028,"Block 2028, Block Group 2, Census Tract 1543.04, Sonoma County, California",59,41,18
1000000US060971543042029,060971543042029,"Block 2029, Block Group 2, Census Tract 1543.04, Sonoma County, California",0,0,0
1000000US060971543042030,060971543042030,"Block 2030, Block Group 2, Census Tract 1543.04, Sonoma County, California",29,11,18
1000000US060971543042031,060971543042031,"Block 2031, Block Group 2, Census Tract 1543.04, Sonoma County, California",0,0,0
1000000US060971543042032,060971543042032,"Block 2032, Block Group 2, Census Tract 1543.04, Sonoma County, California",7,4,3
1000000US060971543042033,060971543042033,"Block 2033, Block Group 2, Census Tract 1543.04, Sonoma County, California",1,0,1
1000000US060971543042034,060971543042034,"Block 2034, Block Group 2, Census Tract 1543.04, Sonoma County, California",14,10,4
1000000US060971543042035,060971543042035,"Block 2035, Block Group 2, Census Tract 1543.04, Sonoma County, California",1,1,0
1000000US060971543042036,060971543042036,"Block 2036, Block Group 2, Census Tract 1543.04, Sonoma County, California",7,6,1
1000000US060971543042037,060971543042037,"Block 2037, Block Group 2, Census Tract 1543.04, Sonoma County, California",16,9,7
1000000US060971543042038,060971543042038,"Block 2038, Block Group 2, Census Tract 1543.04, Sonoma County, California",0,0,0
1000000US060971543042039,060971543042039,"Block 2039, Block Group 2, Census Tract 1543.04, Sonoma County, California",0,0,0
1000000US060971543042040,060971543042040,"Block 2040, Block Group 2, Census Tract 1543.04, Sonoma County, California",0,0,0
1000000US060971543042041,060971543042041,"Block 2041, Block Group 2, Census Tract 1543.04, Sonoma County, California",0,0,0
1000000US060971543042042,060971543042042,"Block 2042, Block Group 2, Census Tract 1543.04, Sonoma County, California",0,0,0
1000000US060971543042043,060971543042043,"Block 2043, Block Group 2, Census Tract 1543.04, Sonoma County, California",0,0,0
1000000US060971543042044,060971543042044,"Block 2044, Block Group 2, Census Tract 1543.04, Sonoma County, California",0,0,0
1000000US060971543042045,060971543042045,"Block 2045, Block Group 2, Census Tract 1543.04, Sonoma County, California",0,0,0
1000000US060971543042046,060971543042046,"Block 2046, Block Group 2, Census Tract 1543.04, Sonoma County, California",20,10,10
1000000US060971543042047,060971543042047,"Block 2047, Block Group 2, Census Tract 1543.04, Sonoma County, California",0,0,0
1000000US060971543042048,060971543042048,"Block 2048, Block Group 2, Census Tract 1543.04, Sonoma County, California",10,7,3
1000000US060971543042049,060971543042049,"Block 2049, Block Group 2, Census Tract 1543.04, Sonoma County, California",0,0,0
1000000US060971543042050,060971543042050,"Block 2050, Block Group 2, Census Tract 1543.04, Sonoma County, California",0,0,0
1000000US060971543042051,060971543042051,"Block 2051, Block Group 2, Census Tract 1543.04, Sonoma County, California",0,0,0
1000000US060971543042052,060971543042052,"Block 2052, Block Group 2, Census Tract 1543.04, Sonoma County, California",0,0,0
1000000US060971543042053,060971543042053,"Block 2053, Block Group 2, Census Tract 1543.04, Sonoma County, California",0,0,0
1000000US060971543042054,060971543042054,"Block 2054, Block Group 2, Census Tract 1543.04, Sonoma County, California",13,6,7
1000000US060971543042055,060971543042055,"Block 2055, Block Group 2, Census Tract 1543.04, Sonoma County, California",0,0,0
1000000US060971543042056,060971543042056,"Block 2056, Block Group 2, Census Tract 1543.04, Sonoma County, California",0,0,0
1000000US060971543042057,060971543042057,"Block 2057, Block Group 2, Census Tract 1543.04, Sonoma County, California",0,0,0
1000000US060971543042058,060971543042058,"Block 2058, Block Group 2, Census Tract 1543.04, Sonoma County, California",0,0,0
1000000US060971543042059,060971543042059,"Block 2059, Block Group 2, Census Tract 1543.04, Sonoma County, California",3,3,0
1000000US060971543042060,060971543042060,"Block 2060, Block Group 2, Census Tract 1543.04, Sonoma County, California",0,0,0
1000000US060971543042061,060971543042061,"Block 2061, Block Group 2, Census Tract 1543.04, Sonoma County, California",0,0,0
1000000US060971543042062,060971543042062,"Block 2062, Block Group 2, Census Tract 1543.04, Sonoma County, California",4,2,2
1000000US060971543042063,060971543042063,"Block 2063, Block Group 2, Census Tract 1543.04, Sonoma County, California",0,0,0
1000000US060971543042064,060971543042064,"Block 2064, Block Group 2, Census Tract 1543.04, Sonoma County, California",0,0,0
1000000US060971543042065,060971543042065,"Block 2065, Block Group 2, Census Tract 1543.04, Sonoma County, California",0,0,0
1000000US060971543042066,060971543042066,"Block 2066, Block Group 2, Census Tract 1543.04, Sonoma County, California",0,0,0
1000000US060971543042067,060971543042067,"Block 2067, Block Group 2, Census Tract 1543.04, Sonoma County, California",0,0,0
1000000US060971543042068,060971543042068,"Block 2068, Block Group 2, Census Tract 1543.04, Sonoma County, California",0,0,0
1000000US060971543042069,060971543042069,"Block 2069, Block Group 2, Census Tract 1543.04, Sonoma County, California",0,0,0
1000000US060971543042070,060971543042070,"Block 2070, Block Group 2, Census Tract 1543.04, Sonoma County, California",1,1,0
1000000US060971543042071,060971543042071,"Block 2071, Block Group 2, Census Tract 1543.04, Sonoma County, California",0,0,0
1000000US060971543042072,060971543042072,"Block 2072, Block Group 2, Census Tract 1543.04, Sonoma County, California",0,0,0
1000000US060971543042073,060971543042073,"Block 2073, Block Group 2, Census Tract 1543.04, Sonoma County, California",4,3,1
1000000US060971543042074,060971543042074,"Block 2074, Block Group 2, Census Tract 1543.04, Sonoma County, California",3,0,3
1000000US060971543042075,060971543042075,"Block 2075, Block Group 2, Census Tract 1543.04, Sonoma County, California",0,0,0
1000000US060971543042076,060971543042076,"Block 2076, Block Group 2, Census Tract 1543.04, Sonoma County, California",0,0,0
1000000US060971543042077,060971543042077,"Block 2077, Block Group 2, Census Tract 1543.04, Sonoma County, California",2,1,1
1000000US060971543042078,060971543042078,"Block 2078, Block Group 2, Census Tract 1543.04, Sonoma County, California",9,5,4
1000000US060971543042079,060971543042079,"Block 2079, Block Group 2, Census Tract 1543.04, Sonoma County, California",13,6,7
1000000US060971543042080,060971543042080,"Block 2080, Block Group 2, Census Tract 1543.04, Sonoma County, California",15,11,4
1000000US060971543042081,060971543042081,"Block 2081, Block Group 2, Census Tract 1543.04, Sonoma County, California",21,8,13
1000000US060971543042082,060971543042082,"Block 2082, Block Group 2, Census Tract 1543.04, Sonoma County, California",10,6,4
1000000US060971543042083,060971543042083,"Block 2083, Block Group 2, Census Tract 1543.04, Sonoma County, California",0,0,0
1000000US060971543042084,060971543042084,"Block 2084, Block Group 2, Census Tract 1543.04, Sonoma County, California",0,0,0
1000000US060971543042085,060971543042085,"Block 2085, Block Group 2, Census Tract 1543.04, Sonoma County, California",21,12,9
1000000US060971543042086,060971543042086,"Block 2086, Block Group 2, Census Tract 1543.04, Sonoma County, California",17,7,10
1000000US060971543042087,060971543042087,"Block 2087, Block Group 2, Census Tract 1543.04, Sonoma County, California",0,0,0
1000000US060971543042088,060971543042088,"Block 2088, Block Group 2, Census Tract 1543.04, Sonoma County, California",0,0,0
1000000US060971543042089,060971543042089,"Block 2089, Block Group 2, Census Tract 1543.04, Sonoma County, California",0,0,0
1000000US060971543042090,060971543042090,"Block 2090, Block Group 2, Census Tract 1543.04, Sonoma County, California",0,0,0
1000000US060971543042091,060971543042091,"Block 2091, Block Group 2, Census Tract 1543.04, Sonoma County, California",9,3,6
1000000US060971543042092,060971543042092,"Block 2092, Block Group 2, Census Tract 1543.04, Sonoma County, California",4,1,3
1000000US060971543042093,060971543042093,"Block 2093, Block Group 2, Census Tract 1543.04, Sonoma County, California",1,1,0
1000000US060971543042094,060971543042094,"Block 2094, Block Group 2, Census Tract 1543.04, Sonoma County, California",8,4,4
1000000US060971543042095,060971543042095,"Block 2095, Block Group 2, Census Tract 1543.04, Sonoma County, California",11,7,4
1000000US060971543042096,060971543042096,"Block 2096, Block Group 2, Census Tract 1543.04, Sonoma County, California",0,0,0
1000000US060971543042097,060971543042097,"Block 2097, Block Group 2, Census Tract 1543.04, Sonoma County, California",0,0,0
1000000US060971543042098,060971543042098,"Block 2098, Block Group 2, Census Tract 1543.04, Sonoma County, California",0,0,0
1000000US060971543042099,060971543042099,"Block 2099, Block Group 2, Census Tract 1543.04, Sonoma County, California",0,0,0
1000000US060971543042100,060971543042100,"Block 2100, Block Group 2, Census Tract 1543.04, Sonoma County, California",0,0,0
1000000US060971543042101,060971543042101,"Block 2101, Block Group 2, Census Tract 1543.04, Sonoma County, California",28,13,15
1000000US060971543042102,060971543042102,"Block 2102, Block Group 2, Census Tract 1543.04, Sonoma County, California",9,5,4
1000000US060971543043000,060971543043000,"Block 3000, Block Group 3, Census Tract 1543.04, Sonoma County, California",20,7,13
1000000US060971543043001,060971543043001,"Block 3001, Block Group 3, Census Tract 1543.04, Sonoma County, California",0,0,0
1000000US060971543043002,060971543043002,"Block 3002, Block Group 3, Census Tract 1543.04, Sonoma County, California",21,11,10
1000000US060971543043003,060971543043003,"Block 3003, Block Group 3, Census Tract 1543.04, Sonoma County, California",46,33,13
1000000US060971543043004,060971543043004,"Block 3004, Block Group 3, Census Tract 1543.04, Sonoma County, California",10,3,7
1000000US060971543043005,060971543043005,"Block 3005, Block Group 3, Census Tract 1543.04, Sonoma County, California",1,1,0
1000000US060971543043006,060971543043006,"Block 3006, Block Group 3, Census Tract 1543.04, Sonoma County, California",0,0,0
1000000US060971543043007,060971543043007,"Block 3007, Block Group 3, Census Tract 1543.04, Sonoma County, California",4,3,1
1000000US060971543043008,060971543043008,"Block 3008, Block Group 3, Census Tract 1543.04, Sonoma County, California",9,3,6
1000000US060971543043009,060971543043009,"Block 3009, Block Group 3, Census Tract 1543.04, Sonoma County, California",1,1,0
1000000US060971543043010,060971543043010,"Block 3010, Block Group 3, Census Tract 1543.04, Sonoma County, California",0,0,0
1000000US060971543043011,060971543043011,"Block 3011, Block Group 3, Census Tract 1543.04, Sonoma County, California",0,0,0
1000000US060971543043012,060971543043012,"Block 3012, Block Group 3, Census Tract 1543.04, Sonoma County, California",14,11,3
1000000US060971543043013,060971543043013,"Block 3013, Block Group 3, Census Tract 1543.04, Sonoma County, California",55,30,25
1000000US060971543043014,060971543043014,"Block 3014, Block Group 3, Census Tract 1543.04, Sonoma County, California",8,7,1
1000000US060971543043015,060971543043015,"Block 3015, Block Group 3, Census Tract 1543.04, Sonoma County, California",5,2,3
1000000US060971543043016,060971543043016,"Block 3016, Block Group 3, Census Tract 1543.04, Sonoma County, California",0,0,0
1000000US060971543043017,060971543043017,"Block 3017, Block Group 3, Census Tract 1543.04, Sonoma County, California",11,9,2
1000000US060971543043018,060971543043018,"Block 3018, Block Group 3, Census Tract 1543.04, Sonoma County, California",0,0,0
1000000US060971543043019,060971543043019,"Block 3019, Block Group 3, Census Tract 1543.04, Sonoma County, California",0,0,0
1000000US060971543043020,060971543043020,"Block 3020, Block Group 3, Census Tract 1543.04, Sonoma County, California",0,0,0
1000000US060971543043021,060971543043021,"Block 3021, Block Group 3, Census Tract 1543.04, Sonoma County, California",0,0,0
1000000US060971543043022,060971543043022,"Block 3022, Block Group 3, Census Tract 1543.04, Sonoma County, California",0,0,0
1000000US060971543043023,060971543043023,"Block 3023, Block Group 3, Census Tract 1543.04, Sonoma County, California",1,1,0
1000000US060971543043024,060971543043024,"Block 3024, Block Group 3, Census Tract 1543.04, Sonoma County, California",0,0,0
1000000US060971543043025,060971543043025,"Block 3025, Block Group 3, Census Tract 1543.04, Sonoma County, California",0,0,0
1000000US060971543043026,060971543043026,"Block 3026, Block Group 3, Census Tract 1543.04, Sonoma County, California",0,0,0
1000000US060971543043027,060971543043027,"Block 3027, Block Group 3, Census Tract 1543.04, Sonoma County, California",13,7,6
1000000US060971543043028,060971543043028,"Block 3028, Block Group 3, Census Tract 1543.04, Sonoma County, California",0,0,0
1000000US060971543043029,060971543043029,"Block 3029, Block Group 3, Census Tract 1543.04, Sonoma County, California",0,0,0
1000000US060971543043030,060971543043030,"Block 3030, Block Group 3, Census Tract 1543.04, Sonoma County, California",1,0,1
1000000US060971543043031,060971543043031,"Block 3031, Block Group 3, Census Tract 1543.04, Sonoma County, California",0,0,0
1000000US060971543043032,060971543043032,"Block 3032, Block Group 3, Census Tract 1543.04, Sonoma County, California",62,28,34
1000000US060971543043033,060971543043033,"Block 3033, Block Group 3, Census Tract 1543.04, Sonoma County, California",0,0,0
1000000US060971543043034,060971543043034,"Block 3034, Block Group 3, Census Tract 1543.04, Sonoma County, California",0,0,0
1000000US060971543043035,060971543043035,"Block 3035, Block Group 3, Census Tract 1543.04, Sonoma County, California",0,0,0
1000000US060971543043036,060971543043036,"Block 3036, Block Group 3, Census Tract 1543.04, Sonoma County, California",0,0,0
1000000US060971543043037,060971543043037,"Block 3037, Block Group 3, Census Tract 1543.04, Sonoma County, California",0,0,0
1000000US060971543043038,060971543043038,"Block 3038, Block Group 3, Census Tract 1543.04, Sonoma County, California",54,42,12
1000000US060971543043039,060971543043039,"Block 3039, Block Group 3, Census Tract 1543.04, Sonoma County, California",0,0,0
1000000US060971543043040,060971543043040,"Block 3040, Block Group 3, Census Tract 1543.04, Sonoma County, California",4,4,0
1000000US060971543043041,060971543043041,"Block 3041, Block Group 3, Census Tract 1543.04, Sonoma County, California",0,0,0
1000000US060971543043042,060971543043042,"Block 3042, Block Group 3, Census Tract 1543.04, Sonoma County, California",0,0,0
1000000US060971543043043,060971543043043,"Block 3043, Block Group 3, Census Tract 1543.04, Sonoma County, California",2,1,1
1000000US060971543043044,060971543043044,"Block 3044, Block Group 3, Census Tract 1543.04, Sonoma County, California",10,5,5
1000000US060971543043045,060971543043045,"Block 3045, Block Group 3, Census Tract 1543.04, Sonoma County, California",0,0,0
1000000US060971543043046,060971543043046,"Block 3046, Block Group 3, Census Tract 1543.04, Sonoma County, California",2,2,0
1000000US060971543043047,060971543043047,"Block 3047, Block Group 3, Census Tract 1543.04, Sonoma County, California",0,0,0
1000000US060971543043048,060971543043048,"Block 3048, Block Group 3, Census Tract 1543.04, Sonoma County, California",1,0,1
1000000US060971543043049,060971543043049,"Block 3049, Block Group 3, Census Tract 1543.04, Sonoma County, California",1,0,1
1000000US060971543043050,060971543043050,"Block 3050, Block Group 3, Census Tract 1543.04, Sonoma County, California",1,0,1
1000000US060971543043051,060971543043051,"Block 3051, Block Group 3, Census Tract 1543.04, Sonoma County, California",28,11,17
1000000US060971543043052,060971543043052,"Block 3052, Block Group 3, Census Tract 1543.04, Sonoma County, California",0,0,0
1000000US060971543043053,060971543043053,"Block 3053, Block Group 3, Census Tract 1543.04, Sonoma County, California",0,0,0
1000000US060971543043054,060971543043054,"Block 3054, Block Group 3, Census Tract 1543.04, Sonoma County, California",0,0,0
1000000US060971543043055,060971543043055,"Block 3055, Block Group 3, Census Tract 1543.04, Sonoma County, California",0,0,0
1000000US060971543043056,060971543043056,"Block 3056, Block Group 3, Census Tract 1543.04, Sonoma County, California",0,0,0
1000000US060971543043057,060971543043057,"Block 3057, Block Group 3, Census Tract 1543.04, Sonoma County, California",6,6,0
1000000US060971543043058,060971543043058,"Block 3058, Block Group 3, Census Tract 1543.04, Sonoma County, California",0,0,0
1000000US060971543043059,060971543043059,"Block 3059, Block Group 3, Census Tract 1543.04, Sonoma County, California",0,0,0
1000000US060971543043060,060971543043060,"Block 3060, Block Group 3, Census Tract 1543.04, Sonoma County, California",1,1,0
1000000US060971543043061,060971543043061,"Block 3061, Block Group 3, Census Tract 1543.04, Sonoma County, California",0,0,0
1000000US060971543043062,060971543043062,"Block 3062, Block Group 3, Census Tract 1543.04, Sonoma County, California",0,0,0
1000000US060971543043063,060971543043063,"Block 3063, Block Group 3, Census Tract 1543.04, Sonoma County, California",0,0,0
1000000US060971543043064,060971543043064,"Block 3064, Block Group 3, Census Tract 1543.04, Sonoma County, California",0,0,0
1000000US060971543043065,060971543043065,"Block 3065, Block Group 3, Census Tract 1543.04, Sonoma County, California",16,1,15
1000000US060971543043066,060971543043066,"Block 3066, Block Group 3, Census Tract 1543.04, Sonoma County, California",4,2,2
1000000US060971543043067,060971543043067,"Block 3067, Block Group 3, Census Tract 1543.04, Sonoma County, California",0,0,0
1000000US060971543043068,060971543043068,"Block 3068, Block Group 3, Census Tract 1543.04, Sonoma County, California",2,2,0
1000000US060971543043069,060971543043069,"Block 3069, Block Group 3, Census Tract 1543.04, Sonoma County, California",8,3,5
1000000US060971543043070,060971543043070,"Block 3070, Block Group 3, Census Tract 1543.04, Sonoma County, California",0,0,0
1000000US060971543043071,060971543043071,"Block 3071, Block Group 3, Census Tract 1543.04, Sonoma County, California",0,0,0
1000000US060971543043072,060971543043072,"Block 3072, Block Group 3, Census Tract 1543.04, Sonoma County, California",27,9,18
1000000US060971543043073,060971543043073,"Block 3073, Block Group 3, Census Tract 1543.04, Sonoma County, California",1,0,1
1000000US060971543043074,060971543043074,"Block 3074, Block Group 3, Census Tract 1543.04, Sonoma County, California",0,0,0
1000000US060971543043075,060971543043075,"Block 3075, Block Group 3, Census Tract 1543.04, Sonoma County, California",4,2,2
1000000US060971543043076,060971543043076,"Block 3076, Block Group 3, Census Tract 1543.04, Sonoma County, California",2,0,2
1000000US060971543043077,060971543043077,"Block 3077, Block Group 3, Census Tract 1543.04, Sonoma County, California",13,6,7
1000000US060971543043078,060971543043078,"Block 3078, Block Group 3, Census Tract 1543.04, Sonoma County, California",9,6,3
1000000US060971543043079,060971543043079,"Block 3079, Block Group 3, Census Tract 1543.04, Sonoma County, California",7,4,3
1000000US060971543043080,060971543043080,"Block 3080, Block Group 3, Census Tract 1543.04, Sonoma County, California",7,5,2
1000000US060971543043081,060971543043081,"Block 3081, Block Group 3, Census Tract 1543.04, Sonoma County, California",3,3,0
1000000US060971543043082,060971543043082,"Block 3082, Block Group 3, Census Tract 1543.04, Sonoma County, California",18,8,10
1000000US060971543043083,060971543043083,"Block 3083, Block Group 3, Census Tract 1543.04, Sonoma County, California",0,0,0
1000000US060971543043084,060971543043084,"Block 3084, Block Group 3, Census Tract 1543.04, Sonoma County, California",0,0,0
1000000US060971543043085,060971543043085,"Block 3085, Block Group 3, Census Tract 1543.04, Sonoma County, California",0,0,0
1000000US060971543043086,060971543043086,"Block 3086, Block Group 3, Census Tract 1543.04, Sonoma County, California",0,0,0
1000000US060971543043087,060971543043087,"Block 3087, Block Group 3, Census Tract 1543.04, Sonoma County, California",0,0,0
1000000US060971543043088,060971543043088,"Block 3088, Block Group 3, Census Tract 1543.04, Sonoma County, California",1,1,0
1000000US060971543043089,060971543043089,"Block 3089, Block Group 3, Census Tract 1543.04, Sonoma County, California",1,0,1
1000000US060971543043090,060971543043090,"Block 3090, Block Group 3, Census Tract 1543.04, Sonoma County, California",0,0,0
1000000US060971543043091,060971543043091,"Block 3091, Block Group 3, Census Tract 1543.04, Sonoma County, California",4,0,4
1000000US060971543043092,060971543043092,"Block 3092, Block Group 3, Census Tract 1543.04, Sonoma County, California",0,0,0
1000000US060971543043093,060971543043093,"Block 3093, Block Group 3, Census Tract 1543.04, Sonoma County, California",0,0,0
1000000US060971543043094,060971543043094,"Block 3094, Block Group 3, Census Tract 1543.04, Sonoma County, California",26,14,12
1000000US060971543043095,060971543043095,"Block 3095, Block Group 3, Census Tract 1543.04, Sonoma County, California",13,3,10
1000000US060971543043096,060971543043096,"Block 3096, Block Group 3, Census Tract 1543.04, Sonoma County, California",5,1,4
1000000US060971543043097,060971543043097,"Block 3097, Block Group 3, Census Tract 1543.04, Sonoma County, California",9,2,7
1000000US060971543043098,060971543043098,"Block 3098, Block Group 3, Census Tract 1543.04, Sonoma County, California",13,5,8
1000000US060971543043099,060971543043099,"Block 3099, Block Group 3, Census Tract 1543.04, Sonoma County, California",4,3,1
1000000US060971543043100,060971543043100,"Block 3100, Block Group 3, Census Tract 1543.04, Sonoma County, California",11,6,5
1000000US060971543043101,060971543043101,"Block 3101, Block Group 3, Census Tract 1543.04, Sonoma County, California",0,0,0
1000000US060971543043102,060971543043102,"Block 3102, Block Group 3, Census Tract 1543.04, Sonoma County, California",0,0,0
1000000US060971543043103,060971543043103,"Block 3103, Block Group 3, Census Tract 1543.04, Sonoma County, California",17,13,4
1000000US060971543043104,060971543043104,"Block 3104, Block Group 3, Census Tract 1543.04, Sonoma County, California",4,2,2
1000000US060971543043105,060971543043105,"Block 3105, Block Group 3, Census Tract 1543.04, Sonoma County, California",15,3,12
1000000US060971543043106,060971543043106,"Block 3106, Block Group 3, Census Tract 1543.04, Sonoma County, California",0,0,0
1000000US060971543043107,060971543043107,"Block 3107, Block Group 3, Census Tract 1543.04, Sonoma County, California",0,0,0
1000000US060971543043108,060971543043108,"Block 3108, Block Group 3, Census Tract 1543.04, Sonoma County, California",60,32,28
1000000US060971543043109,060971543043109,"Block 3109, Block Group 3, Census Tract 1543.04, Sonoma County, California",0,0,0
1000000US060971543043110,060971543043110,"Block 3110, Block Group 3, Census Tract 1543.04, Sonoma County, California",10,5,5
1000000US060971543043111,060971543043111,"Block 3111, Block Group 3, Census Tract 1543.04, Sonoma County, California",25,11,14
1000000US060971543043112,060971543043112,"Block 3112, Block Group 3, Census Tract 1543.04, Sonoma County, California",0,0,0
1000000US060971543043113,060971543043113,"Block 3113, Block Group 3, Census Tract 1543.04, Sonoma County, California",0,0,0
1000000US060971543043114,060971543043114,"Block 3114, Block Group 3, Census Tract 1543.04, Sonoma County, California",0,0,0
1000000US060971543043115,060971543043115,"Block 3115, Block Group 3, Census Tract 1543.04, Sonoma County, California",0,0,0
1000000US060971543043116,060971543043116,"Block 3116, Block Group 3, Census Tract 1543.04, Sonoma County, California",0,0,0
1000000US060971543043117,060971543043117,"Block 3117, Block Group 3, Census Tract 1543.04, Sonoma County, California",0,0,0
1000000US060971543043118,060971543043118,"Block 3118, Block Group 3, Census Tract 1543.04, Sonoma County, California",5,5,0
1000000US060971543043119,060971543043119,"Block 3119, Block Group 3, Census Tract 1543.04, Sonoma County, California",4,4,0
1000000US060971543043120,060971543043120,"Block 3120, Block Group 3, Census Tract 1543.04, Sonoma County, California",10,7,3
1000000US060971543043121,060971543043121,"Block 3121, Block Group 3, Census Tract 1543.04, Sonoma County, California",0,0,0
1000000US060971543043122,060971543043122,"Block 3122, Block Group 3, Census Tract 1543.04, Sonoma County, California",0,0,0
1000000US060971543043123,060971543043123,"Block 3123, Block Group 3, Census Tract 1543.04, Sonoma County, California",0,0,0
1000000US060971543043124,060971543043124,"Block 3124, Block Group 3, Census Tract 1543.04, Sonoma County, California",18,14,4
1000000US060971543043125,060971543043125,"Block 3125, Block Group 3, Census Tract 1543.04, Sonoma County, California",0,0,0
1000000US060971543043126,060971543043126,"Block 3126, Block Group 3, Census Tract 1543.04, Sonoma County, California",0,0,0
1000000US060971543043127,060971543043127,"Block 3127, Block Group 3, Census Tract 1543.04, Sonoma County, California",0,0,0
1000000US060971543043128,060971543043128,"Block 3128, Block Group 3, Census Tract 1543.04, Sonoma County, California",0,0,0
1000000US060971543043129,060971543043129,"Block 3129, Block Group 3, Census Tract 1543.04, Sonoma County, California",0,0,0
1000000US060971543043130,060971543043130,"Block 3130, Block Group 3, Census Tract 1543.04, Sonoma County, California",11,10,1
1000000US060971543043131,060971543043131,"Block 3131, Block Group 3, Census Tract 1543.04, Sonoma County, California",0,0,0
1000000US060971543043132,060971543043132,"Block 3132, Block Group 3, Census Tract 1543.04, Sonoma County, California",4,3,1
1000000US060971543043133,060971543043133,"Block 3133, Block Group 3, Census Tract 1543.04, Sonoma County, California",0,0,0
1000000US060971543043134,060971543043134,"Block 3134, Block Group 3, Census Tract 1543.04, Sonoma County, California",0,0,0
1000000US060971543043135,060971543043135,"Block 3135, Block Group 3, Census Tract 1543.04, Sonoma County, California",1,0,1
1000000US060971543043136,060971543043136,"Block 3136, Block Group 3, Census Tract 1543.04, Sonoma County, California",12,7,5
1000000US060971543043137,060971543043137,"Block 3137, Block Group 3, Census Tract 1543.04, Sonoma County, California",17,6,11
1000000US060971543043138,060971543043138,"Block 3138, Block Group 3, Census Tract 1543.04, Sonoma County, California",7,6,1
1000000US060971543043139,060971543043139,"Block 3139, Block Group 3, Census Tract 1543.04, Sonoma County, California",55,29,26
1000000US060971543043140,060971543043140,"Block 3140, Block Group 3, Census Tract 1543.04, Sonoma County, California",0,0,0
1000000US060971543043141,060971543043141,"Block 3141, Block Group 3, Census Tract 1543.04, Sonoma County, California",18,6,12
1000000US060971543043142,060971543043142,"Block 3142, Block Group 3, Census Tract 1543.04, Sonoma County, California",19,9,10
1000000US060979901000001,060979901000001,"Block 0001, Block Group 0, Census Tract 9901, Sonoma County, California",0,0,0
1000000US060979901000002,060979901000002,"Block 0002, Block Group 0, Census Tract 9901, Sonoma County, California",0,0,0
1000000US060979901000003,060979901000003,"Block 0003, Block Group 0, Census Tract 9901, Sonoma County, California",0,0,0
1000000US060979901000004,060979901000004,"Block 0004, Block Group 0, Census Tract 9901, Sonoma County, California",0,0,0
1000000US060979901000005,060979901000005,"Block 0005, Block Group 0, Census Tract 9901, Sonoma County, California",0,0,0
1000000US060979901000006,060979901000006,"Block 0006, Block Group 0, Census Tract 9901, Sonoma County, California",0,0,0
1000000US060979901000007,060979901000007,"Block 0007, Block Group 0, Census Tract 9901, Sonoma County, California",0,0,0
1000000US060979901000008,060979901000008,"Block 0008, Block Group 0, Census Tract 9901, Sonoma County, California",0,0,0
1000000US060979901000009,060979901000009,"Block 0009, Block Group 0, Census Tract 9901, Sonoma County, California",0,0,0
1000000US060979901000010,060979901000010,"Block 0010, Block Group 0, Census Tract 9901, Sonoma County, California",0,0,0
